province_code,cmun,municipality_name,population_total,population_male,population_female
01,1,Alegría-Dulantzi,1234,640,594
01,2,Amurrio,9758,4866,4892
01,3,Aramaio,1345,704,641
01,6,Armiñón,139,73,66
01,37,Arraia-Maeztu,684,363,321
01,8,Arrazua-Ubarrundia,745,388,357
01,4,Artziniega,1293,648,645
01,9,Asparrena,1541,763,778
01,10,Ayala,2008,1005,1003
01,11,Baños de Ebro,335,182,153
01,13,Barrundia,554,308,246
01,14,Berantevilla,403,209,194
01,16,Bernedo,540,313,227
01,17,Campezo,1109,582,527
01,19,Cripán,200,104,96
01,20,Cuartango,343,195,148
01,21,Elburgo,192,104,88
01,22,Elciego,921,462,459
01,23,Elvillar,348,188,160
01,56,Harana/Valle de Arana,366,201,165
01,901,Iruña de Oca,1616,853,763
01,27,Iruraiz-Gauna,408,224,184
01,28,Labastida,1082,573,509
01,30,Lagrán,190,101,89
01,31,Laguardia,1423,727,696
01,32,Lanciego,650,339,311
01,902,Lantarón,829,448,381
01,33,Lapuebla de Labarca,861,430,431
01,58,Legutiano,1311,693,618
01,34,Leza,182,99,83
01,36,Llodio,19913,9999,9914
01,39,Moreda de Alava,283,155,128
01,41,Navaridas,227,125,102
01,42,Okondo,770,388,382
01,43,Oyón/Oion,2242,1130,1112
01,44,Peñacerrada-Urizaharra,251,140,111
01,46,Ribera Alta,512,297,215
01,47,Ribera Baja,465,247,218
01,49,Salinas de Añana,203,105,98
01,51,Salvatierra o Agurain,3796,1929,1867
01,52,Samaniego,305,151,154
01,53,San Millán,691,377,314
01,54,Urkabustaiz,836,447,389
01,55,Valdegovía,883,492,391
01,57,Villabuena de Alava,345,170,175
01,59,Vitoria-Gasteiz,214234,105300,108934
01,60,Yécora,254,126,128
01,61,Zalduondo,136,73,63
01,62,Zambrana,357,196,161
01,18,Zigoitia,1057,576,481
01,63,Zuia,1451,732,719
02,1,Abengibre,1019,506,513
02,2,Alatoz,683,357,326
02,3,Albacete,143799,70234,73565
02,4,Albatana,907,458,449
02,5,Alborea,798,420,378
02,6,Alcadozo,809,412,397
02,7,Alcalá del Júcar,1563,799,764
02,8,Alcaraz,1799,878,921
02,9,Almansa,23507,11569,11938
02,10,Alpera,2353,1209,1144
02,11,Ayna,1086,545,541
02,12,Balazote,2203,1116,1087
02,14,Ballestero (El),595,294,301
02,13,Balsa de Ves,270,146,124
02,15,Barrax,1979,995,984
02,16,Bienservida,952,481,471
02,17,Bogarra,1448,755,693
02,18,Bonete,1245,633,612
02,19,Bonillo (El),3333,1692,1641
02,20,Carcelén,676,356,320
02,21,Casas de Juan Núñez,1322,689,633
02,22,Casas de Lázaro,455,244,211
02,23,Casas de Ves,962,489,473
02,24,Casas-Ibáñez,4041,2034,2007
02,25,Caudete,8765,4359,4406
02,26,Cenizate,1091,567,524
02,29,Chinchilla de Monte-Aragón,3153,1629,1524
02,27,Corral-Rubio,481,247,234
02,28,Cotillas,235,118,117
02,30,Elche de la Sierra,4010,1984,2026
02,31,Férez,814,417,397
02,32,Fuensanta,401,199,202
02,33,Fuente-Alamo,2449,1245,1204
02,34,Fuentealbilla,1842,933,909
02,35,Gineta (La),2083,1003,1080
02,36,Golosalvo,140,67,73
02,37,Hellín,26021,12899,13122
02,38,Herrera (La),422,217,205
02,39,Higueruela,1298,643,655
02,40,Hoya-Gonzalo,770,384,386
02,41,Jorquera,594,317,277
02,42,Letur,1386,685,701
02,43,Lezuza,1841,955,886
02,44,Liétor,1758,908,850
02,45,Madrigueras,4513,2290,2223
02,46,Mahora,1397,690,707
02,47,Masegoso,180,105,75
02,48,Minaya,1772,891,881
02,49,Molinicos,1444,743,701
02,50,Montalvos,153,79,74
02,51,Montealegre del Castillo,2153,1084,1069
02,52,Motilleja,541,268,273
02,53,Munera,4168,2107,2061
02,54,Navas de Jorquera,540,276,264
02,55,Nerpio,1928,1025,903
02,56,Ontur,2469,1225,1244
02,57,Ossa de Montiel,2876,1430,1446
02,58,Paterna del Madera,623,333,290
02,60,Peñas de San Pedro,1282,678,604
02,59,Peñascosa,452,230,222
02,61,Pétrola,979,498,481
02,62,Povedilla,745,392,353
02,63,Pozohondo,1911,986,925
02,64,Pozo-Lorente,540,251,289
02,65,Pozuelo,684,356,328
02,66,Recueja (La),361,180,181
02,67,Riópar,1436,738,698
02,68,Robledo,459,237,222
02,69,Roda (La),13523,6774,6749
02,70,Salobre,644,331,313
02,71,San Pedro,1336,674,662
02,72,Socovos,2106,1078,1028
02,73,Tarazona de la Mancha,5976,2988,2988
02,74,Tobarra,7344,3652,3692
02,75,Valdeganga,2022,1013,1009
02,76,Vianos,497,243,254
02,77,Villa de Ves,68,34,34
02,78,Villalgordo del Júcar,1328,656,672
02,79,Villamalea,3449,1769,1680
02,80,Villapalacios,908,451,457
02,81,Villarrobledo,22165,10855,11310
02,82,Villatoya,194,101,93
02,83,Villavaliente,307,158,149
02,84,Villaverde de Guadalimar,570,302,268
02,85,Viveros,595,309,286
02,86,Yeste,5014,2563,2451
03,1,Adsubia,582,292,290
03,2,Agost,4017,2008,2009
03,3,Agres,656,342,314
03,4,Aigües,544,272,272
03,5,Albatera,8417,4213,4204
03,6,Alcalalí,842,422,420
03,7,Alcocer de Planes,122,52,70
03,8,Alcoleja,294,141,153
03,9,Alcoy/Alcoi,60921,29305,31616
03,10,Alfafara,391,190,201
03,11,Alfàs del Pi (l'),12547,6127,6420
03,12,Algorfa,1140,581,559
03,13,Algueña,1425,685,740
03,14,Alicante/Alacant,274577,131776,142801
03,15,Almoradí,13479,6739,6740
03,16,Almudaina,125,62,63
03,17,Alqueria d'Asnar (l'),407,198,209
03,18,Altea,13519,6630,6889
03,19,Aspe,16391,8199,8192
03,20,Balones,176,83,93
03,21,Banyeres de Mariola,7056,3517,3539
03,22,Benasau,210,106,104
03,23,Benejama,1799,897,902
03,24,Benejúzar,5009,2481,2528
03,25,Benferri,1011,509,502
03,26,Beniarbeig,1208,592,616
03,27,Beniardá,224,107,117
03,28,Beniarrés,1464,738,726
03,29,Benichembla,390,196,194
03,30,Benidoleig,783,378,405
03,31,Benidorm,50040,24552,25488
03,32,Benifallim,169,82,87
03,33,Benifato,140,71,69
03,34,Benijófar,1592,773,819
03,35,Benilloba,961,490,471
03,36,Benillup,105,54,51
03,37,Benimantell,432,200,232
03,38,Benimarfull,408,186,222
03,39,Benimassot,122,62,60
03,40,Benimeli,329,169,160
03,41,Benissa,9154,4541,4613
03,42,Benitachell/Poble Nou de Benitatxell (el),1989,1001,988
03,43,Biar,3568,1720,1848
03,44,Bigastro,4721,2398,2323
03,45,Bolulla,306,152,154
03,46,Busot,1373,682,691
03,49,Callosa de Segura,15230,7556,7674
03,48,Callosa d'En Sarrià,6322,3178,3144
03,47,Calpe/Calp,14216,7073,7143
03,50,Campello (el),15200,7546,7654
03,51,Campo de Mirra/Camp de Mirra (el),379,183,196
03,52,Cañada,1088,521,567
03,53,Castalla,7631,3764,3867
03,54,Castell de Castells,499,254,245
03,55,Catral,4881,2430,2451
03,56,Cocentaina,10737,5257,5480
03,57,Confrides,300,174,126
03,58,Cox,5750,2901,2849
03,59,Crevillente,23781,11945,11836
03,61,Daya Nueva,1189,610,579
03,62,Daya Vieja,183,92,91
03,63,Dénia,27469,13337,14132
03,64,Dolores,6127,3041,3086
03,65,Elche/Elx,191660,94407,97253
03,66,Elda,52751,25738,27013
03,67,Facheca,125,67,58
03,68,Famorca,73,34,39
03,69,Finestrat,1504,749,755
03,70,Formentera del Segura,2112,1038,1074
03,72,Gaianes,314,146,168
03,71,Gata de Gorgos,5070,2506,2564
03,73,Gorga,270,140,130
03,74,Granja de Rocamora,2076,1049,1027
03,75,Guadalest,169,88,81
03,76,Guardamar del Segura,8227,4077,4150
03,77,Hondón de las Nieves,1587,795,792
03,78,Hondón de los Frailes,550,273,277
03,79,Ibi,21076,10428,10648
03,80,Jacarilla,1504,766,738
03,81,Jalón/Xaló,2011,991,1020
03,82,Jávea/Xàbia,21393,10587,10806
03,83,Jijona/Xixona,7608,3582,4026
03,85,Llíber,527,261,266
03,84,Lorcha/Orxa (l'),823,414,409
03,86,Millena,157,76,81
03,88,Monforte del Cid,5082,2635,2447
03,89,Monóvar/Monòver,12085,5897,6188
03,903,Montesinos (Los),2436,1223,1213
03,91,Murla,332,142,190
03,92,Muro de Alcoy,7104,3513,3591
03,90,Mutxamel,12779,6392,6387
03,93,Novelda,23188,11357,11831
03,94,Nucia (la),7010,3467,3543
03,95,Ondara,5149,2566,2583
03,96,Onil,6786,3386,3400
03,97,Orba,1576,772,804
03,99,Orihuela,50724,24978,25746
03,98,Orxeta,470,237,233
03,100,Parcent,767,377,390
03,101,Pedreguer,5853,2846,3007
03,102,Pego,10369,5219,5150
03,103,Penàguila,346,165,181
03,104,Petrer,26505,13189,13316
03,902,Pilar de la Horadada,9528,4983,4545
03,105,Pinoso,5970,2958,3012
03,106,Planes,822,405,417
03,901,Poblets (els),1191,574,617
03,107,Polop,1995,975,1020
03,60,Quatretondeta,189,93,96
03,109,Rafal,3027,1498,1529
03,110,Ráfol de Almunia,368,178,190
03,111,Redován,5268,2704,2564
03,112,Relleu,822,404,418
03,113,Rojales,7195,3553,3642
03,114,Romana (la),2005,1023,982
03,115,Sagra,379,189,190
03,116,Salinas,1174,598,576
03,118,San Fulgencio,2888,1433,1455
03,904,San Isidro,1256,651,605
03,119,San Juan de Alicante,16008,7897,8111
03,120,San Miguel de Salinas,3521,1803,1718
03,122,San Vicente del Raspeig/Sant Vicent del Raspeig,34986,17278,17708
03,117,Sanet y Negrals,566,257,309
03,121,Santa Pola,17099,8458,8641
03,123,Sax,8605,4312,4293
03,124,Sella,587,300,287
03,125,Senija,474,244,230
03,127,Tárbena,721,360,361
03,128,Teulada,8430,4197,4233
03,129,Tibi,1147,586,561
03,130,Tollos,47,29,18
03,131,Tormos,305,148,157
03,132,Torremanzanas/Torre de les Maçanes (la),749,368,381
03,133,Torrevieja,35998,17709,18289
03,134,Vall d'Alcalà (la),186,85,101
03,135,Vall de Ebo,343,176,167
03,136,Vall de Gallinera,682,346,336
03,137,Vall de Laguart,918,442,476
03,138,Verger (el),3627,1761,1866
03,139,Villajoyosa/Vila Joiosa (la),22866,11220,11646
03,140,Villena,31555,15517,16038
04,1,Abla,1529,754,775
04,2,Abrucena,1460,715,745
04,3,Adra,20898,10397,10501
04,4,Albanchez,626,315,311
04,5,Alboloduy,817,385,432
04,6,Albox,9456,4730,4726
04,7,Alcolea,858,440,418
04,8,Alcóntar,621,317,304
04,9,Alcudia de Monteagud,183,85,98
04,10,Alhabia,694,353,341
04,11,Alhama de Almería,3104,1548,1556
04,12,Alicún,249,121,128
04,13,Almería,170503,82674,87829
04,14,Almócita,193,99,94
04,15,Alsodux,113,54,59
04,16,Antas,2659,1314,1345
04,17,Arboleas,1550,790,760
04,18,Armuña de Almanzora,339,163,176
04,19,Bacares,287,154,133
04,20,Bayárcal,357,188,169
04,21,Bayarque,235,112,123
04,22,Bédar,552,293,259
04,23,Beires,133,64,69
04,24,Benahadux,2702,1306,1396
04,26,Benitagla,111,56,55
04,27,Benizalón,328,169,159
04,28,Bentarique,331,169,162
04,29,Berja,13043,6501,6542
04,30,Canjáyar,1783,899,884
04,31,Cantoria,3357,1694,1663
04,32,Carboneras,6215,3177,3038
04,33,Castro de Filabres,207,103,104
04,36,Chercos,289,150,139
04,37,Chirivel,1860,934,926
04,34,Cóbdar,274,139,135
04,35,Cuevas del Almanzora,9625,4843,4782
04,38,Dalías,3590,1781,1809
04,39,Darrical,76,41,35
04,902,Ejido (El),47610,24823,22787
04,41,Enix,223,113,110
04,43,Felix,562,280,282
04,44,Fines,1746,902,844
04,45,Fiñana,2644,1291,1353
04,46,Fondón,934,467,467
04,47,Gádor,2596,1287,1309
04,48,Gallardos (Los),1761,891,870
04,49,Garrucha,4867,2491,2376
04,50,Gérgal,1089,531,558
04,51,Huécija,537,269,268
04,52,Huércal de Almería,5366,2701,2665
04,53,Huércal-Overa,13756,6761,6995
04,54,Illar,489,235,254
04,55,Instinción,547,263,284
04,56,Laroya,108,54,54
04,57,Láujar de Andarax,1815,902,913
04,58,Líjar,516,257,259
04,59,Lubrín,1823,876,947
04,60,Lucainena de las Torres,588,291,297
04,61,Lúcar,799,393,406
04,62,Macael,5956,3039,2917
04,63,María,1658,849,809
04,64,Mojácar,4394,2165,2229
04,903,Mojonera (La),6460,3463,2997
04,65,Nacimiento,541,268,273
04,66,Níjar,15017,7788,7229
04,67,Ohanes,817,414,403
04,68,Olula de Castro,197,97,100
04,69,Olula del Río,6165,3099,3066
04,70,Oria,2240,1125,1115
04,71,Padules,488,242,246
04,72,Partaloa,394,191,203
04,73,Paterna del Río,335,181,154
04,74,Pechina,2564,1288,1276
04,75,Pulpí,5202,2626,2576
04,76,Purchena,1696,820,876
04,77,Rágol,395,184,211
04,78,Rioja,1180,588,592
04,79,Roquetas de Mar,37237,19061,18176
04,80,Santa Cruz de Marchena,215,98,117
04,81,Santa Fe de Mondújar,411,199,212
04,82,Senés,359,183,176
04,83,Serón,2742,1368,1374
04,84,Sierro,510,250,260
04,85,Somontín,508,255,253
04,86,Sorbas,2834,1442,1392
04,87,Suflí,233,116,117
04,88,Tabernas,3457,1729,1728
04,89,Taberno,1023,506,517
04,90,Tahal,415,217,198
04,91,Terque,444,224,220
04,92,Tíjola,3845,1940,1905
04,901,Tres Villas (Las),686,359,327
04,93,Turre,2157,1068,1089
04,94,Turrillas,289,148,141
04,95,Uleila del Campo,1007,514,493
04,96,Urrácal,345,169,176
04,97,Velefique,348,180,168
04,98,Vélez-Blanco,2317,1183,1134
04,99,Vélez-Rubio,6528,3149,3379
04,100,Vera,6453,3242,3211
04,101,Viator,3186,1569,1617
04,102,Vícar,14807,7803,7004
04,103,Zurgena,2123,1048,1075
05,1,Adanero,332,179,153
05,2,Adrada (La),2003,1039,964
05,5,Albornos,276,145,131
05,7,Aldeanueva de Santa Cruz,193,103,90
05,8,Aldeaseca,362,183,179
05,10,Aldehuela (La),291,141,150
05,12,Amavida,203,101,102
05,13,Arenal (El),1109,530,579
05,14,Arenas de San Pedro,6609,3257,3352
05,15,Arevalillo,152,77,75
05,16,Arévalo,7359,3556,3803
05,17,Aveinte,153,80,73
05,18,Avellaneda,43,20,23
05,19,Avila,47187,22703,24484
05,21,Barco de Avila (El),2564,1251,1313
05,22,Barraco (El),2010,1015,995
05,23,Barromán,265,145,120
05,24,Becedas,459,235,224
05,25,Becedillas,182,96,86
05,26,Bercial de Zapardiel,322,151,171
05,27,Berlanas (Las),369,185,184
05,29,Bernuy-Zapardiel,260,144,116
05,30,Berrocalejo de Aragona,41,22,19
05,33,Blascomillán,317,155,162
05,34,Blasconuño de Matacabras,27,15,12
05,35,Blascosancho,163,78,85
05,36,Bohodón (El),215,107,108
05,37,Bohoyo,504,254,250
05,38,Bonilla de la Sierra,202,108,94
05,39,Brabos,76,40,36
05,40,Bularros,127,71,56
05,41,Burgohondo,1253,634,619
05,42,Cabezas de Alambre,257,136,121
05,43,Cabezas del Pozo,179,102,77
05,44,Cabezas del Villar,510,271,239
05,45,Cabizuela,157,79,78
05,46,Canales,68,37,31
05,47,Candeleda,5176,2655,2521
05,48,Cantiveros,191,96,95
05,49,Cardeñosa,569,298,271
05,51,Carrera (La),302,145,157
05,52,Casas del Puerto de Villatoro,111,62,49
05,53,Casasola,189,100,89
05,54,Casavieja,1679,872,807
05,55,Casillas,949,492,457
05,56,Castellanos de Zapardiel,150,86,64
05,57,Cebreros,3483,1747,1736
05,58,Cepeda la Mora,150,81,69
05,67,Chamartín,121,66,55
05,59,Cillán,157,81,76
05,60,Cisla,203,101,102
05,61,Colilla (La),196,102,94
05,62,Collado de Contreras,283,153,130
05,63,Collado del Mirón,97,50,47
05,64,Constanzana,203,105,98
05,65,Crespos,779,404,375
05,66,Cuevas del Valle,662,358,304
05,903,Diego del Carpio,333,182,151
05,69,Donjimeno,142,74,68
05,70,Donvidas,70,34,36
05,72,Espinosa de los Caballeros,114,64,50
05,73,Flores de Avila,453,236,217
05,74,Fontiveros,1094,558,536
05,75,Fresnedilla,123,55,68
05,76,Fresno (El),441,231,210
05,77,Fuente el Sauz,351,181,170
05,78,Fuentes de Año,224,118,106
05,79,Gallegos de Altamiros,109,58,51
05,80,Gallegos de Sobrinos,114,54,60
05,81,Garganta del Villar,84,48,36
05,82,Gavilanes,751,432,319
05,83,Gemuño,233,111,122
05,85,Gil García,79,37,42
05,84,Gilbuena,153,86,67
05,86,Gimialcón,131,70,61
05,87,Gotarrendura,190,72,118
05,88,Grandes y San Martín,55,29,26
05,89,Guisando,720,375,345
05,90,Gutierre-Muñoz,137,68,69
05,92,Hernansancho,235,118,117
05,93,Herradón de Pinares,510,262,248
05,94,Herreros de Suso,248,124,124
05,95,Higuera de las Dueñas,320,176,144
05,96,Hija de Dios (La),114,63,51
05,97,Horcajada (La),861,425,436
05,99,Horcajo de las Torres,867,476,391
05,100,Hornillo (El),442,223,219
05,102,Hoyo de Pinares (El),2525,1283,1242
05,101,Hoyocasero,416,211,205
05,103,Hoyorredondo,133,71,62
05,106,Hoyos de Miguel Muñoz,62,33,29
05,104,Hoyos del Collado,50,31,19
05,105,Hoyos del Espino,400,219,181
05,107,Hurtumpascual,119,65,54
05,108,Junciana,100,48,52
05,109,Langa,608,311,297
05,110,Lanzahíta,933,485,448
05,113,Llanos de Tormes (Los),146,76,70
05,112,Losar del Barco (El),162,84,78
05,114,Madrigal de las Altas Torres,2066,1056,1010
05,115,Maello,657,326,331
05,116,Malpartida de Corneja,239,116,123
05,117,Mamblas,289,158,131
05,118,Mancera de Arriba,156,76,80
05,119,Manjabálago,78,44,34
05,120,Marlín,53,29,24
05,121,Martiherrero,208,116,92
05,122,Martínez,255,132,123
05,123,Mediana de Voltoya,111,64,47
05,124,Medinilla,247,123,124
05,125,Mengamuñoz,74,33,41
05,126,Mesegar de Corneja,130,66,64
05,127,Mijares,1031,526,505
05,128,Mingorría,556,276,280
05,129,Mirón (El),268,156,112
05,130,Mironcillo,135,75,60
05,131,Mirueña de los Infanzones,215,106,109
05,132,Mombeltrán,1225,656,569
05,133,Monsalupe,99,49,50
05,134,Moraleja de Matacabras,73,35,38
05,135,Muñana,586,303,283
05,136,Muñico,156,83,73
05,138,Muñogalindo,458,247,211
05,139,Muñogrande,111,58,53
05,140,Muñomer del Peco,143,78,65
05,141,Muñopepe,106,56,50
05,142,Muñosancho,180,82,98
05,143,Muñotello,133,70,63
05,144,Narrillos del Alamo,173,91,82
05,145,Narrillos del Rebollar,82,41,41
05,149,Narros de Saldueña,210,116,94
05,147,Narros del Castillo,271,147,124
05,148,Narros del Puerto,41,22,19
05,152,Nava de Arévalo,1042,535,507
05,153,Nava del Barco,202,106,96
05,151,Navacepedilla de Corneja,150,87,63
05,154,Navadijos,67,38,29
05,155,Navaescurial,111,63,48
05,156,Navahondilla,136,78,58
05,157,Navalacruz,344,169,175
05,158,Navalmoral,635,313,322
05,159,Navalonguilla,469,238,231
05,160,Navalosa,532,276,256
05,161,Navalperal de Pinares,943,454,489
05,162,Navalperal de Tormes,142,77,65
05,163,Navaluenga,2034,1024,1010
05,164,Navaquesera,44,26,18
05,165,Navarredonda de Gredos,482,247,235
05,166,Navarredondilla,308,151,157
05,167,Navarrevisca,435,227,208
05,168,Navas del Marqués (Las),4346,2176,2170
05,169,Navatalgordo,423,208,215
05,170,Navatejares,122,54,68
05,171,Neila de San Miguel,135,70,65
05,172,Niharra,204,102,102
05,173,Ojos-Albos,53,26,27
05,174,Orbita,111,55,56
05,175,Oso (El),231,127,104
05,176,Padiernos,260,135,125
05,177,Pajares de Adaja,196,100,96
05,178,Palacios de Goda,536,265,271
05,179,Papatrigo,343,175,168
05,180,Parral (El),137,75,62
05,181,Pascualcobo,48,27,21
05,182,Pedro Bernardo,1387,715,672
05,183,Pedro-Rodríguez,228,112,116
05,184,Peguerinos,326,171,155
05,185,Peñalba de Avila,136,78,58
05,186,Piedrahíta,2271,1101,1170
05,187,Piedralaves,2173,1101,1072
05,188,Poveda,95,53,42
05,189,Poyales del Hoyo,769,389,380
05,190,Pozanco,58,32,26
05,191,Pradosegar,191,102,89
05,192,Puerto Castilla,144,80,64
05,193,Rasueros,405,214,191
05,194,Riocabado,212,116,96
05,195,Riofrío,358,189,169
05,196,Rivilla de Barajas,100,51,49
05,197,Salobral,132,65,67
05,198,Salvadiós,127,66,61
05,199,San Bartolomé de Béjar,88,41,47
05,200,San Bartolomé de Corneja,131,71,60
05,201,San Bartolomé de Pinares,787,417,370
05,206,San Esteban de los Patos,50,28,22
05,208,San Esteban de Zapardiel,74,38,36
05,207,San Esteban del Valle,954,496,458
05,209,San García de Ingelmos,186,99,87
05,901,San Juan de Gredos,426,217,209
05,210,San Juan de la Encinilla,151,69,82
05,211,San Juan de la Nava,704,367,337
05,212,San Juan del Molinillo,342,191,151
05,213,San Juan del Olmo,194,107,87
05,214,San Lorenzo de Tormes,67,29,38
05,215,San Martín de la Vega del Alberche,324,185,139
05,216,San Martín del Pimpollar,356,192,164
05,217,San Miguel de Corneja,132,61,71
05,218,San Miguel de Serrezuela,232,123,109
05,219,San Pascual,59,36,23
05,220,San Pedro del Arroyo,478,246,232
05,231,San Vicente de Arévalo,233,118,115
05,204,Sanchidrián,793,401,392
05,205,Sanchorreja,136,68,68
05,222,Santa Cruz de Pinares,219,122,97
05,221,Santa Cruz del Valle,656,332,324
05,226,Santa María de los Caballeros,172,88,84
05,224,Santa María del Arroyo,145,74,71
05,225,Santa María del Berrocal,581,272,309
05,902,Santa María del Cubillo,403,223,180
05,227,Santa María del Tiétar,378,204,174
05,904,Santiago de Tormes,323,160,163
05,228,Santiago del Collado,304,190,114
05,229,Santo Domingo de las Posadas,101,48,53
05,230,Santo Tomé de Zabarcos,124,68,56
05,232,Serrada (La),148,73,75
05,233,Serranillos,453,239,214
05,234,Sigeres,84,39,45
05,235,Sinlabajos,264,137,127
05,236,Solana de Avila,234,126,108
05,237,Solana de Rioalmar,304,161,143
05,238,Solosancho,1101,578,523
05,239,Sotalvo,266,136,130
05,240,Sotillo de la Adrada,3507,1725,1782
05,241,Tiemblo (El),3797,1894,1903
05,242,Tiñosillos,765,409,356
05,243,Tolbaños,147,73,74
05,244,Tormellas,119,64,55
05,245,Tornadizos de Avila,361,179,182
05,247,Torre (La),467,258,209
05,246,Tórtoles,133,71,62
05,249,Umbrías,180,93,87
05,251,Vadillo de la Sierra,175,96,79
05,252,Valdecasa,126,67,59
05,253,Vega de Santa María,145,79,66
05,254,Velayos,289,140,149
05,256,Villaflor,175,90,85
05,257,Villafranca de la Sierra,219,120,99
05,905,Villanueva de Avila,612,316,296
05,258,Villanueva de Gómez,153,75,78
05,259,Villanueva del Aceral,209,95,114
05,260,Villanueva del Campillo,225,119,106
05,261,Villar de Corneja,86,45,41
05,262,Villarejo del Valle,510,262,248
05,263,Villatoro,251,145,106
05,264,Viñegra de Moraña,101,56,45
05,265,Vita,122,75,47
05,266,Zapardiel de la Cañada,220,112,108
05,267,Zapardiel de la Ribera,142,72,70
06,1,Acedera,1023,541,482
06,2,Aceuchal,5201,2547,2654
06,3,Ahillones,1230,601,629
06,4,Alange,2031,1049,982
06,5,Albuera (La),1805,922,883
06,6,Alburquerque,5780,2926,2854
06,7,Alconchel,2347,1160,1187
06,8,Alconera,744,374,370
06,9,Aljucén,230,127,103
06,10,Almendral,1494,731,763
06,11,Almendralejo,27209,13283,13926
06,12,Arroyo de San Serván,4028,2051,1977
06,13,Atalaya,377,184,193
06,14,Azuaga,9274,4581,4693
06,15,Badajoz,122510,59198,63312
06,16,Barcarrota,3938,2007,1931
06,17,Baterno,413,210,203
06,18,Benquerencia de la Serena,1117,560,557
06,19,Berlanga,2716,1342,1374
06,20,Bienvenida,2371,1202,1169
06,21,Bodonal de la Sierra,1306,677,629
06,22,Burguillos del Cerro,3406,1670,1736
06,23,Cabeza del Buey,6222,3025,3197
06,24,Cabeza la Vaca,1684,831,853
06,25,Calamonte,5869,2948,2921
06,26,Calera de León,1159,579,580
06,27,Calzadilla de los Barros,819,407,412
06,28,Campanario,5915,2875,3040
06,29,Campillo de Llerena,1830,895,935
06,30,Capilla,227,105,122
06,31,Carmonita,685,356,329
06,32,Carrascalejo (El),34,18,16
06,33,Casas de Don Pedro,1827,910,917
06,34,Casas de Reina,254,119,135
06,35,Castilblanco,1403,699,704
06,36,Castuera,7951,4015,3936
06,42,Cheles,1379,687,692
06,37,Codosera (La),2406,1239,1167
06,38,Cordobilla de Lácara,1030,530,500
06,39,Coronada (La),2513,1255,1258
06,40,Corte de Peleas,1312,662,650
06,41,Cristina,558,297,261
06,43,Don Alvaro,680,334,346
06,44,Don Benito,31022,15333,15689
06,45,Entrín Bajo,684,338,346
06,46,Esparragalejo,1565,766,799
06,47,Esparragosa de la Serena,1146,570,576
06,48,Esparragosa de Lares,1247,617,630
06,49,Feria,1412,705,707
06,50,Fregenal de la Sierra,5416,2631,2785
06,51,Fuenlabrada de los Montes,2103,1037,1066
06,52,Fuente de Cantos,5075,2570,2505
06,53,Fuente del Arco,844,418,426
06,54,Fuente del Maestre,6876,3419,3457
06,55,Fuentes de León,2851,1379,1472
06,56,Garbayuela,605,319,286
06,57,Garlitos,796,409,387
06,58,Garrovilla (La),2710,1403,1307
06,59,Granja de Torrehermosa,2688,1355,1333
06,60,Guareña,7404,3746,3658
06,61,Haba (La),1491,750,741
06,62,Helechosa de los Montes,812,434,378
06,63,Herrera del Duque,4060,2052,2008
06,64,Higuera de la Serena,1294,653,641
06,65,Higuera de Llerena,495,240,255
06,66,Higuera de Vargas,2360,1193,1167
06,67,Higuera la Real,2854,1416,1438
06,68,Hinojosa del Valle,616,320,296
06,69,Hornachos,3731,1905,1826
06,70,Jerez de los Caballeros,9429,4704,4725
06,71,Lapa (La),352,178,174
06,73,Llera,1037,540,497
06,74,Llerena,5730,2775,2955
06,72,Lobón,2718,1392,1326
06,75,Magacela,751,388,363
06,76,Maguilla,1171,591,580
06,77,Malcocinado,570,298,272
06,78,Malpartida de la Serena,831,427,404
06,79,Manchita,770,390,380
06,80,Medellín,2487,1248,1239
06,81,Medina de las Torres,1589,795,794
06,82,Mengabril,458,230,228
06,83,Mérida,51830,25381,26449
06,84,Mirandilla,1329,675,654
06,85,Monesterio,5120,2568,2552
06,86,Montemolín,1765,883,882
06,87,Monterrubio de la Serena,3210,1566,1644
06,88,Montijo,15480,7629,7851
06,89,Morera (La),772,383,389
06,90,Nava de Santiago (La),1173,591,582
06,91,Navalvillar de Pela,5083,2567,2516
06,92,Nogales,816,405,411
06,93,Oliva de la Frontera,6065,3035,3030
06,94,Oliva de Mérida,2052,1026,1026
06,95,Olivenza,10499,5173,5326
06,96,Orellana de la Sierra,416,211,205
06,97,Orellana la Vieja,3835,1924,1911
06,98,Palomas,708,380,328
06,99,Parra (La),1419,725,694
06,100,Peñalsordo,1672,797,875
06,101,Peraleda del Zaucejo,690,352,338
06,102,Puebla de Alcocer,1550,768,782
06,103,Puebla de la Calzada,5481,2716,2765
06,104,Puebla de la Reina,894,453,441
06,107,Puebla de Obando,2020,1022,998
06,108,Puebla de Sancho Pérez,3053,1537,1516
06,105,Puebla del Maestre,975,480,495
06,106,Puebla del Prior,602,303,299
06,109,Quintana de la Serena,5405,2711,2694
06,110,Reina,245,131,114
06,111,Rena,677,345,332
06,112,Retamal de Llerena,604,310,294
06,113,Ribera del Fresno,3443,1664,1779
06,114,Risco,249,121,128
06,115,Roca de la Sierra (La),1629,798,831
06,116,Salvaleón,2350,1188,1162
06,117,Salvatierra de los Barros,2012,998,1014
06,119,San Pedro de Mérida,798,416,382
06,123,San Vicente de Alcántara,6021,2984,3037
06,118,Sancti-Spíritus,373,171,202
06,120,Santa Amalia,4347,2174,2173
06,121,Santa Marta,4084,2030,2054
06,122,Santos de Maimona (Los),8004,3994,4010
06,124,Segura de León,2325,1156,1169
06,125,Siruela,2509,1232,1277
06,126,Solana de los Barros,2877,1454,1423
06,127,Talarrubias,3751,1851,1900
06,128,Talavera la Real,5288,2684,2604
06,129,Táliga,773,397,376
06,130,Tamurejo,286,143,143
06,131,Torre de Miguel Sesmero,1275,626,649
06,132,Torremayor,1131,561,570
06,133,Torremejía,2017,1018,999
06,134,Trasierra,702,372,330
06,135,Trujillanos,1257,654,603
06,136,Usagre,2123,1074,1049
06,137,Valdecaballeros,1449,720,729
06,901,Valdelacalzada,2580,1333,1247
06,138,Valdetorres,1385,703,682
06,139,Valencia de las Torres,878,440,438
06,140,Valencia del Mombuey,874,429,445
06,141,Valencia del Ventoso,2445,1211,1234
06,146,Valle de la Serena,1662,813,849
06,147,Valle de Matamoros,540,261,279
06,148,Valle de Santa Ana,1288,655,633
06,142,Valverde de Burguillos,405,207,198
06,143,Valverde de Leganés,3705,1886,1819
06,144,Valverde de Llerena,885,438,447
06,145,Valverde de Mérida,1124,569,555
06,149,Villafranca de los Barros,12391,6085,6306
06,150,Villagarcía de la Torre,1056,538,518
06,151,Villagonzalo,1515,734,781
06,152,Villalba de los Barros,1748,897,851
06,153,Villanueva de la Serena,23833,11746,12087
06,154,Villanueva del Fresno,3449,1735,1714
06,156,Villar de Rena,1737,916,821
06,155,Villar del Rey,2347,1211,1136
06,157,Villarta de los Montes,740,369,371
06,158,Zafra,14884,7148,7736
06,159,Zahínos,3211,1608,1603
06,160,Zalamea de la Serena,5063,2502,2561
06,162,Zarza (La),3688,1858,1830
06,161,Zarza-Capilla,545,283,262
07,2,Alaior,6705,3320,3385
07,1,Alaró,3840,1836,2004
07,3,Alcúdia,10284,5169,5115
07,4,Algaida,3461,1716,1745
07,5,Andraitx,8098,4044,4054
07,901,Ariany,801,372,429
07,6,Artà,5971,2969,3002
07,7,Bañalbufar,520,266,254
07,8,Binissalem,4885,2366,2519
07,9,Búger,926,458,468
07,10,Bunyola,4332,2151,2181
07,11,Calvià,28748,14402,14346
07,12,Campanet,2255,1104,1151
07,13,Campos,6735,3339,3396
07,14,Capdepera,6321,3155,3166
07,64,Castell (Es),5720,2849,2871
07,15,Ciutadella de Menorca,21296,10603,10693
07,16,Consell,2172,1062,1110
07,17,Costitx,824,405,419
07,18,Deyá,583,296,287
07,26,Eivissa,29447,14597,14850
07,19,Escorca,302,163,139
07,20,Esporles,3507,1727,1780
07,21,Estellenchs,354,181,173
07,22,Felanitx,14123,6986,7137
07,23,Ferreries,3828,1998,1830
07,24,Formentera,5353,2697,2656
07,25,Fornalutx,507,249,258
07,27,Inca,21129,10348,10781
07,28,Lloret de Vista Alegre,818,406,412
07,29,Lloseta,4544,2250,2294
07,30,Llubí,1904,925,979
07,31,Llucmajor,20474,10141,10333
07,32,Mahón,21884,10648,11236
07,33,Manacor,30018,14888,15130
07,34,Mancor de la Vall,903,439,464
07,35,María de la Salud,1763,864,899
07,36,Marratxí,16180,8112,8068
07,37,Mercadal (Es),2572,1281,1291
07,902,Migjorn Gran (Es),1076,550,526
07,38,Montuïri,2190,1070,1120
07,39,Muro,6060,2988,3072
07,40,Palma de Mallorca,304250,147128,157122
07,41,Petra,2592,1261,1331
07,44,Pobla (Sa),10213,5272,4941
07,42,Pollença,12945,6430,6515
07,43,Porreres,4217,2099,2118
07,45,Puigpunyent,1084,535,549
07,59,Salines (Ses),3009,1521,1488
07,48,San José,11841,6051,5790
07,46,Sant Antoni de Portmany,14292,7165,7127
07,49,Sant Joan,1655,813,842
07,50,Sant Joan de Labritja,3835,1938,1897
07,51,Sant Llorenç des Cardassar,5282,2614,2668
07,52,Sant Lluís,3928,1977,1951
07,53,Santa Eugènia,1033,514,519
07,54,Santa Eulalia del Río,19452,9795,9657
07,55,Santa Margalida,6789,3345,3444
07,56,Santa María del Camí,4394,2176,2218
07,57,Santanyí,7702,3862,3840
07,58,Selva,2901,1420,1481
07,47,Sencelles,1896,960,936
07,60,Sineu,2568,1268,1300
07,61,Sóller,10515,5165,5350
07,62,Son Servera,6872,3403,3469
07,63,Valldemosa,1511,719,792
07,65,Vilafranca de Bonany,2190,1070,1120
08,1,Abrera,7003,3593,3410
08,2,Aguilar de Segarra,206,100,106
08,14,Aiguafreda,2090,1019,1071
08,3,Alella,7696,3768,3928
08,4,Alpens,256,139,117
08,5,Ametlla del Vallès (L'),4771,2328,2443
08,6,Arenys de Mar,11827,5672,6155
08,7,Arenys de Munt,5483,2697,2786
08,8,Argençola,163,84,79
08,9,Argentona,8676,4316,4360
08,10,Artés,4308,2133,2175
08,11,Avià,1810,912,898
08,12,Avinyó,2003,989,1014
08,13,Avinyonet del Penedès,1185,615,570
08,15,Badalona,210987,104191,106796
08,904,Badia del Vallès,17058,8596,8462
08,16,Bagà,2114,1020,1094
08,17,Balenyà,3025,1514,1511
08,18,Balsareny,3304,1622,1682
08,252,Barberà del Vallès,25484,12835,12649
08,19,Barcelona,1508805,704977,803828
08,20,Begues,3105,1581,1524
08,21,Bellprat,87,48,39
08,22,Berga,14207,6933,7274
08,23,Bigues i Riells,3969,2036,1933
08,24,Borredà,471,223,248
08,25,Bruc (El),876,447,429
08,26,Brull (El),196,105,91
08,27,Cabanyes (Les),468,253,215
08,29,Cabrera de Mar,3417,1730,1687
08,28,Cabrera d'Igualada,341,189,152
08,30,Cabrils,3756,1805,1951
08,31,Calaf,3148,1541,1607
08,34,Calders,647,339,308
08,33,Caldes de Montbui,12788,6299,6489
08,32,Caldes d'Estrac,1751,837,914
08,35,Calella,11687,5521,6166
08,37,Calldetenes,1802,912,890
08,38,Callús,1345,660,685
08,36,Calonge de Segarra,185,100,85
08,39,Campins,242,114,128
08,40,Canet de Mar,9455,4611,4844
08,41,Canovelles,13287,6668,6619
08,42,Cànoves i Samalús,1552,787,765
08,43,Canyelles,1291,689,602
08,44,Capellades,5021,2442,2579
08,45,Capolat,69,40,29
08,46,Cardedeu,10805,5373,5432
08,47,Cardona,5882,2849,3033
08,48,Carme,685,353,332
08,49,Casserres,1612,773,839
08,57,Castell de l'Areny,52,32,20
08,52,Castellar de n'Hug,172,88,84
08,50,Castellar del Riu,91,53,38
08,51,Castellar del Vallès,15845,7906,7939
08,53,Castellbell i el Vilar,2789,1381,1408
08,54,Castellbisbal,6271,3221,3050
08,55,Castellcir,307,168,139
08,56,Castelldefels,38509,19188,19321
08,58,Castellet i la Gornal,1241,622,619
08,60,Castellfollit de Riubregós,238,116,122
08,59,Castellfollit del Boix,337,168,169
08,61,Castellgalí,782,398,384
08,62,Castellnou de Bages,378,200,178
08,63,Castellolí,424,218,206
08,64,Castellterçol,1970,956,1014
08,65,Castellví de la Marca,1461,741,720
08,66,Castellví de Rosanes,933,478,455
08,67,Centelles,5771,2846,2925
08,268,Cercs,1496,730,766
08,266,Cerdanyola del Vallès,50503,25310,25193
08,68,Cervelló,7069,3549,3520
08,69,Collbató,1566,842,724
08,70,Collsuspina,246,126,120
08,71,Copons,265,129,136
08,72,Corbera de Llobregat,7600,3844,3756
08,73,Cornellà de Llobregat,82490,40558,41932
08,74,Cubelles,4715,2144,2571
08,75,Dosrius,2269,1192,1077
08,76,Esparreguera,14501,7262,7239
08,77,Esplugues de Llobregat,46810,23092,23718
08,78,Espunyola (L'),283,146,137
08,79,Estany (L'),382,184,198
08,134,Figaró-Montmany,763,388,375
08,80,Fígols,53,30,23
08,81,Fogars de Montclús,313,165,148
08,82,Fogars de Tordera,573,297,276
08,83,Folgueroles,1322,657,665
08,84,Fonollosa,816,410,406
08,85,Font-rubí,1186,612,574
08,86,Franqueses del Vallès (Les),10810,5426,5384
08,90,Gaià,160,86,74
08,87,Gallifa,150,82,68
08,88,Garriga (La),10476,5059,5417
08,89,Gavà,37985,18925,19060
08,91,Gelida,3903,1917,1986
08,92,Gironella,5037,2446,2591
08,93,Gisclareny,30,16,14
08,94,Granada (La),1299,626,673
08,95,Granera,57,35,22
08,96,Granollers,50951,24894,26057
08,97,Gualba,685,352,333
08,99,Guardiola de Berguedà,1014,508,506
08,100,Gurb,1823,928,895
08,101,Hospitalet de Llobregat (L'),255050,124948,130102
08,162,Hostalets de Pierola (Els),1138,581,557
08,102,Igualada,32512,15737,16775
08,103,Jorba,561,269,292
08,104,Llacuna (La),842,436,406
08,105,Llagosta (La),11264,5574,5690
08,107,Lliçà d'Amunt,7668,3965,3703
08,108,Lliçà de Vall,4513,2310,2203
08,106,Llinars del Vallès,6040,3109,2931
08,109,Lluçà,272,148,124
08,110,Malgrat de Mar,12707,6276,6431
08,111,Malla,255,125,130
08,112,Manlleu,17035,8431,8604
08,113,Manresa,64385,30926,33459
08,242,Marganell,215,93,122
08,114,Martorell,17822,8905,8917
08,115,Martorelles,4937,2504,2433
08,116,Masies de Roda (Les),637,314,323
08,117,Masies de Voltregà (Les),2585,1272,1313
08,118,Masnou (El),20387,9829,10558
08,119,Masquefa,3369,1687,1682
08,120,Matadepera,6082,3065,3017
08,121,Mataró,102018,49976,52042
08,122,Mediona,1248,640,608
08,138,Moià,3806,1870,1936
08,123,Molins de Rei,18752,9231,9521
08,124,Mollet del Vallès,41911,20935,20976
08,128,Monistrol de Calders,597,294,303
08,127,Monistrol de Montserrat,2508,1267,1241
08,125,Montcada i Reixac,27068,13413,13655
08,130,Montclar,128,65,63
08,131,Montesquiu,850,422,428
08,126,Montgat,7659,3750,3909
08,132,Montmajor,499,254,245
08,133,Montmaneu,217,119,98
08,135,Montmeló,7675,3790,3885
08,136,Montornès del Vallès,11970,6001,5969
08,137,Montseny,286,152,134
08,129,Muntanyola,242,131,111
08,139,Mura,218,116,102
08,140,Navarcles,5225,2579,2646
08,141,Navàs,5812,2871,2941
08,142,Nou de Berguedà (La),155,84,71
08,143,Odena,2656,1327,1329
08,145,Olèrdola,1893,967,926
08,146,Olesa de Bonesvalls,719,377,342
08,147,Olesa de Montserrat,15797,7907,7890
08,148,Olivella,954,519,435
08,149,Olost,1204,590,614
08,144,Olvan,950,460,490
08,150,Orís,230,118,112
08,151,Oristà,665,329,336
08,152,Orpí,149,78,71
08,153,Orrius,420,217,203
08,154,Pacs del Penedès,620,314,306
08,155,Palafolls,4069,2025,2044
08,156,Palau de Plegamans,9689,4936,4753
08,157,Pallejà,6846,3414,3432
08,158,Papiol (El),3434,1691,1743
08,159,Parets del Vallès,12601,6361,6240
08,160,Perafita,319,160,159
08,161,Piera,7574,3836,3738
08,163,Pineda de Mar,17884,8891,8993
08,164,Pla del Penedès (El),953,475,478
08,165,Pobla de Claramunt (La),1687,851,836
08,166,Pobla de Lillet (La),1566,765,801
08,167,Polinyà,3956,2030,1926
08,182,Pont de Vilomara i Rocafort (El),2396,1206,1190
08,168,Pontons,291,154,137
08,169,Prat de Llobregat (El),63255,31558,31697
08,171,Prats de Lluçanès,2790,1374,1416
08,170,Prats de Rei (Els),552,273,279
08,230,Premià de Dalt,7774,3899,3875
08,172,Premià de Mar,24420,12205,12215
08,174,Puigdàlber,319,146,173
08,175,Puig-reig,4578,2210,2368
08,176,Pujalt,179,91,88
08,177,Quar (La),56,29,27
08,178,Rajadell,336,179,157
08,179,Rellinars,326,164,162
08,180,Ripollet,28903,14458,14445
08,181,Roca del Vallès (La),6728,3360,3368
08,183,Roda de Ter,5002,2411,2591
08,184,Rubí,54085,27058,27027
08,185,Rubió,121,62,59
08,901,Rupit i Pruit,357,179,178
08,187,Sabadell,185798,90347,95451
08,188,Sagàs,162,85,77
08,190,Saldes,348,193,155
08,191,Sallent,7360,3553,3807
08,194,Sant Adrià de Besòs,33361,16475,16886
08,195,Sant Agustí de Lluçanès,105,54,51
08,196,Sant Andreu de la Barca,18332,9347,8985
08,197,Sant Andreu de Llavaneres,6194,3074,3120
08,198,Sant Antoni de Vilamajor,2822,1391,1431
08,199,Sant Bartomeu del Grau,1215,649,566
08,200,Sant Boi de Llobregat,78005,38883,39122
08,201,Sant Boi de Lluçanès,565,274,291
08,203,Sant Cebrià de Vallalta,1322,719,603
08,202,Sant Celoni,12890,6420,6470
08,204,Sant Climent de Llobregat,2476,1220,1256
08,205,Sant Cugat del Vallès,47210,23318,23892
08,206,Sant Cugat Sesgarrigues,752,403,349
08,207,Sant Esteve de Palautordera,1282,650,632
08,208,Sant Esteve Sesrovires,4486,2497,1989
08,210,Sant Feliu de Codines,4007,1956,2051
08,211,Sant Feliu de Llobregat,35797,17647,18150
08,212,Sant Feliu Sasserra,642,319,323
08,209,Sant Fost de Campsentelles,5711,2890,2821
08,213,Sant Fruitós de Bages,5300,2643,2657
08,215,Sant Hipòlit de Voltregà,2909,1425,1484
08,193,Sant Iscle de Vallalta,712,374,338
08,216,Sant Jaume de Frontanyà,30,16,14
08,218,Sant Joan de Vilatorrada,8446,4227,4219
08,217,Sant Joan Despí,26805,13226,13579
08,903,Sant Julià de Cerdanyola,217,114,103
08,220,Sant Julià de Vilatorta,2063,1005,1058
08,221,Sant Just Desvern,13306,6408,6898
08,222,Sant Llorenç d'Hortons,1301,660,641
08,223,Sant Llorenç Savall,2037,988,1049
08,225,Sant Martí d'Albars,125,65,60
08,224,Sant Martí de Centelles,683,345,338
08,226,Sant Martí de Tous,946,469,477
08,227,Sant Martí Sarroca,2486,1261,1225
08,228,Sant Martí Sesgueioles,371,183,188
08,229,Sant Mateu de Bages,513,263,250
08,231,Sant Pere de Ribes,18695,9403,9292
08,232,Sant Pere de Riudebitlles,2144,1055,1089
08,233,Sant Pere de Torelló,2135,1021,1114
08,234,Sant Pere de Vilamajor,1882,966,916
08,189,Sant Pere Sallavinera,167,82,85
08,235,Sant Pol de Mar,2819,1421,1398
08,236,Sant Quintí de Mediona,1568,773,795
08,237,Sant Quirze de Besora,2011,987,1024
08,238,Sant Quirze del Vallès,10342,5126,5216
08,239,Sant Quirze Safaja,282,149,133
08,240,Sant Sadurní d'Anoia,9205,4586,4619
08,241,Sant Sadurní d'Osormort,74,39,35
08,98,Sant Salvador de Guardiola,1651,829,822
08,262,Sant Vicenç de Castellet,7419,3547,3872
08,264,Sant Vicenç de Montalt,2248,1120,1128
08,265,Sant Vicenç de Torelló,1725,819,906
08,263,Sant Vicenç dels Horts,22621,11363,11258
08,243,Santa Cecília de Voltregà,199,111,88
08,244,Santa Coloma de Cervelló,3358,1647,1711
08,245,Santa Coloma de Gramenet,123175,61267,61908
08,246,Santa Eugènia de Berga,1905,970,935
08,247,Santa Eulàlia de Riuprimer,845,434,411
08,248,Santa Eulàlia de Ronçana,4049,2051,1998
08,249,Santa Fe del Penedès,233,111,122
08,250,Santa Margarida de Montbui,9113,4548,4565
08,251,Santa Margarida i els Monjos,4230,2149,2081
08,253,Santa Maria de Besora,166,84,82
08,254,Santa Maria de Corcó,2038,1022,1016
08,256,Santa Maria de Martorelles,658,315,343
08,255,Santa Maria de Merlès,183,91,92
08,257,Santa Maria de Miralles,96,49,47
08,259,Santa Maria de Palautordera,5456,2739,2717
08,258,Santa Maria d'Oló,990,508,482
08,260,Santa Perpètua de Mogoda,18124,9180,8944
08,261,Santa Susanna,1453,722,731
08,192,Santpedor,5062,2482,2580
08,267,Sentmenat,5253,2606,2647
08,269,Seva,2238,1133,1105
08,270,Sitges,16801,8323,8478
08,271,Sobremunt,90,41,49
08,272,Sora,181,97,84
08,273,Subirats,2307,1162,1145
08,274,Súria,6282,3082,3200
08,276,Tagamanent,180,99,81
08,277,Talamanca,84,45,39
08,278,Taradell,4755,2349,2406
08,275,Tavèrnoles,241,114,127
08,280,Tavertet,133,67,66
08,281,Teià,4669,2370,2299
08,279,Terrassa,163862,79779,84083
08,282,Tiana,5172,2571,2601
08,283,Tona,5765,2839,2926
08,284,Tordera,8918,4497,4421
08,285,Torelló,11952,5822,6130
08,286,Torre de Claramunt (La),2011,1044,967
08,287,Torrelavit,1176,600,576
08,288,Torrelles de Foix,1603,847,756
08,289,Torrelles de Llobregat,3114,1559,1555
08,290,Ullastrell,961,490,471
08,291,Vacarisses,1711,902,809
08,292,Vallbona d'Anoia,1037,521,516
08,293,Vallcebre,274,151,123
08,294,Vallgorguina,1065,533,532
08,295,Vallirana,8407,4237,4170
08,296,Vallromanes,1079,554,525
08,297,Veciana,173,90,83
08,298,Vic,30397,14597,15800
08,299,Vilada,548,280,268
08,301,Viladecans,53235,26781,26454
08,300,Viladecavalls,4882,2445,2437
08,305,Vilafranca del Penedès,28553,13964,14589
08,306,Vilalba Sasserra,338,173,165
08,303,Vilanova de Sau,311,146,165
08,302,Vilanova del Camí,10060,5063,4997
08,902,Vilanova del Vallès,1999,1010,989
08,307,Vilanova i la Geltrú,47979,23572,24407
08,214,Vilassar de Dalt,7208,3513,3695
08,219,Vilassar de Mar,14821,7295,7526
08,304,Vilobí del Penedès,852,437,415
08,308,Viver i Serrateix,191,100,91
09,1,Abajas,37,18,19
09,3,Adrada de Haza,307,165,142
09,6,Aguas Cándidas,96,52,44
09,7,Aguilar de Bureba,97,53,44
09,9,Albillos,162,90,72
09,10,Alcocero de Mola,63,39,24
09,11,Alfoz de Bricia,146,68,78
09,907,Alfoz de Quintanadueñas,579,300,279
09,12,Alfoz de Santa Gadea,156,83,73
09,13,Altable,63,39,24
09,14,Altos (Los),245,136,109
09,16,Ameyugo,51,27,24
09,17,Anguix,162,81,81
09,18,Aranda de Duero,29222,14518,14704
09,19,Arandilla,198,113,85
09,20,Arauzo de Miel,409,223,186
09,21,Arauzo de Salce,83,48,35
09,22,Arauzo de Torre,113,60,53
09,23,Arcos,249,135,114
09,24,Arenillas de Riopisuerga,235,126,109
09,25,Arija,261,125,136
09,26,Arlanzón,439,232,207
09,27,Arraya de Oca,53,27,26
09,29,Atapuerca,202,107,95
09,30,Ausines (Los),140,78,62
09,32,Avellanosa de Muñó,175,94,81
09,33,Bahabón de Esgueva,156,89,67
09,34,Balbases (Los),390,200,190
09,35,Baños de Valdearados,512,282,230
09,36,Bañuelos de Bureba,51,31,20
09,37,Barbadillo de Herreros,168,94,74
09,38,Barbadillo del Mercado,183,105,78
09,39,Barbadillo del Pez,118,61,57
09,41,Barrio de Muñó,35,21,14
09,43,Barrios de Bureba (Los),280,148,132
09,44,Barrios de Colina,80,46,34
09,45,Basconcillos del Tozo,403,217,186
09,46,Bascuñana,74,41,33
09,47,Belbimbre,75,39,36
09,48,Belorado,2135,1076,1059
09,50,Berberana,88,44,44
09,51,Berlangas de Roa,282,147,135
09,52,Berzosa de Bureba,60,34,26
09,54,Bozoó,105,58,47
09,55,Brazacorta,112,63,49
09,56,Briviesca,6101,3016,3085
09,57,Bugedo,104,78,26
09,58,Buniel,173,96,77
09,59,Burgos,163156,78917,84239
09,60,Busto de Bureba,267,140,127
09,61,Cabañes de Esgueva,303,157,146
09,62,Cabezón de la Sierra,80,37,43
09,63,Cabia,239,124,115
09,64,Caleruega,443,233,210
09,65,Campillo de Aranda,200,108,92
09,66,Campolara,106,57,49
09,67,Canicosa de la Sierra,669,342,327
09,68,Cantabrana,61,34,27
09,70,Carazo,48,25,23
09,71,Carcedo de Bureba,46,24,22
09,72,Carcedo de Burgos,139,81,58
09,73,Cardeñadijo,467,244,223
09,74,Cardeñajimeno,353,192,161
09,75,Cardeñuela Riopico,78,38,40
09,76,Carrias,51,34,17
09,77,Cascajares de Bureba,67,36,31
09,78,Cascajares de la Sierra,25,11,14
09,79,Castellanos de Castro,71,39,32
09,83,Castil de Peones,37,17,20
09,82,Castildelgado,83,43,40
09,84,Castrillo de la Reina,311,188,123
09,85,Castrillo de la Vega,598,320,278
09,88,Castrillo de Riopisuerga,97,55,42
09,86,Castrillo del Val,347,193,154
09,90,Castrillo Matajudíos,84,43,41
09,91,Castrojeriz,1105,561,544
09,93,Cayuela,126,76,50
09,94,Cebrecos,79,46,33
09,95,Celada del Camino,92,42,50
09,98,Cerezo de Rio Tirón,818,439,379
09,100,Cerratón de Juarros,71,39,32
09,101,Ciadoncha,139,83,56
09,102,Cillaperlata,85,48,37
09,103,Cilleruelo de Abajo,369,205,164
09,104,Cilleruelo de Arriba,83,43,40
09,105,Ciruelos de Cervera,174,90,84
09,108,Cogollos,226,125,101
09,109,Condado de Treviño,852,470,382
09,110,Contreras,119,74,45
09,112,Coruña del Conde,166,92,74
09,113,Covarrubias,655,342,313
09,114,Cubillo del Campo,76,41,35
09,115,Cubo de Bureba,136,72,64
09,117,Cueva de Roa (La),122,70,52
09,119,Cuevas de San Clemente,70,33,37
09,120,Encío,58,30,28
09,122,Espinosa de Cervera,120,72,48
09,124,Espinosa de los Monteros,2303,1177,1126
09,123,Espinosa del Camino,52,27,25
09,125,Estépar,852,456,396
09,127,Fontioso,103,57,46
09,128,Frandovínez,85,47,38
09,129,Fresneda de la Sierra Tirón,107,56,51
09,130,Fresneña,123,68,55
09,131,Fresnillo de las Dueñas,305,158,147
09,132,Fresno de Río Tirón,273,158,115
09,133,Fresno de Rodilla,35,22,13
09,134,Frías,330,181,149
09,135,Fuentebureba,90,44,46
09,136,Fuentecén,307,167,140
09,137,Fuentelcésped,205,100,105
09,138,Fuentelisendo,118,58,60
09,139,Fuentemolinos,132,74,58
09,140,Fuentenebro,206,108,98
09,141,Fuentespina,589,310,279
09,143,Galbarros,32,22,10
09,144,Gallega (La),98,60,38
09,148,Grijalba,139,70,69
09,149,Grisaleña,53,32,21
09,151,Gumiel de Hizán,652,349,303
09,152,Gumiel de Mercado,406,220,186
09,154,Hacinas,225,117,108
09,155,Haza,45,22,23
09,159,Hontanas,80,43,37
09,160,Hontangas,156,88,68
09,162,Hontoria de la Cantera,127,65,62
09,164,Hontoria de Valdearados,242,149,93
09,163,Hontoria del Pinar,943,505,438
09,166,Hormazas (Las),156,85,71
09,167,Hornillos del Camino,81,46,35
09,168,Horra (La),477,249,228
09,169,Hortigüela,125,78,47
09,170,Hoyales de Roa,324,161,163
09,172,Huérmeces,159,88,71
09,173,Huerta de Arriba,197,103,94
09,174,Huerta del Rey,1203,630,573
09,175,Humada,246,140,106
09,176,Hurones,60,38,22
09,177,Ibeas de Juarros,966,529,437
09,178,Ibrillos,104,59,45
09,179,Iglesiarrubia,68,36,32
09,180,Iglesias,195,99,96
09,181,Isar,436,201,235
09,182,Itero del Castillo,127,67,60
09,183,Jaramillo de la Fuente,34,18,16
09,184,Jaramillo Quemado,19,15,4
09,189,Junta de Traslaloma,218,113,105
09,190,Junta de Villalba de Losa,97,50,47
09,191,Jurisdicción de Lara,84,48,36
09,192,Jurisdicción de San Zadornil,86,39,47
09,194,Lerma,2495,1256,1239
09,195,Llano de Bureba,68,40,28
09,196,Madrigal del Monte,191,102,89
09,197,Madrigalejo del Monte,175,95,80
09,198,Mahamud,168,84,84
09,199,Mambrilla de Castrejón,166,87,79
09,200,Mambrillas de Lara,81,42,39
09,201,Mamolar,74,38,36
09,202,Manciles,49,26,23
09,206,Mazuela,88,47,41
09,208,Mecerreyes,319,164,155
09,209,Medina de Pomar,5512,2745,2767
09,211,Melgar de Fernamental,2057,1040,1017
09,213,Merindad de Cuesta-Urria,524,292,232
09,214,Merindad de Montija,1008,555,453
09,906,Merindad de Río Ubierna,1253,658,595
09,215,Merindad de Sotoscueva,652,345,307
09,216,Merindad de Valdeporres,541,276,265
09,217,Merindad de Valdivielso,581,301,280
09,218,Milagros,457,239,218
09,219,Miranda de Ebro,35502,17591,17911
09,220,Miraveche,121,65,56
09,221,Modúbar de la Emparedada,240,134,106
09,223,Monasterio de la Sierra,37,22,15
09,224,Monasterio de Rodilla,217,120,97
09,225,Moncalvillo,134,77,57
09,226,Monterrubio de la Demanda,95,51,44
09,227,Montorio,179,91,88
09,228,Moradillo de Roa,234,123,111
09,229,Nava de Roa,295,155,140
09,230,Navas de Bureba,54,27,27
09,231,Nebreda,113,69,44
09,232,Neila,244,118,126
09,235,Olmedillo de Roa,241,124,117
09,236,Olmillos de Muñó,48,26,22
09,238,Oña,1798,915,883
09,239,Oquillas,81,42,39
09,241,Orbaneja Riopico,137,76,61
09,242,Padilla de Abajo,106,63,43
09,243,Padilla de Arriba,138,75,63
09,244,Padrones de Bureba,86,46,40
09,246,Palacios de la Sierra,919,477,442
09,247,Palacios de Riopisuerga,35,16,19
09,248,Palazuelos de la Sierra,67,34,33
09,249,Palazuelos de Muñó,75,42,33
09,250,Pampliega,433,219,214
09,251,Pancorvo,519,271,248
09,253,Pardilla,123,66,57
09,255,Partido de la Sierra en Tobalina,90,56,34
09,256,Pedrosa de Duero,607,314,293
09,259,Pedrosa de Río Urbel,301,171,130
09,257,Pedrosa del Páramo,117,66,51
09,258,Pedrosa del Príncipe,309,162,147
09,261,Peñaranda de Duero,617,329,288
09,262,Peral de Arlanza,279,142,137
09,265,Piérnigas,48,31,17
09,266,Pineda de la Sierra,129,68,61
09,267,Pineda-Trasmonte,202,106,96
09,268,Pinilla de los Barruecos,133,76,57
09,269,Pinilla de los Moros,50,33,17
09,270,Pinilla-Trasmonte,238,128,110
09,272,Poza de la Sal,389,196,193
09,273,Prádanos de Bureba,78,44,34
09,274,Pradoluengo,1746,851,895
09,275,Presencio,286,151,135
09,276,Puebla de Arganzón (La),265,145,120
09,277,Puentedura,133,70,63
09,279,Quemada,263,148,115
09,281,Quintana del Pidio,192,102,90
09,280,Quintanabureba,38,21,17
09,283,Quintanaélez,124,63,61
09,287,Quintanaortuño,109,55,54
09,288,Quintanapalla,126,67,59
09,289,Quintanar de la Sierra,2220,1145,1075
09,292,Quintanavides,86,39,47
09,294,Quintanilla de la Mata,177,99,78
09,295,Quintanilla del Coco,129,67,62
09,298,Quintanilla San García,120,58,62
09,301,Quintanilla Vivar,369,185,184
09,297,Quintanillas (Las),356,194,162
09,901,Quintanilla-Tordueles,620,327,293
09,302,Rabanera del Pinar,146,79,67
09,303,Rábanos,97,58,39
09,304,Rabé de las Calzadas,177,93,84
09,306,Rebolledo de la Torre,176,94,82
09,307,Redecilla del Camino,156,91,65
09,308,Redecilla del Campo,105,55,50
09,309,Regumiel de la Sierra,513,258,255
09,310,Reinoso,26,18,8
09,311,Retuerta,77,43,34
09,312,Revilla (La),130,71,59
09,314,Revilla del Campo,140,70,70
09,315,Revillarruz,148,72,76
09,316,Revilla-Vallegera,183,103,80
09,317,Rezmondo,26,11,15
09,318,Riocavado de la Sierra,76,41,35
09,321,Roa,2329,1192,1137
09,323,Rojas,108,60,48
09,325,Royuela de Río Franco,354,195,159
09,326,Rubena,157,78,79
09,327,Rublacedo de Abajo,42,21,21
09,328,Rucandio,123,62,61
09,329,Salas de Bureba,182,100,82
09,330,Salas de los Infantes,2076,1036,1040
09,332,Saldaña de Burgos,104,57,47
09,334,Salinillas de Bureba,73,40,33
09,335,San Adrián de Juarros,44,20,24
09,337,San Juan del Monte,167,91,76
09,338,San Mamés de Burgos,168,95,73
09,339,San Martín de Rubiales,280,149,131
09,340,San Millán de Lara,88,53,35
09,360,San Vicente del Valle,39,25,14
09,343,Santa Cecilia,139,78,61
09,345,Santa Cruz de la Salceda,209,111,98
09,346,Santa Cruz del Valle Urbión,133,81,52
09,347,Santa Gadea del Cid,198,105,93
09,348,Santa Inés,207,107,100
09,350,Santa María del Campo,730,370,360
09,351,Santa María del Invierno,54,31,23
09,352,Santa María del Mercadillo,210,124,86
09,353,Santa María Rivarredonda,144,77,67
09,354,Santa Olalla de Bureba,37,19,18
09,355,Santibáñez de Esgueva,187,95,92
09,356,Santibáñez del Val,64,38,26
09,358,Santo Domingo de Silos,323,200,123
09,361,Sargentes de la Lora,197,104,93
09,362,Sarracín,150,86,64
09,363,Sasamón,1593,867,726
09,365,Sequera de Haza (La),70,39,31
09,366,Solarana,120,66,54
09,368,Sordillos,35,22,13
09,369,Sotillo de la Ribera,626,344,282
09,372,Sotragero,157,84,73
09,373,Sotresgudo,800,424,376
09,374,Susinos del Páramo,105,57,48
09,375,Tamarón,49,29,20
09,377,Tardajos,712,389,323
09,378,Tejada,55,32,23
09,380,Terradillos de Esgueva,134,67,67
09,381,Tinieblas de la Sierra,39,20,19
09,382,Tobar,49,27,22
09,384,Tordómar,425,233,192
09,386,Torrecilla del Monte,77,44,33
09,387,Torregalindo,157,88,69
09,388,Torrelara,33,15,18
09,389,Torrepadre,165,90,75
09,390,Torresandino,830,450,380
09,391,Tórtoles de Esgueva,580,314,266
09,392,Tosantos,80,40,40
09,394,Trespaderne,1170,619,551
09,395,Tubilla del Agua,168,103,65
09,396,Tubilla del Lago,221,119,102
09,398,Urbel del Castillo,103,57,46
09,400,Vadocondes,484,252,232
09,403,Valdeande,179,103,76
09,405,Valdezate,210,109,101
09,406,Valdorros,124,73,51
09,408,Vallarta de Bureba,76,44,32
09,904,Valle de las Navas,635,355,280
09,908,Valle de Losa,722,414,308
09,409,Valle de Manzanedo,126,64,62
09,410,Valle de Mena,3472,1773,1699
09,411,Valle de Oca,221,109,112
09,902,Valle de Santibáñez,659,336,323
09,905,Valle de Sedano,530,285,245
09,412,Valle de Tobalina,1096,577,519
09,413,Valle de Valdebezana,808,440,368
09,414,Valle de Valdelaguna,258,137,121
09,415,Valle de Valdelucio,388,207,181
09,416,Valle de Zamanzas,85,50,35
09,417,Vallegera,59,31,28
09,418,Valles de Palenzuela,114,59,55
09,419,Valluércanes,133,75,58
09,407,Valmala,35,16,19
09,422,Vid de Bureba (La),44,23,21
09,421,Vid y Barrios (La),353,202,151
09,423,Vileña,46,28,18
09,427,Villadiego,2090,1133,957
09,428,Villaescusa de Roa,182,98,84
09,429,Villaescusa la Sombría,59,36,23
09,430,Villaespasa,33,17,16
09,431,Villafranca Montes de Oca,211,111,100
09,432,Villafruela,318,178,140
09,433,Villagalijo,82,46,36
09,434,Villagonzalo Pedernales,658,333,325
09,437,Villahoz,434,218,216
09,438,Villalba de Duero,561,309,252
09,439,Villalbilla de Burgos,651,344,307
09,440,Villalbilla de Gumiel,144,81,63
09,441,Villaldemiro,97,44,53
09,442,Villalmanzo,490,259,231
09,443,Villamayor de los Montes,268,129,139
09,444,Villamayor de Treviño,116,66,50
09,445,Villambistia,82,47,35
09,446,Villamedianilla,29,15,14
09,447,Villamiel de la Sierra,39,22,17
09,448,Villangómez,347,185,162
09,449,Villanueva de Argaño,117,62,55
09,450,Villanueva de Carazo,24,15,9
09,451,Villanueva de Gumiel,313,161,152
09,454,Villanueva de Teba,78,43,35
09,455,Villaquirán de la Puebla,78,44,34
09,456,Villaquirán de los Infantes,222,114,108
09,903,Villarcayo de Merindad de Castilla la Vieja,3934,1973,1961
09,458,Villariezo,169,89,80
09,460,Villasandino,275,136,139
09,463,Villasur de Herreros,322,178,144
09,464,Villatuelda,77,42,35
09,466,Villaverde del Monte,207,111,96
09,467,Villaverde-Mogina,139,85,54
09,471,Villayerno Morquillas,141,72,69
09,472,Villazopeque,100,55,45
09,473,Villegas,135,75,60
09,476,Villoruebo,54,34,20
09,424,Viloria de Rioja,71,39,32
09,425,Vilviestre del Pinar,810,415,395
09,478,Vizcaínos,72,38,34
09,480,Zael,156,82,74
09,482,Zarzosa de Río Pisuerga,66,37,29
09,483,Zazuar,287,148,139
09,485,Zuñeda,88,44,44
10,1,Abadía,283,160,123
10,2,Abertura,519,277,242
10,3,Acebo,831,438,393
10,4,Acehuche,1007,504,503
10,5,Aceituna,739,375,364
10,6,Ahigal,1666,858,808
10,7,Albalá del Caudillo,890,436,454
10,8,Alcántara,1876,961,915
10,9,Alcollarín,382,181,201
10,10,Alcuéscar,3144,1635,1509
10,13,Aldea de Trujillo,429,224,205
10,12,Aldea del Cano,762,372,390
10,11,Aldeacentenera,1017,506,511
10,14,Aldeanueva de la Vera,2584,1287,1297
10,15,Aldeanueva del Camino,935,451,484
10,16,Aldehuela del Jerte,392,224,168
10,17,Alía,1454,720,734
10,18,Aliseda,2414,1208,1206
10,19,Almaraz,1439,738,701
10,20,Almoharín,2047,1016,1031
10,21,Arroyo de la Luz,6645,3329,3316
10,23,Arroyomolinos,1101,557,544
10,22,Arroyomolinos de la Vera,616,307,309
10,24,Baños de Montemayor,716,327,389
10,25,Barrado,578,296,282
10,26,Belvís de Monroy,619,319,300
10,27,Benquerencia,105,60,45
10,28,Berrocalejo,134,59,75
10,29,Berzocana,689,346,343
10,30,Bohonal de Ibor,620,310,310
10,31,Botija,190,87,103
10,32,Brozas,2448,1223,1225
10,33,Cabañas del Castillo,612,311,301
10,34,Cabezabellosa,530,265,265
10,35,Cabezuela del Valle,2438,1262,1176
10,36,Cabrero,463,243,220
10,37,Cáceres,77768,37434,40334
10,38,Cachorrilla,105,50,55
10,39,Cadalso,621,318,303
10,40,Calzadilla,577,291,286
10,41,Caminomorisco,1298,690,608
10,42,Campillo de Deleitosa,155,76,79
10,43,Campo Lugar,1250,628,622
10,44,Cañamero,1992,1028,964
10,45,Cañaveral,1593,783,810
10,46,Carbajo,310,169,141
10,47,Carcaboso,1313,687,626
10,48,Carrascalejo,455,227,228
10,49,Casar de Cáceres,4753,2379,2374
10,50,Casar de Palomero,1411,704,707
10,51,Casares de las Hurdes,904,461,443
10,52,Casas de Don Antonio,239,111,128
10,53,Casas de Don Gómez,392,196,196
10,56,Casas de Millán,848,437,411
10,57,Casas de Miravete,169,89,80
10,54,Casas del Castañar,748,372,376
10,55,Casas del Monte,928,479,449
10,58,Casatejada,1338,673,665
10,59,Casillas de Coria,564,265,299
10,60,Castañar de Ibor,1397,705,692
10,61,Ceclavín,2284,1170,1114
10,62,Cedillo,581,299,282
10,63,Cerezo,248,116,132
10,64,Cilleros,2218,1114,1104
10,65,Collado,238,118,120
10,66,Conquista de la Sierra,204,99,105
10,67,Coria,11900,5866,6034
10,68,Cuacos de Yuste,892,470,422
10,69,Cumbre (La),1190,586,604
10,70,Deleitosa,961,474,487
10,71,Descargamaría,270,133,137
10,72,Eljas,1284,651,633
10,73,Escurial,986,493,493
10,75,Fresnedoso de Ibor,395,193,202
10,76,Galisteo,2008,1019,989
10,77,Garciaz,1056,531,525
10,78,Garganta (La),641,334,307
10,79,Garganta la Olla,1207,635,572
10,80,Gargantilla,526,270,256
10,81,Gargüera,211,107,104
10,82,Garrovillas,2557,1229,1328
10,83,Garvín,119,73,46
10,84,Gata,2013,1004,1009
10,85,Gordo (El),309,152,157
10,86,Granja (La),450,241,209
10,87,Guadalupe,2457,1218,1239
10,88,Guijo de Coria,310,160,150
10,89,Guijo de Galisteo,1841,939,902
10,90,Guijo de Granadilla,788,388,400
10,91,Guijo de Santa Bárbara,517,257,260
10,92,Herguijuela,467,229,238
10,93,Hernán-Pérez,514,269,245
10,94,Herrera de Alcántara,350,175,175
10,95,Herreruela,491,258,233
10,96,Hervás,3965,1911,2054
10,97,Higuera,127,71,56
10,98,Hinojal,460,219,241
10,99,Holguera,865,442,423
10,100,Hoyos,1038,528,510
10,101,Huélaga,213,107,106
10,102,Ibahernando,785,385,400
10,103,Jaraicejo,692,339,353
10,104,Jaraíz de la Vera,7012,3574,3438
10,105,Jarandilla de la Vera,3325,1668,1657
10,106,Jarilla,205,112,93
10,107,Jerte,1372,716,656
10,108,Ladrillar,384,209,175
10,109,Logrosán,2618,1319,1299
10,110,Losar de la Vera,3114,1589,1525
10,111,Madrigal de la Vera,1836,951,885
10,112,Madrigalejo,2317,1139,1178
10,113,Madroñera,3200,1602,1598
10,114,Majadas,1246,660,586
10,115,Malpartida de Cáceres,4338,2178,2160
10,116,Malpartida de Plasencia,4342,2112,2230
10,117,Marchagaz,401,195,206
10,118,Mata de Alcántara,401,201,200
10,119,Membrío,948,449,499
10,120,Mesas de Ibor,201,109,92
10,121,Miajadas,9907,4949,4958
10,122,Millanes,263,146,117
10,123,Mirabel,893,443,450
10,124,Mohedas de Granadilla,1169,597,572
10,125,Monroy,1278,639,639
10,126,Montánchez,2306,1141,1165
10,127,Montehermoso,5368,2701,2667
10,128,Moraleja,8273,4104,4169
10,129,Morcillo,528,266,262
10,130,Navaconcejo,2182,1101,1081
10,131,Navalmoral de la Mata,15819,7797,8022
10,132,Navalvillar de Ibor,573,289,284
10,133,Navas del Madroño,1661,837,824
10,134,Navezuelas,755,394,361
10,135,Nuñomoral,2002,1054,948
10,136,Oliva de Plasencia,340,171,169
10,137,Palomero,598,312,286
10,138,Pasarón de la Vera,730,369,361
10,139,Pedroso de Acim,149,79,70
10,140,Peraleda de la Mata,1468,734,734
10,141,Peraleda de San Román,456,226,230
10,142,Perales del Puerto,1055,520,535
10,143,Pescueza,246,120,126
10,144,Pesga (La),1295,673,622
10,145,Piedras Albas,236,111,125
10,146,Pinofranqueado,1824,973,851
10,147,Piornal,1581,787,794
10,148,Plasencia,37299,18282,19017
10,149,Plasenzuela,544,249,295
10,150,Portaje,425,205,220
10,151,Portezuelo,339,161,178
10,152,Pozuelo de Zarzón,660,324,336
10,153,Puerto de Santa Cruz,436,210,226
10,154,Rebollar,251,129,122
10,155,Riolobos,1571,831,740
10,156,Robledillo de Gata,187,93,94
10,157,Robledillo de la Vera,372,182,190
10,158,Robledillo de Trujillo,513,267,246
10,159,Robledollano,466,252,214
10,160,Romangordo,210,97,113
10,901,Rosalejo,1875,1057,818
10,161,Ruanes,105,55,50
10,162,Salorino,891,439,452
10,163,Salvatierra de Santiago,476,246,230
10,164,San Martín de Trevejo,1025,522,503
10,165,Santa Ana,406,203,203
10,166,Santa Cruz de la Sierra,387,199,188
10,167,Santa Cruz de Paniagua,478,256,222
10,168,Santa Marta de Magasca,386,194,192
10,169,Santiago de Alcántara,818,409,409
10,170,Santiago del Campo,337,175,162
10,171,Santibáñez el Alto,535,274,261
10,172,Santibáñez el Bajo,1033,536,497
10,173,Saucedilla,617,310,307
10,174,Segura de Toro,225,119,106
10,175,Serradilla,2027,1019,1008
10,176,Serrejón,523,270,253
10,177,Sierra de Fuentes,1689,830,859
10,178,Talaván,1066,522,544
10,179,Talaveruela de la Vera,492,233,259
10,180,Talayuela,7122,3978,3144
10,181,Tejeda de Tiétar,1036,560,476
10,182,Toril,213,132,81
10,183,Tornavacas,1416,744,672
10,184,Torno (El),1033,534,499
10,187,Torre de Don Miguel,718,353,365
10,188,Torre de Santa María,773,372,401
10,185,Torrecilla de los Angeles,708,359,349
10,186,Torrecillas de la Tiesa,1278,646,632
10,190,Torrejón el Rubio,743,377,366
10,189,Torrejoncillo,3671,1791,1880
10,191,Torremenga,581,296,285
10,192,Torremocha,1285,612,673
10,193,Torreorgaz,1604,814,790
10,194,Torrequemada,603,286,317
10,195,Trujillo,9315,4438,4877
10,196,Valdastillas,440,217,223
10,197,Valdecañas de Tajo,149,82,67
10,198,Valdefuentes,1606,786,820
10,199,Valdehúncar,180,86,94
10,200,Valdelacasa de Tajo,618,284,334
10,201,Valdemorales,291,144,147
10,202,Valdeobispo,853,419,434
10,203,Valencia de Alcántara,6578,3241,3337
10,204,Valverde de la Vera,594,306,288
10,205,Valverde del Fresno,2773,1403,1370
10,206,Viandar de la Vera,342,160,182
10,207,Villa del Campo,664,331,333
10,208,Villa del Rey,185,98,87
10,209,Villamesías,419,211,208
10,210,Villamiel,826,411,415
10,211,Villanueva de la Sierra,638,302,336
10,212,Villanueva de la Vera,2075,1026,1049
10,214,Villar de Plasencia,307,148,159
10,213,Villar del Pedroso,877,440,437
10,215,Villasbuenas de Gata,545,281,264
10,216,Zarza de Granadilla,1895,979,916
10,217,Zarza de Montánchez,662,335,327
10,218,Zarza la Mayor,1737,861,876
10,219,Zorita,2094,1030,1064
11,1,Alcalá de los Gazules,5689,2937,2752
11,2,Alcalá del Valle,5208,2664,2544
11,3,Algar,1906,1022,884
11,4,Algeciras,101907,50108,51799
11,5,Algodonales,5691,2929,2762
11,6,Arcos de la Frontera,28110,14074,14036
11,7,Barbate,21888,10935,10953
11,8,Barrios (Los),15507,7850,7657
11,901,Benalup,5971,3055,2916
11,9,Benaocaz,597,302,295
11,10,Bornos,8054,3988,4066
11,11,Bosque (El),1802,930,872
11,12,Cádiz,145595,70051,75544
11,13,Castellar de la Frontera,2388,1215,1173
11,15,Chiclana de la Frontera,53001,26899,26102
11,16,Chipiona,15518,7887,7631
11,14,Conil de la Frontera,16687,8445,8242
11,17,Espera,3969,2049,1920
11,18,Gastor (El),2010,1068,942
11,19,Grazalema,2298,1178,1120
11,20,Jerez de la Frontera,182269,89096,93173
11,21,Jimena de la Frontera,8999,4625,4374
11,22,Línea de la Concepción (La),59293,28749,30544
11,23,Medina-Sidonia,10750,5528,5222
11,24,Olvera,8991,4485,4506
11,25,Paterna de Rivera,5093,2627,2466
11,26,Prado del Rey,5726,2860,2866
11,27,Puerto de Santa María (El),72460,36284,36176
11,28,Puerto Real,33069,16689,16380
11,29,Puerto Serrano,6673,3441,3232
11,30,Rota,24197,12223,11974
11,31,San Fernando,85882,42429,43453
11,902,San José del Valle,4299,2196,2103
11,33,San Roque,22168,11091,11077
11,32,Sanlúcar de Barrameda,61088,30617,30471
11,34,Setenil de las Bodegas,3138,1601,1537
11,35,Tarifa,14993,7577,7416
11,36,Torre-Alháquime,1018,521,497
11,37,Trebujena,6915,3505,3410
11,38,Ubrique,18102,8949,9153
11,39,Vejer de la Frontera,12823,6505,6318
11,40,Villaluenga del Rosario,511,267,244
11,41,Villamartín,11967,6017,5950
11,42,Zahara,1542,795,747
12,2,Aín,130,68,62
12,3,Albocácer,1399,670,729
12,4,Alcalá de Chivert,4915,2469,2446
12,5,Alcora/Alcora (l'),8662,4404,4258
12,6,Alcudia de Veo,181,85,96
12,7,Alfondeguilla,922,451,471
12,8,Algimia de Almonacid,313,178,135
12,9,Almazora/Almassora,16306,8054,8252
12,10,Almedíjar,300,144,156
12,11,Almenara,5018,2471,2547
12,901,Alquerías del Niño Perdido,3508,1693,1815
12,12,Altura,3093,1545,1548
12,13,Arañuel,133,68,65
12,14,Ares del Maestre,281,134,147
12,15,Argelita,110,53,57
12,16,Artana,1909,956,953
12,1,Atzeneta del Maestrat,1486,753,733
12,17,Ayódar,221,120,101
12,18,Azuébar,375,190,185
12,20,Barracas,171,96,75
12,22,Bejís,368,203,165
12,24,Benafer,153,83,70
12,25,Benafigos,238,127,111
12,26,Benasal,1405,678,727
12,27,Benicarló,19229,9467,9762
12,28,Benicasim/Benicàssim,9913,5042,4871
12,29,Benlloch,876,448,428
12,21,Betxí,5284,2685,2599
12,31,Borriol,3129,1565,1564
12,32,Burriana,26211,12725,13486
12,33,Cabanes,2364,1159,1205
12,34,Cálig,1774,865,909
12,36,Canet lo Roig,934,450,484
12,37,Castell de Cabres,24,12,12
12,38,Castellfort,245,128,117
12,39,Castellnovo,1037,503,534
12,40,Castellón de la Plana/Castelló de la Plana,135729,66044,69685
12,41,Castillo de Villamalefa,137,69,68
12,42,Catí,912,472,440
12,43,Caudiel,712,348,364
12,44,Cervera del Maestre,746,362,384
12,52,Chert/Xert,938,457,481
12,53,Chilches,2216,1121,1095
12,55,Chodos/Xodos,161,87,74
12,56,Chóvar,398,204,194
12,45,Cinctorres,591,274,317
12,46,Cirat,302,156,146
12,48,Cortes de Arenoso,411,224,187
12,49,Costur,466,234,232
12,50,Coves de Vinromà (les),1857,933,924
12,51,Culla,844,420,424
12,57,Eslida,775,366,409
12,58,Espadilla,85,40,45
12,59,Fanzara,282,138,144
12,60,Figueroles,556,274,282
12,61,Forcall,554,271,283
12,63,Fuente la Reina,32,14,18
12,64,Fuentes de Ayódar,98,49,49
12,65,Gaibiel,217,115,102
12,67,Geldo,700,351,349
12,68,Herbés,115,55,60
12,69,Higueras,46,27,19
12,70,Jana (la),848,424,424
12,71,Jérica,1591,811,780
12,74,Llosa (la),937,470,467
12,72,Lucena del Cid,1629,795,834
12,73,Ludiente,235,116,119
12,75,Mata de Morella (la),208,101,107
12,76,Matet,151,78,73
12,77,Moncofa,3610,1818,1792
12,78,Montán,346,171,175
12,79,Montanejos,404,206,198
12,80,Morella,2797,1352,1445
12,81,Navajas,484,237,247
12,82,Nules,11493,5714,5779
12,83,Olocau del Rey,158,85,73
12,84,Onda,18680,9392,9288
12,85,Oropesa del Mar/Orpesa,2578,1322,1256
12,87,Palanques,23,14,9
12,88,Pavías,62,39,23
12,89,Peñíscola,3821,1886,1935
12,90,Pina de Montalgrao,175,91,84
12,93,Pobla de Benifassà (la),202,103,99
12,94,Pobla Tornesa (la),529,260,269
12,91,Portell de Morella,277,138,139
12,92,Puebla de Arenoso,178,91,87
12,95,Ribesalbes,1310,648,662
12,96,Rossell,1206,611,595
12,97,Sacañet,124,64,60
12,98,Salzadella (la),824,403,421
12,99,San Jorge,573,275,298
12,101,San Rafael del Río,492,251,241
12,902,Sant Joan de Moró,1669,840,829
12,100,Sant Mateu,1779,883,896
12,102,Santa Magdalena de Pulpis,728,364,364
12,103,Sarratella,109,59,50
12,104,Segorbe,7657,3703,3954
12,105,Sierra Engarcerán,1090,573,517
12,106,Soneja,1416,712,704
12,107,Sot de Ferrer,412,207,205
12,108,Sueras/Suera,568,282,286
12,109,Tales,770,365,405
12,110,Teresa,382,192,190
12,111,Tírig,575,286,289
12,112,Todolella,138,82,56
12,113,Toga,110,49,61
12,114,Torás,278,151,127
12,115,Toro (El),364,193,171
12,116,Torralba del Pinar,71,36,35
12,119,Torre d'En Besora (la),227,117,110
12,120,Torre Endoménech,260,131,129
12,117,Torreblanca,4583,2298,2285
12,118,Torrechiva,63,38,25
12,121,Traiguera,1597,822,775
12,122,Useras/Useres (les),1094,557,537
12,124,Vall d'Alba,1853,927,926
12,125,Vall de Almonacid,288,148,140
12,126,Vall d'Uixó (la),28283,13972,14311
12,123,Vallat,43,19,24
12,127,Vallibona,108,58,50
12,128,Vilafamés,1422,761,661
12,132,Vilanova d'Alcolea,669,335,334
12,134,Vilar de Canes,188,93,95
12,129,Villafranca del Cid,2740,1333,1407
12,130,Villahermosa del Río,474,262,212
12,131,Villamalur,161,88,73
12,133,Villanueva de Viver,95,50,45
12,135,Villarreal/Vila-real,39550,19619,19931
12,136,Villavieja,3413,1691,1722
12,137,Villores,72,36,36
12,138,Vinaròs,20940,10216,10724
12,139,Vistabella del Maestrazgo,475,235,240
12,140,Viver,1202,610,592
12,141,Zorita del Maestrazgo,146,72,74
12,142,Zucaina,223,128,95
13,1,Abenójar,1834,920,914
13,2,Agudo,2171,1101,1070
13,3,Alamillo,693,347,346
13,4,Albaladejo,1753,872,881
13,5,Alcázar de San Juan,25961,12652,13309
13,6,Alcoba,783,409,374
13,7,Alcolea de Calatrava,1626,814,812
13,8,Alcubillas,714,337,377
13,9,Aldea del Rey,2240,1095,1145
13,10,Alhambra,1341,680,661
13,11,Almadén,7498,3615,3883
13,12,Almadenejos,601,321,280
13,13,Almagro,8436,4078,4358
13,14,Almedina,768,377,391
13,15,Almodóvar del Campo,7727,3820,3907
13,16,Almuradiel,1042,475,567
13,17,Anchuras,455,251,204
13,18,Arenas de San Juan,1085,539,546
13,19,Argamasilla de Alba,6631,3278,3353
13,20,Argamasilla de Calatrava,5472,2765,2707
13,21,Arroba de los Montes,694,355,339
13,22,Ballesteros de Calatrava,584,288,296
13,23,Bolaños de Calatrava,10547,5244,5303
13,24,Brazatortas,1279,641,638
13,25,Cabezarados,395,208,187
13,26,Cabezarrubias del Puerto,678,347,331
13,27,Calzada de Calatrava,4934,2412,2522
13,28,Campo de Criptana,13892,6798,7094
13,29,Cañada de Calatrava,88,49,39
13,30,Caracuel de Calatrava,175,98,77
13,31,Carrión de Calatrava,2620,1293,1327
13,32,Carrizosa,1725,869,856
13,33,Castellar de Santiago,2252,1097,1155
13,38,Chillón,2438,1186,1252
13,34,Ciudad Real,59392,28110,31282
13,35,Corral de Calatrava,1328,674,654
13,36,Cortijos (Los),1100,539,561
13,37,Cózar,1373,668,705
13,39,Daimiel,16929,8250,8679
13,40,Fernancaballero,1072,512,560
13,41,Fontanarejo,400,208,192
13,42,Fuencaliente,1333,712,621
13,43,Fuenllana,337,155,182
13,44,Fuente el Fresno,3486,1719,1767
13,45,Granátula de Calatrava,1022,483,539
13,46,Guadalmez,1093,563,530
13,47,Herencia,7073,3550,3523
13,48,Hinojosas de Calatrava,805,383,422
13,49,Horcajo de los Montes,1116,554,562
13,50,Labores (Las),700,349,351
13,51,Luciana,469,240,229
13,52,Malagón,8197,4047,4150
13,53,Manzanares,18097,8838,9259
13,54,Membrilla,6642,3288,3354
13,55,Mestanza,1003,490,513
13,56,Miguelturra,8866,4400,4466
13,57,Montiel,1768,888,880
13,58,Moral de Calatrava,5194,2534,2660
13,59,Navalpino,331,162,169
13,60,Navas de Estena,451,245,206
13,61,Pedro Muñoz,7188,3580,3608
13,62,Picón,647,338,309
13,63,Piedrabuena,5181,2614,2567
13,64,Poblete,762,379,383
13,65,Porzuna,3970,1987,1983
13,66,Pozuelo de Calatrava,2515,1246,1269
13,67,Pozuelos de Calatrava (Los),597,295,302
13,68,Puebla de Don Rodrigo,1324,696,628
13,69,Puebla del Príncipe,1101,552,549
13,70,Puerto Lápice,1041,521,520
13,71,Puertollano,50772,24691,26081
13,72,Retuerta del Bullaque,1094,571,523
13,901,Robledo (El),1119,595,524
13,902,Ruidera,611,324,287
13,73,Saceruela,783,414,369
13,74,San Carlos del Valle,1260,625,635
13,75,San Lorenzo de Calatrava,324,164,160
13,76,Santa Cruz de los Cáñamos,687,346,341
13,77,Santa Cruz de Mudela,4795,2337,2458
13,78,Socuéllamos,11046,5405,5641
13,79,Solana (La),14845,7414,7431
13,80,Solana del Pino,596,304,292
13,81,Terrinches,994,482,512
13,82,Tomelloso,29586,14467,15119
13,83,Torralba de Calatrava,2993,1451,1542
13,84,Torre de Juan Abad,1521,750,771
13,85,Torrenueva,3231,1624,1607
13,86,Valdemanco del Esteras,329,164,165
13,87,Valdepeñas,26217,12662,13555
13,88,Valenzuela de Calatrava,828,408,420
13,89,Villahermosa,2766,1319,1447
13,90,Villamanrique,1707,844,863
13,91,Villamayor de Calatrava,667,332,335
13,92,Villanueva de la Fuente,2791,1376,1415
13,93,Villanueva de los Infantes,5792,2774,3018
13,94,Villanueva de San Carlos,516,260,256
13,95,Villar del Pozo,106,55,51
13,96,Villarrubia de los Ojos,9539,4746,4793
13,97,Villarta de San Juan,2997,1509,1488
13,98,Viso del Marqués,3125,1542,1583
14,1,Adamuz,4466,2241,2225
14,2,Aguilar de la Frontera,13334,6596,6738
14,3,Alcaracejos,1478,733,745
14,4,Almedinilla,2572,1279,1293
14,5,Almodóvar del Río,7237,3599,3638
14,6,Añora,1650,810,840
14,7,Baena,18736,9275,9461
14,8,Belalcázar,3943,1906,2037
14,9,Belmez,4115,1980,2135
14,10,Benamejí,4682,2338,2344
14,11,Blázquez (Los),716,363,353
14,12,Bujalance,8163,4020,4143
14,13,Cabra,20707,10085,10622
14,14,Cañete de las Torres,3420,1699,1721
14,15,Carcabuey,2887,1439,1448
14,16,Cardeña,2009,1011,998
14,17,Carlota (La),10023,5005,5018
14,18,Carpio (El),4497,2206,2291
14,19,Castro del Río,8036,3913,4123
14,20,Conquista,530,260,270
14,21,Córdoba,306248,147344,158904
14,22,Doña Mencía,5007,2491,2516
14,23,Dos Torres,2564,1259,1305
14,24,Encinas Reales,2333,1147,1186
14,25,Espejo,4065,2019,2046
14,26,Espiel,2500,1244,1256
14,27,Fernán Núñez,9442,4705,4737
14,28,Fuente la Lancha,444,224,220
14,29,Fuente Obejuna,6243,3198,3045
14,30,Fuente Palmera,9711,4892,4819
14,31,Fuente-Tójar,859,402,457
14,32,Granjuela (La),519,274,245
14,33,Guadalcázar,1161,589,572
14,34,Guijo (El),416,217,199
14,35,Hinojosa del Duque,8042,3877,4165
14,36,Hornachuelos,5006,2530,2476
14,37,Iznájar,5271,2643,2628
14,38,Lucena,34786,17272,17514
14,39,Luque,3422,1685,1737
14,40,Montalbán de Córdoba,4639,2328,2311
14,41,Montemayor,3801,1907,1894
14,42,Montilla,22949,11324,11625
14,43,Montoro,9394,4584,4810
14,44,Monturque,1937,970,967
14,45,Moriles,3765,1869,1896
14,46,Nueva Carteya,5797,2888,2909
14,47,Obejo,1494,754,740
14,48,Palenciana,1563,780,783
14,49,Palma del Río,19011,9506,9505
14,50,Pedro Abad,2889,1450,1439
14,51,Pedroche,1862,928,934
14,52,Peñarroya-Pueblonuevo,13844,6624,7220
14,53,Posadas,7107,3541,3566
14,54,Pozoblanco,16042,7720,8322
14,55,Priego de Córdoba,21732,10635,11097
14,56,Puente Genil,27472,13444,14028
14,57,Rambla (La),7199,3580,3619
14,58,Rute,10047,4944,5103
14,59,San Sebastián de los Ballesteros,837,431,406
14,61,Santa Eufemia,1204,615,589
14,60,Santaella,5854,2941,2913
14,62,Torrecampo,1436,707,729
14,63,Valenzuela,1484,704,780
14,64,Valsequillo,488,238,250
14,65,Victoria (La),1781,877,904
14,66,Villa del Río,7163,3641,3522
14,67,Villafranca de Córdoba,3777,1949,1828
14,68,Villaharta,629,313,316
14,69,Villanueva de Córdoba,10164,4960,5204
14,70,Villanueva del Duque,1895,885,1010
14,71,Villanueva del Rey,1259,654,605
14,72,Villaralto,1597,771,826
14,73,Villaviciosa de Córdoba,3911,2018,1893
14,74,Viso (El),3208,1537,1671
14,75,Zuheros,930,462,468
15,1,Abegondo,5467,2729,2738
15,2,Ames,13288,6453,6835
15,3,Aranga,2466,1231,1235
15,4,Ares,4576,2267,2309
15,5,Arteixo,20898,10457,10441
15,6,Arzúa,7014,3457,3557
15,7,Baña (A),5836,2834,3002
15,8,Bergondo,5732,2769,2963
15,9,Betanzos,12299,5790,6509
15,10,Boimorto,2722,1385,1337
15,11,Boiro,17932,8718,9214
15,12,Boqueixón,4314,2122,2192
15,13,Brión,6378,3037,3341
15,14,Cabana de Bergantiños,6009,3003,3006
15,15,Cabanas,3226,1559,1667
15,16,Camariñas,7349,3672,3677
15,17,Cambre,14972,7339,7633
15,18,Capela (A),1642,810,832
15,19,Carballo,27287,13240,14047
15,901,Cariño,5316,2600,2716
15,20,Carnota,6140,2951,3189
15,21,Carral,5184,2514,2670
15,22,Cedeira,7750,3828,3922
15,23,Cee,7352,3566,3786
15,24,Cerceda,5654,2749,2905
15,25,Cerdido,1768,854,914
15,26,Cesuras,2794,1392,1402
15,27,Coirós,1565,768,797
15,28,Corcubión,2015,984,1031
15,29,Coristanco,8416,4179,4237
15,30,Coruña (A),243785,113992,129793
15,31,Culleredo,18513,9063,9450
15,32,Curtis,4622,2265,2357
15,33,Dodro,3404,1660,1744
15,34,Dumbría,4928,2398,2530
15,35,Fene,15010,7400,7610
15,36,Ferrol,83048,38902,44146
15,37,Fisterra,5397,2719,2678
15,38,Frades,3179,1594,1585
15,39,Irixoa,1808,894,914
15,41,Laracha,10791,5304,5487
15,40,Laxe,3616,1797,1819
15,42,Lousame,4461,2169,2292
15,43,Malpica de Bergantiños,7443,3637,3806
15,44,Mañón,2072,1017,1055
15,45,Mazaricos,7010,3404,3606
15,46,Melide,8625,4267,4358
15,47,Mesía,3521,1762,1759
15,48,Miño,4817,2284,2533
15,49,Moeche,1601,769,832
15,50,Monfero,2847,1458,1389
15,51,Mugardos,6200,2979,3221
15,53,Muros,11065,5301,5764
15,52,Muxía,6634,3256,3378
15,54,Narón,31207,15076,16131
15,55,Neda,6221,3017,3204
15,56,Negreira,6707,3201,3506
15,57,Noia,14422,6941,7481
15,58,Oleiros,23057,11128,11929
15,59,Ordes,11893,5802,6091
15,60,Oroso,4537,2253,2284
15,61,Ortigueira,8893,4234,4659
15,62,Outes,9283,4480,4803
15,63,Oza dos Ríos,3263,1591,1672
15,64,Paderne,2802,1331,1471
15,65,Padrón,10066,4877,5189
15,66,Pino (O),5056,2516,2540
15,67,Pobra do Caramiñal (A),10165,4845,5320
15,68,Ponteceso,7663,3809,3854
15,69,Pontedeume,8881,4269,4612
15,70,Pontes de García Rodríguez (As),12664,6373,6291
15,71,Porto do Son,10586,5184,5402
15,72,Rianxo,12193,5987,6206
15,73,Ribeira,26572,13098,13474
15,74,Rois,5356,2566,2790
15,75,Sada,9997,4838,5159
15,76,San Sadurniño,3504,1717,1787
15,77,Santa Comba,11109,5409,5700
15,78,Santiago de Compostela,93672,43988,49684
15,79,Santiso,2324,1203,1121
15,80,Sobrado,2706,1405,1301
15,81,Somozas (As),1543,766,777
15,82,Teo,13915,6786,7129
15,83,Toques,1735,899,836
15,84,Tordoia,5334,2563,2771
15,85,Touro,5126,2507,2619
15,86,Trazo,3956,1964,1992
15,88,Val do Dubra,5174,2547,2627
15,87,Valdoviño,6736,3315,3421
15,89,Vedra,5156,2472,2684
15,91,Vilarmaior,1435,724,711
15,90,Vilasantar,1748,890,858
15,92,Vimianzo,9379,4626,4753
15,93,Zas,6508,3176,3332
16,1,Abia de la Obispalía,93,50,43
16,2,Acebrón (El),289,147,142
16,3,Alarcón,215,109,106
16,4,Albaladejo del Cuende,412,220,192
16,5,Albalate de las Nogueras,402,218,184
16,6,Albendea,197,97,100
16,7,Alberca de Záncara (La),1769,874,895
16,8,Alcalá de la Vega,166,90,76
16,9,Alcantud,136,72,64
16,10,Alcázar del Rey,279,138,141
16,11,Alcohujate,65,34,31
16,12,Alconchel de la Estrella,230,118,112
16,13,Algarra,38,18,20
16,14,Aliaguilla,885,465,420
16,15,Almarcha (La),639,316,323
16,16,Almendros,357,182,175
16,17,Almodóvar del Pinar,532,284,248
16,18,Almonacid del Marquesado,587,302,285
16,19,Altarejos,344,176,168
16,20,Arandilla del Arroyo,55,24,31
16,905,Arcas del Villar,606,301,305
16,22,Arcos de la Sierra,123,67,56
16,24,Arguisuelas,213,113,100
16,25,Arrancacepas,38,20,18
16,26,Atalaya del Cañavate,133,68,65
16,27,Barajas de Melo,719,348,371
16,29,Barchín del Hoyo,145,80,65
16,30,Bascuñana de San Pedro,37,21,16
16,31,Beamud,111,63,48
16,32,Belinchón,344,176,168
16,33,Belmonte,2539,1199,1340
16,34,Belmontejo,282,139,143
16,35,Beteta,411,201,210
16,36,Boniches,233,115,118
16,38,Buciegas,88,45,43
16,39,Buenache de Alarcón,641,328,313
16,40,Buenache de la Sierra,110,69,41
16,41,Buendía,568,279,289
16,42,Campillo de Altobuey,1687,836,851
16,43,Campillos-Paravientos,153,83,70
16,44,Campillos-Sierra,96,50,46
16,901,Campos del Paraíso,1189,559,630
16,45,Canalejas del Arroyo,333,175,158
16,46,Cañada del Hoyo,370,194,176
16,47,Cañadajuncosa,360,189,171
16,48,Cañamares,595,319,276
16,49,Cañavate (El),279,140,139
16,50,Cañaveras,424,215,209
16,51,Cañaveruelas,256,129,127
16,52,Cañete,843,414,429
16,53,Cañizares,617,326,291
16,55,Carboneras de Guadazaón,1024,545,479
16,56,Cardenete,712,365,347
16,57,Carrascosa,118,70,48
16,58,Carrascosa de Haro,162,81,81
16,60,Casas de Benítez,1121,536,585
16,61,Casas de Fernando Alonso,1370,674,696
16,62,Casas de Garcimolina,26,11,15
16,63,Casas de Guijarro,158,81,77
16,64,Casas de Haro,908,465,443
16,65,Casas de los Pinos,532,255,277
16,66,Casasimarro,3049,1562,1487
16,67,Castejón,239,120,119
16,68,Castillejo de Iniesta,205,112,93
16,70,Castillejo-Sierra,56,25,31
16,72,Castillo de Garcimuñoz,241,123,118
16,71,Castillo-Albaráñez,33,17,16
16,73,Cervera del Llano,320,157,163
16,23,Chillarón de Cuenca,307,164,143
16,81,Chumillas,47,31,16
16,74,Cierva (La),60,33,27
16,78,Cuenca,43733,20969,22764
16,79,Cueva del Hierro,45,26,19
16,82,Enguídanos,554,285,269
16,83,Fresneda de Altarejos,94,52,42
16,84,Fresneda de la Sierra,75,37,38
16,85,Frontera (La),217,109,108
16,86,Fuente de Pedro Naharro,1226,607,619
16,87,Fuentelespino de Haro,335,182,153
16,88,Fuentelespino de Moya,158,81,77
16,904,Fuentenava de Jábaga,283,149,134
16,89,Fuentes,514,271,243
16,91,Fuertescusa,127,71,56
16,92,Gabaldón,182,101,81
16,93,Garaballa,159,82,77
16,94,Gascueña,167,79,88
16,95,Graja de Campalbo,146,80,66
16,96,Graja de Iniesta,355,189,166
16,97,Henarejos,290,139,151
16,98,Herrumblar (El),782,405,377
16,99,Hinojosa (La),364,176,188
16,100,Hinojosos (Los),1129,558,571
16,101,Hito (El),246,125,121
16,102,Honrubia,1647,809,838
16,103,Hontanaya,494,245,249
16,104,Hontecillas,99,48,51
16,106,Horcajo de Santiago,3603,1788,1815
16,107,Huélamo,165,84,81
16,108,Huelves,80,36,44
16,109,Huérguina,106,51,55
16,110,Huerta de la Obispalía,155,85,70
16,111,Huerta del Marquesado,218,122,96
16,112,Huete,2337,1190,1147
16,113,Iniesta,3792,1850,1942
16,115,Laguna del Marquesado,79,43,36
16,116,Lagunaseca,114,53,61
16,117,Landete,1652,820,832
16,118,Ledaña,2018,997,1021
16,119,Leganiel,251,128,123
16,121,Majadas (Las),392,193,199
16,122,Mariana,334,169,165
16,123,Masegosa,135,71,64
16,124,Mesas (Las),2579,1322,1257
16,125,Minglanilla,2364,1196,1168
16,126,Mira,1152,585,567
16,128,Monreal del Llano,91,47,44
16,129,Montalbanejo,218,102,116
16,130,Montalbo,765,400,365
16,131,Monteagudo de las Salinas,122,70,52
16,132,Mota de Altarejos,60,37,23
16,133,Mota del Cuervo,5502,2725,2777
16,134,Motilla del Palancar,5013,2502,2511
16,135,Moya,280,153,127
16,137,Narboneta,115,60,55
16,139,Olivares de Júcar,600,302,298
16,140,Olmeda de la Cuesta,54,30,24
16,141,Olmeda del Rey,254,122,132
16,142,Olmedilla de Alarcón,218,111,107
16,143,Olmedilla de Eliz,36,19,17
16,145,Osa de la Vega,682,346,336
16,146,Pajarón,140,72,68
16,147,Pajaroncillo,98,52,46
16,148,Palomares del Campo,1038,508,530
16,149,Palomera,172,83,89
16,150,Paracuellos,160,74,86
16,151,Paredes,75,38,37
16,152,Parra de las Vegas (La),66,34,32
16,153,Pedernoso (El),1353,676,677
16,154,Pedroñeras (Las),6448,3281,3167
16,155,Peral (El),728,371,357
16,156,Peraleja (La),161,83,78
16,157,Pesquera (La),280,146,134
16,158,Picazo (El),737,365,372
16,159,Pinarejo,490,255,235
16,160,Pineda de Gigüela,171,89,82
16,161,Piqueras del Castillo,90,50,40
16,162,Portalrubio de Guadamajud,105,50,55
16,163,Portilla,100,52,48
16,165,Poyatos,119,66,53
16,166,Pozoamargo,328,154,174
16,908,Pozorrubielos de la Mancha,299,150,149
16,167,Pozorrubio de Santiago,547,260,287
16,169,Pozuelo (El),106,54,52
16,170,Priego,1025,531,494
16,171,Provencio (El),2626,1301,1325
16,172,Puebla de Almenara,580,302,278
16,173,Puebla de Don Francisco,383,189,194
16,174,Puebla del Salvador,317,170,147
16,175,Quintanar del Rey,6077,3102,2975
16,176,Rada de Haro,67,33,34
16,177,Reíllo,154,76,78
16,181,Rozalén del Monte,126,64,62
16,185,Saceda-Trasierra,95,52,43
16,186,Saelices,730,372,358
16,187,Salinas del Manzano,135,78,57
16,188,Salmeroncillos,190,98,92
16,189,Salvacañete,351,192,159
16,190,San Clemente,6568,3211,3357
16,191,San Lorenzo de la Parrilla,1536,775,761
16,192,San Martín de Boniches,111,56,55
16,193,San Pedro Palmiches,111,60,51
16,194,Santa Cruz de Moya,446,222,224
16,196,Santa María de los Llanos,867,442,425
16,195,Santa María del Campo Rus,823,407,416
16,197,Santa María del Val,127,66,61
16,198,Sisante,1823,919,904
16,199,Solera de Gabaldón,45,24,21
16,909,Sotorribas,984,484,500
16,202,Talayuelas,1197,613,584
16,203,Tarancón,11304,5557,5747
16,204,Tébar,407,223,184
16,205,Tejadillos,185,92,93
16,206,Tinajas,380,207,173
16,209,Torralba,202,101,101
16,211,Torrejoncillo del Rey,753,360,393
16,212,Torrubia del Campo,373,174,199
16,213,Torrubia del Castillo,46,23,23
16,215,Tragacete,387,206,181
16,216,Tresjuncos,546,276,270
16,217,Tribaldos,140,67,73
16,218,Uclés,300,139,161
16,219,Uña,143,69,74
16,906,Valdecolmenas (Los),137,71,66
16,224,Valdemeca,117,59,58
16,225,Valdemorillo de la Sierra,108,57,51
16,227,Valdemoro-Sierra,174,101,73
16,228,Valdeolivas,319,170,149
16,902,Valdetórtola,152,85,67
16,903,Valeras (Las),1443,716,727
16,231,Valhermoso de la Fuente,64,29,35
16,234,Valsalobre,58,29,29
16,236,Valverde de Júcar,1410,708,702
16,237,Valverdejo,154,79,75
16,238,Vara de Rey,751,371,380
16,239,Vega del Codorno,241,127,114
16,240,Vellisca,192,94,98
16,242,Villaconejos de Trabaque,544,280,264
16,243,Villaescusa de Haro,632,321,311
16,244,Villagarcía del Llano,998,495,503
16,245,Villalba de la Sierra,528,264,264
16,246,Villalba del Rey,742,382,360
16,247,Villalgordo del Marquesado,146,73,73
16,248,Villalpardo,1123,558,565
16,249,Villamayor de Santiago,2827,1403,1424
16,250,Villanueva de Guadamajud,130,65,65
16,251,Villanueva de la Jara,2475,1248,1227
16,253,Villar de Cañas,458,225,233
16,254,Villar de Domingo García,294,157,137
16,255,Villar de la Encina,242,122,120
16,263,Villar de Olalla,877,454,423
16,258,Villar del Humo,502,267,235
16,259,Villar del Infantado,49,29,20
16,910,Villar y Velasco,141,75,66
16,264,Villarejo de Fuentes,838,399,439
16,265,Villarejo de la Peñuela,36,17,19
16,266,Villarejo-Periesteban,553,280,273
16,269,Villares del Saz,748,377,371
16,270,Villarrubio,235,121,114
16,271,Villarta,813,421,392
16,272,Villas de la Ventosa,399,221,178
16,273,Villaverde y Pasaconsol,442,218,224
16,274,Víllora,262,124,138
16,275,Vindel,26,17,9
16,276,Yémeda,31,13,18
16,277,Zafra de Záncara,235,121,114
16,278,Zafrilla,139,67,72
16,279,Zarza de Tajo,278,128,150
16,280,Zarzuela,300,147,153
17,1,Agullana,619,329,290
17,2,Aiguaviva,432,215,217
17,3,Albanyà,123,64,59
17,4,Albons,513,264,249
17,6,Alp,1012,525,487
17,7,Amer,2276,1126,1150
17,8,Anglès,4785,2427,2358
17,9,Arbúcies,4317,2139,2178
17,10,Argelaguer,361,190,171
17,11,Armentera (L'),749,367,382
17,12,Avinyonet de Puigventós,473,238,235
17,15,Banyoles,14395,6989,7406
17,16,Bàscara,770,397,373
17,13,Begur,3039,1542,1497
17,18,Bellcaire d'Empordà,487,243,244
17,19,Besalú,2031,991,1040
17,20,Bescanó,2970,1493,1477
17,21,Beuda,120,65,55
17,22,Bisbal d'Empordà (La),8007,3901,4106
17,234,Biure,223,112,111
17,23,Blanes,27713,13902,13811
17,29,Boadella d'Empordà,220,109,111
17,24,Bolvir,245,118,127
17,25,Bordils,1309,642,667
17,26,Borrassà,503,246,257
17,27,Breda,3243,1651,1592
17,28,Brunyola,376,190,186
17,31,Cabanelles,227,126,101
17,30,Cabanes,770,386,384
17,32,Cadaqués,1852,895,957
17,33,Caldes de Malavella,3598,1795,1803
17,34,Calonge,5832,2898,2934
17,35,Camós,621,311,310
17,36,Campdevànol,3347,1642,1705
17,37,Campelles,127,65,62
17,38,Campllong,280,144,136
17,39,Camprodon,2308,1141,1167
17,40,Canet d'Adri,503,255,248
17,41,Cantallops,265,131,134
17,42,Capmany,394,200,194
17,44,Cassà de la Selva,7428,3674,3754
17,46,Castellfollit de la Roca,1006,485,521
17,47,Castelló d'Empúries,4830,2467,2363
17,48,Castell-Platja d'Aro,5177,2627,2550
17,189,Cellera de Ter (La),2034,994,1040
17,49,Celrà,2522,1225,1297
17,50,Cervià de Ter,657,321,336
17,51,Cistella,211,105,106
17,54,Colera,422,212,210
17,55,Colomers,212,104,108
17,57,Corçà,1151,582,569
17,56,Cornellà del Terri,1806,905,901
17,58,Crespià,213,103,110
17,901,"Cruïlles, Monells i Sant Sadurní de l'Heura",1099,540,559
17,60,Darnius,531,282,249
17,61,Das,145,79,66
17,62,Escala (L'),5266,2616,2650
17,63,Espinelves,175,92,83
17,64,Espolla,396,199,197
17,65,Esponellà,404,200,204
17,5,Far d'Empordà (El),402,200,202
17,66,Figueres,33157,16146,17011
17,67,Flaçà,851,422,429
17,68,Foixà,317,157,160
17,69,Fontanals de Cerdanya,376,186,190
17,70,Fontanilles,119,64,55
17,71,Fontcoberta,1015,520,495
17,902,Forallac,1633,793,840
17,73,Fornells de la Selva,1308,635,673
17,74,Fortià,485,232,253
17,75,Garrigàs,319,169,150
17,76,Garrigoles,149,84,65
17,77,Garriguella,666,333,333
17,78,Ger,288,153,135
17,79,Girona,70576,33883,36693
17,80,Gombrèn,241,110,131
17,81,Gualta,270,136,134
17,82,Guils de Cerdanya,304,155,149
17,83,Hostalric,2919,1445,1474
17,84,Isòvol,189,99,90
17,85,Jafre,340,174,166
17,86,Jonquera (La),2384,1185,1199
17,87,Juià,259,119,140
17,88,Lladó,498,253,245
17,89,Llagostera,5410,2722,2688
17,90,Llambilles,448,229,219
17,91,Llanars,448,232,216
17,92,Llançà,3843,1925,1918
17,93,Llers,833,427,406
17,94,Llívia,924,479,445
17,95,Lloret de Mar,16674,8266,8408
17,96,Llosses (Les),269,145,124
17,102,Maçanet de Cabrenys,641,328,313
17,103,Maçanet de la Selva,3263,1652,1611
17,97,Madremanya,182,77,105
17,98,Maià de Montcal,320,159,161
17,100,Masarac,247,122,125
17,101,Massanes,490,249,241
17,99,Meranges,70,41,29
17,105,Mieres,300,156,144
17,106,Mollet de Peralada,183,97,86
17,107,Molló,333,176,157
17,109,Montagut,771,403,368
17,110,Mont-ras,1500,789,711
17,111,Navata,685,337,348
17,112,Ogassa,245,143,102
17,114,Olot,27482,13154,14328
17,115,Ordis,283,145,138
17,116,Osor,509,276,233
17,117,Palafrugell,17303,8664,8639
17,118,Palamós,14239,6984,7255
17,119,Palau de Santa Eulàlia,94,52,42
17,121,Palau-sator,286,142,144
17,120,Palau-saverdera,753,383,370
17,123,Palol de Revardit,365,186,179
17,124,Pals,1770,899,871
17,125,Pardines,139,70,69
17,126,Parlavà,337,176,161
17,128,Pau,393,190,203
17,129,Pedret i Marzà,112,55,57
17,130,Pera (La),355,188,167
17,132,Peralada,1147,597,550
17,133,Planes d'Hostoles (Les),1743,860,883
17,134,Planoles,265,138,127
17,135,Pont de Molins,432,224,208
17,136,Pontós,216,121,95
17,137,Porqueres,3279,1645,1634
17,140,Port de la Selva (El),813,390,423
17,138,Portbou,1614,808,806
17,139,Preses (Les),1327,645,682
17,141,Puigcerdà,6356,3157,3199
17,142,Quart,2123,1080,1043
17,43,Queralbs,192,106,86
17,143,Rabós,148,72,76
17,144,Regencós,278,154,124
17,145,Ribes de Freser,2156,1051,1105
17,146,Riells i Viabrea,1429,740,689
17,147,Ripoll,10908,5296,5612
17,148,Riudarenes,1215,610,605
17,149,Riudaura,389,196,193
17,150,Riudellots de la Selva,1465,743,722
17,151,Riumors,198,96,102
17,152,Roses,11483,5769,5714
17,153,Rupià,184,99,85
17,154,Sales de Llierca,66,39,27
17,155,Salt,21519,10625,10894
17,157,Sant Andreu Salou,146,74,72
17,183,Sant Aniol de Finestres,251,134,117
17,158,Sant Climent Sescebes,398,202,196
17,159,Sant Feliu de Buixalleu,672,357,315
17,160,Sant Feliu de Guíxols,17779,8665,9114
17,161,Sant Feliu de Pallerols,1101,535,566
17,162,Sant Ferriol,188,105,83
17,163,Sant Gregori,2130,1111,1019
17,164,Sant Hilari Sacalm,5064,2549,2515
17,165,Sant Jaume de Llierca,761,378,383
17,167,Sant Joan de les Abadesses,3794,1855,1939
17,168,Sant Joan de Mollet,367,179,188
17,185,Sant Joan les Fonts,2745,1362,1383
17,166,Sant Jordi Desvalls,588,296,292
17,169,Sant Julià de Ramis,1942,982,960
17,903,Sant Julià del Llor i Bonmatí,914,453,461
17,171,Sant Llorenç de la Muga,131,66,65
17,172,Sant Martí de Llémena,372,190,182
17,173,Sant Martí Vell,185,95,90
17,174,Sant Miquel de Campmajor,208,113,95
17,175,Sant Miquel de Fluvià,576,294,282
17,176,Sant Mori,142,69,73
17,177,Sant Pau de Segúries,648,322,326
17,178,Sant Pere Pescador,1330,717,613
17,180,Santa Coloma de Farners,8404,4254,4150
17,181,Santa Cristina d'Aro,2443,1273,1170
17,182,Santa Llogaia d'Alguema,301,156,145
17,184,Santa Pau,1445,730,715
17,186,Sarrià de Ter,3032,1486,1546
17,187,Saus,703,350,353
17,188,Selva de Mar (La),182,91,91
17,190,Serinyà,776,395,381
17,191,Serra de Daró,174,85,89
17,192,Setcases,160,81,79
17,193,Sils,2724,1382,1342
17,52,Siurana,153,73,80
17,194,Susqueda,87,51,36
17,195,Tallada d'Empordà (La),327,169,158
17,196,Terrades,192,90,102
17,197,Torrent,176,89,87
17,198,Torroella de Fluvià,316,172,144
17,199,Torroella de Montgrí,7726,3898,3828
17,200,Tortellà,683,349,334
17,201,Toses,139,85,54
17,202,Tossa de Mar,3853,1904,1949
17,204,Ullà,787,403,384
17,205,Ullastret,243,128,115
17,203,Ultramort,188,101,87
17,206,Urús,141,71,70
17,14,Vajol (La),84,46,38
17,208,Vall de Bianya (La),1076,524,552
17,207,Vall d'en Bas (La),2542,1293,1249
17,170,Vallfogona de Ripollès,230,117,113
17,209,Vall-llobrega,295,153,142
17,210,Ventalló,547,286,261
17,211,Verges,1090,542,548
17,212,Vidrà,172,86,86
17,213,Vidreres,4095,2036,2059
17,214,Vilabertran,795,395,400
17,215,Vilablareix,1323,653,670
17,217,Viladamat,401,204,197
17,216,Viladasens,182,97,85
17,218,Vilademuls,751,378,373
17,220,Viladrau,866,440,426
17,221,Vilafant,3467,1715,1752
17,223,Vilajuïga,856,425,431
17,224,Vilallonga de Ter,416,222,194
17,225,Vilamacolum,252,121,131
17,226,Vilamalla,606,308,298
17,227,Vilamaniscle,128,67,61
17,228,Vilanant,271,139,132
17,230,Vila-sacra,351,165,186
17,222,Vilaür,117,57,60
17,233,Vilobí d'Onyar,2141,1116,1025
17,232,Vilopriu,161,80,81
18,1,Agrón,440,228,212
18,2,Alamedilla,1007,508,499
18,3,Albolote,12455,6259,6196
18,4,Albondón,1192,588,604
18,5,Albuñán,509,256,253
18,6,Albuñol,5566,2782,2784
18,7,Albuñuelas,1329,678,651
18,10,Aldeire,788,400,388
18,11,Alfacar,4211,2138,2073
18,12,Algarinejo,5323,2721,2602
18,13,Alhama de Granada,5983,3010,2973
18,14,Alhendín,4107,2061,2046
18,15,Alicún de Ortega,783,406,377
18,16,Almegíjar,430,217,213
18,17,Almuñécar,21472,10561,10911
18,904,Alpujarra de la Sierra,1219,619,600
18,18,Alquife,1018,507,511
18,20,Arenas del Rey,2065,1064,1001
18,21,Armilla,12859,6343,6516
18,22,Atarfe,10516,5166,5350
18,23,Baza,20685,10140,10545
18,24,Beas de Granada,1007,524,483
18,25,Beas de Guadix,397,210,187
18,27,Benalúa de Guadix,3357,1683,1674
18,28,Benalúa de las Villas,1394,691,703
18,29,Benamaurel,2507,1283,1224
18,30,Bérchules,871,463,408
18,32,Bubión,393,191,202
18,33,Busquístar,378,205,173
18,34,Cacín,835,423,412
18,35,Cádiar,1754,909,845
18,36,Cájar,2768,1307,1461
18,114,Calahorra (La),957,473,484
18,37,Calicasas,624,317,307
18,38,Campotéjar,1440,728,712
18,39,Caniles,5303,2598,2705
18,40,Cáñar,314,150,164
18,42,Capileira,572,279,293
18,43,Carataunas,203,105,98
18,44,Cástaras,328,168,160
18,45,Castilléjar,2120,1055,1065
18,46,Castril,3067,1570,1497
18,47,Cenes de la Vega,4006,2037,1969
18,59,Chauchina,3969,1959,2010
18,61,Chimeneas,1549,777,772
18,62,Churriana de la Vega,6458,3191,3267
18,48,Cijuela,1495,739,756
18,49,Cogollos de Guadix,798,418,380
18,50,Cogollos Vega,2035,1027,1008
18,51,Colomera,1708,874,834
18,53,Cortes de Baza,3059,1565,1494
18,54,Cortes y Graena,1026,521,505
18,912,Cuevas del Campo,2314,1143,1171
18,56,Cúllar,5229,2602,2627
18,57,Cúllar Vega,2656,1319,1337
18,63,Darro,1628,799,829
18,64,Dehesas de Guadix,713,358,355
18,66,Deifontes,2539,1267,1272
18,67,Diezma,981,518,463
18,68,Dílar,1555,772,783
18,69,Dólar,645,318,327
18,70,Dúdar,289,147,142
18,71,Dúrcal,6062,3002,3060
18,72,Escúzar,886,450,436
18,74,Ferreira,398,181,217
18,76,Fonelas,1306,656,650
18,78,Freila,1133,572,561
18,79,Fuente Vaqueros,3974,1971,2003
18,905,Gabias (Las),7576,3793,3783
18,82,Galera,1426,712,714
18,83,Gobernador,396,199,197
18,84,Gójar,3160,1603,1557
18,85,Gor,1251,621,630
18,86,Gorafe,583,280,303
18,87,Granada,245640,114904,130736
18,88,Guadahortuna,2334,1198,1136
18,89,Guadix,20310,10077,10233
18,906,Guajares (Los),1382,709,673
18,93,Gualchos,2990,1507,1483
18,94,Güéjar Sierra,2713,1369,1344
18,95,Güevéjar,1502,749,753
18,96,Huélago,683,353,330
18,97,Huéneja,1329,654,675
18,98,Huéscar,8369,4161,4208
18,99,Huétor Santillán,1687,878,809
18,100,Huétor Tájar,8171,4080,4091
18,101,Huétor Vega,7984,4002,3982
18,102,Illora,10797,5416,5381
18,103,Itrabo,1052,516,536
18,105,Iznalloz,6705,3399,3306
18,107,Jayena,1479,754,725
18,108,Jerez del Marquesado,1214,613,601
18,109,Jete,754,363,391
18,111,Jun,1553,786,767
18,112,Juviles,187,96,91
18,115,Láchar,2335,1184,1151
18,116,Lanjarón,3971,1976,1995
18,117,Lanteira,683,341,342
18,119,Lecrín,2424,1191,1233
18,120,Lentegí,356,166,190
18,121,Lobras,190,92,98
18,122,Loja,20032,9911,10121
18,123,Lugros,426,223,203
18,124,Lújar,572,308,264
18,126,Malahá (La),1702,856,846
18,127,Maracena,14095,7011,7084
18,128,Marchal,452,214,238
18,132,Moclín,4742,2354,2388
18,133,Molvízar,2640,1301,1339
18,134,Monachil,5074,2569,2505
18,135,Montefrío,7426,3758,3668
18,136,Montejícar,3006,1527,1479
18,137,Montillana,1420,716,704
18,138,Moraleda de Zafayona,2724,1393,1331
18,909,Morelábor,953,482,471
18,140,Motril,50316,24841,25475
18,141,Murtas,906,474,432
18,903,Nevada,1418,718,700
18,143,Nigüelas,1139,570,569
18,144,Nívar,646,323,323
18,145,Ogíjares,7607,3825,3782
18,146,Orce,1478,746,732
18,147,Orgiva,5147,2591,2556
18,148,Otívar,1108,556,552
18,149,Otura,3499,1749,1750
18,150,Padul,6673,3323,3350
18,151,Pampaneira,335,171,164
18,152,Pedro Martínez,1523,776,747
18,153,Peligros,6983,3452,3531
18,154,Peza (La),1467,769,698
18,910,Pinar (El),1286,652,634
18,157,Pinos Genil,1176,612,564
18,158,Pinos Puente,13275,6665,6610
18,159,Píñar,1422,732,690
18,161,Polícar,260,131,129
18,162,Polopos,1252,647,605
18,163,Pórtugos,440,216,224
18,164,Puebla de Don Fadrique,2643,1327,1316
18,165,Pulianas,3335,1683,1652
18,167,Purullena,2196,1074,1122
18,168,Quéntar,1134,576,558
18,170,Rubite,421,222,199
18,171,Salar,2753,1360,1393
18,173,Salobreña,10104,5025,5079
18,174,Santa Cruz del Comercio,560,289,271
18,175,Santa Fe,12349,6063,6286
18,176,Soportújar,288,151,137
18,177,Sorvilán,694,349,345
18,901,Taha (La),787,396,391
18,178,Torre-Cardela,1240,609,631
18,179,Torvizcón,1022,517,505
18,180,Trevélez,800,419,381
18,181,Turón,387,218,169
18,182,Ugíjar,2625,1298,1327
18,902,Valle (El),1431,695,736
18,907,Valle del Zalabí,2431,1203,1228
18,183,Válor,1024,515,509
18,911,Vegas del Genil,2753,1385,1368
18,184,Vélez de Benaudalla,2688,1317,1371
18,185,Ventas de Huelma,702,347,355
18,908,Villamena,1013,478,535
18,187,Villanueva de las Torres,1012,527,485
18,188,Villanueva Mesía,1922,959,963
18,189,Víznar,742,373,369
18,192,Zafarraya,2227,1147,1080
18,913,Zagra,1187,583,604
18,193,Zubia (La),11887,5832,6055
18,194,Zújar,2933,1501,1432
19,1,Abánades,125,67,58
19,2,Ablanque,157,79,78
19,3,Adobes,45,26,19
19,4,Alaminos,97,43,54
19,5,Alarilla,123,72,51
19,6,Albalate de Zorita,1010,533,477
19,7,Albares,520,259,261
19,8,Albendiego,52,28,24
19,9,Alcocer,300,154,146
19,10,Alcolea de las Peñas,33,17,16
19,11,Alcolea del Pinar,409,199,210
19,13,Alcoroches,211,113,98
19,15,Aldeanueva de Guadalajara,107,46,61
19,16,Algar de Mesa,92,50,42
19,17,Algora,113,64,49
19,18,Alhóndiga,256,141,115
19,19,Alique,37,11,26
19,20,Almadrones,91,54,37
19,21,Almoguera,862,449,413
19,22,Almonacid de Zorita,977,476,501
19,23,Alocén,156,74,82
19,24,Alovera,1422,723,699
19,27,Alustante,284,156,128
19,31,Angón,43,25,18
19,32,Anguita,316,163,153
19,33,Anquela del Ducado,89,44,45
19,34,Anquela del Pedregal,27,17,10
19,36,Aranzueque,369,184,185
19,37,Arbancón,210,118,92
19,38,Arbeteta,52,26,26
19,39,Argecilla,116,68,48
19,40,Armallones,54,32,22
19,41,Armuña de Tajuña,116,63,53
19,42,Arroyo de las Fraguas,53,24,29
19,43,Atanzón,110,63,47
19,44,Atienza,494,259,235
19,45,Auñón,266,140,126
19,46,Azuqueca de Henares,16013,8111,7902
19,47,Baides,97,50,47
19,48,Baños de Tajo,31,20,11
19,49,Bañuelos,32,18,14
19,50,Barriopedro,36,15,21
19,51,Berninches,125,71,54
19,52,Bodera (La),58,34,24
19,53,Brihuega,3101,1577,1524
19,54,Budia,296,156,140
19,55,Bujalaro,88,46,42
19,57,Bustares,108,59,49
19,58,Cabanillas del Campo,2285,1177,1108
19,59,Campillo de Dueñas,151,88,63
19,60,Campillo de Ranas,121,61,60
19,61,Campisábalos,66,33,33
19,64,Canredondo,108,55,53
19,65,Cantalojas,155,82,73
19,66,Cañizar,125,60,65
19,67,Cardoso de la Sierra (El),103,66,37
19,70,Casa de Uceda,119,63,56
19,71,Casar (El),2222,1127,1095
19,73,Casas de San Galindo,41,22,19
19,74,Caspueñas,81,49,32
19,75,Castejón de Henares,129,68,61
19,76,Castellar de la Muela,55,26,29
19,78,Castilforte,53,31,22
19,79,Castilnuevo,12,5,7
19,80,Cendejas de Enmedio,129,66,63
19,81,Cendejas de la Torre,113,67,46
19,82,Centenera,75,41,34
19,103,Checa,427,227,200
19,104,Chequilla,21,10,11
19,106,Chillarón del Rey,137,72,65
19,105,Chiloeches,1137,604,533
19,86,Cifuentes,2405,1220,1185
19,87,Cincovillas,38,20,18
19,88,Ciruelas,92,47,45
19,89,Ciruelos del Pinar,67,36,31
19,90,Cobeta,129,65,64
19,91,Cogollor,61,35,26
19,92,Cogolludo,629,346,283
19,95,Condemios de Abajo,32,18,14
19,96,Condemios de Arriba,183,96,87
19,97,Congostrina,43,18,25
19,98,Copernal,32,17,15
19,99,Corduente,481,263,218
19,102,Cubillo de Uceda (El),142,71,71
19,107,Driebes,364,190,174
19,108,Durón,110,53,57
19,109,Embid,66,36,30
19,110,Escamilla,146,66,80
19,111,Escariche,220,116,104
19,112,Escopete,68,25,43
19,113,Espinosa de Henares,543,263,280
19,114,Esplegares,63,37,26
19,115,Establés,55,30,25
19,116,Estriégana,29,16,13
19,117,Fontanar,902,460,442
19,118,Fuembellida,17,10,7
19,119,Fuencemillán,130,68,62
19,120,Fuentelahiguera de Albatages,194,102,92
19,121,Fuentelencina,166,86,80
19,122,Fuentelsaz,156,76,80
19,123,Fuentelviejo,81,40,41
19,124,Fuentenovilla,227,126,101
19,125,Gajanejos,96,52,44
19,126,Galápagos,230,118,112
19,127,Galve de Sorbe,169,83,86
19,129,Gascueña de Bornova,50,26,24
19,130,Guadalajara,67108,33019,34089
19,132,Henche,77,37,40
19,133,Heras de Ayuso,126,65,61
19,134,Herrería,42,21,21
19,135,Hiendelaencina,147,76,71
19,136,Hijes,27,14,13
19,138,Hita,290,158,132
19,139,Hombrados,54,32,22
19,142,Hontoba,185,86,99
19,143,Horche,1375,694,681
19,145,Hortezuela de Océn,84,45,39
19,146,Huerce (La),42,24,18
19,147,Huérmeces del Cerro,70,41,29
19,148,Huertahernando,70,41,29
19,150,Hueva,151,74,77
19,151,Humanes,1250,639,611
19,152,Illana,702,370,332
19,153,Iniéstola,20,12,8
19,154,Inviernas (Las),98,57,41
19,155,Irueste,75,37,38
19,156,Jadraque,1247,635,612
19,157,Jirueque,61,34,27
19,159,Ledanca,152,78,74
19,160,Loranca de Tajuña,305,159,146
19,161,Lupiana,278,150,128
19,162,Luzaga,124,58,66
19,163,Luzón,93,44,49
19,165,Majaelrayo,58,29,29
19,166,Málaga del Fresno,223,112,111
19,167,Malaguilla,156,94,62
19,168,Mandayona,472,228,244
19,169,Mantiel,74,33,41
19,170,Maranchón,262,134,128
19,172,Masegoso de Tajuña,105,51,54
19,173,Matarrubia,50,32,18
19,174,Matillas,225,117,108
19,175,Mazarete,87,45,42
19,176,Mazuecos,395,197,198
19,177,Medranda,150,74,76
19,178,Megina,87,42,45
19,179,Membrillera,103,49,54
19,181,Miedes de Atienza,115,60,55
19,182,Mierla (La),44,25,19
19,184,Millana,121,61,60
19,183,Milmarcos,102,54,48
19,185,Miñosa (La),48,27,21
19,186,Mirabueno,123,66,57
19,187,Miralrío,85,47,38
19,188,Mochales,127,60,67
19,189,Mohernando,142,82,60
19,190,Molina de Aragón,3529,1801,1728
19,191,Monasterio,21,10,11
19,192,Mondéjar,2114,1060,1054
19,193,Montarrón,64,37,27
19,194,Moratilla de los Meleros,115,60,55
19,195,Morenilla,58,38,20
19,196,Muduex,125,66,59
19,197,Navas de Jadraque (Las),22,14,8
19,198,Negredo,25,11,14
19,199,Ocentejo,49,20,29
19,200,Olivar (El),114,58,56
19,201,Olmeda de Cobeta,84,33,51
19,202,Olmeda de Jadraque (La),22,11,11
19,203,Ordial (El),49,21,28
19,204,Orea,276,151,125
19,208,Pálmaces de Jadraque,63,33,30
19,209,Pardos,67,33,34
19,210,Paredes de Sigüenza,76,40,36
19,211,Pareja,481,236,245
19,212,Pastrana,1209,619,590
19,213,Pedregal (El),114,62,52
19,214,Peñalén,160,86,74
19,215,Peñalver,237,135,102
19,216,Peralejos de las Truchas,170,87,83
19,217,Peralveche,95,50,45
19,218,Pinilla de Jadraque,106,54,52
19,219,Pinilla de Molina,28,19,9
19,220,Pioz,380,202,178
19,221,Piqueras,57,33,24
19,222,Pobo de Dueñas (El),189,104,85
19,223,Poveda de la Sierra,207,109,98
19,224,Pozo de Almoguera,212,108,104
19,225,Pozo de Guadalajara,401,211,190
19,226,Prádena de Atienza,42,25,17
19,227,Prados Redondos,92,57,35
19,228,Puebla de Beleña,37,24,13
19,229,Puebla de Valles,73,39,34
19,230,Quer,107,55,52
19,231,Rebollosa de Jadraque,40,21,19
19,232,Recuenco (El),101,51,50
19,233,Renera,70,36,34
19,234,Retiendas,54,26,28
19,235,Riba de Saelices,197,108,89
19,237,Rillo de Gallo,72,40,32
19,238,Riofrío del Llano,81,44,37
19,239,Robledillo de Mohernando,168,86,82
19,240,Robledo de Corpes,76,39,37
19,241,Romanillos de Atienza,70,42,28
19,242,Romanones,145,82,63
19,243,Rueda de la Sierra,76,40,36
19,244,Sacecorbo,143,81,62
19,245,Sacedón,1585,801,784
19,246,Saelices de la Sal,72,36,36
19,247,Salmerón,287,149,138
19,248,San Andrés del Congosto,99,48,51
19,249,San Andrés del Rey,50,20,30
19,250,Santiuste,25,11,14
19,251,Saúca,66,35,31
19,252,Sayatón,199,106,93
19,254,Selas,60,28,32
19,901,Semillas,34,17,17
19,255,Setiles,179,97,82
19,256,Sienes,107,60,47
19,257,Sigüenza,4880,2437,2443
19,258,Solanillos del Extremo,127,66,61
19,259,Somolinos,36,19,17
19,260,Sotillo (El),52,31,21
19,261,Sotodosos,70,35,35
19,262,Tamajón,207,101,106
19,263,Taragudo,30,17,13
19,264,Taravilla,77,38,39
19,265,Tartanedo,210,103,107
19,266,Tendilla,370,191,179
19,267,Terzaga,42,27,15
19,268,Tierzo,42,22,20
19,269,Toba (La),122,69,53
19,271,Tordellego,78,39,39
19,270,Tordelrábano,18,9,9
19,272,Tordesilos,150,79,71
19,274,Torija,382,180,202
19,279,Torre del Burgo,69,38,31
19,277,Torrecuadrada de Molina,22,13,9
19,278,Torrecuadradilla,76,46,30
19,280,Torrejón del Rey,814,426,388
19,281,Torremocha de Jadraque,18,11,7
19,282,Torremocha del Campo,343,190,153
19,283,Torremocha del Pinar,70,33,37
19,284,Torremochuela,12,6,6
19,285,Torrubia,46,24,22
19,286,Tórtola de Henares,399,205,194
19,287,Tortuera,247,129,118
19,288,Tortuero,42,25,17
19,289,Traid,70,34,36
19,290,Trijueque,570,308,262
19,291,Trillo,1467,754,713
19,293,Uceda,791,391,400
19,294,Ujados,38,20,18
19,296,Utande,59,38,21
19,297,Valdarachas,27,10,17
19,298,Valdearenas,62,30,32
19,299,Valdeavellano,103,55,48
19,300,Valdeaveruelo,234,129,105
19,301,Valdeconcha,51,29,22
19,302,Valdegrudas,57,29,28
19,303,Valdelcubo,75,44,31
19,304,Valdenuño Fernández,135,72,63
19,305,Valdepeñas de la Sierra,245,135,110
19,306,Valderrebollo,43,22,21
19,307,Valdesotos,45,18,27
19,308,Valfermoso de Tajuña,111,58,53
19,309,Valhermoso,35,20,15
19,310,Valtablado del Río,16,10,6
19,311,Valverde de los Arroyos,88,47,41
19,314,Viana de Jadraque,64,37,27
19,317,Villanueva de Alcorón,300,167,133
19,318,Villanueva de Argecilla,44,24,20
19,319,Villanueva de la Torre,330,166,164
19,321,Villares de Jadraque,57,30,27
19,322,Villaseca de Henares,82,40,42
19,323,Villaseca de Uceda,65,35,30
19,324,Villel de Mesa,271,141,130
19,325,Viñuelas,123,72,51
19,326,Yebes,181,128,53
19,327,Yebra,576,295,281
19,329,Yélamos de Abajo,101,50,51
19,330,Yélamos de Arriba,149,72,77
19,331,Yunquera de Henares,2041,1040,1001
19,332,Yunta (La),180,90,90
19,333,Zaorejas,206,117,89
19,334,Zarzuela de Jadraque,31,15,16
19,335,Zorita de los Canes,88,48,40
20,1,Abaltzisketa,259,149,110
20,2,Aduna,311,164,147
20,16,Aia,1646,922,724
20,3,Aizarnazabal,551,293,258
20,4,Albiztur,296,159,137
20,5,Alegia,1662,854,808
20,6,Alkiza,260,150,110
20,906,Altzaga,95,49,46
20,7,Altzo,321,177,144
20,8,Amezketa,1005,530,475
20,9,Andoain,14540,7243,7297
20,10,Anoeta,1776,909,867
20,11,Antzuola,1936,1000,936
20,12,Arama,158,77,81
20,13,Aretxabaleta,5943,3033,2910
20,55,Arrasate o Mondragón,24571,12300,12271
20,14,Asteasu,1192,639,553
20,903,Astigarraga,3178,1569,1609
20,15,Ataun,1589,815,774
20,17,Azkoitia,10240,5098,5142
20,18,Azpeitia,13536,6784,6752
20,904,Baliarrain,94,45,49
20,19,Beasain,12331,6162,6169
20,20,Beizama,164,91,73
20,21,Belauntza,286,154,132
20,22,Berastegi,932,507,425
20,74,Bergara,15317,7618,7699
20,23,Berrobi,565,306,259
20,24,Bidegoyan,421,238,183
20,29,Deba,5042,2569,2473
20,69,Donostia-San Sebastián,176908,82986,93922
20,30,Eibar,30314,14850,15464
20,31,Elduain,227,123,104
20,33,Elgeta,982,506,476
20,32,Elgoibar,10989,5483,5506
20,66,Errezil,639,353,286
20,34,Eskoriatza,3999,2075,1924
20,35,Ezkio-Itsaso,538,280,258
20,38,Gabiria,428,236,192
20,37,Gainza,136,82,54
20,907,Gaztelu,144,84,60
20,39,Getaria,2397,1208,1189
20,40,Hernani,18627,9268,9359
20,41,Hernialde,301,152,149
20,36,Hondarribia,14453,7197,7256
20,42,Ibarra,4287,2226,2061
20,43,Idiazabal,2020,1030,990
20,44,Ikaztegieta,380,197,183
20,45,Irun,55215,27002,28213
20,46,Irura,726,365,361
20,47,Itsasondo,628,316,312
20,48,Larraul,135,80,55
20,902,Lasarte-Oria,17861,8881,8980
20,49,Lazkao,4902,2521,2381
20,50,Leaburu,377,205,172
20,51,Legazpi,9278,4762,4516
20,52,Legorreta,1420,715,705
20,68,Leintz-Gatzaga,250,140,110
20,53,Lezo,5753,2838,2915
20,54,Lizartza,644,341,303
20,901,Mendaro,1308,674,634
20,57,Mutiloa,168,86,82
20,56,Mutriku,4774,2373,2401
20,63,Oiartzun,8878,4446,4432
20,58,Olaberria,1010,521,489
20,59,Oñati,10564,5281,5283
20,76,Ordizia,9120,4459,4661
20,905,Orendain,156,91,65
20,60,Orexa,79,40,39
20,61,Orio,4266,2166,2100
20,62,Ormaiztegi,1182,596,586
20,64,Pasaia,17300,8416,8884
20,67,Rentería,39663,19505,20158
20,70,Segura,1263,626,637
20,65,Soraluze/Placencia de las Armas,4430,2200,2230
20,71,Tolosa,17979,8636,9343
20,72,Urnieta,5120,2622,2498
20,77,Urretxu,6242,3149,3093
20,73,Usurbil,5265,2706,2559
20,75,Villabona,5370,2727,2643
20,78,Zaldibia,1573,817,756
20,79,Zarautz,19202,9482,9720
20,25,Zegama,1348,686,662
20,26,Zerain,233,115,118
20,27,Zestoa,3252,1688,1564
20,28,Zizurkil,2684,1358,1326
20,81,Zumaia,8280,4143,4137
20,80,Zumárraga,10324,5185,5139
21,1,Alájar,804,406,398
21,2,Aljaraque,9587,4808,4779
21,3,Almendro (El),862,448,414
21,4,Almonaster la Real,2057,1010,1047
21,5,Almonte,16264,8156,8108
21,6,Alosno,5054,2436,2618
21,7,Aracena,6708,3292,3416
21,8,Aroche,3581,1771,1810
21,9,Arroyomolinos de León,1168,599,569
21,10,Ayamonte,17566,8613,8953
21,11,Beas,4232,2117,2115
21,12,Berrocal,428,213,215
21,13,Bollullos Par del Condado,12741,6333,6408
21,14,Bonares,5056,2559,2497
21,15,Cabezas Rubias,1009,517,492
21,16,Cala,1493,748,745
21,17,Calañas,4974,2465,2509
21,18,Campillo (El),2452,1184,1268
21,19,Campofrío,871,443,428
21,20,Cañaveral de León,539,263,276
21,21,Cartaya,11435,5676,5759
21,22,Castaño del Robledo,201,105,96
21,23,Cerro de Andévalo (El),2785,1365,1420
21,30,Chucena,1930,978,952
21,24,Corteconcepción,689,356,333
21,25,Cortegana,5206,2588,2618
21,26,Cortelazor,338,170,168
21,27,Cumbres de Enmedio,60,31,29
21,28,Cumbres de San Bartolomé,597,299,298
21,29,Cumbres Mayores,2184,1078,1106
21,31,Encinasola,1945,958,987
21,32,Escacena del Campo,2226,1099,1127
21,33,Fuenteheridos,676,340,336
21,34,Galaroza,1594,774,820
21,35,Gibraleón,11166,5623,5543
21,36,Granada de Río Tinto (La),234,119,115
21,37,Granado (El),680,365,315
21,38,Higuera de la Sierra,1291,648,643
21,39,Hinojales,441,217,224
21,40,Hinojos,3482,1771,1711
21,41,Huelva,140675,68072,72603
21,42,Isla Cristina,17310,8635,8675
21,43,Jabugo,2595,1298,1297
21,44,Lepe,18325,9361,8964
21,45,Linares de la Sierra,301,143,158
21,46,Lucena del Puerto,2180,1117,1063
21,47,Manzanilla,2523,1260,1263
21,48,Marines (Los),329,164,165
21,49,Minas de Riotinto,5212,2482,2730
21,50,Moguer,13371,6766,6605
21,51,Nava (La),328,168,160
21,52,Nerva,6594,3191,3403
21,53,Niebla,3846,1955,1891
21,54,Palma del Condado (La),9749,4815,4934
21,55,Palos de la Frontera,6884,3483,3401
21,56,Paterna del Campo,3883,1995,1888
21,57,Paymogo,1294,617,677
21,58,Puebla de Guzmán,3275,1646,1629
21,59,Puerto Moral,242,119,123
21,60,Punta Umbría,10998,5603,5395
21,61,Rociana del Condado,6348,3231,3117
21,62,Rosal de la Frontera,1915,915,1000
21,63,San Bartolomé de la Torre,2940,1496,1444
21,64,San Juan del Puerto,5990,2997,2993
21,66,San Silvestre de Guzmán,660,327,333
21,65,Sanlúcar de Guadiana,392,191,201
21,67,Santa Ana la Real,495,235,260
21,68,Santa Bárbara de Casa,1401,702,699
21,69,Santa Olalla del Cala,2285,1158,1127
21,70,Trigueros,7280,3629,3651
21,71,Valdelarco,283,137,146
21,72,Valverde del Camino,12609,6112,6497
21,73,Villablanca,2072,1075,997
21,74,Villalba del Alcor,3618,1793,1825
21,75,Villanueva de las Cruces,460,220,240
21,76,Villanueva de los Castillejos,2684,1316,1368
21,77,Villarrasa,2092,1070,1022
21,78,Zalamea la Real,3545,1741,1804
21,79,Zufre,1146,600,546
22,1,Abiego,305,149,156
22,2,Abizanda,136,72,64
22,3,Adahuesca,171,88,83
22,4,Agüero,163,86,77
22,907,Aínsa-Sobrarbe,1512,787,725
22,6,Aisa,354,193,161
22,7,Albalate de Cinca,1107,566,541
22,8,Albalatillo,271,137,134
22,9,Albelda,975,497,478
22,11,Albero Alto,101,53,48
22,12,Albero Bajo,117,64,53
22,13,Alberuela de Tubo,404,205,199
22,14,Alcalá de Gurrea,370,185,185
22,15,Alcalá del Obispo,353,178,175
22,16,Alcampell,1015,505,510
22,17,Alcolea de Cinca,1245,638,607
22,18,Alcubierre,483,258,225
22,19,Alerre,167,88,79
22,20,Alfántega,131,66,65
22,21,Almudévar,2379,1234,1145
22,22,Almunia de San Juan,704,353,351
22,23,Almuniente,644,333,311
22,24,Alquézar,303,152,151
22,25,Altorricón,1454,745,709
22,27,Angüés,461,253,208
22,28,Ansó,509,256,253
22,29,Antillón,171,80,91
22,32,Aragüés del Puerto,144,90,54
22,35,Arén,418,217,201
22,36,Argavieso,121,69,52
22,37,Arguis,59,32,27
22,39,Ayerbe,1142,588,554
22,40,Azanuy-Alins,204,98,106
22,41,Azara,231,113,118
22,42,Azlor,174,88,86
22,43,Baélls,160,84,76
22,44,Bailo,338,199,139
22,45,Baldellou,159,86,73
22,46,Ballobar,1102,562,540
22,47,Banastás,170,87,83
22,48,Barbastro,14520,7044,7476
22,49,Barbués,121,62,59
22,50,Barbuñales,110,55,55
22,51,Bárcabo,114,63,51
22,52,Belver de Cinca,1406,748,658
22,53,Benabarre,1195,616,579
22,54,Benasque,1219,638,581
22,55,Berbegal,486,245,241
22,57,Bielsa,472,245,227
22,58,Bierge,224,129,95
22,59,Biescas,1240,644,596
22,60,Binaced,1622,831,791
22,61,Binéfar,8130,4065,4065
22,62,Bisaurri,223,126,97
22,63,Biscarrués,249,132,117
22,64,Blecua y Torres,187,98,89
22,66,Boltaña,881,445,436
22,67,Bonansa,72,37,35
22,68,Borau,78,42,36
22,69,Broto,522,265,257
22,72,Caldearenas,267,150,117
22,74,Campo,376,175,201
22,75,Camporrélls,263,130,133
22,76,Canal de Berdún,429,237,192
22,77,Candasnos,572,296,276
22,78,Canfranc,509,269,240
22,79,Capdesaso,194,92,102
22,80,Capella,406,209,197
22,81,Casbas de Huesca,322,171,151
22,83,Castejón de Monegros,754,375,379
22,84,Castejón de Sos,514,267,247
22,82,Castejón del Puente,407,213,194
22,85,Castelflorite,157,83,74
22,86,Castiello de Jaca,156,80,76
22,87,Castigaleu,104,61,43
22,88,Castillazuelo,239,115,124
22,89,Castillonroy,444,220,224
22,94,Chalamera,179,92,87
22,95,Chía,121,67,54
22,96,Chimillas,162,88,74
22,90,Colungo,129,69,60
22,99,Esplús,811,394,417
22,102,Estada,198,103,95
22,103,Estadilla,968,486,482
22,105,Estopiñán del Castillo,195,102,93
22,106,Fago,43,28,15
22,107,Fanlo,107,63,44
22,109,Fiscal,244,136,108
22,110,Fonz,1169,604,565
22,111,Foradada del Toscar,260,126,134
22,112,Fraga,11783,5890,5893
22,113,Fueva (La),622,330,292
22,114,Gistaín,187,109,78
22,115,Grado (El),586,308,278
22,116,Grañén,2062,1047,1015
22,117,Graus,3300,1672,1628
22,119,Gurrea de Gállego,1895,961,934
22,122,Hoz de Jaca,80,33,47
22,908,Hoz y Costean,275,147,128
22,124,Huerto,268,146,122
22,125,Huesca,45607,21940,23667
22,126,Ibieca,110,60,50
22,127,Igriés,193,105,88
22,128,Ilche,294,151,143
22,129,Isábena,268,140,128
22,130,Jaca,11310,5615,5695
22,131,Jasa,137,74,63
22,133,Labuerda,180,96,84
22,135,Laluenga,271,142,129
22,136,Lalueza,1292,702,590
22,137,Lanaja,1651,868,783
22,139,Laperdiguera,103,53,50
22,141,Lascellas-Ponzano,169,88,81
22,142,Lascuarre,173,93,80
22,143,Laspaúles,284,159,125
22,144,Laspuña,278,154,124
22,149,Loarre,412,216,196
22,150,Loporzano,537,272,265
22,151,Loscorrales,127,69,58
22,905,Lupiñén-Ortilla,366,197,169
22,155,Monesma y Cajigar,105,54,51
22,156,Monflorite-Lascasas,193,105,88
22,157,Montanuy,322,182,140
22,158,Monzón,14576,7340,7236
22,160,Naval,301,151,150
22,162,Novales,197,97,100
22,163,Nueno,217,123,94
22,164,Olvena,53,22,31
22,165,Ontiñena,682,350,332
22,167,Osso de Cinca,738,394,344
22,168,Palo,33,16,17
22,170,Panticosa,613,313,300
22,172,Peñalba,817,408,409
22,173,Peñas de Riglos (Las),298,165,133
22,174,Peralta de Alcofea,762,377,385
22,175,Peralta de Calasanz,306,165,141
22,176,Peraltilla,180,95,85
22,177,Perarrúa,147,72,75
22,178,Pertusa,147,75,72
22,181,Piracés,100,64,36
22,182,Plan,312,173,139
22,184,Poleñino,253,127,126
22,186,Pozán de Vero,257,126,131
22,187,Puebla de Castro (La),306,158,148
22,188,Puente de Montañana,142,71,71
22,902,Puente la Reina de Jaca,269,136,133
22,189,Puértolas,219,128,91
22,190,Pueyo de Araguás (El),184,113,71
22,193,Pueyo de Santa Cruz,371,192,179
22,195,Quicena,146,72,74
22,197,Robres,709,366,343
22,199,Sabiñánigo,8759,4439,4320
22,200,Sahún,323,174,149
22,201,Salas Altas,403,212,191
22,202,Salas Bajas,180,80,100
22,203,Salillas,130,67,63
22,204,Sallent de Gállego,983,514,469
22,205,San Esteban de Litera,658,331,327
22,207,San Juan de Plan,166,90,76
22,903,San Miguel del Cinca,918,477,441
22,206,Sangarrén,285,143,142
22,208,Santa Cilia de Jaca,205,110,95
22,209,Santa Cruz de la Serós,162,93,69
22,906,Santa María de Dulcis,214,109,105
22,212,Santaliestra y San Quílez,101,58,43
22,213,Sariñena,4058,2022,2036
22,214,Secastilla,168,78,90
22,215,Seira,202,101,101
22,217,Sena,615,323,292
22,218,Senés de Alcubierre,60,31,29
22,220,Sesa,281,144,137
22,221,Sesué,117,63,54
22,222,Siétamo,361,204,157
22,223,Sopeira,113,59,54
22,904,Sotonera (La),1127,599,528
22,225,Tamarite de Litera,3867,1918,1949
22,226,Tardienta,1087,560,527
22,227,Tella-Sin,293,154,139
22,228,Tierz,183,92,91
22,229,Tolva,220,119,101
22,230,Torla,344,183,161
22,232,Torralba de Aragón,136,63,73
22,233,Torre la Ribera,120,68,52
22,234,Torrente de Cinca,1142,565,577
22,235,Torres de Alcanadre,139,82,57
22,236,Torres de Barbués,370,185,185
22,239,Tramaced,104,61,43
22,242,Valfarta,109,58,51
22,243,Valle de Bardají,57,29,28
22,901,Valle de Hecho,1005,536,469
22,244,Valle de Lierp,63,34,29
22,245,Velilla de Cinca,499,243,256
22,909,Vencillón,481,247,234
22,246,Veracruz,116,64,52
22,247,Viacamp y Litera,32,21,11
22,248,Vicién,126,70,56
22,249,Villanova,113,62,51
22,250,Villanúa,317,160,157
22,251,Villanueva de Sigena,492,256,236
22,252,Yebra de Basa,172,105,67
22,253,Yésero,70,37,33
22,254,Zaidín,1698,851,847
23,1,Albánchez de Ubeda,1540,768,772
23,2,Alcalá la Real,21558,10692,10866
23,3,Alcaudete,11367,5623,5744
23,4,Aldeaquemada,622,311,311
23,5,Andújar,37705,18655,19050
23,6,Arjona,5660,2839,2821
23,7,Arjonilla,4072,2040,2032
23,8,Arquillos,1900,950,950
23,9,Baeza,16012,7856,8156
23,10,Bailén,17408,8733,8675
23,11,Baños de la Encina,2756,1413,1343
23,12,Beas de Segura,8261,4145,4116
23,902,Bedmar y Garcíez,3234,1632,1602
23,14,Begíjar,3111,1572,1539
23,15,Bélmez de la Moraleda,2011,989,1022
23,16,Benatae,585,295,290
23,17,Cabra del Santo Cristo,2280,1166,1114
23,18,Cambil,3297,1734,1563
23,19,Campillo de Arenas,2291,1157,1134
23,20,Canena,2137,1037,1100
23,21,Carboneros,700,345,355
23,901,Cárcheles,1564,776,788
23,24,Carolina (La),15048,7380,7668
23,25,Castellar,3695,1860,1835
23,26,Castillo de Locubín,5667,2805,2862
23,27,Cazalilla,867,422,445
23,28,Cazorla,9690,4741,4949
23,29,Chiclana de Segura,1679,845,834
23,30,Chilluévar,1811,896,915
23,31,Escañuela,1005,498,507
23,32,Espelúy,814,396,418
23,33,Frailes,1891,955,936
23,34,Fuensanta de Martos,3391,1650,1741
23,35,Fuerte del Rey,1183,583,600
23,37,Génave,720,367,353
23,38,Guardia de Jaén (La),2051,1060,991
23,39,Guarromán,2874,1410,1464
23,41,Higuera de Calatrava,707,366,341
23,42,Hinojares,524,257,267
23,43,Hornos,761,377,384
23,44,Huelma,6021,3026,2995
23,45,Huesa,2764,1409,1355
23,46,Ibros,3158,1593,1565
23,47,Iruela (La),2106,1074,1032
23,48,Iznatoraf,1218,595,623
23,49,Jabalquinto,2631,1305,1326
23,50,Jaén,104776,50470,54306
23,51,Jamilena,3306,1676,1630
23,52,Jimena,1604,780,824
23,53,Jódar,12060,5970,6090
23,40,Lahiguera,1919,934,985
23,54,Larva,546,281,265
23,55,Linares,60222,29415,30807
23,56,Lopera,4004,1973,2031
23,57,Lupión,1107,519,588
23,58,Mancha Real,8913,4468,4445
23,59,Marmolejo,7707,3879,3828
23,60,Martos,22307,10779,11528
23,61,Mengíbar,8563,4314,4249
23,62,Montizón,2015,1016,999
23,63,Navas de San Juan,5363,2650,2713
23,64,Noalejo,2408,1210,1198
23,65,Orcera,2389,1213,1176
23,66,Peal de Becerro,5147,2551,2596
23,67,Pegalajar,3136,1569,1567
23,69,Porcuna,7008,3504,3504
23,70,Pozo Alcón,6385,3238,3147
23,71,Puente de Génave,2073,1037,1036
23,72,Puerta de Segura (La),2818,1405,1413
23,73,Quesada,6256,3085,3171
23,74,Rus,3773,1888,1885
23,75,Sabiote,4325,2107,2218
23,76,Santa Elena,1077,577,500
23,77,Santiago de Calatrava,942,469,473
23,904,Santiago-Pontones,5021,2536,2485
23,79,Santisteban del Puerto,5058,2561,2497
23,80,Santo Tomé,2503,1257,1246
23,81,Segura de la Sierra,2196,1087,1109
23,82,Siles,2871,1433,1438
23,84,Sorihuela del Guadalimar,1283,647,636
23,85,Torreblascopedro,3033,1496,1537
23,86,Torredelcampo,12301,6123,6178
23,87,Torredonjimeno,13688,6675,7013
23,88,Torreperogil,7490,3660,3830
23,90,Torres,1882,950,932
23,91,Torres de Albánchez,1075,538,537
23,92,Ubeda,32086,15707,16379
23,93,Valdepeñas de Jaén,4560,2290,2270
23,94,Vilches,5162,2573,2589
23,95,Villacarrillo,11107,5533,5574
23,96,Villanueva de la Reina,3301,1624,1677
23,97,Villanueva del Arzobispo,8495,4181,4314
23,98,Villardompardo,1279,620,659
23,99,Villares (Los),4968,2462,2506
23,101,Villarrodrigo,617,304,313
23,903,Villatorres,4079,2027,2052
24,1,Acebedo,305,165,140
24,2,Algadefe,388,199,189
24,3,Alija del Infantado,1051,524,527
24,4,Almanza,807,423,384
24,5,Antigua (La),668,349,319
24,6,Ardón,728,381,347
24,7,Arganza,962,465,497
24,8,Astorga,12564,5950,6614
24,9,Balboa,501,268,233
24,10,Bañeza (La),10492,5108,5384
24,11,Barjas,458,248,210
24,12,Barrios de Luna (Los),368,184,184
24,14,Bembibre,11104,5532,5572
24,15,Benavides,3096,1588,1508
24,16,Benuza,728,380,348
24,17,Bercianos del Páramo,904,449,455
24,18,Bercianos del Real Camino,242,121,121
24,19,Berlanga del Bierzo,459,220,239
24,20,Boca de Huérgano,663,367,296
24,21,Boñar,2664,1301,1363
24,22,Borrenes,551,281,270
24,23,Brazuelo,370,176,194
24,24,Burgo Ranero (El),1002,526,476
24,25,Burón,415,215,200
24,26,Bustillo del Páramo,1999,996,1003
24,27,Cabañas Raras,1305,668,637
24,28,Cabreros del Río,647,336,311
24,29,Cabrillanes,1209,588,621
24,30,Cacabelos,4846,2425,2421
24,31,Calzada del Coto,316,172,144
24,32,Campazas,182,90,92
24,33,Campo de Villavidel,360,187,173
24,34,Camponaraya,3226,1568,1658
24,36,Candín,444,242,202
24,37,Cármenes,458,232,226
24,38,Carracedelo,3533,1751,1782
24,39,Carrizo,2829,1427,1402
24,40,Carrocera,647,323,324
24,41,Carucedo,674,320,354
24,42,Castilfalé,107,57,50
24,43,Castrillo de Cabrera,203,101,102
24,44,Castrillo de la Valduerna,257,113,144
24,46,Castrocalbón,1449,741,708
24,47,Castrocontrigo,1209,595,614
24,49,Castropodame,1873,936,937
24,50,Castrotierra de Valmadrigal,172,88,84
24,51,Cea,787,403,384
24,52,Cebanico,276,149,127
24,53,Cebrones del Río,754,386,368
24,65,Chozas de Abajo,2203,1122,1081
24,54,Cimanes de la Vega,725,355,370
24,55,Cimanes del Tejar,1113,557,556
24,56,Cistierna,4509,2233,2276
24,57,Congosto,1788,859,929
24,58,Corbillos de los Oteros,318,164,154
24,59,Corullón,1302,633,669
24,60,Crémenes,1319,629,690
24,61,Cuadros,1661,789,872
24,62,Cubillas de los Oteros,232,115,117
24,63,Cubillas de Rueda,653,337,316
24,64,Cubillos del Sil,1539,803,736
24,66,Destriana,935,450,485
24,67,Encinedo,1147,586,561
24,68,Ercina (La),759,373,386
24,69,Escobar de Campos,89,52,37
24,70,Fabero,6120,3089,3031
24,71,Folgoso de la Ribera,1442,702,740
24,73,Fresno de la Vega,745,370,375
24,74,Fuentes de Carbajal,149,75,74
24,76,Garrafe de Torío,1097,561,536
24,77,Gordaliza del Pino,385,195,190
24,78,Gordoncillo,688,340,348
24,79,Gradefes,1383,678,705
24,80,Grajal de Campos,308,132,176
24,81,Gusendos de los Oteros,246,121,125
24,82,Hospital de Orbigo,1195,591,604
24,83,Igüeña,2148,1129,1019
24,84,Izagre,278,139,139
24,86,Joarilla de las Matas,475,246,229
24,87,Laguna Dalga,971,480,491
24,88,Laguna de Negrillos,1656,847,809
24,89,León,145242,68024,77218
24,92,Llamas de la Ribera,1297,656,641
24,90,Lucillo,560,282,278
24,91,Luyego,1030,493,537
24,93,Magaz de Cepeda,579,284,295
24,94,Mansilla de las Mulas,1785,896,889
24,95,Mansilla Mayor,413,199,214
24,96,Maraña,191,100,91
24,97,Matadeón de los Oteros,326,165,161
24,98,Matallana de Torío,1778,886,892
24,99,Matanza,333,164,169
24,100,Molinaseca,815,422,393
24,101,Murias de Paredes,760,356,404
24,102,Noceda,1012,502,510
24,103,Oencia,557,300,257
24,104,Omañas (Las),494,246,248
24,105,Onzonilla,1435,711,724
24,106,Oseja de Sajambre,356,197,159
24,107,Pajares de los Oteros,403,208,195
24,108,Palacios de la Valduerna,570,275,295
24,109,Palacios del Sil,1570,789,781
24,110,Páramo del Sil,1959,992,967
24,112,Peranzanes,373,208,165
24,113,Pobladura de Pelayo García,609,312,297
24,114,Pola de Gordón (La),5471,2655,2816
24,115,Ponferrada,61575,30104,31471
24,116,Posada de Valdeón,511,269,242
24,117,Pozuelo del Páramo,707,368,339
24,118,Prado de la Guzpeña,181,98,83
24,119,Priaranza del Bierzo,1021,525,496
24,120,Prioro,512,269,243
24,121,Puebla de Lillo,706,378,328
24,122,Puente de Domingo Flórez,1980,1040,940
24,123,Quintana del Castillo,1185,616,569
24,124,Quintana del Marco,580,297,283
24,125,Quintana y Congosto,900,467,433
24,127,Regueras de Arriba,430,223,207
24,129,Reyero,165,86,79
24,130,Riaño,540,294,246
24,131,Riego de la Vega,1171,576,595
24,132,Riello,1093,558,535
24,133,Rioseco de Tapia,615,325,290
24,134,Robla (La),5227,2614,2613
24,136,Roperuelos del Páramo,867,431,436
24,137,Sabero,2026,1008,1018
24,139,Sahagún,3298,1592,1706
24,141,San Adrián del Valle,173,81,92
24,142,San Andrés del Rabanedo,23226,11299,11927
24,144,San Cristóbal de la Polantera,1178,594,584
24,145,San Emiliano,1030,525,505
24,146,San Esteban de Nogales,390,185,205
24,148,San Justo de la Vega,2365,1190,1175
24,149,San Millán de los Caballeros,201,105,96
24,150,San Pedro Bercianos,400,196,204
24,143,Sancedo,620,310,310
24,151,Santa Colomba de Curueño,712,339,373
24,152,Santa Colomba de Somoza,495,247,248
24,153,Santa Cristina de Valmadrigal,407,206,201
24,154,Santa Elena de Jamuz,1458,738,720
24,155,Santa María de la Isla,746,388,358
24,158,Santa María de Ordás,483,248,235
24,156,Santa María del Monte de Cea,422,209,213
24,157,Santa María del Páramo,3151,1509,1642
24,159,Santa Marina del Rey,2689,1339,1350
24,160,Santas Martas,1072,561,511
24,161,Santiago Millas,359,186,173
24,162,Santovenia de la Valdoncina,1523,746,777
24,163,Sariegos,2122,1061,1061
24,164,Sena de Luna,547,275,272
24,165,Sobrado,570,289,281
24,166,Soto de la Vega,2101,1070,1031
24,167,Soto y Amío,1150,564,586
24,168,Toral de los Guzmanes,729,381,348
24,169,Toreno,4481,2313,2168
24,170,Torre del Bierzo,3399,1697,1702
24,171,Trabadelo,633,330,303
24,172,Truchas,863,440,423
24,173,Turcia,1434,714,720
24,174,Urdiales del Páramo,771,395,376
24,185,Val de San Lorenzo,825,402,423
24,175,Valdefresno,1608,816,792
24,176,Valdefuentes del Páramo,477,247,230
24,177,Valdelugueros,491,265,226
24,178,Valdemora,131,62,69
24,179,Valdepiélago,423,205,218
24,180,Valdepolo,1684,874,810
24,181,Valderas,2305,1185,1120
24,182,Valderrey,692,333,359
24,183,Valderrueda,1421,716,705
24,184,Valdesamario,314,161,153
24,187,Valdevimbre,1288,648,640
24,188,Valencia de Don Juan,3826,1893,1933
24,191,Vallecillo,190,98,92
24,189,Valverde de la Virgen,4116,2063,2053
24,190,Valverde-Enrique,251,124,127
24,193,Vecilla (La),484,251,233
24,196,Vega de Espinareda,3123,1584,1539
24,197,Vega de Infanzones,864,426,438
24,198,Vega de Valcarce,998,503,495
24,194,Vegacervera,371,192,179
24,199,Vegaquemada,586,273,313
24,201,Vegas del Condado,1440,739,701
24,202,Villablino,15284,7715,7569
24,203,Villabraz,176,92,84
24,205,Villadangos del Páramo,996,501,495
24,206,Villadecanes,2408,1207,1201
24,207,Villademor de la Vega,492,262,230
24,209,Villafranca del Bierzo,4130,2043,2087
24,210,Villagatón,912,478,434
24,211,Villamandos,475,224,251
24,901,Villamanín,1362,674,688
24,212,Villamañán,1488,746,742
24,213,Villamartín de Don Sancho,218,115,103
24,214,Villamejil,1024,516,508
24,215,Villamol,270,134,136
24,216,Villamontán de la Valduerna,1170,591,579
24,217,Villamoratiel de las Matas,201,112,89
24,218,Villanueva de las Manzanas,656,322,334
24,219,Villaobispo de Otero,763,388,375
24,902,Villaornate y Castro,584,310,274
24,221,Villaquejida,1110,583,527
24,222,Villaquilambre,7048,3558,3490
24,223,Villarejo de Orbigo,3616,1766,1850
24,224,Villares de Orbigo,1028,520,508
24,225,Villasabariego,1204,605,599
24,226,Villaselán,348,191,157
24,227,Villaturiel,1803,923,880
24,228,Villazala,1101,580,521
24,229,Villazanzo de Valderaduey,744,410,334
24,230,Zotes del Páramo,734,374,360
25,1,Abella de la Conca,186,102,84
25,2,Ager,553,292,261
25,3,Agramunt,4925,2489,2436
25,38,Aitona,2183,1078,1105
25,4,Alamús (Els),671,334,337
25,5,Alàs i Cerc,409,220,189
25,6,Albagés (L'),507,265,242
25,7,Albatàrrec,1007,499,508
25,8,Albesa,1482,724,758
25,9,Albi (L'),791,405,386
25,10,Alcanó,266,134,132
25,11,Alcarràs,4715,2343,2372
25,12,Alcoletge,1618,815,803
25,13,Alfarràs,2947,1436,1511
25,14,Alfés,345,184,161
25,15,Algerri,522,256,266
25,16,Alguaire,2825,1432,1393
25,17,Alins,287,138,149
25,19,Almacelles,5475,2774,2701
25,20,Almatret,516,269,247
25,21,Almenar,3439,1751,1688
25,22,Alòs de Balaguer,188,109,79
25,23,Alpicat,3412,1675,1737
25,24,Alt Aneu,375,206,169
25,27,Anglesola,1211,615,596
25,29,Arbeca,2313,1155,1158
25,31,Arres,64,34,30
25,32,Arsèguel,101,52,49
25,33,Artesa de Lleida,1217,611,606
25,34,Artesa de Segre,3068,1570,1498
25,36,Aspa,251,125,126
25,37,Avellanes i Santa Linya (Les),460,243,217
25,39,Baix Pallars,351,196,155
25,40,Balaguer,13103,6421,6682
25,41,Barbens,752,386,366
25,42,Baronia de Rialb (La),251,127,124
25,44,Bassella,341,174,167
25,45,Bausen,70,41,29
25,46,Belianes,558,269,289
25,170,Bellaguarda,366,187,179
25,47,Bellcaire d'Urgell,1369,654,715
25,48,Bell-lloc d'Urgell,2119,1046,1073
25,49,Bellmunt d'Urgell,233,116,117
25,50,Bellpuig,3927,1941,1986
25,51,Bellver de Cerdanya,1535,802,733
25,52,Bellvís,2161,1073,1088
25,53,Benavent de Segrià,786,407,379
25,55,Biosca,265,130,135
25,57,Bòrdes (Es),220,119,101
25,58,Borges Blanques (Les),5190,2570,2620
25,59,Bossòst,822,407,415
25,56,Bovera,426,216,210
25,60,Cabanabona,101,46,55
25,61,Cabó,127,70,57
25,62,Camarasa,897,449,448
25,63,Canejan,104,56,48
25,904,Castell de Mur,157,82,75
25,64,Castellar de la Ribera,147,70,77
25,67,Castelldans,949,488,461
25,68,Castellnou de Seana,738,349,389
25,69,Castelló de Farfanya,597,298,299
25,70,Castellserà,1139,562,577
25,71,Cava,61,36,25
25,72,Cervera,7153,3505,3648
25,73,Cervià de les Garrigues,862,447,415
25,74,Ciutadilla,218,113,105
25,75,Clariana de Cardener,148,77,71
25,76,Cogul (El),230,116,114
25,77,Coll de Nargó,606,321,285
25,163,Coma i la Pedra (La),222,137,85
25,161,Conca de Dalt,437,228,209
25,78,Corbins,1037,523,514
25,79,Cubells,360,182,178
25,81,Espluga Calba (L'),445,235,210
25,82,Espot,272,143,129
25,88,Estamariu,135,70,65
25,85,Estaràs,165,89,76
25,86,Esterri d'Aneu,611,293,318
25,87,Esterri de Cardós,80,41,39
25,89,Farrera,88,48,40
25,908,Fígols i Alinyà,306,165,141
25,92,Floresta (La),177,92,85
25,93,Fondarella,653,327,326
25,94,Foradada,175,101,74
25,96,Fuliola (La),1264,636,628
25,97,Fulleda,117,62,55
25,98,Gavet de la Conca,335,163,172
25,912,Gimenells i el Pla de la Font,1162,612,550
25,99,Golmés,1276,612,664
25,100,Gósol,210,116,94
25,101,Granadella (La),839,428,411
25,102,Granja d'Escarp (La),1115,587,528
25,103,Granyanella,137,69,68
25,105,Granyena de les Garrigues,179,91,88
25,104,Granyena de Segarra,174,91,83
25,109,Guimerà,397,197,200
25,903,Guingueta d'Aneu (La),270,137,133
25,110,Guissona,2928,1513,1415
25,111,Guixers,148,90,58
25,115,Isona i Conca Dellà,1272,670,602
25,112,Ivars de Noguera,340,170,170
25,113,Ivars d'Urgell,1715,870,845
25,114,Ivorra,154,82,72
25,910,Josa i Tuixén,141,78,63
25,118,Juncosa,582,310,272
25,119,Juneda,2996,1517,1479
25,121,Les,673,338,335
25,122,Linyola,2385,1184,1201
25,123,Lladorre,212,109,103
25,124,Lladurs,238,129,109
25,125,Llardecans,650,333,317
25,126,Llavorsí,273,141,132
25,120,Lleida,112035,54564,57471
25,127,Lles de Cerdanya,291,162,129
25,128,Llimiana,136,72,64
25,129,Llobera,240,125,115
25,133,Maials,1017,517,500
25,130,Maldà,300,152,148
25,131,Massalcoreig,658,319,339
25,132,Massoteres,169,85,84
25,134,Menàrguens,836,423,413
25,135,Miralcamp,1254,601,653
25,137,Mollerussa,9400,4676,4724
25,136,Molsosa (La),136,70,66
25,139,Montellà i Martinet,493,251,242
25,140,Montferrer i Castellbò,730,392,338
25,138,Montgai,813,413,400
25,142,Montoliu de Lleida,486,236,250
25,141,Montoliu de Segarra,208,112,96
25,143,Montornès de Segarra,105,48,57
25,145,Nalec,104,48,56
25,25,Naut Aran,1337,703,634
25,146,Navès,264,129,135
25,148,Odèn,285,162,123
25,149,Oliana,1844,950,894
25,150,Oliola,196,114,82
25,151,Olius,482,237,245
25,152,Oluges (Les),195,102,93
25,153,Omellons (Els),271,135,136
25,154,Omells de na Gaia (Els),152,86,66
25,155,Organyà,1010,513,497
25,156,Os de Balaguer,773,410,363
25,157,Ossó de Sió,214,104,110
25,158,Palau d'Anglesola (El),1623,815,808
25,164,Penelles,573,308,265
25,165,Peramola,375,196,179
25,166,Pinell de Solsonès,232,123,109
25,167,Pinós,325,181,144
25,911,Plans de Sió (Els),609,312,297
25,168,Poal (El),629,329,300
25,169,Pobla de Cérvoles (La),198,113,85
25,171,Pobla de Segur (La),2997,1448,1549
25,30,Pont de Bar (El),142,76,66
25,173,Pont de Suert (El),2167,1093,1074
25,172,Ponts,2292,1148,1144
25,174,Portella (La),585,312,273
25,175,Prats i Sansor,180,98,82
25,176,Preixana,437,221,216
25,177,Preixens,521,251,270
25,179,Prullans,208,107,101
25,180,Puiggròs,254,129,125
25,181,Puigverd d'Agramunt,223,118,105
25,182,Puigverd de Lleida,1005,497,508
25,183,Rialp,527,274,253
25,905,Ribera d'Ondara,531,275,256
25,185,Ribera d'Urgellet,743,391,352
25,186,Riner,276,139,137
25,189,Rosselló,1733,851,882
25,190,Salàs de Pallars,358,182,176
25,191,Sanaüja,462,227,235
25,196,Sant Esteve de la Sarga,116,70,46
25,192,Sant Guim de Freixenet,1056,515,541
25,197,Sant Guim de la Plana,206,105,101
25,193,Sant Llorenç de Morunys,900,444,456
25,902,Sant Martí de Riucorb,736,378,358
25,194,Sant Ramon,560,273,287
25,201,Sarroca de Bellera,147,82,65
25,200,Sarroca de Lleida,486,248,238
25,202,Senterada,117,62,55
25,35,Sentiu de Sió (La),468,224,244
25,204,Seròs,1800,969,831
25,203,Seu d'Urgell (La),10711,5230,5481
25,205,Sidamon,455,232,223
25,206,Soleràs (El),424,214,210
25,207,Solsona,7128,3574,3554
25,208,Soriguera,309,164,145
25,209,Sort,1718,865,853
25,210,Soses,1504,778,726
25,211,Sudanell,736,394,342
25,212,Sunyer,314,154,160
25,215,Talarn,365,191,174
25,216,Talavera,304,156,148
25,217,Tàrrega,11855,5770,6085
25,218,Tarrés,108,57,51
25,219,Tarroja de Segarra,200,103,97
25,220,Térmens,1401,709,692
25,221,Tírvia,116,61,55
25,222,Tiurana,22,15,7
25,223,Torà,1143,581,562
25,224,Torms (Els),198,109,89
25,225,Tornabous,830,422,408
25,227,Torre de Cabdella (La),691,342,349
25,226,Torrebesses,339,166,173
25,228,Torrefarrera,1593,810,783
25,907,Torrefeta i Florejacs,683,334,349
25,230,Torregrossa,2239,1105,1134
25,231,Torrelameu,585,315,270
25,232,Torres de Segre,1786,901,885
25,233,Torre-serona,310,158,152
25,234,Tremp,5503,2702,2801
25,43,Vall de Boí (La),757,429,328
25,901,Vall de Cardós,326,168,158
25,238,Vallbona de les Monges,272,133,139
25,240,Vallfogona de Balaguer,1430,722,708
25,906,Valls d'Aguilar (Les),302,157,145
25,239,Valls de Valira (Les),748,401,347
25,909,Vansa i Fórnols (La),174,88,86
25,242,Verdú,994,479,515
25,243,Vielha e Mijaran,3692,1875,1817
25,244,Vilagrassa,425,220,205
25,245,Vilaller,618,328,290
25,247,Vilamòs,148,72,76
25,248,Vilanova de Bellpuig,1184,582,602
25,254,Vilanova de la Barca,962,471,491
25,249,Vilanova de l'Aguda,296,156,140
25,250,Vilanova de Meià,485,253,232
25,251,Vilanova de Segrià,705,351,354
25,252,Vila-sana,533,261,272
25,253,Vilosell (El),201,89,112
25,255,Vinaixa,650,319,331
26,1,Abalos,289,168,121
26,2,Agoncillo,885,461,424
26,3,Aguilar del Río Alhama,728,371,357
26,4,Ajamil,79,53,26
26,5,Albelda de Iregua,2267,1147,1120
26,6,Alberite,1985,993,992
26,7,Alcanadre,836,428,408
26,8,Aldeanueva de Ebro,2523,1303,1220
26,9,Alesanco,510,262,248
26,10,Alesón,146,72,74
26,11,Alfaro,9257,4621,4636
26,12,Almarza de Cameros,40,25,15
26,13,Anguciana,318,163,155
26,14,Anguiano,643,359,284
26,15,Arenzana de Abajo,331,173,158
26,16,Arenzana de Arriba,41,23,18
26,17,Arnedillo,433,205,228
26,18,Arnedo,12715,6316,6399
26,19,Arrúbal,440,228,212
26,20,Ausejo,777,410,367
26,21,Autol,3381,1725,1656
26,22,Azofra,365,197,168
26,23,Badarán,771,408,363
26,24,Bañares,443,222,221
26,26,Baños de Río Tobía,1845,934,911
26,25,Baños de Rioja,117,68,49
26,27,Berceo,228,136,92
26,28,Bergasa,195,106,89
26,29,Bergasillas Bajera,33,19,14
26,30,Bezares,33,20,13
26,31,Bobadilla,175,96,79
26,32,Brieva de Cameros,77,45,32
26,33,Briñas,197,98,99
26,34,Briones,840,440,400
26,35,Cabezón de Cameros,32,21,11
26,36,Calahorra,18926,9161,9765
26,37,Camprovín,239,128,111
26,38,Canales de la Sierra,107,58,49
26,39,Canillas de Río Tuerto,75,36,39
26,40,Cañas,119,55,64
26,41,Cárdenas,253,126,127
26,42,Casalarreina,909,459,450
26,43,Castañares de Rioja,496,256,240
26,44,Castroviejo,63,32,31
26,45,Cellorigo,20,11,9
26,46,Cenicero,2102,1068,1034
26,47,Cervera del Río Alhama,3381,1737,1644
26,48,Cidamón,50,27,23
26,49,Cihuri,149,78,71
26,50,Cirueña,132,77,55
26,51,Clavijo,202,105,97
26,52,Cordovín,224,116,108
26,53,Corera,257,126,131
26,54,Cornago,637,347,290
26,55,Corporales,64,33,31
26,56,Cuzcurrita de Río Tirón,482,261,221
26,57,Daroca de Rioja,61,37,24
26,58,Enciso,188,114,74
26,59,Entrena,1121,583,538
26,60,Estollo,156,87,69
26,61,Ezcaray,1812,948,864
26,62,Foncea,130,68,62
26,63,Fonzaleche,175,104,71
26,64,Fuenmayor,2120,1055,1065
26,65,Galbárruli,69,38,31
26,66,Galilea,286,149,137
26,67,Gallinero de Cameros,31,20,11
26,68,Gimileo,95,47,48
26,69,Grañón,439,230,209
26,70,Grávalos,288,146,142
26,71,Haro,9119,4503,4616
26,72,Herce,378,188,190
26,73,Herramélluri,179,96,83
26,74,Hervías,204,108,96
26,75,Hormilla,497,261,236
26,76,Hormilleja,188,93,95
26,77,Hornillos de Cameros,26,14,12
26,78,Hornos de Moncalvillo,98,48,50
26,79,Huércanos,895,457,438
26,80,Igea,820,445,375
26,81,Jalón de Cameros,33,19,14
26,82,Laguna de Cameros,169,98,71
26,83,Lagunilla del Jubera,386,208,178
26,84,Lardero,3729,1859,1870
26,86,Ledesma de la Cogolla,20,13,7
26,87,Leiva,315,157,158
26,88,Leza de Río Leza,33,22,11
26,89,Logroño,123841,59526,64315
26,91,Lumbreras,183,112,71
26,92,Manjarrés,152,86,66
26,93,Mansilla de la Sierra,54,37,17
26,94,Manzanares de Rioja,132,70,62
26,95,Matute,174,83,91
26,96,Medrano,218,116,102
26,98,Munilla,120,64,56
26,99,Murillo de Río Leza,1573,798,775
26,100,Muro de Aguas,74,44,30
26,101,Muro en Cameros,43,28,15
26,102,Nájera,6952,3452,3500
26,103,Nalda,907,477,430
26,104,Navajún,19,12,7
26,105,Navarrete,2028,1027,1001
26,106,Nestares,77,41,36
26,107,Nieva de Cameros,122,64,58
26,109,Ochánduri,108,55,53
26,108,Ocón,353,201,152
26,110,Ojacastro,241,142,99
26,111,Ollauri,329,182,147
26,112,Ortigosa de Cameros,338,176,162
26,113,Pazuengos,51,33,18
26,114,Pedroso,119,65,54
26,115,Pinillos,31,17,14
26,117,Pradejón,2904,1504,1400
26,118,Pradillo,101,56,45
26,119,Préjano,222,111,111
26,120,Quel,1934,999,935
26,121,Rabanera,64,40,24
26,122,Rasillo de Cameros (El),125,63,62
26,123,Redal (El),216,106,110
26,124,Ribafrecha,1028,555,473
26,125,Rincón de Soto,3343,1680,1663
26,126,Robres del Castillo,20,13,7
26,127,Rodezno,324,170,154
26,128,Sajazarra,161,83,78
26,129,San Asensio,1345,703,642
26,130,San Millán de la Cogolla,288,179,109
26,131,San Millán de Yécora,63,38,25
26,132,San Román de Cameros,178,100,78
26,139,San Torcuato,110,58,52
26,142,San Vicente de la Sonsierra,1119,573,546
26,134,Santa Coloma,153,95,58
26,135,Santa Engracia del Jubera,232,139,93
26,136,Santa Eulalia Bajera,111,62,49
26,138,Santo Domingo de la Calzada,5661,2831,2830
26,140,Santurde de Rioja,329,164,165
26,141,Santurdejo,218,122,96
26,143,Sojuela,93,54,39
26,144,Sorzano,249,129,120
26,145,Sotés,267,143,124
26,146,Soto en Cameros,151,80,71
26,147,Terroba,37,21,16
26,148,Tirgo,282,144,138
26,149,Tobía,62,37,25
26,150,Tormantos,222,119,103
26,153,Torre en Cameros,11,8,3
26,151,Torrecilla en Cameros,554,293,261
26,152,Torrecilla sobre Alesanco,90,46,44
26,154,Torremontalbo,15,9,6
26,155,Treviana,284,150,134
26,157,Tricio,389,189,200
26,158,Tudelilla,464,236,228
26,160,Uruñuela,753,390,363
26,161,Valdemadera,19,10,9
26,162,Valgañón,182,99,83
26,163,Ventosa,136,74,62
26,164,Ventrosa,105,47,58
26,165,Viguera,376,215,161
26,166,Villalba de Rioja,161,95,66
26,167,Villalobar de Rioja,136,82,54
26,168,Villamediana de Iregua,1945,990,955
26,169,Villanueva de Cameros,126,67,59
26,170,Villar de Arnedo (El),697,335,362
26,171,Villar de Torre,338,175,163
26,172,Villarejo,46,26,20
26,173,Villarroya,9,4,5
26,174,Villarta-Quintana,225,113,112
26,175,Villavelayo,82,48,34
26,176,Villaverde de Rioja,105,59,46
26,177,Villoslada de Cameros,391,226,165
26,178,Viniegra de Abajo,131,70,61
26,179,Viniegra de Arriba,56,35,21
26,180,Zarratón,275,145,130
26,181,Zarzosa,18,13,5
26,183,Zorraquín,49,27,22
27,1,Abadín,3647,1718,1929
27,2,Alfoz,2553,1241,1312
27,3,Antas de Ulla,2969,1422,1547
27,4,Baleira,2055,1065,990
27,901,Baralla,3488,1799,1689
27,5,Barreiros,3574,1710,1864
27,6,Becerreá,3897,1969,1928
27,7,Begonte,4084,2014,2070
27,8,Bóveda,2185,1058,1127
27,902,Burela,7925,3939,3986
27,9,Carballedo,3517,1745,1772
27,10,Castro de Rei,5833,2937,2896
27,11,Castroverde,3650,1874,1776
27,12,Cervantes,2414,1310,1104
27,13,Cervo,5143,2584,2559
27,16,Chantada,10227,4984,5243
27,14,Corgo (O),4556,2281,2275
27,15,Cospeito,6122,3002,3120
27,17,Folgoso do Courel,1704,870,834
27,18,Fonsagrada (A),5948,3131,2817
27,19,Foz,9516,4554,4962
27,20,Friol,4911,2462,2449
27,22,Guitiriz,6589,3277,3312
27,23,Guntín,3732,1860,1872
27,24,Incio (O),2722,1338,1384
27,26,Láncara,3455,1797,1658
27,27,Lourenzá,2980,1444,1536
27,28,Lugo,85174,40129,45045
27,29,Meira,1837,905,932
27,30,Mondoñedo,5398,2502,2896
27,31,Monforte de Lemos,19180,9184,9996
27,32,Monterroso,4484,2221,2263
27,33,Muras,1218,599,619
27,34,Navia de Suarna,2116,1145,971
27,35,Negueira de Muñiz,310,159,151
27,37,Nogais (As),1738,907,831
27,38,Ourol,1663,803,860
27,39,Outeiro de Rei,4115,2063,2052
27,40,Palas de Rei,4537,2237,2300
27,41,Pantón,3737,1778,1959
27,42,Paradela,2867,1433,1434
27,43,Páramo (O),2018,1040,978
27,44,Pastoriza (A),4197,2096,2101
27,45,Pedrafita do Cebreiro,1716,920,796
27,47,Pobra de Brollón (A),2885,1404,1481
27,46,Pol,2312,1130,1182
27,48,Pontenova (A),3528,1722,1806
27,49,Portomarín,2171,1074,1097
27,50,Quiroga,4702,2341,2361
27,56,Rábade,1588,796,792
27,51,Ribadeo,8813,4125,4688
27,52,Ribas de Sil,1588,763,825
27,53,Ribeira de Piquín,986,487,499
27,54,Riotorto,2046,1009,1037
27,55,Samos,2242,1185,1057
27,57,Sarria,13023,6378,6645
27,58,Saviñao (O),5373,2630,2743
27,59,Sober,3331,1600,1731
27,60,Taboada,4503,2200,2303
27,61,Trabada,1817,870,947
27,62,Triacastela,970,484,486
27,63,Valadouro (O),2603,1290,1313
27,64,Vicedo (O),2564,1247,1317
27,65,Vilalba,15797,7684,8113
27,66,Viveiro,15209,7362,7847
27,21,Xermade,2938,1446,1492
27,25,Xove,3613,1817,1796
28,1,Acebeda (La),53,28,25
28,2,Ajalvir,1622,842,780
28,3,Alameda del Valle,166,93,73
28,4,Alamo (El),3878,1991,1887
28,5,Alcalá de Henares,163386,81302,82084
28,6,Alcobendas,83031,40979,42052
28,7,Alcorcón,141465,69960,71505
28,8,Aldea del Fresno,1236,634,602
28,9,Algete,12335,6293,6042
28,10,Alpedrete,5211,2611,2600
28,11,Ambite,290,144,146
28,12,Anchuelo,596,327,269
28,13,Aranjuez,38900,18804,20096
28,14,Arganda del Rey,29224,14491,14733
28,15,Arroyomolinos,2709,1368,1341
28,16,Atazar (El),96,52,44
28,17,Batres,639,322,317
28,18,Becerril de la Sierra,2707,1406,1301
28,19,Belmonte de Tajo,1142,576,566
28,21,Berrueco (El),318,168,150
28,20,Berzosa del Lozoya,116,58,58
28,22,Boadilla del Monte,17814,9029,8785
28,23,Boalo (El),2451,1236,1215
28,24,Braojos,155,81,74
28,25,Brea de Tajo,489,247,242
28,26,Brunete,3940,1947,1993
28,27,Buitrago del Lozoya,1403,686,717
28,28,Bustarviejo,1345,685,660
28,29,Cabanillas de la Sierra,410,208,202
28,30,Cabrera (La),1337,662,675
28,31,Cadalso de los Vidrios,2217,1131,1086
28,32,Camarma de Esteruelas,2086,1040,1046
28,33,Campo Real,2548,1287,1261
28,34,Canencia,474,246,228
28,35,Carabaña,1063,528,535
28,36,Casarrubuelos,622,341,281
28,37,Cenicientos,1898,943,955
28,38,Cercedilla,5051,2472,2579
28,39,Cervera de Buitrago,97,53,44
28,51,Chapinería,1145,583,562
28,52,Chinchón,3849,1912,1937
28,40,Ciempozuelos,12445,6305,6140
28,41,Cobeña,2074,1050,1024
28,46,Collado Mediano,3681,1859,1822
28,47,Collado Villalba,36950,18363,18587
28,43,Colmenar de Oreja,5596,2737,2859
28,42,Colmenar del Arroyo,816,382,434
28,45,Colmenar Viejo,28328,14041,14287
28,44,Colmenarejo,3558,1792,1766
28,48,Corpa,384,196,188
28,49,Coslada,76001,37788,38213
28,50,Cubas de la Sagra,1149,567,582
28,53,Daganzo de Arriba,2429,1225,1204
28,54,Escorial (El),8554,4265,4289
28,55,Estremera,1076,555,521
28,56,Fresnedillas de la Oliva,635,320,315
28,57,Fresno de Torote,499,262,237
28,58,Fuenlabrada,163567,82166,81401
28,59,Fuente el Saz de Jarama,3208,1647,1561
28,60,Fuentidueña de Tajo,1398,680,718
28,61,Galapagar,16503,8324,8179
28,62,Garganta de los Montes,329,167,162
28,63,Gargantilla del Lozoya,212,123,89
28,64,Gascones,102,54,48
28,65,Getafe,143153,71183,71970
28,66,Griñón,3748,1939,1809
28,67,Guadalix de la Sierra,2481,1265,1216
28,68,Guadarrama,7830,3857,3973
28,69,Hiruela (La),56,30,26
28,70,Horcajo de la Sierra,127,71,56
28,71,Horcajuelo de la Sierra,91,45,46
28,72,Hoyo de Manzanares,5080,2570,2510
28,73,Humanes de Madrid,8305,4244,4061
28,74,Leganés,174593,87000,87593
28,75,Loeches,2672,1338,1334
28,76,Lozoya,444,232,212
28,901,Lozoyuela-Navas-Sieteiglesias,622,330,292
28,78,Madarcos,36,17,19
28,79,Madrid,2866850,1338558,1528292
28,80,Majadahonda,40042,19489,20553
28,82,Manzanares el Real,3087,1577,1510
28,83,Meco,4142,2099,2043
28,84,Mejorada del Campo,14677,7378,7299
28,85,Miraflores de la Sierra,3365,1693,1672
28,86,Molar (El),3422,1789,1633
28,87,Molinos (Los),2957,1418,1539
28,88,Montejo de la Sierra,279,130,149
28,89,Moraleja de Enmedio,2289,1135,1154
28,90,Moralzarzal,3672,1867,1805
28,91,Morata de Tajuña,5438,2643,2795
28,92,Móstoles,196173,97345,98828
28,93,Navacerrada,1778,875,903
28,94,Navalafuente,459,253,206
28,95,Navalagamella,939,477,462
28,96,Navalcarnero,11601,5874,5727
28,97,Navarredonda,99,52,47
28,99,Navas del Rey,1440,734,706
28,100,Nuevo Baztán,2108,1077,1031
28,101,Olmeda de las Fuentes,146,80,66
28,102,Orusco de Tajuña,670,342,328
28,104,Paracuellos de Jarama,5293,2705,2588
28,106,Parla,69163,34531,34632
28,107,Patones,360,184,176
28,108,Pedrezuela,1154,616,538
28,109,Pelayos de la Presa,1198,589,609
28,110,Perales de Tajuña,1991,962,1029
28,111,Pezuela de las Torres,540,277,263
28,112,Pinilla del Valle,167,92,75
28,113,Pinto,25038,12437,12601
28,114,Piñuécar,160,75,85
28,115,Pozuelo de Alarcón,60120,29425,30695
28,116,Pozuelo del Rey,252,133,119
28,117,Prádena del Rincón,110,60,50
28,118,Puebla de la Sierra,78,45,33
28,902,Puentes Viejas,414,218,196
28,119,Quijorna,829,437,392
28,120,Rascafría,1459,757,702
28,121,Redueña,163,79,84
28,122,Ribatejada,307,168,139
28,123,Rivas-Vaciamadrid,22620,11258,11362
28,124,Robledillo de la Jara,84,42,42
28,125,Robledo de Chavela,2139,1063,1076
28,126,Robregordo,88,43,45
28,127,Rozas de Madrid (Las),45280,22129,23151
28,128,Rozas de Puerto Real,319,168,151
28,129,San Agustín de Guadalix,4603,2341,2262
28,130,San Fernando de Henares,29688,14882,14806
28,131,San Lorenzo de El Escorial,10828,5234,5594
28,132,San Martín de la Vega,8995,4585,4410
28,133,San Martín de Valdeiglesias,5969,2958,3011
28,134,San Sebastián de los Reyes,57632,28690,28942
28,135,Santa María de la Alameda,752,415,337
28,136,Santorcaz,529,273,256
28,137,Santos de la Humosa (Los),918,469,449
28,138,Serna del Monte (La),111,59,52
28,140,Serranillos del Valle,810,419,391
28,141,Sevilla la Nueva,2650,1368,1282
28,143,Somosierra,99,55,44
28,144,Soto del Real,3992,2028,1964
28,145,Talamanca de Jarama,1334,654,680
28,146,Tielmes,1973,1001,972
28,147,Titulcia,918,457,461
28,148,Torrejón de Ardoz,88821,44315,44506
28,149,Torrejón de la Calzada,3219,1557,1662
28,150,Torrejón de Velasco,1504,774,730
28,151,Torrelaguna,2612,1256,1356
28,152,Torrelodones,10743,5264,5479
28,153,Torremocha de Jarama,322,162,160
28,154,Torres de la Alameda,3925,1970,1955
28,903,Tres Cantos,27715,13742,13973
28,155,Valdaracete,650,318,332
28,156,Valdeavero,556,291,265
28,157,Valdelaguna,540,294,246
28,158,Valdemanco,515,272,243
28,159,Valdemaqueda,553,277,276
28,160,Valdemorillo,3997,2045,1952
28,161,Valdemoro,21240,10630,10610
28,162,Valdeolmos-Alalpardo,1625,853,772
28,163,Valdepiélagos,327,168,159
28,164,Valdetorres de Jarama,1662,854,808
28,165,Valdilecha,1797,907,890
28,166,Valverde de Alcalá,265,140,125
28,167,Velilla de San Antonio,4597,2321,2276
28,168,Vellón (El),1045,536,509
28,169,Venturada,539,274,265
28,171,Villa del Prado,3758,1905,1853
28,170,Villaconejos,2909,1476,1433
28,172,Villalbilla,3586,1839,1747
28,173,Villamanrique de Tajo,585,293,292
28,174,Villamanta,1499,753,746
28,175,Villamantilla,338,174,164
28,176,Villanueva de la Cañada,7913,3912,4001
28,178,Villanueva de Perales,444,250,194
28,177,Villanueva del Pardillo,2887,1469,1418
28,179,Villar del Olmo,1010,518,492
28,180,Villarejo de Salvanés,5384,2675,2709
28,181,Villaviciosa de Odón,17019,8441,8578
28,182,Villavieja del Lozoya,180,86,94
28,183,Zarzalejo,1002,516,486
29,1,Alameda,4960,2494,2466
29,2,Alcaucín,1484,760,724
29,3,Alfarnate,1447,742,705
29,4,Alfarnatejo,422,234,188
29,5,Algarrobo,4735,2389,2346
29,6,Algatocín,1014,529,485
29,7,Alhaurín de la Torre,16914,8477,8437
29,8,Alhaurín el Grande,16859,8381,8478
29,9,Almáchar,1967,1015,952
29,10,Almargen,2146,1083,1063
29,11,Almogía,4263,2169,2094
29,12,Alora,12862,6459,6403
29,13,Alozaina,2274,1190,1084
29,14,Alpandeire,303,153,150
29,15,Antequera,40181,19592,20589
29,16,Archez,341,179,162
29,17,Archidona,8246,4124,4122
29,18,Ardales,3030,1516,1514
29,19,Arenas,1218,645,573
29,20,Arriate,3430,1702,1728
29,21,Atajate,177,97,80
29,22,Benadalid,264,145,119
29,23,Benahavís,1721,855,866
29,24,Benalauría,521,277,244
29,25,Benalmádena,27147,13291,13856
29,26,Benamargosa,1590,811,779
29,27,Benamocarra,2779,1423,1356
29,28,Benaoján,1704,842,862
29,29,Benarrabá,647,322,325
29,30,Borge (El),1046,537,509
29,31,Burgo (El),2070,1070,1000
29,32,Campillos,7737,3875,3862
29,33,Canillas de Aceituno,2327,1169,1158
29,34,Canillas de Albaida,659,347,312
29,35,Cañete la Real,2247,1154,1093
29,36,Carratraca,870,433,437
29,37,Cartajima,257,137,120
29,38,Cártama,12713,6412,6301
29,39,Casabermeja,3034,1583,1451
29,40,Casarabonela,2600,1344,1256
29,41,Casares,3206,1658,1548
29,42,Coín,17572,8753,8819
29,43,Colmenar,3138,1561,1577
29,44,Comares,1405,719,686
29,45,Cómpeta,2684,1361,1323
29,46,Cortes de la Frontera,3643,1818,1825
29,47,Cuevas Bajas,1516,716,800
29,49,Cuevas de San Marcos,4079,2039,2040
29,48,Cuevas del Becerro,2038,1049,989
29,50,Cútar,615,306,309
29,51,Estepona,37557,18654,18903
29,52,Faraján,310,159,151
29,53,Frigiliana,2149,1054,1095
29,54,Fuengirola,41713,20196,21517
29,55,Fuente de Piedra,2059,1008,1051
29,56,Gaucín,1660,857,803
29,57,Genalguacil,624,322,302
29,58,Guaro,2011,1019,992
29,59,Humilladero,2514,1273,1241
29,60,Igualeja,969,483,486
29,61,Istán,1320,660,660
29,62,Iznate,754,390,364
29,63,Jimera de Líbar,428,209,219
29,64,Jubrique,866,436,430
29,65,Júzcar,219,124,95
29,66,Macharaviaya,324,173,151
29,67,Málaga,549135,263864,285271
29,68,Manilva,5131,2621,2510
29,69,Marbella,98823,48698,50125
29,70,Mijas,35423,17753,17670
29,71,Moclinejo,1021,519,502
29,72,Mollina,3276,1618,1658
29,73,Monda,1620,841,779
29,74,Montejaque,1069,527,542
29,75,Nerja,14965,7369,7596
29,76,Ojén,2004,1055,949
29,77,Parauta,252,136,116
29,79,Periana,3466,1790,1676
29,80,Pizarra,6586,3311,3275
29,81,Pujerra,347,194,153
29,82,Rincón de la Victoria,19247,9562,9685
29,83,Riogordo,2662,1355,1307
29,84,Ronda,34385,16830,17555
29,85,Salares,237,118,119
29,86,Sayalonga,1138,591,547
29,87,Sedella,526,287,239
29,88,Sierra de Yeguas,3203,1607,1596
29,89,Teba,4386,2226,2160
29,90,Tolox,2571,1333,1238
29,901,Torremolinos,35408,17314,18094
29,91,Torrox,11869,5889,5980
29,92,Totalán,609,315,294
29,93,Valle de Abdalajís,3081,1552,1529
29,94,Vélez-Málaga,53071,26392,26679
29,95,Villanueva de Algaidas,4175,2049,2126
29,98,Villanueva de Tapia,1642,828,814
29,96,Villanueva del Rosario,3270,1600,1670
29,97,Villanueva del Trabuco,4674,2364,2310
29,99,Viñuela,1165,590,575
29,100,Yunquera,3274,1698,1576
30,1,Abanilla,6130,3026,3104
30,2,Abarán,12002,5938,6064
30,3,Aguilas,25702,12824,12878
30,4,Albudeite,1328,666,662
30,5,Alcantarilla,31872,15570,16302
30,902,Alcázares (Los),5501,2762,2739
30,6,Aledo,991,507,484
30,7,Alguazas,6973,3452,3521
30,8,Alhama de Murcia,15318,7621,7697
30,9,Archena,14163,7031,7132
30,10,Beniel,7862,3901,3961
30,11,Blanca,5690,2811,2879
30,12,Bullas,10488,5293,5195
30,13,Calasparra,8917,4475,4442
30,14,Campos del Río,2019,990,1029
30,15,Caravaca de la Cruz,21824,10844,10980
30,16,Cartagena,170483,83828,86655
30,17,Cehegín,14085,7031,7054
30,18,Ceutí,6924,3497,3427
30,19,Cieza,31680,15442,16238
30,20,Fortuna,6295,3212,3083
30,21,Fuente Alamo de Murcia,9046,4523,4523
30,22,Jumilla,20439,10143,10296
30,23,Librilla,3759,1849,1910
30,24,Lorca,69045,34099,34946
30,25,Lorquí,5424,2671,2753
30,26,Mazarrón,16142,8136,8006
30,27,Molina de Segura,41109,20264,20845
30,28,Moratalla,8621,4369,4252
30,29,Mula,13386,6636,6750
30,30,Murcia,345759,168065,177694
30,31,Ojós,608,303,305
30,32,Pliego,3373,1723,1650
30,33,Puerto Lumbreras,10474,5091,5383
30,34,Ricote,1603,778,825
30,35,San Javier,16773,8561,8212
30,36,San Pedro del Pinatar,13644,6704,6940
30,901,Santomera,9978,4996,4982
30,37,Torre-Pacheco,20345,10797,9548
30,38,Torres de Cotillas (Las),15093,7557,7536
30,39,Totana,21441,10718,10723
30,40,Ulea,1010,505,505
30,41,Unión (La),14046,6952,7094
30,42,Villanueva del Río Segura,1469,701,768
30,43,Yecla,28415,14207,14208
31,1,Abáigar,95,51,44
31,2,Abárzuza,508,249,259
31,3,Abaurregaina/Abaurrea Alta,192,111,81
31,4,Abaurrepea/Abaurrea Baja,48,33,15
31,5,Aberin,365,192,173
31,6,Ablitas,2231,1140,1091
31,7,Adiós,125,61,64
31,8,Aguilar de Codés,112,61,51
31,9,Aibar,933,487,446
31,11,Allín,819,429,390
31,12,Allo,1049,516,533
31,10,Altsasu/Alsasua,7004,3543,3461
31,13,Améscoa Baja,844,443,401
31,14,Ancín,276,139,137
31,15,Andosilla,2511,1258,1253
31,16,Ansoáin,5396,2745,2651
31,17,Anue,449,261,188
31,18,Añorbe,401,220,181
31,19,Aoiz/Agoitz,1848,913,935
31,20,Araitz,613,359,254
31,25,Arakil,856,451,405
31,21,Aranarache,93,46,47
31,23,Aranguren,2786,1452,1334
31,24,Arano,154,80,74
31,22,Arantza,714,397,317
31,26,Aras,227,118,109
31,27,Arbizu,919,477,442
31,28,Arce,317,179,138
31,29,Arcos (Los),1346,669,677
31,30,Arellano,205,109,96
31,31,Areso,310,159,151
31,32,Arguedas,2221,1102,1119
31,33,Aria,69,43,26
31,34,Aribe,70,34,36
31,35,Armañanzas,100,52,48
31,36,Arróniz,1212,634,578
31,37,Arruazu,110,60,50
31,38,Artajona,1676,884,792
31,39,Artazu,86,48,38
31,40,Atez,213,131,82
31,58,Auritz/Burguete,320,146,174
31,41,Ayegui,849,440,409
31,42,Azagra,3496,1749,1747
31,43,Azuelo,63,30,33
31,44,Bakaiku,359,199,160
31,901,Barañain,18936,9330,9606
31,45,Barásoain,465,229,236
31,46,Barbarin,106,50,56
31,47,Bargota,396,201,195
31,48,Barillas,211,101,110
31,49,Basaburua,682,391,291
31,50,Baztan,7806,3969,3837
31,137,Beintza-Labaien,303,169,134
31,51,Beire,349,168,181
31,52,Belascoáin,96,48,48
31,250,Bera/Vera de Bidasoa,3480,1769,1711
31,53,Berbinzana,714,363,351
31,905,Beriáin,2317,1150,1167
31,902,Berrioplano,1057,528,529
31,903,Berriozar,5500,2814,2686
31,54,Bertizarana,651,326,325
31,55,Betelu,334,188,146
31,56,Biurrun-Olcoz,173,90,83
31,57,Buñuel,2390,1171,1219
31,59,Burgui,253,140,113
31,60,Burlada,15366,7593,7773
31,61,Busto (El),105,55,50
31,62,Cabanillas,1464,747,717
31,63,Cabredo,130,68,62
31,64,Cadreita,1873,920,953
31,65,Caparroso,2331,1140,1191
31,66,Cárcar,1257,612,645
31,67,Carcastillo,2670,1333,1337
31,68,Cascante,3555,1745,1810
31,69,Cáseda,1078,535,543
31,70,Castejón,3173,1582,1591
31,71,Castillonuevo,27,17,10
31,72,Cintruénigo,5430,2696,2734
31,74,Cirauqui,454,252,202
31,75,Ciriza,52,19,33
31,76,Cizur,1105,555,550
31,77,Corella,6329,3161,3168
31,78,Cortes,3196,1625,1571
31,79,Desojo,151,84,67
31,80,Dicastillo,708,372,336
31,81,Donamaria,394,195,199
31,221,Doneztebe/Santesteban,1291,648,643
31,83,Echarri,58,31,27
31,86,Egüés,8467,4267,4200
31,87,Elgorriaga,198,99,99
31,89,Enériz,185,93,92
31,90,Eratsun,189,116,73
31,91,Ergoiena,491,277,214
31,92,Erro,787,427,360
31,94,Eslava,196,99,97
31,95,Esparza de Salazar,122,64,58
31,96,Espronceda,178,100,78
31,97,Estella/Lizarra,12552,6051,6501
31,98,Esteribar,1475,781,694
31,99,Etayo,95,49,46
31,82,Etxalar,837,433,404
31,84,Etxarri-Aranatz,2372,1223,1149
31,85,Etxauri,383,197,186
31,100,Eulate,403,206,197
31,101,Ezcabarte,1085,575,510
31,93,Ezcároz,364,197,167
31,102,Ezkurra,253,157,96
31,103,Ezprogui,67,34,33
31,104,Falces,2661,1316,1345
31,105,Fitero,2083,1041,1042
31,106,Fontellas,651,330,321
31,107,Funes,2112,1068,1044
31,108,Fustiñana,2295,1153,1142
31,109,Galar,1032,545,487
31,110,Gallipienzo,161,93,68
31,111,Gallués,124,76,48
31,112,Garaioa,126,69,57
31,113,Garde,201,110,91
31,114,Garínoain,299,161,138
31,115,Garralda,227,119,108
31,116,Genevilla,127,67,60
31,117,Goizueta,949,512,437
31,118,Goñi,206,115,91
31,119,Güesa,79,45,34
31,120,Guesálaz,458,269,189
31,121,Guirguillano,80,44,36
31,256,Hiriberri/Villanueva de Aezkoa,156,82,74
31,122,Huarte/Uharte,2750,1389,1361
31,124,Ibargoiti,218,126,92
31,259,Igantzi,595,312,283
31,125,Igúzquiza,343,170,173
31,126,Imotz,405,223,182
31,127,Irañeta,161,85,76
31,904,Irurtzun,1991,1019,972
31,128,Isaba,562,272,290
31,129,Ituren,462,233,229
31,130,Iturmendi,360,186,174
31,131,Iza,660,344,316
31,132,Izagaondoa,178,107,71
31,133,Izalzu,49,27,22
31,134,Jaurrieta,268,145,123
31,135,Javier,143,62,81
31,136,Juslapeña,464,256,208
31,138,Lakuntza,1003,518,485
31,139,Lana,213,120,93
31,140,Lantz,122,77,45
31,141,Lapoblación,183,102,81
31,142,Larraga,1900,993,907
31,143,Larraona,164,83,81
31,144,Larraun,1120,616,504
31,145,Lazagurría,245,130,115
31,146,Leache,50,29,21
31,147,Legarda,71,41,30
31,148,Legaria,152,83,69
31,149,Leitza,3086,1604,1482
31,908,Lekunberri,846,431,415
31,150,Leoz,260,158,102
31,151,Lerga,87,46,41
31,152,Lerín,1932,956,976
31,153,Lesaka,2728,1435,1293
31,154,Lezáun,262,148,114
31,155,Liédena,322,156,166
31,156,Lizoáin,231,130,101
31,157,Lodosa,4607,2333,2274
31,158,Lónguida,288,151,137
31,159,Lumbier,1420,753,667
31,160,Luquin,132,73,59
31,248,Luzaide/Valcarlos,467,232,235
31,161,Mañeru,365,182,183
31,162,Marañón,76,40,36
31,163,Marcilla,2384,1202,1182
31,164,Mélida,844,429,415
31,165,Mendavia,3521,1753,1768
31,166,Mendaza,401,186,215
31,167,Mendigorría,901,463,438
31,168,Metauten,311,170,141
31,169,Milagro,2585,1265,1320
31,170,Mirafuentes,57,28,29
31,171,Miranda de Arga,978,490,488
31,172,Monreal,295,156,139
31,173,Monteagudo,1189,596,593
31,174,Morentin,120,57,63
31,175,Mues,119,64,55
31,176,Murchante,2997,1477,1520
31,177,Murieta,281,156,125
31,178,Murillo el Cuende,669,360,309
31,179,Murillo el Fruto,780,389,391
31,180,Muruzábal,212,109,103
31,181,Navascués,222,134,88
31,182,Nazar,59,33,26
31,88,Noáin (Valle de Elorz),3857,1924,1933
31,183,Obanos,750,362,388
31,185,Ochagavía,701,360,341
31,184,Oco,91,53,38
31,186,Odieta,329,178,151
31,187,Oitz,159,94,65
31,188,Olaibar,169,92,77
31,189,Olazti/Olazagutía,1622,832,790
31,190,Olejua,58,28,30
31,191,Olite,3106,1557,1549
31,194,Ollo,363,209,154
31,192,Olóriz,172,97,75
31,193,Olza,1216,613,603
31,195,Orbaitzeta,243,135,108
31,196,Orbara,67,36,31
31,906,Orcoyen,1250,642,608
31,197,Orísoain,98,52,46
31,198,Oronz,53,29,24
31,199,Oroz-Betelu,232,129,103
31,211,Orreaga/Roncesvalles,32,18,14
31,200,Oteiza,921,482,439
31,201,Pamplona/Iruña,166279,79101,87178
31,202,Peralta,4668,2324,2344
31,203,Petilla de Aragón,52,27,25
31,204,Piedramillera,75,42,33
31,205,Pitillas,614,312,302
31,206,Puente la Reina/Gares,2120,1052,1068
31,207,Pueyo,333,175,158
31,208,Ribaforada,3165,1640,1525
31,209,Romanzado,161,92,69
31,210,Roncal,364,185,179
31,212,Sada,255,139,116
31,213,Saldías,157,85,72
31,214,Salinas de Oro,107,65,42
31,215,San Adrián,5241,2538,2703
31,217,San Martín de Unx,494,263,231
31,216,Sangüesa,4553,2338,2215
31,219,Sansol,127,63,64
31,220,Santacara,1049,539,510
31,222,Sarriés,84,49,35
31,223,Sartaguda,1376,691,685
31,224,Sesma,1408,697,711
31,225,Sorlada,53,27,26
31,226,Sunbilla,659,343,316
31,227,Tafalla,10017,4901,5116
31,228,Tiebas-Muruarte de Reta,594,318,276
31,229,Tirapu,70,38,32
31,230,Torralba del Río,158,86,72
31,231,Torres del Río,198,98,100
31,232,Tudela,26857,12995,13862
31,233,Tulebras,102,35,67
31,234,Ucar,114,62,52
31,123,Uharte-Arakil,794,421,373
31,235,Ujué,254,131,123
31,236,Ultzama,1646,831,815
31,237,Unciti,231,132,99
31,238,Unzué,132,77,55
31,239,Urdazubi/Urdax,420,202,218
31,240,Urdiain,638,327,311
31,241,Urraul Alto,150,87,63
31,242,Urraul Bajo,284,130,154
31,244,Urrotz,216,119,97
31,243,Urroz,363,181,182
31,245,Urzainqui,111,58,53
31,246,Uterga,141,67,74
31,247,Uztárroz,289,145,144
31,249,Valtierra,2459,1208,1251
31,251,Viana,3389,1730,1659
31,252,Vidángoz,117,61,56
31,253,Vidaurreta,101,62,39
31,254,Villafranca,2515,1208,1307
31,255,Villamayor de Monjardín,118,66,52
31,257,Villatuerta,786,399,387
31,258,Villava/Atarrabia,8570,4287,4283
31,260,Yerri,1528,812,716
31,261,Yesa,272,155,117
31,262,Zabalza,141,62,79
31,73,Ziordia,372,173,199
31,907,Zizur Mayor/Zizur Nagusia,8248,4121,4127
31,263,Zubieta,321,186,135
31,264,Zugarramurdi,247,131,116
31,265,Zúñiga,130,74,56
32,1,Allariz,5178,2485,2693
32,2,Amoeiro,2291,1116,1175
32,3,Arnoia (A),1209,569,640
32,4,Avión,3001,1328,1673
32,5,Baltar,1361,680,681
32,6,Bande,2798,1327,1471
32,7,Baños de Molgas,2292,1135,1157
32,8,Barbadás,5239,2516,2723
32,9,Barco de Valdeorras (O),11828,5887,5941
32,10,Beade,608,298,310
32,11,Beariz,1735,794,941
32,12,Blancos (Os),1269,637,632
32,13,Boborás,3712,1719,1993
32,14,Bola (A),1648,772,876
32,15,Bolo (O),1655,817,838
32,16,Calvos de Randín,1394,681,713
32,18,Carballeda de Avia,1792,859,933
32,17,Carballeda de Valdeorras,2397,1212,1185
32,19,Carballiño (O),12146,5782,6364
32,20,Cartelle,4073,1974,2099
32,22,Castrelo de Miño,2121,1013,1108
32,21,Castrelo do Val,1327,657,670
32,23,Castro Caldelas,2028,1024,1004
32,24,Celanova,6065,2877,3188
32,25,Cenlle,1833,869,964
32,29,Chandrexa de Queixa,984,541,443
32,26,Coles,3082,1511,1571
32,27,Cortegada,1484,701,783
32,28,Cualedro,2542,1286,1256
32,30,Entrimo,1523,682,841
32,31,Esgos,1438,693,745
32,33,Gomesende,1271,591,680
32,34,Gudiña (A),1866,945,921
32,35,Irixo (O),2284,1037,1247
32,38,Larouco,634,300,334
32,39,Laza,2194,1089,1105
32,40,Leiro,2100,999,1101
32,41,Lobeira,1298,633,665
32,42,Lobios,2797,1338,1459
32,43,Maceda,3467,1660,1807
32,44,Manzaneda,1417,730,687
32,45,Maside,3473,1629,1844
32,46,Melón,1691,749,942
32,47,Merca (A),2458,1168,1290
32,48,Mezquita (A),1596,793,803
32,49,Montederramo,1384,708,676
32,50,Monterrei,3563,1781,1782
32,51,Muíños,2207,1067,1140
32,52,Nogueira de Ramuín,2713,1278,1435
32,53,Oímbra,2054,1015,1039
32,54,Ourense,107060,50368,56692
32,55,Paderne de Allariz,1781,834,947
32,56,Padrenda,2843,1352,1491
32,57,Parada de Sil,980,477,503
32,58,Pereiro de Aguiar (O),4718,2294,2424
32,59,Peroxa (A),2677,1260,1417
32,60,Petín,1187,570,617
32,61,Piñor,1722,861,861
32,63,Pobra de Trives (A),3044,1539,1505
32,64,Pontedeva,807,373,434
32,62,Porqueira,1229,601,628
32,65,Punxín,1025,486,539
32,66,Quintela de Leirado,1030,474,556
32,67,Rairiz de Veiga,2001,979,1022
32,68,Ramirás,2100,970,1130
32,69,Ribadavia,5650,2698,2952
32,71,Riós,2467,1238,1229
32,72,Rúa (A),5018,2462,2556
32,73,Rubiá,1937,962,975
32,74,San Amaro,1656,803,853
32,75,San Cibrao das Viñas,3310,1603,1707
32,76,San Cristovo de Cea,3447,1682,1765
32,70,San Xoán de Río,1137,546,591
32,77,Sandiás,1749,810,939
32,78,Sarreaus,2099,1050,1049
32,79,Taboadela,1756,876,880
32,80,Teixeira (A),627,299,328
32,81,Toén,2636,1321,1315
32,82,Trasmiras,1914,930,984
32,83,Veiga (A),1538,762,776
32,84,Verea,1505,712,793
32,85,Verín,12271,6000,6271
32,86,Viana do Bolo,4389,2178,2211
32,87,Vilamarín,2269,1095,1174
32,88,Vilamartín de Valdeorras,2537,1250,1287
32,89,Vilar de Barrio,2265,1137,1128
32,90,Vilar de Santos,1058,520,538
32,91,Vilardevós,3079,1557,1522
32,92,Vilariño de Conso,877,481,396
32,32,Xinzo de Limia,9716,4834,4882
32,36,Xunqueira de Ambía,2150,1040,1110
32,37,Xunqueira de Espadanedo,1132,542,590
33,1,Allande,2613,1335,1278
33,2,Aller,16347,8120,8227
33,3,Amieva,958,504,454
33,4,Avilés,85696,41237,44459
33,5,Belmonte de Miranda,2456,1267,1189
33,6,Bimenes,2285,1080,1205
33,7,Boal,2720,1344,1376
33,8,Cabrales,2393,1217,1176
33,9,Cabranes,1344,661,683
33,10,Candamo,2688,1297,1391
33,12,Cangas de Onís,6285,3078,3207
33,11,Cangas del Narcea,18110,9217,8893
33,13,Caravia,577,292,285
33,14,Carreño,10533,5129,5404
33,15,Caso,2118,1110,1008
33,16,Castrillón,22361,10838,11523
33,17,Castropol,4547,2172,2375
33,18,Coaña,3846,1867,1979
33,19,Colunga,4681,2294,2387
33,20,Corvera de Asturias,16502,8155,8347
33,21,Cudillero,6218,3047,3171
33,22,Degaña,1605,850,755
33,23,Franco (El),4193,2044,2149
33,24,Gijón,264381,125734,138647
33,25,Gozón,11410,5535,5875
33,26,Grado,12051,5805,6246
33,27,Grandas de Salime,1387,716,671
33,28,Ibias,2307,1237,1070
33,29,Illano,689,364,325
33,30,Illas,1225,642,583
33,31,Langreo,50597,24269,26328
33,32,Laviana,15085,7335,7750
33,33,Lena,14323,6998,7325
33,35,Llanera,11407,5600,5807
33,36,Llanes,13184,6299,6885
33,37,Mieres,51423,24752,26671
33,38,Morcín,2933,1428,1505
33,39,Muros de Nalón,2497,1173,1324
33,40,Nava,5681,2781,2900
33,41,Navia,9136,4392,4744
33,42,Noreña,4207,2005,2202
33,43,Onís,915,464,451
33,44,Oviedo,200049,93426,106623
33,45,Parres,5574,2707,2867
33,46,Peñamellera Alta,783,389,394
33,47,Peñamellera Baja,1683,840,843
33,48,Pesoz,268,134,134
33,49,Piloña,9215,4468,4747
33,50,Ponga,788,454,334
33,51,Pravia,9694,4652,5042
33,52,Proaza,960,489,471
33,53,Quirós,1738,908,830
33,54,Regueras (Las),2268,1117,1151
33,55,Ribadedeva,1916,928,988
33,56,Ribadesella,6295,3016,3279
33,57,Ribera de Arriba,2095,1028,1067
33,58,Riosa,2663,1365,1298
33,59,Salas,7416,3641,3775
33,61,San Martín de Oscos,560,293,267
33,60,San Martín del Rey Aurelio,22129,10653,11476
33,63,San Tirso de Abres,675,331,344
33,62,Santa Eulalia de Oscos,607,310,297
33,64,Santo Adriano,357,183,174
33,65,Sariego,1452,716,736
33,66,Siero,46315,22430,23885
33,67,Sobrescobio,769,402,367
33,68,Somiedo,1664,875,789
33,69,Soto del Barco,4450,2104,2346
33,70,Tapia de Casariego,4455,2124,2331
33,71,Taramundi,975,476,499
33,72,Teverga,2335,1205,1130
33,73,Tineo,13578,6855,6723
33,34,Valdés,16073,7873,8200
33,74,Vegadeo,5030,2407,2623
33,75,Villanueva de Oscos,428,219,209
33,76,Villaviciosa,14465,7125,7340
33,77,Villayón,2040,1048,992
33,78,Yernes y Tameza,209,106,103
34,1,Abarca de Campos,51,25,26
34,3,Abia de las Torres,233,117,116
34,4,Aguilar de Campoo,7741,3841,3900
34,5,Alar del Rey,1334,638,696
34,6,Alba de Cerrato,115,52,63
34,9,Amayuelas de Arriba,44,26,18
34,10,Ampudia,719,376,343
34,11,Amusco,618,338,280
34,12,Antigüedad,456,248,208
34,15,Arconada,81,43,38
34,17,Astudillo,1340,697,643
34,18,Autilla del Pino,253,130,123
34,19,Autillo de Campos,198,91,107
34,20,Ayuela,90,54,36
34,22,Baltanás,1628,844,784
34,24,Baquerín de Campos,41,25,16
34,25,Bárcena de Campos,72,32,40
34,27,Barruelo de Santullán,2052,964,1088
34,28,Báscones de Ojeda,225,111,114
34,29,Becerril de Campos,1182,574,608
34,31,Belmonte de Campos,63,30,33
34,32,Berzosilla,77,33,44
34,33,Boada de Campos,29,16,13
34,35,Boadilla de Rioseco,198,100,98
34,34,Boadilla del Camino,204,110,94
34,36,Brañosera,317,166,151
34,37,Buenavista de Valdavia,467,234,233
34,38,Bustillo de la Vega,385,205,180
34,39,Bustillo del Páramo de Carrión,103,54,49
34,41,Calahorra de Boedo,151,74,77
34,42,Calzada de los Molinos,396,214,182
34,45,Capillas,127,60,67
34,46,Cardeñosa de Volpejera,58,30,28
34,47,Carrión de los Condes,2545,1196,1349
34,48,Castil de Vela,117,56,61
34,49,Castrejón de la Peña,659,348,311
34,50,Castrillo de Don Juan,363,201,162
34,51,Castrillo de Onielo,198,96,102
34,52,Castrillo de Villavega,329,170,159
34,53,Castromocho,277,142,135
34,55,Cervatos de la Cueza,418,217,201
34,56,Cervera de Pisuerga,2796,1425,1371
34,57,Cevico de la Torre,739,361,378
34,58,Cevico Navero,310,163,147
34,59,Cisneros,666,319,347
34,60,Cobos de Cerrato,269,132,137
34,61,Collazos de Boedo,176,96,80
34,62,Congosto de Valdavia,279,156,123
34,63,Cordovilla la Real,122,70,52
34,66,Cubillas de Cerrato,111,54,57
34,67,Dehesa de Montejo,264,154,110
34,68,Dehesa de Romanos,53,28,25
34,69,Dueñas,2985,1524,1461
34,70,Espinosa de Cerrato,277,144,133
34,71,Espinosa de Villagonzalo,290,143,147
34,72,Frechilla,276,129,147
34,73,Fresno del Río,204,104,100
34,74,Frómista,1041,522,519
34,76,Fuentes de Nava,851,420,431
34,77,Fuentes de Valdepero,251,137,114
34,79,Grijota,794,396,398
34,80,Guardo,8779,4446,4333
34,81,Guaza de Campos,85,40,45
34,82,Hérmedes de Cerrato,155,72,83
34,83,Herrera de Pisuerga,2761,1383,1378
34,84,Herrera de Valdecañas,200,99,101
34,86,Hontoria de Cerrato,134,69,65
34,87,Hornillos de Cerrato,148,67,81
34,88,Husillos,229,127,102
34,89,Itero de la Vega,258,135,123
34,91,Lagartos,178,95,83
34,92,Lantadilla,572,276,296
34,94,Ledigos,114,58,56
34,903,Loma de Ucieza,364,190,174
34,96,Lomas,59,29,30
34,98,Magaz de Pisuerga,739,386,353
34,99,Manquillos,81,43,38
34,100,Mantinos,211,109,102
34,101,Marcilla de Campos,83,37,46
34,102,Mazariegos,292,156,136
34,103,Mazuecos de Valdeginate,148,76,72
34,104,Melgar de Yuso,426,235,191
34,106,Meneses de Campos,163,88,75
34,107,Micieces de Ojeda,115,61,54
34,108,Monzón de Campos,807,420,387
34,109,Moratinos,95,49,46
34,110,Mudá,142,70,72
34,112,Nogal de las Huertas,80,44,36
34,113,Olea de Boedo,49,24,25
34,114,Olmos de Ojeda,365,204,161
34,116,Osornillo,106,55,51
34,901,Osorno la Mayor,1839,979,860
34,120,Palencia,78831,37746,41085
34,121,Palenzuela,344,181,163
34,122,Páramo de Boedo,122,63,59
34,123,Paredes de Nava,2549,1265,1284
34,124,Payo de Ojeda,101,60,41
34,125,Pedraza de Campos,146,75,71
34,126,Pedrosa de la Vega,398,213,185
34,127,Perales,137,74,63
34,904,Pernía (La),493,264,229
34,129,Pino del Río,269,153,116
34,130,Piña de Campos,317,172,145
34,131,Población de Arroyo,96,51,45
34,132,Población de Campos,227,125,102
34,133,Población de Cerrato,129,69,60
34,134,Polentinos,98,53,45
34,135,Pomar de Valdivia,543,279,264
34,136,Poza de la Vega,290,163,127
34,137,Pozo de Urama,43,25,18
34,139,Prádanos de Ojeda,266,138,128
34,140,Puebla de Valdavia (La),174,88,86
34,141,Quintana del Puente,285,150,135
34,143,Quintanilla de Onsoña,272,157,115
34,146,Reinoso de Cerrato,86,51,35
34,147,Renedo de la Vega,294,169,125
34,149,Requena de Campos,56,28,28
34,151,Respenda de la Peña,305,163,142
34,152,Revenga de Campos,200,94,106
34,154,Revilla de Collazos,103,56,47
34,155,Ribas de Campos,228,119,109
34,156,Riberos de la Cueza,97,50,47
34,157,Saldaña,3183,1613,1570
34,158,Salinas de Pisuerga,296,162,134
34,159,San Cebrián de Campos,567,324,243
34,160,San Cebrián de Mudá,218,106,112
34,161,San Cristóbal de Boedo,54,30,24
34,163,San Mamés de Campos,123,51,72
34,165,San Román de la Cuba,137,71,66
34,167,Santa Cecilia del Alcor,184,100,84
34,168,Santa Cruz de Boedo,73,40,33
34,169,Santervás de la Vega,584,319,265
34,170,Santibáñez de Ecla,109,45,64
34,171,Santibáñez de la Peña,1636,829,807
34,174,Santoyo,298,147,151
34,175,Serna (La),135,77,58
34,177,Soto de Cerrato,243,121,122
34,176,Sotobañado y Priorato,187,100,87
34,178,Tabanera de Cerrato,182,91,91
34,179,Tabanera de Valdavia,57,24,33
34,180,Támara de Campos,108,55,53
34,181,Tariego de Cerrato,573,298,275
34,182,Torquemada,1266,641,625
34,184,Torremormojón,84,41,43
34,185,Triollo,102,54,48
34,186,Valbuena de Pisuerga,78,46,32
34,189,Valdeolmillos,96,48,48
34,190,Valderrábano,83,48,35
34,192,Valde-Ucieza,139,79,60
34,196,Valle de Cerrato,135,74,61
34,902,Valle del Retortillo,235,118,117
34,199,Velilla del Río Carrión,1976,1003,973
34,23,Venta de Baños,6461,3210,3251
34,201,Vertavillo,259,145,114
34,93,Vid de Ojeda (La),146,86,60
34,202,Villabasta de Valdavia,44,20,24
34,204,Villacidaler,79,40,39
34,205,Villaconancio,96,52,44
34,206,Villada,1400,682,718
34,208,Villaeles de Valdavia,90,48,42
34,210,Villahán,147,78,69
34,211,Villaherreros,304,144,160
34,213,Villalaco,90,39,51
34,214,Villalba de Guardo,238,129,109
34,215,Villalcázar de Sirga,245,114,131
34,216,Villalcón,102,49,53
34,217,Villalobón,292,155,137
34,218,Villaluenga de la Vega,686,391,295
34,220,Villamartín de Campos,171,90,81
34,221,Villamediana,249,128,121
34,222,Villameriel,170,91,79
34,223,Villamoronta,350,185,165
34,224,Villamuera de la Cueza,77,45,32
34,225,Villamuriel de Cerrato,4349,2229,2120
34,227,Villanueva del Rebollar,116,60,56
34,228,Villanuño de Valdavia,138,76,62
34,229,Villaprovedo,110,64,46
34,230,Villarmentero de Campos,19,10,9
34,231,Villarrabé,289,146,143
34,232,Villarramiel,1122,549,573
34,233,Villasarracino,308,157,151
34,234,Villasila de Valdavia,117,67,50
34,236,Villaturde,281,139,142
34,237,Villaumbrales,910,475,435
34,238,Villaviudas,510,246,264
34,240,Villerías de Campos,136,71,65
34,241,Villodre,50,30,20
34,242,Villodrigo,138,67,71
34,243,Villoldo,521,275,246
34,245,Villota del Páramo,495,287,208
34,246,Villovieco,141,70,71
35,1,Agaete,6028,3052,2976
35,2,Agüimes,18284,9290,8994
35,3,Antigua,3004,1577,1427
35,4,Arrecife,38091,19266,18825
35,5,Artenara,1250,645,605
35,6,Arucas,29719,14991,14728
35,7,Betancuria,592,305,287
35,8,Firgas,6526,3300,3226
35,9,Gáldar,21704,10878,10826
35,10,Haría,3531,1814,1717
35,11,Ingenio,24394,12221,12173
35,12,Mogán,10398,5356,5042
35,13,Moya,8663,4371,4292
35,14,Oliva (La),6956,3596,3360
35,15,Pájara,5812,3057,2755
35,16,Palmas de Gran Canaria (Las),355563,174894,180669
35,17,Puerto del Rosario,19030,10001,9029
35,18,San Bartolomé,9852,5052,4800
35,19,San Bartolomé de Tirajana,35443,18186,17257
35,20,San Nicolás de Tolentino,8082,4056,4026
35,21,Santa Brígida,16809,8392,8417
35,22,Santa Lucía,40127,20364,19763
35,23,Santa María de Guía de Gran Canaria,13117,6483,6634
35,24,Teguise,8691,4455,4236
35,25,Tejeda,2552,1295,1257
35,26,Telde,84389,42277,42112
35,27,Teror,11225,5691,5534
35,28,Tías,10096,5184,4912
35,29,Tinajo,3755,1925,1830
35,30,Tuineje,7544,3914,3630
35,32,Valleseco,4383,2241,2142
35,31,Valsequillo de Gran Canaria,7796,3975,3821
35,33,Vega de San Mateo,7316,3771,3545
35,34,Yaiza,3363,1798,1565
36,20,Agolada,4915,2392,2523
36,1,Arbo,5019,2474,2545
36,3,Baiona,10499,5129,5370
36,2,Barro,3570,1710,1860
36,4,Bueu,12599,6192,6407
36,5,Caldas de Reis,9307,4479,4828
36,6,Cambados,12936,6298,6638
36,7,Campo Lameiro,2461,1175,1286
36,8,Cangas,23231,11466,11765
36,9,Cañiza (A),7695,3664,4031
36,10,Catoira,3612,1771,1841
36,11,Cerdedo,2771,1204,1567
36,12,Cotobade,5123,2337,2786
36,13,Covelo (O),4501,2076,2425
36,14,Crecente,3060,1392,1668
36,15,Cuntis,5834,2682,3152
36,16,Dozón,2538,1260,1278
36,17,Estrada (A),22492,10622,11870
36,18,Forcarei,5301,2512,2789
36,19,Fornelos de Montes,2410,1099,1311
36,21,Gondomar,11147,5469,5678
36,22,Grove (O),11035,5478,5557
36,23,Guarda (A),9921,4757,5164
36,24,Lalín,20515,9987,10528
36,25,Lama (A),2988,1352,1636
36,26,Marín,24731,12200,12531
36,27,Meaño,5504,2638,2866
36,28,Meis,5017,2352,2665
36,29,Moaña,17687,8564,9123
36,30,Mondariz,6347,3006,3341
36,31,Mondariz-Balneario,636,300,336
36,32,Moraña,4524,2151,2373
36,33,Mos,13755,6664,7091
36,34,Neves (As),5033,2380,2653
36,35,Nigrán,15197,7433,7764
36,36,Oia,3156,1566,1590
36,37,Pazos de Borbén,3285,1535,1750
36,41,Poio,13683,6633,7050
36,42,Ponteareas,17360,8301,9059
36,43,Ponte-Caldelas,6963,3252,3711
36,44,Pontecesures,2881,1416,1465
36,38,Pontevedra,74287,35183,39104
36,39,Porriño (O),15749,7575,8174
36,40,Portas,3231,1509,1722
36,45,Redondela,28893,13991,14902
36,46,Ribadumia,4079,1975,2104
36,47,Rodeiro,4578,2329,2249
36,48,Rosal (O),5866,2834,3032
36,49,Salceda de Caselas,6074,2950,3124
36,50,Salvaterra de Miño,8778,4193,4585
36,51,Sanxenxo,16034,7884,8150
36,52,Silleda,9527,4590,4937
36,53,Soutomaior,5236,2494,2742
36,54,Tomiño,10478,5091,5387
36,55,Tui,16003,7613,8390
36,56,Valga,6442,3155,3287
36,57,Vigo,286774,136332,150442
36,59,Vila de Cruces,7624,3740,3884
36,58,Vilaboa,5639,2761,2878
36,60,Vilagarcía de Arousa,33375,16144,17231
36,61,Vilanova de Arousa,15198,7387,7811
37,1,Abusejo,280,139,141
37,2,Agallas,187,98,89
37,3,Ahigal de los Aceiteros,216,109,107
37,4,Ahigal de Villarino,49,26,23
37,5,Alameda de Gardón (La),184,87,97
37,6,Alamedilla (La),239,116,123
37,7,Alaraz,698,360,338
37,8,Alba de Tormes,4647,2292,2355
37,9,Alba de Yeltes,308,151,157
37,10,Alberca (La),1106,576,530
37,11,Alberguería de Argañán (La),208,107,101
37,12,Alconada,238,118,120
37,15,Aldea del Obispo,434,223,211
37,13,Aldeacipreste,276,151,125
37,14,Aldeadávila de la Ribera,1741,886,855
37,16,Aldealengua,513,259,254
37,17,Aldeanueva de Figueroa,362,178,184
37,18,Aldeanueva de la Sierra,103,50,53
37,19,Aldearrodrigo,227,117,110
37,20,Aldearrubia,526,284,242
37,21,Aldeaseca de Alba,149,73,76
37,22,Aldeaseca de la Frontera,373,185,188
37,23,Aldeatejada,588,289,299
37,24,Aldeavieja de Tormes,133,66,67
37,25,Aldehuela de la Bóveda,395,194,201
37,26,Aldehuela de Yeltes,355,177,178
37,27,Almenara de Tormes,253,127,126
37,28,Almendra,213,108,105
37,29,Anaya de Alba,338,184,154
37,30,Añover de Tormes,123,65,58
37,31,Arabayona,551,296,255
37,32,Arapiles,520,252,268
37,33,Arcediano,105,52,53
37,34,Arco (El),113,59,54
37,35,Armenteros,346,171,175
37,37,Atalaya (La),160,87,73
37,38,Babilafuente,1013,546,467
37,39,Bañobárez,476,246,230
37,40,Barbadillo,591,286,305
37,41,Barbalos,123,63,60
37,42,Barceo,76,40,36
37,44,Barruecopardo,606,309,297
37,45,Bastida (La),46,23,23
37,46,Béjar,16662,7938,8724
37,47,Beleña,153,84,69
37,49,Bermellar,227,105,122
37,50,Berrocal de Huebra,135,65,70
37,51,Berrocal de Salvatierra,150,74,76
37,52,Boada,484,247,237
37,54,Bodón (El),355,183,172
37,55,Bogajo,222,116,106
37,56,Bouza (La),72,36,36
37,57,Bóveda del Río Almar,313,166,147
37,58,Brincones,124,60,64
37,59,Buenamadre,187,97,90
37,60,Buenavista,80,43,37
37,61,Cabaco (El),314,158,156
37,63,Cabeza de Béjar (La),121,63,58
37,65,Cabeza del Caballo,505,257,248
37,62,Cabezabellosa de la Calzada,144,77,67
37,67,Cabrerizos,1434,715,719
37,68,Cabrillas,570,267,303
37,69,Calvarrasa de Abajo,997,494,503
37,70,Calvarrasa de Arriba,661,345,316
37,71,Calzada de Béjar (La),107,56,51
37,72,Calzada de Don Diego,262,134,128
37,73,Calzada de Valdunciel,627,309,318
37,74,Campillo de Azaba,290,145,145
37,77,Campo de Peñaranda (El),427,225,202
37,78,Candelario,1157,566,591
37,79,Canillas de Abajo,119,68,51
37,80,Cantagallo,290,141,149
37,81,Cantalapiedra,1413,691,722
37,82,Cantalpino,1233,665,568
37,83,Cantaracillo,301,154,147
37,85,Carbajosa de la Sagrada,1126,577,549
37,86,Carpio de Azaba,115,58,57
37,87,Carrascal de Barregas,376,191,185
37,88,Carrascal del Obispo,271,134,137
37,89,Casafranca,89,41,48
37,90,Casas del Conde (Las),92,44,48
37,91,Casillas de Flores,297,142,155
37,92,Castellanos de Moriscos,377,176,201
37,185,Castellanos de Villiquera,565,294,271
37,96,Castillejo de Martín Viejo,356,184,172
37,97,Castraz,72,46,26
37,98,Cepeda,554,265,289
37,99,Cereceda de la Sierra,109,59,50
37,100,Cerezal de Peñahorcada,148,80,68
37,101,Cerralbo,269,143,126
37,102,Cerro (El),594,302,292
37,103,Cespedosa de Tormes,718,377,341
37,114,Chagarcía Medianero,164,85,79
37,104,Cilleros de la Bastida,47,22,25
37,106,Cipérez,476,238,238
37,107,Ciudad Rodrigo,14901,7180,7721
37,108,Coca de Alba,168,73,95
37,109,Colmenar de Montemayor,289,166,123
37,110,Cordovilla,147,80,67
37,112,Cristóbal,259,134,125
37,113,Cubo de Don Sancho (El),620,327,293
37,115,Dios le Guarde,172,97,75
37,116,Doñinos de Ledesma,110,58,52
37,117,Doñinos de Salamanca,684,348,336
37,118,Ejeme,212,115,97
37,119,Encina (La),227,121,106
37,120,Encina de San Silvestre,128,64,64
37,121,Encinas de Abajo,689,351,338
37,122,Encinas de Arriba,299,146,153
37,123,Encinasola de los Comendadores,315,164,151
37,124,Endrinal,311,172,139
37,125,Escurial de la Sierra,320,157,163
37,126,Espadaña,58,30,28
37,127,Espeja,319,166,153
37,128,Espino de la Orbada,383,196,187
37,129,Florida de Liébana,252,137,115
37,130,Forfoleda,252,129,123
37,131,Frades de la Sierra,299,153,146
37,132,Fregeneda (La),601,292,309
37,133,Fresnedoso,138,64,74
37,134,Fresno Alhándiga,353,192,161
37,135,Fuente de San Esteban (La),1594,818,776
37,136,Fuenteguinaldo,1012,513,499
37,137,Fuenteliante,165,75,90
37,138,Fuenterroble de Salvatierra,283,142,141
37,139,Fuentes de Béjar,349,144,205
37,140,Fuentes de Oñoro,1520,722,798
37,141,Gajates,282,143,139
37,142,Galindo y Perahuy,242,131,111
37,143,Galinduste,588,287,301
37,144,Galisancho,624,340,284
37,145,Gallegos de Argañán,431,224,207
37,146,Gallegos de Solmirón,214,104,110
37,147,Garcibuey,303,169,134
37,148,Garcihernández,615,329,286
37,149,Garcirrey,113,56,57
37,150,Gejuelo del Barro,51,29,22
37,151,Golpejas,219,112,107
37,152,Gomecello,583,303,280
37,154,Guadramiro,240,137,103
37,155,Guijo de Avila,121,66,55
37,156,Guijuelo,5002,2489,2513
37,157,Herguijuela de Ciudad Rodrigo,166,86,80
37,158,Herguijuela de la Sierra,352,175,177
37,159,Herguijuela del Campo,138,68,70
37,160,Hinojosa de Duero,894,440,454
37,161,Horcajo de Montemayor,208,106,102
37,162,Horcajo Medianero,393,200,193
37,163,Hoya (La),23,17,6
37,164,Huerta,270,144,126
37,165,Iruelos,72,31,41
37,166,Ituero de Azaba,312,168,144
37,167,Juzbado,181,93,88
37,168,Lagunilla,684,366,318
37,169,Larrodrigo,332,176,156
37,170,Ledesma,2008,992,1016
37,171,Ledrada,608,305,303
37,172,Linares de Riofrío,1084,548,536
37,173,Lumbrales,2315,1153,1162
37,175,Machacón,543,273,270
37,174,Macotera,1813,918,895
37,176,Madroñal,170,88,82
37,177,Maíllo (El),473,233,240
37,178,Malpartida,175,97,78
37,179,Mancera de Abajo,395,201,194
37,180,Manzano (El),108,57,51
37,181,Martiago,412,213,199
37,183,Martín de Yeltes,583,299,284
37,182,Martinamor,87,44,43
37,184,Masueco,501,251,250
37,186,Mata de Ledesma (La),155,74,81
37,187,Matilla de los Caños del Río,702,365,337
37,188,Maya (La),272,143,129
37,189,Membribe de la Sierra,102,52,50
37,190,Mieza,379,189,190
37,191,Milano (El),193,99,94
37,192,Miranda de Azán,351,150,201
37,193,Miranda del Castañar,653,340,313
37,194,Mogarraz,379,178,201
37,195,Molinillo,80,37,43
37,196,Monforte de la Sierra,113,63,50
37,197,Monleón,135,77,58
37,198,Monleras,277,140,137
37,199,Monsagro,250,141,109
37,200,Montejo,241,130,111
37,201,Montemayor del Río,378,189,189
37,202,Monterrubio de Armuña,339,167,172
37,203,Monterrubio de la Sierra,173,91,82
37,204,Morasverdes,473,235,238
37,205,Morille,202,108,94
37,206,Moríñigo,147,78,69
37,207,Moriscos,143,73,70
37,208,Moronta,147,75,72
37,209,Mozárbez,401,207,194
37,211,Narros de Matalayegua,320,174,146
37,213,Nava de Béjar,125,63,62
37,214,Nava de Francia,167,87,80
37,215,Nava de Sotrobal,212,112,100
37,212,Navacarros,123,65,58
37,216,Navales,416,239,177
37,217,Navalmoral de Béjar,82,38,44
37,218,Navamorales,192,102,90
37,219,Navarredonda de la Rinconada,276,133,143
37,221,Navasfrías,752,372,380
37,222,Negrilla de Palencia,141,67,74
37,223,Olmedo de Camaces,213,101,112
37,224,Orbada (La),298,150,148
37,225,Pajares de la Laguna,152,76,76
37,226,Palacios del Arzobispo,247,128,119
37,228,Palaciosrubios,570,305,265
37,229,Palencia de Negrilla,216,107,109
37,230,Parada de Arriba,248,134,114
37,231,Parada de Rubiales,363,187,176
37,232,Paradinas de San Juan,663,354,309
37,233,Pastores,65,35,30
37,234,Payo (El),532,253,279
37,235,Pedraza de Alba,304,160,144
37,236,Pedrosillo de Alba,291,148,143
37,237,Pedrosillo de los Aires,471,254,217
37,238,Pedrosillo el Ralo,146,71,75
37,239,Pedroso de la Armuña (El),332,165,167
37,240,Pelabravo,712,362,350
37,241,Pelarrodríguez,211,121,90
37,242,Pelayos,90,45,45
37,243,Peña (La),167,79,88
37,244,Peñacaballera,231,112,119
37,245,Peñaparda,513,250,263
37,246,Peñaranda de Bracamonte,6291,3078,3213
37,247,Peñarandilla,289,148,141
37,248,Peralejos de Abajo,214,101,113
37,249,Peralejos de Arriba,76,42,34
37,250,Pereña de la Ribera,554,281,273
37,251,Peromingo,167,80,87
37,252,Pinedas,213,108,105
37,253,Pino de Tormes (El),181,94,87
37,254,Pitiegua,271,131,140
37,255,Pizarral,97,46,51
37,256,Poveda de las Cintas,364,196,168
37,257,Pozos de Hinojo,95,52,43
37,258,Puebla de Azaba,316,164,152
37,259,Puebla de San Medel,74,39,35
37,260,Puebla de Yeltes,269,143,126
37,261,Puente del Congosto,370,185,185
37,262,Puertas,117,62,55
37,263,Puerto de Béjar,516,240,276
37,264,Puerto Seguro,122,59,63
37,265,Rágama,326,167,159
37,266,Redonda (La),123,56,67
37,267,Retortillo,275,129,146
37,268,Rinconada de la Sierra (La),179,89,90
37,269,Robleda,602,322,280
37,270,Robliza de Cojos,194,98,96
37,271,Rollán,607,313,294
37,272,Saelices el Chico,204,107,97
37,273,Sagrada (La),207,105,102
37,303,Sahugo (El),307,159,148
37,274,Salamanca,159225,74850,84375
37,275,Saldeana,197,109,88
37,276,Salmoral,371,191,180
37,277,Salvatierra de Tormes,64,32,32
37,278,San Cristóbal de la Cuesta,337,173,164
37,284,San Esteban de la Sierra,469,238,231
37,285,San Felices de los Gallegos,683,344,339
37,286,San Martín del Castañar,283,142,141
37,287,San Miguel de Valero,447,231,216
37,36,San Miguel del Robledo,101,48,53
37,288,San Morales,203,110,93
37,289,San Muñoz,380,190,190
37,291,San Pedro de Rozados,389,195,194
37,290,San Pedro del Valle,134,66,68
37,292,San Pelayo de Guareña,114,58,56
37,280,Sanchón de la Ribera,132,71,61
37,281,Sanchón de la Sagrada,59,33,26
37,282,Sanchotello,345,174,171
37,279,Sancti-Spíritus,1243,640,603
37,283,Sando,191,103,88
37,293,Santa María de Sando,211,108,103
37,294,Santa Marta de Tormes,9392,4687,4705
37,296,Santiago de la Puebla,609,317,292
37,297,Santibáñez de Béjar,722,355,367
37,298,Santibáñez de la Sierra,264,145,119
37,299,Santiz,302,156,146
37,300,Santos (Los),808,421,387
37,301,Sardón de los Frailes,106,57,49
37,302,Saucelle,484,242,242
37,304,Sepulcro Hilario,333,168,165
37,305,Sequeros,261,114,147
37,306,Serradilla del Arroyo,475,239,236
37,307,Serradilla del Llano,298,153,145
37,309,Sierpe (La),57,30,27
37,310,Sieteiglesias de Tormes,181,92,89
37,311,Sobradillo,403,197,206
37,312,Sorihuela,411,205,206
37,313,Sotoserrano,716,372,344
37,314,Tabera de Abajo,120,61,59
37,315,Tala (La),151,77,74
37,316,Tamames,1074,550,524
37,317,Tarazona de Guareña,450,236,214
37,318,Tardáguila,271,145,126
37,319,Tejado (El),186,92,94
37,320,Tejeda y Segoyuela,132,70,62
37,321,Tenebrón,240,123,117
37,322,Terradillos,2842,1447,1395
37,323,Topas,722,367,355
37,324,Tordillos,608,305,303
37,325,Tornadizo (El),154,79,75
37,327,Torresmenudas,245,118,127
37,328,Trabanca,261,133,128
37,329,Tremedal de Tormes,57,28,29
37,330,Valdecarros,470,247,223
37,331,Valdefuentes de Sangusín,344,173,171
37,332,Valdehijaderos,130,72,58
37,333,Valdelacasa,372,198,174
37,334,Valdelageve,136,71,65
37,335,Valdelosa,511,244,267
37,336,Valdemierque,77,39,38
37,337,Valderrodrigo,190,89,101
37,338,Valdunciel,123,58,65
37,339,Valero,494,250,244
37,343,Vallejera de Riofrío,54,24,30
37,340,Valsalabroso,235,124,111
37,341,Valverde de Valdelacasa,82,39,43
37,342,Valverdón,270,135,135
37,344,Vecinos,307,153,154
37,345,Vega de Tirados,235,120,115
37,346,Veguillas (Las),314,155,159
37,347,Vellés (La),511,262,249
37,348,Ventosa del Río Almar,175,84,91
37,349,Vídola (La),202,100,102
37,351,Villaflores,483,245,238
37,352,Villagonzalo de Tormes,251,137,114
37,353,Villalba de los Llanos,204,113,91
37,354,Villamayor,2337,1208,1129
37,355,Villanueva del Conde,264,139,125
37,356,Villar de Argañán,114,57,57
37,357,Villar de Ciervo,434,229,205
37,358,Villar de Gallimazo,234,118,116
37,359,Villar de la Yegua,333,152,181
37,360,Villar de Peralonso,366,172,194
37,361,Villar de Samaniego,132,69,63
37,362,Villares de la Reina,1920,954,966
37,363,Villares de Yeltes,187,88,99
37,364,Villarino de los Aires,1171,576,595
37,365,Villarmayor,252,128,124
37,366,Villarmuerto,70,40,30
37,367,Villasbuenas,331,165,166
37,368,Villasdardo,26,12,14
37,369,Villaseco de los Gamitos,211,107,104
37,370,Villaseco de los Reyes,470,243,227
37,371,Villasrubias,402,219,183
37,372,Villaverde de Guareña,203,99,104
37,373,Villavieja de Yeltes,1208,601,607
37,374,Villoria,1414,701,713
37,375,Villoruela,1026,511,515
37,350,Vilvestre,647,320,327
37,376,Vitigudino,3183,1559,1624
37,377,Yecla de Yeltes,385,190,195
37,378,Zamarra,171,88,83
37,379,Zamayón,212,121,91
37,380,Zarapicos,70,39,31
37,381,Zarza de Pumareda (La),219,123,96
37,382,Zorita de la Frontera,303,166,137
38,1,Adeje,14029,7066,6963
38,2,Agulo,1157,571,586
38,3,Alajeró,1155,601,554
38,4,Arafo,4667,2262,2405
38,5,Arico,5064,2592,2472
38,6,Arona,28208,14115,14093
38,7,Barlovento,2488,1250,1238
38,8,Breña Alta,5816,2872,2944
38,9,Breña Baja,3746,1856,1890
38,10,Buenavista del Norte,5664,2879,2785
38,11,Candelaria,12392,6141,6251
38,12,Fasnia,2434,1229,1205
38,13,Frontera,4409,2241,2168
38,14,Fuencaliente de la Palma,1735,883,852
38,15,Garachico,5728,2823,2905
38,16,Garafía,2002,1019,983
38,17,Granadilla de Abona,18508,9253,9255
38,18,Guancha (La),5232,2611,2621
38,19,Guía de Isora,12560,6144,6416
38,20,Güímar,14014,6880,7134
38,21,Hermigua,2150,1112,1038
38,22,Icod de los Vinos,21364,10511,10853
38,23,Laguna (La),121769,59697,62072
38,24,Llanos de Aridane (Los),17944,8817,9127
38,25,Matanza de Acentejo (La),6451,3279,3172
38,26,Orotava (La),35642,17638,18004
38,27,Paso (El),7006,3539,3467
38,28,Puerto de la Cruz,24542,11887,12655
38,29,Puntagorda,1798,885,913
38,30,Puntallana,2201,1087,1114
38,31,Realejos (Los),32599,16124,16475
38,32,Rosario (El),10880,5453,5427
38,33,San Andrés y Sauces,5438,2777,2661
38,34,San Juan de la Rambla,4743,2343,2400
38,35,San Miguel,5776,2902,2874
38,36,San Sebastián de la Gomera,6199,3108,3091
38,37,Santa Cruz de la Palma,17265,8330,8935
38,38,Santa Cruz de Tenerife,203787,97817,105970
38,39,Santa Ursula,9591,4769,4822
38,40,Santiago del Teide,7506,3816,3690
38,41,Sauzal (El),7034,3498,3536
38,42,Silos (Los),5257,2602,2655
38,43,Tacoronte,19056,9538,9518
38,44,Tanque (El),3247,1626,1621
38,45,Tazacorte,6909,3479,3430
38,46,Tegueste,8558,4251,4307
38,47,Tijarafe,2658,1343,1315
38,49,Valle Gran Rey,3631,1847,1784
38,50,Vallehermoso,2716,1350,1366
38,48,Valverde,3929,1938,1991
38,51,Victoria de Acentejo (La),7678,3818,3860
38,52,Vilaflor,1616,824,792
38,53,Villa de Mazo,4501,2264,2237
39,1,Alfoz de Lloredo,2646,1348,1298
39,2,Ampuero,3337,1664,1673
39,3,Anievas,407,211,196
39,4,Arenas de Iguña,2165,1084,1081
39,5,Argoños,778,398,380
39,6,Arnuero,1811,908,903
39,7,Arredondo,668,364,304
39,8,Astillero (El),13010,6408,6602
39,9,Bárcena de Cicero,2213,1140,1073
39,10,Bárcena de Pie de Concha,955,454,501
39,11,Bareyo,1704,864,840
39,12,Cabezón de la Sal,7076,3491,3585
39,13,Cabezón de Liébana,782,424,358
39,14,Cabuérniga,1152,582,570
39,15,Camaleño,1116,580,536
39,16,Camargo,22311,10934,11377
39,27,Campoo de Enmedio,3858,1961,1897
39,17,Campoo de Yuso,761,372,389
39,18,Cartes,2954,1468,1486
39,19,Castañeda,1566,772,794
39,20,Castro-Urdiales,15167,7544,7623
39,21,Cieza,722,358,364
39,22,Cillorigo Castro,1166,620,546
39,23,Colindres,6099,3034,3065
39,24,Comillas,2364,1140,1224
39,25,Corrales de Buelna (Los),10289,5148,5141
39,26,Corvera de Toranzo,2192,1105,1087
39,28,Entrambasaguas,2483,1240,1243
39,29,Escalante,747,383,364
39,30,Guriezo,1705,879,826
39,31,Hazas de Cesto,1274,642,632
39,32,Hermandad de Campoo de Suso,1863,991,872
39,33,Herrerías,754,411,343
39,34,Lamasón,417,229,188
39,35,Laredo,12913,6252,6661
39,36,Liendo,811,413,398
39,37,Liérganes,2263,1107,1156
39,38,Limpias,1271,633,638
39,39,Luena,1022,533,489
39,40,Marina de Cudeyo,4503,2257,2246
39,41,Mazcuerras,1901,1004,897
39,42,Medio Cudeyo,5904,2889,3015
39,43,Meruelo,955,485,470
39,44,Miengo,3437,1703,1734
39,45,Miera,580,288,292
39,46,Molledo,2024,999,1025
39,47,Noja,1876,938,938
39,48,Penagos,1696,852,844
39,49,Peñarrubia,298,151,147
39,50,Pesaguero,421,224,197
39,51,Pesquera,106,49,57
39,52,Piélagos,10741,5339,5402
39,53,Polaciones,302,179,123
39,54,Polanco,3660,1783,1877
39,55,Potes,1622,802,820
39,56,Puente Viesgo,2308,1152,1156
39,57,Ramales de la Victoria,2284,1173,1111
39,58,Rasines,1016,522,494
39,59,Reinosa,11786,5716,6070
39,60,Reocín,6837,3383,3454
39,61,Ribamontán al Mar,3355,1707,1648
39,62,Ribamontán al Monte,2045,1046,999
39,63,Rionansa,1561,848,713
39,64,Riotuerto,1535,750,785
39,65,Rozas de Valdearroyo (Las),298,154,144
39,66,Ruente,949,486,463
39,67,Ruesga,1281,651,630
39,68,Ruiloba,708,357,351
39,69,San Felices de Buelna,2230,1073,1157
39,70,San Miguel de Aguayo,159,83,76
39,71,San Pedro del Romeral,693,352,341
39,72,San Roque de Riomiera,572,313,259
39,80,San Vicente de la Barquera,4395,2234,2161
39,73,Santa Cruz de Bezana,7046,3504,3542
39,74,Santa María de Cayón,6196,3105,3091
39,75,Santander,185410,86979,98431
39,76,Santillana del Mar,3854,1886,1968
39,77,Santiurde de Reinosa,368,199,169
39,78,Santiurde de Toranzo,1695,855,840
39,79,Santoña,11843,5993,5850
39,81,Saro,547,273,274
39,82,Selaya,1987,1006,981
39,83,Soba,1737,910,827
39,84,Solórzano,1014,524,490
39,85,Suances,6117,3009,3108
39,86,Tojos (Los),400,216,184
39,87,Torrelavega,58196,28127,30069
39,88,Tresviso,62,36,26
39,89,Tudanca,275,162,113
39,90,Udías,847,422,425
39,95,Val de San Vicente,2536,1278,1258
39,91,Valdáliga,2652,1361,1291
39,92,Valdeolea,1626,838,788
39,93,Valdeprado del Río,319,172,147
39,94,Valderredible,1165,610,555
39,96,Vega de Liébana,1063,558,505
39,97,Vega de Pas,1011,504,507
39,98,Villacarriedo,1804,941,863
39,99,Villaescusa,3041,1472,1569
39,100,Villafufre,1107,570,537
39,101,Villaverde de Trucíos,379,195,184
39,102,Voto,2310,1210,1100
40,1,Abades,876,442,434
40,2,Adrada de Pirón,61,33,28
40,3,Adrados,236,113,123
40,4,Aguilafuente,813,385,428
40,5,Alconada de Maderuelo,60,32,28
40,12,Aldea Real,409,221,188
40,6,Aldealcorvo,35,17,18
40,7,Aldealengua de Pedraza,105,56,49
40,8,Aldealengua de Santa María,97,52,45
40,9,Aldeanueva de la Serrezuela,59,33,26
40,10,Aldeanueva del Codonal,223,117,106
40,13,Aldeasoña,126,54,72
40,14,Aldehorno,84,41,43
40,15,Aldehuela del Codonal,60,27,33
40,16,Aldeonte,96,48,48
40,17,Anaya,131,66,65
40,18,Añe,127,69,58
40,19,Arahuetes,45,24,21
40,20,Arcones,260,138,122
40,21,Arevalillo de Cega,38,20,18
40,22,Armuña,281,152,129
40,24,Ayllón,1237,624,613
40,25,Barbolla,238,127,111
40,26,Basardilla,91,48,43
40,28,Bercial,138,67,71
40,29,Bercimuel,76,34,42
40,30,Bernardos,776,388,388
40,31,Bernuy de Porreros,336,172,164
40,32,Boceguillas,614,315,299
40,33,Brieva,72,44,28
40,34,Caballar,113,52,61
40,35,Cabañas de Polendos,119,62,57
40,36,Cabezuela,736,391,345
40,37,Calabazas de Fuentidueña,82,38,44
40,39,Campo de San Pedro,398,226,172
40,40,Cantalejo,3521,1786,1735
40,41,Cantimpalos,1306,668,638
40,43,Carbonero el Mayor,2349,1189,1160
40,44,Carrascal del Río,217,114,103
40,45,Casla,155,79,76
40,46,Castillejo de Mesleón,145,75,70
40,47,Castro de Fuentidueña,95,54,41
40,48,Castrojimeno,50,30,20
40,49,Castroserna de Abajo,63,38,25
40,51,Castroserracín,60,35,25
40,52,Cedillo de la Torre,139,71,68
40,53,Cerezo de Abajo,197,99,98
40,54,Cerezo de Arriba,240,129,111
40,65,Chañe,743,392,351
40,55,Cilleruelo de San Mamés,55,27,28
40,56,Cobos de Fuentidueña,73,32,41
40,57,Coca,2027,1008,1019
40,58,Codorniz,507,248,259
40,59,Collado Hermoso,146,68,78
40,60,Condado de Castilnovo,162,89,73
40,61,Corral de Ayllón,113,62,51
40,902,Cozuelos de Fuentidueña,217,108,109
40,62,Cubillo,66,39,27
40,63,Cuéllar,9118,4639,4479
40,905,Cuevas de Provanco,228,125,103
40,68,Domingo García,49,22,27
40,69,Donhierro,116,65,51
40,70,Duruelo,155,79,76
40,71,Encinas,72,35,37
40,72,Encinillas,82,45,37
40,73,Escalona del Prado,599,320,279
40,74,Escarabajosa de Cabezas,390,205,185
40,75,Escobar de Polendos,228,116,112
40,76,Espinar (El),5854,2992,2862
40,77,Espirdo,220,121,99
40,78,Fresneda de Cuéllar,260,137,123
40,79,Fresno de Cantespino,235,122,113
40,80,Fresno de la Fuente,78,40,38
40,81,Frumales,239,119,120
40,82,Fuente de Santa Cruz,198,100,98
40,83,Fuente el Olmo de Fuentidueña,163,81,82
40,84,Fuente el Olmo de Iscar,119,66,53
40,86,Fuentepelayo,1006,503,503
40,87,Fuentepiñel,192,95,97
40,88,Fuenterrebollo,453,236,217
40,89,Fuentesaúco de Fuentidueña,351,182,169
40,91,Fuentesoto,172,86,86
40,92,Fuentidueña,195,98,97
40,93,Gallegos,113,60,53
40,94,Garcillán,349,186,163
40,95,Gomezserracín,664,345,319
40,97,Grajera,96,47,49
40,99,Honrubia de la Cuesta,90,41,49
40,100,Hontalbilla,471,241,230
40,101,Hontanares de Eresma,158,86,72
40,103,Huertos (Los),169,83,86
40,104,Ituero y Lama,74,43,31
40,105,Juarros de Riomoros,75,40,35
40,106,Juarros de Voltoya,288,156,132
40,107,Labajos,161,91,70
40,108,Laguna de Contreras,191,105,86
40,109,Languilla,141,79,62
40,110,Lastras de Cuéllar,582,303,279
40,111,Lastras del Pozo,82,45,37
40,112,Lastrilla (La),1375,686,689
40,113,Losa (La),362,194,168
40,115,Maderuelo,153,79,74
40,903,Marazoleja,160,91,69
40,118,Marazuela,92,45,47
40,119,Martín Miguel,210,101,109
40,120,Martín Muñoz de la Dehesa,192,104,88
40,121,Martín Muñoz de las Posadas,547,279,268
40,122,Marugán,337,181,156
40,124,Mata de Cuéllar,331,179,152
40,123,Matabuena,216,110,106
40,125,Matilla (La),122,66,56
40,126,Melque de Cercos,132,66,66
40,127,Membibre de la Hoz,82,43,39
40,128,Migueláñez,183,92,91
40,129,Montejo de Arévalo,308,168,140
40,130,Montejo de la Vega de la Serrezuela,209,110,99
40,131,Monterrubio,71,35,36
40,132,Moral de Hornuez,121,63,58
40,134,Mozoncillo,1052,542,510
40,135,Muñopedro,422,213,209
40,136,Muñoveros,218,117,101
40,138,Nava de la Asunción,2692,1377,1315
40,139,Navafría,391,208,183
40,140,Navalilla,170,84,86
40,141,Navalmanzano,1157,598,559
40,142,Navares de Ayuso,87,44,43
40,143,Navares de Enmedio,187,102,85
40,144,Navares de las Cuevas,26,12,14
40,145,Navas de Oro,1488,750,738
40,904,Navas de Riofrío,262,128,134
40,146,Navas de San Antonio,297,156,141
40,148,Nieva,380,200,180
40,149,Olombrada,845,442,403
40,150,Orejana,122,66,56
40,151,Ortigosa de Pestaño,87,44,43
40,901,Ortigosa del Monte,294,147,147
40,152,Otero de Herreros,812,398,414
40,154,Pajarejos,47,22,25
40,155,Palazuelos de Eresma,2499,1228,1271
40,156,Pedraza,467,242,225
40,157,Pelayos del Arroyo,55,28,27
40,158,Perosillo,35,22,13
40,159,Pinarejos,207,116,91
40,160,Pinarnegrillo,205,105,100
40,161,Pradales,82,41,41
40,162,Prádena,581,313,268
40,163,Puebla de Pedraza,95,45,50
40,164,Rapariegos,289,151,138
40,165,Rebollo,140,76,64
40,166,Remondo,380,182,198
40,168,Riaguas de San Bartolomé,82,42,40
40,170,Riaza,1673,884,789
40,171,Ribota,41,23,18
40,172,Riofrío de Riaza,51,26,25
40,173,Roda de Eresma,106,52,54
40,174,Sacramenia,556,289,267
40,176,Samboal,633,332,301
40,177,San Cristóbal de Cuéllar,251,129,122
40,178,San Cristóbal de la Vega,161,82,79
40,181,San Ildefonso,5110,2461,2649
40,182,San Martín y Mudrián,309,160,149
40,183,San Miguel de Bernuy,199,103,96
40,184,San Pedro de Gaíllos,381,187,194
40,179,Sanchonuño,756,373,383
40,180,Sangarcía,473,240,233
40,185,Santa María la Real de Nieva,1545,774,771
40,186,Santa Marta del Cerro,51,24,27
40,188,Santiuste de Pedraza,108,58,50
40,189,Santiuste de San Juan Bautista,786,399,387
40,190,Santo Domingo de Pirón,56,26,30
40,191,Santo Tomé del Puerto,340,178,162
40,192,Sauquillo de Cabezas,250,134,116
40,193,Sebúlcor,298,157,141
40,194,Segovia,54287,26121,28166
40,195,Sepúlveda,1343,695,648
40,196,Sequera de Fresno,57,31,26
40,198,Sotillo,49,22,27
40,199,Sotosalbos,114,62,52
40,200,Tabanera la Luenga,81,45,36
40,201,Tolocirio,64,29,35
40,206,Torre Val de San Pedro,204,109,95
40,202,Torreadrada,146,76,70
40,203,Torrecaballeros,443,233,210
40,204,Torrecilla del Pinar,345,170,175
40,205,Torreiglesias,393,208,185
40,207,Trescasas,234,118,116
40,208,Turégano,1111,553,558
40,210,Urueñas,130,68,62
40,211,Valdeprados,56,28,28
40,212,Valdevacas de Montejo,35,20,15
40,213,Valdevacas y Guijar,156,83,73
40,218,Valle de Tabladillo,178,93,85
40,219,Vallelado,860,433,427
40,220,Valleruela de Pedraza,78,43,35
40,221,Valleruela de Sepúlveda,78,39,39
40,214,Valseca,319,166,153
40,215,Valtiendas,206,115,91
40,216,Valverde del Majano,485,249,236
40,222,Veganzones,302,147,155
40,223,Vegas de Matute,249,140,109
40,224,Ventosilla y Tejadilla,29,17,12
40,225,Villacastín,1540,782,758
40,228,Villaverde de Iscar,763,397,366
40,229,Villaverde de Montejo,83,43,40
40,230,Villeguillo,141,80,61
40,231,Yanguas de Eresma,197,94,103
40,233,Zarzuela del Monte,532,272,260
40,234,Zarzuela del Pinar,622,330,292
41,1,Aguadulce,1956,981,975
41,2,Alanís,2108,1056,1052
41,3,Albaida del Aljarafe,1841,930,911
41,4,Alcalá de Guadaira,56313,27845,28468
41,5,Alcalá del Río,9368,4785,4583
41,6,Alcolea del Río,3398,1682,1716
41,7,Algaba (La),12792,6458,6334
41,8,Algámitas,1412,734,678
41,9,Almadén de la Plata,1696,857,839
41,10,Almensilla,2232,1116,1116
41,11,Arahal,18110,8955,9155
41,12,Aznalcázar,3387,1702,1685
41,13,Aznalcóllar,5812,2984,2828
41,14,Badolatosa,3173,1637,1536
41,15,Benacazón,4936,2503,2433
41,16,Bollullos de la Mitación,4950,2486,2464
41,17,Bormujos,6839,3395,3444
41,18,Brenes,10623,5347,5276
41,19,Burguillos,3451,1716,1735
41,20,Cabezas de San Juan (Las),15509,8003,7506
41,21,Camas,25679,12484,13195
41,22,Campana (La),5260,2659,2601
41,23,Cantillana,8930,4480,4450
41,901,Cañada Rosal,2904,1465,1439
41,24,Carmona,25266,12724,12542
41,25,Carrión de los Céspedes,2257,1074,1183
41,26,Casariche,5132,2580,2552
41,27,Castilblanco de los Arroyos,4457,2228,2229
41,28,Castilleja de Guzmán,692,349,343
41,29,Castilleja de la Cuesta,15726,7742,7984
41,30,Castilleja del Campo,653,319,334
41,31,Castillo de las Guardas (El),1600,812,788
41,32,Cazalla de la Sierra,5229,2619,2610
41,33,Constantina,7390,3638,3752
41,34,Coria del Río,23362,11722,11640
41,35,Coripe,1620,828,792
41,36,Coronil (El),5134,2600,2534
41,37,Corrales (Los),4150,2121,2029
41,903,Cuervo de Sevilla (El),7588,3876,3712
41,38,Dos Hermanas,91138,45135,46003
41,39,Ecija,37292,18383,18909
41,40,Espartinas,4160,2112,2048
41,41,Estepa,11560,5708,5852
41,42,Fuentes de Andalucía,7470,3701,3769
41,43,Garrobo (El),761,379,382
41,44,Gelves,5084,2496,2588
41,45,Gerena,5405,2713,2692
41,46,Gilena,3840,1948,1892
41,47,Gines,8634,4249,4385
41,48,Guadalcanal,3095,1530,1565
41,49,Guillena,8281,4194,4087
41,50,Herrera,5925,2923,3002
41,51,Huévar,2308,1185,1123
41,52,Lantejuela (La),3356,1715,1641
41,53,Lebrija,23833,12056,11777
41,54,Lora de Estepa,741,367,374
41,55,Lora del Río,18895,9319,9576
41,56,Luisiana (La),4331,2219,2112
41,57,Madroño (El),402,205,197
41,58,Mairena del Alcor,16071,7999,8072
41,59,Mairena del Aljarafe,30659,15384,15275
41,60,Marchena,17921,8838,9083
41,61,Marinaleda,2622,1301,1321
41,62,Martín de la Jara,2819,1489,1330
41,63,Molares (Los),2659,1343,1316
41,64,Montellano,7064,3558,3506
41,65,Morón de la Frontera,28303,14084,14219
41,66,Navas de la Concepción (Las),1926,960,966
41,67,Olivares,7604,3847,3757
41,68,Osuna,17212,8519,8693
41,69,Palacios y Villafranca (Los),31718,16077,15641
41,70,Palomares del Río,3448,1744,1704
41,71,Paradas,7014,3527,3487
41,72,Pedrera,5025,2520,2505
41,73,Pedroso (El),2403,1177,1226
41,74,Peñaflor,3930,1994,1936
41,75,Pilas,11122,5491,5631
41,76,Pruna,3475,1781,1694
41,77,Puebla de Cazalla (La),10825,5444,5381
41,78,Puebla de los Infantes (La),3591,1816,1775
41,79,Puebla del Río (La),10650,5291,5359
41,80,Real de la Jara (El),1761,861,900
41,81,Rinconada (La),26059,13125,12934
41,82,Roda de Andalucía (La),4175,2071,2104
41,83,Ronquillo (El),1419,712,707
41,84,Rubio (El),3702,1856,1846
41,85,Salteras,2875,1429,1446
41,86,San Juan de Aznalfarache,21484,10422,11062
41,88,San Nicolás del Puerto,726,377,349
41,87,Sanlúcar la Mayor,10412,5167,5245
41,89,Santiponce,6770,3400,3370
41,90,Saucejo (El),4163,2098,2065
41,91,Sevilla,697487,333469,364018
41,92,Tocina,8660,4326,4334
41,93,Tomares,16980,8393,8587
41,94,Umbrete,4709,2362,2347
41,95,Utrera,46173,23099,23074
41,96,Valencina de la Concepción,5922,3001,2921
41,902,Villafranco del Guadalquivir,6022,3015,3007
41,97,Villamanrique de la Condesa,3764,1852,1912
41,100,Villanueva de San Juan,1610,802,808
41,98,Villanueva del Ariscal,4432,2131,2301
41,99,Villanueva del Río y Minas,5953,2873,3080
41,101,Villaverde del Río,6669,3382,3287
41,102,Viso del Alcor (El),15886,8042,7844
42,1,Abejar,359,183,176
42,3,Adradas,110,58,52
42,4,Agreda,3521,1721,1800
42,6,Alconaba,175,102,73
42,7,Alcubilla de Avellaneda,238,123,115
42,8,Alcubilla de las Peñas,100,51,49
42,9,Aldealafuente,170,82,88
42,10,Aldealices,35,17,18
42,11,Aldealpozo,32,15,17
42,12,Aldealseñor,49,29,20
42,13,Aldehuela de Periáñez,47,25,22
42,14,Aldehuelas (Las),133,74,59
42,15,Alentisque,51,21,30
42,16,Aliud,45,19,26
42,17,Almajano,196,97,99
42,18,Almaluez,329,166,163
42,19,Almarza,641,348,293
42,20,Almazán,5877,2925,2952
42,21,Almazul,183,99,84
42,22,Almenar de Soria,423,219,204
42,23,Alpanseque,119,60,59
42,24,Arancón,115,63,52
42,25,Arcos de Jalón,2042,1012,1030
42,26,Arenillas,55,30,25
42,27,Arévalo de la Sierra,120,62,58
42,28,Ausejo de la Sierra,55,28,27
42,29,Baraona,261,140,121
42,30,Barca,156,83,73
42,31,Barcones,55,28,27
42,32,Bayubas de Abajo,291,150,141
42,33,Bayubas de Arriba,98,50,48
42,34,Beratón,40,33,7
42,35,Berlanga de Duero,1238,637,601
42,36,Blacos,65,37,28
42,37,Bliecos,66,33,33
42,38,Borjabad,70,38,32
42,39,Borobia,406,197,209
42,41,Buberos,54,24,30
42,42,Buitrago,49,24,25
42,43,Burgo de Osma-Ciudad de Osma,5053,2495,2558
42,44,Cabrejas del Campo,99,53,46
42,45,Cabrejas del Pinar,495,260,235
42,46,Calatañazor,76,39,37
42,48,Caltojar,144,75,69
42,49,Candilichera,243,125,118
42,50,Cañamaque,46,26,20
42,51,Carabantes,42,23,19
42,52,Caracena,19,12,7
42,53,Carrascosa de Abajo,47,25,22
42,54,Carrascosa de la Sierra,16,8,8
42,55,Casarejos,284,143,141
42,56,Castilfrío de la Sierra,39,23,16
42,58,Castillejo de Robledo,228,119,109
42,57,Castilruiz,356,181,175
42,59,Centenera de Andaluz,36,15,21
42,60,Cerbón,53,29,24
42,61,Cidones,340,182,158
42,62,Cigudosa,87,49,38
42,63,Cihuela,111,66,45
42,64,Ciria,102,48,54
42,65,Cirujales del Río,45,24,21
42,68,Coscurita,163,93,70
42,69,Covaleda,2053,1058,995
42,70,Cubilla,89,45,44
42,71,Cubo de la Solana,280,154,126
42,73,Cueva de Agreda,112,59,53
42,75,Dévanos,152,83,69
42,76,Deza,393,203,190
42,78,Duruelo de la Sierra,1493,754,739
42,79,Escobosa de Almazán,47,28,19
42,80,Espeja de San Marcelino,279,156,123
42,81,Espejón,241,124,117
42,82,Estepa de San Juan,16,8,8
42,83,Frechilla de Almazán,53,26,27
42,84,Fresno de Caracena,58,32,26
42,85,Fuentearmegil,375,200,175
42,86,Fuentecambrón,82,45,37
42,87,Fuentecantos,53,27,26
42,88,Fuentelmonge,150,76,74
42,89,Fuentelsaz de Soria,62,33,29
42,90,Fuentepinilla,174,95,79
42,92,Fuentes de Magaña,107,50,57
42,93,Fuentestrún,74,43,31
42,94,Garray,336,174,162
42,95,Golmayo,595,330,265
42,96,Gómara,546,269,277
42,97,Gormaz,24,12,12
42,98,Herrera de Soria,28,17,11
42,100,Hinojosa del Campo,57,33,24
42,103,Langa de Duero,988,523,465
42,105,Liceras,69,35,34
42,106,Losilla (La),20,12,8
42,107,Magaña,110,55,55
42,108,Maján,20,10,10
42,110,Matalebreras,135,67,68
42,111,Matamala de Almazán,434,224,210
42,113,Medinaceli,733,373,360
42,115,Miño de Medinaceli,125,61,64
42,116,Miño de San Esteban,101,56,45
42,117,Molinos de Duero,200,105,95
42,118,Momblona,47,25,22
42,119,Monteagudo de las Vicarías,326,152,174
42,120,Montejo de Tiermes,254,144,110
42,121,Montenegro de Cameros,124,67,57
42,123,Morón de Almazán,293,140,153
42,124,Muriel de la Fuente,83,43,40
42,125,Muriel Viejo,92,48,44
42,127,Nafría de Ucero,92,49,43
42,128,Narros,61,28,33
42,129,Navaleno,937,471,466
42,130,Nepas,94,54,40
42,131,Nolay,101,55,46
42,132,Noviercas,258,119,139
42,134,Olvega,3293,1702,1591
42,135,Oncala,117,67,50
42,139,Pinilla del Campo,26,15,11
42,140,Portillo de Soria,24,13,11
42,141,Póveda de Soria (La),126,64,62
42,142,Pozalmuro,101,50,51
42,144,Quintana Redonda,613,321,292
42,145,Quintanas de Gormaz,199,98,101
42,148,Quiñonería,15,5,10
42,149,Rábanos (Los),435,259,176
42,151,Rebollar,47,28,19
42,152,Recuerda,125,65,60
42,153,Rello,50,23,27
42,154,Renieblas,130,69,61
42,155,Retortillo de Soria,267,141,126
42,156,Reznos,55,30,25
42,157,Riba de Escalote (La),34,20,14
42,158,Rioseco de Soria,161,83,78
42,159,Rollamienta,51,28,23
42,160,Royo (El),374,177,197
42,161,Salduero,193,99,94
42,162,San Esteban de Gormaz,3426,1760,1666
42,163,San Felices,78,42,36
42,164,San Leonardo de Yagüe,2104,1066,1038
42,165,San Pedro Manrique,501,252,249
42,166,Santa Cruz de Yanguas,65,40,25
42,167,Santa María de Huerta,496,252,244
42,168,Santa María de las Hoyas,208,112,96
42,171,Serón de Nágima,319,162,157
42,172,Soliedra,45,27,18
42,173,Soria,33597,16004,17593
42,174,Sotillo del Rincón,214,105,109
42,175,Suellacabras,51,29,22
42,176,Tajahuerce,51,25,26
42,177,Tajueco,139,73,66
42,178,Talveila,222,115,107
42,181,Tardelcuende,708,351,357
42,182,Taroda,89,44,45
42,183,Tejado,262,129,133
42,184,Torlengua,122,60,62
42,185,Torreblacos,43,21,22
42,187,Torrubia de Soria,104,58,46
42,188,Trévago,85,38,47
42,189,Ucero,115,59,56
42,190,Vadillo,161,86,75
42,191,Valdeavellano de Tera,235,123,112
42,192,Valdegeña,53,27,26
42,193,Valdelagua del Cerro,34,16,18
42,194,Valdemaluque,316,153,163
42,195,Valdenebro,170,89,81
42,196,Valdeprado,18,7,11
42,197,Valderrodilla,139,67,72
42,198,Valtajeros,31,17,14
42,200,Velamazán,154,89,65
42,201,Velilla de la Sierra,24,11,13
42,202,Velilla de los Ajos,45,28,17
42,204,Viana de Duero,83,47,36
42,205,Villaciervos,101,54,47
42,206,Villanueva de Gormaz,23,13,10
42,207,Villar del Ala,58,28,30
42,208,Villar del Campo,41,22,19
42,209,Villar del Río,208,117,91
42,211,Villares de Soria (Los),129,65,64
42,212,Villasayas,112,69,43
42,213,Villaseca de Arciel,50,27,23
42,215,Vinuesa,1105,581,524
42,216,Vizmanos,45,28,17
42,217,Vozmediano,57,31,26
42,218,Yanguas,84,41,43
42,219,Yelo,73,38,35
43,1,Aiguamúrcia,614,310,304
43,2,Albinyana,1077,553,524
43,3,Albiol (L'),144,74,70
43,4,Alcanar,7727,3796,3931
43,5,Alcover,3523,1798,1725
43,904,Aldea (L'),3563,1802,1761
43,6,Aldover,794,376,418
43,7,Aleixar (L'),633,312,321
43,8,Alfara de Carles,383,202,181
43,9,Alforja,1179,597,582
43,10,Alió,339,164,175
43,11,Almoster,679,338,341
43,12,Altafulla,2555,1302,1253
43,13,Ametlla de Mar (L'),4341,2155,2186
43,906,Ampolla (L'),1667,818,849
43,14,Amposta,15900,7864,8036
43,16,Arboç (L'),3362,1718,1644
43,15,Arbolí,131,64,67
43,17,Argentera (L'),149,83,66
43,18,Arnes,535,275,260
43,19,Ascó,1714,860,854
43,20,Banyeres del Penedès,1524,783,741
43,21,Barberà de la Conca,401,201,200
43,22,Batea,1985,1004,981
43,23,Bellmunt del Priorat,303,147,156
43,24,Bellvei,1241,659,582
43,25,Benifallet,896,450,446
43,26,Benissanet,1020,510,510
43,27,Bisbal de Falset (La),245,122,123
43,28,Bisbal del Penedès (La),1628,834,794
43,29,Blancafort,395,197,198
43,30,Bonastre,303,157,146
43,31,Borges del Camp (Les),1471,738,733
43,32,Bot,858,437,421
43,33,Botarell,510,258,252
43,34,Bràfim,569,276,293
43,35,Cabacés,340,175,165
43,36,Cabra del Camp,483,263,220
43,37,Calafell,9772,4912,4860
43,903,Camarles,2953,1485,1468
43,38,Cambrils,17536,8709,8827
43,39,Capafonts,105,55,50
43,40,Capçanes,409,184,225
43,41,Caseres,333,164,169
43,42,Castellvell del Camp,1069,541,528
43,43,Catllar (El),1828,952,876
43,45,Colldejou,196,108,88
43,46,Conesa,104,51,53
43,47,Constantí,5154,2685,2469
43,48,Corbera d'Ebre,1064,546,518
43,49,Cornudella de Montsant,881,439,442
43,50,Creixell,1400,711,689
43,51,Cunit,4246,2177,2069
43,901,Deltebre,10157,5102,5055
43,53,Duesaigües,210,128,82
43,54,Espluga de Francolí (L'),3671,1792,1879
43,55,Falset,2504,1267,1237
43,56,Fatarella (La),1301,654,647
43,57,Febró (La),55,30,25
43,58,Figuera (La),123,64,59
43,59,Figuerola del Camp,226,113,113
43,60,Flix,4372,2181,2191
43,61,Forès,72,34,38
43,62,Freginals,341,168,173
43,63,Galera (La),748,371,377
43,64,Gandesa,2668,1325,1343
43,65,Garcia,551,273,278
43,66,Garidells (Els),162,82,80
43,67,Ginestar,835,424,411
43,68,Godall,751,382,369
43,69,Gratallops,221,111,110
43,70,Guiamets (Els),302,146,156
43,71,Horta de Sant Joan,1272,658,614
43,72,Lloar (El),133,67,66
43,73,Llorac,122,57,65
43,74,Llorenç del Penedès,1434,696,738
43,76,Marçà,611,292,319
43,75,Margalef,132,69,63
43,77,Mas de Barberans,726,369,357
43,78,Masdenverge,912,460,452
43,79,Masllorenç,419,208,211
43,80,Masó (La),258,127,131
43,81,Maspujols,414,211,203
43,82,Masroig (El),524,251,273
43,83,Milà (El),156,73,83
43,84,Miravet,810,411,399
43,85,Molar (El),280,148,132
43,86,Montblanc,5892,2939,2953
43,88,Montbrió del Camp,1413,697,716
43,89,Montferri,158,79,79
43,90,Montmell (El),419,229,190
43,91,Mont-ral,145,74,71
43,92,Mont-roig del Camp,6064,3077,2987
43,93,Móra d'Ebre,4880,2384,2496
43,94,Móra la Nova,2683,1335,1348
43,95,Morell (El),2338,1166,1172
43,96,Morera de Montsant (La),184,100,84
43,97,Nou de Gaià (La),380,185,195
43,98,Nulles,341,159,182
43,100,Pallaresos (Els),2179,1133,1046
43,99,Palma d'Ebre (La),421,199,222
43,101,Passanant,192,115,77
43,102,Paüls,651,335,316
43,103,Perafort,515,265,250
43,104,Perelló (El),2152,1086,1066
43,105,Piles (Les),162,91,71
43,106,Pinell de Brai (El),1125,575,550
43,107,Pira,364,175,189
43,108,Pla de Santa Maria (El),1627,834,793
43,109,Pobla de Mafumet (La),1018,508,510
43,110,Pobla de Massaluca (La),445,227,218
43,111,Pobla de Montornès (La),1115,592,523
43,112,Poboleda,336,172,164
43,113,Pont d'Armentera (El),582,294,288
43,141,Pontils,136,66,70
43,114,Porrera,444,228,216
43,115,Pradell de la Teixeta,232,124,108
43,116,Prades,510,260,250
43,117,Prat de Comte,202,96,106
43,118,Pratdip,452,223,229
43,119,Puigpelat,486,242,244
43,120,Querol,238,131,107
43,121,Rasquera,865,433,432
43,122,Renau,54,29,25
43,123,Reus,90993,44545,46448
43,124,Riba (La),820,422,398
43,125,Riba-roja d'Ebre,1472,754,718
43,126,Riera de Gaià (La),902,453,449
43,127,Riudecanyes,596,298,298
43,128,Riudecols,992,509,483
43,129,Riudoms,5006,2500,2506
43,130,Rocafort de Queralt,254,136,118
43,131,Roda de Barà,2851,1528,1323
43,132,Rodonyà,384,196,188
43,133,Roquetes,6057,3014,3043
43,134,Rourell (El),255,140,115
43,135,Salomó,384,197,187
43,905,Salou,10708,5421,5287
43,136,Sant Carles de la Ràpita,10828,5351,5477
43,137,Sant Jaume dels Domenys,1287,653,634
43,902,Sant Jaume d'Enveja,3352,1689,1663
43,138,Santa Bàrbara,3283,1634,1649
43,139,Santa Coloma de Queralt,2518,1217,1301
43,140,Santa Oliva,1828,922,906
43,142,Sarral,1413,723,690
43,143,Savallà del Comtat,74,35,39
43,144,Secuita (La),1069,536,533
43,145,Selva del Camp (La),3767,1898,1869
43,146,Senan,36,22,14
43,44,Sénia (La),5045,2549,2496
43,147,Solivella,658,315,343
43,148,Tarragona,112176,54712,57464
43,149,Tivenys,961,478,483
43,150,Tivissa,1726,859,867
43,151,Torre de Fontaubella (La),83,37,46
43,152,Torre de l'Espanyol (La),649,335,314
43,153,Torredembarra,8907,4370,4537
43,154,Torroja del Priorat,129,72,57
43,155,Tortosa,30088,14543,15545
43,156,Ulldecona,5152,2530,2622
43,157,Ulldemolins,494,255,239
43,158,Vallclara,112,55,57
43,159,Vallfogona de Riucorb,130,75,55
43,160,Vallmoll,1012,520,492
43,161,Valls,20206,9883,10323
43,162,Vandellòs i l'Hospitalet de l'Infant,4253,2114,2139
43,163,Vendrell (El),19010,9496,9514
43,164,Vespella de Gaià,148,84,64
43,165,Vilabella,814,402,412
43,175,Vilalba dels Arcs,796,420,376
43,166,Vilallonga del Camp,1211,610,601
43,168,Vilanova de Prades,157,85,72
43,167,Vilanova d'Escornalbou,462,235,227
43,169,Vilaplana,523,270,253
43,170,Vila-rodona,1005,541,464
43,171,Vila-seca,12124,6064,6060
43,172,Vilaverd,361,184,177
43,173,Vilella Alta (La),133,68,65
43,174,Vilella Baixa (La),169,87,82
43,176,Vimbodí,1061,547,514
43,177,Vinebre,444,214,230
43,178,Vinyols i els Arcs,1028,545,483
43,52,Xerta,1216,591,625
44,1,Ababuj,85,50,35
44,2,Abejuela,70,39,31
44,3,Aguatón,26,11,15
44,4,Aguaviva,641,321,320
44,5,Aguilar del Alfambra,88,42,46
44,6,Alacón,481,250,231
44,7,Alba,294,150,144
44,8,Albalate del Arzobispo,2434,1197,1237
44,9,Albarracín,1061,534,527
44,10,Albentosa,268,134,134
44,11,Alcaine,61,33,28
44,12,Alcalá de la Selva,442,228,214
44,13,Alcañiz,12679,6238,6441
44,14,Alcorisa,3316,1681,1635
44,16,Alfambra,705,345,360
44,17,Aliaga,440,233,207
44,21,Allepuz,146,75,71
44,22,Alloza,831,405,426
44,23,Allueva,19,8,11
44,18,Almohaja,35,21,14
44,19,Alobras,94,52,42
44,20,Alpeñés,32,19,13
44,24,Anadón,23,12,11
44,25,Andorra,8282,4259,4023
44,26,Arcos de las Salinas,178,89,89
44,27,Arens de Lledó,243,115,128
44,28,Argente,276,137,139
44,29,Ariño,930,461,469
44,31,Azaila,192,105,87
44,32,Bádenas,25,12,13
44,33,Báguena,558,286,272
44,34,Bañón,188,99,89
44,35,Barrachina,176,88,88
44,36,Bea,46,25,21
44,37,Beceite,693,358,335
44,39,Bello,411,191,220
44,38,Belmonte de San José,151,80,71
44,40,Berge,237,123,114
44,41,Bezas,72,37,35
44,42,Blancas,203,105,98
44,43,Blesa,159,93,66
44,44,Bordón,139,78,61
44,45,Bronchales,447,240,207
44,46,Bueña,110,61,49
44,47,Burbáguena,356,157,199
44,48,Cabra de Mora,97,54,43
44,49,Calaceite,1238,631,607
44,50,Calamocha,4019,1997,2022
44,51,Calanda,3596,1816,1780
44,52,Calomarde,90,42,48
44,53,Camañas,144,80,64
44,54,Camarena de la Sierra,167,90,77
44,55,Camarillas,131,71,60
44,56,Caminreal,832,411,421
44,59,Cantavieja,739,389,350
44,60,Cañada de Benatanduz,69,43,26
44,61,Cañada de Verich (La),106,58,48
44,62,Cañada Vellida,63,41,22
44,63,Cañizar del Olivar,129,69,60
44,64,Cascante del Río,126,73,53
44,65,Castejón de Tornos,109,57,52
44,66,Castel de Cabra,192,100,92
44,70,Castellar (El),95,51,44
44,71,Castellote,735,371,364
44,67,Castelnou,106,55,51
44,68,Castelserás,873,463,410
44,74,Cedrillas,552,282,270
44,75,Celadas,433,232,201
44,76,Cella,3030,1538,1492
44,77,Cerollera (La),87,47,40
44,80,Codoñera (La),358,182,176
44,82,Corbalán,75,42,33
44,84,Cortes de Aragón,143,70,73
44,85,Cosa,106,57,49
44,86,Cretas,638,326,312
44,87,Crivillén,138,70,68
44,88,Cuba (La),70,36,34
44,89,Cubla,60,32,28
44,90,Cucalón,83,44,39
44,92,Cuervo (El),138,70,68
44,93,Cuevas de Almudén,111,62,49
44,94,Cuevas Labradas,180,95,85
44,96,Ejulve,236,117,119
44,97,Escorihuela,240,118,122
44,99,Escucha,1179,621,558
44,100,Estercuel,386,190,196
44,101,Ferreruela de Huerva,87,47,40
44,102,Fonfría,33,19,14
44,103,Formiche Alto,201,109,92
44,105,Fórnoles,108,51,57
44,106,Fortanete,195,98,97
44,107,Foz-Calanda,255,140,115
44,108,Fresneda (La),435,227,208
44,109,Frías de Albarracín,180,93,87
44,110,Fuenferrada,49,26,23
44,111,Fuentes Calientes,143,77,66
44,112,Fuentes Claras,689,343,346
44,113,Fuentes de Rubielos,83,47,36
44,114,Fuentespalda,379,188,191
44,115,Galve,144,76,68
44,116,Gargallo,128,67,61
44,117,Gea de Albarracín,503,263,240
44,118,Ginebrosa (La),275,153,122
44,119,Griegos,155,91,64
44,120,Guadalaviar,297,150,147
44,121,Gúdar,83,49,34
44,122,Híjar,1974,985,989
44,123,Hinojosa de Jarque,186,102,84
44,124,Hoz de la Vieja (La),139,76,63
44,125,Huesa del Común,138,76,62
44,126,Iglesuela del Cid (La),502,261,241
44,127,Jabaloyas,101,56,45
44,128,Jarque de la Val,106,59,47
44,129,Jatiel,72,36,36
44,130,Jorcas,54,34,20
44,131,Josa,47,26,21
44,132,Lagueruela,73,37,36
44,133,Lanzuela,32,21,11
44,135,Libros,182,94,88
44,136,Lidón,85,40,45
44,137,Linares de Mora,317,174,143
44,141,Lledó,217,112,105
44,138,Loscos,223,124,99
44,142,Maicas,25,15,10
44,143,Manzanera,487,262,225
44,144,Martín del Río,518,270,248
44,145,Mas de las Matas,1483,751,732
44,146,Mata de los Olmos (La),281,134,147
44,147,Mazaleón,608,312,296
44,148,Mezquita de Jarque,144,73,71
44,149,Mirambel,144,79,65
44,150,Miravete de la Sierra,50,30,20
44,151,Molinos,359,184,175
44,152,Monforte de Moyuela,85,50,35
44,153,Monreal del Campo,2305,1155,1150
44,154,Monroyo,393,204,189
44,155,Montalbán,1668,842,826
44,156,Monteagudo del Castillo,68,39,29
44,157,Monterde de Albarracín,76,33,43
44,158,Mora de Rubielos,1346,698,648
44,159,Moscardón,48,24,24
44,160,Mosqueruela,719,367,352
44,161,Muniesa,756,392,364
44,163,Noguera,183,92,91
44,164,Nogueras,23,16,7
44,165,Nogueruelas,224,116,108
44,167,Obón,60,29,31
44,168,Odón,271,128,143
44,169,Ojos Negros,611,314,297
44,171,Olba,220,113,107
44,172,Oliete,499,251,248
44,173,Olmos (Los),154,86,68
44,174,Orihuela del Tremedal,620,312,308
44,175,Orrios,209,111,98
44,176,Palomar de Arroyos,274,152,122
44,177,Pancrudo,202,112,90
44,178,Parras de Castellote (Las),109,59,50
44,179,Peñarroya de Tastavins,552,285,267
44,180,Peracense,118,61,57
44,181,Peralejos,101,53,48
44,182,Perales del Alfambra,294,160,134
44,183,Pitarque,114,56,58
44,184,Plou,54,27,27
44,185,Pobo (El),155,87,68
44,187,Portellada (La),342,176,166
44,189,Pozondón,88,49,39
44,190,Pozuel del Campo,116,62,54
44,191,Puebla de Híjar (La),1145,558,587
44,192,Puebla de Valverde (La),476,253,223
44,193,Puertomingalvo,136,73,63
44,194,Ráfales,225,118,107
44,195,Rillo,151,83,68
44,196,Riodeva,245,118,127
44,197,Ródenas,98,47,51
44,198,Royuela,238,133,105
44,199,Rubiales,64,37,27
44,200,Rubielos de la Cérida,61,30,31
44,201,Rubielos de Mora,620,306,314
44,203,Salcedillo,9,5,4
44,204,Saldón,47,28,19
44,205,Samper de Calanda,1032,490,542
44,206,San Agustín,156,77,79
44,207,San Martín del Río,312,151,161
44,208,Santa Cruz de Nogueras,28,16,12
44,209,Santa Eulalia,1283,618,665
44,210,Sarrión,1026,544,482
44,211,Segura de los Baños,56,30,26
44,212,Seno,56,28,28
44,213,Singra,98,48,50
44,215,Terriente,186,108,78
44,216,Teruel,28994,13968,15026
44,217,Toril y Masegoso,37,22,15
44,218,Tormón,43,21,22
44,219,Tornos,271,141,130
44,220,Torralba de los Sisones,229,115,114
44,223,Torre de Arcas,117,56,61
44,224,Torre de las Arcas,40,25,15
44,225,Torre del Compte,189,91,98
44,227,Torre los Negros,98,47,51
44,221,Torrecilla de Alcañiz,453,239,214
44,222,Torrecilla del Rebollar,170,91,79
44,226,Torrelacárcel,313,160,153
44,228,Torremocha de Jiloca,182,88,94
44,229,Torres de Albarracín,162,82,80
44,230,Torrevelilla,207,102,105
44,231,Torrijas,85,45,40
44,232,Torrijo del Campo,592,300,292
44,234,Tramacastiel,120,58,62
44,235,Tramacastilla,143,68,75
44,236,Tronchón,92,47,45
44,237,Urrea de Gaén,633,310,323
44,238,Utrillas,3343,1719,1624
44,239,Valacloche,21,13,8
44,240,Valbona,195,102,93
44,241,Valdealgorfa,780,386,394
44,243,Valdecuenca,37,21,16
44,244,Valdelinares,126,73,53
44,245,Valdeltormo,396,204,192
44,246,Valderrobres,1935,990,945
44,247,Valjunquera,460,233,227
44,249,Vallecillo (El),40,24,16
44,250,Veguillas de la Sierra,31,17,14
44,251,Villafranca del Campo,404,207,197
44,252,Villahermosa del Campo,68,39,29
44,256,Villanueva del Rebollar de la Sierra,47,26,21
44,257,Villar del Cobo,235,114,121
44,258,Villar del Salz,115,58,57
44,260,Villarluengo,205,111,94
44,261,Villarquemado,1005,504,501
44,262,Villarroya de los Pinares,214,106,108
44,263,Villastar,345,184,161
44,264,Villel,345,170,175
44,265,Vinaceite,306,158,148
44,266,Visiedo,228,103,125
44,267,Vivel del Río Martín,110,57,53
44,268,Zoma (La),34,18,16
45,1,Ajofrín,2162,1100,1062
45,2,Alameda de la Sagra,2797,1468,1329
45,3,Albarreal de Tajo,594,293,301
45,4,Alcabón,573,295,278
45,5,Alcañizo,351,181,170
45,6,Alcaudete de la Jara,1684,774,910
45,7,Alcolea de Tajo,804,401,403
45,8,Aldea en Cabo,193,102,91
45,9,Aldeanueva de Barbarroya,872,445,427
45,10,Aldeanueva de San Bartolomé,650,320,330
45,11,Almendral de la Cañada,399,208,191
45,12,Almonacid de Toledo,786,404,382
45,13,Almorox,2219,1122,1097
45,14,Añover de Tajo,4620,2405,2215
45,15,Arcicóllar,575,276,299
45,16,Argés,2242,1117,1125
45,17,Azután,365,185,180
45,18,Barcience,110,57,53
45,19,Bargas,6608,3317,3291
45,20,Belvís de la Jara,1808,883,925
45,21,Borox,2132,1062,1070
45,22,Buenaventura,553,268,285
45,23,Burguillos de Toledo,788,394,394
45,24,Burujón,1285,661,624
45,25,Cabañas de la Sagra,1077,551,526
45,26,Cabañas de Yepes,264,137,127
45,27,Cabezamesada,527,271,256
45,28,Calera y Chozas,3750,1892,1858
45,29,Caleruela,326,163,163
45,30,Calzada de Oropesa (La),629,310,319
45,31,Camarena,2143,1091,1052
45,32,Camarenilla,549,272,277
45,33,Campillo de la Jara (El),572,308,264
45,34,Camuñas,1772,897,875
45,35,Cardiel de los Montes,127,70,57
45,36,Carmena,805,415,390
45,37,Carpio de Tajo (El),2332,1136,1196
45,38,Carranque,1469,754,715
45,39,Carriches,313,151,162
45,40,Casar de Escalona (El),845,417,428
45,41,Casarrubios del Monte,2506,1289,1217
45,42,Casasbuenas,229,116,113
45,43,Castillo de Bayuela,1013,506,507
45,45,Cazalegas,1177,581,596
45,46,Cebolla,2810,1397,1413
45,47,Cedillo del Condado,1382,709,673
45,48,Cerralbos (Los),480,234,246
45,49,Cervera de los Montes,428,223,205
45,56,Chozas de Canales,1006,498,508
45,57,Chueca,271,137,134
45,50,Ciruelos,329,176,153
45,51,Cobeja,1739,865,874
45,52,Cobisa,1034,533,501
45,53,Consuegra,10113,5005,5108
45,54,Corral de Almaguer,5856,2935,2921
45,55,Cuerva,1272,629,643
45,58,Domingo Pérez,503,239,264
45,59,Dosbarrios,2045,1025,1020
45,60,Erustes,211,107,104
45,61,Escalona,2048,1047,1001
45,62,Escalonilla,1451,708,743
45,63,Espinoso del Rey,655,336,319
45,64,Esquivias,3770,1888,1882
45,65,Estrella (La),457,241,216
45,66,Fuensalida,7525,3769,3756
45,67,Gálvez,3115,1581,1534
45,68,Garciotum,160,79,81
45,69,Gerindote,1864,946,918
45,70,Guadamur,1622,841,781
45,71,Guardia (La),2427,1193,1234
45,72,Herencias (Las),727,375,352
45,73,Herreruela de Oropesa,432,206,226
45,74,Hinojosa de San Vicente,490,263,227
45,75,Hontanar,116,62,54
45,76,Hormigos,434,220,214
45,77,Huecas,381,195,186
45,78,Huerta de Valdecarábanos,1715,836,879
45,79,Iglesuela (La),474,240,234
45,80,Illán de Vacas,6,5,1
45,81,Illescas,9743,4874,4869
45,82,Lagartera,1939,951,988
45,83,Layos,273,135,138
45,84,Lillo,2892,1437,1455
45,85,Lominchar,1105,566,539
45,86,Lucillos,515,254,261
45,87,Madridejos,10533,5180,5353
45,88,Magán,1081,542,539
45,89,Malpica de Tajo,1779,894,885
45,90,Manzaneque,487,239,248
45,91,Maqueda,489,264,225
45,92,Marjaliza,326,163,163
45,93,Marrupe,122,57,65
45,94,Mascaraque,506,237,269
45,95,Mata (La),1010,504,506
45,96,Mazarambroz,1200,594,606
45,97,Mejorada,1092,557,535
45,98,Menasalbas,2987,1547,1440
45,99,Méntrida,1913,963,950
45,100,Mesegar de Tajo,245,118,127
45,101,Miguel Esteban,4688,2325,2363
45,102,Mocejón,4032,2030,2002
45,103,Mohedas de la Jara,651,335,316
45,104,Montearagón,479,244,235
45,105,Montesclaros,483,236,247
45,106,Mora,9312,4566,4746
45,107,Nambroca,2342,1154,1188
45,108,Nava de Ricomalillo (La),775,391,384
45,109,Navahermosa,3938,2019,1919
45,110,Navalcán,2403,1250,1153
45,111,Navalmoralejo,88,41,47
45,112,Navalmorales (Los),2679,1331,1348
45,113,Navalucillos (Los),2827,1421,1406
45,114,Navamorcuende,765,398,367
45,115,Noblejas,3022,1527,1495
45,116,Noez,902,449,453
45,117,Nombela,951,492,459
45,118,Novés,1548,785,763
45,119,Numancia de la Sagra,1917,998,919
45,120,Nuño Gómez,178,89,89
45,121,Ocaña,6102,3009,3093
45,122,Olías del Rey,4205,2115,2090
45,123,Ontígola,1088,585,503
45,124,Orgaz,2670,1347,1323
45,125,Oropesa,2834,1410,1424
45,126,Otero,230,114,116
45,127,Palomeque,465,234,231
45,128,Pantoja,2282,1168,1114
45,129,Paredes de Escalona,111,54,57
45,130,Parrillas,474,232,242
45,131,Pelahustán,378,196,182
45,132,Pepino,787,402,385
45,133,Polán,3246,1640,1606
45,134,Portillo de Toledo,1933,994,939
45,135,Puebla de Almoradiel (La),5360,2685,2675
45,136,Puebla de Montalbán (La),6969,3494,3475
45,137,Pueblanueva (La),1986,1003,983
45,138,Puente del Arzobispo (El),1562,747,815
45,139,Puerto de San Vicente,292,142,150
45,140,Pulgar,1235,624,611
45,141,Quero,1391,704,687
45,142,Quintanar de la Orden,9330,4629,4701
45,143,Quismondo,1328,634,694
45,144,Real de San Vicente (El),985,501,484
45,145,Recas,2469,1291,1178
45,146,Retamoso,198,106,92
45,147,Rielves,493,247,246
45,148,Robledo del Mazo,538,278,260
45,149,Romeral (El),943,465,478
45,150,San Bartolomé de las Abiertas,492,259,233
45,151,San Martín de Montalbán,751,375,376
45,152,San Martín de Pusa,798,402,396
45,153,San Pablo de los Montes,2131,1075,1056
45,154,San Román de los Montes,596,308,288
45,155,Santa Ana de Pusa,387,207,180
45,156,Santa Cruz de la Zarza,4439,2223,2216
45,157,Santa Cruz del Retamar,1607,816,791
45,158,Santa Olalla,2418,1228,1190
45,901,Santo Domingo-Caudilla,790,391,399
45,159,Sartajada,111,69,42
45,160,Segurilla,952,478,474
45,161,Seseña,3597,1870,1727
45,162,Sevilleja de la Jara,1108,585,523
45,163,Sonseca,9142,4603,4539
45,164,Sotillo de las Palomas,218,112,106
45,165,Talavera de la Reina,70922,34671,36251
45,166,Tembleque,2121,1071,1050
45,167,Toboso (El),2141,1046,1095
45,168,Toledo,66006,31734,34272
45,169,Torralba de Oropesa,294,142,152
45,171,Torre de Esteban Hambrán (La),1442,741,701
45,170,Torrecilla de la Jara,313,163,150
45,172,Torrico,939,476,463
45,173,Torrijos,9822,4820,5002
45,174,Totanés,349,182,167
45,175,Turleque,1027,514,513
45,176,Ugena,981,524,457
45,177,Urda,3046,1519,1527
45,179,Valdeverdeja,854,393,461
45,180,Valmojado,2325,1185,1140
45,181,Velada,2373,1223,1150
45,182,Ventas con Peña Aguilera (Las),1405,717,688
45,183,Ventas de Retamosa (Las),690,357,333
45,184,Ventas de San Julián (Las),239,113,126
45,186,Villa de Don Fadrique (La),4155,2049,2106
45,185,Villacañas,9301,4599,4702
45,187,Villafranca de los Caballeros,5349,2653,2696
45,188,Villaluenga de la Sagra,2639,1335,1304
45,189,Villamiel de Toledo,441,224,217
45,190,Villaminaya,655,333,322
45,191,Villamuelas,760,377,383
45,192,Villanueva de Alcardete,3313,1655,1658
45,193,Villanueva de Bogas,843,419,424
45,194,Villarejo de Montalbán,104,53,51
45,195,Villarrubia de Santiago,2922,1455,1467
45,196,Villaseca de la Sagra,1580,803,777
45,197,Villasequilla,2381,1238,1143
45,198,Villatobas,2280,1149,1131
45,199,Viso de San Juan (El),993,522,471
45,200,Yébenes (Los),6573,3313,3260
45,201,Yeles,1417,740,677
45,202,Yepes,4428,2244,2184
45,203,Yuncler,1960,996,964
45,204,Yunclillos,609,307,302
45,205,Yuncos,3307,1721,1586
46,1,Ademuz,1197,598,599
46,2,Ador,1117,565,552
46,4,Agullent,2205,1061,1144
46,42,Aielo de Malferit,3924,1939,1985
46,5,Alaquàs,25514,12660,12854
46,6,Albaida,5793,2843,2950
46,7,Albal,10523,5228,5295
46,8,Albalat de la Ribera,3473,1676,1797
46,9,Albalat dels Sorells,3530,1711,1819
46,10,Albalat dels Tarongers,651,342,309
46,11,Alberic,9100,4469,4631
46,12,Alborache,875,446,429
46,13,Alboraya,13127,6464,6663
46,14,Albuixech,3088,1509,1579
46,15,Alcácer,7335,3697,3638
46,16,Alcàntera de Xúquer,1492,745,747
46,18,Alcublas,837,424,413
46,19,Alcúdia (l'),10511,5166,5345
46,20,Alcúdia de Crespins (l'),4185,2063,2122
46,21,Aldaia,23425,11724,11701
46,22,Alfafar,20302,10052,10250
46,24,Alfara de Algimia,509,250,259
46,25,Alfara del Patriarca,2733,1343,1390
46,26,Alfarp,1336,648,688
46,27,Alfarrasí,1231,605,626
46,23,Alfauir,343,180,163
46,28,Algar de Palancia,413,201,212
46,29,Algemesí,25029,12359,12670
46,30,Algimia de Alfara,829,413,416
46,31,Alginet,11632,5798,5834
46,32,Almàssera,5545,2648,2897
46,33,Almiserà,255,128,127
46,34,Almoines,1759,863,896
46,35,Almussafes,6881,3436,3445
46,36,Alpuente,985,498,487
46,37,Alquería de la Condesa/Alqueria de la Comtessa (l'),1487,705,782
46,17,Alzira,40556,19736,20820
46,38,Andilla,292,162,130
46,39,Anna,2637,1329,1308
46,40,Antella,1558,780,778
46,41,Aras de Alpuente,420,236,184
46,3,Atzeneta d'Albaida,1243,635,608
46,43,Ayelo de Rugat,196,103,93
46,44,Ayora,5556,2846,2710
46,46,Barx,1203,568,635
46,45,Barxeta,1610,812,798
46,47,Bèlgida,677,329,348
46,48,Bellreguard,3764,1876,1888
46,49,Bellús,383,191,192
46,50,Benagéber,156,89,67
46,51,Benaguasil,9155,4601,4554
46,52,Benavites,651,315,336
46,53,Beneixida,647,315,332
46,54,Benetússer,13961,6885,7076
46,55,Beniarjó,1165,557,608
46,56,Beniatjar,245,123,122
46,57,Benicolet,501,258,243
46,60,Benifaió,12178,6020,6158
46,59,Benifairó de la Valldigna,1669,824,845
46,58,Benifairó de les Valls,1978,976,1002
46,61,Beniflá,153,67,86
46,62,Benigánim,5437,2753,2684
46,63,Benimodo,1757,894,863
46,64,Benimuslem,552,269,283
46,65,Beniparrell,1510,767,743
46,66,Benirredrà,1008,478,530
46,67,Benisanó,1672,859,813
46,68,Benisoda,291,164,127
46,69,Benisuera,196,91,105
46,70,Bétera,11619,5767,5852
46,71,Bicorp,697,350,347
46,72,Bocairent,4627,2285,2342
46,73,Bolbaite,1439,724,715
46,74,Bonrepòs i Mirambell,2377,1166,1211
46,75,Bufalí,220,106,114
46,76,Bugarra,855,432,423
46,77,Buñol,9410,4657,4753
46,78,Burjassot,34061,16534,17527
46,79,Calles,435,232,203
46,80,Camporrobles,1398,716,682
46,81,Canals,12886,6386,6500
46,82,Canet d'En Berenguer,1975,957,1018
46,83,Carcaixent,20397,9933,10464
46,84,Cárcer,2022,966,1056
46,85,Carlet,14366,6999,7367
46,86,Carrícola,77,34,43
46,87,Casas Altas,165,88,77
46,88,Casas Bajas,316,167,149
46,89,Casinos,2292,1189,1103
46,257,Castelló de la Ribera,7089,3486,3603
46,90,Castelló de Rugat,2069,1058,1011
46,91,Castellonet de la Conquesta,144,73,71
46,92,Castielfabib,561,302,259
46,93,Catadau,2189,1075,1114
46,94,Catarroja,20627,10148,10479
46,95,Caudete de las Fuentes,845,425,420
46,96,Cerdà,282,136,146
46,107,Chella,2539,1257,1282
46,106,Chelva,2211,1115,1096
46,108,Chera,582,293,289
46,109,Cheste,6857,3444,3413
46,111,Chiva,8794,4379,4415
46,112,Chulilla,744,373,371
46,97,Cofrentes,1007,502,505
46,98,Corbera,3148,1520,1628
46,99,Cortes de Pallás,602,313,289
46,100,Cotes,375,169,206
46,105,Cullera,20595,10136,10459
46,113,Daimús,1389,694,695
46,114,Domeño,505,261,244
46,115,Dos Aguas,367,207,160
46,116,Eliana (l'),11526,5791,5735
46,117,Emperador,188,91,97
46,118,Enguera,4754,2333,2421
46,119,Enova (l'),1104,560,544
46,120,Estivella,1097,516,581
46,121,Estubeny,141,63,78
46,122,Faura,2809,1403,1406
46,123,Favara,1726,834,892
46,126,Foios,5235,2525,2710
46,128,Font de la Figuera (la),2129,1067,1062
46,127,Font d'En Carròs (la),3211,1595,1616
46,124,Fontanars dels Alforins,970,504,466
46,125,Fortaleny,997,505,492
46,129,Fuenterrobles,711,367,344
46,131,Gandia,56555,27630,28925
46,902,Gátova,512,247,265
46,130,Gavarda,1268,610,658
46,132,Genovés,2314,1150,1164
46,133,Gestalgar,661,318,343
46,134,Gilet,1433,709,724
46,135,Godella,10408,5074,5334
46,136,Godelleta,2095,1025,1070
46,137,Granja de la Costera (la),363,172,191
46,138,Guadasequies,390,207,183
46,139,Guadassuar,5415,2705,2710
46,140,Guardamar,69,38,31
46,141,Higueruelas,556,288,268
46,142,Jalance,1117,569,548
46,144,Jarafuel,1006,523,483
46,154,Llanera de Ranes,1056,527,529
46,155,Llaurí,1336,667,669
46,147,Llíria,15550,7719,7831
46,153,Llocnou de Sant Jeroni,555,278,277
46,156,Llombai,2220,1115,1105
46,157,Llosa de Ranes,3640,1871,1769
46,150,Llutxent,2377,1201,1176
46,148,Loriguilla,1004,507,497
46,149,Losa del Obispo,469,227,242
46,151,Lugar Nuevo de Fenollet,731,356,375
46,152,Lugar Nuevo de la Corona,123,61,62
46,158,Macastre,997,487,510
46,159,Manises,25170,12297,12873
46,160,Manuel,2411,1159,1252
46,161,Marines,1305,665,640
46,162,Masalavés,1480,759,721
46,163,Massalfassar,1364,669,695
46,164,Massamagrell,12283,6041,6242
46,165,Massanassa,7645,3721,3924
46,166,Meliana,9120,4435,4685
46,167,Millares,693,341,352
46,168,Miramar,1064,513,551
46,169,Mislata,40302,19761,20541
46,170,Mogente/Moixent,4214,2140,2074
46,171,Moncada,18420,9108,9312
46,172,Monserrat,2762,1405,1357
46,173,Montaverner,1711,859,852
46,174,Montesa,1260,629,631
46,175,Montichelvo,610,307,303
46,176,Montroy,1567,803,764
46,177,Museros,4083,2021,2062
46,178,Náquera,2075,1047,1028
46,179,Navarrés,2772,1394,1378
46,180,Novelé/Novetlè,646,314,332
46,181,Oliva,20654,10145,10509
46,183,Olleria (l'),7010,3569,3441
46,182,Olocau,768,388,380
46,184,Ontinyent,31024,15269,15755
46,185,Otos,534,266,268
46,186,Paiporta,17259,8518,8741
46,187,Palma de Gandía,1534,750,784
46,188,Palmera,497,241,256
46,189,Palomar,496,248,248
46,190,Paterna,47414,23455,23959
46,191,Pedralba,2099,1061,1038
46,192,Petrés,757,364,393
46,193,Picanya,8582,4308,4274
46,194,Picassent,15438,7769,7669
46,195,Piles,1956,952,1004
46,196,Pinet,235,120,115
46,199,Pobla de Farnals (la),4960,2479,2481
46,202,Pobla de Vallbona (la),9871,5061,4810
46,200,Pobla del Duc (la),2490,1215,1275
46,203,Pobla Llarga (la),4390,2140,2250
46,197,Polinyà de Xúquer,3048,1527,1521
46,198,Potríes,965,463,502
46,205,Puçol,13662,6708,6954
46,201,Puebla de San Miguel,77,43,34
46,204,Puig,6868,3372,3496
46,101,Quart de les Valls,1093,520,573
46,102,Quart de Poblet,27112,13363,13749
46,103,Quartell,1374,675,699
46,104,Quatretonda,2570,1315,1255
46,206,Quesa,780,389,391
46,207,Rafelbuñol/Rafelbunyol,5260,2582,2678
46,208,Rafelcofer,1390,650,740
46,209,Rafelguaraf,2478,1223,1255
46,210,Ráfol de Salem,377,169,208
46,211,Real de Gandía,1802,870,932
46,212,Real de Montroi,1843,941,902
46,213,Requena,18795,9453,9342
46,214,Riba-roja de Túria,11236,5582,5654
46,215,Riola,1600,801,799
46,216,Rocafort,4799,2359,2440
46,217,Rotglá y Corbera,1018,515,503
46,218,Rótova,1345,681,664
46,219,Rugat,199,98,101
46,220,Sagunto/Sagunt,58135,28342,29793
46,221,Salem,471,240,231
46,222,San Juan de Enova,360,160,200
46,223,Sedaví,8198,3994,4204
46,224,Segart,181,86,95
46,225,Sellent,496,264,232
46,226,Sempere,38,19,19
46,227,Senyera,885,418,467
46,228,Serra,1794,901,893
46,229,Siete Aguas,1074,543,531
46,230,Silla,16165,8149,8016
46,231,Simat de la Valldigna,3114,1581,1533
46,232,Sinarcas,1253,657,596
46,233,Sollana,4425,2132,2293
46,234,Sot de Chera,283,144,139
46,235,Sueca,24869,12196,12673
46,236,Sumacàrcer,1382,702,680
46,237,Tavernes Blanques,8299,4090,4209
46,238,Tavernes de la Valldigna,16412,8167,8245
46,239,Teresa de Cofrentes,751,382,369
46,240,Terrateig,195,102,93
46,241,Titaguas,556,303,253
46,242,Torrebaja,457,233,224
46,243,Torrella,204,102,102
46,244,Torrent,60999,30154,30845
46,245,Torres Torres,417,199,218
46,246,Tous,1205,593,612
46,247,Tuéjar,1342,705,637
46,248,Turís,4471,2302,2169
46,249,Utiel,11782,5827,5955
46,250,Valencia,746683,354950,391733
46,251,Vallada,3089,1561,1528
46,252,Vallanca,240,112,128
46,253,Vallés,103,56,47
46,254,Venta del Moro,1636,833,803
46,256,Vilamarxant,5592,2818,2774
46,255,Villalonga,3649,1828,1821
46,258,Villar del Arzobispo,3460,1726,1734
46,259,Villargordo del Cabriel,739,380,359
46,260,Vinalesa,2265,1074,1191
46,145,Xàtiva,24760,12012,12748
46,143,Xeraco,4573,2252,2321
46,146,Xeresa,1880,952,928
46,110,Xirivella,26478,13140,13338
46,261,Yátova,2002,1041,961
46,262,Yesa (La),303,149,154
46,263,Zarra,438,227,211
47,1,Adalia,93,48,45
47,2,Aguasal,25,13,12
47,3,Aguilar de Campos,396,207,189
47,4,Alaejos,1717,891,826
47,5,Alcazarén,739,395,344
47,6,Aldea de San Miguel,242,123,119
47,7,Aldeamayor de San Martín,1275,643,632
47,8,Almenara de Adaja,33,19,14
47,9,Amusquillo,190,104,86
47,10,Arroyo de la Encomienda,1930,994,936
47,11,Ataquines,918,474,444
47,12,Bahabón,208,99,109
47,13,Barcial de la Loma,171,88,83
47,14,Barruelo del Valle,78,41,37
47,15,Becilla de Valderaduey,459,241,218
47,16,Benafarces,118,57,61
47,17,Bercero,295,157,138
47,18,Berceruelo,35,19,16
47,19,Berrueces,112,62,50
47,20,Bobadilla del Campo,417,220,197
47,21,Bocigas,180,87,93
47,22,Bocos de Duero,84,35,49
47,23,Boecillo,1242,641,601
47,24,Bolaños de Campos,384,195,189
47,25,Brahojos de Medina,189,107,82
47,26,Bustillo de Chaves,100,49,51
47,27,Cabezón,1692,868,824
47,28,Cabezón de Valderaduey,54,29,25
47,29,Cabreros del Monte,105,58,47
47,30,Campaspero,1529,787,742
47,31,Campillo (El),248,139,109
47,32,Camporredondo,219,121,98
47,33,Canalejas de Peñafiel,318,156,162
47,34,Canillas de Esgueva,149,81,68
47,35,Carpio,1244,654,590
47,36,Casasola de Arión,390,211,179
47,37,Castrejón de Trabancos,277,151,126
47,38,Castrillo de Duero,236,116,120
47,39,Castrillo-Tejeriego,295,153,142
47,40,Castrobol,90,41,49
47,41,Castrodeza,256,137,119
47,42,Castromembibre,90,48,42
47,43,Castromonte,487,252,235
47,44,Castronuevo de Esgueva,305,161,144
47,45,Castronuño,1111,562,549
47,46,Castroponce,210,106,104
47,47,Castroverde de Cerrato,279,154,125
47,48,Ceinos de Campos,271,145,126
47,49,Cervillego de la Cruz,167,83,84
47,50,Cigales,2620,1254,1366
47,51,Ciguñuela,368,203,165
47,52,Cistérniga,2488,1291,1197
47,53,Cogeces de Iscar,156,82,74
47,54,Cogeces del Monte,972,523,449
47,55,Corcos,276,145,131
47,56,Corrales de Duero,145,82,63
47,57,Cubillas de Santa Marta,265,145,120
47,58,Cuenca de Campos,306,151,155
47,59,Curiel de Duero,135,75,60
47,60,Encinas de Esgueva,409,221,188
47,61,Esguevillas de Esgueva,446,226,220
47,62,Fombellida,301,155,146
47,63,Fompedraza,145,79,66
47,64,Fontihoyuelo,42,26,16
47,65,Fresno el Viejo,1331,680,651
47,66,Fuensaldaña,881,426,455
47,67,Fuente el Sol,314,161,153
47,68,Fuente-Olmedo,66,34,32
47,69,Gallegos de Hornija,156,79,77
47,70,Gatón de Campos,49,29,20
47,71,Geria,477,259,218
47,73,Herrín de Campos,218,105,113
47,74,Hornillos de Eresma,153,78,75
47,75,Iscar,6133,3103,3030
47,76,Laguna de Duero,14234,7221,7013
47,77,Langayo,490,259,231
47,79,Llano de Olmedo,105,56,49
47,78,Lomoviejo,268,134,134
47,80,Manzanillo,86,45,41
47,81,Marzales,77,37,40
47,82,Matapozuelos,1017,513,504
47,83,Matilla de los Caños,98,54,44
47,84,Mayorga,1712,835,877
47,86,Medina de Rioseco,5015,2441,2574
47,85,Medina del Campo,20174,9908,10266
47,87,Megeces,472,236,236
47,88,Melgar de Abajo,202,102,100
47,89,Melgar de Arriba,322,163,159
47,90,Mojados,2423,1216,1207
47,91,Monasterio de Vega,87,43,44
47,92,Montealegre de Campos,175,95,80
47,93,Montemayor de Pililla,1085,568,517
47,94,Moral de la Reina,243,122,121
47,95,Moraleja de las Panaderas,29,17,12
47,96,Morales de Campos,208,103,105
47,97,Mota del Marqués,462,218,244
47,98,Mucientes,613,313,300
47,99,Mudarra (La),265,134,131
47,100,Muriel,232,114,118
47,101,Nava del Rey,2310,1136,1174
47,102,Nueva Villa de las Torres,426,234,192
47,103,Olivares de Duero,350,188,162
47,104,Olmedo,3501,1706,1795
47,105,Olmos de Esgueva,184,103,81
47,106,Olmos de Peñafiel,87,45,42
47,109,Palazuelo de Vedija,235,120,115
47,110,Parrilla (La),666,318,348
47,111,Pedraja de Portillo (La),1102,552,550
47,112,Pedrajas de San Esteban,3215,1629,1586
47,113,Pedrosa del Rey,245,133,112
47,114,Peñafiel,5160,2599,2561
47,115,Peñaflor de Hornija,506,267,239
47,116,Pesquera de Duero,534,286,248
47,117,Piña de Esgueva,411,211,200
47,118,Piñel de Abajo,235,124,111
47,119,Piñel de Arriba,161,80,81
47,121,Pollos,853,440,413
47,122,Portillo,2562,1300,1262
47,123,Pozal de Gallinas,503,264,239
47,124,Pozaldez,536,263,273
47,125,Pozuelo de la Orden,83,46,37
47,126,Puras,63,30,33
47,127,Quintanilla de Arriba,240,126,114
47,129,Quintanilla de Onésimo,1175,623,552
47,130,Quintanilla de Trigueros,103,52,51
47,128,Quintanilla del Molar,89,39,50
47,131,Rábano,256,123,133
47,132,Ramiro,87,46,41
47,133,Renedo de Esgueva,933,489,444
47,134,Roales de Campos,266,129,137
47,135,Robladillo,110,54,56
47,137,Roturas,29,17,12
47,138,Rubí de Bracamonte,348,182,166
47,139,Rueda,1514,785,729
47,140,Saelices de Mayorga,208,109,99
47,141,Salvador de Zapardiel,208,111,97
47,142,San Cebrián de Mazote,247,132,115
47,143,San Llorente,215,114,101
47,144,San Martín de Valvení,117,67,50
47,145,San Miguel del Arroyo,855,444,411
47,146,San Miguel del Pino,247,131,116
47,147,San Pablo de la Moraleja,197,106,91
47,148,San Pedro de Latarce,679,365,314
47,149,San Pelayo,42,23,19
47,150,San Román de Hornija,479,232,247
47,151,San Salvador,50,25,25
47,156,San Vicente del Palacio,266,136,130
47,152,Santa Eufemia del Arroyo,130,63,67
47,153,Santervás de Campos,173,91,82
47,154,Santibáñez de Valcorba,235,122,113
47,155,Santovenia de Pisuerga,1556,786,770
47,157,Sardón de Duero,647,326,321
47,158,Seca (La),1066,566,500
47,159,Serrada,1023,524,499
47,160,Siete Iglesias de Trabancos,667,340,327
47,161,Simancas,2900,1472,1428
47,162,Tamariz de Campos,115,59,56
47,163,Tiedra,429,210,219
47,164,Tordehumos,576,296,280
47,165,Tordesillas,7946,4011,3935
47,169,Torre de Esgueva,117,58,59
47,170,Torre de Peñafiel,50,27,23
47,166,Torrecilla de la Abadesa,384,202,182
47,167,Torrecilla de la Orden,395,193,202
47,168,Torrecilla de la Torre,39,23,16
47,171,Torrelobatón,588,288,300
47,172,Torrescárcela,182,95,87
47,173,Traspinedo,834,427,407
47,174,Trigueros del Valle,282,144,138
47,175,Tudela de Duero,5745,2941,2804
47,176,Unión de Campos (La),333,162,171
47,177,Urones de Castroponce,171,96,75
47,178,Urueña,204,102,102
47,179,Valbuena de Duero,518,264,254
47,180,Valdearcos de la Vega,153,76,77
47,181,Valdenebro de los Valles,259,134,125
47,182,Valdestillas,1556,784,772
47,183,Valdunquillo,240,111,129
47,186,Valladolid,319805,154149,165656
47,184,Valoria la Buena,683,353,330
47,185,Valverde de Campos,123,65,58
47,187,Vega de Ruiponce,151,72,79
47,188,Vega de Valdetronco,199,102,97
47,189,Velascálvaro,201,106,95
47,190,Velilla,161,81,80
47,191,Velliza,161,91,70
47,192,Ventosa de la Cuesta,167,89,78
47,193,Viana de Cega,1337,678,659
47,195,Villabáñez,485,259,226
47,196,Villabaruz de Campos,55,26,29
47,197,Villabrágima,1249,646,603
47,198,Villacarralón,128,68,60
47,199,Villacid de Campos,115,61,54
47,200,Villaco,142,81,61
47,203,Villafrades de Campos,121,55,66
47,204,Villafranca de Duero,402,204,198
47,205,Villafrechós,544,276,268
47,206,Villafuerte,161,76,85
47,207,Villagarcía de Campos,446,238,208
47,208,Villagómez la Nueva,109,50,59
47,209,Villalán de Campos,54,26,28
47,210,Villalar de los Comuneros,510,252,258
47,211,Villalba de la Loma,50,26,24
47,212,Villalba de los Alcores,589,307,282
47,213,Villalbarba,175,86,89
47,214,Villalón de Campos,2166,1047,1119
47,215,Villamuriel de Campos,103,52,51
47,216,Villán de Tordesillas,189,97,92
47,217,Villanubla,928,486,442
47,218,Villanueva de Duero,938,487,451
47,219,Villanueva de la Condesa,44,26,18
47,220,Villanueva de los Caballeros,294,146,148
47,221,Villanueva de los Infantes,158,82,76
47,222,Villanueva de San Mancio,99,53,46
47,223,Villardefrades,248,133,115
47,224,Villarmentero de Esgueva,136,68,68
47,225,Villasexmir,130,68,62
47,226,Villavaquerín,229,121,108
47,227,Villavellid,69,37,32
47,228,Villaverde de Medina,614,333,281
47,229,Villavicencio de los Caballeros,359,166,193
47,194,Viloria,404,218,186
47,230,Wamba,390,208,182
47,231,Zaratán,1221,623,598
47,232,Zarza (La),164,83,81
48,1,Abadiño,6897,3469,3428
48,2,Abanto y Ciérvana/Abanto Zierbena,8417,4176,4241
48,911,Ajangiz,388,200,188
48,912,Alonsotegi,2894,1414,1480
48,3,Amorebieta-Echano,16060,8020,8040
48,4,Amoroto,374,198,176
48,5,Aracaldo,110,64,46
48,6,Arantzazu,285,137,148
48,8,Arcentales,637,346,291
48,93,Areatza,1096,495,601
48,9,Arrankudiaga,730,349,381
48,914,Arratzu,399,201,198
48,10,Arrieta,471,240,231
48,11,Arrigorriaga,10413,5115,5298
48,23,Artea,594,283,311
48,91,Atxondo,1490,744,746
48,70,Aulesti,658,341,317
48,12,Bakio,1389,707,682
48,90,Balmaseda,7226,3502,3724
48,13,Barakaldo,100474,49241,51233
48,14,Barrika,1047,520,527
48,15,Basauri,48490,24043,24447
48,92,Bedia,996,498,498
48,16,Berango,4645,2313,2332
48,17,Bermeo,17176,8456,8720
48,18,Berriatua,978,507,471
48,19,Berriz,4099,2056,2043
48,20,Bilbao,358875,170460,188415
48,21,Busturia,1640,826,814
48,22,Carranza,3147,1663,1484
48,901,Derio,4677,2320,2357
48,26,Dima,1048,532,516
48,27,Durango,23909,11774,12135
48,28,Ea,808,390,418
48,31,Elantxobe,510,228,282
48,32,Elorrio,7338,3678,3660
48,902,Erandio,23613,11614,11999
48,33,Ereño,268,133,135
48,34,Ermua,17346,8846,8500
48,79,Errigoiti,452,246,206
48,29,"Etxebarri, Anteiglesia de San Esteban/Etxebarri Doneztebeko Elizatea",6374,3210,3164
48,30,Etxebarria,788,411,377
48,906,Forua,977,495,482
48,35,Fruiz,316,159,157
48,36,Galdakao,29646,14741,14905
48,37,Galdames,804,419,385
48,38,Gamiz-Fika,987,510,477
48,39,Garay,244,126,118
48,40,Gatika,1090,555,535
48,41,Gauteguiz de Arteaga,778,384,394
48,46,Gernika-Lumo,15439,7502,7937
48,44,Getxo,82196,39376,42820
48,42,Gordexola,1448,724,724
48,43,Gorliz,3523,1749,1774
48,45,Güeñes,5913,2922,2991
48,47,Guizaburuaga,136,68,68
48,48,Ibarrangelu,525,245,280
48,94,Igorre,4000,2004,1996
48,49,Ispaster,624,325,299
48,910,Iurreta,4483,2210,2273
48,50,Izurza,277,144,133
48,907,Kortezubi,368,193,175
48,51,Lanestosa,296,149,147
48,52,Larrabetzu,1518,762,756
48,53,Laukiz,937,480,457
48,54,Leioa,26256,12949,13307
48,57,Lekeitio,7430,3645,3785
48,55,Lemoa,2470,1232,1238
48,56,Lemoiz,829,430,399
48,81,Lezama,2057,1034,1023
48,903,Loiu,1686,860,826
48,58,Mallabia,1100,576,524
48,59,Mañaria,473,253,220
48,60,Markina-Xemein,4713,2334,2379
48,61,Maruri,580,284,296
48,62,Mendata,332,182,150
48,63,Mendexa,338,177,161
48,64,Meñaka,473,243,230
48,66,Morga,386,207,179
48,68,Mundaka,1781,830,951
48,69,Mungia,12807,6272,6535
48,7,Munitibar-Arbatzegi Gerrikaitz,397,216,181
48,908,Murueta,202,104,98
48,71,Muskiz,6367,3136,3231
48,67,Muxika,1415,733,682
48,909,Nabarniz,244,116,128
48,73,Ondarroa,10247,5121,5126
48,74,Orduña,3963,2019,1944
48,75,Orozko,1888,935,953
48,83,Ortuella,8601,4200,4401
48,72,Otxandio,1046,545,501
48,77,Plentzia,3117,1484,1633
48,78,Portugalete,54071,26518,27553
48,82,Santurtzi,49976,24578,25398
48,84,Sestao,34496,16816,17680
48,904,Sondika,3582,1720,1862
48,85,Sopelana,9460,4729,4731
48,86,Sopuerta,2268,1153,1115
48,76,Sukarrieta,314,159,155
48,87,Trucios,534,262,272
48,88,Ubide,161,77,84
48,65,Ugao-Miraballes,4173,2108,2065
48,89,Urduliz,2787,1372,1415
48,80,Valle de Trápaga-Trapagaran,12855,6318,6537
48,95,Zaldibar,3050,1447,1603
48,96,Zalla,7518,3699,3819
48,905,Zamudio,3053,1537,1516
48,97,Zaratamo,1597,801,796
48,24,Zeanuri,1135,596,539
48,25,Zeberio,899,461,438
48,913,Zierbena,1148,598,550
49,2,Abezames,118,58,60
49,3,Alcañices,1229,599,630
49,4,Alcubilla de Nogales,216,108,108
49,5,Alfaraz de Sayago,232,121,111
49,6,Algodre,218,110,108
49,7,Almaraz de Duero,488,242,246
49,8,Almeida de Sayago,696,360,336
49,9,Andavías,524,255,269
49,10,Arcenillas,281,139,142
49,11,Arcos de la Polvorosa,320,171,149
49,12,Argañín,121,56,65
49,13,Argujillo,404,215,189
49,14,Arquillinos,207,103,104
49,15,Arrabalde,426,209,217
49,16,Aspariegos,414,204,210
49,17,Asturianos,369,180,189
49,18,Ayoó de Vidriales,516,251,265
49,19,Barcial del Barco,301,166,135
49,20,Belver de los Montes,535,278,257
49,21,Benavente,16055,7820,8235
49,22,Benegiles,446,234,212
49,23,Bermillo de Sayago,1549,793,756
49,24,Bóveda de Toro (La),1029,527,502
49,25,Bretó,267,142,125
49,26,Bretocino,334,181,153
49,27,Brime de Sog,266,124,142
49,28,Brime de Urz,167,93,74
49,29,Burganes de Valverde,927,477,450
49,30,Bustillo del Oro,175,86,89
49,31,Cabañas de Sayago,219,108,111
49,32,Calzadilla de Tera,524,250,274
49,33,Camarzana de Tera,1099,539,560
49,34,Cañizal,656,345,311
49,35,Cañizo,358,178,180
49,36,Carbajales de Alba,736,355,381
49,37,Carbellino,285,147,138
49,38,Casaseca de Campeán,165,85,80
49,39,Casaseca de las Chanas,384,195,189
49,40,Castrillo de la Guareña,178,88,90
49,41,Castrogonzalo,537,280,257
49,42,Castronuevo,360,185,175
49,43,Castroverde de Campos,435,217,218
49,44,Cazurra,108,60,48
49,46,Cerecinos de Campos,454,236,218
49,47,Cerecinos del Carrizal,172,92,80
49,48,Cernadilla,159,74,85
49,50,Cobreros,874,433,441
49,52,Coomonte,364,186,178
49,53,Coreses,1250,642,608
49,54,Corrales,1218,586,632
49,55,Cotanes,184,96,88
49,56,Cubillos,414,207,207
49,57,Cubo de Benavente,204,106,98
49,58,Cubo de Tierra del Vino (El),507,254,253
49,59,Cuelgamures,155,87,68
49,61,Entrala,162,73,89
49,62,Espadañedo,220,108,112
49,63,Faramontanos de Tábara,526,271,255
49,64,Fariza,752,383,369
49,65,Fermoselle,1782,856,926
49,66,Ferreras de Abajo,662,332,330
49,67,Ferreras de Arriba,563,286,277
49,68,Ferreruela,703,369,334
49,69,Figueruela de Arriba,591,287,304
49,71,Fonfría,1226,614,612
49,75,Fresno de la Polvorosa,231,109,122
49,76,Fresno de la Ribera,430,234,196
49,77,Fresno de Sayago,299,148,151
49,78,Friera de Valverde,304,154,150
49,79,Fuente Encalada,167,83,84
49,80,Fuentelapeña,1079,549,530
49,82,Fuentes de Ropel,643,325,318
49,81,Fuentesaúco,1896,933,963
49,83,Fuentesecas,92,45,47
49,84,Fuentespreadas,422,230,192
49,85,Galende,1416,698,718
49,86,Gallegos del Pan,174,90,84
49,87,Gallegos del Río,933,486,447
49,88,Gamones,106,62,44
49,90,Gema,292,148,144
49,91,Granja de Moreruela,398,190,208
49,92,Granucillo,288,142,146
49,93,Guarrate,395,216,179
49,94,Hermisende,482,246,236
49,95,Hiniesta (La),406,197,209
49,96,Jambrina,291,145,146
49,97,Justel,188,98,90
49,98,Losacino,379,205,174
49,99,Losacio,184,96,88
49,100,Lubián,397,190,207
49,101,Luelmo,280,142,138
49,102,Maderal (El),307,159,148
49,103,Madridanos,582,293,289
49,104,Mahide,602,309,293
49,105,Maire de Castroponce,270,138,132
49,107,Malva,252,124,128
49,108,Manganeses de la Lampreana,861,439,422
49,109,Manganeses de la Polvorosa,890,435,455
49,110,Manzanal de Arriba,511,258,253
49,112,Manzanal de los Infantes,192,100,92
49,111,Manzanal del Barco,218,115,103
49,113,Matilla de Arzón,281,151,130
49,114,Matilla la Seca,74,38,36
49,115,Mayalde,246,123,123
49,116,Melgar de Tera,617,301,316
49,117,Micereces de Tera,680,356,324
49,118,Milles de la Polvorosa,304,151,153
49,119,Molacillos,321,171,150
49,120,Molezuelas de la Carballeda,130,63,67
49,121,Mombuey,499,246,253
49,122,Monfarracinos,570,298,272
49,123,Montamarta,738,353,385
49,124,Moral de Sayago,412,224,188
49,126,Moraleja de Sayago,308,166,142
49,125,Moraleja del Vino,1261,652,609
49,128,Morales de Rey,797,389,408
49,129,Morales de Toro,1156,589,567
49,130,Morales de Valverde,324,157,167
49,127,Morales del Vino,1440,736,704
49,131,Moralina,393,208,185
49,132,Moreruela de los Infanzones,510,267,243
49,133,Moreruela de Tábara,572,297,275
49,134,Muelas de los Caballeros,244,126,118
49,135,Muelas del Pan,944,459,485
49,136,Muga de Sayago,541,264,277
49,137,Navianos de Valverde,274,144,130
49,138,Olmillos de Castro,451,233,218
49,139,Otero de Bodas,291,157,134
49,141,Pajares de la Lampreana,533,266,267
49,143,Palacios de Sanabria,376,182,194
49,142,Palacios del Pan,265,121,144
49,145,Pedralba de la Pradería,332,153,179
49,146,Pego (El),491,246,245
49,147,Peleagonzalo,469,238,231
49,148,Peleas de Abajo,225,114,111
49,149,Peñausende,625,321,304
49,150,Peque,254,129,125
49,151,Perdigón (El),773,384,389
49,152,Pereruela,769,392,377
49,153,Perilla de Castro,266,134,132
49,154,Pías,255,130,125
49,155,Piedrahita de Castro,169,90,79
49,156,Pinilla de Toro,423,213,210
49,157,Pino,245,129,116
49,158,Piñero (El),329,175,154
49,160,Pobladura de Valderaduey,84,38,46
49,159,Pobladura del Valle,343,166,177
49,162,Porto,363,191,172
49,163,Pozoantiguo,392,194,198
49,164,Pozuelo de Tábara,258,124,134
49,165,Prado,114,54,60
49,166,Puebla de Sanabria,1739,840,899
49,167,Pueblica de Valverde,364,185,179
49,170,Quintanilla de Urz,150,79,71
49,168,Quintanilla del Monte,156,72,84
49,169,Quintanilla del Olmo,67,30,37
49,171,Quiruelas de Vidriales,1017,479,538
49,172,Rabanales,935,486,449
49,173,Rábano de Aliste,521,256,265
49,174,Requejo,230,112,118
49,175,Revellinos,358,185,173
49,176,Riofrío de Aliste,1135,584,551
49,177,Rionegro del Puente,427,207,220
49,178,Roales,400,204,196
49,179,Robleda-Cervantes,473,219,254
49,180,Roelos,177,91,86
49,181,Rosinos de la Requejada,548,251,297
49,183,Salce,167,91,76
49,184,Samir de los Caños,262,136,126
49,185,San Agustín del Pozo,223,116,107
49,186,San Cebrián de Castro,425,197,228
49,187,San Cristóbal de Entreviñas,1646,836,810
49,188,San Esteban del Molar,196,109,87
49,189,San Justo,396,188,208
49,190,San Martín de Valderaduey,112,49,63
49,191,San Miguel de la Ribera,441,222,219
49,192,San Miguel del Valle,259,121,138
49,193,San Pedro de Ceque,721,355,366
49,194,San Pedro de la Nave-Almendra,540,270,270
49,208,San Vicente de la Cabeza,675,359,316
49,209,San Vitero,798,414,384
49,197,Santa Clara de Avedillo,264,127,137
49,199,Santa Colomba de las Monjas,359,182,177
49,200,Santa Cristina de la Polvorosa,1314,678,636
49,201,Santa Croya de Tera,511,259,252
49,202,Santa Eufemia del Barco,307,166,141
49,203,Santa María de la Vega,533,280,253
49,204,Santa María de Valverde,108,55,53
49,205,Santibáñez de Tera,627,322,305
49,206,Santibáñez de Vidriales,1437,710,727
49,207,Santovenia,462,221,241
49,210,Sanzoles,729,376,353
49,214,Tábara,987,530,457
49,216,Tapioles,258,142,116
49,219,Toro,9821,4756,5065
49,220,Torre del Valle (La),200,105,95
49,221,Torregamones,344,168,176
49,222,Torres del Carrizal,555,281,274
49,223,Trabazos,1003,509,494
49,224,Trefacio,258,122,136
49,225,Uña de Quintana,238,121,117
49,226,Vadillo de la Guareña,371,193,178
49,227,Valcabado,351,177,174
49,228,Valdefinjas,96,55,41
49,229,Valdescorriel,200,98,102
49,230,Vallesa,194,104,90
49,231,Vega de Tera,549,260,289
49,232,Vega de Villalobos,169,79,90
49,233,Vegalatrave,173,92,81
49,234,Venialbo,573,298,275
49,235,Vezdemarbán,742,357,385
49,236,Vidayanes,128,59,69
49,237,Videmala,226,111,115
49,238,Villabrázaro,430,221,209
49,239,Villabuena del Puente,1041,538,503
49,240,Villadepera,295,143,152
49,241,Villaescusa,401,205,196
49,242,Villafáfila,688,334,354
49,243,Villaferrueña,168,87,81
49,244,Villageriz,74,38,36
49,245,Villalazán,408,200,208
49,246,Villalba de la Lampreana,346,181,165
49,247,Villalcampo,755,361,394
49,248,Villalobos,352,167,185
49,249,Villalonso,146,72,74
49,250,Villalpando,1782,863,919
49,251,Villalube,349,176,173
49,252,Villamayor de Campos,574,288,286
49,255,Villamor de los Escuderos,623,320,303
49,256,Villanázar,402,190,212
49,257,Villanueva de Azoague,405,207,198
49,258,Villanueva de Campeán,207,107,100
49,259,Villanueva de las Peras,206,103,103
49,260,Villanueva del Campo,1126,555,571
49,264,Villar del Buey,929,504,425
49,261,Villaralbo,1595,792,803
49,262,Villardeciervos,585,268,317
49,263,Villardefallaves,115,62,53
49,265,Villardiegua de la Ribera,182,92,90
49,266,Villárdiga,124,59,65
49,267,Villardondiego,147,76,71
49,268,Villarrín de Campos,669,346,323
49,269,Villaseco,351,173,178
49,270,Villavendimio,226,124,102
49,272,Villaveza de Valverde,152,77,75
49,271,Villaveza del Agua,277,138,139
49,273,Viñas,313,162,151
49,275,Zamora,63783,30303,33480
50,1,Abanto,191,103,88
50,2,Acered,297,152,145
50,3,Agón,201,107,94
50,4,Aguarón,746,369,377
50,5,Aguilón,263,134,129
50,6,Ainzón,1221,608,613
50,7,Aladrén,64,37,27
50,8,Alagón,5595,2785,2810
50,9,Alarba,166,92,74
50,10,Alberite de San Juan,107,56,51
50,11,Albeta,130,61,69
50,12,Alborge,128,62,66
50,13,Alcalá de Ebro,312,149,163
50,14,Alcalá de Moncayo,162,87,75
50,15,Alconchel de Ariza,171,93,78
50,16,Aldehuela de Liestos,67,35,32
50,17,Alfajarín,1450,742,708
50,18,Alfamén,1319,689,630
50,19,Alforque,89,46,43
50,20,Alhama de Aragón,1217,594,623
50,21,Almochuel,45,26,19
50,22,Almolda (La),717,354,363
50,23,Almonacid de la Cuba,355,182,173
50,24,Almonacid de la Sierra,864,447,417
50,25,Almunia de Doña Godina (La),5373,2746,2627
50,26,Alpartir,629,334,295
50,27,Ambel,371,183,188
50,28,Anento,73,43,30
50,29,Aniñón,911,485,426
50,30,Añón de Moncayo,317,189,128
50,31,Aranda de Moncayo,254,140,114
50,32,Arándiga,535,272,263
50,33,Ardisa,85,43,42
50,34,Ariza,1385,705,680
50,35,Artieda,105,56,49
50,36,Asín,108,50,58
50,37,Atea,251,140,111
50,38,Ateca,2059,1009,1050
50,39,Azuara,759,395,364
50,40,Badules,122,63,59
50,41,Bagüés,34,19,15
50,42,Balconchán,34,17,17
50,43,Bárboles,317,165,152
50,44,Bardallur,311,156,155
50,45,Belchite,1628,833,795
50,46,Belmonte de Gracián,310,171,139
50,47,Berdejo,53,29,24
50,48,Berrueco,38,22,16
50,901,Biel-Fuencalderas,204,113,91
50,50,Bijuesca,148,84,64
50,51,Biota,1255,644,611
50,52,Bisimbre,141,63,78
50,53,Boquiñeni,1028,524,504
50,54,Bordalba,101,58,43
50,55,Borja,4174,2027,2147
50,56,Botorrita,467,247,220
50,57,Brea de Aragón,2019,1006,1013
50,58,Bubierca,112,54,58
50,59,Bujaraloz,1035,541,494
50,60,Bulbuente,265,141,124
50,61,Bureta,333,166,167
50,62,Burgo de Ebro (El),1447,730,717
50,63,Buste (El),121,65,56
50,64,Cabañas de Ebro,524,272,252
50,65,Cabolafuente,86,51,35
50,66,Cadrete,1243,653,590
50,67,Calatayud,17078,8155,8923
50,68,Calatorao,2692,1381,1311
50,69,Calcena,102,53,49
50,70,Calmarza,94,44,50
50,71,Campillo de Aragón,214,120,94
50,72,Carenas,251,123,128
50,73,Cariñena,2852,1433,1419
50,74,Caspe,7770,3816,3954
50,75,Castejón de Alarba,121,67,54
50,76,Castejón de las Armas,154,74,80
50,77,Castejón de Valdejasa,351,186,165
50,78,Castiliscar,437,219,218
50,79,Cervera de la Cañada,354,173,181
50,80,Cerveruela,6,3,3
50,81,Cetina,761,375,386
50,92,Chiprana,406,200,206
50,93,Chodes,131,64,67
50,82,Cimballa,141,72,69
50,83,Cinco Olivas,134,65,69
50,84,Clarés de Ribota,101,53,48
50,85,Codo,299,148,151
50,86,Codos,306,177,129
50,87,Contamina,61,32,29
50,88,Cosuenda,431,219,212
50,89,Cuarte de Huerva,1720,887,833
50,90,Cubel,249,122,127
50,91,Cuerlas (Las),103,53,50
50,94,Daroca,2335,1152,1183
50,95,Ejea de los Caballeros,15227,7757,7470
50,96,Embid de Ariza,64,34,30
50,98,Encinacorba,347,184,163
50,99,Epila,3957,2021,1936
50,100,Erla,484,235,249
50,101,Escatrón,1371,675,696
50,102,Fabara,1261,666,595
50,104,Farlete,468,235,233
50,105,Fayón,392,206,186
50,106,Fayos (Los),201,111,90
50,107,Figueruelas,955,479,476
50,108,Fombuena,21,16,5
50,109,Frago (El),106,65,41
50,110,Frasno (El),573,300,273
50,111,Fréscano,261,124,137
50,113,Fuendejalón,935,469,466
50,114,Fuendetodos,154,88,66
50,115,Fuentes de Ebro,3763,1950,1813
50,116,Fuentes de Jiloca,372,192,180
50,117,Gallocanta,191,97,94
50,118,Gallur,2992,1491,1501
50,119,Gelsa,1289,653,636
50,120,Godojos,77,40,37
50,121,Gotor,392,207,185
50,122,Grisel,65,34,31
50,123,Grisén,480,237,243
50,124,Herrera de los Navarros,605,317,288
50,125,Ibdes,620,312,308
50,126,Illueca,3282,1601,1681
50,128,Isuerre,67,37,30
50,129,Jaraba,329,169,160
50,130,Jarque,591,318,273
50,131,Jaulín,306,158,148
50,132,Joyosa (La),363,186,177
50,133,Lagata,157,83,74
50,134,Langa del Castillo,190,91,99
50,135,Layana,159,78,81
50,136,Lécera,879,425,454
50,138,Lechón,58,34,24
50,137,Leciñena,1413,698,715
50,139,Letux,506,257,249
50,140,Litago,183,103,80
50,141,Lituénigo,122,60,62
50,142,Lobera de Onsella,66,37,29
50,143,Longares,870,446,424
50,144,Longás,42,26,16
50,146,Lucena de Jalón,273,138,135
50,147,Luceni,1074,534,540
50,148,Luesia,440,228,212
50,149,Luesma,22,12,10
50,150,Lumpiaque,962,497,465
50,151,Luna,961,505,456
50,152,Maella,2079,1051,1028
50,153,Magallón,1243,650,593
50,154,Mainar,194,101,93
50,155,Malanquilla,139,72,67
50,156,Maleján,314,165,149
50,160,Mallén,2963,1524,1439
50,157,Malón,491,253,238
50,159,Maluenda,1031,496,535
50,161,Manchones,162,79,83
50,162,Mara,214,111,103
50,163,María de Huerva,849,407,442
50,164,Mediana de Aragón,515,262,253
50,165,Mequinenza,2582,1285,1297
50,166,Mesones de Isuela,392,194,198
50,167,Mezalocha,318,171,147
50,168,Mianos,37,20,17
50,169,Miedes de Aragón,532,273,259
50,170,Monegrillo,553,300,253
50,171,Moneva,127,62,65
50,172,Monreal de Ariza,324,166,158
50,173,Monterde,238,119,119
50,174,Montón,140,71,69
50,175,Morata de Jalón,1614,806,808
50,176,Morata de Jiloca,359,192,167
50,177,Morés,518,272,246
50,178,Moros,555,279,276
50,179,Moyuela,365,180,185
50,180,Mozota,115,55,60
50,181,Muel,1128,563,565
50,182,Muela (La),1098,568,530
50,183,Munébrega,485,258,227
50,184,Murero,144,84,60
50,185,Murillo de Gállego,139,82,57
50,186,Navardún,64,33,31
50,187,Nigüella,123,64,59
50,188,Nombrevilla,33,18,15
50,189,Nonaspe,1100,557,543
50,190,Novallas,773,376,397
50,191,Novillas,713,366,347
50,192,Nuévalos,297,170,127
50,193,Nuez de Ebro,550,292,258
50,194,Olvés,178,96,82
50,195,Orcajo,47,23,24
50,196,Orera,143,73,70
50,197,Orés,108,63,45
50,198,Oseja,60,32,28
50,199,Osera de Ebro,361,174,187
50,200,Paniza,702,343,359
50,201,Paracuellos de Jiloca,512,231,281
50,202,Paracuellos de la Ribera,331,158,173
50,203,Pastriz,893,438,455
50,204,Pedrola,2582,1331,1251
50,205,Pedrosas (Las),109,51,58
50,206,Perdiguera,447,235,212
50,207,Piedratajada,200,101,99
50,208,Pina de Ebro,2187,1088,1099
50,209,Pinseque,1472,733,739
50,210,Pintanos (Los),88,44,44
50,211,Plasencia de Jalón,361,193,168
50,212,Pleitas,74,41,33
50,213,Plenas,167,84,83
50,214,Pomer,22,12,10
50,215,Pozuel de Ariza,29,20,9
50,216,Pozuelo de Aragón,367,202,165
50,217,Pradilla de Ebro,652,338,314
50,218,Puebla de Albortón,158,81,77
50,219,Puebla de Alfindén,1578,819,759
50,220,Puendeluna,61,35,26
50,221,Purujosa,34,25,9
50,222,Quinto,2152,1083,1069
50,223,Remolinos,1253,637,616
50,224,Retascón,76,42,34
50,225,Ricla,2043,1061,982
50,227,Romanos,154,90,64
50,228,Rueda de Jalón,358,184,174
50,229,Ruesca,93,48,45
50,241,Sabiñán,997,486,511
50,230,Sádaba,1722,875,847
50,231,Salillas de Jalón,372,194,178
50,232,Salvatierra de Esca,291,149,142
50,233,Samper del Salz,149,75,74
50,234,San Martín de la Virgen de Moncayo,314,162,152
50,235,San Mateo de Gállego,2031,1056,975
50,236,Santa Cruz de Grío,238,130,108
50,237,Santa Cruz de Moncayo,101,51,50
50,238,Santa Eulalia de Gállego,138,65,73
50,239,Santed,83,37,46
50,240,Sástago,1510,757,753
50,242,Sediles,111,56,55
50,243,Sestrica,485,250,235
50,244,Sierra de Luna,275,136,139
50,245,Sigüés,185,96,89
50,246,Sisamón,89,54,35
50,247,Sobradiel,596,283,313
50,248,Sos del Rey Católico,850,422,428
50,249,Tabuenca,497,271,226
50,250,Talamantes,67,37,30
50,251,Tarazona,10365,4993,5372
50,252,Tauste,7017,3484,3533
50,253,Terrer,708,340,368
50,254,Tierga,265,143,122
50,255,Tobed,299,142,157
50,256,Torralba de los Frailes,112,54,58
50,257,Torralba de Ribota,237,135,102
50,258,Torralbilla,77,40,37
50,259,Torrehermosa,119,65,54
50,260,Torrelapaja,48,24,24
50,261,Torrellas,336,174,162
50,262,Torres de Berrellén,1402,704,698
50,263,Torrijo de la Cañada,426,223,203
50,264,Tosos,211,106,105
50,265,Trasmoz,67,33,34
50,266,Trasobares,249,136,113
50,267,Uncastillo,967,474,493
50,268,Undués de Lerda,59,35,24
50,269,Urrea de Jalón,354,181,173
50,270,Urriés,88,53,35
50,271,Used,404,216,188
50,272,Utebo,9075,4574,4501
50,274,Val de San Martín,74,34,40
50,273,Valdehorna,62,32,30
50,275,Valmadrid,63,34,29
50,276,Valpalmas,203,103,100
50,277,Valtorres,102,48,54
50,278,Velilla de Ebro,290,146,144
50,279,Velilla de Jiloca,130,64,66
50,280,Vera de Moncayo,483,245,238
50,281,Vierlas,106,50,56
50,283,Villadoz,87,47,40
50,284,Villafeliche,241,122,119
50,285,Villafranca de Ebro,688,335,353
50,286,Villalba de Perejil,126,68,58
50,287,Villalengua,453,241,212
50,288,Villanueva de Gállego,2734,1373,1361
50,290,Villanueva de Huerva,617,313,304
50,289,Villanueva de Jiloca,127,67,60
50,291,Villar de los Navarros,158,80,78
50,292,Villarreal de Huerva,181,104,77
50,293,Villarroya de la Sierra,725,370,355
50,294,Villarroya del Campo,83,40,43
50,282,Vilueña (La),103,47,56
50,295,Vistabella,34,18,16
50,296,Zaida (La),619,317,302
50,297,Zaragoza,601674,289654,312020
50,298,Zuera,5374,2754,2620
51,1,Ceuta,68796,34229,34567
52,1,Melilla,59576,29647,29929
