province_code,province_name,cmun,municipality_name,population_total,population_male,population_female
02,Albacete,1,Abengibre,748,359,389
02,Albacete,2,Alatoz,555,309,246
02,Albacete,3,Albacete,172816,84507,88309
02,Albacete,4,Albatana,698,362,336
02,Albacete,5,Alborea,697,357,340
02,Albacete,6,Alcadozo,662,361,301
02,Albacete,7,Alcalá del Júcar,1202,642,560
02,Albacete,8,Alcaraz,1414,721,693
02,Albacete,9,Almansa,24566,12226,12340
02,Albacete,10,Alpera,2290,1189,1101
02,Albacete,11,Ayna,672,360,312
02,Albacete,12,Balazote,2350,1205,1145
02,Albacete,14,"Ballestero, El",414,213,201
02,Albacete,13,Balsa de Ves,136,80,56
02,Albacete,15,Barrax,1872,950,922
02,Albacete,16,Bienservida,615,322,293
02,Albacete,17,Bogarra,908,478,430
02,Albacete,18,Bonete,1103,562,541
02,Albacete,19,"Bonillo, El",2852,1464,1388
02,Albacete,20,Carcelén,521,286,235
02,Albacete,21,Casas de Juan Núñez,1291,679,612
02,Albacete,22,Casas de Lázaro,358,203,155
02,Albacete,23,Casas de Ves,628,328,300
02,Albacete,24,Casas-Ibáñez,4558,2323,2235
02,Albacete,25,Caudete,10010,5091,4919
02,Albacete,26,Cenizate,1192,603,589
02,Albacete,29,Chinchilla de Monte-Aragón,4213,2193,2020
02,Albacete,27,Corral-Rubio,342,184,158
02,Albacete,28,Cotillas,130,66,64
02,Albacete,30,Elche de la Sierra,3666,1840,1826
02,Albacete,31,Férez,678,338,340
02,Albacete,32,Fuensanta,313,174,139
02,Albacete,33,Fuente-Álamo,2531,1331,1200
02,Albacete,34,Fuentealbilla,1843,925,918
02,Albacete,35,"Gineta, La",2457,1258,1199
02,Albacete,36,Golosalvo,110,59,51
02,Albacete,37,Hellín,30184,15061,15123
02,Albacete,38,"Herrera, La",341,177,164
02,Albacete,39,Higueruela,1196,619,577
02,Albacete,40,Hoya-Gonzalo,643,344,299
02,Albacete,41,Jorquera,378,205,173
02,Albacete,42,Letur,948,461,487
02,Albacete,43,Lezuza,1412,729,683
02,Albacete,44,Liétor,1240,646,594
02,Albacete,45,Madrigueras,4647,2391,2256
02,Albacete,46,Mahora,1360,698,662
02,Albacete,47,Masegoso,115,63,52
02,Albacete,48,Minaya,1538,809,729
02,Albacete,49,Molinicos,863,442,421
02,Albacete,50,Montalvos,102,56,46
02,Albacete,51,Montealegre del Castillo,2057,1043,1014
02,Albacete,52,Motilleja,549,293,256
02,Albacete,53,Munera,3572,1817,1755
02,Albacete,54,Navas de Jorquera,523,270,253
02,Albacete,55,Nerpio,1277,700,577
02,Albacete,56,Ontur,2072,1037,1035
02,Albacete,57,Ossa de Montiel,2411,1191,1220
02,Albacete,58,Paterna del Madera,359,192,167
02,Albacete,60,Peñas de San Pedro,1436,836,600
02,Albacete,59,Peñascosa,328,177,151
02,Albacete,61,Pétrola,719,368,351
02,Albacete,62,Povedilla,452,243,209
02,Albacete,901,Pozo Cañada,2800,1409,1391
02,Albacete,63,Pozohondo,1653,865,788
02,Albacete,64,Pozo-Lorente,414,215,199
02,Albacete,65,Pozuelo,514,271,243
02,Albacete,66,"Recueja, La",260,135,125
02,Albacete,67,Riópar,1391,712,679
02,Albacete,68,Robledo,366,200,166
02,Albacete,69,"Roda, La",15603,7887,7716
02,Albacete,70,Salobre,523,277,246
02,Albacete,71,San Pedro,1179,600,579
02,Albacete,72,Socovos,1788,915,873
02,Albacete,73,Tarazona de la Mancha,6363,3221,3142
02,Albacete,74,Tobarra,7754,3941,3813
02,Albacete,75,Valdeganga,1958,999,959
02,Albacete,76,Vianos,359,185,174
02,Albacete,77,Villa de Ves,59,33,26
02,Albacete,78,Villalgordo del Júcar,1125,592,533
02,Albacete,79,Villamalea,4124,2068,2056
02,Albacete,80,Villapalacios,594,309,285
02,Albacete,81,Villarrobledo,25317,12541,12776
02,Albacete,82,Villatoya,107,63,44
02,Albacete,83,Villavaliente,219,129,90
02,Albacete,84,Villaverde de Guadalimar,349,183,166
02,Albacete,85,Viveros,338,175,163
02,Albacete,86,Yeste,2742,1402,1340
03,Alicante/Alacant,2,Agost,4703,2343,2360
03,Alicante/Alacant,3,Agres,549,292,257
03,Alicante/Alacant,4,Aigües,913,478,435
03,Alicante/Alacant,5,Albatera,11850,6062,5788
03,Alicante/Alacant,6,Alcalalí,1276,631,645
03,Alicante/Alacant,7,Alcocer de Planes,230,118,112
03,Alicante/Alacant,8,Alcoleja,185,95,90
03,Alicante/Alacant,9,Alcoy/Alcoi,59106,28836,30270
03,Alicante/Alacant,10,Alfafara,405,196,209
03,Alicante/Alacant,11,"Alfàs del Pi, l'",18394,9084,9310
03,Alicante/Alacant,12,Algorfa,2761,1380,1381
03,Alicante/Alacant,13,Algueña,1372,683,689
03,Alicante/Alacant,14,Alicante/Alacant,329988,160062,169926
03,Alicante/Alacant,15,Almoradí,20332,10306,10026
03,Alicante/Alacant,16,Almudaina,113,57,56
03,Alicante/Alacant,17,"Alqueria d'Asnar, l'",496,231,265
03,Alicante/Alacant,18,Altea,21813,10702,11111
03,Alicante/Alacant,19,Aspe,20425,10271,10154
03,Alicante/Alacant,1,"Atzúbia, l'",664,349,315
03,Alicante/Alacant,20,Balones,128,65,63
03,Alicante/Alacant,21,Banyeres de Mariola,7102,3551,3551
03,Alicante/Alacant,22,Benasau,157,75,82
03,Alicante/Alacant,23,Beneixama,1710,860,850
03,Alicante/Alacant,24,Benejúzar,5372,2689,2683
03,Alicante/Alacant,25,Benferri,1923,1011,912
03,Alicante/Alacant,26,Beniarbeig,1919,978,941
03,Alicante/Alacant,27,Beniardá,183,91,92
03,Alicante/Alacant,28,Beniarrés,1137,576,561
03,Alicante/Alacant,30,Benidoleig,1080,544,536
03,Alicante/Alacant,31,Benidorm,66831,33195,33636
03,Alicante/Alacant,32,Benifallim,111,62,49
03,Alicante/Alacant,33,Benifato,148,72,76
03,Alicante/Alacant,29,Benigembla,433,219,214
03,Alicante/Alacant,34,Benijófar,3290,1614,1676
03,Alicante/Alacant,35,Benilloba,755,390,365
03,Alicante/Alacant,36,Benillup,102,45,57
03,Alicante/Alacant,37,Benimantell,495,240,255
03,Alicante/Alacant,38,Benimarfull,418,211,207
03,Alicante/Alacant,39,Benimassot,99,57,42
03,Alicante/Alacant,40,Benimeli,391,188,203
03,Alicante/Alacant,41,Benissa,10879,5340,5539
03,Alicante/Alacant,42,"Benitachell/Poble Nou de Benitatxell, el",4020,2002,2018
03,Alicante/Alacant,43,Biar,3650,1791,1859
03,Alicante/Alacant,44,Bigastro,6656,3353,3303
03,Alicante/Alacant,45,Bolulla,414,215,199
03,Alicante/Alacant,46,Busot,2904,1483,1421
03,Alicante/Alacant,49,Callosa de Segura,18625,9430,9195
03,Alicante/Alacant,48,Callosa d'en Sarrià,7223,3682,3541
03,Alicante/Alacant,47,Calp,20804,10491,10313
03,Alicante/Alacant,50,"Campello, el",27604,13456,14148
03,Alicante/Alacant,51,"Campo de Mirra/Camp de Mirra, el",436,228,208
03,Alicante/Alacant,52,Cañada,1242,618,624
03,Alicante/Alacant,53,Castalla,9876,4988,4888
03,Alicante/Alacant,54,Castell de Castells,436,218,218
03,Alicante/Alacant,75,"Castell de Guadalest, el",205,103,102
03,Alicante/Alacant,55,Catral,8620,4353,4267
03,Alicante/Alacant,56,Cocentaina,11461,5799,5662
03,Alicante/Alacant,57,Confrides,221,127,94
03,Alicante/Alacant,58,Cox,7192,3698,3494
03,Alicante/Alacant,59,Crevillent,28836,14572,14264
03,Alicante/Alacant,61,Daya Nueva,1684,843,841
03,Alicante/Alacant,62,Daya Vieja,713,369,344
03,Alicante/Alacant,63,Dénia,41568,20185,21383
03,Alicante/Alacant,64,Dolores,7302,3649,3653
03,Alicante/Alacant,65,Elche/Elx,228675,113345,115330
03,Alicante/Alacant,66,Elda,52620,25697,26923
03,Alicante/Alacant,67,Facheca,101,52,49
03,Alicante/Alacant,68,Famorca,57,30,27
03,Alicante/Alacant,69,Finestrat,6292,3191,3101
03,Alicante/Alacant,77,"Fondó de les Neus, el/Hondón de las Nieves",2436,1224,1212
03,Alicante/Alacant,70,Formentera del Segura,4064,2058,2006
03,Alicante/Alacant,72,Gaianes,448,235,213
03,Alicante/Alacant,71,Gata de Gorgos,5804,2926,2878
03,Alicante/Alacant,73,Gorga,273,152,121
03,Alicante/Alacant,74,Granja de Rocamora,2469,1287,1182
03,Alicante/Alacant,76,Guardamar del Segura,14716,7202,7514
03,Alicante/Alacant,78,Hondón de los Frailes,1102,567,535
03,Alicante/Alacant,79,Ibi,23423,11747,11676
03,Alicante/Alacant,80,Jacarilla,1953,997,956
03,Alicante/Alacant,82,Jávea/Xàbia,27060,13441,13619
03,Alicante/Alacant,83,Jijona/Xixona,6895,3349,3546
03,Alicante/Alacant,85,Llíber,951,468,483
03,Alicante/Alacant,84,"Lorcha/Orxa, l'",606,299,307
03,Alicante/Alacant,86,Millena,230,125,105
03,Alicante/Alacant,88,Monforte del Cid,7592,3967,3625
03,Alicante/Alacant,89,Monóvar/Monòver,12177,6073,6104
03,Alicante/Alacant,903,"Montesinos, Los",4862,2457,2405
03,Alicante/Alacant,91,Murla,477,226,251
03,Alicante/Alacant,92,Muro de Alcoy,9319,4620,4699
03,Alicante/Alacant,90,Mutxamel,24778,12352,12426
03,Alicante/Alacant,93,Novelda,25868,12825,13043
03,Alicante/Alacant,94,"Nucia, la",18548,9366,9182
03,Alicante/Alacant,95,Ondara,6739,3377,3362
03,Alicante/Alacant,96,Onil,7493,3739,3754
03,Alicante/Alacant,97,Orba,2035,994,1041
03,Alicante/Alacant,99,Orihuela,76097,37829,38268
03,Alicante/Alacant,98,Orxeta,760,385,375
03,Alicante/Alacant,100,Parcent,965,471,494
03,Alicante/Alacant,101,Pedreguer,7435,3698,3737
03,Alicante/Alacant,102,Pego,9923,4960,4963
03,Alicante/Alacant,103,Penàguila,308,163,145
03,Alicante/Alacant,104,Petrer,34533,17162,17371
03,Alicante/Alacant,902,Pilar de la Horadada,21202,10894,10308
03,Alicante/Alacant,105,"Pinós, el/Pinoso",7718,3896,3822
03,Alicante/Alacant,106,Planes,733,389,344
03,Alicante/Alacant,901,"Poblets, els",2926,1392,1534
03,Alicante/Alacant,107,Polop,4725,2437,2288
03,Alicante/Alacant,60,Quatretondeta,109,62,47
03,Alicante/Alacant,109,Rafal,4322,2165,2157
03,Alicante/Alacant,110,"Ràfol d'Almúnia, el",631,322,309
03,Alicante/Alacant,111,Redován,7811,4028,3783
03,Alicante/Alacant,112,Relleu,1118,575,543
03,Alicante/Alacant,113,Rojales,16231,8201,8030
03,Alicante/Alacant,114,"Romana, la",2377,1232,1145
03,Alicante/Alacant,115,Sagra,393,198,195
03,Alicante/Alacant,116,Salinas,1562,795,767
03,Alicante/Alacant,118,San Fulgencio,7646,3866,3780
03,Alicante/Alacant,904,San Isidro,1920,983,937
03,Alicante/Alacant,120,San Miguel de Salinas,5797,2909,2888
03,Alicante/Alacant,122,San Vicente del Raspeig/Sant Vicent del Raspeig,57175,28303,28872
03,Alicante/Alacant,117,Sanet y Negrals,634,325,309
03,Alicante/Alacant,119,Sant Joan d'Alacant,23149,11171,11978
03,Alicante/Alacant,121,Santa Pola,31137,15602,15535
03,Alicante/Alacant,123,Sax,9737,4909,4828
03,Alicante/Alacant,124,Sella,579,306,273
03,Alicante/Alacant,125,Senija,578,293,285
03,Alicante/Alacant,127,Tàrbena,640,329,311
03,Alicante/Alacant,128,Teulada,10097,5041,5056
03,Alicante/Alacant,129,Tibi,1603,842,761
03,Alicante/Alacant,130,Tollos,50,27,23
03,Alicante/Alacant,131,Tormos,333,163,170
03,Alicante/Alacant,132,"Torremanzanas/Torre de les Maçanes, la",682,357,325
03,Alicante/Alacant,133,Torrevieja,83252,41527,41725
03,Alicante/Alacant,134,"Vall d'Alcalà, la",168,92,76
03,Alicante/Alacant,136,Vall de Gallinera,594,323,271
03,Alicante/Alacant,137,"Vall de Laguar, la",825,408,417
03,Alicante/Alacant,135,"Vall d'Ebo, la",232,124,108
03,Alicante/Alacant,138,"Verger, el",4421,2212,2209
03,Alicante/Alacant,139,"Villajoyosa/Vila Joiosa, la",33607,16777,16830
03,Alicante/Alacant,140,Villena,33968,16972,16996
03,Alicante/Alacant,81,Xaló,2636,1306,1330
04,Almería,1,Abla,1267,651,616
04,Almería,2,Abrucena,1170,606,564
04,Almería,3,Adra,24697,12480,12217
04,Almería,4,Albánchez,754,378,376
04,Almería,5,Alboloduy,610,299,311
04,Almería,6,Albox,11481,5873,5608
04,Almería,7,Alcolea,811,416,395
04,Almería,8,Alcóntar,577,319,258
04,Almería,9,Alcudia de Monteagud,148,68,80
04,Almería,10,Alhabia,678,355,323
04,Almería,11,Alhama de Almería,3653,1835,1818
04,Almería,12,Alicún,217,110,107
04,Almería,13,Almería,195389,95044,100345
04,Almería,14,Almócita,174,91,83
04,Almería,15,Alsodux,132,75,57
04,Almería,16,Antas,3124,1556,1568
04,Almería,17,Arboleas,4463,2238,2225
04,Almería,18,Armuña de Almanzora,327,158,169
04,Almería,19,Bacares,244,128,116
04,Almería,904,Balanegra,2939,1532,1407
04,Almería,20,Bayárcal,303,163,140
04,Almería,21,Bayarque,215,108,107
04,Almería,22,Bédar,892,437,455
04,Almería,23,Beires,110,53,57
04,Almería,24,Benahadux,4212,2092,2120
04,Almería,26,Benitagla,66,39,27
04,Almería,27,Benizalón,263,142,121
04,Almería,28,Bentarique,238,136,102
04,Almería,29,Berja,12331,6204,6127
04,Almería,30,Canjáyar,1223,633,590
04,Almería,31,Cantoria,3251,1653,1598
04,Almería,32,Carboneras,7837,4032,3805
04,Almería,33,Castro de Filabres,130,61,69
04,Almería,36,Chercos,291,147,144
04,Almería,37,Chirivel,1568,792,776
04,Almería,34,Cóbdar,156,92,64
04,Almería,35,Cuevas del Almanzora,13655,7103,6552
04,Almería,38,Dalías,3986,1973,2013
04,Almería,902,"Ejido, El",88096,46719,41377
04,Almería,41,Enix,434,241,193
04,Almería,43,Felix,661,372,289
04,Almería,44,Fines,2048,1066,982
04,Almería,45,Fiñana,2014,1007,1007
04,Almería,46,Fondón,1002,531,471
04,Almería,47,Gádor,3037,1575,1462
04,Almería,48,"Gallardos, Los",2841,1431,1410
04,Almería,49,Garrucha,8666,4465,4201
04,Almería,50,Gérgal,1030,546,484
04,Almería,51,Huécija,501,243,258
04,Almería,52,Huércal de Almería,17234,8791,8443
04,Almería,53,Huércal-Overa,18649,9254,9395
04,Almería,54,Íllar,374,202,172
04,Almería,55,Instinción,430,208,222
04,Almería,56,Laroya,169,95,74
04,Almería,57,Láujar de Andarax,1533,762,771
04,Almería,58,Líjar,395,207,188
04,Almería,59,Lubrín,1440,704,736
04,Almería,60,Lucainena de las Torres,570,308,262
04,Almería,61,Lúcar,771,382,389
04,Almería,62,Macael,5576,2866,2710
04,Almería,63,María,1288,659,629
04,Almería,64,Mojácar,6330,3115,3215
04,Almería,903,"Mojonera, La",8717,4816,3901
04,Almería,65,Nacimiento,475,240,235
04,Almería,66,Níjar,28996,15816,13180
04,Almería,67,Ohanes,626,306,320
04,Almería,68,Olula de Castro,191,103,88
04,Almería,69,Olula del Río,6216,3194,3022
04,Almería,70,Oria,2265,1191,1074
04,Almería,71,Padules,436,223,213
04,Almería,72,Partaloa,975,484,491
04,Almería,73,Paterna del Río,364,211,153
04,Almería,74,Pechina,4010,2036,1974
04,Almería,75,Pulpí,9055,4669,4386
04,Almería,76,Purchena,1636,846,790
04,Almería,77,Rágol,307,165,142
04,Almería,78,Rioja,1367,684,683
04,Almería,79,Roquetas de Mar,93363,48180,45183
04,Almería,80,Santa Cruz de Marchena,225,111,114
04,Almería,81,Santa Fe de Mondújar,429,216,213
04,Almería,82,Senés,312,166,146
04,Almería,83,Serón,2080,1058,1022
04,Almería,84,Sierro,400,210,190
04,Almería,85,Somontín,471,236,235
04,Almería,86,Sorbas,2463,1296,1167
04,Almería,87,Suflí,222,119,103
04,Almería,88,Tabernas,3679,1893,1786
04,Almería,89,Taberno,984,480,504
04,Almería,90,Tahal,346,174,172
04,Almería,91,Terque,386,194,192
04,Almería,92,Tíjola,3615,1786,1829
04,Almería,901,"Tres Villas, Las",598,320,278
04,Almería,93,Turre,3317,1692,1625
04,Almería,94,Turrillas,229,133,96
04,Almería,95,Uleila del Campo,848,427,421
04,Almería,96,Urrácal,332,171,161
04,Almería,97,Velefique,247,132,115
04,Almería,98,Vélez-Blanco,1918,998,920
04,Almería,99,Vélez-Rubio,6661,3227,3434
04,Almería,100,Vera,15528,7916,7612
04,Almería,101,Viator,5686,2911,2775
04,Almería,102,Vícar,25149,13388,11761
04,Almería,103,Zurgena,2877,1437,1440
01,Araba/Álava,51,Agurain/Salvatierra,5025,2502,2523
01,Araba/Álava,1,Alegría-Dulantzi,2913,1512,1401
01,Araba/Álava,2,Amurrio,10291,5101,5190
01,Araba/Álava,49,Añana,156,89,67
01,Araba/Álava,3,Aramaio,1496,791,705
01,Araba/Álava,6,Armiñón,239,128,111
01,Araba/Álava,37,Arraia-Maeztu,725,404,321
01,Araba/Álava,8,Arratzua-Ubarrundia,976,528,448
01,Araba/Álava,4,Artziniega,1829,914,915
01,Araba/Álava,9,Asparrena,1640,823,817
01,Araba/Álava,10,Ayala/Aiara,2969,1508,1461
01,Araba/Álava,11,Baños de Ebro/Mañueta,306,167,139
01,Araba/Álava,13,Barrundia,898,502,396
01,Araba/Álava,14,Berantevilla,443,236,207
01,Araba/Álava,16,Bernedo,504,299,205
01,Araba/Álava,17,Campezo/Kanpezu,1048,556,492
01,Araba/Álava,21,Elburgo/Burgelu,607,319,288
01,Araba/Álava,22,Elciego,1030,514,516
01,Araba/Álava,23,Elvillar/Bilar,353,173,180
01,Araba/Álava,46,Erriberagoitia/Ribera Alta,736,420,316
01,Araba/Álava,56,Harana/Valle de Arana,232,132,100
01,Araba/Álava,901,Iruña Oka/Iruña de Oca,3264,1683,1581
01,Araba/Álava,27,Iruraiz-Gauna,530,289,241
01,Araba/Álava,19,Kripan,184,98,86
01,Araba/Álava,20,Kuartango,372,216,156
01,Araba/Álava,28,Labastida/Bastida,1454,762,692
01,Araba/Álava,30,Lagrán,166,92,74
01,Araba/Álava,31,Laguardia,1474,763,711
01,Araba/Álava,32,Lanciego/Lantziego,673,345,328
01,Araba/Álava,902,Lantarón,899,502,397
01,Araba/Álava,33,Lapuebla de Labarca,859,448,411
01,Araba/Álava,36,Laudio/Llodio,18133,8965,9168
01,Araba/Álava,58,Legutio,1800,960,840
01,Araba/Álava,34,Leza,203,100,103
01,Araba/Álava,39,Moreda de Álava/Moreda Araba,230,115,115
01,Araba/Álava,41,Navaridas,226,132,94
01,Araba/Álava,42,Okondo,1155,600,555
01,Araba/Álava,43,Oyón-Oion,3338,1693,1645
01,Araba/Álava,44,Peñacerrada-Urizaharra,264,156,108
01,Araba/Álava,47,Ribera Baja/Erribera Beitia,1375,748,627
01,Araba/Álava,52,Samaniego,323,163,160
01,Araba/Álava,53,San Millán/Donemiliaga,709,394,315
01,Araba/Álava,54,Urkabustaiz,1330,699,631
01,Araba/Álava,55,Valdegovía/Gaubea,996,557,439
01,Araba/Álava,57,Villabuena de Álava/Eskuernaga,300,152,148
01,Araba/Álava,59,Vitoria-Gasteiz,246976,120500,126476
01,Araba/Álava,60,Yécora/Iekora,270,139,131
01,Araba/Álava,61,Zalduondo,190,106,84
01,Araba/Álava,62,Zambrana,383,208,175
01,Araba/Álava,18,Zigoitia,1766,960,806
01,Araba/Álava,63,Zuia,2316,1191,1125
33,Asturias,1,Allande,1742,881,861
33,Asturias,2,Aller,11027,5423,5604
33,Asturias,3,Amieva,699,385,314
33,Asturias,4,Avilés,79514,37632,41882
33,Asturias,5,Belmonte de Miranda,1554,806,748
33,Asturias,6,Bimenes,1737,829,908
33,Asturias,7,Boal,1586,799,787
33,Asturias,8,Cabrales,2008,1027,981
33,Asturias,9,Cabranes,1058,539,519
33,Asturias,10,Candamo,2028,995,1033
33,Asturias,12,Cangas de Onís,6332,3064,3268
33,Asturias,11,Cangas del Narcea,12947,6392,6555
33,Asturias,13,Caravia,472,241,231
33,Asturias,14,Carreño,10545,5096,5449
33,Asturias,15,Caso,1574,890,684
33,Asturias,16,Castrillón,22490,10892,11598
33,Asturias,17,Castropol,3510,1712,1798
33,Asturias,18,Coaña,3387,1651,1736
33,Asturias,19,Colunga,3440,1688,1752
33,Asturias,20,Corvera de Asturias,15871,7794,8077
33,Asturias,21,Cudillero,5183,2572,2611
33,Asturias,22,Degaña,978,508,470
33,Asturias,23,"Franco, El",3834,1886,1948
33,Asturias,24,Gijón,272365,128355,144010
33,Asturias,25,Gozón,10440,5077,5363
33,Asturias,26,Grado,9980,4823,5157
33,Asturias,27,Grandas de Salime,874,448,426
33,Asturias,28,Ibias,1362,765,597
33,Asturias,29,Illano,360,181,179
33,Asturias,30,Illas,1017,513,504
33,Asturias,31,Langreo,40529,19289,21240
33,Asturias,32,Laviana,13236,6347,6889
33,Asturias,33,Lena,11278,5427,5851
33,Asturias,35,Llanera,13794,6857,6937
33,Asturias,36,Llanes,13759,6677,7082
33,Asturias,37,Mieres,38962,18506,20456
33,Asturias,38,Morcín,2666,1335,1331
33,Asturias,39,Muros de Nalón,1858,885,973
33,Asturias,40,Nava,5333,2626,2707
33,Asturias,41,Navia,8425,4062,4363
33,Asturias,42,Noreña,5210,2505,2705
33,Asturias,43,Onís,743,396,347
33,Asturias,44,Oviedo,220301,102047,118254
33,Asturias,45,Parres,5389,2634,2755
33,Asturias,46,Peñamellera Alta,544,280,264
33,Asturias,47,Peñamellera Baja,1261,611,650
33,Asturias,48,Pesoz,156,84,72
33,Asturias,49,Piloña,7178,3546,3632
33,Asturias,50,Ponga,623,372,251
33,Asturias,51,Pravia,8384,4050,4334
33,Asturias,52,Proaza,754,435,319
33,Asturias,53,Quirós,1212,693,519
33,Asturias,54,"Regueras, Las",1874,958,916
33,Asturias,55,Ribadedeva,1753,839,914
33,Asturias,56,Ribadesella,5779,2755,3024
33,Asturias,57,Ribera de Arriba,1873,940,933
33,Asturias,58,Riosa,1991,1002,989
33,Asturias,59,Salas,5140,2543,2597
33,Asturias,61,San Martín de Oscos,403,203,200
33,Asturias,60,San Martín del Rey Aurelio,16584,7947,8637
33,Asturias,63,San Tirso de Abres,447,218,229
33,Asturias,62,Santa Eulalia de Oscos,461,244,217
33,Asturias,64,Santo Adriano,278,138,140
33,Asturias,65,Sariego,1252,607,645
33,Asturias,66,Siero,51776,25218,26558
33,Asturias,67,Sobrescobio,834,444,390
33,Asturias,68,Somiedo,1142,662,480
33,Asturias,69,Soto del Barco,3924,1949,1975
33,Asturias,70,Tapia de Casariego,3851,1867,1984
33,Asturias,71,Taramundi,652,317,335
33,Asturias,72,Teverga,1678,897,781
33,Asturias,73,Tineo,9700,4884,4816
33,Asturias,34,Valdés,11987,5849,6138
33,Asturias,74,Vegadeo,3894,1874,2020
33,Asturias,75,Villanueva de Oscos,303,150,153
33,Asturias,76,Villaviciosa,14455,7137,7318
33,Asturias,77,Villayón,1280,663,617
33,Asturias,78,Yernes y Tameza,140,78,62
05,Ávila,1,Adanero,211,117,94
05,Ávila,2,"Adrada, La",2583,1328,1255
05,Ávila,5,Albornos,199,106,93
05,Ávila,7,Aldeanueva de Santa Cruz,120,62,58
05,Ávila,8,Aldeaseca,255,127,128
05,Ávila,10,"Aldehuela, La",172,88,84
05,Ávila,12,Amavida,139,69,70
05,Ávila,13,"Arenal, El",996,505,491
05,Ávila,14,Arenas de San Pedro,6556,3182,3374
05,Ávila,15,Arevalillo,78,38,40
05,Ávila,16,Arévalo,8087,3932,4155
05,Ávila,17,Aveinte,83,46,37
05,Ávila,18,Avellaneda,29,17,12
05,Ávila,19,Ávila,58149,27784,30365
05,Ávila,21,"Barco de Ávila, El",2436,1175,1261
05,Ávila,22,"Barraco, El",1886,975,911
05,Ávila,23,Barromán,183,101,82
05,Ávila,24,Becedas,219,116,103
05,Ávila,25,Becedillas,95,52,43
05,Ávila,26,Bercial de Zapardiel,206,109,97
05,Ávila,27,"Berlanas, Las",324,167,157
05,Ávila,29,Bernuy-Zapardiel,121,70,51
05,Ávila,30,Berrocalejo de Aragona,39,19,20
05,Ávila,33,Blascomillán,199,105,94
05,Ávila,34,Blasconuño de Matacabras,14,8,6
05,Ávila,35,Blascosancho,106,49,57
05,Ávila,36,"Bohodón, El",126,64,62
05,Ávila,37,Bohoyo,261,144,117
05,Ávila,38,Bonilla de la Sierra,124,73,51
05,Ávila,39,Brabos,47,29,18
05,Ávila,40,Bularros,68,44,24
05,Ávila,41,Burgohondo,1225,634,591
05,Ávila,42,Cabezas de Alambre,158,79,79
05,Ávila,43,Cabezas del Pozo,83,45,38
05,Ávila,44,Cabezas del Villar,296,165,131
05,Ávila,45,Cabizuela,94,50,44
05,Ávila,46,Canales,49,27,22
05,Ávila,47,Candeleda,5002,2543,2459
05,Ávila,48,Cantiveros,115,64,51
05,Ávila,49,Cardeñosa,440,233,207
05,Ávila,51,"Carrera, La",184,102,82
05,Ávila,52,Casas del Puerto,99,52,47
05,Ávila,53,Casasola,84,44,40
05,Ávila,54,Casavieja,1468,761,707
05,Ávila,55,Casillas,650,348,302
05,Ávila,56,Castellanos de Zapardiel,95,51,44
05,Ávila,57,Cebreros,3100,1599,1501
05,Ávila,58,Cepeda la Mora,80,44,36
05,Ávila,67,Chamartín,82,48,34
05,Ávila,59,Cillán,108,64,44
05,Ávila,60,Cisla,110,57,53
05,Ávila,61,"Colilla, La",328,170,158
05,Ávila,62,Collado de Contreras,181,95,86
05,Ávila,63,Collado del Mirón,35,21,14
05,Ávila,64,Constanzana,109,65,44
05,Ávila,65,Crespos,516,281,235
05,Ávila,66,Cuevas del Valle,492,269,223
05,Ávila,903,Diego del Carpio,148,81,67
05,Ávila,69,Donjimeno,79,46,33
05,Ávila,70,Donvidas,36,19,17
05,Ávila,72,Espinosa de los Caballeros,96,53,43
05,Ávila,73,Flores de Ávila,321,177,144
05,Ávila,74,Fontiveros,754,392,362
05,Ávila,75,Fresnedilla,127,55,72
05,Ávila,76,"Fresno, El",597,308,289
05,Ávila,77,Fuente el Saúz,170,92,78
05,Ávila,78,Fuentes de Año,108,58,50
05,Ávila,79,Gallegos de Altamiros,65,38,27
05,Ávila,80,Gallegos de Sobrinos,48,22,26
05,Ávila,81,Garganta del Villar,41,29,12
05,Ávila,82,Gavilanes,598,316,282
05,Ávila,83,Gemuño,161,84,77
05,Ávila,85,Gil García,39,18,21
05,Ávila,84,Gilbuena,70,41,29
05,Ávila,86,Gimialcón,78,48,30
05,Ávila,87,Gotarrendura,161,56,105
05,Ávila,88,Grandes y San Martín,31,15,16
05,Ávila,89,Guisando,521,258,263
05,Ávila,90,Gutierre-Muñoz,77,37,40
05,Ávila,92,Hernansancho,170,95,75
05,Ávila,93,Herradón de Pinares,480,272,208
05,Ávila,94,Herreros de Suso,134,73,61
05,Ávila,95,Higuera de las Dueñas,281,153,128
05,Ávila,96,"Hija de Dios, La",81,48,33
05,Ávila,97,"Horcajada, La",500,255,245
05,Ávila,99,Horcajo de las Torres,531,300,231
05,Ávila,100,"Hornillo, El",289,153,136
05,Ávila,102,"Hoyo de Pinares, El",2216,1146,1070
05,Ávila,101,Hoyocasero,303,174,129
05,Ávila,103,Hoyorredondo,71,37,34
05,Ávila,106,Hoyos de Miguel Muñoz,31,15,16
05,Ávila,104,Hoyos del Collado,36,21,15
05,Ávila,105,Hoyos del Espino,380,209,171
05,Ávila,107,Hurtumpascual,57,34,23
05,Ávila,108,Junciana,42,22,20
05,Ávila,109,Langa,495,259,236
05,Ávila,110,Lanzahíta,860,443,417
05,Ávila,113,"Llanos de Tormes, Los",70,31,39
05,Ávila,112,"Losar del Barco, El",108,55,53
05,Ávila,114,Madrigal de las Altas Torres,1464,746,718
05,Ávila,115,Maello,600,308,292
05,Ávila,116,Malpartida de Corneja,107,54,53
05,Ávila,117,Mamblas,210,118,92
05,Ávila,118,Mancera de Arriba,78,44,34
05,Ávila,119,Manjabálago y Ortigosa de Rioalmar,28,17,11
05,Ávila,120,Marlín,33,22,11
05,Ávila,121,Martiherrero,307,160,147
05,Ávila,122,Martínez,129,66,63
05,Ávila,123,Mediana de Voltoya,103,51,52
05,Ávila,124,Medinilla,102,44,58
05,Ávila,125,Mengamuñoz,63,32,31
05,Ávila,126,Mesegar de Corneja,64,37,27
05,Ávila,127,Mijares,736,401,335
05,Ávila,128,Mingorría,394,206,188
05,Ávila,129,"Mirón, El",127,77,50
05,Ávila,130,Mironcillo,93,50,43
05,Ávila,131,Mirueña de los Infanzones,98,55,43
05,Ávila,132,Mombeltrán,1070,556,514
05,Ávila,133,Monsalupe,71,36,35
05,Ávila,134,Moraleja de Matacabras,51,31,20
05,Ávila,135,Muñana,408,216,192
05,Ávila,136,Muñico,107,53,54
05,Ávila,138,Muñogalindo,343,175,168
05,Ávila,139,Muñogrande,62,34,28
05,Ávila,140,Muñomer del Peco,129,71,58
05,Ávila,141,Muñopepe,106,62,44
05,Ávila,142,Muñosancho,102,46,56
05,Ávila,143,Muñotello,63,32,31
05,Ávila,144,Narrillos del Álamo,78,42,36
05,Ávila,145,Narrillos del Rebollar,53,30,23
05,Ávila,149,Narros de Saldueña,107,61,46
05,Ávila,147,Narros del Castillo,166,92,74
05,Ávila,148,Narros del Puerto,23,11,12
05,Ávila,152,Nava de Arévalo,761,402,359
05,Ávila,153,Nava del Barco,97,52,45
05,Ávila,151,Navacepedilla de Corneja,98,52,46
05,Ávila,154,Navadijos,38,27,11
05,Ávila,155,Navaescurial,55,34,21
05,Ávila,156,Navahondilla,320,181,139
05,Ávila,157,Navalacruz,243,127,116
05,Ávila,158,Navalmoral,340,180,160
05,Ávila,159,Navalonguilla,253,126,127
05,Ávila,160,Navalosa,326,182,144
05,Ávila,161,Navalperal de Pinares,815,418,397
05,Ávila,162,Navalperal de Tormes,90,47,43
05,Ávila,163,Navaluenga,1902,933,969
05,Ávila,164,Navaquesera,21,9,12
05,Ávila,165,Navarredonda de Gredos,455,222,233
05,Ávila,166,Navarredondilla,184,99,85
05,Ávila,167,Navarrevisca,285,154,131
05,Ávila,168,"Navas del Marqués, Las",5187,2635,2552
05,Ávila,169,Navatalgordo,233,129,104
05,Ávila,170,Navatejares,54,27,27
05,Ávila,171,Neila de San Miguel,71,35,36
05,Ávila,172,Niharra,188,103,85
05,Ávila,173,Ojos-Albos,60,37,23
05,Ávila,174,Orbita,76,41,35
05,Ávila,175,"Oso, El",174,100,74
05,Ávila,176,Padiernos,269,146,123
05,Ávila,177,Pajares de Adaja,170,90,80
05,Ávila,178,Palacios de Goda,416,217,199
05,Ávila,179,Papatrigo,236,117,119
05,Ávila,180,"Parral, El",75,40,35
05,Ávila,181,Pascualcobo,43,27,16
05,Ávila,182,Pedro Bernardo,876,463,413
05,Ávila,183,Pedro-Rodríguez,148,78,70
05,Ávila,184,Peguerinos,280,151,129
05,Ávila,185,Peñalba de Ávila,109,59,50
05,Ávila,186,Piedrahíta,1823,865,958
05,Ávila,187,Piedralaves,2105,1060,1045
05,Ávila,188,Poveda,47,30,17
05,Ávila,189,Poyales del Hoyo,521,280,241
05,Ávila,190,Pozanco,50,31,19
05,Ávila,191,Pradosegar,132,69,63
05,Ávila,192,Puerto Castilla,114,69,45
05,Ávila,193,Rasueros,194,113,81
05,Ávila,194,Riocabado,151,85,66
05,Ávila,195,Riofrío,223,132,91
05,Ávila,196,Rivilla de Barajas,59,26,33
05,Ávila,197,Salobral,102,54,48
05,Ávila,198,Salvadiós,75,37,38
05,Ávila,199,San Bartolomé de Béjar,41,23,18
05,Ávila,200,San Bartolomé de Corneja,48,23,25
05,Ávila,201,San Bartolomé de Pinares,563,301,262
05,Ávila,206,San Esteban de los Patos,33,19,14
05,Ávila,208,San Esteban de Zapardiel,38,23,15
05,Ávila,207,San Esteban del Valle,770,405,365
05,Ávila,209,San García de Ingelmos,82,48,34
05,Ávila,901,San Juan de Gredos,265,143,122
05,Ávila,210,San Juan de la Encinilla,86,44,42
05,Ávila,211,San Juan de la Nava,500,262,238
05,Ávila,212,San Juan del Molinillo,205,117,88
05,Ávila,213,San Juan del Olmo,104,63,41
05,Ávila,214,San Lorenzo de Tormes,36,21,15
05,Ávila,215,San Martín de la Vega del Alberche,177,103,74
05,Ávila,216,San Martín del Pimpollar,183,105,78
05,Ávila,217,San Miguel de Corneja,59,32,27
05,Ávila,218,San Miguel de Serrezuela,123,66,57
05,Ávila,219,San Pascual,42,26,16
05,Ávila,220,San Pedro del Arroyo,427,224,203
05,Ávila,231,San Vicente de Arévalo,179,104,75
05,Ávila,204,Sanchidrián,738,379,359
05,Ávila,205,Sanchorreja,81,41,40
05,Ávila,222,Santa Cruz de Pinares,146,80,66
05,Ávila,221,Santa Cruz del Valle,370,192,178
05,Ávila,226,Santa María de los Caballeros,74,45,29
05,Ávila,224,Santa María del Arroyo,112,59,53
05,Ávila,225,Santa María del Berrocal,416,228,188
05,Ávila,902,Santa María del Cubillo,309,181,128
05,Ávila,227,Santa María del Tiétar,460,244,216
05,Ávila,228,Santiago del Collado,178,109,69
05,Ávila,904,Santiago del Tormes,130,73,57
05,Ávila,229,Santo Domingo de las Posadas,79,42,37
05,Ávila,230,Santo Tomé de Zabarcos,67,37,30
05,Ávila,232,"Serrada, La",117,62,55
05,Ávila,233,Serranillos,247,138,109
05,Ávila,234,Sigeres,43,22,21
05,Ávila,235,Sinlabajos,130,70,60
05,Ávila,236,Solana de Ávila,117,66,51
05,Ávila,237,Solana de Rioalmar,173,98,75
05,Ávila,238,Solosancho,859,460,399
05,Ávila,239,Sotalbo,237,125,112
05,Ávila,240,Sotillo de la Adrada,4535,2259,2276
05,Ávila,241,"Tiemblo, El",4143,2115,2028
05,Ávila,242,Tiñosillos,802,412,390
05,Ávila,243,Tolbaños,95,53,42
05,Ávila,244,Tormellas,46,27,19
05,Ávila,245,Tornadizos de Ávila,432,217,215
05,Ávila,247,"Torre, La",246,134,112
05,Ávila,246,Tórtoles,62,32,30
05,Ávila,249,Umbrías,105,56,49
05,Ávila,251,Vadillo de la Sierra,57,35,22
05,Ávila,252,Valdecasa,70,41,29
05,Ávila,253,Vega de Santa María,87,43,44
05,Ávila,254,Velayos,220,108,112
05,Ávila,256,Villaflor,120,63,57
05,Ávila,257,Villafranca de la Sierra,128,71,57
05,Ávila,905,Villanueva de Ávila,224,111,113
05,Ávila,258,Villanueva de Gómez,138,80,58
05,Ávila,259,Villanueva del Aceral,131,65,66
05,Ávila,260,Villanueva del Campillo,99,56,43
05,Ávila,261,Villar de Corneja,37,22,15
05,Ávila,262,Villarejo del Valle,381,204,177
05,Ávila,263,Villatoro,178,100,78
05,Ávila,264,Viñegra de Moraña,48,26,22
05,Ávila,265,Vita,87,51,36
05,Ávila,266,Zapardiel de la Cañada,98,55,43
05,Ávila,267,Zapardiel de la Ribera,113,58,55
06,Badajoz,1,Acedera,818,428,390
06,Badajoz,2,Aceuchal,5436,2692,2744
06,Badajoz,3,Ahillones,914,456,458
06,Badajoz,4,Alange,1891,958,933
06,Badajoz,5,"Albuera, La",2024,1053,971
06,Badajoz,6,Alburquerque,5371,2687,2684
06,Badajoz,7,Alconchel,1717,861,856
06,Badajoz,8,Alconera,738,361,377
06,Badajoz,9,Aljucén,242,134,108
06,Badajoz,10,Almendral,1262,616,646
06,Badajoz,11,Almendralejo,33540,16629,16911
06,Badajoz,12,Arroyo de San Serván,4167,2120,2047
06,Badajoz,13,Atalaya,294,153,141
06,Badajoz,14,Azuaga,7984,3950,4034
06,Badajoz,15,Badajoz,150543,73003,77540
06,Badajoz,16,Barcarrota,3608,1838,1770
06,Badajoz,17,Baterno,305,161,144
06,Badajoz,18,Benquerencia de la Serena,849,418,431
06,Badajoz,19,Berlanga,2386,1201,1185
06,Badajoz,20,Bienvenida,2149,1115,1034
06,Badajoz,21,Bodonal de la Sierra,1060,549,511
06,Badajoz,22,Burguillos del Cerro,3090,1528,1562
06,Badajoz,23,Cabeza del Buey,5015,2481,2534
06,Badajoz,24,Cabeza la Vaca,1345,685,660
06,Badajoz,25,Calamonte,6260,3112,3148
06,Badajoz,26,Calera de León,999,504,495
06,Badajoz,27,Calzadilla de los Barros,789,391,398
06,Badajoz,28,Campanario,5025,2476,2549
06,Badajoz,29,Campillo de Llerena,1390,701,689
06,Badajoz,30,Capilla,187,95,92
06,Badajoz,31,Carmonita,562,281,281
06,Badajoz,32,"Carrascalejo, El",70,37,33
06,Badajoz,33,Casas de Don Pedro,1527,789,738
06,Badajoz,34,Casas de Reina,197,92,105
06,Badajoz,35,Castilblanco,1005,513,492
06,Badajoz,36,Castuera,6027,2964,3063
06,Badajoz,42,Cheles,1213,585,628
06,Badajoz,37,"Codosera, La",2131,1131,1000
06,Badajoz,38,Cordobilla de Lácara,937,478,459
06,Badajoz,39,"Coronada, La",2193,1075,1118
06,Badajoz,40,Corte de Peleas,1267,624,643
06,Badajoz,41,Cristina,567,289,278
06,Badajoz,43,Don Álvaro,766,396,370
06,Badajoz,44,Don Benito,36924,18245,18679
06,Badajoz,45,Entrín Bajo,583,293,290
06,Badajoz,46,Esparragalejo,1463,719,744
06,Badajoz,47,Esparragosa de la Serena,1032,529,503
06,Badajoz,48,Esparragosa de Lares,942,456,486
06,Badajoz,49,Feria,1176,573,603
06,Badajoz,50,Fregenal de la Sierra,4904,2415,2489
06,Badajoz,51,Fuenlabrada de los Montes,1898,937,961
06,Badajoz,52,Fuente de Cantos,4852,2407,2445
06,Badajoz,53,Fuente del Arco,693,348,345
06,Badajoz,54,Fuente del Maestre,6822,3383,3439
06,Badajoz,55,Fuentes de León,2340,1150,1190
06,Badajoz,56,Garbayuela,532,282,250
06,Badajoz,57,Garlitos,614,318,296
06,Badajoz,58,"Garrovilla, La",2421,1216,1205
06,Badajoz,59,Granja de Torrehermosa,2101,1046,1055
06,Badajoz,903,Guadiana del Caudillo,2550,1254,1296
06,Badajoz,60,Guareña,7057,3560,3497
06,Badajoz,61,"Haba, La",1263,629,634
06,Badajoz,62,Helechosa de los Montes,665,376,289
06,Badajoz,63,Herrera del Duque,3557,1778,1779
06,Badajoz,64,Higuera de la Serena,948,498,450
06,Badajoz,65,Higuera de Llerena,346,176,170
06,Badajoz,66,Higuera de Vargas,1975,995,980
06,Badajoz,67,Higuera la Real,2297,1156,1141
06,Badajoz,68,Hinojosa del Valle,489,241,248
06,Badajoz,69,Hornachos,3673,1848,1825
06,Badajoz,70,Jerez de los Caballeros,9445,4675,4770
06,Badajoz,71,"Lapa, La",289,149,140
06,Badajoz,73,Llera,875,454,421
06,Badajoz,74,Llerena,5821,2896,2925
06,Badajoz,72,Lobón,2804,1434,1370
06,Badajoz,75,Magacela,535,279,256
06,Badajoz,76,Maguilla,982,482,500
06,Badajoz,77,Malcocinado,372,206,166
06,Badajoz,78,Malpartida de la Serena,572,295,277
06,Badajoz,79,Manchita,774,394,380
06,Badajoz,80,Medellín,2285,1144,1141
06,Badajoz,81,Medina de las Torres,1238,633,605
06,Badajoz,82,Mengabril,470,253,217
06,Badajoz,83,Mérida,59187,28889,30298
06,Badajoz,84,Mirandilla,1308,665,643
06,Badajoz,85,Monesterio,4261,2183,2078
06,Badajoz,86,Montemolín,1403,679,724
06,Badajoz,87,Monterrubio de la Serena,2463,1190,1273
06,Badajoz,88,Montijo,15649,7741,7908
06,Badajoz,89,"Morera, La",725,368,357
06,Badajoz,90,"Nava de Santiago, La",969,493,476
06,Badajoz,91,Navalvillar de Pela,4553,2309,2244
06,Badajoz,92,Nogales,682,338,344
06,Badajoz,93,Oliva de la Frontera,5256,2651,2605
06,Badajoz,94,Oliva de Mérida,1763,903,860
06,Badajoz,95,Olivenza,11977,5982,5995
06,Badajoz,96,Orellana de la Sierra,239,127,112
06,Badajoz,97,Orellana la Vieja,2756,1433,1323
06,Badajoz,98,Palomas,705,347,358
06,Badajoz,99,"Parra, La",1348,689,659
06,Badajoz,100,Peñalsordo,1008,482,526
06,Badajoz,101,Peraleda del Zaucejo,530,267,263
06,Badajoz,102,Puebla de Alcocer,1216,593,623
06,Badajoz,103,Puebla de la Calzada,5914,2964,2950
06,Badajoz,104,Puebla de la Reina,771,382,389
06,Badajoz,107,Puebla de Obando,1860,944,916
06,Badajoz,108,Puebla de Sancho Pérez,2745,1385,1360
06,Badajoz,105,Puebla del Maestre,716,365,351
06,Badajoz,106,Puebla del Prior,495,253,242
06,Badajoz,902,Pueblonuevo del Guadiana,2024,1024,1000
06,Badajoz,109,Quintana de la Serena,4702,2384,2318
06,Badajoz,110,Reina,162,80,82
06,Badajoz,111,Rena,624,320,304
06,Badajoz,112,Retamal de Llerena,455,235,220
06,Badajoz,113,Ribera del Fresno,3394,1674,1720
06,Badajoz,114,Risco,150,76,74
06,Badajoz,115,"Roca de la Sierra, La",1503,740,763
06,Badajoz,116,Salvaleón,1829,917,912
06,Badajoz,117,Salvatierra de los Barros,1692,828,864
06,Badajoz,119,San Pedro de Mérida,850,435,415
06,Badajoz,123,San Vicente de Alcántara,5528,2782,2746
06,Badajoz,118,Sancti-Spíritus,188,105,83
06,Badajoz,120,Santa Amalia,4065,2061,2004
06,Badajoz,121,Santa Marta,4204,2111,2093
06,Badajoz,122,"Santos de Maimona, Los",8137,4120,4017
06,Badajoz,124,Segura de León,1944,957,987
06,Badajoz,125,Siruela,1944,973,971
06,Badajoz,126,Solana de los Barros,2679,1332,1347
06,Badajoz,127,Talarrubias,3473,1730,1743
06,Badajoz,128,Talavera la Real,5381,2701,2680
06,Badajoz,129,Táliga,697,347,350
06,Badajoz,130,Tamurejo,223,115,108
06,Badajoz,131,Torre de Miguel Sesmero,1279,652,627
06,Badajoz,132,Torremayor,998,481,517
06,Badajoz,133,Torremejía,2270,1167,1103
06,Badajoz,134,Trasierra,644,341,303
06,Badajoz,135,Trujillanos,1409,727,682
06,Badajoz,136,Usagre,1787,881,906
06,Badajoz,137,Valdecaballeros,1105,571,534
06,Badajoz,901,Valdelacalzada,2753,1404,1349
06,Badajoz,138,Valdetorres,1204,590,614
06,Badajoz,139,Valencia de las Torres,600,318,282
06,Badajoz,140,Valencia del Mombuey,747,378,369
06,Badajoz,141,Valencia del Ventoso,2035,1018,1017
06,Badajoz,146,Valle de la Serena,1251,637,614
06,Badajoz,147,Valle de Matamoros,372,183,189
06,Badajoz,148,Valle de Santa Ana,1148,564,584
06,Badajoz,142,Valverde de Burguillos,290,151,139
06,Badajoz,143,Valverde de Leganés,4204,2116,2088
06,Badajoz,144,Valverde de Llerena,621,308,313
06,Badajoz,145,Valverde de Mérida,1068,540,528
06,Badajoz,149,Villafranca de los Barros,13114,6479,6635
06,Badajoz,150,Villagarcía de la Torre,926,481,445
06,Badajoz,151,Villagonzalo,1247,604,643
06,Badajoz,152,Villalba de los Barros,1538,783,755
06,Badajoz,153,Villanueva de la Serena,25882,12636,13246
06,Badajoz,154,Villanueva del Fresno,3411,1695,1716
06,Badajoz,156,Villar de Rena,1397,724,673
06,Badajoz,155,Villar del Rey,2203,1176,1027
06,Badajoz,157,Villarta de los Montes,476,241,235
06,Badajoz,158,Zafra,16822,8135,8687
06,Badajoz,159,Zahínos,2819,1399,1420
06,Badajoz,160,Zalamea de la Serena,3665,1847,1818
06,Badajoz,162,"Zarza, La",3485,1771,1714
06,Badajoz,161,Zarza-Capilla,328,167,161
07,"Balears, Illes",2,Alaior,9097,4573,4524
07,"Balears, Illes",1,Alaró,5389,2603,2786
07,"Balears, Illes",3,Alcúdia,19395,9785,9610
07,"Balears, Illes",4,Algaida,5430,2771,2659
07,"Balears, Illes",5,Andratx,10930,5418,5512
07,"Balears, Illes",901,Ariany,854,454,400
07,"Balears, Illes",6,Artà,7541,3781,3760
07,"Balears, Illes",7,Banyalbufar,495,269,226
07,"Balears, Illes",8,Binissalem,8143,4043,4100
07,"Balears, Illes",9,Búger,1046,533,513
07,"Balears, Illes",10,Bunyola,6636,3251,3385
07,"Balears, Illes",11,Calvià,49063,24544,24519
07,"Balears, Illes",12,Campanet,2512,1250,1262
07,"Balears, Illes",13,Campos,10418,5150,5268
07,"Balears, Illes",14,Capdepera,11267,5729,5538
07,"Balears, Illes",64,"Castell, Es",7343,3711,3632
07,"Balears, Illes",15,Ciutadella de Menorca,28838,14302,14536
07,"Balears, Illes",16,Consell,3962,2002,1960
07,"Balears, Illes",17,Costitx,1247,625,622
07,"Balears, Illes",18,Deià,637,303,334
07,"Balears, Illes",26,Eivissa,49689,25008,24681
07,"Balears, Illes",19,Escorca,217,125,92
07,"Balears, Illes",20,Esporles,4942,2443,2499
07,"Balears, Illes",21,Estellencs,305,161,144
07,"Balears, Illes",22,Felanitx,17333,8709,8624
07,"Balears, Illes",23,Ferreries,4633,2310,2323
07,"Balears, Illes",24,Formentera,12280,6429,5851
07,"Balears, Illes",25,Fornalutx,663,323,340
07,"Balears, Illes",27,Inca,31255,15729,15526
07,"Balears, Illes",28,Lloret de Vistalegre,1277,650,627
07,"Balears, Illes",29,Lloseta,5799,2930,2869
07,"Balears, Illes",30,Llubí,2206,1104,1102
07,"Balears, Illes",31,Llucmajor,35513,17982,17531
07,"Balears, Illes",33,Manacor,41095,20490,20605
07,"Balears, Illes",34,Mancor de la Vall,1449,726,723
07,"Balears, Illes",32,Maó-Mahón,28161,13795,14366
07,"Balears, Illes",35,Maria de la Salut,2159,1109,1050
07,"Balears, Illes",36,Marratxí,36383,18294,18089
07,"Balears, Illes",37,"Mercadal, Es",4788,2424,2364
07,"Balears, Illes",902,"Migjorn Gran, Es",1356,679,677
07,"Balears, Illes",38,Montuïri,2836,1433,1403
07,"Balears, Illes",39,Muro,6829,3429,3400
07,"Balears, Illes",40,Palma de Mallorca,406492,197833,208659
07,"Balears, Illes",41,Petra,2794,1390,1404
07,"Balears, Illes",44,"Pobla, Sa",12793,6516,6277
07,"Balears, Illes",42,Pollença,16157,8055,8102
07,"Balears, Illes",43,Porreres,5256,2693,2563
07,"Balears, Illes",45,Puigpunyent,1997,997,1000
07,"Balears, Illes",59,"Salines, Ses",4860,2451,2409
07,"Balears, Illes",46,Sant Antoni de Portmany,25290,13260,12030
07,"Balears, Illes",49,Sant Joan,2064,1018,1046
07,"Balears, Illes",50,Sant Joan de Labritja,6139,3129,3010
07,"Balears, Illes",48,Sant Josep de sa Talaia,26133,13507,12626
07,"Balears, Illes",51,Sant Llorenç des Cardassar,8328,4116,4212
07,"Balears, Illes",52,Sant Lluís,6954,3506,3448
07,"Balears, Illes",53,Santa Eugènia,1653,831,822
07,"Balears, Illes",54,Santa Eulària des Riu,36605,18615,17990
07,"Balears, Illes",55,Santa Margalida,11801,6007,5794
07,"Balears, Illes",56,Santa María del Camí,7062,3500,3562
07,"Balears, Illes",57,Santanyí,11348,5666,5682
07,"Balears, Illes",58,Selva,3869,1940,1929
07,"Balears, Illes",47,Sencelles,3154,1580,1574
07,"Balears, Illes",60,Sineu,3641,1794,1847
07,"Balears, Illes",61,Sóller,13936,7009,6927
07,"Balears, Illes",62,Son Servera,11265,5631,5634
07,"Balears, Illes",63,Valldemossa,1950,986,964
07,"Balears, Illes",65,Vilafranca de Bonany,3047,1516,1531
08,Barcelona,1,Abrera,12363,6283,6080
08,Barcelona,2,Aguilar de Segarra,263,142,121
08,Barcelona,14,Aiguafreda,2514,1204,1310
08,Barcelona,3,Alella,9625,4704,4921
08,Barcelona,4,Alpens,277,144,133
08,Barcelona,5,"Ametlla del Vallès, L'",8368,4228,4140
08,Barcelona,6,Arenys de Mar,15368,7457,7911
08,Barcelona,7,Arenys de Munt,8728,4380,4348
08,Barcelona,8,Argençola,220,113,107
08,Barcelona,9,Argentona,12133,5947,6186
08,Barcelona,10,Artés,5585,2822,2763
08,Barcelona,11,Avià,2249,1112,1137
08,Barcelona,12,Avinyó,2240,1119,1121
08,Barcelona,13,Avinyonet del Penedès,1653,873,780
08,Barcelona,15,Badalona,215848,106216,109632
08,Barcelona,904,Badia del Vallès,13466,6586,6880
08,Barcelona,16,Bagà,2149,1061,1088
08,Barcelona,17,Balenyà,3665,1844,1821
08,Barcelona,18,Balsareny,3240,1618,1622
08,Barcelona,252,Barberà del Vallès,32860,16211,16649
08,Barcelona,19,Barcelona,1620809,766625,854184
08,Barcelona,20,Begues,6830,3375,3455
08,Barcelona,21,Bellprat,74,46,28
08,Barcelona,22,Berga,16115,7945,8170
08,Barcelona,23,Bigues i Riells,8957,4569,4388
08,Barcelona,24,Borredà,480,267,213
08,Barcelona,25,"Bruc, El",1988,1073,915
08,Barcelona,26,"Brull, El",258,139,119
08,Barcelona,27,"Cabanyes, Les",947,484,463
08,Barcelona,28,Cabrera d'Anoia,1364,724,640
08,Barcelona,29,Cabrera de Mar,4594,2325,2269
08,Barcelona,30,Cabrils,7296,3602,3694
08,Barcelona,31,Calaf,3477,1776,1701
08,Barcelona,34,Calders,962,497,465
08,Barcelona,33,Caldes de Montbui,17187,8524,8663
08,Barcelona,32,Caldes d'Estrac,2823,1356,1467
08,Barcelona,35,Calella,18481,9015,9466
08,Barcelona,37,Calldetenes,2446,1238,1208
08,Barcelona,38,Callús,2067,1008,1059
08,Barcelona,36,Calonge de Segarra,198,100,98
08,Barcelona,39,Campins,498,260,238
08,Barcelona,40,Canet de Mar,14423,7008,7415
08,Barcelona,41,Canovelles,16145,8326,7819
08,Barcelona,42,Cànoves i Samalús,2906,1472,1434
08,Barcelona,43,Canyelles,4388,2251,2137
08,Barcelona,44,Capellades,5225,2582,2643
08,Barcelona,45,Capolat,99,47,52
08,Barcelona,46,Cardedeu,18210,8951,9259
08,Barcelona,47,Cardona,4728,2316,2412
08,Barcelona,48,Carme,791,407,384
08,Barcelona,49,Casserres,1557,767,790
08,Barcelona,57,Castell de l'Areny,69,40,29
08,Barcelona,52,Castellar de n'Hug,159,86,73
08,Barcelona,50,Castellar del Riu,166,96,70
08,Barcelona,51,Castellar del Vallès,23776,11702,12074
08,Barcelona,53,Castellbell i el Vilar,3618,1856,1762
08,Barcelona,54,Castellbisbal,12297,6220,6077
08,Barcelona,55,Castellcir,723,373,350
08,Barcelona,56,Castelldefels,65954,32562,33392
08,Barcelona,58,Castellet i la Gornal,2233,1132,1101
08,Barcelona,60,Castellfollit de Riubregós,160,91,69
08,Barcelona,59,Castellfollit del Boix,440,225,215
08,Barcelona,61,Castellgalí,2017,1056,961
08,Barcelona,62,Castellnou de Bages,1303,658,645
08,Barcelona,63,Castellolí,599,289,310
08,Barcelona,64,Castellterçol,2374,1182,1192
08,Barcelona,65,Castellví de la Marca,1554,772,782
08,Barcelona,66,Castellví de Rosanes,1826,898,928
08,Barcelona,67,Centelles,7417,3632,3785
08,Barcelona,268,Cercs,1166,573,593
08,Barcelona,266,Cerdanyola del Vallès,57723,28289,29434
08,Barcelona,68,Cervelló,8909,4443,4466
08,Barcelona,69,Collbató,4394,2274,2120
08,Barcelona,70,Collsuspina,338,177,161
08,Barcelona,71,Copons,316,158,158
08,Barcelona,72,Corbera de Llobregat,14439,7220,7219
08,Barcelona,73,Cornellà de Llobregat,86610,42023,44587
08,Barcelona,74,Cubelles,14715,7428,7287
08,Barcelona,75,Dosrius,5198,2622,2576
08,Barcelona,76,Esparreguera,21889,11088,10801
08,Barcelona,77,Esplugues de Llobregat,45890,21967,23923
08,Barcelona,78,"Espunyola, L'",240,123,117
08,Barcelona,254,"Esquirol, L'",2161,1098,1063
08,Barcelona,79,"Estany, L'",405,201,204
08,Barcelona,134,Figaró-Montmany,1077,533,544
08,Barcelona,80,Fígols,42,24,18
08,Barcelona,82,Fogars de la Selva,1448,747,701
08,Barcelona,81,Fogars de Montclús,458,245,213
08,Barcelona,83,Folgueroles,2298,1164,1134
08,Barcelona,84,Fonollosa,1412,736,676
08,Barcelona,85,Font-rubí,1358,696,662
08,Barcelona,86,"Franqueses del Vallès, Les",19584,9961,9623
08,Barcelona,90,Gaià,162,89,73
08,Barcelona,87,Gallifa,180,97,83
08,Barcelona,88,"Garriga, La",15984,7752,8232
08,Barcelona,89,Gavà,46538,22830,23708
08,Barcelona,91,Gelida,7299,3692,3607
08,Barcelona,92,Gironella,4808,2357,2451
08,Barcelona,93,Gisclareny,27,15,12
08,Barcelona,94,"Granada, La",2112,1076,1036
08,Barcelona,95,Granera,78,55,23
08,Barcelona,96,Granollers,60695,29897,30798
08,Barcelona,97,Gualba,1423,718,705
08,Barcelona,99,Guardiola de Berguedà,904,476,428
08,Barcelona,100,Gurb,2616,1338,1278
08,Barcelona,101,"Hospitalet de Llobregat, L'",257349,124443,132906
08,Barcelona,162,"Hostalets de Pierola, Els",2901,1494,1407
08,Barcelona,102,Igualada,39316,19255,20061
08,Barcelona,103,Jorba,823,413,410
08,Barcelona,104,"Llacuna, La",863,469,394
08,Barcelona,105,"Llagosta, La",13343,6586,6757
08,Barcelona,107,Lliçà d'Amunt,14933,7623,7310
08,Barcelona,108,Lliçà de Vall,6386,3248,3138
08,Barcelona,106,Llinars del Vallès,9749,4856,4893
08,Barcelona,109,Lluçà,279,137,142
08,Barcelona,110,Malgrat de Mar,18345,9181,9164
08,Barcelona,111,Malla,264,136,128
08,Barcelona,112,Manlleu,20007,9984,10023
08,Barcelona,113,Manresa,75152,36748,38404
08,Barcelona,242,Marganell,254,124,130
08,Barcelona,114,Martorell,27681,14100,13581
08,Barcelona,115,Martorelles,4742,2384,2358
08,Barcelona,116,"Masies de Roda, Les",714,355,359
08,Barcelona,117,"Masies de Voltregà, Les",3140,1550,1590
08,Barcelona,118,"Masnou, El",23288,11209,12079
08,Barcelona,119,Masquefa,8514,4271,4243
08,Barcelona,120,Matadepera,9186,4599,4587
08,Barcelona,121,Mataró,126127,62517,63610
08,Barcelona,122,Mediona,2251,1131,1120
08,Barcelona,138,Moià,6065,3085,2980
08,Barcelona,123,Molins de Rei,25492,12407,13085
08,Barcelona,124,Mollet del Vallès,51128,25210,25918
08,Barcelona,128,Monistrol de Calders,677,356,321
08,Barcelona,127,Monistrol de Montserrat,2935,1489,1446
08,Barcelona,125,Montcada i Reixac,35063,17261,17802
08,Barcelona,130,Montclar,121,61,60
08,Barcelona,131,Montesquiu,960,481,479
08,Barcelona,126,Montgat,11748,5788,5960
08,Barcelona,132,Montmajor,459,235,224
08,Barcelona,133,Montmaneu,153,85,68
08,Barcelona,135,Montmeló,8748,4271,4477
08,Barcelona,136,Montornès del Vallès,16240,8206,8034
08,Barcelona,137,Montseny,343,174,169
08,Barcelona,129,Muntanyola,613,316,297
08,Barcelona,139,Mura,227,124,103
08,Barcelona,140,Navarcles,5950,2895,3055
08,Barcelona,141,Navàs,6020,2997,3023
08,Barcelona,142,"Nou de Berguedà, La",157,80,77
08,Barcelona,143,Òdena,3614,1855,1759
08,Barcelona,145,Olèrdola,3565,1823,1742
08,Barcelona,146,Olesa de Bonesvalls,1734,915,819
08,Barcelona,147,Olesa de Montserrat,23552,11734,11818
08,Barcelona,148,Olivella,3655,1929,1726
08,Barcelona,149,Olost,1197,602,595
08,Barcelona,144,Olvan,844,410,434
08,Barcelona,150,Orís,316,160,156
08,Barcelona,151,Oristà,547,267,280
08,Barcelona,152,Orpí,134,74,60
08,Barcelona,153,Òrrius,694,359,335
08,Barcelona,154,Pacs del Penedès,902,455,447
08,Barcelona,155,Palafolls,9171,4629,4542
08,Barcelona,156,Palau-solità i Plegamans,14626,7170,7456
08,Barcelona,157,Pallejà,11416,5690,5726
08,Barcelona,905,"Palma de Cervelló, La",2998,1475,1523
08,Barcelona,158,"Papiol, El",4102,2029,2073
08,Barcelona,159,Parets del Vallès,18970,9532,9438
08,Barcelona,160,Perafita,411,210,201
08,Barcelona,161,Piera,15194,7743,7451
08,Barcelona,163,Pineda de Mar,26349,13147,13202
08,Barcelona,164,"Pla del Penedès, El",1232,612,620
08,Barcelona,165,"Pobla de Claramunt, La",2190,1109,1081
08,Barcelona,166,"Pobla de Lillet, La",1097,537,560
08,Barcelona,167,Polinyà,8383,4232,4151
08,Barcelona,182,"Pont de Vilomara i Rocafort, El",3794,1954,1840
08,Barcelona,168,Pontons,456,253,203
08,Barcelona,169,"Prat de Llobregat, El",63897,31364,32533
08,Barcelona,171,Prats de Lluçanès,2533,1265,1268
08,Barcelona,170,"Prats de Rei, Els",535,285,250
08,Barcelona,230,Premià de Dalt,10345,5188,5157
08,Barcelona,172,Premià de Mar,28049,13698,14351
08,Barcelona,174,Puigdàlber,506,253,253
08,Barcelona,175,Puig-reig,4086,1996,2090
08,Barcelona,176,Pujalt,203,110,93
08,Barcelona,177,"Quar, La",57,30,27
08,Barcelona,178,Rajadell,536,271,265
08,Barcelona,179,Rellinars,735,379,356
08,Barcelona,180,Ripollet,37899,18776,19123
08,Barcelona,181,"Roca del Vallès, La",10536,5275,5261
08,Barcelona,183,Roda de Ter,6125,2998,3127
08,Barcelona,184,Rubí,75568,37444,38124
08,Barcelona,185,Rubió,230,124,106
08,Barcelona,901,Rupit i Pruit,281,143,138
08,Barcelona,187,Sabadell,209931,102153,107778
08,Barcelona,188,Sagàs,155,84,71
08,Barcelona,190,Saldes,275,157,118
08,Barcelona,191,Sallent,6594,3173,3421
08,Barcelona,194,Sant Adrià de Besòs,36624,18041,18583
08,Barcelona,195,Sant Agustí de Lluçanès,86,44,42
08,Barcelona,196,Sant Andreu de la Barca,27303,13568,13735
08,Barcelona,197,Sant Andreu de Llavaneres,10758,5326,5432
08,Barcelona,198,Sant Antoni de Vilamajor,6005,2990,3015
08,Barcelona,199,Sant Bartomeu del Grau,858,452,406
08,Barcelona,200,Sant Boi de Llobregat,82142,40246,41896
08,Barcelona,201,Sant Boi de Lluçanès,515,258,257
08,Barcelona,203,Sant Cebrià de Vallalta,3310,1728,1582
08,Barcelona,202,Sant Celoni,17588,8784,8804
08,Barcelona,204,Sant Climent de Llobregat,4038,2038,2000
08,Barcelona,205,Sant Cugat del Vallès,89516,43515,46001
08,Barcelona,206,Sant Cugat Sesgarrigues,980,475,505
08,Barcelona,207,Sant Esteve de Palautordera,2648,1309,1339
08,Barcelona,208,Sant Esteve Sesrovires,7670,3838,3832
08,Barcelona,210,Sant Feliu de Codines,6045,3063,2982
08,Barcelona,211,Sant Feliu de Llobregat,44198,21424,22774
08,Barcelona,212,Sant Feliu Sasserra,606,321,285
08,Barcelona,209,Sant Fost de Campsentelles,8664,4299,4365
08,Barcelona,213,Sant Fruitós de Bages,8512,4199,4313
08,Barcelona,215,Sant Hipòlit de Voltregà,3453,1699,1754
08,Barcelona,193,Sant Iscle de Vallalta,1295,663,632
08,Barcelona,216,Sant Jaume de Frontanyà,30,19,11
08,Barcelona,218,Sant Joan de Vilatorrada,10802,5402,5400
08,Barcelona,217,Sant Joan Despí,33873,16500,17373
08,Barcelona,903,Sant Julià de Cerdanyola,242,133,109
08,Barcelona,220,Sant Julià de Vilatorta,3101,1528,1573
08,Barcelona,221,Sant Just Desvern,17201,8235,8966
08,Barcelona,222,Sant Llorenç d'Hortons,2547,1292,1255
08,Barcelona,223,Sant Llorenç Savall,2361,1195,1166
08,Barcelona,225,Sant Martí d'Albars,110,55,55
08,Barcelona,224,Sant Martí de Centelles,1125,581,544
08,Barcelona,226,Sant Martí de Tous,1196,610,586
08,Barcelona,227,Sant Martí Sarroca,3197,1571,1626
08,Barcelona,228,Sant Martí Sesgueioles,354,183,171
08,Barcelona,229,Sant Mateu de Bages,611,308,303
08,Barcelona,231,Sant Pere de Ribes,30142,15095,15047
08,Barcelona,232,Sant Pere de Riudebitlles,2343,1170,1173
08,Barcelona,233,Sant Pere de Torelló,2437,1263,1174
08,Barcelona,234,Sant Pere de Vilamajor,4313,2150,2163
08,Barcelona,189,Sant Pere Sallavinera,156,86,70
08,Barcelona,235,Sant Pol de Mar,5062,2503,2559
08,Barcelona,236,Sant Quintí de Mediona,2170,1109,1061
08,Barcelona,237,Sant Quirze de Besora,2092,1031,1061
08,Barcelona,238,Sant Quirze del Vallès,19867,9715,10152
08,Barcelona,239,Sant Quirze Safaja,627,330,297
08,Barcelona,240,Sant Sadurní d'Anoia,12749,6276,6473
08,Barcelona,241,Sant Sadurní d'Osormort,79,48,31
08,Barcelona,98,Sant Salvador de Guardiola,3127,1584,1543
08,Barcelona,262,Sant Vicenç de Castellet,9300,4617,4683
08,Barcelona,264,Sant Vicenç de Montalt,6272,3136,3136
08,Barcelona,265,Sant Vicenç de Torelló,1998,985,1013
08,Barcelona,263,Sant Vicenç dels Horts,27982,13932,14050
08,Barcelona,243,Santa Cecília de Voltregà,189,97,92
08,Barcelona,244,Santa Coloma de Cervelló,8082,3965,4117
08,Barcelona,245,Santa Coloma de Gramenet,117597,58452,59145
08,Barcelona,246,Santa Eugènia de Berga,2259,1156,1103
08,Barcelona,247,Santa Eulàlia de Riuprimer,1289,652,637
08,Barcelona,248,Santa Eulàlia de Ronçana,7124,3578,3546
08,Barcelona,249,Santa Fe del Penedès,380,196,184
08,Barcelona,250,Santa Margarida de Montbui,9748,4875,4873
08,Barcelona,251,Santa Margarida i els Monjos,7480,3801,3679
08,Barcelona,253,Santa Maria de Besora,147,75,72
08,Barcelona,256,Santa Maria de Martorelles,858,436,422
08,Barcelona,255,Santa Maria de Merlès,190,91,99
08,Barcelona,257,Santa Maria de Miralles,123,65,58
08,Barcelona,259,Santa Maria de Palautordera,9286,4662,4624
08,Barcelona,258,Santa Maria d'Oló,1030,521,509
08,Barcelona,260,Santa Perpètua de Mogoda,25574,12900,12674
08,Barcelona,261,Santa Susanna,3352,1690,1662
08,Barcelona,192,Santpedor,7496,3709,3787
08,Barcelona,267,Sentmenat,8818,4455,4363
08,Barcelona,269,Seva,3451,1726,1725
08,Barcelona,270,Sitges,28527,14279,14248
08,Barcelona,271,Sobremunt,84,36,48
08,Barcelona,272,Sora,193,112,81
08,Barcelona,273,Subirats,3013,1550,1463
08,Barcelona,274,Súria,5911,2882,3029
08,Barcelona,276,Tagamanent,326,172,154
08,Barcelona,277,Talamanca,193,110,83
08,Barcelona,278,Taradell,6344,3159,3185
08,Barcelona,275,Tavèrnoles,317,159,158
08,Barcelona,280,Tavertet,116,62,54
08,Barcelona,281,Teià,6333,3117,3216
08,Barcelona,279,Terrassa,216428,106557,109871
08,Barcelona,282,Tiana,8645,4136,4509
08,Barcelona,283,Tona,8114,4008,4106
08,Barcelona,284,Tordera,16637,8427,8210
08,Barcelona,285,Torelló,13995,6914,7081
08,Barcelona,286,"Torre de Claramunt, La",3707,1900,1807
08,Barcelona,287,Torrelavit,1400,726,674
08,Barcelona,288,Torrelles de Foix,2243,1202,1041
08,Barcelona,289,Torrelles de Llobregat,5950,2934,3016
08,Barcelona,290,Ullastrell,2054,1042,1012
08,Barcelona,291,Vacarisses,6328,3239,3089
08,Barcelona,292,Vallbona d'Anoia,1412,738,674
08,Barcelona,293,Vallcebre,251,142,109
08,Barcelona,294,Vallgorguina,2789,1414,1375
08,Barcelona,295,Vallirana,14784,7408,7376
08,Barcelona,296,Vallromanes,2514,1280,1234
08,Barcelona,297,Veciana,167,94,73
08,Barcelona,298,Vic,43964,21933,22031
08,Barcelona,299,Vilada,424,222,202
08,Barcelona,301,Viladecans,65993,32731,33262
08,Barcelona,300,Viladecavalls,7392,3660,3732
08,Barcelona,305,Vilafranca del Penedès,39532,19333,20199
08,Barcelona,306,Vilalba Sasserra,690,347,343
08,Barcelona,303,Vilanova de Sau,313,153,160
08,Barcelona,302,Vilanova del Camí,12332,6173,6159
08,Barcelona,902,Vilanova del Vallès,5285,2664,2621
08,Barcelona,307,Vilanova i la Geltrú,66077,31979,34098
08,Barcelona,214,Vilassar de Dalt,8961,4412,4549
08,Barcelona,219,Vilassar de Mar,20636,9932,10704
08,Barcelona,304,Vilobí del Penedès,1094,575,519
08,Barcelona,308,Viver i Serrateix,173,88,85
48,Bizkaia,1,Abadiño,7522,3748,3774
48,Bizkaia,2,Abanto y Ciérvana-Abanto Zierbena,9543,4702,4841
48,Bizkaia,911,Ajangiz,474,250,224
48,Bizkaia,912,Alonsotegi,2900,1424,1476
48,Bizkaia,3,Amorebieta-Etxano,18955,9319,9636
48,Bizkaia,4,Amoroto,425,220,205
48,Bizkaia,5,Arakaldo,159,76,83
48,Bizkaia,6,Arantzazu,411,203,208
48,Bizkaia,93,Areatza,1196,569,627
48,Bizkaia,9,Arrankudiaga,960,469,491
48,Bizkaia,914,Arratzu,402,193,209
48,Bizkaia,10,Arrieta,564,290,274
48,Bizkaia,11,Arrigorriaga,12265,5989,6276
48,Bizkaia,23,Artea,749,368,381
48,Bizkaia,8,Artzentales,741,399,342
48,Bizkaia,91,Atxondo,1370,691,679
48,Bizkaia,70,Aulesti,658,325,333
48,Bizkaia,12,Bakio,2640,1337,1303
48,Bizkaia,90,Balmaseda,7739,3772,3967
48,Bizkaia,13,Barakaldo,100313,48520,51793
48,Bizkaia,14,Barrika,1525,742,783
48,Bizkaia,15,Basauri,40877,19828,21049
48,Bizkaia,92,Bedia,1039,497,542
48,Bizkaia,16,Berango,7065,3455,3610
48,Bizkaia,17,Bermeo,16777,8265,8512
48,Bizkaia,18,Berriatua,1241,671,570
48,Bizkaia,19,Berriz,4695,2342,2353
48,Bizkaia,20,Bilbao,345110,162571,182539
48,Bizkaia,21,Busturia,1676,843,833
48,Bizkaia,901,Derio,6404,3153,3251
48,Bizkaia,26,Dima,1460,746,714
48,Bizkaia,27,Durango,29328,14353,14975
48,Bizkaia,28,Ea,836,424,412
48,Bizkaia,31,Elantxobe,363,177,186
48,Bizkaia,32,Elorrio,7307,3627,3680
48,Bizkaia,902,Erandio,24056,11727,12329
48,Bizkaia,33,Ereño,248,139,109
48,Bizkaia,34,Ermua,15951,7956,7995
48,Bizkaia,79,Errigoiti,502,279,223
48,Bizkaia,29,Etxebarri,11176,5585,5591
48,Bizkaia,30,Etxebarria,748,376,372
48,Bizkaia,906,Forua,938,465,473
48,Bizkaia,35,Fruiz,546,275,271
48,Bizkaia,36,Galdakao,29334,14457,14877
48,Bizkaia,37,Galdames,812,433,379
48,Bizkaia,38,Gamiz-Fika,1361,677,684
48,Bizkaia,39,Garai,308,152,156
48,Bizkaia,40,Gatika,1672,831,841
48,Bizkaia,41,Gautegiz Arteaga,847,427,420
48,Bizkaia,46,Gernika-Lumo,16915,8123,8792
48,Bizkaia,44,Getxo,78406,36767,41639
48,Bizkaia,47,Gizaburuaga,209,111,98
48,Bizkaia,42,Gordexola,1674,853,821
48,Bizkaia,43,Gorliz,5680,2805,2875
48,Bizkaia,45,Güeñes,6686,3250,3436
48,Bizkaia,48,Ibarrangelu,651,331,320
48,Bizkaia,94,Igorre,4251,2078,2173
48,Bizkaia,49,Ispaster,706,372,334
48,Bizkaia,910,Iurreta,3658,1820,1838
48,Bizkaia,50,Izurtza,231,133,98
48,Bizkaia,22,Karrantza Harana/Valle de Carranza,2717,1413,1304
48,Bizkaia,907,Kortezubi,445,220,225
48,Bizkaia,51,Lanestosa,268,137,131
48,Bizkaia,52,Larrabetzu,2035,984,1051
48,Bizkaia,53,Laukiz,1190,595,595
48,Bizkaia,54,Leioa,31197,15205,15992
48,Bizkaia,57,Lekeitio,7228,3581,3647
48,Bizkaia,55,Lemoa,3534,1771,1763
48,Bizkaia,56,Lemoiz,1243,657,586
48,Bizkaia,81,Lezama,2390,1196,1194
48,Bizkaia,903,Loiu,2361,1185,1176
48,Bizkaia,58,Mallabia,1168,588,580
48,Bizkaia,59,Mañaria,525,272,253
48,Bizkaia,60,Markina-Xemein,4999,2569,2430
48,Bizkaia,61,Maruri-Jatabe,967,493,474
48,Bizkaia,62,Mendata,395,197,198
48,Bizkaia,63,Mendexa,451,229,222
48,Bizkaia,64,Meñaka,750,392,358
48,Bizkaia,66,Morga,426,221,205
48,Bizkaia,68,Mundaka,1861,890,971
48,Bizkaia,69,Mungia,17384,8465,8919
48,Bizkaia,7,Munitibar-Arbatzegi Gerrikaitz,466,248,218
48,Bizkaia,908,Murueta,311,162,149
48,Bizkaia,71,Muskiz,7579,3747,3832
48,Bizkaia,67,Muxika,1407,722,685
48,Bizkaia,909,Nabarniz,260,130,130
48,Bizkaia,73,Ondarroa,8477,4264,4213
48,Bizkaia,75,Orozko,2673,1312,1361
48,Bizkaia,83,Ortuella,8376,4105,4271
48,Bizkaia,72,Otxandio,1295,656,639
48,Bizkaia,77,Plentzia,4387,2134,2253
48,Bizkaia,78,Portugalete,46120,22062,24058
48,Bizkaia,82,Santurtzi,45765,22081,23684
48,Bizkaia,84,Sestao,27744,13442,14302
48,Bizkaia,904,Sondika,4471,2159,2312
48,Bizkaia,85,Sopela,13510,6655,6855
48,Bizkaia,86,Sopuerta,2596,1294,1302
48,Bizkaia,76,Sukarrieta,367,193,174
48,Bizkaia,87,Trucios-Turtzioz,510,273,237
48,Bizkaia,88,Ubide,175,88,87
48,Bizkaia,65,Ugao-Miraballes,4133,2082,2051
48,Bizkaia,89,Urduliz,4248,2108,2140
48,Bizkaia,74,Urduña/Orduña,4134,2107,2027
48,Bizkaia,80,Valle de Trápaga-Trapagaran,11953,5808,6145
48,Bizkaia,95,Zaldibar,3077,1545,1532
48,Bizkaia,96,Zalla,8421,4133,4288
48,Bizkaia,905,Zamudio,3217,1566,1651
48,Bizkaia,97,Zaratamo,1609,791,818
48,Bizkaia,24,Zeanuri,1241,627,614
48,Bizkaia,25,Zeberio,1074,548,526
48,Bizkaia,913,Zierbena,1497,782,715
48,Bizkaia,915,Ziortza-Bolibar,420,225,195
09,Burgos,1,Abajas,27,19,8
09,Burgos,3,Adrada de Haza,221,111,110
09,Burgos,6,Aguas Cándidas,56,34,22
09,Burgos,7,Aguilar de Bureba,60,35,25
09,Burgos,9,Albillos,215,112,103
09,Burgos,10,Alcocero de Mola,34,26,8
09,Burgos,11,Alfoz de Bricia,77,46,31
09,Burgos,907,Alfoz de Quintanadueñas,2006,1083,923
09,Burgos,12,Alfoz de Santa Gadea,100,58,42
09,Burgos,13,Altable,53,29,24
09,Burgos,14,"Altos, Los",189,111,78
09,Burgos,16,Ameyugo,101,57,44
09,Burgos,17,Anguix,134,74,60
09,Burgos,18,Aranda de Duero,32535,15833,16702
09,Burgos,19,Arandilla,164,99,65
09,Burgos,20,Arauzo de Miel,328,175,153
09,Burgos,21,Arauzo de Salce,59,36,23
09,Burgos,22,Arauzo de Torre,73,43,30
09,Burgos,23,Arcos,1626,874,752
09,Burgos,24,Arenillas de Riopisuerga,178,105,73
09,Burgos,25,Arija,136,71,65
09,Burgos,26,Arlanzón,414,253,161
09,Burgos,27,Arraya de Oca,42,26,16
09,Burgos,29,Atapuerca,181,101,80
09,Burgos,30,"Ausines, Los",132,77,55
09,Burgos,32,Avellanosa de Muñó,114,61,53
09,Burgos,33,Bahabón de Esgueva,78,50,28
09,Burgos,34,"Balbases, Los",306,172,134
09,Burgos,35,Baños de Valdearados,350,208,142
09,Burgos,36,Bañuelos de Bureba,35,20,15
09,Burgos,37,Barbadillo de Herreros,110,65,45
09,Burgos,38,Barbadillo del Mercado,129,71,58
09,Burgos,39,Barbadillo del Pez,68,42,26
09,Burgos,41,Barrio de Muñó,33,18,15
09,Burgos,43,"Barrios de Bureba, Los",202,118,84
09,Burgos,44,Barrios de Colina,51,26,25
09,Burgos,45,Basconcillos del Tozo,295,165,130
09,Burgos,46,Bascuñana,27,18,9
09,Burgos,47,Belbimbre,64,32,32
09,Burgos,48,Belorado,1852,942,910
09,Burgos,50,Berberana,64,32,32
09,Burgos,51,Berlangas de Roa,180,96,84
09,Burgos,52,Berzosa de Bureba,30,21,9
09,Burgos,54,Bozoó,109,63,46
09,Burgos,55,Brazacorta,60,34,26
09,Burgos,56,Briviesca,6860,3421,3439
09,Burgos,57,Bugedo,173,115,58
09,Burgos,58,Buniel,529,292,237
09,Burgos,59,Burgos,175623,83579,92044
09,Burgos,60,Busto de Bureba,154,84,70
09,Burgos,61,Cabañes de Esgueva,173,97,76
09,Burgos,62,Cabezón de la Sierra,59,29,30
09,Burgos,64,Caleruega,441,227,214
09,Burgos,65,Campillo de Aranda,167,99,68
09,Burgos,66,Campolara,67,46,21
09,Burgos,67,Canicosa de la Sierra,478,253,225
09,Burgos,68,Cantabrana,28,16,12
09,Burgos,70,Carazo,34,25,9
09,Burgos,71,Carcedo de Bureba,41,24,17
09,Burgos,72,Carcedo de Burgos,416,228,188
09,Burgos,73,Cardeñadijo,1307,713,594
09,Burgos,74,Cardeñajimeno,1086,573,513
09,Burgos,75,Cardeñuela Riopico,114,66,48
09,Burgos,76,Carrias,25,19,6
09,Burgos,77,Cascajares de Bureba,34,16,18
09,Burgos,78,Cascajares de la Sierra,37,20,17
09,Burgos,79,Castellanos de Castro,51,32,19
09,Burgos,83,Castil de Peones,36,20,16
09,Burgos,82,Castildelgado,40,23,17
09,Burgos,84,Castrillo de la Reina,189,123,66
09,Burgos,85,Castrillo de la Vega,615,332,283
09,Burgos,88,Castrillo de Riopisuerga,60,37,23
09,Burgos,86,Castrillo del Val,786,449,337
09,Burgos,90,Castrillo Mota de Judíos,53,29,24
09,Burgos,91,Castrojeriz,817,422,395
09,Burgos,63,Cavia,233,138,95
09,Burgos,93,Cayuela,174,93,81
09,Burgos,94,Cebrecos,51,31,20
09,Burgos,95,Celada del Camino,91,50,41
09,Burgos,98,Cerezo de Río Tirón,581,312,269
09,Burgos,100,Cerratón de Juarros,51,36,15
09,Burgos,101,Ciadoncha,81,47,34
09,Burgos,102,Cillaperlata,35,24,11
09,Burgos,103,Cilleruelo de Abajo,237,131,106
09,Burgos,104,Cilleruelo de Arriba,46,24,22
09,Burgos,105,Ciruelos de Cervera,110,65,45
09,Burgos,108,Cogollos,531,291,240
09,Burgos,109,Condado de Treviño,1339,764,575
09,Burgos,110,Contreras,79,50,29
09,Burgos,112,Coruña del Conde,120,74,46
09,Burgos,113,Covarrubias,560,298,262
09,Burgos,114,Cubillo del Campo,93,51,42
09,Burgos,115,Cubo de Bureba,101,57,44
09,Burgos,117,"Cueva de Roa, La",87,45,42
09,Burgos,119,Cuevas de San Clemente,45,15,30
09,Burgos,120,Encío,40,22,18
09,Burgos,122,Espinosa de Cervera,99,61,38
09,Burgos,124,Espinosa de los Monteros,1727,904,823
09,Burgos,123,Espinosa del Camino,45,28,17
09,Burgos,125,Estépar,620,368,252
09,Burgos,127,Fontioso,61,34,27
09,Burgos,128,Frandovínez,90,53,37
09,Burgos,129,Fresneda de la Sierra Tirón,104,70,34
09,Burgos,130,Fresneña,77,44,33
09,Burgos,131,Fresnillo de las Dueñas,649,340,309
09,Burgos,132,Fresno de Río Tirón,184,112,72
09,Burgos,133,Fresno de Rodilla,47,26,21
09,Burgos,134,Frías,263,140,123
09,Burgos,135,Fuentebureba,40,21,19
09,Burgos,136,Fuentecén,222,127,95
09,Burgos,137,Fuentelcésped,246,119,127
09,Burgos,138,Fuentelisendo,86,47,39
09,Burgos,139,Fuentemolinos,103,66,37
09,Burgos,140,Fuentenebro,130,76,54
09,Burgos,141,Fuentespina,784,409,375
09,Burgos,143,Galbarros,30,19,11
09,Burgos,144,"Gallega, La",49,30,19
09,Burgos,148,Grijalba,103,53,50
09,Burgos,149,Grisaleña,39,29,10
09,Burgos,151,Gumiel de Izán,545,311,234
09,Burgos,152,Gumiel de Mercado,337,185,152
09,Burgos,154,Hacinas,160,91,69
09,Burgos,155,Haza,27,16,11
09,Burgos,159,Hontanas,73,47,26
09,Burgos,160,Hontangas,96,59,37
09,Burgos,162,Hontoria de la Cantera,151,81,70
09,Burgos,164,Hontoria de Valdearados,191,114,77
09,Burgos,163,Hontoria del Pinar,662,370,292
09,Burgos,166,"Hormazas, Las",103,60,43
09,Burgos,167,Hornillos del Camino,58,35,23
09,Burgos,168,"Horra, La",354,190,164
09,Burgos,169,Hortigüela,102,65,37
09,Burgos,170,Hoyales de Roa,224,118,106
09,Burgos,172,Huérmeces,137,70,67
09,Burgos,173,Huerta de Arriba,130,74,56
09,Burgos,174,Huerta de Rey,937,503,434
09,Burgos,175,Humada,125,82,43
09,Burgos,176,Hurones,72,45,27
09,Burgos,177,Ibeas de Juarros,1404,775,629
09,Burgos,178,Ibrillos,45,28,17
09,Burgos,179,Iglesiarrubia,41,23,18
09,Burgos,180,Iglesias,145,81,64
09,Burgos,181,Isar,316,164,152
09,Burgos,182,Itero del Castillo,82,48,34
09,Burgos,183,Jaramillo de la Fuente,53,34,19
09,Burgos,184,Jaramillo Quemado,7,5,2
09,Burgos,189,Junta de Traslaloma,128,71,57
09,Burgos,190,Junta de Villalba de Losa,79,46,33
09,Burgos,191,Jurisdicción de Lara,39,23,16
09,Burgos,192,Jurisdicción de San Zadornil,52,28,24
09,Burgos,194,Lerma,2596,1300,1296
09,Burgos,195,Llano de Bureba,61,39,22
09,Burgos,196,Madrigal del Monte,151,91,60
09,Burgos,197,Madrigalejo del Monte,163,101,62
09,Burgos,198,Mahamud,118,67,51
09,Burgos,199,Mambrilla de Castrejón,103,57,46
09,Burgos,200,Mambrillas de Lara,49,29,20
09,Burgos,201,Mamolar,28,21,7
09,Burgos,202,Manciles,24,16,8
09,Burgos,206,Mazuela,61,35,26
09,Burgos,208,Mecerreyes,214,113,101
09,Burgos,209,Medina de Pomar,5847,2971,2876
09,Burgos,211,Melgar de Fernamental,1661,901,760
09,Burgos,213,Merindad de Cuesta-Urria,323,176,147
09,Burgos,214,Merindad de Montija,756,450,306
09,Burgos,906,Merindad de Río Ubierna,1441,789,652
09,Burgos,215,Merindad de Sotoscueva,418,235,183
09,Burgos,216,Merindad de Valdeporres,440,223,217
09,Burgos,217,Merindad de Valdivielso,382,216,166
09,Burgos,218,Milagros,459,249,210
09,Burgos,219,Miranda de Ebro,35608,17483,18125
09,Burgos,220,Miraveche,75,48,27
09,Burgos,221,Modúbar de la Emparedada,639,355,284
09,Burgos,223,Monasterio de la Sierra,42,28,14
09,Burgos,224,Monasterio de Rodilla,173,94,79
09,Burgos,225,Moncalvillo,88,52,36
09,Burgos,226,Monterrubio de la Demanda,63,37,26
09,Burgos,227,Montorio,150,80,70
09,Burgos,228,Moradillo de Roa,180,95,85
09,Burgos,229,Nava de Roa,220,116,104
09,Burgos,230,Navas de Bureba,34,14,20
09,Burgos,231,Nebreda,68,49,19
09,Burgos,232,Neila,163,96,67
09,Burgos,235,Olmedillo de Roa,199,119,80
09,Burgos,236,Olmillos de Muñó,37,22,15
09,Burgos,238,Oña,1043,554,489
09,Burgos,239,Oquillas,55,31,24
09,Burgos,241,Orbaneja Riopico,288,153,135
09,Burgos,242,Padilla de Abajo,90,52,38
09,Burgos,243,Padilla de Arriba,73,44,29
09,Burgos,244,Padrones de Bureba,50,25,25
09,Burgos,246,Palacios de la Sierra,743,381,362
09,Burgos,247,Palacios de Riopisuerga,26,13,13
09,Burgos,248,Palazuelos de la Sierra,81,47,34
09,Burgos,249,Palazuelos de Muñó,50,28,22
09,Burgos,250,Pampliega,314,169,145
09,Burgos,251,Pancorbo,448,247,201
09,Burgos,253,Pardilla,125,75,50
09,Burgos,255,Partido de la Sierra en Tobalina,92,52,40
09,Burgos,256,Pedrosa de Duero,438,244,194
09,Burgos,259,Pedrosa de Río Úrbel,241,146,95
09,Burgos,257,Pedrosa del Páramo,104,60,44
09,Burgos,258,Pedrosa del Príncipe,172,90,82
09,Burgos,261,Peñaranda de Duero,529,267,262
09,Burgos,262,Peral de Arlanza,164,87,77
09,Burgos,265,Piérnigas,39,24,15
09,Burgos,266,Pineda de la Sierra,103,66,37
09,Burgos,267,Pineda Trasmonte,110,66,44
09,Burgos,268,Pinilla de los Barruecos,110,64,46
09,Burgos,269,Pinilla de los Moros,32,21,11
09,Burgos,270,Pinilla Trasmonte,167,97,70
09,Burgos,272,Poza de la Sal,303,160,143
09,Burgos,273,Prádanos de Bureba,57,36,21
09,Burgos,274,Pradoluengo,1203,597,606
09,Burgos,275,Presencio,187,114,73
09,Burgos,276,"Puebla de Arganzón, La",502,273,229
09,Burgos,277,Puentedura,123,80,43
09,Burgos,279,Quemada,241,144,97
09,Burgos,281,Quintana del Pidio,154,79,75
09,Burgos,280,Quintanabureba,28,18,10
09,Burgos,283,Quintanaélez,49,25,24
09,Burgos,287,Quintanaortuño,267,153,114
09,Burgos,288,Quintanapalla,112,64,48
09,Burgos,289,Quintanar de la Sierra,1758,922,836
09,Burgos,292,Quintanavides,85,52,33
09,Burgos,294,Quintanilla de la Mata,122,74,48
09,Burgos,901,Quintanilla del Agua y Tordueles,395,204,191
09,Burgos,295,Quintanilla del Coco,58,29,29
09,Burgos,298,Quintanilla San García,83,48,35
09,Burgos,301,Quintanilla Vivar,782,416,366
09,Burgos,297,"Quintanillas, Las",382,219,163
09,Burgos,302,Rabanera del Pinar,112,67,45
09,Burgos,303,Rábanos,83,51,32
09,Burgos,304,Rabé de las Calzadas,214,114,100
09,Burgos,306,Rebolledo de la Torre,117,64,53
09,Burgos,307,Redecilla del Camino,112,70,42
09,Burgos,308,Redecilla del Campo,71,42,29
09,Burgos,309,Regumiel de la Sierra,356,189,167
09,Burgos,310,Reinoso,12,9,3
09,Burgos,311,Retuerta,60,39,21
09,Burgos,314,Revilla del Campo,91,59,32
09,Burgos,316,Revilla Vallejera,115,76,39
09,Burgos,312,"Revilla y Ahedo, La",108,60,48
09,Burgos,315,Revillarruz,482,247,235
09,Burgos,317,Rezmondo,20,8,12
09,Burgos,318,Riocavado de la Sierra,59,38,21
09,Burgos,321,Roa,2262,1151,1111
09,Burgos,323,Rojas,67,44,23
09,Burgos,325,Royuela de Río Franco,204,123,81
09,Burgos,326,Rubena,168,99,69
09,Burgos,327,Rublacedo de Abajo,35,18,17
09,Burgos,328,Rucandio,74,36,38
09,Burgos,329,Salas de Bureba,134,79,55
09,Burgos,330,Salas de los Infantes,1974,1011,963
09,Burgos,332,Saldaña de Burgos,177,94,83
09,Burgos,334,Salinillas de Bureba,51,41,10
09,Burgos,335,San Adrián de Juarros,92,57,35
09,Burgos,337,San Juan del Monte,138,77,61
09,Burgos,338,San Mamés de Burgos,290,164,126
09,Burgos,339,San Martín de Rubiales,134,75,59
09,Burgos,340,San Millán de Lara,79,55,24
09,Burgos,360,San Vicente del Valle,27,20,7
09,Burgos,343,Santa Cecilia,98,59,39
09,Burgos,345,Santa Cruz de la Salceda,139,80,59
09,Burgos,346,Santa Cruz del Valle Urbión,98,63,35
09,Burgos,347,Santa Gadea del Cid,152,79,73
09,Burgos,348,Santa Inés,150,79,71
09,Burgos,350,Santa María del Campo,558,299,259
09,Burgos,351,Santa María del Invierno,62,44,18
09,Burgos,352,Santa María del Mercadillo,106,66,40
09,Burgos,353,Santa María Rivarredonda,93,58,35
09,Burgos,354,Santa Olalla de Bureba,38,28,10
09,Burgos,355,Santibáñez de Esgueva,90,46,44
09,Burgos,356,Santibáñez del Val,43,26,17
09,Burgos,358,Santo Domingo de Silos,282,174,108
09,Burgos,361,Sargentes de la Lora,114,62,52
09,Burgos,362,Sarracín,236,131,105
09,Burgos,363,Sasamón,1027,584,443
09,Burgos,365,"Sequera de Haza, La",34,23,11
09,Burgos,366,Solarana,77,42,35
09,Burgos,368,Sordillos,22,14,8
09,Burgos,369,Sotillo de la Ribera,501,260,241
09,Burgos,372,Sotragero,268,146,122
09,Burgos,373,Sotresgudo,461,263,198
09,Burgos,374,Susinos del Páramo,103,67,36
09,Burgos,375,Tamarón,41,23,18
09,Burgos,377,Tardajos,794,424,370
09,Burgos,378,Tejada,29,20,9
09,Burgos,380,Terradillos de Esgueva,79,36,43
09,Burgos,381,Tinieblas de la Sierra,36,20,16
09,Burgos,382,Tobar,25,17,8
09,Burgos,384,Tordómar,351,192,159
09,Burgos,386,Torrecilla del Monte,60,34,26
09,Burgos,387,Torregalindo,133,83,50
09,Burgos,388,Torrelara,31,16,15
09,Burgos,389,Torrepadre,66,37,29
09,Burgos,390,Torresandino,663,358,305
09,Burgos,391,Tórtoles de Esgueva,471,244,227
09,Burgos,392,Tosantos,56,32,24
09,Burgos,394,Trespaderne,835,434,401
09,Burgos,395,Tubilla del Agua,146,87,59
09,Burgos,396,Tubilla del Lago,156,83,73
09,Burgos,398,Úrbel del Castillo,75,52,23
09,Burgos,400,Vadocondes,374,204,170
09,Burgos,403,Valdeande,99,62,37
09,Burgos,405,Valdezate,138,75,63
09,Burgos,406,Valdorros,322,188,134
09,Burgos,408,Vallarta de Bureba,41,25,16
09,Burgos,904,Valle de las Navas,522,305,217
09,Burgos,908,Valle de Losa,505,296,209
09,Burgos,409,Valle de Manzanedo,118,59,59
09,Burgos,410,Valle de Mena,3742,1923,1819
09,Burgos,411,Valle de Oca,157,97,60
09,Burgos,902,Valle de Santibáñez,488,282,206
09,Burgos,905,Valle de Sedano,438,247,191
09,Burgos,412,Valle de Tobalina,965,530,435
09,Burgos,413,Valle de Valdebezana,477,246,231
09,Burgos,414,Valle de Valdelaguna,198,113,85
09,Burgos,415,Valle de Valdelucio,314,165,149
09,Burgos,416,Valle de Zamanzas,57,32,25
09,Burgos,417,Vallejera,43,25,18
09,Burgos,418,Valles de Palenzuela,86,44,42
09,Burgos,419,Valluércanes,75,49,26
09,Burgos,407,Valmala,30,17,13
09,Burgos,422,"Vid de Bureba, La",17,9,8
09,Burgos,421,"Vid y Barrios, La",242,140,102
09,Burgos,423,Vileña,28,18,10
09,Burgos,427,Villadiego,1546,851,695
09,Burgos,428,Villaescusa de Roa,108,64,44
09,Burgos,429,Villaescusa la Sombría,67,49,18
09,Burgos,430,Villaespasa,22,14,8
09,Burgos,431,Villafranca Montes de Oca,118,73,45
09,Burgos,432,Villafruela,197,111,86
09,Burgos,433,Villagalijo,64,41,23
09,Burgos,434,Villagonzalo Pedernales,1795,938,857
09,Burgos,437,Villahoz,300,161,139
09,Burgos,438,Villalba de Duero,676,355,321
09,Burgos,439,Villalbilla de Burgos,1388,749,639
09,Burgos,440,Villalbilla de Gumiel,86,51,35
09,Burgos,441,Villaldemiro,72,41,31
09,Burgos,442,Villalmanzo,439,239,200
09,Burgos,443,Villamayor de los Montes,185,92,93
09,Burgos,444,Villamayor de Treviño,71,36,35
09,Burgos,445,Villambistia,46,33,13
09,Burgos,446,Villamedianilla,12,7,5
09,Burgos,447,Villamiel de la Sierra,48,29,19
09,Burgos,448,Villangómez,226,140,86
09,Burgos,449,Villanueva de Argaño,108,63,45
09,Burgos,450,Villanueva de Carazo,28,18,10
09,Burgos,451,Villanueva de Gumiel,281,145,136
09,Burgos,454,Villanueva de Teba,44,28,16
09,Burgos,455,Villaquirán de la Puebla,48,29,19
09,Burgos,456,Villaquirán de los Infantes,146,80,66
09,Burgos,903,Villarcayo de Merindad de Castilla la Vieja,4228,2170,2058
09,Burgos,458,Villariezo,631,356,275
09,Burgos,460,Villasandino,195,116,79
09,Burgos,463,Villasur de Herreros,286,171,115
09,Burgos,464,Villatuelda,37,20,17
09,Burgos,466,Villaverde del Monte,120,67,53
09,Burgos,467,Villaverde-Mogina,78,51,27
09,Burgos,471,Villayerno Morquillas,196,104,92
09,Burgos,472,Villazopeque,61,38,23
09,Burgos,473,Villegas,90,53,37
09,Burgos,476,Villoruebo,81,51,30
09,Burgos,424,Viloria de Rioja,45,27,18
09,Burgos,425,Vilviestre del Pinar,572,316,256
09,Burgos,478,Vizcaínos,41,28,13
09,Burgos,480,Zael,115,59,56
09,Burgos,482,Zarzosa de Río Pisuerga,30,19,11
09,Burgos,483,Zazuar,232,122,110
09,Burgos,485,Zuñeda,58,37,21
10,Cáceres,1,Abadía,337,189,148
10,Cáceres,2,Abertura,408,211,197
10,Cáceres,3,Acebo,601,307,294
10,Cáceres,4,Acehúche,814,405,409
10,Cáceres,5,Aceituna,601,314,287
10,Cáceres,6,Ahigal,1405,727,678
10,Cáceres,903,Alagón del Río,932,467,465
10,Cáceres,7,Albalá,684,347,337
10,Cáceres,8,Alcántara,1487,743,744
10,Cáceres,9,Alcollarín,237,118,119
10,Cáceres,10,Alcuéscar,2682,1391,1291
10,Cáceres,12,Aldea del Cano,632,297,335
10,Cáceres,13,"Aldea del Obispo, La",309,166,143
10,Cáceres,11,Aldeacentenera,609,307,302
10,Cáceres,14,Aldeanueva de la Vera,2114,1035,1079
10,Cáceres,15,Aldeanueva del Camino,754,364,390
10,Cáceres,16,Aldehuela de Jerte,364,192,172
10,Cáceres,17,Alía,865,427,438
10,Cáceres,18,Aliseda,1883,953,930
10,Cáceres,19,Almaraz,1651,842,809
10,Cáceres,20,Almoharín,1848,907,941
10,Cáceres,21,Arroyo de la Luz,5917,2945,2972
10,Cáceres,23,Arroyomolinos,770,407,363
10,Cáceres,22,Arroyomolinos de la Vera,452,228,224
10,Cáceres,24,Baños de Montemayor,774,370,404
10,Cáceres,25,Barrado,424,218,206
10,Cáceres,26,Belvís de Monroy,744,388,356
10,Cáceres,27,Benquerencia,79,44,35
10,Cáceres,28,Berrocalejo,102,56,46
10,Cáceres,29,Berzocana,451,240,211
10,Cáceres,30,Bohonal de Ibor,507,263,244
10,Cáceres,31,Botija,190,106,84
10,Cáceres,32,Brozas,1911,954,957
10,Cáceres,33,Cabañas del Castillo,447,240,207
10,Cáceres,34,Cabezabellosa,362,183,179
10,Cáceres,35,Cabezuela del Valle,2250,1152,1098
10,Cáceres,36,Cabrero,361,199,162
10,Cáceres,37,Cáceres,95917,45983,49934
10,Cáceres,38,Cachorrilla,86,46,40
10,Cáceres,39,Cadalso,443,223,220
10,Cáceres,40,Calzadilla,485,249,236
10,Cáceres,41,Caminomorisco,1203,629,574
10,Cáceres,42,Campillo de Deleitosa,68,28,40
10,Cáceres,43,Campo Lugar,891,440,451
10,Cáceres,44,Cañamero,1664,866,798
10,Cáceres,45,Cañaveral,1047,513,534
10,Cáceres,46,Carbajo,221,115,106
10,Cáceres,47,Carcaboso,1106,552,554
10,Cáceres,48,Carrascalejo,239,119,120
10,Cáceres,49,Casar de Cáceres,4532,2248,2284
10,Cáceres,50,Casar de Palomero,1151,584,567
10,Cáceres,51,Casares de las Hurdes,405,207,198
10,Cáceres,52,Casas de Don Antonio,183,90,93
10,Cáceres,53,Casas de Don Gómez,303,164,139
10,Cáceres,56,Casas de Millán,606,302,304
10,Cáceres,57,Casas de Miravete,148,91,57
10,Cáceres,54,Casas del Castañar,594,290,304
10,Cáceres,55,Casas del Monte,823,422,401
10,Cáceres,58,Casatejada,1409,733,676
10,Cáceres,59,Casillas de Coria,397,194,203
10,Cáceres,60,Castañar de Ibor,1082,560,522
10,Cáceres,61,Ceclavín,1871,963,908
10,Cáceres,62,Cedillo,458,241,217
10,Cáceres,63,Cerezo,176,86,90
10,Cáceres,64,Cilleros,1680,855,825
10,Cáceres,65,Collado de la Vera,203,112,91
10,Cáceres,66,Conquista de la Sierra,189,112,77
10,Cáceres,67,Coria,12729,6258,6471
10,Cáceres,68,Cuacos de Yuste,850,440,410
10,Cáceres,69,"Cumbre, La",884,445,439
10,Cáceres,70,Deleitosa,748,372,376
10,Cáceres,71,Descargamaría,130,76,54
10,Cáceres,72,Eljas,936,476,460
10,Cáceres,73,Escurial,800,424,376
10,Cáceres,75,Fresnedoso de Ibor,272,143,129
10,Cáceres,76,Galisteo,985,496,489
10,Cáceres,77,Garciaz,754,387,367
10,Cáceres,79,Garganta la Olla,998,523,475
10,Cáceres,78,"Garganta, La",412,221,191
10,Cáceres,80,Gargantilla,401,204,197
10,Cáceres,81,Gargüera,133,74,59
10,Cáceres,82,Garrovillas de Alconétar,2102,1041,1061
10,Cáceres,83,Garvín,98,54,44
10,Cáceres,84,Gata,1534,796,738
10,Cáceres,85,"Gordo, El",375,192,183
10,Cáceres,86,"Granja, La",342,182,160
10,Cáceres,87,Guadalupe,1960,969,991
10,Cáceres,88,Guijo de Coria,212,110,102
10,Cáceres,89,Guijo de Galisteo,1535,775,760
10,Cáceres,90,Guijo de Granadilla,548,286,262
10,Cáceres,91,Guijo de Santa Bárbara,407,214,193
10,Cáceres,92,Herguijuela,317,163,154
10,Cáceres,93,Hernán-Pérez,470,235,235
10,Cáceres,94,Herrera de Alcántara,272,142,130
10,Cáceres,95,Herreruela,354,179,175
10,Cáceres,96,Hervás,4102,2022,2080
10,Cáceres,97,Higuera,99,61,38
10,Cáceres,98,Hinojal,407,209,198
10,Cáceres,99,Holguera,659,326,333
10,Cáceres,100,Hoyos,893,431,462
10,Cáceres,101,Huélaga,225,115,110
10,Cáceres,102,Ibahernando,569,277,292
10,Cáceres,103,Jaraicejo,497,240,257
10,Cáceres,104,Jaraíz de la Vera,6514,3259,3255
10,Cáceres,105,Jarandilla de la Vera,2883,1433,1450
10,Cáceres,106,Jarilla,140,74,66
10,Cáceres,107,Jerte,1276,639,637
10,Cáceres,108,Ladrillar,209,110,99
10,Cáceres,109,Logrosán,2025,1022,1003
10,Cáceres,110,Losar de la Vera,2792,1442,1350
10,Cáceres,111,Madrigal de la Vera,1603,835,768
10,Cáceres,112,Madrigalejo,1808,903,905
10,Cáceres,113,Madroñera,2631,1319,1312
10,Cáceres,114,Majadas,1338,671,667
10,Cáceres,115,Malpartida de Cáceres,4192,2106,2086
10,Cáceres,116,Malpartida de Plasencia,4609,2282,2327
10,Cáceres,117,Marchagaz,210,108,102
10,Cáceres,118,Mata de Alcántara,314,164,150
10,Cáceres,119,Membrío,658,325,333
10,Cáceres,120,Mesas de Ibor,174,93,81
10,Cáceres,121,Miajadas,9773,4880,4893
10,Cáceres,122,Millanes,241,125,116
10,Cáceres,123,Mirabel,669,333,336
10,Cáceres,124,Mohedas de Granadilla,825,408,417
10,Cáceres,125,Monroy,991,496,495
10,Cáceres,126,Montánchez,1763,882,881
10,Cáceres,127,Montehermoso,5761,2938,2823
10,Cáceres,128,Moraleja,6811,3403,3408
10,Cáceres,129,Morcillo,387,177,210
10,Cáceres,130,Navaconcejo,2007,1018,989
10,Cáceres,131,Navalmoral de la Mata,17297,8326,8971
10,Cáceres,132,Navalvillar de Ibor,431,216,215
10,Cáceres,133,Navas del Madroño,1355,675,680
10,Cáceres,134,Navezuelas,661,343,318
10,Cáceres,135,Nuñomoral,1355,715,640
10,Cáceres,136,Oliva de Plasencia,308,171,137
10,Cáceres,137,Palomero,369,194,175
10,Cáceres,138,Pasarón de la Vera,653,313,340
10,Cáceres,139,Pedroso de Acim,95,50,45
10,Cáceres,140,Peraleda de la Mata,1410,709,701
10,Cáceres,141,Peraleda de San Román,292,151,141
10,Cáceres,142,Perales del Puerto,958,491,467
10,Cáceres,143,Pescueza,158,70,88
10,Cáceres,144,"Pesga, La",1087,569,518
10,Cáceres,145,Piedras Albas,160,76,84
10,Cáceres,146,Pinofranqueado,1785,961,824
10,Cáceres,147,Piornal,1536,772,764
10,Cáceres,148,Plasencia,40360,19504,20856
10,Cáceres,149,Plasenzuela,476,235,241
10,Cáceres,150,Portaje,380,197,183
10,Cáceres,151,Portezuelo,231,122,109
10,Cáceres,152,Pozuelo de Zarzón,479,237,242
10,Cáceres,905,Pueblonuevo de Miramontes,829,424,405
10,Cáceres,153,Puerto de Santa Cruz,338,176,162
10,Cáceres,154,Rebollar,210,104,106
10,Cáceres,155,Riolobos,1266,662,604
10,Cáceres,156,Robledillo de Gata,97,52,45
10,Cáceres,157,Robledillo de la Vera,284,149,135
10,Cáceres,158,Robledillo de Trujillo,357,185,172
10,Cáceres,159,Robledollano,326,181,145
10,Cáceres,160,Romangordo,249,121,128
10,Cáceres,901,Rosalejo,1438,761,677
10,Cáceres,161,Ruanes,66,37,29
10,Cáceres,162,Salorino,613,320,293
10,Cáceres,163,Salvatierra de Santiago,298,155,143
10,Cáceres,164,San Martín de Trevejo,805,399,406
10,Cáceres,165,Santa Ana,250,135,115
10,Cáceres,166,Santa Cruz de la Sierra,333,168,165
10,Cáceres,167,Santa Cruz de Paniagua,330,183,147
10,Cáceres,168,Santa Marta de Magasca,282,143,139
10,Cáceres,169,Santiago de Alcántara,533,258,275
10,Cáceres,170,Santiago del Campo,275,141,134
10,Cáceres,171,Santibáñez el Alto,338,177,161
10,Cáceres,172,Santibáñez el Bajo,761,395,366
10,Cáceres,173,Saucedilla,886,471,415
10,Cáceres,174,Segura de Toro,188,90,98
10,Cáceres,175,Serradilla,1608,815,793
10,Cáceres,176,Serrejón,433,222,211
10,Cáceres,177,Sierra de Fuentes,2006,1021,985
10,Cáceres,178,Talaván,842,439,403
10,Cáceres,179,Talaveruela de la Vera,325,174,151
10,Cáceres,180,Talayuela,7338,3972,3366
10,Cáceres,181,Tejeda de Tiétar,802,433,369
10,Cáceres,904,Tiétar,922,494,428
10,Cáceres,182,Toril,170,108,62
10,Cáceres,183,Tornavacas,1126,591,535
10,Cáceres,184,"Torno, El",897,474,423
10,Cáceres,187,Torre de Don Miguel,488,263,225
10,Cáceres,188,Torre de Santa María,549,277,272
10,Cáceres,185,Torrecilla de los Ángeles,637,333,304
10,Cáceres,186,Torrecillas de la Tiesa,1103,554,549
10,Cáceres,190,Torrejón el Rubio,593,303,290
10,Cáceres,189,Torrejoncillo,3044,1495,1549
10,Cáceres,191,Torremenga,625,333,292
10,Cáceres,192,Torremocha,850,419,431
10,Cáceres,193,Torreorgaz,1669,811,858
10,Cáceres,194,Torrequemada,587,281,306
10,Cáceres,195,Trujillo,9274,4534,4740
10,Cáceres,196,Valdastillas,327,173,154
10,Cáceres,197,Valdecañas de Tajo,123,66,57
10,Cáceres,198,Valdefuentes,1251,621,630
10,Cáceres,199,Valdehúncar,179,95,84
10,Cáceres,200,Valdelacasa de Tajo,387,199,188
10,Cáceres,201,Valdemorales,198,98,100
10,Cáceres,202,Valdeobispo,665,327,338
10,Cáceres,203,Valencia de Alcántara,5532,2715,2817
10,Cáceres,204,Valverde de la Vera,485,244,241
10,Cáceres,205,Valverde del Fresno,2378,1203,1175
10,Cáceres,902,Vegaviana,849,438,411
10,Cáceres,206,Viandar de la Vera,233,122,111
10,Cáceres,207,Villa del Campo,525,255,270
10,Cáceres,208,Villa del Rey,126,64,62
10,Cáceres,209,Villamesías,269,135,134
10,Cáceres,210,Villamiel,462,233,229
10,Cáceres,211,Villanueva de la Sierra,444,222,222
10,Cáceres,212,Villanueva de la Vera,2082,1050,1032
10,Cáceres,214,Villar de Plasencia,234,124,110
10,Cáceres,213,Villar del Pedroso,629,325,304
10,Cáceres,215,Villasbuenas de Gata,357,183,174
10,Cáceres,216,Zarza de Granadilla,1822,925,897
10,Cáceres,217,Zarza de Montánchez,563,278,285
10,Cáceres,218,Zarza la Mayor,1277,635,642
10,Cáceres,219,Zorita,1412,712,700
11,Cádiz,1,Alcalá de los Gazules,5258,2715,2543
11,Cádiz,2,Alcalá del Valle,5150,2591,2559
11,Cádiz,3,Algar,1433,741,692
11,Cádiz,4,Algeciras,121133,59765,61368
11,Cádiz,5,Algodonales,5630,2862,2768
11,Cádiz,6,Arcos de la Frontera,30983,15515,15468
11,Cádiz,7,Barbate,22548,11303,11245
11,Cádiz,8,"Barrios, Los",23374,11688,11686
11,Cádiz,901,Benalup-Casas Viejas,6995,3557,3438
11,Cádiz,9,Benaocaz,687,366,321
11,Cádiz,10,Bornos,7818,3908,3910
11,Cádiz,11,"Bosque, El",2147,1084,1063
11,Cádiz,12,Cádiz,118048,55925,62123
11,Cádiz,13,Castellar de la Frontera,3022,1507,1515
11,Cádiz,15,Chiclana de la Frontera,83148,41736,41412
11,Cádiz,16,Chipiona,19104,9607,9497
11,Cádiz,14,Conil de la Frontera,22369,11250,11119
11,Cádiz,17,Espera,3909,1964,1945
11,Cádiz,18,"Gastor, El",1724,889,835
11,Cádiz,19,Grazalema,2100,1053,1047
11,Cádiz,20,Jerez de la Frontera,212915,104190,108725
11,Cádiz,21,Jimena de la Frontera,9685,4971,4714
11,Cádiz,22,"Línea de la Concepción, La",63146,31031,32115
11,Cádiz,23,Medina-Sidonia,11741,5986,5755
11,Cádiz,24,Olvera,8153,4014,4139
11,Cádiz,25,Paterna de Rivera,5577,2879,2698
11,Cádiz,26,Prado del Rey,5710,2845,2865
11,Cádiz,27,"Puerto de Santa María, El",88430,43444,44986
11,Cádiz,28,Puerto Real,41472,20809,20663
11,Cádiz,29,Puerto Serrano,7066,3578,3488
11,Cádiz,30,Rota,28996,14483,14513
11,Cádiz,31,San Fernando,95643,46795,48848
11,Cádiz,902,San José del Valle,4445,2276,2169
11,Cádiz,33,San Roque,29969,14945,15024
11,Cádiz,32,Sanlúcar de Barrameda,67640,33690,33950
11,Cádiz,34,Setenil de las Bodegas,2781,1424,1357
11,Cádiz,35,Tarifa,18088,9121,8967
11,Cádiz,36,Torre Alháquime,795,399,396
11,Cádiz,37,Trebujena,7069,3543,3526
11,Cádiz,38,Ubrique,16683,8265,8418
11,Cádiz,39,Vejer de la Frontera,12782,6400,6382
11,Cádiz,40,Villaluenga del Rosario,446,233,213
11,Cádiz,41,Villamartín,12207,6119,6088
11,Cádiz,42,Zahara,1416,725,691
39,Cantabria,1,Alfoz de Lloredo,2446,1254,1192
39,Cantabria,2,Ampuero,4222,2156,2066
39,Cantabria,3,Anievas,291,154,137
39,Cantabria,4,Arenas de Iguña,1690,867,823
39,Cantabria,5,Argoños,1713,889,824
39,Cantabria,6,Arnuero,2098,1061,1037
39,Cantabria,7,Arredondo,472,272,200
39,Cantabria,8,"Astillero, El",18120,8823,9297
39,Cantabria,9,Bárcena de Cicero,4132,2150,1982
39,Cantabria,10,Bárcena de Pie de Concha,687,344,343
39,Cantabria,11,Bareyo,1987,1014,973
39,Cantabria,12,Cabezón de la Sal,8326,4042,4284
39,Cantabria,13,Cabezón de Liébana,595,345,250
39,Cantabria,14,Cabuérniga,1001,542,459
39,Cantabria,15,Camaleño,970,537,433
39,Cantabria,16,Camargo,30556,14960,15596
39,Cantabria,27,Campoo de Enmedio,3757,1920,1837
39,Cantabria,17,Campoo de Yuso,682,361,321
39,Cantabria,18,Cartes,5742,2880,2862
39,Cantabria,19,Castañeda,2744,1403,1341
39,Cantabria,20,Castro-Urdiales,31817,15777,16040
39,Cantabria,21,Cieza,536,274,262
39,Cantabria,22,Cillorigo de Liébana,1320,703,617
39,Cantabria,23,Colindres,8288,4073,4215
39,Cantabria,24,Comillas,2195,1042,1153
39,Cantabria,25,"Corrales de Buelna, Los",10912,5346,5566
39,Cantabria,26,Corvera de Toranzo,2055,1046,1009
39,Cantabria,28,Entrambasaguas,5010,2521,2489
39,Cantabria,29,Escalante,749,390,359
39,Cantabria,30,Guriezo,2358,1210,1148
39,Cantabria,31,Hazas de Cesto,1550,785,765
39,Cantabria,32,Hermandad de Campoo de Suso,1612,886,726
39,Cantabria,33,Herrerías,623,347,276
39,Cantabria,34,Lamasón,302,192,110
39,Cantabria,35,Laredo,11347,5394,5953
39,Cantabria,36,Liendo,1216,624,592
39,Cantabria,37,Liérganes,2355,1161,1194
39,Cantabria,38,Limpias,1824,908,916
39,Cantabria,39,Luena,611,332,279
39,Cantabria,40,Marina de Cudeyo,5147,2566,2581
39,Cantabria,41,Mazcuerras,2125,1093,1032
39,Cantabria,42,Medio Cudeyo,7459,3634,3825
39,Cantabria,43,Meruelo,1985,1003,982
39,Cantabria,44,Miengo,4676,2358,2318
39,Cantabria,45,Miera,393,205,188
39,Cantabria,46,Molledo,1585,789,796
39,Cantabria,47,Noja,2553,1274,1279
39,Cantabria,48,Penagos,2083,1059,1024
39,Cantabria,49,Peñarrubia,332,182,150
39,Cantabria,50,Pesaguero,298,169,129
39,Cantabria,51,Pesquera,68,42,26
39,Cantabria,52,Piélagos,24918,12344,12574
39,Cantabria,53,Polaciones,239,152,87
39,Cantabria,54,Polanco,5850,2930,2920
39,Cantabria,55,Potes,1342,655,687
39,Cantabria,56,Puente Viesgo,2843,1445,1398
39,Cantabria,57,Ramales de la Victoria,2895,1459,1436
39,Cantabria,58,Rasines,966,510,456
39,Cantabria,59,Reinosa,9331,4382,4949
39,Cantabria,60,Reocín,8312,4102,4210
39,Cantabria,61,Ribamontán al Mar,4426,2226,2200
39,Cantabria,62,Ribamontán al Monte,2223,1163,1060
39,Cantabria,63,Rionansa,1045,589,456
39,Cantabria,64,Riotuerto,1615,771,844
39,Cantabria,65,"Rozas de Valdearroyo, Las",264,147,117
39,Cantabria,66,Ruente,1031,554,477
39,Cantabria,67,Ruesga,870,472,398
39,Cantabria,68,Ruiloba,748,386,362
39,Cantabria,69,San Felices de Buelna,2421,1219,1202
39,Cantabria,70,San Miguel de Aguayo,154,81,73
39,Cantabria,71,San Pedro del Romeral,452,253,199
39,Cantabria,72,San Roque de Riomiera,380,226,154
39,Cantabria,80,San Vicente de la Barquera,4173,2084,2089
39,Cantabria,73,Santa Cruz de Bezana,12818,6296,6522
39,Cantabria,74,Santa María de Cayón,9095,4552,4543
39,Cantabria,75,Santander,171951,79391,92560
39,Cantabria,76,Santillana del Mar,4154,2029,2125
39,Cantabria,77,Santiurde de Reinosa,254,149,105
39,Cantabria,78,Santiurde de Toranzo,1610,836,774
39,Cantabria,79,Santoña,11004,5371,5633
39,Cantabria,81,Saro,515,270,245
39,Cantabria,82,Selaya,1915,954,961
39,Cantabria,83,Soba,1207,659,548
39,Cantabria,84,Solórzano,1040,552,488
39,Cantabria,85,Suances,8645,4258,4387
39,Cantabria,86,"Tojos, Los",402,237,165
39,Cantabria,87,Torrelavega,52034,24556,27478
39,Cantabria,88,Tresviso,70,47,23
39,Cantabria,89,Tudanca,145,104,41
39,Cantabria,90,Udías,903,456,447
39,Cantabria,95,Val de San Vicente,2804,1466,1338
39,Cantabria,91,Valdáliga,2218,1144,1074
39,Cantabria,92,Valdeolea,994,530,464
39,Cantabria,93,Valdeprado del Río,323,186,137
39,Cantabria,94,Valderredible,987,556,431
39,Cantabria,101,Valle de Villaverde,306,161,145
39,Cantabria,96,Vega de Liébana,765,398,367
39,Cantabria,97,Vega de Pas,784,409,375
39,Cantabria,98,Villacarriedo,1626,847,779
39,Cantabria,99,Villaescusa,3883,1928,1955
39,Cantabria,100,Villafufre,1014,524,490
39,Cantabria,102,Voto,2716,1433,1283
12,Castellón/Castelló,2,Aín,129,69,60
12,Castellón/Castelló,3,Albocàsser,1257,613,644
12,Castellón/Castelló,4,Alcalà de Xivert,6796,3481,3315
12,Castellón/Castelló,5,"Alcora, l'",10502,5305,5197
12,Castellón/Castelló,6,Alcudia de Veo,204,106,98
12,Castellón/Castelló,7,Alfondeguilla,870,441,429
12,Castellón/Castelló,8,Algimia de Almonacid,268,147,121
12,Castellón/Castelló,9,Almazora/Almassora,25648,12869,12779
12,Castellón/Castelló,10,Almedíjar,270,145,125
12,Castellón/Castelló,11,Almenara,5920,2966,2954
12,Castellón/Castelló,901,"Alqueries, les/Alquerías del Niño Perdido",4466,2211,2255
12,Castellón/Castelló,12,Altura,3559,1818,1741
12,Castellón/Castelló,13,Arañuel,151,76,75
12,Castellón/Castelló,14,Ares del Maestrat,197,110,87
12,Castellón/Castelló,15,Argelita,94,54,40
12,Castellón/Castelló,16,Artana,1979,1005,974
12,Castellón/Castelló,1,Atzeneta del Maestrat,1290,656,634
12,Castellón/Castelló,17,Ayódar,165,89,76
12,Castellón/Castelló,18,Azuébar,324,175,149
12,Castellón/Castelló,20,Barracas,165,88,77
12,Castellón/Castelló,22,Bejís,378,218,160
12,Castellón/Castelló,24,Benafer,159,84,75
12,Castellón/Castelló,25,Benafigos,148,84,64
12,Castellón/Castelló,26,Benassal,1106,565,541
12,Castellón/Castelló,27,Benicarló,26429,13166,13263
12,Castellón/Castelló,28,Benicasim/Benicàssim,17964,8953,9011
12,Castellón/Castelló,29,Benlloch,1060,529,531
12,Castellón/Castelló,21,Betxí,5750,2833,2917
12,Castellón/Castelló,32,Borriana/Burriana,34464,17034,17430
12,Castellón/Castelló,31,Borriol,5279,2668,2611
12,Castellón/Castelló,33,Cabanes,2913,1475,1438
12,Castellón/Castelló,34,Càlig,1959,997,962
12,Castellón/Castelló,36,Canet lo Roig,706,343,363
12,Castellón/Castelló,37,Castell de Cabres,17,10,7
12,Castellón/Castelló,38,Castellfort,198,106,92
12,Castellón/Castelló,39,Castellnovo,966,490,476
12,Castellón/Castelló,40,Castellón de la Plana/Castelló de la Plana,169498,82003,87495
12,Castellón/Castelló,41,Castillo de Villamalefa,103,67,36
12,Castellón/Castelló,42,Catí,757,374,383
12,Castellón/Castelló,43,Caudiel,653,339,314
12,Castellón/Castelló,44,Cervera del Maestre,620,296,324
12,Castellón/Castelló,53,Chilches/Xilxes,2658,1392,1266
12,Castellón/Castelló,55,Chodos/Xodos,115,66,49
12,Castellón/Castelló,56,Chóvar,303,156,147
12,Castellón/Castelló,45,Cinctorres,411,196,215
12,Castellón/Castelló,46,Cirat,216,122,94
12,Castellón/Castelló,48,Cortes de Arenoso,298,161,137
12,Castellón/Castelló,49,Costur,532,276,256
12,Castellón/Castelló,50,"Coves de Vinromà, les",1836,917,919
12,Castellón/Castelló,51,Culla,516,267,249
12,Castellón/Castelló,57,Eslida,774,391,383
12,Castellón/Castelló,58,Espadilla,73,43,30
12,Castellón/Castelló,59,Fanzara,272,140,132
12,Castellón/Castelló,60,Figueroles,537,271,266
12,Castellón/Castelló,61,Forcall,438,214,224
12,Castellón/Castelló,63,Fuente la Reina,43,24,19
12,Castellón/Castelló,64,Fuentes de Ayódar,106,58,48
12,Castellón/Castelló,65,Gaibiel,199,109,90
12,Castellón/Castelló,67,Geldo,633,318,315
12,Castellón/Castelló,68,Herbés,48,26,22
12,Castellón/Castelló,69,Higueras,71,40,31
12,Castellón/Castelló,70,"Jana, la",684,340,344
12,Castellón/Castelló,71,Jérica,1550,795,755
12,Castellón/Castelló,74,"Llosa, la",973,481,492
12,Castellón/Castelló,72,Llucena/Lucena del Cid,1331,671,660
12,Castellón/Castelló,73,Ludiente,160,91,69
12,Castellón/Castelló,75,"Mata de Morella, la",173,89,84
12,Castellón/Castelló,76,Matet,86,46,40
12,Castellón/Castelló,77,Moncofa,6092,3170,2922
12,Castellón/Castelló,78,Montán,365,176,189
12,Castellón/Castelló,79,Montanejos,502,258,244
12,Castellón/Castelló,80,Morella,2441,1213,1228
12,Castellón/Castelló,81,Navajas,714,375,339
12,Castellón/Castelló,82,Nules,13266,6611,6655
12,Castellón/Castelló,83,Olocau del Rey,118,66,52
12,Castellón/Castelló,84,Onda,24807,12455,12352
12,Castellón/Castelló,85,Oropesa del Mar/Orpesa,8983,4635,4348
12,Castellón/Castelló,87,Palanques,34,19,15
12,Castellón/Castelló,88,Pavías,63,38,25
12,Castellón/Castelló,89,Peníscola/Peñíscola,7413,3718,3695
12,Castellón/Castelló,90,Pina de Montalgrao,121,59,62
12,Castellón/Castelló,93,"Pobla de Benifassà, la",203,114,89
12,Castellón/Castelló,94,"Pobla Tornesa, la",1227,638,589
12,Castellón/Castelló,91,Portell de Morella,200,98,102
12,Castellón/Castelló,92,Puebla de Arenoso,133,68,65
12,Castellón/Castelló,95,Ribesalbes,1210,616,594
12,Castellón/Castelló,96,Rossell,987,524,463
12,Castellón/Castelló,97,Sacañet,62,41,21
12,Castellón/Castelló,98,"Salzadella, la",743,376,367
12,Castellón/Castelló,101,San Rafael del Río,464,227,237
12,Castellón/Castelló,902,Sant Joan de Moró,3084,1606,1478
12,Castellón/Castelló,99,Sant Jordi/San Jorge,937,483,454
12,Castellón/Castelló,100,Sant Mateu,1958,959,999
12,Castellón/Castelló,102,Santa Magdalena de Pulpis,765,412,353
12,Castellón/Castelló,104,Segorbe,8969,4417,4552
12,Castellón/Castelló,103,"Serratella, la",101,52,49
12,Castellón/Castelló,105,Sierra Engarcerán,1012,535,477
12,Castellón/Castelló,106,Soneja,1468,714,754
12,Castellón/Castelló,107,Sot de Ferrer,429,221,208
12,Castellón/Castelló,108,Sueras/Suera,522,269,253
12,Castellón/Castelló,109,Tales,808,407,401
12,Castellón/Castelló,110,Teresa,250,128,122
12,Castellón/Castelló,111,Tírig,437,223,214
12,Castellón/Castelló,112,Todolella,136,76,60
12,Castellón/Castelló,113,Toga,89,46,43
12,Castellón/Castelló,114,Torás,225,120,105
12,Castellón/Castelló,115,"Toro, El",253,135,118
12,Castellón/Castelló,116,Torralba del Pinar,57,28,29
12,Castellón/Castelló,119,"Torre d'En Besora, la",158,87,71
12,Castellón/Castelló,120,"Torre d'en Doménec, la",198,103,95
12,Castellón/Castelló,117,Torreblanca,5419,2715,2704
12,Castellón/Castelló,118,Torrechiva,77,46,31
12,Castellón/Castelló,121,Traiguera,1434,721,713
12,Castellón/Castelló,122,"Useras/Useres, les",970,500,470
12,Castellón/Castelló,124,Vall d'Alba,2781,1452,1329
12,Castellón/Castelló,125,Vall de Almonacid,272,138,134
12,Castellón/Castelló,126,"Vall d'Uixó, la",31733,15670,16063
12,Castellón/Castelló,123,Vallat,50,23,27
12,Castellón/Castelló,127,Vallibona,77,43,34
12,Castellón/Castelló,128,Vilafamés,1822,971,851
12,Castellón/Castelló,132,Vilanova d'Alcolea,586,309,277
12,Castellón/Castelló,134,Vilar de Canes,177,92,85
12,Castellón/Castelló,135,Vila-real,50334,24958,25376
12,Castellón/Castelló,136,"Vilavella, la",3215,1609,1606
12,Castellón/Castelló,129,Villafranca del Cid/Vilafranca,2267,1109,1158
12,Castellón/Castelló,130,Villahermosa del Río,477,262,215
12,Castellón/Castelló,131,Villamalur,62,38,24
12,Castellón/Castelló,133,Villanueva de Viver,61,34,27
12,Castellón/Castelló,137,Villores,42,22,20
12,Castellón/Castelló,138,Vinaròs,28292,13990,14302
12,Castellón/Castelló,139,Vistabella del Maestrat,352,192,160
12,Castellón/Castelló,140,Viver,1509,784,725
12,Castellón/Castelló,52,Xert,733,347,386
12,Castellón/Castelló,141,Zorita del Maestrazgo,118,61,57
12,Castellón/Castelló,142,Zucaina,189,107,82
13,Ciudad Real,1,Abenójar,1438,736,702
13,Ciudad Real,2,Agudo,1720,871,849
13,Ciudad Real,3,Alamillo,519,265,254
13,Ciudad Real,4,Albaladejo,1201,618,583
13,Ciudad Real,5,Alcázar de San Juan,30943,15052,15891
13,Ciudad Real,6,Alcoba,610,310,300
13,Ciudad Real,7,Alcolea de Calatrava,1458,746,712
13,Ciudad Real,8,Alcubillas,493,252,241
13,Ciudad Real,9,Aldea del Rey,1698,862,836
13,Ciudad Real,10,Alhambra,1009,518,491
13,Ciudad Real,11,Almadén,5537,2654,2883
13,Ciudad Real,12,Almadenejos,440,227,213
13,Ciudad Real,13,Almagro,8983,4417,4566
13,Ciudad Real,14,Almedina,548,293,255
13,Ciudad Real,15,Almodóvar del Campo,6273,3160,3113
13,Ciudad Real,16,Almuradiel,820,398,422
13,Ciudad Real,17,Anchuras,323,166,157
13,Ciudad Real,903,Arenales de San Gregorio,622,319,303
13,Ciudad Real,18,Arenas de San Juan,1051,529,522
13,Ciudad Real,19,Argamasilla de Alba,6928,3480,3448
13,Ciudad Real,20,Argamasilla de Calatrava,5924,3010,2914
13,Ciudad Real,21,Arroba de los Montes,452,239,213
13,Ciudad Real,22,Ballesteros de Calatrava,384,192,192
13,Ciudad Real,23,Bolaños de Calatrava,11882,6028,5854
13,Ciudad Real,24,Brazatortas,1020,533,487
13,Ciudad Real,25,Cabezarados,322,173,149
13,Ciudad Real,26,Cabezarrubias del Puerto,490,254,236
13,Ciudad Real,27,Calzada de Calatrava,3911,1957,1954
13,Ciudad Real,28,Campo de Criptana,13763,6875,6888
13,Ciudad Real,29,Cañada de Calatrava,103,61,42
13,Ciudad Real,30,Caracuel de Calatrava,141,84,57
13,Ciudad Real,31,Carrión de Calatrava,3069,1541,1528
13,Ciudad Real,32,Carrizosa,1251,636,615
13,Ciudad Real,33,Castellar de Santiago,1966,990,976
13,Ciudad Real,38,Chillón,1857,908,949
13,Ciudad Real,34,Ciudad Real,74641,35286,39355
13,Ciudad Real,35,Corral de Calatrava,1153,568,585
13,Ciudad Real,36,"Cortijos, Los",904,482,422
13,Ciudad Real,37,Cózar,1017,500,517
13,Ciudad Real,39,Daimiel,18176,9052,9124
13,Ciudad Real,40,Fernán Caballero,1027,519,508
13,Ciudad Real,41,Fontanarejo,265,145,120
13,Ciudad Real,42,Fuencaliente,1028,543,485
13,Ciudad Real,43,Fuenllana,242,126,116
13,Ciudad Real,44,Fuente el Fresno,3311,1719,1592
13,Ciudad Real,45,Granátula de Calatrava,764,378,386
13,Ciudad Real,46,Guadalmez,763,380,383
13,Ciudad Real,47,Herencia,8431,4291,4140
13,Ciudad Real,48,Hinojosas de Calatrava,529,269,260
13,Ciudad Real,49,Horcajo de los Montes,935,471,464
13,Ciudad Real,50,"Labores, Las",580,290,290
13,Ciudad Real,904,Llanos del Caudillo,722,362,360
13,Ciudad Real,51,Luciana,382,205,177
13,Ciudad Real,52,Malagón,8108,4019,4089
13,Ciudad Real,53,Manzanares,18206,8999,9207
13,Ciudad Real,54,Membrilla,6050,3033,3017
13,Ciudad Real,55,Mestanza,711,352,359
13,Ciudad Real,56,Miguelturra,15225,7662,7563
13,Ciudad Real,57,Montiel,1364,715,649
13,Ciudad Real,58,Moral de Calatrava,5309,2682,2627
13,Ciudad Real,59,Navalpino,231,117,114
13,Ciudad Real,60,Navas de Estena,246,133,113
13,Ciudad Real,61,Pedro Muñoz,7467,3780,3687
13,Ciudad Real,62,Picón,671,349,322
13,Ciudad Real,63,Piedrabuena,4517,2287,2230
13,Ciudad Real,64,Poblete,2465,1267,1198
13,Ciudad Real,65,Porzuna,3633,1866,1767
13,Ciudad Real,66,Pozuelo de Calatrava,3382,1736,1646
13,Ciudad Real,67,"Pozuelos de Calatrava, Los",385,202,183
13,Ciudad Real,68,Puebla de Don Rodrigo,1213,665,548
13,Ciudad Real,69,Puebla del Príncipe,729,370,359
13,Ciudad Real,70,Puerto Lápice,947,467,480
13,Ciudad Real,71,Puertollano,48477,23449,25028
13,Ciudad Real,72,Retuerta del Bullaque,991,541,450
13,Ciudad Real,901,"Robledo, El",1111,589,522
13,Ciudad Real,902,Ruidera,558,282,276
13,Ciudad Real,73,Saceruela,596,325,271
13,Ciudad Real,74,San Carlos del Valle,1143,593,550
13,Ciudad Real,75,San Lorenzo de Calatrava,212,112,100
13,Ciudad Real,76,Santa Cruz de los Cáñamos,530,264,266
13,Ciudad Real,77,Santa Cruz de Mudela,4195,2078,2117
13,Ciudad Real,78,Socuéllamos,12342,6240,6102
13,Ciudad Real,80,Solana del Pino,336,180,156
13,Ciudad Real,79,"Solana, La",15640,7880,7760
13,Ciudad Real,81,Terrinches,711,367,344
13,Ciudad Real,82,Tomelloso,36281,18002,18279
13,Ciudad Real,83,Torralba de Calatrava,3006,1491,1515
13,Ciudad Real,84,Torre de Juan Abad,1035,505,530
13,Ciudad Real,85,Torrenueva,2788,1412,1376
13,Ciudad Real,86,Valdemanco del Esteras,178,94,84
13,Ciudad Real,87,Valdepeñas,30224,14790,15434
13,Ciudad Real,88,Valenzuela de Calatrava,700,323,377
13,Ciudad Real,89,Villahermosa,1908,906,1002
13,Ciudad Real,90,Villamanrique,1210,591,619
13,Ciudad Real,91,Villamayor de Calatrava,615,308,307
13,Ciudad Real,92,Villanueva de la Fuente,2185,1118,1067
13,Ciudad Real,93,Villanueva de los Infantes,5064,2470,2594
13,Ciudad Real,94,Villanueva de San Carlos,308,161,147
13,Ciudad Real,95,Villar del Pozo,89,49,40
13,Ciudad Real,96,Villarrubia de los Ojos,10026,4973,5053
13,Ciudad Real,97,Villarta de San Juan,2863,1437,1426
13,Ciudad Real,98,Viso del Marqués,2378,1157,1221
14,Córdoba,1,Adamuz,4236,2173,2063
14,Córdoba,2,Aguilar de la Frontera,13476,6784,6692
14,Córdoba,3,Alcaracejos,1496,724,772
14,Córdoba,4,Almedinilla,2455,1232,1223
14,Córdoba,5,Almodóvar del Río,7982,4015,3967
14,Córdoba,6,Añora,1553,767,786
14,Córdoba,7,Baena,19523,9977,9546
14,Córdoba,8,Belalcázar,3336,1611,1725
14,Córdoba,9,Belmez,2913,1420,1493
14,Córdoba,10,Benamejí,5025,2519,2506
14,Córdoba,11,"Blázquez, Los",691,358,333
14,Córdoba,12,Bujalance,7599,3796,3803
14,Córdoba,13,Cabra,20557,10055,10502
14,Córdoba,14,Cañete de las Torres,3000,1541,1459
14,Córdoba,15,Carcabuey,2471,1261,1210
14,Córdoba,16,Cardeña,1532,769,763
14,Córdoba,17,"Carlota, La",14010,7030,6980
14,Córdoba,18,"Carpio, El",4480,2229,2251
14,Córdoba,19,Castro del Río,7881,3918,3963
14,Córdoba,20,Conquista,418,208,210
14,Córdoba,21,Córdoba,325916,156522,169394
14,Córdoba,22,Doña Mencía,4718,2305,2413
14,Córdoba,23,Dos Torres,2426,1202,1224
14,Córdoba,24,Encinas Reales,2297,1137,1160
14,Córdoba,25,Espejo,3375,1706,1669
14,Córdoba,26,Espiel,2474,1236,1238
14,Córdoba,27,Fernán-Núñez,9680,4848,4832
14,Córdoba,28,Fuente la Lancha,345,178,167
14,Córdoba,29,Fuente Obejuna,4734,2423,2311
14,Córdoba,30,Fuente Palmera,10871,5468,5403
14,Córdoba,31,Fuente-Tójar,705,335,370
14,Córdoba,32,"Granjuela, La",474,244,230
14,Córdoba,33,Guadalcázar,1605,803,802
14,Córdoba,34,"Guijo, El",355,188,167
14,Córdoba,35,Hinojosa del Duque,6922,3392,3530
14,Córdoba,36,Hornachuelos,4575,2293,2282
14,Córdoba,37,Iznájar,4405,2209,2196
14,Córdoba,38,Lucena,42511,21202,21309
14,Córdoba,39,Luque,3051,1540,1511
14,Córdoba,40,Montalbán de Córdoba,4420,2213,2207
14,Córdoba,41,Montemayor,3902,1960,1942
14,Córdoba,42,Montilla,23209,11487,11722
14,Córdoba,43,Montoro,9518,4661,4857
14,Córdoba,44,Monturque,1994,990,1004
14,Córdoba,45,Moriles,3775,1890,1885
14,Córdoba,46,Nueva Carteya,5396,2739,2657
14,Córdoba,47,Obejo,2011,1053,958
14,Córdoba,48,Palenciana,1515,764,751
14,Córdoba,49,Palma del Río,21162,10531,10631
14,Córdoba,50,Pedro Abad,2864,1451,1413
14,Córdoba,51,Pedroche,1567,757,810
14,Córdoba,52,Peñarroya-Pueblonuevo,11031,5335,5696
14,Córdoba,53,Posadas,7411,3696,3715
14,Córdoba,54,Pozoblanco,17285,8437,8848
14,Córdoba,55,Priego de Córdoba,22697,11070,11627
14,Córdoba,56,Puente Genil,30173,14994,15179
14,Córdoba,57,"Rambla, La",7547,3762,3785
14,Córdoba,58,Rute,9994,4956,5038
14,Córdoba,59,San Sebastián de los Ballesteros,808,405,403
14,Córdoba,61,Santa Eufemia,794,397,397
14,Córdoba,60,Santaella,6049,3064,2985
14,Córdoba,62,Torrecampo,1123,547,576
14,Córdoba,63,Valenzuela,1189,588,601
14,Córdoba,64,Valsequillo,367,178,189
14,Córdoba,65,"Victoria, La",2327,1159,1168
14,Córdoba,66,Villa del Río,7251,3628,3623
14,Córdoba,67,Villafranca de Córdoba,4886,2488,2398
14,Córdoba,68,Villaharta,662,324,338
14,Córdoba,69,Villanueva de Córdoba,8886,4402,4484
14,Córdoba,70,Villanueva del Duque,1504,753,751
14,Córdoba,71,Villanueva del Rey,1081,533,548
14,Córdoba,72,Villaralto,1171,585,586
14,Córdoba,73,Villaviciosa de Córdoba,3347,1716,1631
14,Córdoba,74,"Viso, El",2586,1279,1307
14,Córdoba,75,Zuheros,644,326,318
15,"Coruña, A",1,Abegondo,5467,2698,2769
15,"Coruña, A",2,Ames,30835,14811,16024
15,"Coruña, A",3,Aranga,1935,982,953
15,"Coruña, A",4,Ares,5658,2791,2867
15,"Coruña, A",5,Arteixo,31534,15686,15848
15,"Coruña, A",6,Arzúa,6123,3053,3070
15,"Coruña, A",7,"Baña, A",3541,1690,1851
15,"Coruña, A",8,Bergondo,6623,3235,3388
15,"Coruña, A",9,Betanzos,12941,6136,6805
15,"Coruña, A",10,Boimorto,2040,1042,998
15,"Coruña, A",11,Boiro,18885,9227,9658
15,"Coruña, A",12,Boqueixón,4242,2096,2146
15,"Coruña, A",13,Brión,7699,3716,3983
15,"Coruña, A",14,Cabana de Bergantiños,4347,2099,2248
15,"Coruña, A",15,Cabanas,3314,1617,1697
15,"Coruña, A",16,Camariñas,5419,2641,2778
15,"Coruña, A",17,Cambre,24348,11902,12446
15,"Coruña, A",18,"Capela, A",1274,633,641
15,"Coruña, A",19,Carballo,31195,15247,15948
15,"Coruña, A",901,Cariño,4004,1981,2023
15,"Coruña, A",20,Carnota,4060,1942,2118
15,"Coruña, A",21,Carral,6237,3064,3173
15,"Coruña, A",22,Cedeira,6888,3424,3464
15,"Coruña, A",23,Cee,7539,3608,3931
15,"Coruña, A",24,Cerceda,4992,2461,2531
15,"Coruña, A",25,Cerdido,1170,568,602
15,"Coruña, A",27,Coirós,1801,889,912
15,"Coruña, A",28,Corcubión,1592,770,822
15,"Coruña, A",29,Coristanco,6313,3024,3289
15,"Coruña, A",30,"Coruña, A",244099,113336,130763
15,"Coruña, A",31,Culleredo,29982,14556,15426
15,"Coruña, A",32,Curtis,3968,1978,1990
15,"Coruña, A",33,Dodro,2832,1373,1459
15,"Coruña, A",34,Dumbría,3053,1464,1589
15,"Coruña, A",35,Fene,13110,6271,6839
15,"Coruña, A",36,Ferrol,67569,31692,35877
15,"Coruña, A",37,Fisterra,4734,2402,2332
15,"Coruña, A",38,Frades,2422,1206,1216
15,"Coruña, A",39,Irixoa,1361,676,685
15,"Coruña, A",41,"Laracha, A",11281,5538,5743
15,"Coruña, A",40,Laxe,3090,1559,1531
15,"Coruña, A",42,Lousame,3447,1681,1766
15,"Coruña, A",43,Malpica de Bergantiños,5518,2696,2822
15,"Coruña, A",44,Mañón,1391,677,714
15,"Coruña, A",45,Mazaricos,4014,1920,2094
15,"Coruña, A",46,Melide,7503,3681,3822
15,"Coruña, A",47,Mesía,2637,1304,1333
15,"Coruña, A",48,Miño,5905,2950,2955
15,"Coruña, A",49,Moeche,1230,574,656
15,"Coruña, A",50,Monfero,1985,1028,957
15,"Coruña, A",51,Mugardos,5303,2599,2704
15,"Coruña, A",53,Muros,8792,4254,4538
15,"Coruña, A",52,Muxía,4852,2370,2482
15,"Coruña, A",54,Narón,39280,19002,20278
15,"Coruña, A",55,Neda,5165,2527,2638
15,"Coruña, A",56,Negreira,6883,3324,3559
15,"Coruña, A",57,Noia,14295,6844,7451
15,"Coruña, A",58,Oleiros,35198,17012,18186
15,"Coruña, A",59,Ordes,12580,6143,6437
15,"Coruña, A",60,Oroso,7452,3678,3774
15,"Coruña, A",61,Ortigueira,5966,2869,3097
15,"Coruña, A",62,Outes,6514,3126,3388
15,"Coruña, A",902,Oza-Cesuras,5133,2582,2551
15,"Coruña, A",64,Paderne,2441,1192,1249
15,"Coruña, A",65,Padrón,8463,4055,4408
15,"Coruña, A",66,"Pino, O",4644,2334,2310
15,"Coruña, A",67,"Pobra do Caramiñal, A",9440,4603,4837
15,"Coruña, A",68,Ponteceso,5613,2814,2799
15,"Coruña, A",69,Pontedeume,7937,3809,4128
15,"Coruña, A",70,"Pontes de García Rodríguez, As",10324,5060,5264
15,"Coruña, A",71,Porto do Son,9271,4610,4661
15,"Coruña, A",72,Rianxo,11188,5456,5732
15,"Coruña, A",73,Ribeira,27159,13386,13773
15,"Coruña, A",74,Rois,4627,2206,2421
15,"Coruña, A",75,Sada,15242,7470,7772
15,"Coruña, A",76,San Sadurniño,2877,1429,1448
15,"Coruña, A",77,Santa Comba,9477,4585,4892
15,"Coruña, A",78,Santiago de Compostela,96456,44708,51748
15,"Coruña, A",79,Santiso,1630,836,794
15,"Coruña, A",80,Sobrado,1847,949,898
15,"Coruña, A",81,"Somozas, As",1128,566,562
15,"Coruña, A",82,Teo,18478,9067,9411
15,"Coruña, A",83,Toques,1173,611,562
15,"Coruña, A",84,Tordoia,3433,1617,1816
15,"Coruña, A",85,Touro,3693,1837,1856
15,"Coruña, A",86,Trazo,3186,1580,1606
15,"Coruña, A",88,Val do Dubra,3931,1881,2050
15,"Coruña, A",87,Valdoviño,6594,3204,3390
15,"Coruña, A",89,Vedra,5051,2478,2573
15,"Coruña, A",91,Vilarmaior,1249,638,611
15,"Coruña, A",90,Vilasantar,1241,650,591
15,"Coruña, A",92,Vimianzo,7270,3493,3777
15,"Coruña, A",93,Zas,4671,2262,2409
16,Cuenca,1,Abia de la Obispalía,66,40,26
16,Cuenca,2,"Acebrón, El",237,116,121
16,Cuenca,3,Alarcón,148,68,80
16,Cuenca,4,Albaladejo del Cuende,263,132,131
16,Cuenca,5,Albalate de las Nogueras,276,144,132
16,Cuenca,6,Albendea,130,60,70
16,Cuenca,7,"Alberca de Záncara, La",1622,826,796
16,Cuenca,8,Alcalá de la Vega,90,50,40
16,Cuenca,9,Alcantud,60,35,25
16,Cuenca,10,Alcázar del Rey,145,72,73
16,Cuenca,11,Alcohujate,34,18,16
16,Cuenca,12,Alconchel de la Estrella,98,55,43
16,Cuenca,13,Algarra,27,17,10
16,Cuenca,14,Aliaguilla,674,349,325
16,Cuenca,15,"Almarcha, La",376,207,169
16,Cuenca,16,Almendros,241,142,99
16,Cuenca,17,Almodóvar del Pinar,421,227,194
16,Cuenca,18,Almonacid del Marquesado,433,220,213
16,Cuenca,19,Altarejos,217,115,102
16,Cuenca,20,Arandilla del Arroyo,13,7,6
16,Cuenca,905,Arcas,1691,855,836
16,Cuenca,22,Arcos de la Sierra,85,50,35
16,Cuenca,24,Arguisuelas,153,86,67
16,Cuenca,25,Arrancacepas,28,15,13
16,Cuenca,26,Atalaya del Cañavate,104,52,52
16,Cuenca,27,Barajas de Melo,913,486,427
16,Cuenca,29,Barchín del Hoyo,88,53,35
16,Cuenca,30,Bascuñana de San Pedro,22,16,6
16,Cuenca,31,Beamud,37,18,19
16,Cuenca,32,Belinchón,314,161,153
16,Cuenca,33,Belmonte,1958,976,982
16,Cuenca,34,Belmontejo,181,101,80
16,Cuenca,35,Beteta,277,135,142
16,Cuenca,36,Boniches,148,73,75
16,Cuenca,38,Buciegas,45,28,17
16,Cuenca,39,Buenache de Alarcón,479,252,227
16,Cuenca,40,Buenache de la Sierra,93,55,38
16,Cuenca,41,Buendía,417,222,195
16,Cuenca,42,Campillo de Altobuey,1379,683,696
16,Cuenca,43,Campillos-Paravientos,115,63,52
16,Cuenca,44,Campillos-Sierra,32,13,19
16,Cuenca,901,Campos del Paraíso,798,401,397
16,Cuenca,45,Canalejas del Arroyo,246,131,115
16,Cuenca,46,Cañada del Hoyo,254,129,125
16,Cuenca,47,Cañada Juncosa,255,137,118
16,Cuenca,48,Cañamares,467,254,213
16,Cuenca,49,"Cañavate, El",154,82,72
16,Cuenca,50,Cañaveras,271,133,138
16,Cuenca,51,Cañaveruelas,139,71,68
16,Cuenca,52,Cañete,774,404,370
16,Cuenca,53,Cañizares,480,263,217
16,Cuenca,55,Carboneras de Guadazaón,808,418,390
16,Cuenca,56,Cardenete,501,272,229
16,Cuenca,57,Carrascosa,72,44,28
16,Cuenca,58,Carrascosa de Haro,115,58,57
16,Cuenca,60,Casas de Benítez,875,430,445
16,Cuenca,61,Casas de Fernando Alonso,1208,629,579
16,Cuenca,62,Casas de Garcimolina,28,18,10
16,Cuenca,63,Casas de Guijarro,111,60,51
16,Cuenca,64,Casas de Haro,847,447,400
16,Cuenca,65,Casas de los Pinos,443,220,223
16,Cuenca,66,Casasimarro,3072,1601,1471
16,Cuenca,67,Castejón,166,82,84
16,Cuenca,68,Castillejo de Iniesta,160,89,71
16,Cuenca,70,Castillejo-Sierra,29,14,15
16,Cuenca,72,Castillo de Garcimuñoz,145,82,63
16,Cuenca,71,Castillo-Albaráñez,22,10,12
16,Cuenca,73,Cervera del Llano,221,114,107
16,Cuenca,23,Chillarón de Cuenca,591,318,273
16,Cuenca,81,Chumillas,54,28,26
16,Cuenca,74,"Cierva, La",35,22,13
16,Cuenca,78,Cuenca,54876,26225,28651
16,Cuenca,79,Cueva del Hierro,34,25,9
16,Cuenca,82,Enguídanos,331,180,151
16,Cuenca,83,Fresneda de Altarejos,51,25,26
16,Cuenca,84,Fresneda de la Sierra,53,30,23
16,Cuenca,85,"Frontera, La",157,79,78
16,Cuenca,86,Fuente de Pedro Naharro,1210,626,584
16,Cuenca,87,Fuentelespino de Haro,249,129,120
16,Cuenca,88,Fuentelespino de Moya,107,57,50
16,Cuenca,904,Fuentenava de Jábaga,553,294,259
16,Cuenca,89,Fuentes,447,234,213
16,Cuenca,91,Fuertescusa,70,38,32
16,Cuenca,92,Gabaldón,182,106,76
16,Cuenca,93,Garaballa,74,39,35
16,Cuenca,94,Gascueña,169,94,75
16,Cuenca,95,Graja de Campalbo,92,52,40
16,Cuenca,96,Graja de Iniesta,365,191,174
16,Cuenca,97,Henarejos,153,76,77
16,Cuenca,98,"Herrumblar, El",676,344,332
16,Cuenca,99,"Hinojosa, La",200,101,99
16,Cuenca,100,"Hinojosos, Los",814,402,412
16,Cuenca,101,"Hito, El",154,86,68
16,Cuenca,102,Honrubia,1602,801,801
16,Cuenca,103,Hontanaya,290,157,133
16,Cuenca,104,Hontecillas,51,28,23
16,Cuenca,106,Horcajo de Santiago,3542,1798,1744
16,Cuenca,107,Huélamo,103,61,42
16,Cuenca,108,Huelves,54,28,26
16,Cuenca,109,Huérguina,51,26,25
16,Cuenca,110,Huerta de la Obispalía,134,81,53
16,Cuenca,111,Huerta del Marquesado,200,118,82
16,Cuenca,112,Huete,1776,917,859
16,Cuenca,113,Iniesta,4337,2141,2196
16,Cuenca,115,Laguna del Marquesado,45,26,19
16,Cuenca,116,Lagunaseca,75,43,32
16,Cuenca,117,Landete,1229,618,611
16,Cuenca,118,Ledaña,1614,804,810
16,Cuenca,119,Leganiel,182,93,89
16,Cuenca,121,"Majadas, Las",266,135,131
16,Cuenca,122,Mariana,290,151,139
16,Cuenca,123,Masegosa,73,42,31
16,Cuenca,124,"Mesas, Las",2312,1179,1133
16,Cuenca,125,Minglanilla,2232,1146,1086
16,Cuenca,126,Mira,929,460,469
16,Cuenca,128,Monreal del Llano,69,36,33
16,Cuenca,129,Montalbanejo,103,58,45
16,Cuenca,130,Montalbo,639,343,296
16,Cuenca,131,Monteagudo de las Salinas,120,68,52
16,Cuenca,132,Mota de Altarejos,36,24,12
16,Cuenca,133,Mota del Cuervo,6033,3003,3030
16,Cuenca,134,Motilla del Palancar,5929,2947,2982
16,Cuenca,135,Moya,153,90,63
16,Cuenca,137,Narboneta,49,24,25
16,Cuenca,139,Olivares de Júcar,337,175,162
16,Cuenca,140,Olmeda de la Cuesta,29,17,12
16,Cuenca,141,Olmeda del Rey,132,66,66
16,Cuenca,142,Olmedilla de Alarcón,159,91,68
16,Cuenca,143,Olmedilla de Eliz,16,11,5
16,Cuenca,145,Osa de la Vega,501,259,242
16,Cuenca,146,Pajarón,79,42,37
16,Cuenca,147,Pajaroncillo,75,43,32
16,Cuenca,148,Palomares del Campo,642,327,315
16,Cuenca,149,Palomera,159,83,76
16,Cuenca,150,Paracuellos,99,49,50
16,Cuenca,151,Paredes,64,35,29
16,Cuenca,152,"Parra de las Vegas, La",39,23,16
16,Cuenca,153,"Pedernoso, El",1147,579,568
16,Cuenca,154,"Pedroñeras, Las",6581,3356,3225
16,Cuenca,155,"Peral, El",628,344,284
16,Cuenca,156,"Peraleja, La",95,55,40
16,Cuenca,157,"Pesquera, La",225,123,102
16,Cuenca,158,"Picazo, El",672,337,335
16,Cuenca,159,Pinarejo,227,113,114
16,Cuenca,160,Pineda de Gigüela,61,33,28
16,Cuenca,161,Piqueras del Castillo,55,30,25
16,Cuenca,162,Portalrubio de Guadamejud,26,13,13
16,Cuenca,163,Portilla,69,36,33
16,Cuenca,165,Poyatos,62,31,31
16,Cuenca,166,Pozoamargo,302,160,142
16,Cuenca,908,Pozorrubielos de la Mancha,196,93,103
16,Cuenca,167,Pozorrubio de Santiago,315,145,170
16,Cuenca,169,"Pozuelo, El",54,34,20
16,Cuenca,170,Priego,942,475,467
16,Cuenca,171,"Provencio, El",2453,1212,1241
16,Cuenca,172,Puebla de Almenara,351,184,167
16,Cuenca,174,Puebla del Salvador,192,107,85
16,Cuenca,175,Quintanar del Rey,7533,3882,3651
16,Cuenca,176,Rada de Haro,42,23,19
16,Cuenca,177,Reíllo,105,56,49
16,Cuenca,181,Rozalén del Monte,72,33,39
16,Cuenca,185,Saceda-Trasierra,44,31,13
16,Cuenca,186,Saelices,506,260,246
16,Cuenca,187,Salinas del Manzano,85,48,37
16,Cuenca,188,Salmeroncillos,107,63,44
16,Cuenca,189,Salvacañete,315,162,153
16,Cuenca,190,San Clemente,7247,3677,3570
16,Cuenca,191,San Lorenzo de la Parrilla,1057,523,534
16,Cuenca,192,San Martín de Boniches,46,24,22
16,Cuenca,193,San Pedro Palmiches,57,33,24
16,Cuenca,194,Santa Cruz de Moya,236,126,110
16,Cuenca,196,Santa María de los Llanos,694,359,335
16,Cuenca,195,Santa María del Campo Rus,607,298,309
16,Cuenca,197,Santa María del Val,60,36,24
16,Cuenca,198,Sisante,1685,848,837
16,Cuenca,199,Solera de Gabaldón,28,12,16
16,Cuenca,909,Sotorribas,776,400,376
16,Cuenca,202,Talayuelas,898,476,422
16,Cuenca,203,Tarancón,14834,7357,7477
16,Cuenca,204,Tébar,283,150,133
16,Cuenca,205,Tejadillos,130,65,65
16,Cuenca,206,Tinajas,197,102,95
16,Cuenca,209,Torralba,126,75,51
16,Cuenca,211,Torrejoncillo del Rey,394,199,195
16,Cuenca,212,Torrubia del Campo,265,130,135
16,Cuenca,213,Torrubia del Castillo,40,24,16
16,Cuenca,215,Tragacete,261,143,118
16,Cuenca,216,Tresjuncos,316,169,147
16,Cuenca,217,Tribaldos,91,48,43
16,Cuenca,218,Uclés,219,116,103
16,Cuenca,219,Uña,92,45,47
16,Cuenca,906,"Valdecolmenas, Los",77,47,30
16,Cuenca,224,Valdemeca,87,48,39
16,Cuenca,225,Valdemorillo de la Sierra,66,38,28
16,Cuenca,227,Valdemoro-Sierra,114,68,46
16,Cuenca,228,Valdeolivas,195,119,76
16,Cuenca,902,Valdetórtola,140,79,61
16,Cuenca,903,"Valeras, Las",1547,820,727
16,Cuenca,231,Valhermoso de la Fuente,47,25,22
16,Cuenca,173,"Valle de Altomira, El",221,124,97
16,Cuenca,234,Valsalobre,26,15,11
16,Cuenca,236,Valverde de Júcar,1111,557,554
16,Cuenca,237,Valverdejo,99,52,47
16,Cuenca,238,Vara de Rey,530,274,256
16,Cuenca,239,Vega del Codorno,135,84,51
16,Cuenca,240,Vellisca,102,58,44
16,Cuenca,242,Villaconejos de Trabaque,358,180,178
16,Cuenca,243,Villaescusa de Haro,494,245,249
16,Cuenca,244,Villagarcía del Llano,775,396,379
16,Cuenca,245,Villalba de la Sierra,499,243,256
16,Cuenca,246,Villalba del Rey,546,296,250
16,Cuenca,247,Villalgordo del Marquesado,78,40,38
16,Cuenca,248,Villalpardo,976,485,491
16,Cuenca,249,Villamayor de Santiago,2587,1316,1271
16,Cuenca,250,Villanueva de Guadamejud,68,41,27
16,Cuenca,251,Villanueva de la Jara,2259,1132,1127
16,Cuenca,253,Villar de Cañas,402,211,191
16,Cuenca,254,Villar de Domingo García,216,112,104
16,Cuenca,255,Villar de la Encina,169,91,78
16,Cuenca,263,Villar de Olalla,1250,668,582
16,Cuenca,258,Villar del Humo,203,115,88
16,Cuenca,259,Villar del Infantado,42,25,17
16,Cuenca,910,Villar y Velasco,88,48,40
16,Cuenca,264,Villarejo de Fuentes,475,242,233
16,Cuenca,265,Villarejo de la Peñuela,20,7,13
16,Cuenca,266,Villarejo-Periesteban,392,197,195
16,Cuenca,269,Villares del Saz,485,236,249
16,Cuenca,270,Villarrubio,196,107,89
16,Cuenca,271,Villarta,829,415,414
16,Cuenca,272,Villas de la Ventosa,230,133,97
16,Cuenca,273,Villaverde y Pasaconsol,352,188,164
16,Cuenca,274,Víllora,125,67,58
16,Cuenca,275,Vindel,10,6,4
16,Cuenca,276,Yémeda,24,17,7
16,Cuenca,277,Zafra de Záncara,128,72,56
16,Cuenca,278,Zafrilla,67,34,33
16,Cuenca,279,Zarza de Tajo,248,138,110
16,Cuenca,280,Zarzuela,192,103,89
20,Gipuzkoa,1,Abaltzisketa,327,178,149
20,Gipuzkoa,2,Aduna,472,257,215
20,Gipuzkoa,16,Aia,2083,1112,971
20,Gipuzkoa,3,Aizarnazabal,773,395,378
20,Gipuzkoa,4,Albiztur,320,163,157
20,Gipuzkoa,5,Alegia,1746,896,850
20,Gipuzkoa,6,Alkiza,367,183,184
20,Gipuzkoa,906,Altzaga,170,82,88
20,Gipuzkoa,7,Altzo,427,220,207
20,Gipuzkoa,8,Amezketa,936,510,426
20,Gipuzkoa,9,Andoain,14659,7247,7412
20,Gipuzkoa,10,Anoeta,2061,1065,996
20,Gipuzkoa,11,Antzuola,2151,1081,1070
20,Gipuzkoa,12,Arama,211,107,104
20,Gipuzkoa,13,Aretxabaleta,7015,3512,3503
20,Gipuzkoa,55,Arrasate/Mondragón,21977,10830,11147
20,Gipuzkoa,14,Asteasu,1494,789,705
20,Gipuzkoa,903,Astigarraga,6077,3113,2964
20,Gipuzkoa,15,Ataun,1687,882,805
20,Gipuzkoa,17,Azkoitia,11563,5758,5805
20,Gipuzkoa,18,Azpeitia,14690,7348,7342
20,Gipuzkoa,904,Baliarrain,142,79,63
20,Gipuzkoa,19,Beasain,13854,6951,6903
20,Gipuzkoa,20,Beizama,163,101,62
20,Gipuzkoa,21,Belauntza,243,125,118
20,Gipuzkoa,22,Berastegi,1080,550,530
20,Gipuzkoa,74,Bergara,14691,7272,7419
20,Gipuzkoa,23,Berrobi,581,304,277
20,Gipuzkoa,24,Bidania-Goiatz,508,280,228
20,Gipuzkoa,29,Deba,5502,2741,2761
20,Gipuzkoa,69,Donostia/San Sebastián,186370,87640,98730
20,Gipuzkoa,30,Eibar,27417,13264,14153
20,Gipuzkoa,31,Elduain,238,121,117
20,Gipuzkoa,33,Elgeta,1131,569,562
20,Gipuzkoa,32,Elgoibar,11540,5739,5801
20,Gipuzkoa,67,Errenteria,39439,19126,20313
20,Gipuzkoa,66,Errezil,580,307,273
20,Gipuzkoa,34,Eskoriatza,4089,2060,2029
20,Gipuzkoa,35,Ezkio-Itsaso,609,317,292
20,Gipuzkoa,38,Gabiria,494,263,231
20,Gipuzkoa,37,Gaintza,127,74,53
20,Gipuzkoa,907,Gaztelu,162,90,72
20,Gipuzkoa,39,Getaria,2815,1429,1386
20,Gipuzkoa,40,Hernani,20003,9772,10231
20,Gipuzkoa,41,Hernialde,315,163,152
20,Gipuzkoa,36,Hondarribia,17049,8456,8593
20,Gipuzkoa,42,Ibarra,4191,2090,2101
20,Gipuzkoa,43,Idiazabal,2304,1158,1146
20,Gipuzkoa,44,Ikaztegieta,478,246,232
20,Gipuzkoa,45,Irun,61855,30241,31614
20,Gipuzkoa,46,Irura,1823,944,879
20,Gipuzkoa,47,Itsasondo,642,322,320
20,Gipuzkoa,48,Larraul,249,136,113
20,Gipuzkoa,902,Lasarte-Oria,18166,8844,9322
20,Gipuzkoa,49,Lazkao,5559,2800,2759
20,Gipuzkoa,50,Leaburu,363,191,172
20,Gipuzkoa,51,Legazpi,8438,4286,4152
20,Gipuzkoa,52,Legorreta,1433,723,710
20,Gipuzkoa,68,Leintz-Gatzaga,231,127,104
20,Gipuzkoa,53,Lezo,6025,2974,3051
20,Gipuzkoa,54,Lizartza,597,309,288
20,Gipuzkoa,901,Mendaro,2012,1028,984
20,Gipuzkoa,57,Mutiloa,249,137,112
20,Gipuzkoa,56,Mutriku,5375,2715,2660
20,Gipuzkoa,63,Oiartzun,10199,5040,5159
20,Gipuzkoa,58,Olaberria,949,480,469
20,Gipuzkoa,59,Oñati,11394,5631,5763
20,Gipuzkoa,76,Ordizia,9998,4962,5036
20,Gipuzkoa,905,Orendain,209,111,98
20,Gipuzkoa,60,Orexa,127,70,57
20,Gipuzkoa,61,Orio,5857,2949,2908
20,Gipuzkoa,62,Ormaiztegi,1314,667,647
20,Gipuzkoa,64,Pasaia,16096,7760,8336
20,Gipuzkoa,70,Segura,1455,739,716
20,Gipuzkoa,65,Soraluze-Placencia de las Armas,3901,1974,1927
20,Gipuzkoa,71,Tolosa,19386,9341,10045
20,Gipuzkoa,72,Urnieta,6242,3125,3117
20,Gipuzkoa,77,Urretxu,6786,3353,3433
20,Gipuzkoa,73,Usurbil,6159,3096,3063
20,Gipuzkoa,75,Villabona,5878,2938,2940
20,Gipuzkoa,78,Zaldibia,1578,815,763
20,Gipuzkoa,79,Zarautz,23118,11283,11835
20,Gipuzkoa,25,Zegama,1535,783,752
20,Gipuzkoa,26,Zerain,248,115,133
20,Gipuzkoa,27,Zestoa,3713,1950,1763
20,Gipuzkoa,28,Zizurkil,2975,1493,1482
20,Gipuzkoa,81,Zumaia,9979,4956,5023
20,Gipuzkoa,80,Zumarraga,9848,4839,5009
17,Girona,1,Agullana,831,414,417
17,Girona,2,Aiguaviva,779,395,384
17,Girona,3,Albanyà,141,75,66
17,Girona,4,Albons,769,381,388
17,Girona,6,Alp,1499,775,724
17,Girona,7,Amer,2242,1090,1152
17,Girona,8,Anglès,5479,2713,2766
17,Girona,9,Arbúcies,6427,3307,3120
17,Girona,10,Argelaguer,423,219,204
17,Girona,11,"Armentera, L'",949,480,469
17,Girona,12,Avinyonet de Puigventós,1565,781,784
17,Girona,15,Banyoles,19397,9644,9753
17,Girona,16,Bàscara,989,514,475
17,Girona,13,Begur,3933,1974,1959
17,Girona,18,Bellcaire d'Empordà,668,328,340
17,Girona,19,Besalú,2443,1153,1290
17,Girona,20,Bescanó,4929,2479,2450
17,Girona,21,Beuda,181,101,80
17,Girona,22,"Bisbal d'Empordà, La",10775,5365,5410
17,Girona,234,Biure,230,118,112
17,Girona,23,Blanes,38813,19333,19480
17,Girona,29,Boadella i les Escaules,267,140,127
17,Girona,24,Bolvir,380,199,181
17,Girona,25,Bordils,1693,854,839
17,Girona,26,Borrassà,715,367,348
17,Girona,27,Breda,3740,1844,1896
17,Girona,28,Brunyola,369,185,184
17,Girona,31,Cabanelles,265,150,115
17,Girona,30,Cabanes,903,490,413
17,Girona,32,Cadaqués,2794,1359,1435
17,Girona,33,Caldes de Malavella,7351,3646,3705
17,Girona,34,Calonge,10804,5409,5395
17,Girona,35,Camós,687,343,344
17,Girona,36,Campdevànol,3243,1585,1658
17,Girona,37,Campelles,135,70,65
17,Girona,38,Campllong,525,257,268
17,Girona,39,Camprodon,2214,1091,1123
17,Girona,40,Canet d'Adri,703,358,345
17,Girona,41,Cantallops,322,162,160
17,Girona,42,Capmany,623,316,307
17,Girona,44,Cassà de la Selva,10231,5199,5032
17,Girona,46,Castellfollit de la Roca,951,486,465
17,Girona,47,Castelló d'Empúries,10791,5474,5317
17,Girona,48,Castell-Platja d'Aro,10593,5214,5379
17,Girona,189,"Cellera de Ter, La",2006,1004,1002
17,Girona,49,Celrà,5376,2695,2681
17,Girona,50,Cervià de Ter,923,473,450
17,Girona,51,Cistella,304,152,152
17,Girona,54,Colera,481,242,239
17,Girona,55,Colomers,179,88,91
17,Girona,57,Corçà,1245,633,612
17,Girona,56,Cornellà del Terri,2280,1169,1111
17,Girona,58,Crespià,259,131,128
17,Girona,901,"Cruïlles, Monells i Sant Sadurní de l'Heura",1296,660,636
17,Girona,60,Darnius,564,279,285
17,Girona,61,Das,223,121,102
17,Girona,62,"Escala, L'",10407,5313,5094
17,Girona,63,Espinelves,203,99,104
17,Girona,64,Espolla,423,209,214
17,Girona,65,Esponellà,432,216,216
17,Girona,5,"Far d'Empordà, El",568,286,282
17,Girona,66,Figueres,45961,22733,23228
17,Girona,67,Flaçà,1050,509,541
17,Girona,68,Foixà,313,163,150
17,Girona,69,Fontanals de Cerdanya,448,235,213
17,Girona,70,Fontanilles,138,78,60
17,Girona,71,Fontcoberta,1481,737,744
17,Girona,902,Forallac,1708,848,860
17,Girona,73,Fornells de la Selva,2613,1294,1319
17,Girona,74,Fortià,726,352,374
17,Girona,75,Garrigàs,436,230,206
17,Girona,76,Garrigoles,172,96,76
17,Girona,77,Garriguella,851,418,433
17,Girona,78,Ger,423,219,204
17,Girona,79,Girona,99013,47379,51634
17,Girona,80,Gombrèn,185,95,90
17,Girona,81,Gualta,392,219,173
17,Girona,82,Guils de Cerdanya,525,278,247
17,Girona,83,Hostalric,4106,2060,2046
17,Girona,84,Isòvol,270,152,118
17,Girona,85,Jafre,393,213,180
17,Girona,86,"Jonquera, La",3157,1595,1562
17,Girona,87,Juià,334,186,148
17,Girona,88,Lladó,773,377,396
17,Girona,89,Llagostera,8229,4201,4028
17,Girona,90,Llambilles,716,363,353
17,Girona,91,Llanars,507,272,235
17,Girona,92,Llançà,4796,2361,2435
17,Girona,93,Llers,1211,602,609
17,Girona,94,Llívia,1415,758,657
17,Girona,95,Lloret de Mar,36878,18857,18021
17,Girona,96,"Llosses, Les",210,116,94
17,Girona,102,Maçanet de Cabrenys,706,345,361
17,Girona,103,Maçanet de la Selva,6822,3530,3292
17,Girona,97,Madremanya,284,141,143
17,Girona,98,Maià de Montcal,409,216,193
17,Girona,100,Masarac,279,146,133
17,Girona,101,Massanes,721,392,329
17,Girona,99,Meranges,99,61,38
17,Girona,105,Mieres,318,162,156
17,Girona,106,Mollet de Peralada,186,98,88
17,Girona,107,Molló,342,164,178
17,Girona,109,Montagut i Oix,919,486,433
17,Girona,110,Mont-ras,1725,871,854
17,Girona,111,Navata,1307,646,661
17,Girona,112,Ogassa,228,133,95
17,Girona,114,Olot,34194,16974,17220
17,Girona,115,Ordis,364,194,170
17,Girona,116,Osor,421,217,204
17,Girona,117,Palafrugell,22725,11274,11451
17,Girona,118,Palamós,17743,8651,9092
17,Girona,119,Palau de Santa Eulàlia,96,58,38
17,Girona,121,Palau-sator,285,151,134
17,Girona,120,Palau-saverdera,1456,714,742
17,Girona,123,Palol de Revardit,476,237,239
17,Girona,124,Pals,2469,1246,1223
17,Girona,125,Pardines,160,89,71
17,Girona,126,Parlavà,394,206,188
17,Girona,128,Pau,537,277,260
17,Girona,129,Pedret i Marzà,186,98,88
17,Girona,130,"Pera, La",457,219,238
17,Girona,132,Peralada,1859,920,939
17,Girona,133,"Planes d'Hostoles, Les",1629,828,801
17,Girona,134,Planoles,303,168,135
17,Girona,135,Pont de Molins,531,265,266
17,Girona,136,Pontós,240,133,107
17,Girona,137,Porqueres,4594,2271,2323
17,Girona,140,"Port de la Selva, El",992,508,484
17,Girona,138,Portbou,1107,543,564
17,Girona,139,"Preses, Les",1764,874,890
17,Girona,141,Puigcerdà,8839,4425,4414
17,Girona,142,Quart,3570,1786,1784
17,Girona,43,Queralbs,176,98,78
17,Girona,143,Rabós,175,86,89
17,Girona,144,Regencós,279,143,136
17,Girona,145,Ribes de Freser,1783,887,896
17,Girona,146,Riells i Viabrea,3922,2026,1896
17,Girona,147,Ripoll,10611,5236,5375
17,Girona,148,Riudarenes,2145,1106,1039
17,Girona,149,Riudaura,475,229,246
17,Girona,150,Riudellots de la Selva,2029,1024,1005
17,Girona,151,Riumors,266,133,133
17,Girona,152,Roses,19216,9645,9571
17,Girona,153,Rupià,264,134,130
17,Girona,154,Sales de Llierca,147,76,71
17,Girona,155,Salt,29836,15685,14151
17,Girona,157,Sant Andreu Salou,150,79,71
17,Girona,183,Sant Aniol de Finestres,363,195,168
17,Girona,158,Sant Climent Sescebes,636,372,264
17,Girona,159,Sant Feliu de Buixalleu,825,431,394
17,Girona,160,Sant Feliu de Guíxols,21721,10712,11009
17,Girona,161,Sant Feliu de Pallerols,1342,647,695
17,Girona,162,Sant Ferriol,228,125,103
17,Girona,163,Sant Gregori,3636,1857,1779
17,Girona,164,Sant Hilari Sacalm,5578,2801,2777
17,Girona,165,Sant Jaume de Llierca,852,410,442
17,Girona,167,Sant Joan de les Abadesses,3270,1631,1639
17,Girona,168,Sant Joan de Mollet,498,236,262
17,Girona,185,Sant Joan les Fonts,2931,1478,1453
17,Girona,166,Sant Jordi Desvalls,732,357,375
17,Girona,169,Sant Julià de Ramis,3447,1750,1697
17,Girona,903,Sant Julià del Llor i Bonmatí,1321,683,638
17,Girona,171,Sant Llorenç de la Muga,251,133,118
17,Girona,172,Sant Martí de Llémena,612,314,298
17,Girona,173,Sant Martí Vell,245,126,119
17,Girona,174,Sant Miquel de Campmajor,226,119,107
17,Girona,175,Sant Miquel de Fluvià,746,390,356
17,Girona,176,Sant Mori,175,94,81
17,Girona,177,Sant Pau de Segúries,672,330,342
17,Girona,178,Sant Pere Pescador,2040,1102,938
17,Girona,180,Santa Coloma de Farners,12854,6461,6393
17,Girona,181,Santa Cristina d'Aro,5194,2600,2594
17,Girona,182,Santa Llogaia d'Àlguema,353,184,169
17,Girona,184,Santa Pau,1549,777,772
17,Girona,186,Sarrià de Ter,5052,2484,2568
17,Girona,187,"Saus, Camallera i Llampaies",839,415,424
17,Girona,188,"Selva de Mar, La",191,109,82
17,Girona,190,Serinyà,1117,577,540
17,Girona,191,Serra de Daró,206,113,93
17,Girona,192,Setcases,182,97,85
17,Girona,193,Sils,5910,2996,2914
17,Girona,52,Siurana,159,74,85
17,Girona,194,Susqueda,98,56,42
17,Girona,195,"Tallada d'Empordà, La",450,234,216
17,Girona,196,Terrades,306,149,157
17,Girona,197,Torrent,161,90,71
17,Girona,198,Torroella de Fluvià,688,367,321
17,Girona,199,Torroella de Montgrí,11516,5842,5674
17,Girona,200,Tortellà,783,380,403
17,Girona,201,Toses,168,99,69
17,Girona,202,Tossa de Mar,5542,2792,2750
17,Girona,204,Ullà,1138,626,512
17,Girona,205,Ullastret,295,148,147
17,Girona,203,Ultramort,216,121,95
17,Girona,206,Urús,173,81,92
17,Girona,14,"Vajol, La",85,47,38
17,Girona,208,"Vall de Bianya, La",1265,633,632
17,Girona,207,"Vall d'en Bas, La",3018,1519,1499
17,Girona,170,Vallfogona de Ripollès,204,112,92
17,Girona,209,Vall-llobrega,924,464,460
17,Girona,210,Ventalló,793,397,396
17,Girona,211,Verges,1159,558,601
17,Girona,212,Vidrà,177,89,88
17,Girona,213,Vidreres,7652,3949,3703
17,Girona,214,Vilabertran,919,468,451
17,Girona,215,Vilablareix,2691,1328,1363
17,Girona,217,Viladamat,468,241,227
17,Girona,216,Viladasens,216,112,104
17,Girona,218,Vilademuls,789,415,374
17,Girona,220,Viladrau,1038,517,521
17,Girona,221,Vilafant,5465,2700,2765
17,Girona,223,Vilajuïga,1123,561,562
17,Girona,224,Vilallonga de Ter,406,213,193
17,Girona,225,Vilamacolum,325,168,157
17,Girona,226,Vilamalla,1146,579,567
17,Girona,227,Vilamaniscle,199,108,91
17,Girona,228,Vilanant,401,201,200
17,Girona,230,Vila-sacra,706,345,361
17,Girona,222,Vilaür,145,74,71
17,Girona,233,Vilobí d'Onyar,3138,1635,1503
17,Girona,232,Vilopriu,207,110,97
18,Granada,1,Agrón,290,146,144
18,Granada,2,Alamedilla,606,310,296
18,Granada,3,Albolote,18660,9288,9372
18,Granada,4,Albondón,745,411,334
18,Granada,5,Albuñán,418,219,199
18,Granada,6,Albuñol,6998,3742,3256
18,Granada,7,Albuñuelas,836,419,417
18,Granada,10,Aldeire,635,338,297
18,Granada,11,Alfacar,5440,2777,2663
18,Granada,12,Algarinejo,2677,1374,1303
18,Granada,13,Alhama de Granada,5981,3185,2796
18,Granada,14,Alhendín,8928,4503,4425
18,Granada,15,Alicún de Ortega,495,248,247
18,Granada,16,Almegíjar,362,199,163
18,Granada,17,Almuñécar,27135,13452,13683
18,Granada,904,Alpujarra de la Sierra,1021,570,451
18,Granada,18,Alquife,665,330,335
18,Granada,20,Arenas del Rey,1179,597,582
18,Granada,21,Armilla,24028,12029,11999
18,Granada,22,Atarfe,18392,9189,9203
18,Granada,23,Baza,20642,10257,10385
18,Granada,24,Beas de Granada,1000,532,468
18,Granada,25,Beas de Guadix,345,172,173
18,Granada,27,Benalúa,3286,1637,1649
18,Granada,28,Benalúa de las Villas,1083,570,513
18,Granada,29,Benamaurel,2337,1177,1160
18,Granada,30,Bérchules,715,385,330
18,Granada,32,Bubión,301,151,150
18,Granada,33,Busquístar,278,145,133
18,Granada,34,Cacín,587,299,288
18,Granada,35,Cádiar,1486,785,701
18,Granada,36,Cájar,5054,2440,2614
18,Granada,114,"Calahorra, La",673,337,336
18,Granada,37,Calicasas,619,309,310
18,Granada,38,Campotéjar,1271,652,619
18,Granada,39,Caniles,4179,2134,2045
18,Granada,40,Cáñar,348,196,152
18,Granada,42,Capileira,559,285,274
18,Granada,43,Carataunas,179,99,80
18,Granada,44,Cástaras,244,149,95
18,Granada,45,Castilléjar,1344,698,646
18,Granada,46,Castril,2193,1120,1073
18,Granada,47,Cenes de la Vega,7897,3971,3926
18,Granada,59,Chauchina,5490,2715,2775
18,Granada,61,Chimeneas,1326,702,624
18,Granada,62,Churriana de la Vega,14556,7233,7323
18,Granada,48,Cijuela,3228,1633,1595
18,Granada,49,Cogollos de Guadix,659,366,293
18,Granada,50,Cogollos de la Vega,2089,1041,1048
18,Granada,51,Colomera,1376,717,659
18,Granada,53,Cortes de Baza,1940,976,964
18,Granada,54,Cortes y Graena,994,517,477
18,Granada,912,Cuevas del Campo,1821,914,907
18,Granada,56,Cúllar,4276,2151,2125
18,Granada,57,Cúllar Vega,7330,3689,3641
18,Granada,63,Darro,1571,795,776
18,Granada,64,Dehesas de Guadix,419,213,206
18,Granada,65,Dehesas Viejas,728,369,359
18,Granada,66,Deifontes,2618,1320,1298
18,Granada,67,Diezma,775,396,379
18,Granada,68,Dílar,1959,997,962
18,Granada,69,Dólar,638,338,300
18,Granada,915,Domingo Pérez de Granada,899,470,429
18,Granada,70,Dúdar,323,172,151
18,Granada,71,Dúrcal,7028,3464,3564
18,Granada,72,Escúzar,772,394,378
18,Granada,74,Ferreira,305,158,147
18,Granada,76,Fonelas,996,523,473
18,Granada,78,Freila,890,456,434
18,Granada,79,Fuente Vaqueros,4388,2205,2183
18,Granada,905,"Gabias, Las",20329,10389,9940
18,Granada,82,Galera,1104,554,550
18,Granada,83,Gobernador,246,114,132
18,Granada,84,Gójar,5606,2855,2751
18,Granada,85,Gor,746,385,361
18,Granada,86,Gorafe,390,199,191
18,Granada,87,Granada,232770,107844,124926
18,Granada,88,Guadahortuna,1932,997,935
18,Granada,89,Guadix,18799,9285,9514
18,Granada,906,"Guájares, Los",1037,550,487
18,Granada,93,Gualchos,5051,2636,2415
18,Granada,94,Güéjar Sierra,2878,1527,1351
18,Granada,95,Güevéjar,2551,1342,1209
18,Granada,96,Huélago,395,204,191
18,Granada,97,Huéneja,1156,609,547
18,Granada,98,Huéscar,7498,3701,3797
18,Granada,99,Huétor de Santillán,1889,966,923
18,Granada,100,Huétor Tájar,10236,5159,5077
18,Granada,101,Huétor Vega,11904,5986,5918
18,Granada,102,Íllora,10233,5104,5129
18,Granada,103,Ítrabo,1009,508,501
18,Granada,105,Iznalloz,5033,2569,2464
18,Granada,106,Játar,633,349,284
18,Granada,107,Jayena,1101,563,538
18,Granada,108,Jerez del Marquesado,1002,528,474
18,Granada,109,Jete,890,463,427
18,Granada,111,Jun,3681,1869,1812
18,Granada,112,Juviles,144,68,76
18,Granada,115,Láchar,3270,1675,1595
18,Granada,116,Lanjarón,3503,1737,1766
18,Granada,117,Lanteira,559,292,267
18,Granada,119,Lecrín,2089,1062,1027
18,Granada,120,Lentegí,322,167,155
18,Granada,121,Lobras,148,79,69
18,Granada,122,Loja,20469,10205,10264
18,Granada,123,Lugros,334,180,154
18,Granada,124,Lújar,454,244,210
18,Granada,126,"Malahá, La",1856,927,929
18,Granada,127,Maracena,22071,10888,11183
18,Granada,128,Marchal,417,199,218
18,Granada,132,Moclín,3820,1908,1912
18,Granada,133,Molvízar,2796,1433,1363
18,Granada,134,Monachil,7715,3982,3733
18,Granada,135,Montefrío,5472,2749,2723
18,Granada,136,Montejícar,2183,1119,1064
18,Granada,137,Montillana,1207,630,577
18,Granada,138,Moraleda de Zafayona,3176,1609,1567
18,Granada,909,Morelábor,650,352,298
18,Granada,140,Motril,60420,29763,30657
18,Granada,141,Murtas,473,265,208
18,Granada,903,Nevada,1089,560,529
18,Granada,143,Nigüelas,1195,608,587
18,Granada,144,Nívar,971,506,465
18,Granada,145,Ogíjares,13848,6852,6996
18,Granada,146,Orce,1205,615,590
18,Granada,147,Órgiva,5570,2803,2767
18,Granada,148,Otívar,1043,527,516
18,Granada,150,Padul,8454,4261,4193
18,Granada,151,Pampaneira,324,160,164
18,Granada,152,Pedro Martínez,1166,573,593
18,Granada,153,Peligros,11191,5548,5643
18,Granada,154,"Peza, La",1214,624,590
18,Granada,910,"Pinar, El",933,485,448
18,Granada,157,Pinos Genil,1422,748,674
18,Granada,158,Pinos Puente,10314,5166,5148
18,Granada,159,Píñar,1139,615,524
18,Granada,161,Polícar,228,121,107
18,Granada,162,Polopos,1650,882,768
18,Granada,163,Pórtugos,403,208,195
18,Granada,164,Puebla de Don Fadrique,2308,1188,1120
18,Granada,165,Pulianas,5364,2673,2691
18,Granada,167,Purullena,2329,1176,1153
18,Granada,168,Quéntar,928,473,455
18,Granada,170,Rubite,382,214,168
18,Granada,171,Salar,2667,1351,1316
18,Granada,173,Salobreña,12402,6209,6193
18,Granada,174,Santa Cruz del Comercio,549,286,263
18,Granada,175,Santa Fe,14960,7352,7608
18,Granada,176,Soportújar,266,147,119
18,Granada,177,Sorvilán,550,294,256
18,Granada,901,"Taha, La",653,336,317
18,Granada,178,Torre-Cardela,782,407,375
18,Granada,179,Torvizcón,650,339,311
18,Granada,180,Trevélez,758,390,368
18,Granada,181,Turón,253,151,102
18,Granada,182,Ugíjar,2511,1234,1277
18,Granada,914,Valderrubio,2083,1021,1062
18,Granada,907,Valle del Zalabí,2146,1101,1045
18,Granada,902,"Valle, El",938,466,472
18,Granada,183,Válor,676,346,330
18,Granada,911,Vegas del Genil,10808,5514,5294
18,Granada,184,Vélez de Benaudalla,2885,1438,1447
18,Granada,185,Ventas de Huelma,620,331,289
18,Granada,149,Villa de Otura,6832,3454,3378
18,Granada,908,Villamena,967,484,483
18,Granada,187,Villanueva de las Torres,633,332,301
18,Granada,188,Villanueva Mesía,2013,992,1021
18,Granada,189,Víznar,978,504,474
18,Granada,192,Zafarraya,2052,1083,969
18,Granada,913,Zagra,866,440,426
18,Granada,193,"Zubia, La",19006,9348,9658
18,Granada,194,Zújar,2612,1347,1265
19,Guadalajara,1,Abánades,55,30,25
19,Guadalajara,2,Ablanque,62,36,26
19,Guadalajara,3,Adobes,38,21,17
19,Guadalajara,4,Alaminos,67,30,37
19,Guadalajara,5,Alarilla,122,77,45
19,Guadalajara,6,Albalate de Zorita,930,525,405
19,Guadalajara,7,Albares,549,283,266
19,Guadalajara,8,Albendiego,43,28,15
19,Guadalajara,9,Alcocer,332,172,160
19,Guadalajara,10,Alcolea de las Peñas,12,8,4
19,Guadalajara,11,Alcolea del Pinar,328,180,148
19,Guadalajara,13,Alcoroches,130,79,51
19,Guadalajara,15,Aldeanueva de Guadalajara,81,47,34
19,Guadalajara,16,Algar de Mesa,59,40,19
19,Guadalajara,17,Algora,79,49,30
19,Guadalajara,18,Alhóndiga,165,94,71
19,Guadalajara,19,Alique,18,9,9
19,Guadalajara,20,Almadrones,60,38,22
19,Guadalajara,21,Almoguera,1340,706,634
19,Guadalajara,22,Almonacid de Zorita,730,351,379
19,Guadalajara,23,Alocén,187,93,94
19,Guadalajara,24,Alovera,12478,6324,6154
19,Guadalajara,27,Alustante,147,83,64
19,Guadalajara,31,Angón,13,10,3
19,Guadalajara,32,Anguita,176,91,85
19,Guadalajara,33,Anquela del Ducado,61,34,27
19,Guadalajara,34,Anquela del Pedregal,21,15,6
19,Guadalajara,36,Aranzueque,414,211,203
19,Guadalajara,37,Arbancón,158,90,68
19,Guadalajara,38,Arbeteta,25,18,7
19,Guadalajara,39,Argecilla,65,44,21
19,Guadalajara,40,Armallones,49,30,19
19,Guadalajara,41,Armuña de Tajuña,234,127,107
19,Guadalajara,42,Arroyo de las Fraguas,24,14,10
19,Guadalajara,43,Atanzón,90,57,33
19,Guadalajara,44,Atienza,452,256,196
19,Guadalajara,45,Auñón,150,84,66
19,Guadalajara,46,Azuqueca de Henares,34768,17606,17162
19,Guadalajara,47,Baides,61,31,30
19,Guadalajara,48,Baños de Tajo,16,13,3
19,Guadalajara,49,Bañuelos,16,14,2
19,Guadalajara,50,Barriopedro,17,12,5
19,Guadalajara,51,Berninches,56,35,21
19,Guadalajara,52,"Bodera, La",24,15,9
19,Guadalajara,53,Brihuega,2465,1286,1179
19,Guadalajara,54,Budia,214,123,91
19,Guadalajara,55,Bujalaro,50,27,23
19,Guadalajara,57,Bustares,81,49,32
19,Guadalajara,58,Cabanillas del Campo,9947,5052,4895
19,Guadalajara,59,Campillo de Dueñas,81,47,34
19,Guadalajara,60,Campillo de Ranas,157,103,54
19,Guadalajara,61,Campisábalos,65,47,18
19,Guadalajara,64,Canredondo,75,44,31
19,Guadalajara,65,Cantalojas,153,96,57
19,Guadalajara,66,Cañizar,60,33,27
19,Guadalajara,67,"Cardoso de la Sierra, El",66,42,24
19,Guadalajara,70,Casa de Uceda,95,50,45
19,Guadalajara,71,"Casar, El",11792,6020,5772
19,Guadalajara,73,Casas de San Galindo,21,16,5
19,Guadalajara,74,Caspueñas,88,50,38
19,Guadalajara,75,Castejón de Henares,62,39,23
19,Guadalajara,76,Castellar de la Muela,30,16,14
19,Guadalajara,78,Castilforte,56,37,19
19,Guadalajara,79,Castilnuevo,9,5,4
19,Guadalajara,80,Cendejas de Enmedio,74,39,35
19,Guadalajara,81,Cendejas de la Torre,26,15,11
19,Guadalajara,82,Centenera,110,63,47
19,Guadalajara,103,Checa,279,163,116
19,Guadalajara,104,Chequilla,17,10,7
19,Guadalajara,106,Chillarón del Rey,93,54,39
19,Guadalajara,105,Chiloeches,3424,1776,1648
19,Guadalajara,86,Cifuentes,1749,914,835
19,Guadalajara,87,Cincovillas,22,11,11
19,Guadalajara,88,Ciruelas,91,51,40
19,Guadalajara,89,Ciruelos del Pinar,30,18,12
19,Guadalajara,90,Cobeta,110,56,54
19,Guadalajara,91,Cogollor,29,17,12
19,Guadalajara,92,Cogolludo,581,342,239
19,Guadalajara,95,Condemios de Abajo,15,10,5
19,Guadalajara,96,Condemios de Arriba,116,64,52
19,Guadalajara,97,Congostrina,18,14,4
19,Guadalajara,98,Copernal,26,18,8
19,Guadalajara,99,Corduente,353,196,157
19,Guadalajara,102,"Cubillo de Uceda, El",125,65,60
19,Guadalajara,107,Driebes,335,177,158
19,Guadalajara,108,Durón,114,58,56
19,Guadalajara,109,Embid,39,21,18
19,Guadalajara,110,Escamilla,58,29,29
19,Guadalajara,111,Escariche,175,105,70
19,Guadalajara,112,Escopete,53,22,31
19,Guadalajara,113,Espinosa de Henares,684,350,334
19,Guadalajara,114,Esplegares,42,27,15
19,Guadalajara,115,Establés,30,17,13
19,Guadalajara,116,Estriégana,17,11,6
19,Guadalajara,117,Fontanar,2347,1229,1118
19,Guadalajara,118,Fuembellida,8,5,3
19,Guadalajara,119,Fuencemillán,98,58,40
19,Guadalajara,120,Fuentelahiguera de Albatages,128,72,56
19,Guadalajara,121,Fuentelencina,295,165,130
19,Guadalajara,122,Fuentelsaz,95,52,43
19,Guadalajara,123,Fuentelviejo,52,26,26
19,Guadalajara,124,Fuentenovilla,532,291,241
19,Guadalajara,125,Gajanejos,41,27,14
19,Guadalajara,126,Galápagos,2408,1280,1128
19,Guadalajara,127,Galve de Sorbe,97,54,43
19,Guadalajara,129,Gascueña de Bornova,32,18,14
19,Guadalajara,130,Guadalajara,84145,40435,43710
19,Guadalajara,132,Henche,100,52,48
19,Guadalajara,133,Heras de Ayuso,241,143,98
19,Guadalajara,134,Herrería,21,13,8
19,Guadalajara,135,Hiendelaencina,117,66,51
19,Guadalajara,136,Hijes,19,11,8
19,Guadalajara,138,Hita,329,184,145
19,Guadalajara,139,Hombrados,33,19,14
19,Guadalajara,142,Hontoba,308,180,128
19,Guadalajara,143,Horche,2542,1291,1251
19,Guadalajara,145,Hortezuela de Océn,48,29,19
19,Guadalajara,146,"Huerce, La",43,26,17
19,Guadalajara,147,Huérmeces del Cerro,42,28,14
19,Guadalajara,148,Huertahernando,55,35,20
19,Guadalajara,150,Hueva,142,87,55
19,Guadalajara,151,Humanes,1462,720,742
19,Guadalajara,152,Illana,660,373,287
19,Guadalajara,153,Iniéstola,22,13,9
19,Guadalajara,154,"Inviernas, Las",70,47,23
19,Guadalajara,155,Irueste,74,47,27
19,Guadalajara,156,Jadraque,1459,759,700
19,Guadalajara,157,Jirueque,57,38,19
19,Guadalajara,159,Ledanca,104,53,51
19,Guadalajara,160,Loranca de Tajuña,1227,675,552
19,Guadalajara,161,Lupiana,248,126,122
19,Guadalajara,162,Luzaga,67,38,29
19,Guadalajara,163,Luzón,63,33,30
19,Guadalajara,165,Majaelrayo,57,32,25
19,Guadalajara,166,Málaga del Fresno,175,98,77
19,Guadalajara,167,Malaguilla,146,82,64
19,Guadalajara,168,Mandayona,314,163,151
19,Guadalajara,169,Mantiel,41,24,17
19,Guadalajara,170,Maranchón,240,131,109
19,Guadalajara,171,Marchamalo,7073,3558,3515
19,Guadalajara,172,Masegoso de Tajuña,57,33,24
19,Guadalajara,173,Matarrubia,48,32,16
19,Guadalajara,174,Matillas,122,61,61
19,Guadalajara,175,Mazarete,38,17,21
19,Guadalajara,176,Mazuecos,271,141,130
19,Guadalajara,177,Medranda,80,40,40
19,Guadalajara,178,Megina,32,21,11
19,Guadalajara,179,Membrillera,91,51,40
19,Guadalajara,181,Miedes de Atienza,61,35,26
19,Guadalajara,182,"Mierla, La",40,27,13
19,Guadalajara,184,Millana,110,65,45
19,Guadalajara,183,Milmarcos,80,46,34
19,Guadalajara,185,"Miñosa, La",31,21,10
19,Guadalajara,186,Mirabueno,86,49,37
19,Guadalajara,187,Miralrío,57,34,23
19,Guadalajara,188,Mochales,50,29,21
19,Guadalajara,189,Mohernando,169,92,77
19,Guadalajara,190,Molina de Aragón,3365,1689,1676
19,Guadalajara,191,Monasterio,15,5,10
19,Guadalajara,192,Mondéjar,2627,1353,1274
19,Guadalajara,193,Montarrón,25,14,11
19,Guadalajara,194,Moratilla de los Meleros,103,60,43
19,Guadalajara,195,Morenilla,41,24,17
19,Guadalajara,196,Muduex,107,57,50
19,Guadalajara,197,"Navas de Jadraque, Las",30,19,11
19,Guadalajara,198,Negredo,13,6,7
19,Guadalajara,199,Ocentejo,19,14,5
19,Guadalajara,200,"Olivar, El",78,44,34
19,Guadalajara,201,Olmeda de Cobeta,63,34,29
19,Guadalajara,202,"Olmeda de Jadraque, La",7,3,4
19,Guadalajara,203,"Ordial, El",29,17,12
19,Guadalajara,204,Orea,184,109,75
19,Guadalajara,208,Pálmaces de Jadraque,40,24,16
19,Guadalajara,209,Pardos,42,24,18
19,Guadalajara,210,Paredes de Sigüenza,20,10,10
19,Guadalajara,211,Pareja,419,240,179
19,Guadalajara,212,Pastrana,885,447,438
19,Guadalajara,213,"Pedregal, El",78,47,31
19,Guadalajara,214,Peñalén,74,43,31
19,Guadalajara,215,Peñalver,168,108,60
19,Guadalajara,216,Peralejos de las Truchas,151,81,70
19,Guadalajara,217,Peralveche,55,37,18
19,Guadalajara,218,Pinilla de Jadraque,53,29,24
19,Guadalajara,219,Pinilla de Molina,13,10,3
19,Guadalajara,220,Pioz,3602,1903,1699
19,Guadalajara,221,Piqueras,58,36,22
19,Guadalajara,222,"Pobo de Dueñas, El",120,60,60
19,Guadalajara,223,Poveda de la Sierra,126,66,60
19,Guadalajara,224,Pozo de Almoguera,98,56,42
19,Guadalajara,225,Pozo de Guadalajara,1260,668,592
19,Guadalajara,226,Prádena de Atienza,44,30,14
19,Guadalajara,227,Prados Redondos,67,42,25
19,Guadalajara,228,Puebla de Beleña,46,25,21
19,Guadalajara,229,Puebla de Valles,64,36,28
19,Guadalajara,230,Quer,756,399,357
19,Guadalajara,231,Rebollosa de Jadraque,12,8,4
19,Guadalajara,232,"Recuenco, El",65,42,23
19,Guadalajara,233,Renera,91,51,40
19,Guadalajara,234,Retiendas,44,28,16
19,Guadalajara,235,Riba de Saelices,100,57,43
19,Guadalajara,237,Rillo de Gallo,46,26,20
19,Guadalajara,238,Riofrío del Llano,46,28,18
19,Guadalajara,239,Robledillo de Mohernando,109,53,56
19,Guadalajara,240,Robledo de Corpes,47,28,19
19,Guadalajara,241,Romanillos de Atienza,43,28,15
19,Guadalajara,242,Romanones,108,58,50
19,Guadalajara,243,Rueda de la Sierra,48,32,16
19,Guadalajara,244,Sacecorbo,93,52,41
19,Guadalajara,245,Sacedón,1542,813,729
19,Guadalajara,246,Saelices de la Sal,48,26,22
19,Guadalajara,247,Salmerón,159,88,71
19,Guadalajara,248,San Andrés del Congosto,75,47,28
19,Guadalajara,249,San Andrés del Rey,32,16,16
19,Guadalajara,250,Santiuste,22,13,9
19,Guadalajara,251,Saúca,56,31,25
19,Guadalajara,252,Sayatón,83,50,33
19,Guadalajara,254,Selas,52,24,28
19,Guadalajara,901,Semillas,43,26,17
19,Guadalajara,255,Setiles,83,50,33
19,Guadalajara,256,Sienes,56,33,23
19,Guadalajara,257,Sigüenza,4496,2237,2259
19,Guadalajara,258,Solanillos del Extremo,92,54,38
19,Guadalajara,259,Somolinos,38,17,21
19,Guadalajara,260,"Sotillo, El",46,25,21
19,Guadalajara,261,Sotodosos,36,18,18
19,Guadalajara,262,Tamajón,124,67,57
19,Guadalajara,263,Taragudo,48,24,24
19,Guadalajara,264,Taravilla,35,23,12
19,Guadalajara,265,Tartanedo,142,86,56
19,Guadalajara,266,Tendilla,329,180,149
19,Guadalajara,267,Terzaga,23,13,10
19,Guadalajara,268,Tierzo,34,23,11
19,Guadalajara,269,"Toba, La",103,57,46
19,Guadalajara,271,Tordellego,55,31,24
19,Guadalajara,270,Tordelrábano,14,10,4
19,Guadalajara,272,Tordesilos,105,60,45
19,Guadalajara,274,Torija,1380,715,665
19,Guadalajara,279,Torre del Burgo,367,203,164
19,Guadalajara,277,Torrecuadrada de Molina,20,13,7
19,Guadalajara,278,Torrecuadradilla,25,15,10
19,Guadalajara,280,Torrejón del Rey,5160,2681,2479
19,Guadalajara,281,Torremocha de Jadraque,23,15,8
19,Guadalajara,282,Torremocha del Campo,198,112,86
19,Guadalajara,283,Torremocha del Pinar,39,17,22
19,Guadalajara,284,Torremochuela,11,7,4
19,Guadalajara,285,Torrubia,22,12,10
19,Guadalajara,286,Tórtola de Henares,997,546,451
19,Guadalajara,287,Tortuera,203,110,93
19,Guadalajara,288,Tortuero,17,11,6
19,Guadalajara,289,Traíd,26,17,9
19,Guadalajara,290,Trijueque,1148,611,537
19,Guadalajara,291,Trillo,1355,711,644
19,Guadalajara,293,Uceda,2574,1333,1241
19,Guadalajara,294,Ujados,34,20,14
19,Guadalajara,296,Utande,35,24,11
19,Guadalajara,297,Valdarachas,37,19,18
19,Guadalajara,298,Valdearenas,86,55,31
19,Guadalajara,299,Valdeavellano,107,56,51
19,Guadalajara,300,Valdeaveruelo,1077,553,524
19,Guadalajara,301,Valdeconcha,40,22,18
19,Guadalajara,302,Valdegrudas,61,38,23
19,Guadalajara,303,Valdelcubo,52,33,19
19,Guadalajara,304,Valdenuño Fernández,263,148,115
19,Guadalajara,305,Valdepeñas de la Sierra,175,102,73
19,Guadalajara,306,Valderrebollo,22,12,10
19,Guadalajara,307,Valdesotos,26,17,9
19,Guadalajara,308,Valfermoso de Tajuña,54,36,18
19,Guadalajara,309,Valhermoso,29,15,14
19,Guadalajara,310,Valtablado del Río,9,6,3
19,Guadalajara,311,Valverde de los Arroyos,85,46,39
19,Guadalajara,314,Viana de Jadraque,52,34,18
19,Guadalajara,317,Villanueva de Alcorón,172,92,80
19,Guadalajara,318,Villanueva de Argecilla,30,19,11
19,Guadalajara,319,Villanueva de la Torre,6561,3310,3251
19,Guadalajara,321,Villares de Jadraque,52,33,19
19,Guadalajara,322,Villaseca de Henares,29,15,14
19,Guadalajara,323,Villaseca de Uceda,41,22,19
19,Guadalajara,324,Villel de Mesa,193,106,87
19,Guadalajara,325,Viñuelas,140,72,68
19,Guadalajara,326,Yebes,3076,1603,1473
19,Guadalajara,327,Yebra,474,246,228
19,Guadalajara,329,Yélamos de Abajo,64,34,30
19,Guadalajara,330,Yélamos de Arriba,83,51,32
19,Guadalajara,331,Yunquera de Henares,3875,1987,1888
19,Guadalajara,332,"Yunta, La",98,53,45
19,Guadalajara,333,Zaorejas,133,90,43
19,Guadalajara,334,Zarzuela de Jadraque,39,22,17
19,Guadalajara,335,Zorita de los Canes,69,34,35
21,Huelva,1,Alájar,777,399,378
21,Huelva,2,Aljaraque,20836,10354,10482
21,Huelva,3,"Almendro, El",839,441,398
21,Huelva,4,Almonaster la Real,1848,978,870
21,Huelva,5,Almonte,23272,11613,11659
21,Huelva,6,Alosno,3954,1934,2020
21,Huelva,7,Aracena,8048,3970,4078
21,Huelva,8,Aroche,3131,1573,1558
21,Huelva,9,Arroyomolinos de León,981,514,467
21,Huelva,10,Ayamonte,20714,10369,10345
21,Huelva,11,Beas,4238,2130,2108
21,Huelva,12,Berrocal,330,169,161
21,Huelva,13,Bollullos Par del Condado,14095,7030,7065
21,Huelva,14,Bonares,6025,3004,3021
21,Huelva,15,Cabezas Rubias,734,385,349
21,Huelva,16,Cala,1202,609,593
21,Huelva,17,Calañas,4099,2093,2006
21,Huelva,18,"Campillo, El",2043,995,1048
21,Huelva,19,Campofrío,683,345,338
21,Huelva,20,Cañaveral de León,420,210,210
21,Huelva,21,Cartaya,19193,9860,9333
21,Huelva,22,Castaño del Robledo,209,123,86
21,Huelva,23,"Cerro de Andévalo, El",2409,1206,1203
21,Huelva,30,Chucena,2256,1146,1110
21,Huelva,24,Corteconcepción,548,272,276
21,Huelva,25,Cortegana,4812,2440,2372
21,Huelva,26,Cortelazor,304,150,154
21,Huelva,27,Cumbres de Enmedio,52,31,21
21,Huelva,28,Cumbres de San Bartolomé,388,189,199
21,Huelva,29,Cumbres Mayores,1795,889,906
21,Huelva,31,Encinasola,1334,673,661
21,Huelva,32,Escacena del Campo,2254,1107,1147
21,Huelva,33,Fuenteheridos,646,324,322
21,Huelva,34,Galaroza,1409,689,720
21,Huelva,35,Gibraleón,12570,6251,6319
21,Huelva,36,"Granada de Río-Tinto, La",234,123,111
21,Huelva,37,"Granado, El",521,277,244
21,Huelva,38,Higuera de la Sierra,1293,664,629
21,Huelva,39,Hinojales,310,152,158
21,Huelva,40,Hinojos,3891,1955,1936
21,Huelva,41,Huelva,145115,69800,75315
21,Huelva,42,Isla Cristina,21175,10570,10605
21,Huelva,43,Jabugo,2258,1128,1130
21,Huelva,44,Lepe,26931,13947,12984
21,Huelva,45,Linares de la Sierra,267,133,134
21,Huelva,46,Lucena del Puerto,3200,1662,1538
21,Huelva,47,Manzanilla,2076,1057,1019
21,Huelva,48,"Marines, Los",393,213,180
21,Huelva,49,Minas de Riotinto,3924,1904,2020
21,Huelva,50,Moguer,21514,10809,10705
21,Huelva,51,"Nava, La",266,134,132
21,Huelva,52,Nerva,5418,2621,2797
21,Huelva,53,Niebla,4091,2077,2014
21,Huelva,54,"Palma del Condado, La",10690,5320,5370
21,Huelva,55,Palos de la Frontera,10885,5475,5410
21,Huelva,56,Paterna del Campo,3499,1767,1732
21,Huelva,57,Paymogo,1195,605,590
21,Huelva,58,Puebla de Guzmán,3148,1617,1531
21,Huelva,59,Puerto Moral,274,135,139
21,Huelva,60,Punta Umbría,15038,7649,7389
21,Huelva,61,Rociana del Condado,7714,3890,3824
21,Huelva,62,Rosal de la Frontera,1702,844,858
21,Huelva,63,San Bartolomé de la Torre,3640,1810,1830
21,Huelva,64,San Juan del Puerto,9116,4583,4533
21,Huelva,66,San Silvestre de Guzmán,611,324,287
21,Huelva,65,Sanlúcar de Guadiana,419,210,209
21,Huelva,67,Santa Ana la Real,491,233,258
21,Huelva,68,Santa Bárbara de Casa,1092,533,559
21,Huelva,69,Santa Olalla del Cala,2003,1037,966
21,Huelva,70,Trigueros,7708,3817,3891
21,Huelva,71,Valdelarco,238,110,128
21,Huelva,72,Valverde del Camino,12839,6306,6533
21,Huelva,73,Villablanca,2781,1380,1401
21,Huelva,74,Villalba del Alcor,3279,1624,1655
21,Huelva,75,Villanueva de las Cruces,386,185,201
21,Huelva,76,Villanueva de los Castillejos,2747,1375,1372
21,Huelva,77,Villarrasa,2172,1105,1067
21,Huelva,78,Zalamea la Real,3093,1559,1534
21,Huelva,79,Zufre,845,429,416
22,Huesca,1,Abiego,246,127,119
22,Huesca,2,Abizanda,156,82,74
22,Huesca,3,Adahuesca,172,89,83
22,Huesca,4,Agüero,139,82,57
22,Huesca,907,Aínsa-Sobrarbe,2128,1088,1040
22,Huesca,6,Aisa,331,180,151
22,Huesca,7,Albalate de Cinca,1120,590,530
22,Huesca,8,Albalatillo,187,104,83
22,Huesca,9,Albelda,728,376,352
22,Huesca,11,Albero Alto,114,69,45
22,Huesca,12,Albero Bajo,138,75,63
22,Huesca,13,Alberuela de Tubo,310,158,152
22,Huesca,14,Alcalá de Gurrea,267,141,126
22,Huesca,15,Alcalá del Obispo,332,181,151
22,Huesca,16,Alcampell,671,335,336
22,Huesca,17,Alcolea de Cinca,1104,584,520
22,Huesca,18,Alcubierre,377,201,176
22,Huesca,19,Alerre,200,103,97
22,Huesca,20,Alfántega,135,69,66
22,Huesca,21,Almudévar,2444,1246,1198
22,Huesca,22,Almunia de San Juan,665,349,316
22,Huesca,23,Almuniente,486,242,244
22,Huesca,24,Alquézar,304,162,142
22,Huesca,25,Altorricón,1420,760,660
22,Huesca,27,Angüés,360,187,173
22,Huesca,28,Ansó,411,206,205
22,Huesca,29,Antillón,154,79,75
22,Huesca,32,Aragüés del Puerto,114,60,54
22,Huesca,35,Arén,320,176,144
22,Huesca,36,Argavieso,100,59,41
22,Huesca,37,Arguis,122,67,55
22,Huesca,39,Ayerbe,1071,528,543
22,Huesca,40,Azanuy-Alins,173,85,88
22,Huesca,41,Azara,180,92,88
22,Huesca,42,Azlor,143,66,77
22,Huesca,43,Baélls,103,59,44
22,Huesca,44,Bailo,284,171,113
22,Huesca,45,Baldellou,82,46,36
22,Huesca,46,Ballobar,830,421,409
22,Huesca,47,Banastás,295,158,137
22,Huesca,48,Barbastro,16907,8200,8707
22,Huesca,49,Barbués,81,46,35
22,Huesca,50,Barbuñales,94,47,47
22,Huesca,51,Bárcabo,107,59,48
22,Huesca,52,Belver de Cinca,1281,727,554
22,Huesca,53,Benabarre,1110,575,535
22,Huesca,54,Benasque,2121,1136,985
22,Huesca,246,Beranuy,77,46,31
22,Huesca,55,Berbegal,357,188,169
22,Huesca,57,Bielsa,473,247,226
22,Huesca,58,Bierge,242,133,109
22,Huesca,59,Biescas,1480,781,699
22,Huesca,60,Binaced,1524,812,712
22,Huesca,61,Binéfar,9391,4889,4502
22,Huesca,62,Bisaurri,180,99,81
22,Huesca,63,Biscarrués,192,105,87
22,Huesca,64,Blecua y Torres,182,104,78
22,Huesca,66,Boltaña,941,511,430
22,Huesca,67,Bonansa,79,44,35
22,Huesca,68,Borau,81,49,32
22,Huesca,69,Broto,552,308,244
22,Huesca,72,Caldearenas,228,130,98
22,Huesca,74,Campo,343,181,162
22,Huesca,75,Camporrélls,134,72,62
22,Huesca,76,Canal de Berdún,343,188,155
22,Huesca,77,Candasnos,315,164,151
22,Huesca,78,Canfranc,542,301,241
22,Huesca,79,Capdesaso,163,77,86
22,Huesca,80,Capella,358,193,165
22,Huesca,81,Casbas de Huesca,279,154,125
22,Huesca,83,Castejón de Monegros,528,279,249
22,Huesca,84,Castejón de Sos,738,378,360
22,Huesca,82,Castejón del Puente,326,172,154
22,Huesca,85,Castelflorite,112,61,51
22,Huesca,86,Castiello de Jaca,244,135,109
22,Huesca,87,Castigaleu,87,50,37
22,Huesca,88,Castillazuelo,174,86,88
22,Huesca,89,Castillonroy,321,169,152
22,Huesca,94,Chalamera,111,59,52
22,Huesca,95,Chía,87,53,34
22,Huesca,96,Chimillas,389,196,193
22,Huesca,90,Colungo,118,64,54
22,Huesca,99,Esplús,581,290,291
22,Huesca,102,Estada,202,116,86
22,Huesca,103,Estadilla,814,398,416
22,Huesca,105,Estopiñán del Castillo,132,70,62
22,Huesca,106,Fago,27,14,13
22,Huesca,107,Fanlo,102,62,40
22,Huesca,109,Fiscal,323,171,152
22,Huesca,110,Fonz,902,446,456
22,Huesca,111,Foradada del Toscar,178,94,84
22,Huesca,112,Fraga,15024,7643,7381
22,Huesca,113,"Fueva, La",608,324,284
22,Huesca,114,Gistaín,142,79,63
22,Huesca,115,"Grado, El",422,223,199
22,Huesca,116,Grañén,1748,906,842
22,Huesca,117,Graus,3334,1650,1684
22,Huesca,119,Gurrea de Gállego,1483,765,718
22,Huesca,122,Hoz de Jaca,76,37,39
22,Huesca,908,Hoz y Costean,221,122,99
22,Huesca,124,Huerto,218,115,103
22,Huesca,125,Huesca,52223,24957,27266
22,Huesca,126,Ibieca,100,55,45
22,Huesca,127,Igriés,686,356,330
22,Huesca,128,Ilche,213,112,101
22,Huesca,129,Isábena,261,139,122
22,Huesca,130,Jaca,12889,6373,6516
22,Huesca,131,Jasa,94,54,40
22,Huesca,133,Labuerda,157,86,71
22,Huesca,135,Laluenga,210,110,100
22,Huesca,136,Lalueza,943,492,451
22,Huesca,137,Lanaja,1179,628,551
22,Huesca,139,Laperdiguera,91,47,44
22,Huesca,141,Lascellas-Ponzano,128,81,47
22,Huesca,142,Lascuarre,133,68,65
22,Huesca,143,Laspaúles,244,142,102
22,Huesca,144,Laspuña,281,152,129
22,Huesca,149,Loarre,332,185,147
22,Huesca,150,Loporzano,522,294,228
22,Huesca,151,Loscorrales,100,51,49
22,Huesca,905,Lupiñén-Ortilla,335,167,168
22,Huesca,155,Monesma y Cajigar,77,40,37
22,Huesca,156,Monflorite-Lascasas,379,204,175
22,Huesca,157,Montanuy,220,123,97
22,Huesca,158,Monzón,17166,8661,8505
22,Huesca,160,Naval,270,143,127
22,Huesca,162,Novales,155,74,81
22,Huesca,163,Nueno,537,295,242
22,Huesca,164,Olvena,48,24,24
22,Huesca,165,Ontiñena,537,270,267
22,Huesca,167,Osso de Cinca,691,375,316
22,Huesca,168,Palo,26,13,13
22,Huesca,170,Panticosa,795,401,394
22,Huesca,172,Peñalba,662,331,331
22,Huesca,173,"Peñas de Riglos, Las",255,161,94
22,Huesca,174,Peralta de Alcofea,576,303,273
22,Huesca,175,Peralta de Calasanz,221,124,97
22,Huesca,176,Peraltilla,200,104,96
22,Huesca,177,Perarrúa,112,61,51
22,Huesca,178,Pertusa,114,68,46
22,Huesca,181,Piracés,104,59,45
22,Huesca,182,Plan,287,149,138
22,Huesca,184,Poleñino,205,110,95
22,Huesca,186,Pozán de Vero,214,103,111
22,Huesca,187,"Puebla de Castro, La",361,181,180
22,Huesca,188,Puente de Montañana,96,44,52
22,Huesca,902,Puente la Reina de Jaca,263,134,129
22,Huesca,189,Puértolas,210,121,89
22,Huesca,190,"Pueyo de Araguás, El",152,88,64
22,Huesca,193,Pueyo de Santa Cruz,328,165,163
22,Huesca,195,Quicena,283,138,145
22,Huesca,197,Robres,561,286,275
22,Huesca,199,Sabiñánigo,9254,4621,4633
22,Huesca,200,Sahún,305,157,148
22,Huesca,201,Salas Altas,303,155,148
22,Huesca,202,Salas Bajas,171,83,88
22,Huesca,203,Salillas,101,57,44
22,Huesca,204,Sallent de Gállego,1444,730,714
22,Huesca,205,San Esteban de Litera,485,246,239
22,Huesca,207,San Juan de Plan,142,80,62
22,Huesca,903,San Miguel del Cinca,816,417,399
22,Huesca,206,Sangarrén,220,119,101
22,Huesca,208,Santa Cilia,229,124,105
22,Huesca,209,Santa Cruz de la Serós,177,104,73
22,Huesca,906,Santa María de Dulcis,213,116,97
22,Huesca,212,Santaliestra y San Quílez,87,46,41
22,Huesca,213,Sariñena,4155,2142,2013
22,Huesca,214,Secastilla,150,71,79
22,Huesca,215,Seira,143,81,62
22,Huesca,217,Sena,481,259,222
22,Huesca,218,Senés de Alcubierre,42,20,22
22,Huesca,220,Sesa,175,98,77
22,Huesca,221,Sesué,126,68,58
22,Huesca,222,Siétamo,681,376,305
22,Huesca,223,Sopeira,96,51,45
22,Huesca,904,"Sotonera, La",932,486,446
22,Huesca,225,Tamarite de Litera,3507,1804,1703
22,Huesca,226,Tardienta,973,489,484
22,Huesca,227,Tella-Sin,231,127,104
22,Huesca,228,Tierz,754,377,377
22,Huesca,229,Tolva,127,71,56
22,Huesca,230,Torla-Ordesa,299,155,144
22,Huesca,232,Torralba de Aragón,114,60,54
22,Huesca,233,Torre la Ribera,103,55,48
22,Huesca,234,Torrente de Cinca,1132,565,567
22,Huesca,235,Torres de Alcanadre,93,57,36
22,Huesca,236,Torres de Barbués,272,138,134
22,Huesca,239,Tramaced,107,67,40
22,Huesca,242,Valfarta,66,41,25
22,Huesca,243,Valle de Bardají,35,19,16
22,Huesca,901,Valle de Hecho,852,445,407
22,Huesca,244,Valle de Lierp,48,23,25
22,Huesca,245,Velilla de Cinca,448,232,216
22,Huesca,909,Vencillón,392,205,187
22,Huesca,247,Viacamp y Litera,35,23,12
22,Huesca,248,Vicién,121,70,51
22,Huesca,249,Villanova,164,82,82
22,Huesca,250,Villanúa,450,239,211
22,Huesca,251,Villanueva de Sigena,405,207,198
22,Huesca,252,Yebra de Basa,147,86,61
22,Huesca,253,Yésero,56,33,23
22,Huesca,254,Zaidín,1772,929,843
23,Jaén,1,Albanchez de Mágina,1060,550,510
23,Jaén,2,Alcalá la Real,21758,10702,11056
23,Jaén,3,Alcaudete,10634,5235,5399
23,Jaén,4,Aldeaquemada,503,273,230
23,Jaén,5,Andújar,37611,18449,19162
23,Jaén,6,Arjona,5662,2799,2863
23,Jaén,7,Arjonilla,3654,1834,1820
23,Jaén,8,Arquillos,1797,893,904
23,Jaén,905,Arroyo del Ojanco,2353,1199,1154
23,Jaén,9,Baeza,15996,7930,8066
23,Jaén,10,Bailén,17924,8917,9007
23,Jaén,11,Baños de la Encina,2613,1343,1270
23,Jaén,12,Beas de Segura,5275,2752,2523
23,Jaén,902,Bedmar y Garcíez,2757,1379,1378
23,Jaén,14,Begíjar,3073,1546,1527
23,Jaén,15,Bélmez de la Moraleda,1600,806,794
23,Jaén,16,Benatae,467,244,223
23,Jaén,17,Cabra del Santo Cristo,1877,993,884
23,Jaén,18,Cambil,2772,1436,1336
23,Jaén,19,Campillo de Arenas,1854,966,888
23,Jaén,20,Canena,1927,990,937
23,Jaén,21,Carboneros,625,322,303
23,Jaén,901,Cárcheles,1375,720,655
23,Jaén,24,"Carolina, La",15508,7672,7836
23,Jaén,25,Castellar,3389,1703,1686
23,Jaén,26,Castillo de Locubín,4165,2053,2112
23,Jaén,27,Cazalilla,844,409,435
23,Jaén,28,Cazorla,7613,3691,3922
23,Jaén,29,Chiclana de Segura,988,503,485
23,Jaén,30,Chilluévar,1483,721,762
23,Jaén,31,Escañuela,952,476,476
23,Jaén,32,Espeluy,666,326,340
23,Jaén,33,Frailes,1610,802,808
23,Jaén,34,Fuensanta de Martos,3071,1518,1553
23,Jaén,35,Fuerte del Rey,1384,713,671
23,Jaén,37,Génave,614,333,281
23,Jaén,38,"Guardia de Jaén, La",4931,2499,2432
23,Jaén,39,Guarromán,2821,1426,1395
23,Jaén,41,Higuera de Calatrava,622,333,289
23,Jaén,42,Hinojares,334,171,163
23,Jaén,43,Hornos,631,318,313
23,Jaén,44,Huelma,5932,2950,2982
23,Jaén,45,Huesa,2541,1281,1260
23,Jaén,46,Ibros,2925,1471,1454
23,Jaén,47,"Iruela, La",1958,973,985
23,Jaén,48,Iznatoraf,1000,518,482
23,Jaén,49,Jabalquinto,2114,1058,1056
23,Jaén,50,Jaén,114238,54948,59290
23,Jaén,51,Jamilena,3343,1695,1648
23,Jaén,52,Jimena,1293,622,671
23,Jaén,53,Jódar,11901,5903,5998
23,Jaén,40,Lahiguera,1759,862,897
23,Jaén,54,Larva,486,248,238
23,Jaén,55,Linares,58449,28619,29830
23,Jaén,56,Lopera,3714,1859,1855
23,Jaén,57,Lupión,881,429,452
23,Jaén,58,Mancha Real,11265,5604,5661
23,Jaén,59,Marmolejo,6968,3477,3491
23,Jaén,60,Martos,24207,12006,12201
23,Jaén,61,Mengíbar,9916,4944,4972
23,Jaén,62,Montizón,1745,901,844
23,Jaén,63,Navas de San Juan,4506,2260,2246
23,Jaén,64,Noalejo,1963,990,973
23,Jaén,65,Orcera,1860,940,920
23,Jaén,66,Peal de Becerro,5290,2630,2660
23,Jaén,67,Pegalajar,2945,1475,1470
23,Jaén,69,Porcuna,6403,3243,3160
23,Jaén,70,Pozo Alcón,4758,2432,2326
23,Jaén,71,Puente de Génave,2218,1117,1101
23,Jaén,72,"Puerta de Segura, La",2396,1193,1203
23,Jaén,73,Quesada,5400,2735,2665
23,Jaén,74,Rus,3630,1858,1772
23,Jaén,75,Sabiote,4012,1982,2030
23,Jaén,76,Santa Elena,930,492,438
23,Jaén,77,Santiago de Calatrava,709,374,335
23,Jaén,904,Santiago-Pontones,3108,1599,1509
23,Jaén,79,Santisteban del Puerto,4566,2353,2213
23,Jaén,80,Santo Tomé,2208,1108,1100
23,Jaén,81,Segura de la Sierra,1807,890,917
23,Jaén,82,Siles,2305,1166,1139
23,Jaén,84,Sorihuela del Guadalimar,1157,606,551
23,Jaén,85,Torreblascopedro,2594,1309,1285
23,Jaén,86,Torredelcampo,14435,7235,7200
23,Jaén,87,Torredonjimeno,13780,6774,7006
23,Jaén,88,Torreperogil,7391,3613,3778
23,Jaén,90,Torres,1475,744,731
23,Jaén,91,Torres de Albánchez,826,433,393
23,Jaén,92,Úbeda,34733,17046,17687
23,Jaén,93,Valdepeñas de Jaén,3852,1910,1942
23,Jaén,94,Vilches,4567,2291,2276
23,Jaén,95,Villacarrillo,10857,5459,5398
23,Jaén,96,Villanueva de la Reina,3151,1588,1563
23,Jaén,97,Villanueva del Arzobispo,8402,4331,4071
23,Jaén,98,Villardompardo,1001,499,502
23,Jaén,99,"Villares, Los",6007,3001,3006
23,Jaén,101,Villarrodrigo,425,220,205
23,Jaén,903,Villatorres,4389,2221,2168
24,León,1,Acebedo,205,117,88
24,León,2,Algadefe,284,145,139
24,León,3,Alija del Infantado,687,346,341
24,León,4,Almanza,553,318,235
24,León,5,"Antigua, La",395,229,166
24,León,6,Ardón,548,302,246
24,León,7,Arganza,819,411,408
24,León,8,Astorga,11153,5262,5891
24,León,9,Balboa,318,172,146
24,León,10,"Bañeza, La",10349,4985,5364
24,León,11,Barjas,189,101,88
24,León,12,"Barrios de Luna, Los",310,175,135
24,León,14,Bembibre,9191,4528,4663
24,León,15,Benavides,2522,1238,1284
24,León,16,Benuza,487,274,213
24,León,17,Bercianos del Páramo,580,298,282
24,León,18,Bercianos del Real Camino,193,101,92
24,León,19,Berlanga del Bierzo,366,169,197
24,León,20,Boca de Huérgano,470,277,193
24,León,21,Boñar,1865,955,910
24,León,22,Borrenes,332,176,156
24,León,23,Brazuelo,288,156,132
24,León,24,"Burgo Ranero, El",751,401,350
24,León,25,Burón,325,192,133
24,León,26,Bustillo del Páramo,1235,637,598
24,León,27,Cabañas Raras,1337,690,647
24,León,28,Cabreros del Río,421,231,190
24,León,29,Cabrillanes,779,401,378
24,León,30,Cacabelos,5152,2552,2600
24,León,31,Calzada del Coto,241,142,99
24,León,32,Campazas,121,58,63
24,León,33,Campo de Villavidel,205,112,93
24,León,34,Camponaraya,4072,2025,2047
24,León,36,Candín,283,151,132
24,León,37,Cármenes,363,201,162
24,León,38,Carracedelo,3500,1737,1763
24,León,39,Carrizo,2278,1155,1123
24,León,40,Carrocera,479,257,222
24,León,41,Carucedo,555,283,272
24,León,42,Castilfalé,68,39,29
24,León,43,Castrillo de Cabrera,129,72,57
24,León,44,Castrillo de la Valduerna,171,76,95
24,León,46,Castrocalbón,1002,519,483
24,León,47,Castrocontrigo,807,429,378
24,León,49,Castropodame,1680,859,821
24,León,50,Castrotierra de Valmadrigal,110,59,51
24,León,51,Cea,436,224,212
24,León,52,Cebanico,158,96,62
24,León,53,Cebrones del Río,472,253,219
24,León,65,Chozas de Abajo,2553,1336,1217
24,León,54,Cimanes de la Vega,471,244,227
24,León,55,Cimanes del Tejar,755,408,347
24,León,56,Cistierna,3243,1604,1639
24,León,57,Congosto,1554,767,787
24,León,58,Corbillos de los Oteros,217,122,95
24,León,59,Corullón,927,471,456
24,León,60,Crémenes,570,311,259
24,León,61,Cuadros,1986,1018,968
24,León,62,Cubillas de los Oteros,152,87,65
24,León,63,Cubillas de Rueda,411,213,198
24,León,64,Cubillos del Sil,1859,986,873
24,León,66,Destriana,511,245,266
24,León,67,Encinedo,715,378,337
24,León,68,"Ercina, La",473,245,228
24,León,69,Escobar de Campos,42,25,17
24,León,70,Fabero,4635,2254,2381
24,León,71,Folgoso de la Ribera,1132,548,584
24,León,73,Fresno de la Vega,530,267,263
24,León,74,Fuentes de Carbajal,90,49,41
24,León,76,Garrafe de Torío,1496,821,675
24,León,77,Gordaliza del Pino,252,122,130
24,León,78,Gordoncillo,433,220,213
24,León,79,Gradefes,966,525,441
24,León,80,Grajal de Campos,234,112,122
24,León,81,Gusendos de los Oteros,138,73,65
24,León,82,Hospital de Órbigo,976,486,490
24,León,83,Igüeña,1190,621,569
24,León,84,Izagre,179,91,88
24,León,86,Joarilla de las Matas,304,164,140
24,León,87,Laguna Dalga,683,369,314
24,León,88,Laguna de Negrillos,1079,553,526
24,León,89,León,125317,56822,68495
24,León,92,Llamas de la Ribera,849,440,409
24,León,90,Lucillo,391,203,188
24,León,91,Luyego,678,355,323
24,León,93,Magaz de Cepeda,369,187,182
24,León,94,Mansilla de las Mulas,1768,894,874
24,León,95,Mansilla Mayor,340,180,160
24,León,96,Maraña,121,71,50
24,León,97,Matadeón de los Oteros,236,125,111
24,León,98,Matallana de Torío,1322,698,624
24,León,99,Matanza,179,96,83
24,León,100,Molinaseca,895,489,406
24,León,101,Murias de Paredes,407,205,202
24,León,102,Noceda del Bierzo,692,350,342
24,León,103,Oencia,293,168,125
24,León,104,"Omañas, Las",276,145,131
24,León,105,Onzonilla,1779,925,854
24,León,106,Oseja de Sajambre,252,149,103
24,León,107,Pajares de los Oteros,279,170,109
24,León,108,Palacios de la Valduerna,400,192,208
24,León,109,Palacios del Sil,1030,553,477
24,León,110,Páramo del Sil,1336,682,654
24,León,112,Peranzanes,321,182,139
24,León,113,Pobladura de Pelayo García,379,194,185
24,León,114,"Pola de Gordón, La",3379,1701,1678
24,León,115,Ponferrada,65788,31354,34434
24,León,116,Posada de Valdeón,452,271,181
24,León,117,Pozuelo del Páramo,455,229,226
24,León,118,Prado de la Guzpeña,123,67,56
24,León,119,Priaranza del Bierzo,785,397,388
24,León,120,Prioro,374,210,164
24,León,121,Puebla de Lillo,693,386,307
24,León,122,Puente de Domingo Flórez,1533,797,736
24,León,123,Quintana del Castillo,773,429,344
24,León,124,Quintana del Marco,388,212,176
24,León,125,Quintana y Congosto,343,168,175
24,León,127,Regueras de Arriba,295,162,133
24,León,129,Reyero,125,65,60
24,León,130,Riaño,477,278,199
24,León,131,Riego de la Vega,812,427,385
24,León,132,Riello,622,352,270
24,León,133,Rioseco de Tapia,390,216,174
24,León,134,"Robla, La",4045,2039,2006
24,León,136,Roperuelos del Páramo,565,285,280
24,León,137,Sabero,1184,596,588
24,León,139,Sahagún,2597,1287,1310
24,León,141,San Adrián del Valle,105,58,47
24,León,142,San Andrés del Rabanedo,31123,14921,16202
24,León,144,San Cristóbal de la Polantera,745,374,371
24,León,145,San Emiliano,678,371,307
24,León,146,San Esteban de Nogales,265,139,126
24,León,148,San Justo de la Vega,1912,971,941
24,León,149,San Millán de los Caballeros,176,92,84
24,León,150,San Pedro Bercianos,244,133,111
24,León,143,Sancedo,563,285,278
24,León,151,Santa Colomba de Curueño,508,271,237
24,León,152,Santa Colomba de Somoza,498,273,225
24,León,153,Santa Cristina de Valmadrigal,272,140,132
24,León,154,Santa Elena de Jamuz,1109,579,530
24,León,155,Santa María de la Isla,498,261,237
24,León,158,Santa María de Ordás,329,168,161
24,León,156,Santa María del Monte de Cea,237,130,107
24,León,157,Santa María del Páramo,3104,1520,1584
24,León,159,Santa Marina del Rey,1959,975,984
24,León,160,Santas Martas,768,402,366
24,León,161,Santiago Millas,338,190,148
24,León,162,Santovenia de la Valdoncina,2069,1054,1015
24,León,163,Sariegos,4950,2462,2488
24,León,164,Sena de Luna,389,192,197
24,León,165,Sobrado,333,169,164
24,León,166,Soto de la Vega,1578,823,755
24,León,167,Soto y Amío,823,421,402
24,León,168,Toral de los Guzmanes,515,272,243
24,León,206,Toral de los Vados,1909,944,965
24,León,169,Toreno,3219,1610,1609
24,León,170,Torre del Bierzo,2157,1102,1055
24,León,171,Trabadelo,352,195,157
24,León,172,Truchas,426,222,204
24,León,173,Turcia,1035,525,510
24,León,174,Urdiales del Páramo,502,272,230
24,León,185,Val de San Lorenzo,519,258,261
24,León,175,Valdefresno,2167,1110,1057
24,León,176,Valdefuentes del Páramo,335,176,159
24,León,177,Valdelugueros,530,301,229
24,León,178,Valdemora,74,33,41
24,León,179,Valdepiélago,338,193,145
24,León,180,Valdepolo,1240,656,584
24,León,181,Valderas,1719,875,844
24,León,182,Valderrey,450,216,234
24,León,183,Valderrueda,885,456,429
24,León,184,Valdesamario,199,112,87
24,León,187,Valdevimbre,1006,533,473
24,León,188,Valencia de Don Juan,5201,2547,2654
24,León,191,Vallecillo,121,71,50
24,León,189,Valverde de la Virgen,7305,3785,3520
24,León,190,Valverde-Enrique,161,84,77
24,León,193,"Vecilla, La",409,213,196
24,León,196,Vega de Espinareda,2210,1119,1091
24,León,197,Vega de Infanzones,880,445,435
24,León,198,Vega de Valcarce,621,319,302
24,León,194,Vegacervera,293,152,141
24,León,199,Vegaquemada,445,243,202
24,León,201,Vegas del Condado,1158,664,494
24,León,202,Villablino,9150,4510,4640
24,León,203,Villabraz,99,59,40
24,León,205,Villadangos del Páramo,1106,570,536
24,León,207,Villademor de la Vega,337,182,155
24,León,209,Villafranca del Bierzo,3055,1476,1579
24,León,210,Villagatón,588,320,268
24,León,211,Villamandos,303,169,134
24,León,901,Villamanín,958,499,459
24,León,212,Villamañán,1181,575,606
24,León,213,Villamartín de Don Sancho,153,86,67
24,León,214,Villamejil,704,370,334
24,León,215,Villamol,167,83,84
24,León,216,Villamontán de la Valduerna,758,398,360
24,León,217,Villamoratiel de las Matas,163,92,71
24,León,218,Villanueva de las Manzanas,501,264,237
24,León,219,Villaobispo de Otero,576,315,261
24,León,902,Villaornate y Castro,360,179,181
24,León,221,Villaquejida,904,456,448
24,León,222,Villaquilambre,18666,9241,9425
24,León,223,Villarejo de Órbigo,3034,1487,1547
24,León,224,Villares de Órbigo,643,339,304
24,León,225,Villasabariego,1152,616,536
24,León,226,Villaselán,199,112,87
24,León,227,Villaturiel,1932,994,938
24,León,228,Villazala,693,367,326
24,León,229,Villazanzo de Valderaduey,440,252,188
24,León,230,Zotes del Páramo,443,247,196
25,Lleida,1,Abella de la Conca,184,102,82
25,Lleida,2,Àger,586,315,271
25,Lleida,3,Agramunt,5405,2706,2699
25,Lleida,38,Aitona,2548,1321,1227
25,Lleida,4,"Alamús, Els",777,411,366
25,Lleida,5,Alàs i Cerc,351,178,173
25,Lleida,6,"Albagés, L'",393,211,182
25,Lleida,7,Albatàrrec,2275,1183,1092
25,Lleida,8,Albesa,1582,855,727
25,Lleida,9,"Albi, L'",781,404,377
25,Lleida,10,Alcanó,243,121,122
25,Lleida,11,Alcarràs,9363,4836,4527
25,Lleida,12,Alcoletge,3415,1773,1642
25,Lleida,13,Alfarràs,2879,1515,1364
25,Lleida,14,Alfés,313,162,151
25,Lleida,15,Algerri,417,222,195
25,Lleida,16,Alguaire,2970,1562,1408
25,Lleida,17,Alins,286,152,134
25,Lleida,19,Almacelles,6857,3577,3280
25,Lleida,20,Almatret,319,174,145
25,Lleida,21,Almenar,3468,1838,1630
25,Lleida,22,Alòs de Balaguer,128,74,54
25,Lleida,23,Alpicat,6285,3146,3139
25,Lleida,24,Alt Àneu,405,229,176
25,Lleida,27,Anglesola,1324,665,659
25,Lleida,29,Arbeca,2231,1129,1102
25,Lleida,31,Arres,59,37,22
25,Lleida,32,Arsèguel,82,48,34
25,Lleida,33,Artesa de Lleida,1527,795,732
25,Lleida,34,Artesa de Segre,3508,1791,1717
25,Lleida,36,Aspa,214,107,107
25,Lleida,37,"Avellanes i Santa Linya, Les",455,262,193
25,Lleida,39,Baix Pallars,341,183,158
25,Lleida,40,Balaguer,16670,8420,8250
25,Lleida,41,Barbens,933,497,436
25,Lleida,42,"Baronia de Rialb, La",235,124,111
25,Lleida,44,Bassella,229,109,120
25,Lleida,45,Bausen,67,33,34
25,Lleida,46,Belianes,519,261,258
25,Lleida,170,Bellaguarda,305,159,146
25,Lleida,47,Bellcaire d'Urgell,1237,623,614
25,Lleida,48,Bell-lloc d'Urgell,2321,1157,1164
25,Lleida,49,Bellmunt d'Urgell,188,92,96
25,Lleida,50,Bellpuig,4985,2591,2394
25,Lleida,51,Bellver de Cerdanya,1973,1014,959
25,Lleida,52,Bellvís,2276,1157,1119
25,Lleida,53,Benavent de Segrià,1442,753,689
25,Lleida,55,Biosca,186,99,87
25,Lleida,57,"Bòrdes, Es",252,140,112
25,Lleida,58,"Borges Blanques, Les",6005,3068,2937
25,Lleida,59,Bossòst,1120,546,574
25,Lleida,56,Bovera,266,147,119
25,Lleida,60,Cabanabona,81,35,46
25,Lleida,61,Cabó,93,51,42
25,Lleida,62,Camarasa,863,439,424
25,Lleida,63,Canejan,88,51,37
25,Lleida,904,Castell de Mur,168,94,74
25,Lleida,64,Castellar de la Ribera,140,72,68
25,Lleida,67,Castelldans,943,506,437
25,Lleida,68,Castellnou de Seana,686,362,324
25,Lleida,69,Castelló de Farfanya,542,289,253
25,Lleida,70,Castellserà,1008,507,501
25,Lleida,71,Cava,52,32,20
25,Lleida,72,Cervera,9037,4559,4478
25,Lleida,73,Cervià de les Garrigues,660,348,312
25,Lleida,74,Ciutadilla,202,109,93
25,Lleida,75,Clariana de Cardener,145,72,73
25,Lleida,76,"Cogul, El",162,87,75
25,Lleida,77,Coll de Nargó,558,286,272
25,Lleida,163,"Coma i la Pedra, La",259,157,102
25,Lleida,161,Conca de Dalt,445,233,212
25,Lleida,78,Corbins,1411,764,647
25,Lleida,79,Cubells,373,198,175
25,Lleida,81,"Espluga Calba, L'",363,182,181
25,Lleida,82,Espot,365,194,171
25,Lleida,88,Estamariu,124,72,52
25,Lleida,85,Estaràs,158,85,73
25,Lleida,86,Esterri d'Àneu,769,369,400
25,Lleida,87,Esterri de Cardós,67,34,33
25,Lleida,89,Farrera,121,70,51
25,Lleida,908,Fígols i Alinyà,245,139,106
25,Lleida,92,"Floresta, La",155,83,72
25,Lleida,93,Fondarella,796,394,402
25,Lleida,94,Foradada,170,98,72
25,Lleida,96,"Fuliola, La",1237,624,613
25,Lleida,97,Fulleda,86,43,43
25,Lleida,98,Gavet de la Conca,280,132,148
25,Lleida,912,Gimenells i el Pla de la Font,1107,579,528
25,Lleida,99,Golmés,1852,916,936
25,Lleida,100,Gósol,222,121,101
25,Lleida,101,"Granadella, La",737,388,349
25,Lleida,102,"Granja d'Escarp, La",971,522,449
25,Lleida,103,Granyanella,147,81,66
25,Lleida,105,Granyena de les Garrigues,158,95,63
25,Lleida,104,Granyena de Segarra,143,73,70
25,Lleida,109,Guimerà,273,148,125
25,Lleida,903,"Guingueta d'Àneu, La",311,166,145
25,Lleida,110,Guissona,7014,3721,3293
25,Lleida,111,Guixers,140,86,54
25,Lleida,115,Isona i Conca Dellà,1027,544,483
25,Lleida,112,Ivars de Noguera,332,175,157
25,Lleida,113,Ivars d'Urgell,1568,820,748
25,Lleida,114,Ivorra,107,57,50
25,Lleida,910,Josa i Tuixén,115,68,47
25,Lleida,118,Juncosa,408,217,191
25,Lleida,119,Juneda,3383,1766,1617
25,Lleida,121,Les,955,471,484
25,Lleida,122,Linyola,2626,1317,1309
25,Lleida,123,Lladorre,225,108,117
25,Lleida,124,Lladurs,183,95,88
25,Lleida,125,Llardecans,470,246,224
25,Lleida,126,Llavorsí,359,173,186
25,Lleida,120,Lleida,137327,67855,69472
25,Lleida,127,Lles de Cerdanya,253,144,109
25,Lleida,128,Llimiana,142,83,59
25,Lleida,129,Llobera,201,110,91
25,Lleida,133,Maials,945,521,424
25,Lleida,130,Maldà,227,114,113
25,Lleida,131,Massalcoreig,588,335,253
25,Lleida,132,Massoteres,214,116,98
25,Lleida,134,Menàrguens,819,458,361
25,Lleida,135,Miralcamp,1358,684,674
25,Lleida,137,Mollerussa,14574,7437,7137
25,Lleida,136,"Molsosa, La",109,53,56
25,Lleida,139,Montellà i Martinet,554,305,249
25,Lleida,140,Montferrer i Castellbò,1092,591,501
25,Lleida,138,Montgai,636,332,304
25,Lleida,142,Montoliu de Lleida,469,234,235
25,Lleida,141,Montoliu de Segarra,178,98,80
25,Lleida,143,Montornès de Segarra,97,46,51
25,Lleida,145,Nalec,101,54,47
25,Lleida,25,Naut Aran,1781,916,865
25,Lleida,146,Navès,288,144,144
25,Lleida,148,Odèn,256,150,106
25,Lleida,149,Oliana,1826,918,908
25,Lleida,150,Oliola,211,113,98
25,Lleida,151,Olius,931,497,434
25,Lleida,152,"Oluges, Les",155,81,74
25,Lleida,153,"Omellons, Els",210,111,99
25,Lleida,154,"Omells de na Gaia, Els",135,72,63
25,Lleida,155,Organyà,801,401,400
25,Lleida,156,Os de Balaguer,1013,514,499
25,Lleida,157,Ossó de Sió,213,106,107
25,Lleida,158,"Palau d'Anglesola, El",2183,1072,1111
25,Lleida,164,Penelles,463,265,198
25,Lleida,165,Peramola,341,169,172
25,Lleida,166,Pinell de Solsonès,211,123,88
25,Lleida,167,Pinós,312,163,149
25,Lleida,911,"Plans de Sió, Els",509,267,242
25,Lleida,168,"Poal, El",637,333,304
25,Lleida,169,"Pobla de Cérvoles, La",194,109,85
25,Lleida,171,"Pobla de Segur, La",2949,1462,1487
25,Lleida,30,"Pont de Bar, El",171,94,77
25,Lleida,173,"Pont de Suert, El",2265,1140,1125
25,Lleida,172,Ponts,2622,1292,1330
25,Lleida,174,"Portella, La",708,395,313
25,Lleida,175,Prats i Sansor,232,119,113
25,Lleida,176,Preixana,381,199,182
25,Lleida,177,Preixens,443,228,215
25,Lleida,179,Prullans,224,110,114
25,Lleida,180,Puiggròs,280,141,139
25,Lleida,181,Puigverd d'Agramunt,228,127,101
25,Lleida,182,Puigverd de Lleida,1350,694,656
25,Lleida,183,Rialp,666,345,321
25,Lleida,905,Ribera d'Ondara,433,222,211
25,Lleida,185,Ribera d'Urgellet,936,483,453
25,Lleida,186,Riner,262,130,132
25,Lleida,913,Riu de Cerdanya,93,55,38
25,Lleida,189,Rosselló,3083,1549,1534
25,Lleida,190,Salàs de Pallars,337,180,157
25,Lleida,191,Sanaüja,401,209,192
25,Lleida,196,Sant Esteve de la Sarga,130,77,53
25,Lleida,192,Sant Guim de Freixenet,1028,538,490
25,Lleida,197,Sant Guim de la Plana,177,101,76
25,Lleida,193,Sant Llorenç de Morunys,949,470,479
25,Lleida,902,Sant Martí de Riucorb,661,347,314
25,Lleida,194,Sant Ramon,507,275,232
25,Lleida,201,Sarroca de Bellera,120,69,51
25,Lleida,200,Sarroca de Lleida,370,201,169
25,Lleida,202,Senterada,136,79,57
25,Lleida,35,"Sentiu de Sió, La",445,229,216
25,Lleida,204,Seròs,1895,1020,875
25,Lleida,203,"Seu d'Urgell, La",12015,5789,6226
25,Lleida,205,Sidamon,732,383,349
25,Lleida,206,"Soleràs, El",346,183,163
25,Lleida,207,Solsona,8974,4444,4530
25,Lleida,208,Soriguera,403,220,183
25,Lleida,209,Sort,2128,1056,1072
25,Lleida,210,Soses,1719,889,830
25,Lleida,211,Sudanell,874,482,392
25,Lleida,212,Sunyer,359,209,150
25,Lleida,215,Talarn,702,476,226
25,Lleida,216,Talavera,250,141,109
25,Lleida,217,Tàrrega,16599,8230,8369
25,Lleida,218,Tarrés,99,56,43
25,Lleida,219,Tarroja de Segarra,181,99,82
25,Lleida,220,Térmens,1442,720,722
25,Lleida,221,Tírvia,141,69,72
25,Lleida,222,Tiurana,76,37,39
25,Lleida,223,Torà,1223,613,610
25,Lleida,224,"Torms, Els",147,83,64
25,Lleida,225,Tornabous,858,465,393
25,Lleida,227,"Torre de Cabdella, La",754,386,368
25,Lleida,226,Torrebesses,290,155,135
25,Lleida,228,Torrefarrera,4653,2363,2290
25,Lleida,907,Torrefeta i Florejacs,591,313,278
25,Lleida,230,Torregrossa,2192,1113,1079
25,Lleida,231,Torrelameu,715,403,312
25,Lleida,232,Torres de Segre,2225,1130,1095
25,Lleida,233,Torre-serona,363,185,178
25,Lleida,234,Tremp,5906,2910,2996
25,Lleida,43,"Vall de Boí, La",1015,537,478
25,Lleida,901,Vall de Cardós,360,191,169
25,Lleida,238,Vallbona de les Monges,226,122,104
25,Lleida,240,Vallfogona de Balaguer,1867,929,938
25,Lleida,906,"Valls d'Aguilar, Les",277,152,125
25,Lleida,239,"Valls de Valira, Les",808,418,390
25,Lleida,909,"Vansa i Fórnols, La",180,96,84
25,Lleida,242,Verdú,924,441,483
25,Lleida,243,Vielha e Mijaran,5512,2811,2701
25,Lleida,244,Vilagrassa,522,270,252
25,Lleida,245,Vilaller,547,292,255
25,Lleida,247,Vilamòs,151,83,68
25,Lleida,248,Vilanova de Bellpuig,1159,587,572
25,Lleida,254,Vilanova de la Barca,1044,533,511
25,Lleida,249,Vilanova de l'Aguda,206,102,104
25,Lleida,250,Vilanova de Meià,401,224,177
25,Lleida,251,Vilanova de Segrià,943,497,446
25,Lleida,252,Vila-sana,721,356,365
25,Lleida,253,"Vilosell, El",180,91,89
25,Lleida,255,Vinaixa,483,254,229
27,Lugo,1,Abadín,2490,1231,1259
27,Lugo,2,Alfoz,1782,856,926
27,Lugo,3,Antas de Ulla,2059,1012,1047
27,Lugo,4,Baleira,1296,684,612
27,Lugo,901,Baralla,2630,1376,1254
27,Lugo,5,Barreiros,2948,1405,1543
27,Lugo,6,Becerreá,2856,1434,1422
27,Lugo,7,Begonte,3071,1539,1532
27,Lugo,8,Bóveda,1527,784,743
27,Lugo,902,Burela,9524,4727,4797
27,Lugo,9,Carballedo,2266,1141,1125
27,Lugo,10,Castro de Rei,5013,2463,2550
27,Lugo,11,Castroverde,2676,1381,1295
27,Lugo,12,Cervantes,1423,805,618
27,Lugo,13,Cervo,4274,2097,2177
27,Lugo,16,Chantada,8371,4065,4306
27,Lugo,14,"Corgo, O",3523,1786,1737
27,Lugo,15,Cospeito,4665,2258,2407
27,Lugo,17,Folgoso do Courel,1025,539,486
27,Lugo,18,"Fonsagrada, A",3670,1905,1765
27,Lugo,19,Foz,9931,4853,5078
27,Lugo,20,Friol,3842,1935,1907
27,Lugo,22,Guitiriz,5512,2738,2774
27,Lugo,23,Guntín,2780,1418,1362
27,Lugo,24,"Incio, O",1667,833,834
27,Lugo,26,Láncara,2696,1368,1328
27,Lugo,27,Lourenzá,2224,1079,1145
27,Lugo,28,Lugo,97995,45468,52527
27,Lugo,29,Meira,1726,859,867
27,Lugo,30,Mondoñedo,3722,1745,1977
27,Lugo,31,Monforte de Lemos,18783,8923,9860
27,Lugo,32,Monterroso,3678,1839,1839
27,Lugo,33,Muras,648,327,321
27,Lugo,34,Navia de Suarna,1140,640,500
27,Lugo,35,Negueira de Muñiz,219,113,106
27,Lugo,37,"Nogais, As",1146,608,538
27,Lugo,38,Ourol,1016,514,502
27,Lugo,39,Outeiro de Rei,5063,2600,2463
27,Lugo,40,Palas de Rei,3489,1768,1721
27,Lugo,41,Pantón,2565,1233,1332
27,Lugo,42,Paradela,1851,923,928
27,Lugo,43,"Páramo, O",1420,718,702
27,Lugo,44,"Pastoriza, A",3133,1578,1555
27,Lugo,45,Pedrafita do Cebreiro,1070,575,495
27,Lugo,47,"Pobra do Brollón, A",1709,854,855
27,Lugo,46,Pol,1663,822,841
27,Lugo,48,"Pontenova, A",2330,1124,1206
27,Lugo,49,Portomarín,1508,774,734
27,Lugo,50,Quiroga,3328,1600,1728
27,Lugo,56,Rábade,1519,762,757
27,Lugo,51,Ribadeo,9962,4762,5200
27,Lugo,52,Ribas de Sil,980,491,489
27,Lugo,53,Ribeira de Piquín,554,281,273
27,Lugo,54,Riotorto,1288,638,650
27,Lugo,55,Samos,1343,714,629
27,Lugo,57,Sarria,13359,6515,6844
27,Lugo,58,"Saviñao, O",3832,1927,1905
27,Lugo,59,Sober,2338,1145,1193
27,Lugo,60,Taboada,2862,1355,1507
27,Lugo,61,Trabada,1117,541,576
27,Lugo,62,Triacastela,658,327,331
27,Lugo,63,"Valadouro, O",2002,971,1031
27,Lugo,64,"Vicedo, O",1747,858,889
27,Lugo,65,Vilalba,14354,6971,7383
27,Lugo,66,Viveiro,15550,7626,7924
27,Lugo,21,Xermade,1884,911,973
27,Lugo,25,Xove,3342,1663,1679
28,Madrid,1,"Acebeda, La",66,37,29
28,Madrid,2,Ajalvir,4455,2327,2128
28,Madrid,3,Alameda del Valle,199,117,82
28,Madrid,4,"Álamo, El",9149,4553,4596
28,Madrid,5,Alcalá de Henares,194310,94877,99433
28,Madrid,6,Alcobendas,114864,55206,59658
28,Madrid,7,Alcorcón,168141,81235,86906
28,Madrid,8,Aldea del Fresno,2616,1377,1239
28,Madrid,9,Algete,20419,10122,10297
28,Madrid,10,Alpedrete,14240,6980,7260
28,Madrid,11,Ambite,677,352,325
28,Madrid,12,Anchuelo,1238,647,591
28,Madrid,13,Aranjuez,58213,28387,29826
28,Madrid,14,Arganda del Rey,53821,27006,26815
28,Madrid,15,Arroyomolinos,29128,14624,14504
28,Madrid,16,"Atazar, El",97,56,41
28,Madrid,17,Batres,1610,823,787
28,Madrid,18,Becerril de la Sierra,5457,2710,2747
28,Madrid,19,Belmonte de Tajo,1628,854,774
28,Madrid,21,"Berrueco, El",743,384,359
28,Madrid,20,Berzosa del Lozoya,203,120,83
28,Madrid,22,Boadilla del Monte,51463,25163,26300
28,Madrid,23,"Boalo, El",7358,3724,3634
28,Madrid,24,Braojos,208,122,86
28,Madrid,25,Brea de Tajo,539,308,231
28,Madrid,26,Brunete,10373,5125,5248
28,Madrid,27,Buitrago del Lozoya,1854,887,967
28,Madrid,28,Bustarviejo,2399,1197,1202
28,Madrid,29,Cabanillas de la Sierra,712,371,341
28,Madrid,30,"Cabrera, La",2570,1278,1292
28,Madrid,31,Cadalso de los Vidrios,3053,1599,1454
28,Madrid,32,Camarma de Esteruelas,7084,3590,3494
28,Madrid,33,Campo Real,5995,3022,2973
28,Madrid,34,Canencia,448,241,207
28,Madrid,35,Carabaña,1940,961,979
28,Madrid,36,Casarrubuelos,3650,1867,1783
28,Madrid,37,Cenicientos,1984,973,1011
28,Madrid,38,Cercedilla,6853,3353,3500
28,Madrid,39,Cervera de Buitrago,156,92,64
28,Madrid,51,Chapinería,2225,1135,1090
28,Madrid,52,Chinchón,5240,2645,2595
28,Madrid,40,Ciempozuelos,23737,11951,11786
28,Madrid,41,Cobeña,7163,3534,3629
28,Madrid,46,Collado Mediano,6666,3336,3330
28,Madrid,47,Collado Villalba,62152,30269,31883
28,Madrid,43,Colmenar de Oreja,7810,3959,3851
28,Madrid,42,Colmenar del Arroyo,1632,839,793
28,Madrid,45,Colmenar Viejo,48614,24029,24585
28,Madrid,44,Colmenarejo,9015,4434,4581
28,Madrid,48,Corpa,684,363,321
28,Madrid,49,Coslada,83011,40782,42229
28,Madrid,50,Cubas de la Sagra,6112,3024,3088
28,Madrid,53,Daganzo de Arriba,10082,5039,5043
28,Madrid,54,"Escorial, El",15562,7675,7887
28,Madrid,55,Estremera,1261,640,621
28,Madrid,56,Fresnedillas de la Oliva,1550,792,758
28,Madrid,57,Fresno de Torote,2115,1109,1006
28,Madrid,58,Fuenlabrada,194669,96237,98432
28,Madrid,59,Fuente el Saz de Jarama,6424,3258,3166
28,Madrid,60,Fuentidueña de Tajo,1980,1003,977
28,Madrid,61,Galapagar,32903,16148,16755
28,Madrid,62,Garganta de los Montes,331,181,150
28,Madrid,63,Gargantilla del Lozoya y Pinilla de Buitrago,315,176,139
28,Madrid,64,Gascones,176,105,71
28,Madrid,65,Getafe,178288,87292,90996
28,Madrid,66,Griñón,10060,5001,5059
28,Madrid,67,Guadalix de la Sierra,6049,3028,3021
28,Madrid,68,Guadarrama,15620,7686,7934
28,Madrid,69,"Hiruela, La",52,33,19
28,Madrid,70,Horcajo de la Sierra-Aoslos,142,78,64
28,Madrid,71,Horcajuelo de la Sierra,88,43,45
28,Madrid,72,Hoyo de Manzanares,8032,4039,3993
28,Madrid,73,Humanes de Madrid,19607,9859,9748
28,Madrid,74,Leganés,187720,91340,96380
28,Madrid,75,Loeches,8525,4304,4221
28,Madrid,76,Lozoya,559,292,267
28,Madrid,901,Lozoyuela-Navas-Sieteiglesias,1237,649,588
28,Madrid,78,Madarcos,46,29,17
28,Madrid,79,Madrid,3182981,1480600,1702381
28,Madrid,80,Majadahonda,71299,33810,37489
28,Madrid,82,Manzanares el Real,8500,4308,4192
28,Madrid,83,Meco,13570,6859,6711
28,Madrid,84,Mejorada del Campo,22948,11445,11503
28,Madrid,85,Miraflores de la Sierra,5817,2997,2820
28,Madrid,86,"Molar, El",8491,4279,4212
28,Madrid,87,"Molinos, Los",4345,2145,2200
28,Madrid,88,Montejo de la Sierra,356,181,175
28,Madrid,89,Moraleja de Enmedio,4870,2431,2439
28,Madrid,90,Moralzarzal,12496,6242,6254
28,Madrid,91,Morata de Tajuña,7482,3750,3732
28,Madrid,92,Móstoles,206589,100871,105718
28,Madrid,93,Navacerrada,2894,1435,1459
28,Madrid,94,Navalafuente,1340,680,660
28,Madrid,95,Navalagamella,2443,1261,1182
28,Madrid,96,Navalcarnero,27570,13775,13795
28,Madrid,97,Navarredonda y San Mamés,131,84,47
28,Madrid,99,Navas del Rey,2751,1466,1285
28,Madrid,100,Nuevo Baztán,6091,3095,2996
28,Madrid,101,Olmeda de las Fuentes,332,173,159
28,Madrid,102,Orusco de Tajuña,1218,612,606
28,Madrid,104,Paracuellos de Jarama,23905,12121,11784
28,Madrid,106,Parla,125898,62635,63263
28,Madrid,107,Patones,553,262,291
28,Madrid,108,Pedrezuela,5613,2811,2802
28,Madrid,109,Pelayos de la Presa,2468,1250,1218
28,Madrid,110,Perales de Tajuña,2817,1421,1396
28,Madrid,111,Pezuela de las Torres,816,426,390
28,Madrid,112,Pinilla del Valle,185,106,79
28,Madrid,113,Pinto,50442,24984,25458
28,Madrid,114,Piñuécar-Gandullas,183,95,88
28,Madrid,115,Pozuelo de Alarcón,85605,41076,44529
28,Madrid,116,Pozuelo del Rey,1099,577,522
28,Madrid,117,Prádena del Rincón,132,73,59
28,Madrid,118,Puebla de la Sierra,61,37,24
28,Madrid,902,Puentes Viejas,632,345,287
28,Madrid,119,Quijorna,3282,1660,1622
28,Madrid,120,Rascafría,1672,914,758
28,Madrid,121,Redueña,248,135,113
28,Madrid,122,Ribatejada,702,360,342
28,Madrid,123,Rivas-Vaciamadrid,83767,41625,42142
28,Madrid,124,Robledillo de la Jara,87,43,44
28,Madrid,125,Robledo de Chavela,4073,2126,1947
28,Madrid,126,Robregordo,44,27,17
28,Madrid,127,"Rozas de Madrid, Las",95071,46015,49056
28,Madrid,128,Rozas de Puerto Real,534,310,224
28,Madrid,129,San Agustín del Guadalix,13103,6430,6673
28,Madrid,130,San Fernando de Henares,39681,19358,20323
28,Madrid,131,San Lorenzo de El Escorial,18024,8637,9387
28,Madrid,132,San Martín de la Vega,18824,9600,9224
28,Madrid,133,San Martín de Valdeiglesias,8298,4157,4141
28,Madrid,134,San Sebastián de los Reyes,86707,42420,44287
28,Madrid,135,Santa María de la Alameda,1163,616,547
28,Madrid,136,Santorcaz,856,437,419
28,Madrid,137,"Santos de la Humosa, Los",2486,1270,1216
28,Madrid,138,"Serna del Monte, La",73,40,33
28,Madrid,140,Serranillos del Valle,3967,1966,2001
28,Madrid,141,Sevilla la Nueva,9093,4485,4608
28,Madrid,143,Somosierra,77,44,33
28,Madrid,144,Soto del Real,8607,4223,4384
28,Madrid,145,Talamanca de Jarama,3573,1769,1804
28,Madrid,146,Tielmes,2610,1330,1280
28,Madrid,147,Titulcia,1274,651,623
28,Madrid,148,Torrejón de Ardoz,128013,63115,64898
28,Madrid,149,Torrejón de la Calzada,8418,4152,4266
28,Madrid,150,Torrejón de Velasco,4261,2137,2124
28,Madrid,151,Torrelaguna,4712,2381,2331
28,Madrid,152,Torrelodones,23128,11123,12005
28,Madrid,153,Torremocha de Jarama,942,475,467
28,Madrid,154,Torres de la Alameda,7825,4002,3823
28,Madrid,903,Tres Cantos,46046,22349,23697
28,Madrid,155,Valdaracete,643,335,308
28,Madrid,156,Valdeavero,1450,758,692
28,Madrid,157,Valdelaguna,867,438,429
28,Madrid,158,Valdemanco,916,490,426
28,Madrid,159,Valdemaqueda,768,391,377
28,Madrid,160,Valdemorillo,12300,6243,6057
28,Madrid,161,Valdemoro,73976,36694,37282
28,Madrid,162,Valdeolmos-Alalpardo,3906,1987,1919
28,Madrid,163,Valdepiélagos,587,315,272
28,Madrid,164,Valdetorres de Jarama,4316,2193,2123
28,Madrid,165,Valdilecha,2755,1430,1325
28,Madrid,166,Valverde de Alcalá,427,225,202
28,Madrid,167,Velilla de San Antonio,12111,6100,6011
28,Madrid,168,"Vellón, El",1834,968,866
28,Madrid,169,Venturada,2032,1077,955
28,Madrid,171,Villa del Prado,6337,3226,3111
28,Madrid,170,Villaconejos,3350,1700,1650
28,Madrid,172,Villalbilla,13038,6591,6447
28,Madrid,173,Villamanrique de Tajo,694,354,340
28,Madrid,174,Villamanta,2491,1258,1233
28,Madrid,175,Villamantilla,1382,685,697
28,Madrid,176,Villanueva de la Cañada,20320,9913,10407
28,Madrid,178,Villanueva de Perales,1519,771,748
28,Madrid,177,Villanueva del Pardillo,17025,8297,8728
28,Madrid,179,Villar del Olmo,1997,1018,979
28,Madrid,180,Villarejo de Salvanés,7245,3643,3602
28,Madrid,181,Villaviciosa de Odón,27504,13337,14167
28,Madrid,182,Villavieja del Lozoya,267,148,119
28,Madrid,183,Zarzalejo,1596,834,762
29,Málaga,1,Alameda,5384,2714,2670
29,Málaga,2,Alcaucín,2253,1159,1094
29,Málaga,3,Alfarnate,1113,573,540
29,Málaga,4,Alfarnatejo,397,210,187
29,Málaga,5,Algarrobo,6284,3152,3132
29,Málaga,6,Algatocín,778,402,376
29,Málaga,7,Alhaurín de la Torre,39153,19458,19695
29,Málaga,8,Alhaurín el Grande,24720,12350,12370
29,Málaga,9,Almáchar,1814,936,878
29,Málaga,10,Almargen,2004,1025,979
29,Málaga,11,Almogía,3765,1937,1828
29,Málaga,12,Álora,12924,6527,6397
29,Málaga,13,Alozaina,2017,1019,998
29,Málaga,14,Alpandeire,244,125,119
29,Málaga,15,Antequera,41104,20132,20972
29,Málaga,16,Árchez,405,205,200
29,Málaga,17,Archidona,8398,4264,4134
29,Málaga,18,Ardales,2469,1263,1206
29,Málaga,19,Arenas,1190,616,574
29,Málaga,20,Arriate,4094,2015,2079
29,Málaga,21,Atajate,167,89,78
29,Málaga,22,Benadalid,223,111,112
29,Málaga,23,Benahavís,7348,3703,3645
29,Málaga,24,Benalauría,449,237,212
29,Málaga,25,Benalmádena,68859,34082,34777
29,Málaga,26,Benamargosa,1532,791,741
29,Málaga,27,Benamocarra,2988,1515,1473
29,Málaga,28,Benaoján,1497,779,718
29,Málaga,29,Benarrabá,480,240,240
29,Málaga,30,"Borge, El",940,493,447
29,Málaga,31,"Burgo, El",1848,940,908
29,Málaga,32,Campillos,8547,4345,4202
29,Málaga,33,Canillas de Aceituno,1672,891,781
29,Málaga,34,Canillas de Albaida,741,369,372
29,Málaga,35,Cañete la Real,1674,840,834
29,Málaga,36,Carratraca,751,390,361
29,Málaga,37,Cartajima,244,130,114
29,Málaga,38,Cártama,25317,12772,12545
29,Málaga,39,Casabermeja,3442,1806,1636
29,Málaga,40,Casarabonela,2550,1350,1200
29,Málaga,41,Casares,5743,2932,2811
29,Málaga,42,Coín,21562,10824,10738
29,Málaga,43,Colmenar,3383,1742,1641
29,Málaga,44,Comares,1315,718,597
29,Málaga,45,Cómpeta,3847,1930,1917
29,Málaga,46,Cortes de la Frontera,3268,1678,1590
29,Málaga,47,Cuevas Bajas,1416,711,705
29,Málaga,49,Cuevas de San Marcos,3722,1877,1845
29,Málaga,48,Cuevas del Becerro,1608,792,816
29,Málaga,50,Cútar,597,306,291
29,Málaga,51,Estepona,66863,32956,33907
29,Málaga,52,Faraján,248,123,125
29,Málaga,53,Frigiliana,3066,1543,1523
29,Málaga,54,Fuengirola,74929,36642,38287
29,Málaga,55,Fuente de Piedra,2507,1289,1218
29,Málaga,56,Gaucín,1588,830,758
29,Málaga,57,Genalguacil,405,209,196
29,Málaga,58,Guaro,2087,1057,1030
29,Málaga,59,Humilladero,3292,1649,1643
29,Málaga,60,Igualeja,778,393,385
29,Málaga,61,Istán,1432,721,711
29,Málaga,62,Iznate,856,444,412
29,Málaga,63,Jimera de Líbar,396,203,193
29,Málaga,64,Jubrique,589,300,289
29,Málaga,65,Júzcar,226,128,98
29,Málaga,66,Macharaviaya,448,238,210
29,Málaga,67,Málaga,569002,273636,295366
29,Málaga,68,Manilva,14589,7480,7109
29,Málaga,69,Marbella,141172,68127,73045
29,Málaga,70,Mijas,77151,38549,38602
29,Málaga,71,Moclinejo,1204,628,576
29,Málaga,72,Mollina,4924,2484,2440
29,Málaga,73,Monda,2475,1260,1215
29,Málaga,903,Montecorto,630,324,306
29,Málaga,74,Montejaque,997,488,509
29,Málaga,75,Nerja,21047,10398,10649
29,Málaga,76,Ojén,3517,1792,1725
29,Málaga,77,Parauta,209,104,105
29,Málaga,79,Periana,3124,1644,1480
29,Málaga,80,Pizarra,9073,4580,4493
29,Málaga,81,Pujerra,307,160,147
29,Málaga,82,Rincón de la Victoria,45138,22116,23022
29,Málaga,83,Riogordo,2715,1423,1292
29,Málaga,84,Ronda,34268,16665,17603
29,Málaga,85,Salares,175,88,87
29,Málaga,86,Sayalonga,1579,810,769
29,Málaga,87,Sedella,634,354,280
29,Málaga,904,Serrato,494,250,244
29,Málaga,88,Sierra de Yeguas,3363,1703,1660
29,Málaga,89,Teba,3847,1948,1899
29,Málaga,90,Tolox,2062,1045,1017
29,Málaga,901,Torremolinos,67701,33841,33860
29,Málaga,91,Torrox,15371,7843,7528
29,Málaga,92,Totalán,710,373,337
29,Málaga,93,Valle de Abdalajís,2577,1315,1262
29,Málaga,94,Vélez-Málaga,79878,39499,40379
29,Málaga,95,Villanueva de Algaidas,4238,2181,2057
29,Málaga,902,Villanueva de la Concepción,3290,1605,1685
29,Málaga,98,Villanueva de Tapia,1523,772,751
29,Málaga,96,Villanueva del Rosario,3383,1654,1729
29,Málaga,97,Villanueva del Trabuco,5327,2665,2662
29,Málaga,99,Viñuela,2045,1061,984
29,Málaga,100,Yunquera,2926,1496,1430
30,Murcia,1,Abanilla,6158,3122,3036
30,Murcia,2,Abarán,13089,6578,6511
30,Murcia,3,Águilas,34758,17354,17404
30,Murcia,4,Albudeite,1359,694,665
30,Murcia,5,Alcantarilla,41331,20392,20939
30,Murcia,902,"Alcázares, Los",15349,7773,7576
30,Murcia,6,Aledo,945,466,479
30,Murcia,7,Alguazas,9557,4933,4624
30,Murcia,8,Alhama de Murcia,21448,10864,10584
30,Murcia,9,Archena,18771,9817,8954
30,Murcia,10,Beniel,11233,5772,5461
30,Murcia,11,Blanca,6521,3324,3197
30,Murcia,12,Bullas,11546,5804,5742
30,Murcia,13,Calasparra,10214,5172,5042
30,Murcia,14,Campos del Río,2022,958,1064
30,Murcia,15,Caravaca de la Cruz,25633,12795,12838
30,Murcia,16,Cartagena,214177,106988,107189
30,Murcia,17,Cehegín,15193,7636,7557
30,Murcia,18,Ceutí,11472,5751,5721
30,Murcia,19,Cieza,34987,17576,17411
30,Murcia,20,Fortuna,10049,5365,4684
30,Murcia,21,Fuente Álamo de Murcia,16180,8452,7728
30,Murcia,22,Jumilla,25672,13416,12256
30,Murcia,23,Librilla,5160,2632,2528
30,Murcia,24,Lorca,92299,47240,45059
30,Murcia,25,Lorquí,7039,3577,3462
30,Murcia,26,Mazarrón,30996,15992,15004
30,Murcia,27,Molina de Segura,70344,35035,35309
30,Murcia,28,Moratalla,8048,4116,3932
30,Murcia,29,Mula,16713,8558,8155
30,Murcia,30,Murcia,443243,216548,226695
30,Murcia,31,Ojós,494,268,226
30,Murcia,32,Pliego,3873,2008,1865
30,Murcia,33,Puerto Lumbreras,15020,7541,7479
30,Murcia,34,Ricote,1315,695,620
30,Murcia,35,San Javier,31695,15960,15735
30,Murcia,36,San Pedro del Pinatar,24903,12590,12313
30,Murcia,901,Santomera,16058,8120,7938
30,Murcia,37,Torre-Pacheco,35198,18381,16817
30,Murcia,38,"Torres de Cotillas, Las",21420,10884,10536
30,Murcia,39,Totana,31394,16154,15240
30,Murcia,40,Ulea,891,460,431
30,Murcia,41,"Unión, La",19764,10031,9733
30,Murcia,42,Villanueva del Río Segura,2650,1323,1327
30,Murcia,43,Yecla,34092,17123,16969
31,Navarra,1,Abáigar,88,50,38
31,Navarra,2,Abárzuza/Abartzuza,524,259,265
31,Navarra,3,Abaurregaina/Abaurrea Alta,124,77,47
31,Navarra,4,Abaurrepea/Abaurrea Baja,34,21,13
31,Navarra,5,Aberin,358,195,163
31,Navarra,6,Ablitas,2514,1276,1238
31,Navarra,7,Adiós,155,87,68
31,Navarra,8,Aguilar de Codés,72,40,32
31,Navarra,9,Aibar/Oibar,800,424,376
31,Navarra,11,Allín/Allin,853,461,392
31,Navarra,12,Allo,980,494,486
31,Navarra,10,Altsasu/Alsasua,7419,3741,3678
31,Navarra,13,Améscoa Baja,750,397,353
31,Navarra,14,Ancín/Antzin,357,196,161
31,Navarra,15,Andosilla,2718,1379,1339
31,Navarra,16,Ansoáin/Antsoain,10752,5305,5447
31,Navarra,17,Anue,477,260,217
31,Navarra,18,Añorbe,543,302,241
31,Navarra,19,Aoiz/Agoitz,2561,1284,1277
31,Navarra,20,Araitz,523,295,228
31,Navarra,25,Arakil,947,492,455
31,Navarra,21,Aranarache/Aranaratxe,74,44,30
31,Navarra,23,Aranguren,10239,5171,5068
31,Navarra,24,Arano,110,59,51
31,Navarra,22,Arantza,623,334,289
31,Navarra,26,Aras,163,86,77
31,Navarra,27,Arbizu,1119,566,553
31,Navarra,28,Arce/Artzi,271,145,126
31,Navarra,29,"Arcos, Los",1104,549,555
31,Navarra,30,Arellano,159,86,73
31,Navarra,31,Areso,261,134,127
31,Navarra,32,Arguedas,2300,1181,1119
31,Navarra,33,Aria,53,31,22
31,Navarra,34,Aribe,41,22,19
31,Navarra,35,Armañanzas,60,33,27
31,Navarra,36,Arróniz,1044,557,487
31,Navarra,37,Arruazu,101,53,48
31,Navarra,38,Artajona,1658,844,814
31,Navarra,39,Artazu,117,57,60
31,Navarra,40,Atez/Atetz,227,128,99
31,Navarra,58,Auritz/Burguete,244,121,123
31,Navarra,41,Ayegui/Aiegi,2346,1235,1111
31,Navarra,42,Azagra,3843,1973,1870
31,Navarra,43,Azuelo,34,13,21
31,Navarra,44,Bakaiku,345,181,164
31,Navarra,901,Barañáin/Barañain,20124,9733,10391
31,Navarra,45,Barásoain,650,348,302
31,Navarra,46,Barbarin,58,27,31
31,Navarra,47,Bargota,276,135,141
31,Navarra,48,Barillas,218,117,101
31,Navarra,49,Basaburua,850,482,368
31,Navarra,50,Baztan,7736,3909,3827
31,Navarra,137,Beintza-Labaien,232,132,100
31,Navarra,51,Beire,298,152,146
31,Navarra,52,Belascoáin,123,62,61
31,Navarra,250,Bera,3763,1864,1899
31,Navarra,53,Berbinzana,605,309,296
31,Navarra,905,Beriáin,3894,1893,2001
31,Navarra,902,Berrioplano/Berriobeiti,6872,3520,3352
31,Navarra,903,Berriozar,9874,4991,4883
31,Navarra,54,Bertizarana,591,293,298
31,Navarra,55,Betelu,346,184,162
31,Navarra,253,Bidaurreta,169,92,77
31,Navarra,56,Biurrun-Olcoz,207,118,89
31,Navarra,57,Buñuel,2232,1085,1147
31,Navarra,59,Burgui/Burgi,209,120,89
31,Navarra,60,Burlada/Burlata,18591,8981,9610
31,Navarra,61,"Busto, El",62,31,31
31,Navarra,62,Cabanillas,1366,717,649
31,Navarra,63,Cabredo,101,56,45
31,Navarra,64,Cadreita,2028,1057,971
31,Navarra,65,Caparroso,2724,1423,1301
31,Navarra,66,Cárcar,1038,521,517
31,Navarra,67,Carcastillo,2491,1259,1232
31,Navarra,68,Cascante,3780,1878,1902
31,Navarra,69,Cáseda,975,479,496
31,Navarra,70,Castejón,4116,2053,2063
31,Navarra,71,Castillonuevo,17,13,4
31,Navarra,193,Cendea de Olza/Oltza Zendea,1853,932,921
31,Navarra,72,Cintruénigo,7839,4017,3822
31,Navarra,74,Cirauqui/Zirauki,478,260,218
31,Navarra,75,Ciriza/Ziritza,137,64,73
31,Navarra,76,Cizur,3784,1952,1832
31,Navarra,77,Corella,7640,3874,3766
31,Navarra,78,Cortes,3137,1574,1563
31,Navarra,79,Desojo,79,45,34
31,Navarra,80,Dicastillo,612,319,293
31,Navarra,81,Donamaria,434,220,214
31,Navarra,221,Doneztebe/Santesteban,1732,884,848
31,Navarra,83,Echarri/Etxarri,80,40,40
31,Navarra,87,Elgorriaga,203,100,103
31,Navarra,89,Enériz/Eneritz,293,151,142
31,Navarra,90,Eratsun,154,95,59
31,Navarra,91,Ergoiena,399,214,185
31,Navarra,92,Erro,789,441,348
31,Navarra,94,Eslava,118,59,59
31,Navarra,95,Esparza de Salazar/Espartza Zaraitzu,79,42,37
31,Navarra,96,Espronceda,108,60,48
31,Navarra,97,Estella-Lizarra,13707,6593,7114
31,Navarra,98,Esteribar,2629,1362,1267
31,Navarra,99,Etayo,70,38,32
31,Navarra,82,Etxalar,808,434,374
31,Navarra,84,Etxarri Aranatz,2464,1280,1184
31,Navarra,85,Etxauri,602,317,285
31,Navarra,100,Eulate,289,164,125
31,Navarra,101,Ezcabarte,1797,932,865
31,Navarra,93,Ezcároz/Ezkaroze,313,169,144
31,Navarra,102,Ezkurra,154,101,53
31,Navarra,103,Ezprogui,44,22,22
31,Navarra,104,Falces,2313,1166,1147
31,Navarra,105,Fitero,2034,1029,1005
31,Navarra,106,Fontellas,963,484,479
31,Navarra,107,Funes,2482,1330,1152
31,Navarra,108,Fustiñana,2466,1219,1247
31,Navarra,109,Galar,2194,1155,1039
31,Navarra,110,Gallipienzo/Galipentzu,99,57,42
31,Navarra,111,Gallués/Galoze,104,67,37
31,Navarra,112,Garaioa,89,51,38
31,Navarra,113,Garde,148,91,57
31,Navarra,114,Garínoain,456,249,207
31,Navarra,115,Garralda,184,97,87
31,Navarra,116,Genevilla,76,46,30
31,Navarra,117,Goizueta,717,385,332
31,Navarra,118,Goñi,169,108,61
31,Navarra,119,Güesa/Gorza,44,25,19
31,Navarra,120,Guesálaz/Gesalatz,454,265,189
31,Navarra,121,Guirguillano,76,41,35
31,Navarra,256,Hiriberri/Villanueva de Aezkoa,110,59,51
31,Navarra,122,Huarte/Uharte,6917,3483,3434
31,Navarra,124,Ibargoiti,247,145,102
31,Navarra,259,Igantzi,626,325,301
31,Navarra,125,Igúzquiza,338,177,161
31,Navarra,126,Imotz,430,224,206
31,Navarra,127,Irañeta,174,95,79
31,Navarra,904,Irurtzun,2183,1129,1054
31,Navarra,128,Isaba/Izaba,429,212,217
31,Navarra,129,Ituren,519,267,252
31,Navarra,130,Iturmendi,398,205,193
31,Navarra,131,Iza/Itza,1192,638,554
31,Navarra,132,Izagaondoa,183,118,65
31,Navarra,133,Izalzu/Itzaltzu,48,29,19
31,Navarra,134,Jaurrieta,186,103,83
31,Navarra,135,Javier,102,33,69
31,Navarra,136,Juslapeña,550,294,256
31,Navarra,138,Lakuntza,1262,655,607
31,Navarra,139,Lana,166,95,71
31,Navarra,140,Lantz,153,90,63
31,Navarra,141,Lapoblación,125,69,56
31,Navarra,142,Larraga,2060,1091,969
31,Navarra,143,Larraona,104,50,54
31,Navarra,144,Larraun,974,531,443
31,Navarra,145,Lazagurría,193,99,94
31,Navarra,146,Leache/Leatxe,35,21,14
31,Navarra,147,Legarda,110,60,50
31,Navarra,148,Legaria,98,41,57
31,Navarra,149,Leitza,2856,1486,1370
31,Navarra,908,Lekunberri,1502,741,761
31,Navarra,150,Leoz/Leotz,232,146,86
31,Navarra,151,Lerga,70,42,28
31,Navarra,152,Lerín,1654,843,811
31,Navarra,153,Lesaka,2737,1420,1317
31,Navarra,154,Lezáun,252,148,104
31,Navarra,155,Liédena,301,156,145
31,Navarra,156,Lizoáin-Arriasgoiti,295,172,123
31,Navarra,157,Lodosa,4730,2395,2335
31,Navarra,158,Lónguida/Longida,303,162,141
31,Navarra,159,Lumbier,1336,725,611
31,Navarra,160,Luquin,128,69,59
31,Navarra,248,Luzaide/Valcarlos,387,230,157
31,Navarra,161,Mañeru,422,223,199
31,Navarra,162,Marañón,51,25,26
31,Navarra,163,Marcilla,2828,1422,1406
31,Navarra,164,Mélida,718,366,352
31,Navarra,165,Mendavia,3570,1840,1730
31,Navarra,166,Mendaza,301,158,143
31,Navarra,167,Mendigorría,1044,547,497
31,Navarra,168,Metauten,285,158,127
31,Navarra,169,Milagro,3400,1796,1604
31,Navarra,170,Mirafuentes,56,26,30
31,Navarra,171,Miranda de Arga,855,446,409
31,Navarra,172,Monreal/Elo,479,258,221
31,Navarra,173,Monteagudo,1078,537,541
31,Navarra,174,Morentin,126,61,65
31,Navarra,175,Mues,82,44,38
31,Navarra,176,Murchante,3944,1974,1970
31,Navarra,177,Murieta,334,181,153
31,Navarra,178,Murillo el Cuende,659,342,317
31,Navarra,179,Murillo el Fruto,603,313,290
31,Navarra,180,Muruzábal,241,103,138
31,Navarra,181,Navascués/Nabaskoze,145,86,59
31,Navarra,182,Nazar,39,23,16
31,Navarra,88,Noáin (Valle de Elorz)/Noain (Elortzibar),8115,4094,4021
31,Navarra,183,Obanos,906,455,451
31,Navarra,185,Ochagavía/Otsagabia,534,283,251
31,Navarra,184,Oco,77,39,38
31,Navarra,186,Odieta,362,200,162
31,Navarra,187,Oiz,130,76,54
31,Navarra,188,Olaibar,363,203,160
31,Navarra,189,Olazti/Olazagutía,1518,781,737
31,Navarra,190,Olejua,53,29,24
31,Navarra,191,Olite/Erriberri,3927,1992,1935
31,Navarra,192,Olóriz/Oloritz,198,112,86
31,Navarra,195,Orbaizeta,200,99,101
31,Navarra,196,Orbara,38,20,18
31,Navarra,197,Orísoain,85,45,40
31,Navarra,906,Orkoien,3910,1960,1950
31,Navarra,198,Oronz/Orontze,48,27,21
31,Navarra,199,Oroz-Betelu/Orotz-Betelu,149,85,64
31,Navarra,211,Orreaga/Roncesvalles,21,11,10
31,Navarra,200,Oteiza,922,485,437
31,Navarra,201,Pamplona/Iruña,197138,93388,103750
31,Navarra,202,Peralta/Azkoien,5828,2936,2892
31,Navarra,203,Petilla de Aragón,34,20,14
31,Navarra,204,Piedramillera,37,24,13
31,Navarra,205,Pitillas,492,244,248
31,Navarra,206,Puente la Reina/Gares,2805,1431,1374
31,Navarra,207,Pueyo,340,184,156
31,Navarra,208,Ribaforada,3704,1926,1778
31,Navarra,209,Romanzado,180,96,84
31,Navarra,210,Roncal/Erronkari,213,114,99
31,Navarra,212,Sada,151,83,68
31,Navarra,213,Saldías,119,69,50
31,Navarra,214,Salinas de Oro/Jaitz,113,64,49
31,Navarra,215,San Adrián,6214,3085,3129
31,Navarra,217,San Martín de Unx,383,199,184
31,Navarra,216,Sangüesa/Zangoza,5002,2556,2446
31,Navarra,219,Sansol,102,55,47
31,Navarra,220,Santacara,868,445,423
31,Navarra,222,Sarriés/Sartze,64,41,23
31,Navarra,223,Sartaguda,1316,672,644
31,Navarra,224,Sesma,1152,586,566
31,Navarra,225,Sorlada,52,30,22
31,Navarra,226,Sunbilla,675,348,327
31,Navarra,227,Tafalla,10638,5244,5394
31,Navarra,228,Tiebas-Muruarte de Reta,613,314,299
31,Navarra,229,Tirapu,45,28,17
31,Navarra,230,Torralba del Río,110,58,52
31,Navarra,231,Torres del Río,128,61,67
31,Navarra,232,Tudela,35298,17339,17959
31,Navarra,233,Tulebras,123,50,73
31,Navarra,234,Ucar,183,104,79
31,Navarra,123,Uharte Arakil,828,435,393
31,Navarra,235,Ujué,171,100,71
31,Navarra,236,Ultzama,1661,860,801
31,Navarra,237,Unciti,217,126,91
31,Navarra,238,Unzué/Untzue,136,71,65
31,Navarra,239,Urdazubi/Urdax,394,191,203
31,Navarra,240,Urdiain,671,354,317
31,Navarra,241,Urraul Alto,144,93,51
31,Navarra,242,Urraul Bajo,305,135,170
31,Navarra,244,Urroz,185,104,81
31,Navarra,243,Urroz-Villa,385,206,179
31,Navarra,245,Urzainqui/Urzainki,85,54,31
31,Navarra,246,Uterga,164,96,68
31,Navarra,247,Uztárroz/Uztarroze,146,71,75
31,Navarra,86,Valle de Egüés/Eguesibar,20417,10283,10134
31,Navarra,194,Valle de Ollo/Ollaran,399,213,186
31,Navarra,260,Valle de Yerri/Deierri,1513,777,736
31,Navarra,249,Valtierra,2384,1188,1196
31,Navarra,251,Viana,4078,2064,2014
31,Navarra,252,Vidángoz/Bidankoze,95,51,44
31,Navarra,254,Villafranca,2845,1426,1419
31,Navarra,255,Villamayor de Monjardín,115,61,54
31,Navarra,257,Villatuerta,1178,587,591
31,Navarra,258,Villava/Atarrabia,10217,5001,5216
31,Navarra,261,Yesa,291,167,124
31,Navarra,262,Zabalza/Zabaltza,294,158,136
31,Navarra,73,Ziordia,357,185,172
31,Navarra,907,Zizur Mayor/Zizur Nagusia,14686,7185,7501
31,Navarra,263,Zubieta,308,160,148
31,Navarra,264,Zugarramurdi,232,116,116
31,Navarra,265,Zúñiga,108,69,39
32,Ourense,1,Allariz,6026,3029,2997
32,Ourense,2,Amoeiro,2231,1102,1129
32,Ourense,3,"Arnoia, A",1013,507,506
32,Ourense,4,Avión,1860,852,1008
32,Ourense,5,Baltar,957,514,443
32,Ourense,6,Bande,1618,785,833
32,Ourense,7,Baños de Molgas,1623,797,826
32,Ourense,8,Barbadás,10791,5274,5517
32,Ourense,9,"Barco de Valdeorras, O",13581,6620,6961
32,Ourense,10,Beade,411,224,187
32,Ourense,11,Beariz,982,431,551
32,Ourense,12,"Blancos, Os",812,442,370
32,Ourense,13,Boborás,2375,1116,1259
32,Ourense,14,"Bola, A",1251,592,659
32,Ourense,15,"Bolo, O",938,470,468
32,Ourense,16,Calvos de Randín,818,403,415
32,Ourense,18,Carballeda de Avia,1356,658,698
32,Ourense,17,Carballeda de Valdeorras,1623,834,789
32,Ourense,19,"Carballiño, O",13854,6491,7363
32,Ourense,20,Cartelle,2683,1314,1369
32,Ourense,22,Castrelo de Miño,1445,726,719
32,Ourense,21,Castrelo do Val,1028,526,502
32,Ourense,23,Castro Caldelas,1298,658,640
32,Ourense,24,Celanova,5455,2601,2854
32,Ourense,25,Cenlle,1176,575,601
32,Ourense,29,Chandrexa de Queixa,494,280,214
32,Ourense,26,Coles,3077,1546,1531
32,Ourense,27,Cortegada,1125,554,571
32,Ourense,28,Cualedro,1721,883,838
32,Ourense,30,Entrimo,1184,562,622
32,Ourense,31,Esgos,1154,588,566
32,Ourense,33,Gomesende,778,378,400
32,Ourense,34,"Gudiña, A",1360,714,646
32,Ourense,35,"Irixo, O",1519,732,787
32,Ourense,38,Larouco,472,226,246
32,Ourense,39,Laza,1331,688,643
32,Ourense,40,Leiro,1601,764,837
32,Ourense,41,Lobeira,825,396,429
32,Ourense,42,Lobios,1795,905,890
32,Ourense,43,Maceda,2924,1431,1493
32,Ourense,44,Manzaneda,906,443,463
32,Ourense,45,Maside,2797,1373,1424
32,Ourense,46,Melón,1254,597,657
32,Ourense,47,"Merca, A",1924,935,989
32,Ourense,48,"Mezquita, A",1034,541,493
32,Ourense,49,Montederramo,760,392,368
32,Ourense,50,Monterrei,2655,1346,1309
32,Ourense,51,Muíños,1514,768,746
32,Ourense,52,Nogueira de Ramuín,2033,1028,1005
32,Ourense,53,Oímbra,1818,989,829
32,Ourense,54,Ourense,105636,48117,57519
32,Ourense,55,Paderne de Allariz,1414,698,716
32,Ourense,56,Padrenda,1838,876,962
32,Ourense,57,Parada de Sil,593,314,279
32,Ourense,58,"Pereiro de Aguiar, O",6228,3215,3013
32,Ourense,59,"Peroxa, A",1902,936,966
32,Ourense,60,Petín,921,456,465
32,Ourense,61,Piñor,1172,590,582
32,Ourense,63,"Pobra de Trives, A",2150,1069,1081
32,Ourense,64,Pontedeva,570,283,287
32,Ourense,62,Porqueira,848,416,432
32,Ourense,65,Punxín,713,346,367
32,Ourense,66,Quintela de Leirado,615,271,344
32,Ourense,67,Rairiz de Veiga,1330,678,652
32,Ourense,68,Ramirás,1550,700,850
32,Ourense,69,Ribadavia,5095,2479,2616
32,Ourense,71,Riós,1609,813,796
32,Ourense,72,"Rúa, A",4459,2189,2270
32,Ourense,73,Rubiá,1462,715,747
32,Ourense,74,San Amaro,1112,538,574
32,Ourense,75,San Cibrao das Viñas,5184,2629,2555
32,Ourense,76,San Cristovo de Cea,2241,1104,1137
32,Ourense,70,San Xoán de Río,561,278,283
32,Ourense,77,Sandiás,1261,580,681
32,Ourense,78,Sarreaus,1220,617,603
32,Ourense,79,Taboadela,1458,747,711
32,Ourense,80,"Teixeira, A",339,170,169
32,Ourense,81,Toén,2377,1224,1153
32,Ourense,82,Trasmiras,1327,663,664
32,Ourense,83,"Veiga, A",907,459,448
32,Ourense,84,Verea,956,458,498
32,Ourense,85,Verín,13889,6710,7179
32,Ourense,86,Viana do Bolo,2964,1492,1472
32,Ourense,87,Vilamarín,1940,986,954
32,Ourense,88,Vilamartín de Valdeorras,1771,923,848
32,Ourense,89,Vilar de Barrio,1360,688,672
32,Ourense,90,Vilar de Santos,850,416,434
32,Ourense,91,Vilardevós,1971,1026,945
32,Ourense,92,Vilariño de Conso,558,322,236
32,Ourense,32,Xinzo de Limia,9875,4801,5074
32,Ourense,36,Xunqueira de Ambía,1438,721,717
32,Ourense,37,Xunqueira de Espadanedo,756,376,380
34,Palencia,1,Abarca de Campos,43,27,16
34,Palencia,3,Abia de las Torres,174,95,79
34,Palencia,4,Aguilar de Campoo,6916,3362,3554
34,Palencia,5,Alar del Rey,944,465,479
34,Palencia,6,Alba de Cerrato,87,48,39
34,Palencia,9,Amayuelas de Arriba,36,24,12
34,Palencia,10,Ampudia,621,320,301
34,Palencia,11,Amusco,431,238,193
34,Palencia,12,Antigüedad,368,198,170
34,Palencia,15,Arconada,43,25,18
34,Palencia,17,Astudillo,1012,508,504
34,Palencia,18,Autilla del Pino,235,130,105
34,Palencia,19,Autillo de Campos,136,72,64
34,Palencia,20,Ayuela,53,33,20
34,Palencia,22,Baltanás,1234,640,594
34,Palencia,24,Baquerín de Campos,33,22,11
34,Palencia,25,Bárcena de Campos,62,28,34
34,Palencia,27,Barruelo de Santullán,1203,590,613
34,Palencia,28,Báscones de Ojeda,149,80,69
34,Palencia,29,Becerril de Campos,769,402,367
34,Palencia,31,Belmonte de Campos,32,18,14
34,Palencia,32,Berzosilla,44,23,21
34,Palencia,33,Boada de Campos,17,12,5
34,Palencia,35,Boadilla de Rioseco,117,68,49
34,Palencia,34,Boadilla del Camino,117,66,51
34,Palencia,36,Brañosera,250,144,106
34,Palencia,37,Buenavista de Valdavia,275,152,123
34,Palencia,38,Bustillo de la Vega,310,171,139
34,Palencia,39,Bustillo del Páramo de Carrión,62,36,26
34,Palencia,41,Calahorra de Boedo,94,46,48
34,Palencia,42,Calzada de los Molinos,338,190,148
34,Palencia,45,Capillas,77,39,38
34,Palencia,46,Cardeñosa de Volpejera,43,24,19
34,Palencia,47,Carrión de los Condes,2118,1002,1116
34,Palencia,48,Castil de Vela,64,33,31
34,Palencia,49,Castrejón de la Peña,371,200,171
34,Palencia,50,Castrillo de Don Juan,230,127,103
34,Palencia,51,Castrillo de Onielo,102,54,48
34,Palencia,52,Castrillo de Villavega,187,102,85
34,Palencia,53,Castromocho,222,120,102
34,Palencia,55,Cervatos de la Cueza,278,157,121
34,Palencia,56,Cervera de Pisuerga,2359,1185,1174
34,Palencia,57,Cevico de la Torre,490,239,251
34,Palencia,58,Cevico Navero,211,113,98
34,Palencia,59,Cisneros,445,219,226
34,Palencia,60,Cobos de Cerrato,142,79,63
34,Palencia,61,Collazos de Boedo,107,60,47
34,Palencia,62,Congosto de Valdavia,173,107,66
34,Palencia,63,Cordovilla la Real,94,56,38
34,Palencia,66,Cubillas de Cerrato,69,40,29
34,Palencia,67,Dehesa de Montejo,138,79,59
34,Palencia,68,Dehesa de Romanos,41,24,17
34,Palencia,69,Dueñas,2658,1357,1301
34,Palencia,70,Espinosa de Cerrato,158,81,77
34,Palencia,71,Espinosa de Villagonzalo,186,98,88
34,Palencia,72,Frechilla,159,81,78
34,Palencia,73,Fresno del Río,200,98,102
34,Palencia,74,Frómista,790,405,385
34,Palencia,76,Fuentes de Nava,673,349,324
34,Palencia,77,Fuentes de Valdepero,425,220,205
34,Palencia,79,Grijota,2212,1140,1072
34,Palencia,80,Guardo,6279,3129,3150
34,Palencia,81,Guaza de Campos,59,35,24
34,Palencia,82,Hérmedes de Cerrato,81,45,36
34,Palencia,83,Herrera de Pisuerga,2056,1003,1053
34,Palencia,84,Herrera de Valdecañas,147,81,66
34,Palencia,86,Hontoria de Cerrato,102,52,50
34,Palencia,87,Hornillos de Cerrato,145,80,65
34,Palencia,88,Husillos,303,170,133
34,Palencia,89,Itero de la Vega,165,92,73
34,Palencia,91,Lagartos,136,77,59
34,Palencia,92,Lantadilla,305,162,143
34,Palencia,94,Ledigos,67,38,29
34,Palencia,903,Loma de Ucieza,208,121,87
34,Palencia,96,Lomas,53,33,20
34,Palencia,98,Magaz de Pisuerga,981,518,463
34,Palencia,99,Manquillos,84,45,39
34,Palencia,100,Mantinos,146,82,64
34,Palencia,101,Marcilla de Campos,36,17,19
34,Palencia,102,Mazariegos,215,124,91
34,Palencia,103,Mazuecos de Valdeginate,95,57,38
34,Palencia,104,Melgar de Yuso,256,148,108
34,Palencia,106,Meneses de Campos,117,62,55
34,Palencia,107,Micieces de Ojeda,80,46,34
34,Palencia,108,Monzón de Campos,616,316,300
34,Palencia,109,Moratinos,58,35,23
34,Palencia,110,Mudá,87,48,39
34,Palencia,112,Nogal de las Huertas,48,27,21
34,Palencia,113,Olea de Boedo,38,14,24
34,Palencia,114,Olmos de Ojeda,201,121,80
34,Palencia,116,Osornillo,61,31,30
34,Palencia,901,Osorno la Mayor,1252,656,596
34,Palencia,120,Palencia,78892,37207,41685
34,Palencia,121,Palenzuela,212,114,98
34,Palencia,122,Páramo de Boedo,116,63,53
34,Palencia,123,Paredes de Nava,1923,989,934
34,Palencia,124,Payo de Ojeda,64,38,26
34,Palencia,125,Pedraza de Campos,88,44,44
34,Palencia,126,Pedrosa de la Vega,341,186,155
34,Palencia,127,Perales,95,51,44
34,Palencia,904,"Pernía, La",324,185,139
34,Palencia,129,Pino del Río,184,114,70
34,Palencia,130,Piña de Campos,230,119,111
34,Palencia,131,Población de Arroyo,61,33,28
34,Palencia,132,Población de Campos,137,76,61
34,Palencia,133,Población de Cerrato,116,64,52
34,Palencia,134,Polentinos,44,25,19
34,Palencia,135,Pomar de Valdivia,467,264,203
34,Palencia,136,Poza de la Vega,197,114,83
34,Palencia,137,Pozo de Urama,25,17,8
34,Palencia,139,Prádanos de Ojeda,193,104,89
34,Palencia,140,"Puebla de Valdavia, La",108,57,51
34,Palencia,141,Quintana del Puente,255,141,114
34,Palencia,143,Quintanilla de Onsoña,186,110,76
34,Palencia,146,Reinoso de Cerrato,51,34,17
34,Palencia,147,Renedo de la Vega,195,105,90
34,Palencia,149,Requena de Campos,22,11,11
34,Palencia,151,Respenda de la Peña,161,95,66
34,Palencia,152,Revenga de Campos,148,78,70
34,Palencia,154,Revilla de Collazos,80,44,36
34,Palencia,155,Ribas de Campos,150,77,73
34,Palencia,156,Riberos de la Cueza,54,35,19
34,Palencia,157,Saldaña,3067,1552,1515
34,Palencia,158,Salinas de Pisuerga,334,179,155
34,Palencia,159,San Cebrián de Campos,445,248,197
34,Palencia,160,San Cebrián de Mudá,159,84,75
34,Palencia,161,San Cristóbal de Boedo,23,14,9
34,Palencia,163,San Mamés de Campos,53,26,27
34,Palencia,165,San Román de la Cuba,68,39,29
34,Palencia,167,Santa Cecilia del Alcor,121,69,52
34,Palencia,168,Santa Cruz de Boedo,53,32,21
34,Palencia,169,Santervás de la Vega,466,260,206
34,Palencia,170,Santibáñez de Ecla,58,32,26
34,Palencia,171,Santibáñez de la Peña,1060,529,531
34,Palencia,174,Santoyo,206,110,96
34,Palencia,175,"Serna, La",97,61,36
34,Palencia,177,Soto de Cerrato,188,108,80
34,Palencia,176,Sotobañado y Priorato,150,91,59
34,Palencia,178,Tabanera de Cerrato,146,78,68
34,Palencia,179,Tabanera de Valdavia,26,15,11
34,Palencia,180,Támara de Campos,71,37,34
34,Palencia,181,Tariego de Cerrato,513,274,239
34,Palencia,182,Torquemada,989,532,457
34,Palencia,184,Torremormojón,57,31,26
34,Palencia,185,Triollo,61,33,28
34,Palencia,186,Valbuena de Pisuerga,49,27,22
34,Palencia,189,Valdeolmillos,64,38,26
34,Palencia,190,Valderrábano,55,28,27
34,Palencia,192,Valde-Ucieza,96,57,39
34,Palencia,196,Valle de Cerrato,90,54,36
34,Palencia,902,Valle del Retortillo,177,101,76
34,Palencia,199,Velilla del Río Carrión,1330,675,655
34,Palencia,23,Venta de Baños,6429,3227,3202
34,Palencia,201,Vertavillo,196,105,91
34,Palencia,93,"Vid de Ojeda, La",98,60,38
34,Palencia,202,Villabasta de Valdavia,30,16,14
34,Palencia,204,Villacidaler,46,27,19
34,Palencia,205,Villaconancio,65,37,28
34,Palencia,206,Villada,1002,504,498
34,Palencia,208,Villaeles de Valdavia,52,31,21
34,Palencia,210,Villahán,105,54,51
34,Palencia,211,Villaherreros,203,105,98
34,Palencia,213,Villalaco,59,33,26
34,Palencia,214,Villalba de Guardo,198,107,91
34,Palencia,215,Villalcázar de Sirga,172,93,79
34,Palencia,216,Villalcón,68,40,28
34,Palencia,217,Villalobón,1612,808,804
34,Palencia,218,Villaluenga de la Vega,575,324,251
34,Palencia,220,Villamartín de Campos,172,95,77
34,Palencia,221,Villamediana,184,100,84
34,Palencia,222,Villameriel,122,70,52
34,Palencia,223,Villamoronta,244,140,104
34,Palencia,224,Villamuera de la Cueza,46,29,17
34,Palencia,225,Villamuriel de Cerrato,6483,3338,3145
34,Palencia,227,Villanueva del Rebollar,76,38,38
34,Palencia,228,Villanuño de Valdavia,95,54,41
34,Palencia,229,Villaprovedo,68,45,23
34,Palencia,230,Villarmentero de Campos,23,13,10
34,Palencia,231,Villarrabé,215,115,100
34,Palencia,232,Villarramiel,833,452,381
34,Palencia,233,Villasarracino,139,82,57
34,Palencia,234,Villasila de Valdavia,72,48,24
34,Palencia,236,Villaturde,166,87,79
34,Palencia,237,Villaumbrales,676,342,334
34,Palencia,238,Villaviudas,379,184,195
34,Palencia,240,Villerías de Campos,97,53,44
34,Palencia,241,Villodre,17,10,7
34,Palencia,242,Villodrigo,115,65,50
34,Palencia,243,Villoldo,358,189,169
34,Palencia,245,Villota del Páramo,333,191,142
34,Palencia,246,Villovieco,72,38,34
35,"Palmas, Las",1,Agaete,5526,2757,2769
35,"Palmas, Las",2,Agüimes,30882,15668,15214
35,"Palmas, Las",20,"Aldea de San Nicolás, La",7613,3894,3719
35,"Palmas, Las",3,Antigua,11405,6096,5309
35,"Palmas, Las",4,Arrecife,59771,29961,29810
35,"Palmas, Las",5,Artenara,1096,592,504
35,"Palmas, Las",6,Arucas,37367,18578,18789
35,"Palmas, Las",7,Betancuria,710,373,337
35,"Palmas, Las",8,Firgas,7570,3814,3756
35,"Palmas, Las",9,Gáldar,24251,12167,12084
35,"Palmas, Las",10,Haría,4858,2473,2385
35,"Palmas, Las",11,Ingenio,30529,15398,15131
35,"Palmas, Las",12,Mogán,19783,10216,9567
35,"Palmas, Las",13,Moya,7792,3954,3838
35,"Palmas, Las",14,"Oliva, La",25349,13251,12098
35,"Palmas, Las",15,Pájara,19823,10302,9521
35,"Palmas, Las",16,"Palmas de Gran Canaria, Las",377650,182881,194769
35,"Palmas, Las",17,Puerto del Rosario,38711,19650,19061
35,"Palmas, Las",18,San Bartolomé,18249,9187,9062
35,"Palmas, Las",19,San Bartolomé de Tirajana,53542,27845,25697
35,"Palmas, Las",21,Santa Brígida,18295,9102,9193
35,"Palmas, Las",22,Santa Lucía de Tirajana,70396,35183,35213
35,"Palmas, Las",23,Santa María de Guía de Gran Canaria,13924,6918,7006
35,"Palmas, Las",24,Teguise,21896,11086,10810
35,"Palmas, Las",25,Tejeda,1950,1046,904
35,"Palmas, Las",26,Telde,102005,50320,51685
35,"Palmas, Las",27,Teror,12424,6393,6031
35,"Palmas, Las",28,Tías,19964,10219,9745
35,"Palmas, Las",29,Tinajo,6028,3123,2905
35,"Palmas, Las",30,Tuineje,14301,7313,6988
35,"Palmas, Las",32,Valleseco,3810,1993,1817
35,"Palmas, Las",31,Valsequillo de Gran Canaria,9191,4631,4560
35,"Palmas, Las",33,Vega de San Mateo,7562,3894,3668
35,"Palmas, Las",34,Yaiza,16257,8438,7819
36,Pontevedra,20,Agolada,2431,1215,1216
36,Pontevedra,1,Arbo,2711,1384,1327
36,Pontevedra,3,Baiona,12169,6018,6151
36,Pontevedra,2,Barro,3699,1842,1857
36,Pontevedra,4,Bueu,12145,5988,6157
36,Pontevedra,5,Caldas de Reis,9825,4750,5075
36,Pontevedra,6,Cambados,13900,6711,7189
36,Pontevedra,7,Campo Lameiro,1867,882,985
36,Pontevedra,8,Cangas,26490,13080,13410
36,Pontevedra,9,"Cañiza, A",5233,2546,2687
36,Pontevedra,10,Catoira,3337,1623,1714
36,Pontevedra,902,Cerdedo-Cotobade,6107,2913,3194
36,Pontevedra,13,Covelo,2505,1245,1260
36,Pontevedra,14,Crecente,2082,997,1085
36,Pontevedra,15,Cuntis,4750,2255,2495
36,Pontevedra,16,Dozón,1179,611,568
36,Pontevedra,17,"Estrada, A",20700,9962,10738
36,Pontevedra,18,Forcarei,3523,1674,1849
36,Pontevedra,19,Fornelos de Montes,1694,810,884
36,Pontevedra,21,Gondomar,14233,7066,7167
36,Pontevedra,22,"Grove, O",10746,5305,5441
36,Pontevedra,23,"Guarda, A",10051,4889,5162
36,Pontevedra,901,"Illa de Arousa, A",4968,2461,2507
36,Pontevedra,24,Lalín,20075,9751,10324
36,Pontevedra,25,"Lama, A",2478,1217,1261
36,Pontevedra,26,Marín,24637,12324,12313
36,Pontevedra,27,Meaño,5318,2594,2724
36,Pontevedra,28,Meis,4788,2281,2507
36,Pontevedra,29,Moaña,19439,9429,10010
36,Pontevedra,30,Mondariz,4548,2230,2318
36,Pontevedra,31,Mondariz-Balneario,627,326,301
36,Pontevedra,32,Moraña,4246,2057,2189
36,Pontevedra,33,Mos,15132,7487,7645
36,Pontevedra,34,"Neves, As",3968,1915,2053
36,Pontevedra,35,Nigrán,17622,8647,8975
36,Pontevedra,36,Oia,3004,1498,1506
36,Pontevedra,37,Pazos de Borbén,2991,1450,1541
36,Pontevedra,41,Poio,16871,8355,8516
36,Pontevedra,43,Ponte Caldelas,5562,2676,2886
36,Pontevedra,42,Ponteareas,22893,11146,11747
36,Pontevedra,44,Pontecesures,3037,1512,1525
36,Pontevedra,38,Pontevedra,82671,39194,43477
36,Pontevedra,39,"Porriño, O",19600,9652,9948
36,Pontevedra,40,Portas,3016,1442,1574
36,Pontevedra,45,Redondela,29392,14313,15079
36,Pontevedra,46,Ribadumia,5081,2486,2595
36,Pontevedra,47,Rodeiro,2567,1304,1263
36,Pontevedra,48,"Rosal, O",6328,3110,3218
36,Pontevedra,49,Salceda de Caselas,9017,4498,4519
36,Pontevedra,50,Salvaterra de Miño,9657,4813,4844
36,Pontevedra,51,Sanxenxo,17241,8523,8718
36,Pontevedra,52,Silleda,8669,4215,4454
36,Pontevedra,53,Soutomaior,7242,3580,3662
36,Pontevedra,54,Tomiño,13585,6836,6749
36,Pontevedra,55,Tui,16860,8123,8737
36,Pontevedra,56,Valga,5986,2933,3053
36,Pontevedra,57,Vigo,292986,138867,154119
36,Pontevedra,59,Vila de Cruces,5389,2641,2748
36,Pontevedra,58,Vilaboa,6023,2933,3090
36,Pontevedra,60,Vilagarcía de Arousa,37479,17955,19524
36,Pontevedra,61,Vilanova de Arousa,10361,5077,5284
26,"Rioja, La",1,Ábalos,249,146,103
26,"Rioja, La",2,Agoncillo,1072,582,490
26,"Rioja, La",3,Aguilar del Río Alhama,479,239,240
26,"Rioja, La",4,Ajamil de Cameros,66,46,20
26,"Rioja, La",5,Albelda de Iregua,3408,1735,1673
26,"Rioja, La",6,Alberite,2412,1219,1193
26,"Rioja, La",7,Alcanadre,663,347,316
26,"Rioja, La",8,Aldeanueva de Ebro,2730,1426,1304
26,"Rioja, La",9,Alesanco,508,269,239
26,"Rioja, La",10,Alesón,107,65,42
26,"Rioja, La",11,Alfaro,9503,4770,4733
26,"Rioja, La",12,Almarza de Cameros,26,16,10
26,"Rioja, La",13,Anguciana,433,238,195
26,"Rioja, La",14,Anguiano,506,282,224
26,"Rioja, La",15,Arenzana de Abajo,239,126,113
26,"Rioja, La",16,Arenzana de Arriba,30,21,9
26,"Rioja, La",17,Arnedillo,451,223,228
26,"Rioja, La",18,Arnedo,14756,7333,7423
26,"Rioja, La",19,Arrúbal,479,261,218
26,"Rioja, La",20,Ausejo,754,398,356
26,"Rioja, La",21,Autol,4507,2237,2270
26,"Rioja, La",22,Azofra,204,108,96
26,"Rioja, La",23,Badarán,507,257,250
26,"Rioja, La",24,Bañares,240,128,112
26,"Rioja, La",26,Baños de Río Tobía,1600,798,802
26,"Rioja, La",25,Baños de Rioja,91,54,37
26,"Rioja, La",27,Berceo,166,107,59
26,"Rioja, La",28,Bergasa,147,81,66
26,"Rioja, La",29,Bergasillas Bajera,38,20,18
26,"Rioja, La",30,Bezares,20,10,10
26,"Rioja, La",31,Bobadilla,111,57,54
26,"Rioja, La",32,Brieva de Cameros,53,31,22
26,"Rioja, La",33,Briñas,202,91,111
26,"Rioja, La",34,Briones,784,415,369
26,"Rioja, La",35,Cabezón de Cameros,16,12,4
26,"Rioja, La",36,Calahorra,23737,11641,12096
26,"Rioja, La",37,Camprovín,148,81,67
26,"Rioja, La",38,Canales de la Sierra,87,57,30
26,"Rioja, La",39,Canillas de Río Tuerto,38,18,20
26,"Rioja, La",40,Cañas,103,57,46
26,"Rioja, La",41,Cárdenas,151,81,70
26,"Rioja, La",42,Casalarreina,1150,586,564
26,"Rioja, La",43,Castañares de Rioja,430,210,220
26,"Rioja, La",44,Castroviejo,55,35,20
26,"Rioja, La",45,Cellorigo,12,5,7
26,"Rioja, La",46,Cenicero,2016,1016,1000
26,"Rioja, La",47,Cervera del Río Alhama,2346,1204,1142
26,"Rioja, La",48,Cidamón,24,12,12
26,"Rioja, La",49,Cihuri,200,106,94
26,"Rioja, La",50,Cirueña,139,92,47
26,"Rioja, La",51,Clavijo,281,166,115
26,"Rioja, La",52,Cordovín,155,77,78
26,"Rioja, La",53,Corera,255,133,122
26,"Rioja, La",54,Cornago,337,196,141
26,"Rioja, La",55,Corporales,41,23,18
26,"Rioja, La",56,Cuzcurrita de Río Tirón,496,275,221
26,"Rioja, La",57,Daroca de Rioja,45,31,14
26,"Rioja, La",58,Enciso,173,108,65
26,"Rioja, La",59,Entrena,1499,782,717
26,"Rioja, La",60,Estollo,95,64,31
26,"Rioja, La",61,Ezcaray,2044,1061,983
26,"Rioja, La",62,Foncea,93,52,41
26,"Rioja, La",63,Fonzaleche,134,82,52
26,"Rioja, La",64,Fuenmayor,3095,1559,1536
26,"Rioja, La",65,Galbárruli,52,32,20
26,"Rioja, La",66,Galilea,342,176,166
26,"Rioja, La",67,Gallinero de Cameros,23,16,7
26,"Rioja, La",68,Gimileo,118,63,55
26,"Rioja, La",69,Grañón,255,146,109
26,"Rioja, La",70,Grávalos,192,98,94
26,"Rioja, La",71,Haro,11305,5538,5767
26,"Rioja, La",72,Herce,325,174,151
26,"Rioja, La",73,Herramélluri,109,59,50
26,"Rioja, La",74,Hervías,118,60,58
26,"Rioja, La",75,Hormilla,431,234,197
26,"Rioja, La",76,Hormilleja,141,72,69
26,"Rioja, La",77,Hornillos de Cameros,21,10,11
26,"Rioja, La",78,Hornos de Moncalvillo,88,52,36
26,"Rioja, La",79,Huércanos,823,440,383
26,"Rioja, La",80,Igea,607,340,267
26,"Rioja, La",81,Jalón de Cameros,18,10,8
26,"Rioja, La",82,Laguna de Cameros,119,72,47
26,"Rioja, La",83,Lagunilla del Jubera,292,163,129
26,"Rioja, La",84,Lardero,9872,4972,4900
26,"Rioja, La",86,Ledesma de la Cogolla,15,12,3
26,"Rioja, La",87,Leiva,245,125,120
26,"Rioja, La",88,Leza de Río Leza,37,22,15
26,"Rioja, La",89,Logroño,150979,71727,79252
26,"Rioja, La",91,Lumbreras,166,111,55
26,"Rioja, La",92,Manjarrés,116,72,44
26,"Rioja, La",93,Mansilla de la Sierra,67,47,20
26,"Rioja, La",94,Manzanares de Rioja,84,49,35
26,"Rioja, La",95,Matute,93,48,45
26,"Rioja, La",96,Medrano,304,165,139
26,"Rioja, La",98,Munilla,107,60,47
26,"Rioja, La",99,Murillo de Río Leza,1678,854,824
26,"Rioja, La",100,Muro de Aguas,52,29,23
26,"Rioja, La",101,Muro en Cameros,44,25,19
26,"Rioja, La",102,Nájera,8088,3975,4113
26,"Rioja, La",103,Nalda,993,534,459
26,"Rioja, La",104,Navajún,14,10,4
26,"Rioja, La",105,Navarrete,2949,1496,1453
26,"Rioja, La",106,Nestares,93,52,41
26,"Rioja, La",107,Nieva de Cameros,96,62,34
26,"Rioja, La",109,Ochánduri,84,51,33
26,"Rioja, La",108,Ocón,280,175,105
26,"Rioja, La",110,Ojacastro,176,106,70
26,"Rioja, La",111,Ollauri,278,148,130
26,"Rioja, La",112,Ortigosa de Cameros,241,140,101
26,"Rioja, La",113,Pazuengos,34,26,8
26,"Rioja, La",114,Pedroso,77,54,23
26,"Rioja, La",115,Pinillos,18,11,7
26,"Rioja, La",117,Pradejón,3908,1986,1922
26,"Rioja, La",118,Pradillo,59,30,29
26,"Rioja, La",119,Préjano,221,123,98
26,"Rioja, La",120,Quel,2011,1066,945
26,"Rioja, La",121,Rabanera,28,20,8
26,"Rioja, La",122,"Rasillo de Cameros, El",150,78,72
26,"Rioja, La",123,"Redal, El",141,80,61
26,"Rioja, La",124,Ribafrecha,978,511,467
26,"Rioja, La",125,Rincón de Soto,3722,1891,1831
26,"Rioja, La",126,Robres del Castillo,30,19,11
26,"Rioja, La",127,Rodezno,249,137,112
26,"Rioja, La",128,Sajazarra,130,63,67
26,"Rioja, La",129,San Asensio,1130,603,527
26,"Rioja, La",130,San Millán de la Cogolla,228,152,76
26,"Rioja, La",131,San Millán de Yécora,37,26,11
26,"Rioja, La",132,San Román de Cameros,140,83,57
26,"Rioja, La",139,San Torcuato,66,30,36
26,"Rioja, La",142,San Vicente de la Sonsierra,1014,523,491
26,"Rioja, La",134,Santa Coloma,90,56,34
26,"Rioja, La",135,Santa Engracia del Jubera,159,104,55
26,"Rioja, La",136,Santa Eulalia Bajera,115,60,55
26,"Rioja, La",138,Santo Domingo de la Calzada,6298,3157,3141
26,"Rioja, La",140,Santurde de Rioja,272,146,126
26,"Rioja, La",141,Santurdejo,110,71,39
26,"Rioja, La",143,Sojuela,287,166,121
26,"Rioja, La",144,Sorzano,220,126,94
26,"Rioja, La",145,Sotés,291,165,126
26,"Rioja, La",146,Soto en Cameros,97,56,41
26,"Rioja, La",147,Terroba,32,16,16
26,"Rioja, La",148,Tirgo,194,97,97
26,"Rioja, La",149,Tobía,53,31,22
26,"Rioja, La",150,Tormantos,132,78,54
26,"Rioja, La",153,Torre en Cameros,10,8,2
26,"Rioja, La",151,Torrecilla en Cameros,482,262,220
26,"Rioja, La",152,Torrecilla sobre Alesanco,34,20,14
26,"Rioja, La",154,Torremontalbo,12,6,6
26,"Rioja, La",155,Treviana,169,90,79
26,"Rioja, La",157,Tricio,378,188,190
26,"Rioja, La",158,Tudelilla,349,192,157
26,"Rioja, La",160,Uruñuela,980,499,481
26,"Rioja, La",161,Valdemadera,8,5,3
26,"Rioja, La",162,Valgañón,140,87,53
26,"Rioja, La",163,Ventosa,176,90,86
26,"Rioja, La",164,Ventrosa,54,33,21
26,"Rioja, La",165,Viguera,408,226,182
26,"Rioja, La",166,Villalba de Rioja,147,92,55
26,"Rioja, La",167,Villalobar de Rioja,69,48,21
26,"Rioja, La",168,Villamediana de Iregua,7855,3956,3899
26,"Rioja, La",169,Villanueva de Cameros,71,39,32
26,"Rioja, La",170,"Villar de Arnedo, El",605,312,293
26,"Rioja, La",171,Villar de Torre,172,101,71
26,"Rioja, La",172,Villarejo,29,23,6
26,"Rioja, La",173,Villarroya,5,3,2
26,"Rioja, La",174,Villarta-Quintana,144,83,61
26,"Rioja, La",175,Villavelayo,48,30,18
26,"Rioja, La",176,Villaverde de Rioja,55,31,24
26,"Rioja, La",177,Villoslada de Cameros,323,201,122
26,"Rioja, La",178,Viniegra de Abajo,75,45,30
26,"Rioja, La",179,Viniegra de Arriba,39,25,14
26,"Rioja, La",180,Zarratón,253,139,114
26,"Rioja, La",181,Zarzosa,14,10,4
26,"Rioja, La",183,Zorraquín,90,43,47
37,Salamanca,1,Abusejo,203,107,96
37,Salamanca,2,Agallas,153,76,77
37,Salamanca,3,Ahigal de los Aceiteros,126,67,59
37,Salamanca,4,Ahigal de Villarino,35,19,16
37,Salamanca,5,"Alameda de Gardón, La",79,41,38
37,Salamanca,6,"Alamedilla, La",140,71,69
37,Salamanca,7,Alaraz,481,249,232
37,Salamanca,8,Alba de Tormes,5198,2600,2598
37,Salamanca,9,Alba de Yeltes,225,122,103
37,Salamanca,10,"Alberca, La",1128,555,573
37,Salamanca,11,"Alberguería de Argañán, La",123,62,61
37,Salamanca,12,Alconada,160,85,75
37,Salamanca,15,Aldea del Obispo,281,149,132
37,Salamanca,13,Aldeacipreste,119,64,55
37,Salamanca,14,Aldeadávila de la Ribera,1258,637,621
37,Salamanca,16,Aldealengua,677,339,338
37,Salamanca,17,Aldeanueva de Figueroa,263,139,124
37,Salamanca,18,Aldeanueva de la Sierra,107,59,48
37,Salamanca,19,Aldearrodrigo,148,77,71
37,Salamanca,20,Aldearrubia,481,259,222
37,Salamanca,21,Aldeaseca de Alba,77,35,42
37,Salamanca,22,Aldeaseca de la Frontera,280,142,138
37,Salamanca,23,Aldeatejada,1878,945,933
37,Salamanca,24,Aldeavieja de Tormes,103,55,48
37,Salamanca,25,Aldehuela de la Bóveda,289,153,136
37,Salamanca,26,Aldehuela de Yeltes,198,107,91
37,Salamanca,27,Almenara de Tormes,254,145,109
37,Salamanca,28,Almendra,164,96,68
37,Salamanca,29,Anaya de Alba,211,121,90
37,Salamanca,30,Añover de Tormes,94,50,44
37,Salamanca,31,Arabayona de Mógica,380,211,169
37,Salamanca,32,Arapiles,653,350,303
37,Salamanca,33,Arcediano,103,55,48
37,Salamanca,34,"Arco, El",87,43,44
37,Salamanca,35,Armenteros,209,117,92
37,Salamanca,37,"Atalaya, La",117,64,53
37,Salamanca,38,Babilafuente,919,473,446
37,Salamanca,39,Bañobárez,302,157,145
37,Salamanca,40,Barbadillo,414,215,199
37,Salamanca,41,Barbalos,77,41,36
37,Salamanca,42,Barceo,49,30,19
37,Salamanca,44,Barruecopardo,461,252,209
37,Salamanca,45,"Bastida, La",27,16,11
37,Salamanca,46,Béjar,13221,6233,6988
37,Salamanca,47,Beleña,229,121,108
37,Salamanca,49,Bermellar,136,66,70
37,Salamanca,50,Berrocal de Huebra,69,38,31
37,Salamanca,51,Berrocal de Salvatierra,85,46,39
37,Salamanca,52,Boada,292,148,144
37,Salamanca,54,"Bodón, El",285,154,131
37,Salamanca,55,Bogajo,141,75,66
37,Salamanca,56,"Bouza, La",52,24,28
37,Salamanca,57,Bóveda del Río Almar,237,130,107
37,Salamanca,58,Brincones,58,30,28
37,Salamanca,59,Buenamadre,133,71,62
37,Salamanca,60,Buenavista,326,174,152
37,Salamanca,61,"Cabaco, El",245,124,121
37,Salamanca,63,"Cabeza de Béjar, La",72,42,30
37,Salamanca,65,Cabeza del Caballo,316,169,147
37,Salamanca,62,Cabezabellosa de la Calzada,83,47,36
37,Salamanca,67,Cabrerizos,4196,2100,2096
37,Salamanca,68,Cabrillas,395,202,193
37,Salamanca,69,Calvarrasa de Abajo,1152,608,544
37,Salamanca,70,Calvarrasa de Arriba,603,322,281
37,Salamanca,71,"Calzada de Béjar, La",87,48,39
37,Salamanca,72,Calzada de Don Diego,170,90,80
37,Salamanca,73,Calzada de Valdunciel,666,336,330
37,Salamanca,74,Campillo de Azaba,162,93,69
37,Salamanca,77,"Campo de Peñaranda, El",271,156,115
37,Salamanca,78,Candelario,934,469,465
37,Salamanca,79,Canillas de Abajo,78,55,23
37,Salamanca,80,Cantagallo,261,144,117
37,Salamanca,81,Cantalapiedra,1003,522,481
37,Salamanca,82,Cantalpino,895,489,406
37,Salamanca,83,Cantaracillo,194,104,90
37,Salamanca,85,Carbajosa de la Sagrada,6848,3423,3425
37,Salamanca,86,Carpio de Azaba,105,59,46
37,Salamanca,87,Carrascal de Barregas,1151,609,542
37,Salamanca,88,Carrascal del Obispo,223,118,105
37,Salamanca,89,Casafranca,70,39,31
37,Salamanca,90,"Casas del Conde, Las",56,28,28
37,Salamanca,91,Casillas de Flores,187,95,92
37,Salamanca,92,Castellanos de Moriscos,2557,1309,1248
37,Salamanca,185,Castellanos de Villiquera,670,360,310
37,Salamanca,96,Castillejo de Martín Viejo,226,129,97
37,Salamanca,97,Castraz,40,24,16
37,Salamanca,98,Cepeda,346,174,172
37,Salamanca,99,Cereceda de la Sierra,66,36,30
37,Salamanca,100,Cerezal de Peñahorcada,74,41,33
37,Salamanca,101,Cerralbo,160,88,72
37,Salamanca,102,"Cerro, El",430,212,218
37,Salamanca,103,Cespedosa de Tormes,508,270,238
37,Salamanca,114,Chagarcía Medianero,81,42,39
37,Salamanca,104,Cilleros de la Bastida,28,13,15
37,Salamanca,106,Cipérez,284,144,140
37,Salamanca,107,Ciudad Rodrigo,12668,6115,6553
37,Salamanca,108,Coca de Alba,97,46,51
37,Salamanca,109,Colmenar de Montemayor,187,107,80
37,Salamanca,110,Cordovilla,134,72,62
37,Salamanca,112,Cristóbal,168,96,72
37,Salamanca,113,"Cubo de Don Sancho, El",449,244,205
37,Salamanca,115,Dios le Guarde,132,69,63
37,Salamanca,116,Doñinos de Ledesma,69,36,33
37,Salamanca,117,Doñinos de Salamanca,2014,1048,966
37,Salamanca,118,Ejeme,130,74,56
37,Salamanca,120,Encina de San Silvestre,109,54,55
37,Salamanca,119,"Encina, La",108,65,43
37,Salamanca,121,Encinas de Abajo,651,341,310
37,Salamanca,122,Encinas de Arriba,241,121,120
37,Salamanca,123,Encinasola de los Comendadores,174,96,78
37,Salamanca,124,Endrinal,232,127,105
37,Salamanca,125,Escurial de la Sierra,237,133,104
37,Salamanca,126,Espadaña,36,22,14
37,Salamanca,127,Espeja,240,126,114
37,Salamanca,128,Espino de la Orbada,273,148,125
37,Salamanca,129,Florida de Liébana,267,145,122
37,Salamanca,130,Forfoleda,192,103,89
37,Salamanca,131,Frades de la Sierra,200,109,91
37,Salamanca,132,"Fregeneda, La",363,178,185
37,Salamanca,133,Fresnedoso,111,63,48
37,Salamanca,134,Fresno Alhándiga,225,121,104
37,Salamanca,135,"Fuente de San Esteban, La",1334,663,671
37,Salamanca,136,Fuenteguinaldo,678,340,338
37,Salamanca,137,Fuenteliante,104,53,51
37,Salamanca,138,Fuenterroble de Salvatierra,242,124,118
37,Salamanca,139,Fuentes de Béjar,240,120,120
37,Salamanca,140,Fuentes de Oñoro,1208,630,578
37,Salamanca,141,Gajates,169,78,91
37,Salamanca,142,Galindo y Perahuy,703,409,294
37,Salamanca,143,Galinduste,440,215,225
37,Salamanca,144,Galisancho,402,220,182
37,Salamanca,145,Gallegos de Argañán,279,144,135
37,Salamanca,146,Gallegos de Solmirón,124,70,54
37,Salamanca,147,Garcibuey,195,112,83
37,Salamanca,148,Garcihernández,469,249,220
37,Salamanca,149,Garcirrey,69,41,28
37,Salamanca,150,Gejuelo del Barro,38,22,16
37,Salamanca,151,Golpejas,154,81,73
37,Salamanca,152,Gomecello,455,239,216
37,Salamanca,154,Guadramiro,152,87,65
37,Salamanca,155,Guijo de Ávila,67,39,28
37,Salamanca,156,Guijuelo,5627,2821,2806
37,Salamanca,157,Herguijuela de Ciudad Rodrigo,78,46,32
37,Salamanca,158,Herguijuela de la Sierra,271,150,121
37,Salamanca,159,Herguijuela del Campo,82,39,43
37,Salamanca,160,Hinojosa de Duero,691,345,346
37,Salamanca,161,Horcajo de Montemayor,144,76,68
37,Salamanca,162,Horcajo Medianero,217,113,104
37,Salamanca,163,"Hoya, La",41,24,17
37,Salamanca,164,Huerta,298,167,131
37,Salamanca,165,Iruelos,34,14,20
37,Salamanca,166,Ituero de Azaba,233,121,112
37,Salamanca,167,Juzbado,173,91,82
37,Salamanca,168,Lagunilla,481,260,221
37,Salamanca,169,Larrodrigo,193,110,83
37,Salamanca,170,Ledesma,1688,837,851
37,Salamanca,171,Ledrada,489,245,244
37,Salamanca,172,Linares de Riofrío,979,539,440
37,Salamanca,173,Lumbrales,1662,840,822
37,Salamanca,175,Machacón,449,232,217
37,Salamanca,174,Macotera,1114,581,533
37,Salamanca,176,Madroñal,146,83,63
37,Salamanca,177,"Maíllo, El",279,154,125
37,Salamanca,178,Malpartida,101,57,44
37,Salamanca,179,Mancera de Abajo,231,118,113
37,Salamanca,180,"Manzano, El",75,40,35
37,Salamanca,181,Martiago,292,154,138
37,Salamanca,183,Martín de Yeltes,424,219,205
37,Salamanca,182,Martinamor,83,50,33
37,Salamanca,184,Masueco,304,156,148
37,Salamanca,186,"Mata de Ledesma, La",106,58,48
37,Salamanca,187,Matilla de los Caños del Río,640,321,319
37,Salamanca,188,"Maya, La",185,111,74
37,Salamanca,189,Membribe de la Sierra,123,72,51
37,Salamanca,190,Mieza,222,109,113
37,Salamanca,191,"Milano, El",122,72,50
37,Salamanca,192,Miranda de Azán,425,225,200
37,Salamanca,193,Miranda del Castañar,416,218,198
37,Salamanca,194,Mogarraz,283,146,137
37,Salamanca,195,Molinillo,42,25,17
37,Salamanca,196,Monforte de la Sierra,72,38,34
37,Salamanca,197,Monleón,93,53,40
37,Salamanca,198,Monleras,234,109,125
37,Salamanca,199,Monsagro,141,75,66
37,Salamanca,200,Montejo,218,121,97
37,Salamanca,201,Montemayor del Río,272,141,131
37,Salamanca,202,Monterrubio de Armuña,1334,709,625
37,Salamanca,203,Monterrubio de la Sierra,162,91,71
37,Salamanca,204,Morasverdes,269,143,126
37,Salamanca,205,Morille,239,128,111
37,Salamanca,206,Moríñigo,106,58,48
37,Salamanca,207,Moriscos,349,195,154
37,Salamanca,208,Moronta,75,45,30
37,Salamanca,209,Mozárbez,493,258,235
37,Salamanca,211,Narros de Matalayegua,235,127,108
37,Salamanca,213,Nava de Béjar,96,51,45
37,Salamanca,214,Nava de Francia,140,78,62
37,Salamanca,215,Nava de Sotrobal,163,92,71
37,Salamanca,212,Navacarros,104,57,47
37,Salamanca,216,Navales,322,176,146
37,Salamanca,217,Navalmoral de Béjar,62,27,35
37,Salamanca,218,Navamorales,64,41,23
37,Salamanca,219,Navarredonda de la Rinconada,173,88,85
37,Salamanca,221,Navasfrías,469,248,221
37,Salamanca,222,Negrilla de Palencia,89,51,38
37,Salamanca,223,Olmedo de Camaces,106,56,50
37,Salamanca,224,"Orbada, La",218,114,104
37,Salamanca,225,Pajares de la Laguna,112,60,52
37,Salamanca,226,Palacios del Arzobispo,161,79,82
37,Salamanca,228,Palaciosrubios,368,194,174
37,Salamanca,229,Palencia de Negrilla,155,88,67
37,Salamanca,230,Parada de Arriba,250,127,123
37,Salamanca,231,Parada de Rubiales,267,138,129
37,Salamanca,232,Paradinas de San Juan,413,238,175
37,Salamanca,233,Pastores,54,31,23
37,Salamanca,234,"Payo, El",354,175,179
37,Salamanca,235,Pedraza de Alba,239,125,114
37,Salamanca,236,Pedrosillo de Alba,148,86,62
37,Salamanca,237,Pedrosillo de los Aires,369,205,164
37,Salamanca,238,Pedrosillo el Ralo,128,67,61
37,Salamanca,239,"Pedroso de la Armuña, El",222,114,108
37,Salamanca,240,Pelabravo,1247,666,581
37,Salamanca,241,Pelarrodríguez,166,100,66
37,Salamanca,242,Pelayos,94,54,40
37,Salamanca,243,"Peña, La",100,48,52
37,Salamanca,244,Peñacaballera,142,69,73
37,Salamanca,245,Peñaparda,369,187,182
37,Salamanca,246,Peñaranda de Bracamonte,6420,3146,3274
37,Salamanca,247,Peñarandilla,197,103,94
37,Salamanca,248,Peralejos de Abajo,160,86,74
37,Salamanca,249,Peralejos de Arriba,42,25,17
37,Salamanca,250,Pereña de la Ribera,366,192,174
37,Salamanca,251,Peromingo,132,64,68
37,Salamanca,252,Pinedas,115,65,50
37,Salamanca,253,"Pino de Tormes, El",159,88,71
37,Salamanca,254,Pitiegua,192,106,86
37,Salamanca,255,Pizarral,53,31,22
37,Salamanca,256,Poveda de las Cintas,234,131,103
37,Salamanca,257,Pozos de Hinojo,49,28,21
37,Salamanca,258,Puebla de Azaba,179,100,79
37,Salamanca,259,Puebla de San Medel,44,26,18
37,Salamanca,260,Puebla de Yeltes,146,76,70
37,Salamanca,261,Puente del Congosto,227,125,102
37,Salamanca,262,Puertas,86,47,39
37,Salamanca,263,Puerto de Béjar,368,182,186
37,Salamanca,264,Puerto Seguro,62,30,32
37,Salamanca,265,Rágama,227,118,109
37,Salamanca,266,"Redonda, La",86,51,35
37,Salamanca,267,Retortillo,204,110,94
37,Salamanca,268,"Rinconada de la Sierra, La",119,67,52
37,Salamanca,269,Robleda,503,270,233
37,Salamanca,270,Robliza de Cojos,201,102,99
37,Salamanca,271,Rollán,384,209,175
37,Salamanca,272,Saelices el Chico,150,80,70
37,Salamanca,273,"Sagrada, La",109,60,49
37,Salamanca,303,"Sahugo, El",191,103,88
37,Salamanca,274,Salamanca,144436,65702,78734
37,Salamanca,275,Saldeana,113,62,51
37,Salamanca,276,Salmoral,138,86,52
37,Salamanca,277,Salvatierra de Tormes,77,37,40
37,Salamanca,278,San Cristóbal de la Cuesta,989,527,462
37,Salamanca,284,San Esteban de la Sierra,345,194,151
37,Salamanca,285,San Felices de los Gallegos,428,218,210
37,Salamanca,286,San Martín del Castañar,225,120,105
37,Salamanca,287,San Miguel de Valero,334,171,163
37,Salamanca,36,San Miguel del Robledo,60,32,28
37,Salamanca,288,San Morales,332,184,148
37,Salamanca,289,San Muñoz,241,122,119
37,Salamanca,291,San Pedro de Rozados,311,171,140
37,Salamanca,290,San Pedro del Valle,148,81,67
37,Salamanca,292,San Pelayo de Guareña,96,51,45
37,Salamanca,280,Sanchón de la Ribera,84,45,39
37,Salamanca,281,Sanchón de la Sagrada,39,23,16
37,Salamanca,282,Sanchotello,229,120,109
37,Salamanca,279,Sancti-Spíritus,841,459,382
37,Salamanca,283,Sando,127,78,49
37,Salamanca,293,Santa María de Sando,114,60,54
37,Salamanca,294,Santa Marta de Tormes,14806,7277,7529
37,Salamanca,296,Santiago de la Puebla,334,176,158
37,Salamanca,297,Santibáñez de Béjar,476,240,236
37,Salamanca,298,Santibáñez de la Sierra,187,102,85
37,Salamanca,299,Santiz,242,126,116
37,Salamanca,300,"Santos, Los",633,328,305
37,Salamanca,301,Sardón de los Frailes,84,51,33
37,Salamanca,302,Saucelle,295,152,143
37,Salamanca,304,Sepulcro-Hilario,181,101,80
37,Salamanca,305,Sequeros,234,117,117
37,Salamanca,306,Serradilla del Arroyo,267,147,120
37,Salamanca,307,Serradilla del Llano,167,82,85
37,Salamanca,309,"Sierpe, La",46,21,25
37,Salamanca,310,Sieteiglesias de Tormes,191,96,95
37,Salamanca,311,Sobradillo,234,120,114
37,Salamanca,312,Sorihuela,273,140,133
37,Salamanca,313,Sotoserrano,590,316,274
37,Salamanca,314,Tabera de Abajo,106,61,45
37,Salamanca,315,"Tala, La",94,54,40
37,Salamanca,316,Tamames,805,419,386
37,Salamanca,317,Tarazona de Guareña,325,173,152
37,Salamanca,318,Tardáguila,221,127,94
37,Salamanca,319,"Tejado, El",109,59,50
37,Salamanca,320,Tejeda y Segoyuela,91,50,41
37,Salamanca,321,Tenebrón,156,75,81
37,Salamanca,322,Terradillos,3053,1556,1497
37,Salamanca,323,Topas,549,295,254
37,Salamanca,324,Tordillos,367,204,163
37,Salamanca,325,"Tornadizo, El",93,53,40
37,Salamanca,327,Torresmenudas,193,97,96
37,Salamanca,328,Trabanca,212,104,108
37,Salamanca,329,Tremedal de Tormes,45,23,22
37,Salamanca,330,Valdecarros,363,186,177
37,Salamanca,331,Valdefuentes de Sangusín,217,121,96
37,Salamanca,332,Valdehijaderos,79,43,36
37,Salamanca,333,Valdelacasa,235,139,96
37,Salamanca,334,Valdelageve,74,38,36
37,Salamanca,335,Valdelosa,433,212,221
37,Salamanca,336,Valdemierque,62,39,23
37,Salamanca,337,Valderrodrigo,153,74,79
37,Salamanca,338,Valdunciel,97,47,50
37,Salamanca,339,Valero,315,171,144
37,Salamanca,343,Vallejera de Riofrío,68,32,36
37,Salamanca,340,Valsalabroso,153,85,68
37,Salamanca,341,Valverde de Valdelacasa,76,42,34
37,Salamanca,342,Valverdón,285,148,137
37,Salamanca,344,Vecinos,261,134,127
37,Salamanca,345,Vega de Tirados,171,92,79
37,Salamanca,346,"Veguillas, Las",295,139,156
37,Salamanca,347,"Vellés, La",549,302,247
37,Salamanca,348,Ventosa del Río Almar,116,67,49
37,Salamanca,349,"Vídola, La",117,55,62
37,Salamanca,351,Villaflores,288,147,141
37,Salamanca,352,Villagonzalo de Tormes,212,124,88
37,Salamanca,353,Villalba de los Llanos,137,76,61
37,Salamanca,354,Villamayor,7107,3566,3541
37,Salamanca,355,Villanueva del Conde,173,89,84
37,Salamanca,356,Villar de Argañán,87,45,42
37,Salamanca,357,Villar de Ciervo,271,143,128
37,Salamanca,358,Villar de Gallimazo,196,124,72
37,Salamanca,359,Villar de la Yegua,197,102,95
37,Salamanca,360,Villar de Peralonso,241,120,121
37,Salamanca,361,Villar de Samaniego,92,53,39
37,Salamanca,362,Villares de la Reina,6256,3112,3144
37,Salamanca,363,Villares de Yeltes,126,61,65
37,Salamanca,364,Villarino de los Aires,843,438,405
37,Salamanca,365,Villarmayor,192,107,85
37,Salamanca,366,Villarmuerto,42,27,15
37,Salamanca,367,Villasbuenas,198,109,89
37,Salamanca,368,Villasdardo,17,6,11
37,Salamanca,369,Villaseco de los Gamitos,141,80,61
37,Salamanca,370,Villaseco de los Reyes,340,194,146
37,Salamanca,371,Villasrubias,281,155,126
37,Salamanca,372,Villaverde de Guareña,149,81,68
37,Salamanca,373,Villavieja de Yeltes,809,419,390
37,Salamanca,374,Villoria,1368,686,682
37,Salamanca,375,Villoruela,790,401,389
37,Salamanca,350,Vilvestre,436,218,218
37,Salamanca,376,Vitigudino,2580,1258,1322
37,Salamanca,377,Yecla de Yeltes,252,131,121
37,Salamanca,378,Zamarra,100,57,43
37,Salamanca,379,Zamayón,207,124,83
37,Salamanca,380,Zarapicos,55,30,25
37,Salamanca,381,"Zarza de Pumareda, La",152,85,67
37,Salamanca,382,Zorita de la Frontera,162,85,77
38,Santa Cruz de Tenerife,1,Adeje,46833,23612,23221
38,Santa Cruz de Tenerife,2,Agulo,1066,538,528
38,Santa Cruz de Tenerife,3,Alajeró,1983,1060,923
38,Santa Cruz de Tenerife,4,Arafo,5531,2721,2810
38,Santa Cruz de Tenerife,5,Arico,7594,3960,3634
38,Santa Cruz de Tenerife,6,Arona,78930,40358,38572
38,Santa Cruz de Tenerife,7,Barlovento,1859,948,911
38,Santa Cruz de Tenerife,8,Breña Alta,7061,3466,3595
38,Santa Cruz de Tenerife,9,Breña Baja,5434,2733,2701
38,Santa Cruz de Tenerife,10,Buenavista del Norte,4797,2416,2381
38,Santa Cruz de Tenerife,11,Candelaria,27149,13202,13947
38,Santa Cruz de Tenerife,12,Fasnia,2743,1433,1310
38,Santa Cruz de Tenerife,13,Frontera,3983,2011,1972
38,Santa Cruz de Tenerife,14,Fuencaliente de la Palma,1695,867,828
38,Santa Cruz de Tenerife,15,Garachico,4827,2419,2408
38,Santa Cruz de Tenerife,16,Garafía,1584,832,752
38,Santa Cruz de Tenerife,17,Granadilla de Abona,46816,23429,23387
38,Santa Cruz de Tenerife,18,"Guancha, La",5426,2654,2772
38,Santa Cruz de Tenerife,19,Guía de Isora,20537,10245,10292
38,Santa Cruz de Tenerife,20,Güímar,19273,9537,9736
38,Santa Cruz de Tenerife,21,Hermigua,1808,931,877
38,Santa Cruz de Tenerife,22,Icod de los Vinos,22558,11115,11443
38,Santa Cruz de Tenerife,24,"Llanos de Aridane, Los",20107,9723,10384
38,Santa Cruz de Tenerife,25,"Matanza de Acentejo, La",8854,4449,4405
38,Santa Cruz de Tenerife,26,"Orotava, La",41500,20356,21144
38,Santa Cruz de Tenerife,27,"Paso, El",7464,3728,3736
38,Santa Cruz de Tenerife,901,"Pinar de El Hierro, El",1776,932,844
38,Santa Cruz de Tenerife,28,Puerto de la Cruz,30036,14670,15366
38,Santa Cruz de Tenerife,29,Puntagorda,2009,1018,991
38,Santa Cruz de Tenerife,30,Puntallana,2429,1209,1220
38,Santa Cruz de Tenerife,31,"Realejos, Los",36218,17835,18383
38,Santa Cruz de Tenerife,32,"Rosario, El",17312,8764,8548
38,Santa Cruz de Tenerife,33,San Andrés y Sauces,4135,2069,2066
38,Santa Cruz de Tenerife,23,San Cristóbal de La Laguna,153655,74542,79113
38,Santa Cruz de Tenerife,34,San Juan de la Rambla,4828,2400,2428
38,Santa Cruz de Tenerife,35,San Miguel de Abona,18887,9510,9377
38,Santa Cruz de Tenerife,36,San Sebastián de la Gomera,8760,4393,4367
38,Santa Cruz de Tenerife,37,Santa Cruz de la Palma,15581,7560,8021
38,Santa Cruz de Tenerife,38,Santa Cruz de Tenerife,203692,97298,106394
38,Santa Cruz de Tenerife,39,Santa Úrsula,14189,7080,7109
38,Santa Cruz de Tenerife,40,Santiago del Teide,10576,5299,5277
38,Santa Cruz de Tenerife,41,"Sauzal, El",8873,4381,4492
38,Santa Cruz de Tenerife,42,"Silos, Los",4848,2407,2441
38,Santa Cruz de Tenerife,43,Tacoronte,23812,11856,11956
38,Santa Cruz de Tenerife,44,"Tanque, El",2650,1280,1370
38,Santa Cruz de Tenerife,45,Tazacorte,4620,2357,2263
38,Santa Cruz de Tenerife,46,Tegueste,11108,5492,5616
38,Santa Cruz de Tenerife,47,Tijarafe,2590,1306,1284
38,Santa Cruz de Tenerife,49,Valle Gran Rey,4371,2199,2172
38,Santa Cruz de Tenerife,50,Vallehermoso,2988,1539,1449
38,Santa Cruz de Tenerife,48,Valverde,4920,2483,2437
38,Santa Cruz de Tenerife,51,"Victoria de Acentejo, La",8969,4522,4447
38,Santa Cruz de Tenerife,52,Vilaflor de Chasna,1615,841,774
38,Santa Cruz de Tenerife,53,Villa de Mazo,4782,2412,2370
40,Segovia,1,Abades,864,430,434
40,Segovia,2,Adrada de Pirón,41,20,21
40,Segovia,3,Adrados,138,76,62
40,Segovia,4,Aguilafuente,585,283,302
40,Segovia,5,Alconada de Maderuelo,29,18,11
40,Segovia,12,Aldea Real,310,167,143
40,Segovia,6,Aldealcorvo,25,15,10
40,Segovia,7,Aldealengua de Pedraza,80,51,29
40,Segovia,8,Aldealengua de Santa María,65,33,32
40,Segovia,9,Aldeanueva de la Serrezuela,49,36,13
40,Segovia,10,Aldeanueva del Codonal,127,68,59
40,Segovia,13,Aldeasoña,57,32,25
40,Segovia,14,Aldehorno,58,33,25
40,Segovia,15,Aldehuela del Codonal,27,14,13
40,Segovia,16,Aldeonte,58,28,30
40,Segovia,17,Anaya,124,57,67
40,Segovia,18,Añe,90,51,39
40,Segovia,19,Arahuetes,41,28,13
40,Segovia,20,Arcones,159,77,82
40,Segovia,21,Arevalillo de Cega,27,16,11
40,Segovia,22,Armuña,230,132,98
40,Segovia,24,Ayllón,1212,628,584
40,Segovia,25,Barbolla,167,90,77
40,Segovia,26,Basardilla,146,64,82
40,Segovia,28,Bercial,117,62,55
40,Segovia,29,Bercimuel,27,13,14
40,Segovia,30,Bernardos,518,288,230
40,Segovia,31,Bernuy de Porreros,762,407,355
40,Segovia,32,Boceguillas,708,363,345
40,Segovia,33,Brieva,98,53,45
40,Segovia,34,Caballar,91,49,42
40,Segovia,35,Cabañas de Polendos,178,97,81
40,Segovia,36,Cabezuela,681,346,335
40,Segovia,37,Calabazas de Fuentidueña,35,20,15
40,Segovia,39,Campo de San Pedro,265,147,118
40,Segovia,40,Cantalejo,3579,1771,1808
40,Segovia,41,Cantimpalos,1331,694,637
40,Segovia,43,Carbonero el Mayor,2523,1302,1221
40,Segovia,44,Carrascal del Río,151,82,69
40,Segovia,45,Casla,163,94,69
40,Segovia,46,Castillejo de Mesleón,135,77,58
40,Segovia,47,Castro de Fuentidueña,32,20,12
40,Segovia,48,Castrojimeno,33,18,15
40,Segovia,49,Castroserna de Abajo,47,27,20
40,Segovia,51,Castroserracín,50,30,20
40,Segovia,52,Cedillo de la Torre,97,52,45
40,Segovia,53,Cerezo de Abajo,123,67,56
40,Segovia,54,Cerezo de Arriba,136,76,60
40,Segovia,65,Chañe,813,398,415
40,Segovia,55,Cilleruelo de San Mamés,34,22,12
40,Segovia,56,Cobos de Fuentidueña,34,17,17
40,Segovia,57,Coca,1826,914,912
40,Segovia,58,Codorniz,342,173,169
40,Segovia,59,Collado Hermoso,125,60,65
40,Segovia,60,Condado de Castilnovo,104,58,46
40,Segovia,61,Corral de Ayllón,85,49,36
40,Segovia,902,Cozuelos de Fuentidueña,131,71,60
40,Segovia,62,Cubillo,72,42,30
40,Segovia,63,Cuéllar,9524,4807,4717
40,Segovia,905,Cuevas de Provanco,136,75,61
40,Segovia,68,Domingo García,27,16,11
40,Segovia,69,Donhierro,92,50,42
40,Segovia,70,Duruelo,175,106,69
40,Segovia,71,Encinas,43,22,21
40,Segovia,72,Encinillas,284,157,127
40,Segovia,73,Escalona del Prado,512,272,240
40,Segovia,74,Escarabajosa de Cabezas,306,167,139
40,Segovia,75,Escobar de Polendos,177,95,82
40,Segovia,76,"Espinar, El",9155,4678,4477
40,Segovia,77,Espirdo,1248,664,584
40,Segovia,78,Fresneda de Cuéllar,173,97,76
40,Segovia,79,Fresno de Cantespino,261,145,116
40,Segovia,80,Fresno de la Fuente,74,43,31
40,Segovia,81,Frumales,113,58,55
40,Segovia,82,Fuente de Santa Cruz,122,66,56
40,Segovia,83,Fuente el Olmo de Fuentidueña,170,76,94
40,Segovia,84,Fuente el Olmo de Íscar,66,38,28
40,Segovia,86,Fuentepelayo,860,456,404
40,Segovia,87,Fuentepiñel,97,51,46
40,Segovia,88,Fuenterrebollo,352,178,174
40,Segovia,89,Fuentesaúco de Fuentidueña,240,127,113
40,Segovia,91,Fuentesoto,113,61,52
40,Segovia,92,Fuentidueña,141,83,58
40,Segovia,93,Gallegos,92,50,42
40,Segovia,94,Garcillán,450,232,218
40,Segovia,95,Gomezserracín,699,364,335
40,Segovia,97,Grajera,211,118,93
40,Segovia,99,Honrubia de la Cuesta,58,32,26
40,Segovia,100,Hontalbilla,304,166,138
40,Segovia,101,Hontanares de Eresma,1363,721,642
40,Segovia,103,"Huertos, Los",175,102,73
40,Segovia,104,Ituero y Lama,349,183,166
40,Segovia,105,Juarros de Riomoros,55,30,25
40,Segovia,106,Juarros de Voltoya,222,111,111
40,Segovia,107,Labajos,126,71,55
40,Segovia,108,Laguna de Contreras,118,68,50
40,Segovia,109,Languilla,79,47,32
40,Segovia,110,Lastras de Cuéllar,375,191,184
40,Segovia,111,Lastras del Pozo,72,35,37
40,Segovia,112,"Lastrilla, La",3730,1895,1835
40,Segovia,113,"Losa, La",538,301,237
40,Segovia,115,Maderuelo,99,57,42
40,Segovia,903,Marazoleja,105,69,36
40,Segovia,118,Marazuela,51,29,22
40,Segovia,119,Martín Miguel,212,126,86
40,Segovia,120,Martín Muñoz de la Dehesa,227,119,108
40,Segovia,121,Martín Muñoz de las Posadas,308,158,150
40,Segovia,122,Marugán,623,331,292
40,Segovia,124,Mata de Cuéllar,260,136,124
40,Segovia,123,Matabuena,166,95,71
40,Segovia,125,"Matilla, La",98,54,44
40,Segovia,126,Melque de Cercos,81,42,39
40,Segovia,127,Membibre de la Hoz,31,17,14
40,Segovia,128,Migueláñez,140,77,63
40,Segovia,129,Montejo de Arévalo,191,103,88
40,Segovia,130,Montejo de la Vega de la Serrezuela,151,89,62
40,Segovia,131,Monterrubio,62,35,27
40,Segovia,132,Moral de Hornuez,59,34,25
40,Segovia,134,Mozoncillo,914,488,426
40,Segovia,135,Muñopedro,323,171,152
40,Segovia,136,Muñoveros,160,78,82
40,Segovia,138,Nava de la Asunción,2814,1414,1400
40,Segovia,139,Navafría,304,160,144
40,Segovia,140,Navalilla,108,57,51
40,Segovia,141,Navalmanzano,1081,566,515
40,Segovia,142,Navares de Ayuso,51,26,25
40,Segovia,143,Navares de Enmedio,92,55,37
40,Segovia,144,Navares de las Cuevas,27,16,11
40,Segovia,145,Navas de Oro,1368,693,675
40,Segovia,904,Navas de Riofrío,399,194,205
40,Segovia,146,Navas de San Antonio,350,182,168
40,Segovia,148,Nieva,284,147,137
40,Segovia,149,Olombrada,588,308,280
40,Segovia,150,Orejana,65,37,28
40,Segovia,151,Ortigosa de Pestaño,59,31,28
40,Segovia,901,Ortigosa del Monte,552,295,257
40,Segovia,152,Otero de Herreros,975,490,485
40,Segovia,154,Pajarejos,13,9,4
40,Segovia,155,Palazuelos de Eresma,5174,2660,2514
40,Segovia,156,Pedraza,388,218,170
40,Segovia,157,Pelayos del Arroyo,46,28,18
40,Segovia,158,Perosillo,16,12,4
40,Segovia,159,Pinarejos,181,103,78
40,Segovia,160,Pinarnegrillo,101,55,46
40,Segovia,161,Pradales,47,29,18
40,Segovia,162,Prádena,530,282,248
40,Segovia,163,Puebla de Pedraza,57,28,29
40,Segovia,164,Rapariegos,194,102,92
40,Segovia,181,Real Sitio de San Ildefonso,5315,2627,2688
40,Segovia,165,Rebollo,87,47,40
40,Segovia,166,Remondo,302,154,148
40,Segovia,168,Riaguas de San Bartolomé,36,22,14
40,Segovia,170,Riaza,2138,1139,999
40,Segovia,171,Ribota,40,32,8
40,Segovia,172,Riofrío de Riaza,38,24,14
40,Segovia,173,Roda de Eresma,185,97,88
40,Segovia,174,Sacramenia,383,203,180
40,Segovia,176,Samboal,469,257,212
40,Segovia,177,San Cristóbal de Cuéllar,152,82,70
40,Segovia,178,San Cristóbal de la Vega,110,60,50
40,Segovia,906,San Cristóbal de Segovia,3028,1532,1496
40,Segovia,182,San Martín y Mudrián,241,118,123
40,Segovia,183,San Miguel de Bernuy,137,70,67
40,Segovia,184,San Pedro de Gaíllos,300,161,139
40,Segovia,179,Sanchonuño,918,449,469
40,Segovia,180,Sangarcía,319,174,145
40,Segovia,185,Santa María la Real de Nieva,1004,546,458
40,Segovia,186,Santa Marta del Cerro,42,21,21
40,Segovia,188,Santiuste de Pedraza,99,64,35
40,Segovia,189,Santiuste de San Juan Bautista,575,319,256
40,Segovia,190,Santo Domingo de Pirón,61,36,25
40,Segovia,191,Santo Tomé del Puerto,277,153,124
40,Segovia,192,Sauquillo de Cabezas,168,89,79
40,Segovia,193,Sebúlcor,264,140,124
40,Segovia,194,Segovia,51756,24341,27415
40,Segovia,195,Sepúlveda,1105,579,526
40,Segovia,196,Sequera de Fresno,36,24,12
40,Segovia,198,Sotillo,26,15,11
40,Segovia,199,Sotosalbos,110,56,54
40,Segovia,200,Tabanera la Luenga,51,25,26
40,Segovia,201,Tolocirio,53,25,28
40,Segovia,206,Torre Val de San Pedro,188,97,91
40,Segovia,202,Torreadrada,64,29,35
40,Segovia,203,Torrecaballeros,1339,686,653
40,Segovia,204,Torrecilla del Pinar,198,106,92
40,Segovia,205,Torreiglesias,282,148,134
40,Segovia,207,Trescasas,1059,545,514
40,Segovia,208,Turégano,1005,499,506
40,Segovia,210,Urueñas,111,68,43
40,Segovia,211,Valdeprados,74,41,33
40,Segovia,212,Valdevacas de Montejo,32,16,16
40,Segovia,213,Valdevacas y Guijar,95,51,44
40,Segovia,218,Valle de Tabladillo,96,56,40
40,Segovia,219,Vallelado,697,373,324
40,Segovia,220,Valleruela de Pedraza,73,36,37
40,Segovia,221,Valleruela de Sepúlveda,52,25,27
40,Segovia,214,Valseca,245,138,107
40,Segovia,215,Valtiendas,80,45,35
40,Segovia,216,Valverde del Majano,1064,540,524
40,Segovia,222,Veganzones,229,128,101
40,Segovia,223,Vegas de Matute,265,162,103
40,Segovia,224,Ventosilla y Tejadilla,20,14,6
40,Segovia,225,Villacastín,1495,775,720
40,Segovia,228,Villaverde de Íscar,615,323,292
40,Segovia,229,Villaverde de Montejo,30,17,13
40,Segovia,230,Villeguillo,106,65,41
40,Segovia,231,Yanguas de Eresma,140,69,71
40,Segovia,233,Zarzuela del Monte,506,262,244
40,Segovia,234,Zarzuela del Pinar,442,232,210
41,Sevilla,1,Aguadulce,2047,1014,1033
41,Sevilla,2,Alanís,1781,895,886
41,Sevilla,3,Albaida del Aljarafe,3137,1574,1563
41,Sevilla,4,Alcalá de Guadaíra,75106,37345,37761
41,Sevilla,5,Alcalá del Río,11950,6068,5882
41,Sevilla,6,Alcolea del Río,3413,1711,1702
41,Sevilla,7,"Algaba, La",16275,8074,8201
41,Sevilla,8,Algámitas,1284,664,620
41,Sevilla,9,Almadén de la Plata,1424,737,687
41,Sevilla,10,Almensilla,5929,2966,2963
41,Sevilla,11,Arahal,19532,9664,9868
41,Sevilla,12,Aznalcázar,4493,2258,2235
41,Sevilla,13,Aznalcóllar,6116,3131,2985
41,Sevilla,14,Badolatosa,3121,1604,1517
41,Sevilla,15,Benacazón,7167,3599,3568
41,Sevilla,16,Bollullos de la Mitación,10512,5278,5234
41,Sevilla,17,Bormujos,21667,10737,10930
41,Sevilla,18,Brenes,12638,6321,6317
41,Sevilla,19,Burguillos,6523,3281,3242
41,Sevilla,20,"Cabezas de San Juan, Las",16418,8253,8165
41,Sevilla,21,Camas,27293,13326,13967
41,Sevilla,22,"Campana, La",5349,2679,2670
41,Sevilla,23,Cantillana,10612,5413,5199
41,Sevilla,901,Cañada Rosal,3307,1635,1672
41,Sevilla,24,Carmona,28540,14360,14180
41,Sevilla,25,Carrión de los Céspedes,2524,1220,1304
41,Sevilla,26,Casariche,5566,2844,2722
41,Sevilla,27,Castilblanco de los Arroyos,4831,2440,2391
41,Sevilla,28,Castilleja de Guzmán,2835,1460,1375
41,Sevilla,29,Castilleja de la Cuesta,17429,8472,8957
41,Sevilla,30,Castilleja del Campo,628,319,309
41,Sevilla,31,"Castillo de las Guardas, El",1464,747,717
41,Sevilla,32,Cazalla de la Sierra,4849,2392,2457
41,Sevilla,33,Constantina,6040,3014,3026
41,Sevilla,34,Coria del Río,30535,15243,15292
41,Sevilla,35,Coripe,1298,646,652
41,Sevilla,36,"Coronil, El",4830,2420,2410
41,Sevilla,37,"Corrales, Los",3997,2033,1964
41,Sevilla,903,"Cuervo de Sevilla, El",8698,4391,4307
41,Sevilla,38,Dos Hermanas,132551,65319,67232
41,Sevilla,39,Écija,40087,19740,20347
41,Sevilla,40,Espartinas,15423,7710,7713
41,Sevilla,41,Estepa,12526,6243,6283
41,Sevilla,42,Fuentes de Andalucía,7149,3550,3599
41,Sevilla,43,"Garrobo, El",775,390,385
41,Sevilla,44,Gelves,10051,5017,5034
41,Sevilla,45,Gerena,7489,3758,3731
41,Sevilla,46,Gilena,3826,1935,1891
41,Sevilla,47,Gines,13361,6558,6803
41,Sevilla,48,Guadalcanal,2659,1322,1337
41,Sevilla,49,Guillena,12647,6409,6238
41,Sevilla,50,Herrera,6463,3195,3268
41,Sevilla,51,Huévar del Aljarafe,2883,1474,1409
41,Sevilla,902,Isla Mayor,5889,2944,2945
41,Sevilla,52,Lantejuela,3836,1969,1867
41,Sevilla,53,Lebrija,27410,13672,13738
41,Sevilla,54,Lora de Estepa,852,434,418
41,Sevilla,55,Lora del Río,18934,9390,9544
41,Sevilla,56,"Luisiana, La",4569,2302,2267
41,Sevilla,57,"Madroño, El",284,138,146
41,Sevilla,58,Mairena del Alcor,23222,11621,11601
41,Sevilla,59,Mairena del Aljarafe,45471,22237,23234
41,Sevilla,60,Marchena,19691,9846,9845
41,Sevilla,61,Marinaleda,2665,1366,1299
41,Sevilla,62,Martín de la Jara,2740,1416,1324
41,Sevilla,63,"Molares, Los",3455,1757,1698
41,Sevilla,64,Montellano,7073,3545,3528
41,Sevilla,65,Morón de la Frontera,27930,13813,14117
41,Sevilla,66,"Navas de la Concepción, Las",1601,792,809
41,Sevilla,67,Olivares,9422,4734,4688
41,Sevilla,68,Osuna,17735,8824,8911
41,Sevilla,69,"Palacios y Villafranca, Los",38246,19266,18980
41,Sevilla,70,Palomares del Río,8418,4234,4184
41,Sevilla,71,Paradas,6923,3458,3465
41,Sevilla,72,Pedrera,5308,2609,2699
41,Sevilla,73,"Pedroso, El",2055,1010,1045
41,Sevilla,74,Peñaflor,3680,1847,1833
41,Sevilla,75,Pilas,13988,7052,6936
41,Sevilla,76,Pruna,2671,1364,1307
41,Sevilla,77,"Puebla de Cazalla, La",11081,5527,5554
41,Sevilla,78,"Puebla de los Infantes, La",3051,1508,1543
41,Sevilla,79,"Puebla del Río, La",11914,5900,6014
41,Sevilla,80,"Real de la Jara, El",1530,754,776
41,Sevilla,81,"Rinconada, La",38339,19025,19314
41,Sevilla,82,"Roda de Andalucía, La",4277,2117,2160
41,Sevilla,83,"Ronquillo, El",1354,685,669
41,Sevilla,84,"Rubio, El",3457,1689,1768
41,Sevilla,85,Salteras,5499,2660,2839
41,Sevilla,86,San Juan de Aznalfarache,21458,10359,11099
41,Sevilla,88,San Nicolás del Puerto,593,304,289
41,Sevilla,87,Sanlúcar la Mayor,13583,6718,6865
41,Sevilla,89,Santiponce,8445,4178,4267
41,Sevilla,90,"Saucejo, El",4310,2134,2176
41,Sevilla,91,Sevilla,689434,327162,362272
41,Sevilla,92,Tocina,9656,4786,4870
41,Sevilla,93,Tomares,25042,12375,12667
41,Sevilla,94,Umbrete,8695,4363,4332
41,Sevilla,95,Utrera,52701,26225,26476
41,Sevilla,96,Valencina de la Concepción,7860,3871,3989
41,Sevilla,97,Villamanrique de la Condesa,4454,2185,2269
41,Sevilla,100,Villanueva de San Juan,1181,570,611
41,Sevilla,98,Villanueva del Ariscal,6573,3194,3379
41,Sevilla,99,Villanueva del Río y Minas,4866,2429,2437
41,Sevilla,101,Villaverde del Río,7824,3981,3843
41,Sevilla,102,"Viso del Alcor, El",19234,9630,9604
42,Soria,1,Abejar,318,174,144
42,Soria,3,Adradas,48,28,20
42,Soria,4,Ágreda,2993,1526,1467
42,Soria,6,Alconaba,191,123,68
42,Soria,7,Alcubilla de Avellaneda,112,60,52
42,Soria,8,Alcubilla de las Peñas,62,38,24
42,Soria,9,Aldealafuente,89,47,42
42,Soria,10,Aldealices,30,19,11
42,Soria,11,Aldealpozo,18,8,10
42,Soria,12,Aldealseñor,31,17,14
42,Soria,13,Aldehuela de Periáñez,37,21,16
42,Soria,14,"Aldehuelas, Las",65,36,29
42,Soria,15,Alentisque,33,19,14
42,Soria,16,Aliud,17,13,4
42,Soria,17,Almajano,179,95,84
42,Soria,18,Almaluez,148,86,62
42,Soria,19,Almarza,604,346,258
42,Soria,20,Almazán,5526,2795,2731
42,Soria,21,Almazul,70,41,29
42,Soria,22,Almenar de Soria,234,137,97
42,Soria,23,Alpanseque,60,34,26
42,Soria,24,Arancón,90,58,32
42,Soria,25,Arcos de Jalón,1486,794,692
42,Soria,26,Arenillas,26,12,14
42,Soria,27,Arévalo de la Sierra,76,48,28
42,Soria,28,Ausejo de la Sierra,83,43,40
42,Soria,29,Baraona,143,86,57
42,Soria,30,Barca,103,64,39
42,Soria,31,Barcones,22,15,7
42,Soria,32,Bayubas de Abajo,146,80,66
42,Soria,33,Bayubas de Arriba,48,30,18
42,Soria,34,Beratón,28,19,9
42,Soria,35,Berlanga de Duero,902,455,447
42,Soria,36,Blacos,45,24,21
42,Soria,37,Bliecos,36,20,16
42,Soria,38,Borjabad,35,21,14
42,Soria,39,Borobia,242,129,113
42,Soria,41,Buberos,33,18,15
42,Soria,42,Buitrago,59,32,27
42,Soria,43,Burgo de Osma-Ciudad de Osma,4984,2472,2512
42,Soria,44,Cabrejas del Campo,56,35,21
42,Soria,45,Cabrejas del Pinar,356,205,151
42,Soria,46,Calatañazor,51,28,23
42,Soria,48,Caltojar,59,38,21
42,Soria,49,Candilichera,124,72,52
42,Soria,50,Cañamaque,33,24,9
42,Soria,51,Carabantes,19,9,10
42,Soria,52,Caracena,13,9,4
42,Soria,53,Carrascosa de Abajo,23,15,8
42,Soria,54,Carrascosa de la Sierra,18,12,6
42,Soria,55,Casarejos,171,91,80
42,Soria,56,Castilfrío de la Sierra,29,18,11
42,Soria,58,Castillejo de Robledo,117,67,50
42,Soria,57,Castilruiz,181,96,85
42,Soria,59,Centenera de Andaluz,22,10,12
42,Soria,60,Cerbón,34,21,13
42,Soria,61,Cidones,320,192,128
42,Soria,62,Cigudosa,20,13,7
42,Soria,63,Cihuela,49,26,23
42,Soria,64,Ciria,90,46,44
42,Soria,65,Cirujales del Río,22,16,6
42,Soria,68,Coscurita,81,49,32
42,Soria,69,Covaleda,1749,907,842
42,Soria,70,Cubilla,34,20,14
42,Soria,71,Cubo de la Solana,182,99,83
42,Soria,73,Cueva de Ágreda,70,44,26
42,Soria,75,Dévanos,85,46,39
42,Soria,76,Deza,230,117,113
42,Soria,78,Duruelo de la Sierra,1122,573,549
42,Soria,79,Escobosa de Almazán,23,16,7
42,Soria,80,Espeja de San Marcelino,170,99,71
42,Soria,81,Espejón,175,89,86
42,Soria,82,Estepa de San Juan,7,6,1
42,Soria,83,Frechilla de Almazán,25,14,11
42,Soria,84,Fresno de Caracena,20,13,7
42,Soria,85,Fuentearmegil,187,107,80
42,Soria,86,Fuentecambrón,37,22,15
42,Soria,87,Fuentecantos,55,27,28
42,Soria,88,Fuentelmonge,69,40,29
42,Soria,89,Fuentelsaz de Soria,62,30,32
42,Soria,90,Fuentepinilla,91,58,33
42,Soria,92,Fuentes de Magaña,64,36,28
42,Soria,93,Fuentestrún,40,27,13
42,Soria,94,Garray,745,404,341
42,Soria,95,Golmayo,2561,1353,1208
42,Soria,96,Gómara,310,170,140
42,Soria,97,Gormaz,27,19,8
42,Soria,98,Herrera de Soria,9,7,2
42,Soria,100,Hinojosa del Campo,33,22,11
42,Soria,103,Langa de Duero,746,409,337
42,Soria,105,Liceras,53,27,26
42,Soria,106,"Losilla, La",13,9,4
42,Soria,107,Magaña,80,47,33
42,Soria,108,Maján,13,7,6
42,Soria,110,Matalebreras,53,30,23
42,Soria,111,Matamala de Almazán,322,168,154
42,Soria,113,Medinaceli,744,365,379
42,Soria,115,Miño de Medinaceli,78,47,31
42,Soria,116,Miño de San Esteban,47,31,16
42,Soria,117,Molinos de Duero,167,88,79
42,Soria,118,Momblona,23,16,7
42,Soria,119,Monteagudo de las Vicarías,206,107,99
42,Soria,120,Montejo de Tiermes,161,106,55
42,Soria,121,Montenegro de Cameros,61,39,22
42,Soria,123,Morón de Almazán,203,107,96
42,Soria,124,Muriel de la Fuente,64,37,27
42,Soria,125,Muriel Viejo,88,54,34
42,Soria,127,Nafría de Ucero,33,20,13
42,Soria,128,Narros,45,26,19
42,Soria,129,Navaleno,789,423,366
42,Soria,130,Nepas,57,38,19
42,Soria,131,Nolay,57,31,26
42,Soria,132,Noviercas,158,81,77
42,Soria,134,Ólvega,3621,1879,1742
42,Soria,135,Oncala,74,43,31
42,Soria,139,Pinilla del Campo,24,14,10
42,Soria,140,Portillo de Soria,16,11,5
42,Soria,141,"Póveda de Soria, La",114,70,44
42,Soria,142,Pozalmuro,63,28,35
42,Soria,144,Quintana Redonda,493,279,214
42,Soria,145,Quintanas de Gormaz,147,89,58
42,Soria,148,Quiñonería,9,5,4
42,Soria,149,"Rábanos, Los",479,272,207
42,Soria,151,Rebollar,39,18,21
42,Soria,152,Recuerda,88,50,38
42,Soria,153,Rello,15,10,5
42,Soria,154,Renieblas,106,64,42
42,Soria,155,Retortillo de Soria,169,102,67
42,Soria,156,Reznos,30,20,10
42,Soria,157,"Riba de Escalote, La",11,8,3
42,Soria,158,Rioseco de Soria,123,74,49
42,Soria,159,Rollamienta,36,24,12
42,Soria,160,"Royo, El",262,141,121
42,Soria,161,Salduero,141,79,62
42,Soria,162,San Esteban de Gormaz,3021,1596,1425
42,Soria,163,San Felices,58,35,23
42,Soria,164,San Leonardo de Yagüe,2083,1064,1019
42,Soria,165,San Pedro Manrique,602,336,266
42,Soria,166,Santa Cruz de Yanguas,63,41,22
42,Soria,167,Santa María de Huerta,285,157,128
42,Soria,168,Santa María de las Hoyas,106,59,47
42,Soria,171,Serón de Nágima,121,67,54
42,Soria,172,Soliedra,34,19,15
42,Soria,173,Soria,38881,18332,20549
42,Soria,174,Sotillo del Rincón,186,101,85
42,Soria,175,Suellacabras,27,16,11
42,Soria,176,Tajahuerce,29,16,13
42,Soria,177,Tajueco,71,40,31
42,Soria,178,Talveila,123,70,53
42,Soria,181,Tardelcuende,435,229,206
42,Soria,182,Taroda,47,25,22
42,Soria,183,Tejado,116,66,50
42,Soria,184,Torlengua,59,31,28
42,Soria,185,Torreblacos,26,14,12
42,Soria,187,Torrubia de Soria,68,48,20
42,Soria,188,Trévago,48,22,26
42,Soria,189,Ucero,53,28,25
42,Soria,190,Vadillo,97,54,43
42,Soria,191,Valdeavellano de Tera,192,106,86
42,Soria,192,Valdegeña,42,30,12
42,Soria,193,Valdelagua del Cerro,19,12,7
42,Soria,194,Valdemaluque,164,74,90
42,Soria,195,Valdenebro,114,66,48
42,Soria,196,Valdeprado,9,6,3
42,Soria,197,Valderrodilla,75,43,32
42,Soria,198,Valtajeros,25,14,11
42,Soria,200,Velamazán,87,55,32
42,Soria,201,Velilla de la Sierra,23,14,9
42,Soria,202,Velilla de los Ajos,21,12,9
42,Soria,204,Viana de Duero,53,39,14
42,Soria,205,Villaciervos,90,57,33
42,Soria,206,Villanueva de Gormaz,7,5,2
42,Soria,207,Villar del Ala,53,28,25
42,Soria,208,Villar del Campo,22,14,8
42,Soria,209,Villar del Río,143,88,55
42,Soria,211,"Villares de Soria, Los",86,51,35
42,Soria,212,Villasayas,71,46,25
42,Soria,213,Villaseca de Arciel,35,19,16
42,Soria,215,Vinuesa,888,479,409
42,Soria,216,Vizmanos,29,20,9
42,Soria,217,Vozmediano,37,24,13
42,Soria,218,Yanguas,93,60,33
42,Soria,219,Yelo,43,25,18
43,Tarragona,1,Aiguamúrcia,893,460,433
43,Tarragona,2,Albinyana,2340,1185,1155
43,Tarragona,3,"Albiol, L'",479,247,232
43,Tarragona,4,Alcanar,9393,4738,4655
43,Tarragona,5,Alcover,5163,2571,2592
43,Tarragona,904,"Aldea, L'",4211,2215,1996
43,Tarragona,6,Aldover,842,420,422
43,Tarragona,7,"Aleixar, L'",866,445,421
43,Tarragona,8,Alfara de Carles,369,199,170
43,Tarragona,9,Alforja,1799,923,876
43,Tarragona,10,Alió,408,195,213
43,Tarragona,11,Almoster,1361,682,679
43,Tarragona,12,Altafulla,5089,2485,2604
43,Tarragona,13,"Ametlla de Mar, L'",6887,3473,3414
43,Tarragona,906,"Ampolla, L'",3334,1699,1635
43,Tarragona,14,Amposta,20572,10331,10241
43,Tarragona,16,"Arboç, L'",5489,2822,2667
43,Tarragona,15,Arbolí,123,70,53
43,Tarragona,17,"Argentera, L'",135,76,59
43,Tarragona,18,Arnes,459,234,225
43,Tarragona,19,Ascó,1690,868,822
43,Tarragona,20,Banyeres del Penedès,3121,1572,1549
43,Tarragona,21,Barberà de la Conca,477,254,223
43,Tarragona,22,Batea,1938,965,973
43,Tarragona,23,Bellmunt del Priorat,290,146,144
43,Tarragona,24,Bellvei,2193,1125,1068
43,Tarragona,25,Benifallet,721,345,376
43,Tarragona,26,Benissanet,1172,631,541
43,Tarragona,27,"Bisbal de Falset, La",217,117,100
43,Tarragona,28,"Bisbal del Penedès, La",3460,1846,1614
43,Tarragona,29,Blancafort,381,199,182
43,Tarragona,30,Bonastre,661,333,328
43,Tarragona,31,"Borges del Camp, Les",2080,1057,1023
43,Tarragona,32,Bot,609,306,303
43,Tarragona,33,Botarell,1078,566,512
43,Tarragona,34,Bràfim,672,335,337
43,Tarragona,35,Cabacés,309,159,150
43,Tarragona,36,Cabra del Camp,1131,592,539
43,Tarragona,37,Calafell,24898,12541,12357
43,Tarragona,903,Camarles,3270,1661,1609
43,Tarragona,38,Cambrils,32855,16099,16756
43,Tarragona,907,"Canonja, La",5804,2849,2955
43,Tarragona,39,Capafonts,102,54,48
43,Tarragona,40,Capçanes,403,201,202
43,Tarragona,41,Caseres,234,118,116
43,Tarragona,42,Castellvell del Camp,2849,1425,1424
43,Tarragona,43,"Catllar, El",4251,2195,2056
43,Tarragona,45,Colldejou,170,91,79
43,Tarragona,46,Conesa,111,57,54
43,Tarragona,47,Constantí,6493,3368,3125
43,Tarragona,48,Corbera d'Ebre,1061,566,495
43,Tarragona,49,Cornudella de Montsant,953,503,450
43,Tarragona,50,Creixell,3465,1761,1704
43,Tarragona,51,Cunit,12041,5902,6139
43,Tarragona,901,Deltebre,11499,5793,5706
43,Tarragona,53,Duesaigües,243,140,103
43,Tarragona,54,"Espluga de Francolí, L'",3756,1807,1949
43,Tarragona,55,Falset,2820,1409,1411
43,Tarragona,56,"Fatarella, La",980,482,498
43,Tarragona,57,"Febró, La",42,27,15
43,Tarragona,58,"Figuera, La",102,59,43
43,Tarragona,59,Figuerola del Camp,330,160,170
43,Tarragona,60,Flix,3605,1807,1798
43,Tarragona,61,Forès,45,27,18
43,Tarragona,62,Freginals,397,208,189
43,Tarragona,63,"Galera, La",719,370,349
43,Tarragona,64,Gandesa,3011,1540,1471
43,Tarragona,65,Garcia,531,269,262
43,Tarragona,66,"Garidells, Els",194,95,99
43,Tarragona,67,Ginestar,777,406,371
43,Tarragona,68,Godall,608,307,301
43,Tarragona,69,Gratallops,237,128,109
43,Tarragona,70,"Guiamets, Els",272,126,146
43,Tarragona,71,Horta de Sant Joan,1171,610,561
43,Tarragona,72,"Lloar, El",117,60,57
43,Tarragona,73,Llorac,93,52,41
43,Tarragona,74,Llorenç del Penedès,2302,1142,1160
43,Tarragona,76,Marçà,602,322,280
43,Tarragona,75,Margalef,101,60,41
43,Tarragona,77,Mas de Barberans,584,288,296
43,Tarragona,78,Masdenverge,1067,551,516
43,Tarragona,79,Masllorenç,496,268,228
43,Tarragona,80,"Masó, La",281,153,128
43,Tarragona,81,Maspujols,791,403,388
43,Tarragona,82,"Masroig, El",510,283,227
43,Tarragona,83,"Milà, El",182,92,90
43,Tarragona,84,Miravet,726,389,337
43,Tarragona,85,"Molar, El",286,151,135
43,Tarragona,86,Montblanc,7307,3682,3625
43,Tarragona,88,Montbrió del Camp,2806,1453,1353
43,Tarragona,89,Montferri,388,209,179
43,Tarragona,90,"Montmell, El",1405,747,658
43,Tarragona,91,Mont-ral,164,97,67
43,Tarragona,92,Mont-roig del Camp,11597,6035,5562
43,Tarragona,93,Móra d'Ebre,5625,2801,2824
43,Tarragona,94,Móra la Nova,3070,1542,1528
43,Tarragona,95,"Morell, El",3631,1850,1781
43,Tarragona,96,"Morera de Montsant, La",158,90,68
43,Tarragona,97,"Nou de Gaià, La",563,275,288
43,Tarragona,98,Nulles,464,249,215
43,Tarragona,100,"Pallaresos, Els",4635,2348,2287
43,Tarragona,99,"Palma d'Ebre, La",356,171,185
43,Tarragona,101,Passanant i Belltall,149,85,64
43,Tarragona,102,Paüls,567,276,291
43,Tarragona,103,Perafort,1253,654,599
43,Tarragona,104,"Perelló, El",2884,1492,1392
43,Tarragona,105,"Piles, Les",216,116,100
43,Tarragona,106,"Pinell de Brai, El",1012,509,503
43,Tarragona,107,Pira,500,269,231
43,Tarragona,108,"Pla de Santa Maria, El",2266,1166,1100
43,Tarragona,109,"Pobla de Mafumet, La",3854,1983,1871
43,Tarragona,110,"Pobla de Massaluca, La",335,184,151
43,Tarragona,111,"Pobla de Montornès, La",2795,1468,1327
43,Tarragona,112,Poboleda,356,198,158
43,Tarragona,113,"Pont d'Armentera, El",501,252,249
43,Tarragona,141,Pontils,118,65,53
43,Tarragona,114,Porrera,441,236,205
43,Tarragona,115,Pradell de la Teixeta,163,76,87
43,Tarragona,116,Prades,599,317,282
43,Tarragona,117,Prat de Comte,181,98,83
43,Tarragona,118,Pratdip,718,374,344
43,Tarragona,119,Puigpelat,1147,588,559
43,Tarragona,120,Querol,532,298,234
43,Tarragona,121,Rasquera,796,396,400
43,Tarragona,122,Renau,153,78,75
43,Tarragona,123,Reus,103123,49805,53318
43,Tarragona,124,"Riba, La",590,322,268
43,Tarragona,125,Riba-roja d'Ebre,1116,589,527
43,Tarragona,126,"Riera de Gaià, La",1704,851,853
43,Tarragona,127,Riudecanyes,1101,576,525
43,Tarragona,128,Riudecols,1165,611,554
43,Tarragona,129,Riudoms,6515,3357,3158
43,Tarragona,130,Rocafort de Queralt,241,124,117
43,Tarragona,131,Roda de Berà,6354,3273,3081
43,Tarragona,132,Rodonyà,498,262,236
43,Tarragona,133,Roquetes,8084,4194,3890
43,Tarragona,134,"Rourell, El",369,184,185
43,Tarragona,135,Salomó,545,284,261
43,Tarragona,905,Salou,26233,13618,12615
43,Tarragona,136,Sant Carles de la Ràpita,14902,7295,7607
43,Tarragona,137,Sant Jaume dels Domenys,2561,1319,1242
43,Tarragona,902,Sant Jaume d'Enveja,3479,1748,1731
43,Tarragona,138,Santa Bàrbara,3797,1933,1864
43,Tarragona,139,Santa Coloma de Queralt,2695,1334,1361
43,Tarragona,140,Santa Oliva,3315,1679,1636
43,Tarragona,142,Sarral,1560,789,771
43,Tarragona,143,Savallà del Comtat,56,28,28
43,Tarragona,144,"Secuita, La",1676,841,835
43,Tarragona,145,"Selva del Camp, La",5546,2786,2760
43,Tarragona,146,Senan,49,33,16
43,Tarragona,44,"Sénia, La",5652,2837,2815
43,Tarragona,147,Solivella,614,312,302
43,Tarragona,148,Tarragona,131507,63941,67566
43,Tarragona,149,Tivenys,879,448,431
43,Tarragona,150,Tivissa,1677,841,836
43,Tarragona,151,"Torre de Fontaubella, La",137,72,65
43,Tarragona,152,"Torre de l'Espanyol, La",634,327,307
43,Tarragona,153,Torredembarra,15726,7667,8059
43,Tarragona,154,Torroja del Priorat,149,82,67
43,Tarragona,155,Tortosa,33445,16613,16832
43,Tarragona,156,Ulldecona,6321,3252,3069
43,Tarragona,157,Ulldemolins,395,226,169
43,Tarragona,158,Vallclara,103,62,41
43,Tarragona,159,Vallfogona de Riucorb,87,51,36
43,Tarragona,160,Vallmoll,1702,864,838
43,Tarragona,161,Valls,24112,11978,12134
43,Tarragona,162,Vandellòs i l'Hospitalet de l'Infant,6294,3155,3139
43,Tarragona,163,"Vendrell, El",36568,18145,18423
43,Tarragona,164,Vespella de Gaià,424,234,190
43,Tarragona,165,Vilabella,749,388,361
43,Tarragona,175,Vilalba dels Arcs,643,323,320
43,Tarragona,166,Vilallonga del Camp,2340,1200,1140
43,Tarragona,168,Vilanova de Prades,121,63,58
43,Tarragona,167,Vilanova d'Escornalbou,521,275,246
43,Tarragona,169,Vilaplana,585,299,286
43,Tarragona,170,Vila-rodona,1259,653,606
43,Tarragona,171,Vila-seca,21993,11062,10931
43,Tarragona,172,Vilaverd,440,228,212
43,Tarragona,173,"Vilella Alta, La",127,69,58
43,Tarragona,174,"Vilella Baixa, La",200,111,89
43,Tarragona,176,Vimbodí i Poblet,917,509,408
43,Tarragona,177,Vinebre,428,214,214
43,Tarragona,178,Vinyols i els Arcs,1928,1003,925
43,Tarragona,52,Xerta,1188,578,610
44,Teruel,1,Ababuj,73,45,28
44,Teruel,2,Abejuela,50,31,19
44,Teruel,3,Aguatón,19,7,12
44,Teruel,4,Aguaviva,531,262,269
44,Teruel,5,Aguilar del Alfambra,65,38,27
44,Teruel,6,Alacón,274,139,135
44,Teruel,7,Alba,185,103,82
44,Teruel,8,Albalate del Arzobispo,1978,1008,970
44,Teruel,9,Albarracín,1044,541,503
44,Teruel,10,Albentosa,255,134,121
44,Teruel,11,Alcaine,62,38,24
44,Teruel,12,Alcalá de la Selva,369,202,167
44,Teruel,13,Alcañiz,15937,7910,8027
44,Teruel,14,Alcorisa,3313,1681,1632
44,Teruel,16,Alfambra,554,289,265
44,Teruel,17,Aliaga,348,191,157
44,Teruel,21,Allepuz,129,65,64
44,Teruel,22,Alloza,594,305,289
44,Teruel,23,Allueva,31,17,14
44,Teruel,18,Almohaja,18,13,5
44,Teruel,19,Alobras,65,38,27
44,Teruel,20,Alpeñés,23,14,9
44,Teruel,24,Anadón,27,17,10
44,Teruel,25,Andorra,7799,3935,3864
44,Teruel,26,Arcos de las Salinas,106,59,47
44,Teruel,27,Arens de Lledó,199,96,103
44,Teruel,28,Argente,207,99,108
44,Teruel,29,Ariño,733,367,366
44,Teruel,31,Azaila,97,47,50
44,Teruel,32,Bádenas,18,10,8
44,Teruel,33,Báguena,318,175,143
44,Teruel,34,Bañón,149,81,68
44,Teruel,35,Barrachina,121,65,56
44,Teruel,36,Bea,30,18,12
44,Teruel,37,Beceite,551,281,270
44,Teruel,39,Bello,244,113,131
44,Teruel,38,Belmonte de San José,113,55,58
44,Teruel,40,Berge,245,125,120
44,Teruel,41,Bezas,62,39,23
44,Teruel,42,Blancas,134,77,57
44,Teruel,43,Blesa,97,64,33
44,Teruel,44,Bordón,108,62,46
44,Teruel,45,Bronchales,440,250,190
44,Teruel,46,Bueña,57,31,26
44,Teruel,47,Burbáguena,254,135,119
44,Teruel,48,Cabra de Mora,64,37,27
44,Teruel,49,Calaceite,1038,517,521
44,Teruel,50,Calamocha,4353,2152,2201
44,Teruel,51,Calanda,3729,1852,1877
44,Teruel,52,Calomarde,78,47,31
44,Teruel,53,Camañas,129,71,58
44,Teruel,54,Camarena de la Sierra,116,71,45
44,Teruel,55,Camarillas,89,53,36
44,Teruel,56,Caminreal,616,316,300
44,Teruel,59,Cantavieja,717,380,337
44,Teruel,60,Cañada de Benatanduz,42,28,14
44,Teruel,61,"Cañada de Verich, La",85,53,32
44,Teruel,62,Cañada Vellida,35,25,10
44,Teruel,63,Cañizar del Olivar,93,50,43
44,Teruel,64,Cascante del Río,73,44,29
44,Teruel,65,Castejón de Tornos,62,37,25
44,Teruel,66,Castel de Cabra,112,60,52
44,Teruel,70,"Castellar, El",54,36,18
44,Teruel,71,Castellote,688,352,336
44,Teruel,67,Castelnou,146,74,72
44,Teruel,68,Castelserás,823,428,395
44,Teruel,74,Cedrillas,611,311,300
44,Teruel,75,Celadas,408,231,177
44,Teruel,76,Cella,2640,1378,1262
44,Teruel,77,"Cerollera, La",98,59,39
44,Teruel,80,"Codoñera, La",362,193,169
44,Teruel,82,Corbalán,109,59,50
44,Teruel,84,Cortes de Aragón,57,23,34
44,Teruel,85,Cosa,55,31,24
44,Teruel,86,Cretas,572,294,278
44,Teruel,87,Crivillén,71,36,35
44,Teruel,88,"Cuba, La",36,20,16
44,Teruel,89,Cubla,55,38,17
44,Teruel,90,Cucalón,91,54,37
44,Teruel,92,"Cuervo, El",93,49,44
44,Teruel,93,Cuevas de Almudén,138,77,61
44,Teruel,94,Cuevas Labradas,126,70,56
44,Teruel,96,Ejulve,187,97,90
44,Teruel,97,Escorihuela,147,74,73
44,Teruel,99,Escucha,913,495,418
44,Teruel,100,Estercuel,223,127,96
44,Teruel,101,Ferreruela de Huerva,65,36,29
44,Teruel,102,Fonfría,30,17,13
44,Teruel,103,Formiche Alto,155,85,70
44,Teruel,105,Fórnoles,78,42,36
44,Teruel,106,Fortanete,203,114,89
44,Teruel,107,Foz-Calanda,260,136,124
44,Teruel,108,"Fresneda, La",436,244,192
44,Teruel,109,Frías de Albarracín,125,70,55
44,Teruel,110,Fuenferrada,51,30,21
44,Teruel,111,Fuentes Calientes,111,61,50
44,Teruel,112,Fuentes Claras,482,264,218
44,Teruel,113,Fuentes de Rubielos,112,59,53
44,Teruel,114,Fuentespalda,298,150,148
44,Teruel,115,Galve,162,82,80
44,Teruel,116,Gargallo,101,51,50
44,Teruel,117,Gea de Albarracín,372,198,174
44,Teruel,118,"Ginebrosa, La",197,106,91
44,Teruel,119,Griegos,151,91,60
44,Teruel,120,Guadalaviar,241,138,103
44,Teruel,121,Gúdar,81,44,37
44,Teruel,122,Híjar,1697,856,841
44,Teruel,123,Hinojosa de Jarque,132,76,56
44,Teruel,124,"Hoz de la Vieja, La",86,45,41
44,Teruel,125,Huesa del Común,67,42,25
44,Teruel,126,"Iglesuela del Cid, La",414,215,199
44,Teruel,127,Jabaloyas,68,38,30
44,Teruel,128,Jarque de la Val,72,38,34
44,Teruel,129,Jatiel,41,23,18
44,Teruel,130,Jorcas,32,19,13
44,Teruel,131,Josa,32,19,13
44,Teruel,132,Lagueruela,84,45,39
44,Teruel,133,Lanzuela,27,20,7
44,Teruel,135,Libros,103,65,38
44,Teruel,136,Lidón,53,27,26
44,Teruel,137,Linares de Mora,260,152,108
44,Teruel,141,Lledó,166,90,76
44,Teruel,138,Loscos,139,83,56
44,Teruel,142,Maicas,31,17,14
44,Teruel,143,Manzanera,512,271,241
44,Teruel,144,Martín del Río,432,214,218
44,Teruel,145,Mas de las Matas,1270,665,605
44,Teruel,146,"Mata de los Olmos, La",272,136,136
44,Teruel,147,Mazaleón,543,292,251
44,Teruel,148,Mezquita de Jarque,102,60,42
44,Teruel,149,Mirambel,119,68,51
44,Teruel,150,Miravete de la Sierra,31,21,10
44,Teruel,151,Molinos,245,129,116
44,Teruel,152,Monforte de Moyuela,64,46,18
44,Teruel,153,Monreal del Campo,2478,1231,1247
44,Teruel,154,Monroyo,335,201,134
44,Teruel,155,Montalbán,1256,632,624
44,Teruel,156,Monteagudo del Castillo,51,27,24
44,Teruel,157,Monterde de Albarracín,62,35,27
44,Teruel,158,Mora de Rubielos,1565,784,781
44,Teruel,159,Moscardón,57,30,27
44,Teruel,160,Mosqueruela,558,305,253
44,Teruel,161,Muniesa,630,330,300
44,Teruel,163,Noguera de Albarracín,134,73,61
44,Teruel,164,Nogueras,28,18,10
44,Teruel,165,Nogueruelas,211,117,94
44,Teruel,167,Obón,44,24,20
44,Teruel,168,Odón,217,117,100
44,Teruel,169,Ojos Negros,393,211,182
44,Teruel,171,Olba,227,131,96
44,Teruel,172,Oliete,357,184,173
44,Teruel,173,"Olmos, Los",122,67,55
44,Teruel,174,Orihuela del Tremedal,493,272,221
44,Teruel,175,Orrios,127,68,59
44,Teruel,176,Palomar de Arroyos,169,101,68
44,Teruel,177,Pancrudo,119,72,47
44,Teruel,178,"Parras de Castellote, Las",61,35,26
44,Teruel,179,Peñarroya de Tastavins,461,251,210
44,Teruel,180,Peracense,75,43,32
44,Teruel,181,Peralejos,87,47,40
44,Teruel,182,Perales del Alfambra,221,119,102
44,Teruel,183,Pitarque,84,43,41
44,Teruel,184,Plou,45,30,15
44,Teruel,185,"Pobo, El",129,80,49
44,Teruel,187,"Portellada, La",246,124,122
44,Teruel,189,Pozondón,54,30,24
44,Teruel,190,Pozuel del Campo,70,38,32
44,Teruel,191,"Puebla de Híjar, La",944,475,469
44,Teruel,192,"Puebla de Valverde, La",457,253,204
44,Teruel,193,Puertomingalvo,117,64,53
44,Teruel,194,Ráfales,146,82,64
44,Teruel,195,Rillo,92,52,40
44,Teruel,196,Riodeva,149,72,77
44,Teruel,197,Ródenas,62,34,28
44,Teruel,198,Royuela,209,113,96
44,Teruel,199,Rubiales,52,29,23
44,Teruel,200,Rubielos de la Cérida,38,23,15
44,Teruel,201,Rubielos de Mora,626,324,302
44,Teruel,203,Salcedillo,17,11,6
44,Teruel,204,Saldón,26,17,9
44,Teruel,205,Samper de Calanda,821,409,412
44,Teruel,206,San Agustín,131,84,47
44,Teruel,207,San Martín del Río,155,82,73
44,Teruel,208,Santa Cruz de Nogueras,38,19,19
44,Teruel,209,Santa Eulalia,1033,523,510
44,Teruel,210,Sarrión,1125,596,529
44,Teruel,211,Segura de los Baños,43,27,16
44,Teruel,212,Seno,40,18,22
44,Teruel,213,Singra,79,47,32
44,Teruel,215,Terriente,178,101,77
44,Teruel,216,Teruel,35484,16936,18548
44,Teruel,217,Toril y Masegoso,29,24,5
44,Teruel,218,Tormón,34,20,14
44,Teruel,219,Tornos,222,118,104
44,Teruel,220,Torralba de los Sisones,162,90,72
44,Teruel,223,Torre de Arcas,83,38,45
44,Teruel,224,Torre de las Arcas,28,14,14
44,Teruel,225,Torre del Compte,130,64,66
44,Teruel,227,Torre los Negros,86,45,41
44,Teruel,221,Torrecilla de Alcañiz,426,224,202
44,Teruel,222,Torrecilla del Rebollar,136,87,49
44,Teruel,226,Torrelacárcel,169,89,80
44,Teruel,228,Torremocha de Jiloca,107,61,46
44,Teruel,229,Torres de Albarracín,178,99,79
44,Teruel,230,Torrevelilla,192,94,98
44,Teruel,231,Torrijas,39,18,21
44,Teruel,232,Torrijo del Campo,447,237,210
44,Teruel,234,Tramacastiel,67,38,29
44,Teruel,235,Tramacastilla,107,52,55
44,Teruel,236,Tronchón,69,37,32
44,Teruel,237,Urrea de Gaén,461,228,233
44,Teruel,238,Utrillas,3014,1554,1460
44,Teruel,239,Valacloche,23,13,10
44,Teruel,240,Valbona,181,99,82
44,Teruel,241,Valdealgorfa,632,317,315
44,Teruel,243,Valdecuenca,37,23,14
44,Teruel,244,Valdelinares,89,52,37
44,Teruel,245,Valdeltormo,298,144,154
44,Teruel,246,Valderrobres,2338,1179,1159
44,Teruel,247,Valjunquera,341,175,166
44,Teruel,249,"Vallecillo, El",49,28,21
44,Teruel,250,Veguillas de la Sierra,19,11,8
44,Teruel,251,Villafranca del Campo,289,149,140
44,Teruel,252,Villahermosa del Campo,94,63,31
44,Teruel,256,Villanueva del Rebollar de la Sierra,43,25,18
44,Teruel,257,Villar del Cobo,175,100,75
44,Teruel,258,Villar del Salz,59,36,23
44,Teruel,260,Villarluengo,169,103,66
44,Teruel,261,Villarquemado,875,455,420
44,Teruel,262,Villarroya de los Pinares,155,82,73
44,Teruel,263,Villastar,501,252,249
44,Teruel,264,Villel,330,188,142
44,Teruel,265,Vinaceite,262,135,127
44,Teruel,266,Visiedo,135,59,76
44,Teruel,267,Vivel del Río Martín,71,37,34
44,Teruel,268,"Zoma, La",18,6,12
45,Toledo,1,Ajofrín,2245,1114,1131
45,Toledo,2,Alameda de la Sagra,3534,1848,1686
45,Toledo,3,Albarreal de Tajo,702,364,338
45,Toledo,4,Alcabón,685,355,330
45,Toledo,5,Alcañizo,286,146,140
45,Toledo,6,Alcaudete de la Jara,1748,886,862
45,Toledo,7,Alcolea de Tajo,820,407,413
45,Toledo,8,Aldea en Cabo,165,86,79
45,Toledo,9,Aldeanueva de Barbarroya,561,284,277
45,Toledo,10,Aldeanueva de San Bartolomé,452,237,215
45,Toledo,11,Almendral de la Cañada,316,169,147
45,Toledo,12,Almonacid de Toledo,814,398,416
45,Toledo,13,Almorox,2215,1166,1049
45,Toledo,14,Añover de Tajo,5148,2639,2509
45,Toledo,15,Arcicóllar,780,393,387
45,Toledo,16,Argés,6163,3107,3056
45,Toledo,17,Azután,289,143,146
45,Toledo,18,Barcience,806,421,385
45,Toledo,19,Bargas,10030,5016,5014
45,Toledo,20,Belvís de la Jara,1567,782,785
45,Toledo,21,Borox,3626,1899,1727
45,Toledo,22,Buenaventura,423,215,208
45,Toledo,23,Burguillos de Toledo,3173,1628,1545
45,Toledo,24,Burujón,1324,684,640
45,Toledo,25,Cabañas de la Sagra,1777,913,864
45,Toledo,26,Cabañas de Yepes,237,126,111
45,Toledo,27,Cabezamesada,360,193,167
45,Toledo,28,Calera y Chozas,4631,2354,2277
45,Toledo,29,Caleruela,223,111,112
45,Toledo,30,Calzada de Oropesa,534,295,239
45,Toledo,31,Camarena,3734,1933,1801
45,Toledo,32,Camarenilla,556,284,272
45,Toledo,33,"Campillo de la Jara, El",373,198,175
45,Toledo,34,Camuñas,1779,919,860
45,Toledo,35,Cardiel de los Montes,348,185,163
45,Toledo,36,Carmena,743,380,363
45,Toledo,37,"Carpio de Tajo, El",1930,963,967
45,Toledo,38,Carranque,4681,2424,2257
45,Toledo,39,Carriches,266,137,129
45,Toledo,40,"Casar de Escalona, El",1841,984,857
45,Toledo,41,Casarrubios del Monte,5335,2809,2526
45,Toledo,42,Casasbuenas,201,99,102
45,Toledo,43,Castillo de Bayuela,894,452,442
45,Toledo,45,Cazalegas,1743,887,856
45,Toledo,46,Cebolla,3344,1698,1646
45,Toledo,47,Cedillo del Condado,3727,1936,1791
45,Toledo,48,"Cerralbos, Los",414,222,192
45,Toledo,49,Cervera de los Montes,520,266,254
45,Toledo,56,Chozas de Canales,3760,1981,1779
45,Toledo,57,Chueca,265,143,122
45,Toledo,50,Ciruelos,544,289,255
45,Toledo,51,Cobeja,2192,1144,1048
45,Toledo,52,Cobisa,4221,2110,2111
45,Toledo,53,Consuegra,10146,5122,5024
45,Toledo,54,Corral de Almaguer,5443,2791,2652
45,Toledo,55,Cuerva,1361,713,648
45,Toledo,58,Domingo Pérez,417,215,202
45,Toledo,59,Dosbarrios,2230,1141,1089
45,Toledo,60,Erustes,211,108,103
45,Toledo,61,Escalona,3240,1667,1573
45,Toledo,62,Escalonilla,1447,722,725
45,Toledo,63,Espinoso del Rey,466,258,208
45,Toledo,64,Esquivias,5378,2710,2668
45,Toledo,65,"Estrella, La",241,126,115
45,Toledo,66,Fuensalida,10976,5542,5434
45,Toledo,67,Gálvez,3075,1541,1534
45,Toledo,68,Garciotum,190,96,94
45,Toledo,69,Gerindote,2347,1199,1148
45,Toledo,70,Guadamur,1802,906,896
45,Toledo,71,"Guardia, La",2248,1140,1108
45,Toledo,72,"Herencias, Las",793,425,368
45,Toledo,73,Herreruela de Oropesa,357,183,174
45,Toledo,74,Hinojosa de San Vicente,415,227,188
45,Toledo,75,Hontanar,163,99,64
45,Toledo,76,Hormigos,686,371,315
45,Toledo,77,Huecas,654,333,321
45,Toledo,78,Huerta de Valdecarábanos,1703,841,862
45,Toledo,79,"Iglesuela, La",425,220,205
45,Toledo,80,Illán de Vacas,5,4,1
45,Toledo,81,Illescas,27332,13866,13466
45,Toledo,82,Lagartera,1422,710,712
45,Toledo,83,Layos,652,322,330
45,Toledo,84,Lillo,2695,1399,1296
45,Toledo,85,Lominchar,2369,1232,1137
45,Toledo,86,Lucillos,591,310,281
45,Toledo,87,Madridejos,10637,5333,5304
45,Toledo,88,Magán,3259,1670,1589
45,Toledo,89,Malpica de Tajo,1802,920,882
45,Toledo,90,Manzaneque,406,198,208
45,Toledo,91,Maqueda,469,237,232
45,Toledo,92,Marjaliza,270,130,140
45,Toledo,93,Marrupe,156,83,73
45,Toledo,94,Mascaraque,444,223,221
45,Toledo,95,"Mata, La",864,438,426
45,Toledo,96,Mazarambroz,1259,648,611
45,Toledo,97,Mejorada,1266,658,608
45,Toledo,98,Menasalbas,2739,1440,1299
45,Toledo,99,Méntrida,4900,2496,2404
45,Toledo,100,Mesegar de Tajo,228,124,104
45,Toledo,101,Miguel Esteban,4976,2494,2482
45,Toledo,102,Mocejón,4830,2442,2388
45,Toledo,103,Mohedas de la Jara,420,233,187
45,Toledo,104,Montearagón,520,270,250
45,Toledo,105,Montesclaros,417,224,193
45,Toledo,106,Mora,9853,4946,4907
45,Toledo,107,Nambroca,4557,2346,2211
45,Toledo,108,"Nava de Ricomalillo, La",565,294,271
45,Toledo,109,Navahermosa,3738,1913,1825
45,Toledo,110,Navalcán,2080,1095,985
45,Toledo,111,Navalmoralejo,64,34,30
45,Toledo,112,"Navalmorales, Los",2617,1361,1256
45,Toledo,113,"Navalucillos, Los",2251,1159,1092
45,Toledo,114,Navamorcuende,643,323,320
45,Toledo,115,Noblejas,3499,1776,1723
45,Toledo,116,Noez,881,450,431
45,Toledo,117,Nombela,895,471,424
45,Toledo,118,Novés,2721,1403,1318
45,Toledo,119,Numancia de la Sagra,4755,2496,2259
45,Toledo,120,Nuño Gómez,138,77,61
45,Toledo,121,Ocaña,10733,5418,5315
45,Toledo,122,Olías del Rey,7587,3876,3711
45,Toledo,123,Ontígola,4272,2274,1998
45,Toledo,124,Orgaz,2675,1334,1341
45,Toledo,125,Oropesa,2730,1347,1383
45,Toledo,126,Otero,343,172,171
45,Toledo,127,Palomeque,894,477,417
45,Toledo,128,Pantoja,3277,1646,1631
45,Toledo,129,Paredes de Escalona,129,62,67
45,Toledo,130,Parrillas,355,192,163
45,Toledo,131,Pelahustán,318,177,141
45,Toledo,132,Pepino,2809,1461,1348
45,Toledo,133,Polán,3849,1931,1918
45,Toledo,134,Portillo de Toledo,2138,1070,1068
45,Toledo,135,"Puebla de Almoradiel, La",5360,2721,2639
45,Toledo,136,"Puebla de Montalbán, La",7910,4015,3895
45,Toledo,137,"Pueblanueva, La",2252,1133,1119
45,Toledo,138,"Puente del Arzobispo, El",1279,630,649
45,Toledo,139,Puerto de San Vicente,165,87,78
45,Toledo,140,Pulgar,1555,795,760
45,Toledo,141,Quero,1042,531,511
45,Toledo,142,Quintanar de la Orden,10926,5445,5481
45,Toledo,143,Quismondo,1509,784,725
45,Toledo,144,"Real de San Vicente, El",969,512,457
45,Toledo,145,Recas,4220,2339,1881
45,Toledo,146,Retamoso de la Jara,105,53,52
45,Toledo,147,Rielves,756,384,372
45,Toledo,148,Robledo del Mazo,299,169,130
45,Toledo,149,"Romeral, El",609,305,304
45,Toledo,150,San Bartolomé de las Abiertas,464,248,216
45,Toledo,151,San Martín de Montalbán,744,370,374
45,Toledo,152,San Martín de Pusa,685,358,327
45,Toledo,153,San Pablo de los Montes,1867,944,923
45,Toledo,154,San Román de los Montes,1887,1005,882
45,Toledo,155,Santa Ana de Pusa,397,227,170
45,Toledo,156,Santa Cruz de la Zarza,4285,2165,2120
45,Toledo,157,Santa Cruz del Retamar,2871,1494,1377
45,Toledo,158,Santa Olalla,3219,1658,1561
45,Toledo,901,Santo Domingo-Caudilla,1019,540,479
45,Toledo,159,Sartajada,102,60,42
45,Toledo,160,Segurilla,1345,673,672
45,Toledo,161,Seseña,22992,11882,11110
45,Toledo,162,Sevilleja de la Jara,717,390,327
45,Toledo,163,Sonseca,11068,5611,5457
45,Toledo,164,Sotillo de las Palomas,198,107,91
45,Toledo,165,Talavera de la Reina,83303,40041,43262
45,Toledo,166,Tembleque,2036,1029,1007
45,Toledo,167,"Toboso, El",1831,921,910
45,Toledo,168,Toledo,83741,40038,43703
45,Toledo,169,Torralba de Oropesa,210,110,100
45,Toledo,171,"Torre de Esteban Hambrán, La",1712,875,837
45,Toledo,170,Torrecilla de la Jara,238,122,116
45,Toledo,172,Torrico,748,382,366
45,Toledo,173,Torrijos,13295,6578,6717
45,Toledo,174,Totanés,355,179,176
45,Toledo,175,Turleque,804,411,393
45,Toledo,176,Ugena,5297,2747,2550
45,Toledo,177,Urda,2636,1307,1329
45,Toledo,179,Valdeverdeja,598,295,303
45,Toledo,180,Valmojado,4126,2073,2053
45,Toledo,181,Velada,2859,1485,1374
45,Toledo,182,"Ventas con Peña Aguilera, Las",1144,584,560
45,Toledo,183,"Ventas de Retamosa, Las",3266,1728,1538
45,Toledo,184,"Ventas de San Julián, Las",231,113,118
45,Toledo,186,"Villa de Don Fadrique, La",3798,1890,1908
45,Toledo,185,Villacañas,9840,4898,4942
45,Toledo,187,Villafranca de los Caballeros,5024,2500,2524
45,Toledo,188,Villaluenga de la Sagra,3780,1887,1893
45,Toledo,189,Villamiel de Toledo,876,455,421
45,Toledo,190,Villaminaya,552,280,272
45,Toledo,191,Villamuelas,632,331,301
45,Toledo,192,Villanueva de Alcardete,3362,1743,1619
45,Toledo,193,Villanueva de Bogas,742,380,362
45,Toledo,194,Villarejo de Montalbán,82,46,36
45,Toledo,195,Villarrubia de Santiago,2588,1299,1289
45,Toledo,196,Villaseca de la Sagra,1815,911,904
45,Toledo,197,Villasequilla,2510,1296,1214
45,Toledo,198,Villatobas,2407,1244,1163
45,Toledo,199,"Viso de San Juan, El",4238,2264,1974
45,Toledo,200,"Yébenes, Los",6009,3079,2930
45,Toledo,201,Yeles,5177,2703,2474
45,Toledo,202,Yepes,5074,2604,2470
45,Toledo,203,Yuncler,3679,1863,1816
45,Toledo,204,Yunclillos,830,428,402
45,Toledo,205,Yuncos,10827,5571,5256
46,Valencia/València,1,Ademuz,1073,574,499
46,Valencia/València,2,Ador,1400,745,655
46,Valencia/València,4,Agullent,2387,1189,1198
46,Valencia/València,42,Aielo de Malferit,4706,2352,2354
46,Valencia/València,43,Aielo de Rugat,160,86,74
46,Valencia/València,5,Alaquàs,29474,14455,15019
46,Valencia/València,6,Albaida,5946,2944,3002
46,Valencia/València,7,Albal,16244,8135,8109
46,Valencia/València,8,Albalat de la Ribera,3361,1697,1664
46,Valencia/València,9,Albalat dels Sorells,3900,1915,1985
46,Valencia/València,10,Albalat dels Tarongers,1169,626,543
46,Valencia/València,11,Alberic,10504,5239,5265
46,Valencia/València,12,Alborache,1140,601,539
46,Valencia/València,13,Alboraia/Alboraya,24031,11802,12229
46,Valencia/València,14,Albuixech,3911,1931,1980
46,Valencia/València,16,Alcàntera de Xúquer,1318,655,663
46,Valencia/València,15,Alcàsser,9813,4944,4869
46,Valencia/València,18,Alcublas,678,355,323
46,Valencia/València,20,"Alcúdia de Crespins, l'",5108,2541,2567
46,Valencia/València,19,"Alcúdia, l'",11926,5838,6088
46,Valencia/València,21,Aldaia,31320,15624,15696
46,Valencia/València,22,Alfafar,20776,10173,10603
46,Valencia/València,24,Alfara de la Baronia,535,266,269
46,Valencia/València,25,Alfara del Patriarca,3348,1630,1718
46,Valencia/València,26,Alfarp,1517,778,739
46,Valencia/València,27,Alfarrasí,1256,622,634
46,Valencia/València,23,Alfauir,448,229,219
46,Valencia/València,28,Algar de Palancia,471,242,229
46,Valencia/València,29,Algemesí,27511,13685,13826
46,Valencia/València,30,Algimia de Alfara,1051,527,524
46,Valencia/València,31,Alginet,13186,6702,6484
46,Valencia/València,32,Almàssera,7308,3565,3743
46,Valencia/València,33,Almiserà,261,132,129
46,Valencia/València,34,Almoines,2343,1173,1170
46,Valencia/València,35,Almussafes,8914,4463,4451
46,Valencia/València,36,Alpuente,644,356,288
46,Valencia/València,37,"Alqueria de la Comtessa, l'",1443,708,735
46,Valencia/València,17,Alzira,44255,21566,22689
46,Valencia/València,38,Andilla,322,209,113
46,Valencia/València,39,Anna,2639,1336,1303
46,Valencia/València,40,Antella,1233,610,623
46,Valencia/València,41,Aras de los Olmos,375,207,168
46,Valencia/València,3,Atzeneta d'Albaida,1155,590,565
46,Valencia/València,44,Ayora,5311,2645,2666
46,Valencia/València,46,Barx,1227,637,590
46,Valencia/València,45,Barxeta,1577,814,763
46,Valencia/València,47,Bèlgida,690,336,354
46,Valencia/València,48,Bellreguard,4550,2255,2295
46,Valencia/València,49,Bellús,315,161,154
46,Valencia/València,50,Benagéber,192,107,85
46,Valencia/València,51,Benaguasil,10960,5564,5396
46,Valencia/València,52,Benavites,613,290,323
46,Valencia/València,53,Beneixida,648,316,332
46,Valencia/València,54,Benetússer,14495,7041,7454
46,Valencia/València,55,Beniarjó,1759,880,879
46,Valencia/València,56,Beniatjar,219,110,109
46,Valencia/València,57,Benicolet,585,294,291
46,Valencia/València,904,Benicull de Xúquer,970,484,486
46,Valencia/València,60,Benifaió,11956,5948,6008
46,Valencia/València,59,Benifairó de la Valldigna,1596,792,804
46,Valencia/València,58,Benifairó de les Valls,2205,1097,1108
46,Valencia/València,61,Beniflá,458,233,225
46,Valencia/València,62,Benigànim,5850,2957,2893
46,Valencia/València,63,Benimodo,2230,1137,1093
46,Valencia/València,64,Benimuslem,656,337,319
46,Valencia/València,65,Beniparrell,1964,1015,949
46,Valencia/València,66,Benirredrà,1570,772,798
46,Valencia/València,67,Benissanó,2238,1119,1119
46,Valencia/València,68,Benissoda,425,232,193
46,Valencia/València,69,Benissuera,194,97,97
46,Valencia/València,70,Bétera,23178,11610,11568
46,Valencia/València,71,Bicorp,526,269,257
46,Valencia/València,72,Bocairent,4271,2162,2109
46,Valencia/València,73,Bolbaite,1362,684,678
46,Valencia/València,74,Bonrepòs i Mirambell,3629,1774,1855
46,Valencia/València,75,Bufali,163,90,73
46,Valencia/València,76,Bugarra,711,362,349
46,Valencia/València,77,Buñol,9596,4812,4784
46,Valencia/València,78,Burjassot,37575,18106,19469
46,Valencia/València,79,Calles,345,194,151
46,Valencia/València,80,Camporrobles,1217,625,592
46,Valencia/València,81,Canals,13631,6827,6804
46,Valencia/València,82,Canet d'En Berenguer,6473,3314,3159
46,Valencia/València,83,Carcaixent,20483,10143,10340
46,Valencia/València,84,Càrcer,1923,917,1006
46,Valencia/València,85,Carlet,15446,7668,7778
46,Valencia/València,86,Carrícola,95,49,46
46,Valencia/València,87,Casas Altas,139,74,65
46,Valencia/València,88,Casas Bajas,172,88,84
46,Valencia/València,89,Casinos,2759,1415,1344
46,Valencia/València,90,Castelló de Rugat,2278,1165,1113
46,Valencia/València,91,Castellonet de la Conquesta,138,74,64
46,Valencia/València,92,Castielfabib,311,163,148
46,Valencia/València,93,Catadau,2773,1389,1384
46,Valencia/València,94,Catarroja,27752,13711,14041
46,Valencia/València,95,Caudete de las Fuentes,706,374,332
46,Valencia/València,96,Cerdà,341,183,158
46,Valencia/València,107,Chella,2513,1234,1279
46,Valencia/València,106,Chelva,1516,785,731
46,Valencia/València,108,Chera,484,258,226
46,Valencia/València,109,Cheste,8372,4265,4107
46,Valencia/València,111,Chiva,14867,7645,7222
46,Valencia/València,112,Chulilla,628,333,295
46,Valencia/València,97,Cofrentes,1104,563,541
46,Valencia/València,98,Corbera,3190,1581,1609
46,Valencia/València,99,Cortes de Pallás,876,481,395
46,Valencia/València,100,Cotes,336,173,163
46,Valencia/València,105,Cullera,21999,10932,11067
46,Valencia/València,113,Daimús,3018,1508,1510
46,Valencia/València,114,Domeño,689,352,337
46,Valencia/València,115,Dos Aguas,379,218,161
46,Valencia/València,116,"Eliana, l'",17760,8660,9100
46,Valencia/València,117,Emperador,707,368,339
46,Valencia/València,118,Enguera,4926,2435,2491
46,Valencia/València,119,"Ènova, l'",919,468,451
46,Valencia/València,120,Estivella,1416,689,727
46,Valencia/València,121,Estubeny,119,59,60
46,Valencia/València,122,Faura,3503,1766,1737
46,Valencia/València,123,Favara,2473,1248,1225
46,Valencia/València,126,Foios,7234,3564,3670
46,Valencia/València,128,"Font de la Figuera, la",2067,1041,1026
46,Valencia/València,127,"Font d'En Carròs, la",3743,1850,1893
46,Valencia/València,124,Fontanars dels Alforins,985,502,483
46,Valencia/València,125,Fortaleny,1033,515,518
46,Valencia/València,129,Fuenterrobles,709,391,318
46,Valencia/València,131,Gandia,74121,36490,37631
46,Valencia/València,902,Gátova,398,185,213
46,Valencia/València,130,Gavarda,1073,509,564
46,Valencia/València,132,Genovés,2815,1420,1395
46,Valencia/València,133,Gestalgar,596,315,281
46,Valencia/València,134,Gilet,3308,1717,1591
46,Valencia/València,135,Godella,13031,6302,6729
46,Valencia/València,136,Godelleta,3391,1736,1655
46,Valencia/València,137,"Granja de la Costera, la",312,153,159
46,Valencia/València,138,Guadasséquies,459,244,215
46,Valencia/València,139,Guadassuar,5913,2912,3001
46,Valencia/València,140,Guardamar de la Safor,472,249,223
46,Valencia/València,141,Higueruelas,503,265,238
46,Valencia/València,142,Jalance,852,446,406
46,Valencia/València,144,Jarafuel,785,411,374
46,Valencia/València,154,Llanera de Ranes,1042,528,514
46,Valencia/València,155,Llaurí,1221,617,604
46,Valencia/València,147,Llíria,22793,11572,11221
46,Valencia/València,152,Llocnou de la Corona,116,59,57
46,Valencia/València,153,Llocnou de Sant Jeroni,544,270,274
46,Valencia/València,151,Llocnou d'En Fenollet,887,461,426
46,Valencia/València,156,Llombai,2702,1361,1341
46,Valencia/València,157,"Llosa de Ranes, la",3599,1847,1752
46,Valencia/València,150,Llutxent,2367,1218,1149
46,Valencia/València,148,Loriguilla,1985,1030,955
46,Valencia/València,149,Losa del Obispo,510,258,252
46,Valencia/València,158,Macastre,1236,650,586
46,Valencia/València,159,Manises,30630,15110,15520
46,Valencia/València,160,Manuel,2448,1193,1255
46,Valencia/València,161,Marines,1858,966,892
46,Valencia/València,162,Massalavés,1596,836,760
46,Valencia/València,163,Massalfassar,2462,1229,1233
46,Valencia/València,164,Massamagrell,15553,7710,7843
46,Valencia/València,165,Massanassa,9375,4651,4724
46,Valencia/València,166,Meliana,10678,5240,5438
46,Valencia/València,167,Millares,349,177,172
46,Valencia/València,168,Miramar,2608,1349,1259
46,Valencia/València,169,Mislata,43042,20878,22164
46,Valencia/València,170,Mogente/Moixent,4371,2195,2176
46,Valencia/València,171,Moncada,21623,10602,11021
46,Valencia/València,173,Montaverner,1666,836,830
46,Valencia/València,174,Montesa,1204,610,594
46,Valencia/València,175,Montitxelvo/Montichelvo,614,304,310
46,Valencia/València,176,Montroi/Montroy,2865,1533,1332
46,Valencia/València,172,Montserrat,7419,3854,3565
46,Valencia/València,177,Museros,6164,3087,3077
46,Valencia/València,178,Náquera,6058,3175,2883
46,Valencia/València,179,Navarrés,3031,1521,1510
46,Valencia/València,180,Novelé/Novetlè,858,422,436
46,Valencia/València,181,Oliva,25488,12577,12911
46,Valencia/València,183,"Olleria, l'",8261,4140,4121
46,Valencia/València,182,Olocau,1750,924,826
46,Valencia/València,184,Ontinyent,35342,17467,17875
46,Valencia/València,185,Otos,450,228,222
46,Valencia/València,186,Paiporta,25241,12538,12703
46,Valencia/València,187,Palma de Gandía,1511,777,734
46,Valencia/València,188,Palmera,1024,535,489
46,Valencia/València,189,"Palomar, el",579,296,283
46,Valencia/València,190,Paterna,68547,33963,34584
46,Valencia/València,191,Pedralba,2785,1465,1320
46,Valencia/València,192,Petrés,968,480,488
46,Valencia/València,193,Picanya,11278,5570,5708
46,Valencia/València,194,Picassent,20658,10439,10219
46,Valencia/València,195,Piles,2712,1350,1362
46,Valencia/València,196,Pinet,159,78,81
46,Valencia/València,199,"Pobla de Farnals, la",7747,3885,3862
46,Valencia/València,202,"Pobla de Vallbona, la",23684,11978,11706
46,Valencia/València,200,"Pobla del Duc, la",2589,1255,1334
46,Valencia/València,203,"Pobla Llarga, la",4493,2251,2242
46,Valencia/València,197,Polinyà de Xúquer,2484,1257,1227
46,Valencia/València,198,Potries,1013,516,497
46,Valencia/València,205,Puçol,19531,9639,9892
46,Valencia/València,201,Puebla de San Miguel,62,39,23
46,Valencia/València,204,"Puig de Santa Maria, el",8618,4200,4418
46,Valencia/València,101,Quart de les Valls,1042,498,544
46,Valencia/València,102,Quart de Poblet,24491,11963,12528
46,Valencia/València,103,Quartell,1539,739,800
46,Valencia/València,104,Quatretonda,2278,1153,1125
46,Valencia/València,206,Quesa,673,354,319
46,Valencia/València,207,Rafelbunyol,8870,4361,4509
46,Valencia/València,208,Rafelcofer,1375,669,706
46,Valencia/València,209,Rafelguaraf,2394,1183,1211
46,Valencia/València,210,Ráfol de Salem,425,205,220
46,Valencia/València,212,Real,2184,1114,1070
46,Valencia/València,211,"Real de Gandia, el",2363,1149,1214
46,Valencia/València,213,Requena,20320,10140,10180
46,Valencia/València,214,Riba-roja de Túria,21626,10961,10665
46,Valencia/València,215,Riola,1785,911,874
46,Valencia/València,216,Rocafort,7004,3441,3563
46,Valencia/València,217,Rotglà i Corberà,1108,557,551
46,Valencia/València,218,Rótova,1259,653,606
46,Valencia/València,219,Rugat,158,83,75
46,Valencia/València,220,Sagunto/Sagunt,65278,31978,33300
46,Valencia/València,221,Salem,437,220,217
46,Valencia/València,903,San Antonio de Benagéber,8755,4317,4438
46,Valencia/València,222,Sant Joanet,484,237,247
46,Valencia/València,223,Sedaví,10179,4952,5227
46,Valencia/València,224,Segart,158,79,79
46,Valencia/València,225,Sellent,376,190,186
46,Valencia/València,226,Sempere,41,22,19
46,Valencia/València,227,Senyera,1149,568,581
46,Valencia/València,228,Serra,3068,1573,1495
46,Valencia/València,229,Siete Aguas,1196,639,557
46,Valencia/València,230,Silla,18440,9160,9280
46,Valencia/València,231,Simat de la Valldigna,3297,1651,1646
46,Valencia/València,232,Sinarcas,1147,588,559
46,Valencia/València,233,Sollana,4886,2388,2498
46,Valencia/València,234,Sot de Chera,370,194,176
46,Valencia/València,235,Sueca,27598,13608,13990
46,Valencia/València,236,Sumacàrcer,1141,563,578
46,Valencia/València,237,Tavernes Blanques,9095,4441,4654
46,Valencia/València,238,Tavernes de la Valldigna,17336,8687,8649
46,Valencia/València,239,Teresa de Cofrentes,631,327,304
46,Valencia/València,240,Terrateig,284,150,134
46,Valencia/València,241,Titaguas,450,233,217
46,Valencia/València,242,Torrebaja,412,214,198
46,Valencia/València,243,Torrella,145,78,67
46,Valencia/València,244,Torrent,80630,39761,40869
46,Valencia/València,245,Torres Torres,641,345,296
46,Valencia/València,246,Tous,1268,646,622
46,Valencia/València,247,Tuéjar,1147,605,542
46,Valencia/València,248,Turís,6627,3464,3163
46,Valencia/València,249,Utiel,11601,5785,5816
46,Valencia/València,250,Valencia,787808,375210,412598
46,Valencia/València,251,Vallada,3093,1573,1520
46,Valencia/València,252,Vallanca,120,61,59
46,Valencia/València,253,Vallés,153,82,71
46,Valencia/València,254,Venta del Moro,1277,681,596
46,Valencia/València,255,Vilallonga/Villalonga,4371,2155,2216
46,Valencia/València,256,Vilamarxant,9376,4855,4521
46,Valencia/València,257,Villanueva de Castellón,7209,3572,3637
46,Valencia/València,258,Villar del Arzobispo,3542,1804,1738
46,Valencia/València,259,Villargordo del Cabriel,612,329,283
46,Valencia/València,260,Vinalesa,3345,1622,1723
46,Valencia/València,145,Xàtiva,29070,14215,14855
46,Valencia/València,143,Xeraco,5715,2889,2826
46,Valencia/València,146,Xeresa,2162,1111,1051
46,Valencia/València,110,Xirivella,28950,14302,14648
46,Valencia/València,261,Yátova,2080,1071,1009
46,Valencia/València,262,"Yesa, La",234,125,109
46,Valencia/València,263,Zarra,381,208,173
47,Valladolid,1,Adalia,59,36,23
47,Valladolid,2,Aguasal,24,18,6
47,Valladolid,3,Aguilar de Campos,256,146,110
47,Valladolid,4,Alaejos,1389,747,642
47,Valladolid,5,Alcazarén,647,343,304
47,Valladolid,6,Aldea de San Miguel,232,123,109
47,Valladolid,7,Aldeamayor de San Martín,5292,2739,2553
47,Valladolid,8,Almenara de Adaja,25,12,13
47,Valladolid,9,Amusquillo,110,70,40
47,Valladolid,10,Arroyo de la Encomienda,19421,9768,9653
47,Valladolid,11,Ataquines,572,315,257
47,Valladolid,12,Bahabón,112,51,61
47,Valladolid,13,Barcial de la Loma,99,54,45
47,Valladolid,14,Barruelo del Valle,62,37,25
47,Valladolid,15,Becilla de Valderaduey,230,129,101
47,Valladolid,16,Benafarces,71,37,34
47,Valladolid,17,Bercero,211,116,95
47,Valladolid,18,Berceruelo,37,22,15
47,Valladolid,19,Berrueces,93,55,38
47,Valladolid,20,Bobadilla del Campo,304,176,128
47,Valladolid,21,Bocigas,84,47,37
47,Valladolid,22,Bocos de Duero,60,25,35
47,Valladolid,23,Boecillo,4104,2091,2013
47,Valladolid,24,Bolaños de Campos,334,181,153
47,Valladolid,25,Brahojos de Medina,124,67,57
47,Valladolid,26,Bustillo de Chaves,72,42,30
47,Valladolid,27,Cabezón de Pisuerga,3678,1876,1802
47,Valladolid,28,Cabezón de Valderaduey,37,20,17
47,Valladolid,29,Cabreros del Monte,66,36,30
47,Valladolid,30,Campaspero,1114,603,511
47,Valladolid,31,"Campillo, El",225,133,92
47,Valladolid,32,Camporredondo,161,93,68
47,Valladolid,33,Canalejas de Peñafiel,224,124,100
47,Valladolid,34,Canillas de Esgueva,75,45,30
47,Valladolid,35,Carpio,1022,542,480
47,Valladolid,36,Casasola de Arión,249,141,108
47,Valladolid,37,Castrejón de Trabancos,178,88,90
47,Valladolid,38,Castrillo de Duero,119,67,52
47,Valladolid,39,Castrillo-Tejeriego,184,104,80
47,Valladolid,40,Castrobol,66,35,31
47,Valladolid,41,Castrodeza,158,96,62
47,Valladolid,42,Castromembibre,58,37,21
47,Valladolid,43,Castromonte,315,183,132
47,Valladolid,44,Castronuevo de Esgueva,385,205,180
47,Valladolid,45,Castronuño,871,430,441
47,Valladolid,46,Castroponce,145,80,65
47,Valladolid,47,Castroverde de Cerrato,230,142,88
47,Valladolid,48,Ceinos de Campos,228,124,104
47,Valladolid,49,Cervillego de la Cruz,94,54,40
47,Valladolid,50,Cigales,5067,2580,2487
47,Valladolid,51,Ciguñuela,385,200,185
47,Valladolid,52,Cistérniga,8984,4560,4424
47,Valladolid,53,Cogeces de Íscar,139,69,70
47,Valladolid,54,Cogeces del Monte,703,380,323
47,Valladolid,55,Corcos,203,105,98
47,Valladolid,56,Corrales de Duero,98,56,42
47,Valladolid,57,Cubillas de Santa Marta,295,170,125
47,Valladolid,58,Cuenca de Campos,227,118,109
47,Valladolid,59,Curiel de Duero,129,80,49
47,Valladolid,60,Encinas de Esgueva,272,158,114
47,Valladolid,61,Esguevillas de Esgueva,272,147,125
47,Valladolid,62,Fombellida,174,102,72
47,Valladolid,63,Fompedraza,107,56,51
47,Valladolid,64,Fontihoyuelo,34,20,14
47,Valladolid,65,Fresno el Viejo,927,495,432
47,Valladolid,66,Fuensaldaña,1607,829,778
47,Valladolid,67,Fuente el Sol,168,89,79
47,Valladolid,68,Fuente-Olmedo,35,18,17
47,Valladolid,69,Gallegos de Hornija,134,68,66
47,Valladolid,70,Gatón de Campos,34,18,16
47,Valladolid,71,Geria,508,246,262
47,Valladolid,73,Herrín de Campos,130,64,66
47,Valladolid,74,Hornillos de Eresma,163,91,72
47,Valladolid,75,Íscar,6420,3231,3189
47,Valladolid,76,Laguna de Duero,22691,11311,11380
47,Valladolid,77,Langayo,258,163,95
47,Valladolid,79,Llano de Olmedo,62,33,29
47,Valladolid,78,Lomoviejo,178,94,84
47,Valladolid,80,Manzanillo,50,27,23
47,Valladolid,81,Marzales,48,23,25
47,Valladolid,82,Matapozuelos,1055,542,513
47,Valladolid,83,Matilla de los Caños,106,59,47
47,Valladolid,84,Mayorga,1618,804,814
47,Valladolid,86,Medina de Rioseco,4770,2339,2431
47,Valladolid,85,Medina del Campo,20679,10038,10641
47,Valladolid,87,Megeces,431,228,203
47,Valladolid,88,Melgar de Abajo,102,57,45
47,Valladolid,89,Melgar de Arriba,166,88,78
47,Valladolid,90,Mojados,3243,1699,1544
47,Valladolid,91,Monasterio de Vega,86,49,37
47,Valladolid,92,Montealegre de Campos,120,70,50
47,Valladolid,93,Montemayor de Pililla,896,480,416
47,Valladolid,94,Moral de la Reina,169,94,75
47,Valladolid,95,Moraleja de las Panaderas,41,27,14
47,Valladolid,96,Morales de Campos,140,73,67
47,Valladolid,97,Mota del Marqués,373,195,178
47,Valladolid,98,Mucientes,681,347,334
47,Valladolid,99,"Mudarra, La",161,81,80
47,Valladolid,100,Muriel,140,77,63
47,Valladolid,101,Nava del Rey,2074,1058,1016
47,Valladolid,102,Nueva Villa de las Torres,301,172,129
47,Valladolid,103,Olivares de Duero,308,171,137
47,Valladolid,104,Olmedo,3666,1799,1867
47,Valladolid,105,Olmos de Esgueva,211,115,96
47,Valladolid,106,Olmos de Peñafiel,60,33,27
47,Valladolid,109,Palazuelo de Vedija,205,105,100
47,Valladolid,110,"Parrilla, La",493,248,245
47,Valladolid,111,"Pedraja de Portillo, La",1123,567,556
47,Valladolid,112,Pedrajas de San Esteban,3342,1720,1622
47,Valladolid,113,Pedrosa del Rey,193,109,84
47,Valladolid,114,Peñafiel,5201,2592,2609
47,Valladolid,115,Peñaflor de Hornija,305,176,129
47,Valladolid,116,Pesquera de Duero,466,253,213
47,Valladolid,117,Piña de Esgueva,341,179,162
47,Valladolid,118,Piñel de Abajo,183,98,85
47,Valladolid,119,Piñel de Arriba,100,55,45
47,Valladolid,121,Pollos,595,314,281
47,Valladolid,122,Portillo,2435,1281,1154
47,Valladolid,123,Pozal de Gallinas,549,300,249
47,Valladolid,124,Pozaldez,492,260,232
47,Valladolid,125,Pozuelo de la Orden,57,33,24
47,Valladolid,126,Puras,50,27,23
47,Valladolid,127,Quintanilla de Arriba,155,85,70
47,Valladolid,129,Quintanilla de Onésimo,1055,547,508
47,Valladolid,130,Quintanilla de Trigueros,101,51,50
47,Valladolid,128,Quintanilla del Molar,63,28,35
47,Valladolid,131,Rábano,184,99,85
47,Valladolid,132,Ramiro,49,28,21
47,Valladolid,133,Renedo de Esgueva,3724,1902,1822
47,Valladolid,134,Roales de Campos,163,92,71
47,Valladolid,135,Robladillo,94,54,40
47,Valladolid,137,Roturas,31,19,12
47,Valladolid,138,Rubí de Bracamonte,247,139,108
47,Valladolid,139,Rueda,1300,672,628
47,Valladolid,140,Saelices de Mayorga,119,73,46
47,Valladolid,141,Salvador de Zapardiel,135,77,58
47,Valladolid,142,San Cebrián de Mazote,147,88,59
47,Valladolid,143,San Llorente,120,66,54
47,Valladolid,144,San Martín de Valvení,85,47,38
47,Valladolid,145,San Miguel del Arroyo,677,360,317
47,Valladolid,146,San Miguel del Pino,331,175,156
47,Valladolid,147,San Pablo de la Moraleja,117,60,57
47,Valladolid,148,San Pedro de Latarce,510,274,236
47,Valladolid,149,San Pelayo,54,26,28
47,Valladolid,150,San Román de Hornija,327,158,169
47,Valladolid,151,San Salvador,31,16,15
47,Valladolid,156,San Vicente del Palacio,177,96,81
47,Valladolid,152,Santa Eufemia del Arroyo,86,45,41
47,Valladolid,153,Santervás de Campos,121,64,57
47,Valladolid,154,Santibáñez de Valcorba,162,91,71
47,Valladolid,155,Santovenia de Pisuerga,4298,2220,2078
47,Valladolid,157,Sardón de Duero,597,311,286
47,Valladolid,158,"Seca, La",1091,559,532
47,Valladolid,159,Serrada,1127,587,540
47,Valladolid,160,Siete Iglesias de Trabancos,456,243,213
47,Valladolid,161,Simancas,5214,2646,2568
47,Valladolid,162,Tamariz de Campos,57,32,25
47,Valladolid,163,Tiedra,297,147,150
47,Valladolid,164,Tordehumos,441,233,208
47,Valladolid,165,Tordesillas,8858,4486,4372
47,Valladolid,169,Torre de Esgueva,72,36,36
47,Valladolid,170,Torre de Peñafiel,41,24,17
47,Valladolid,166,Torrecilla de la Abadesa,280,139,141
47,Valladolid,167,Torrecilla de la Orden,261,134,127
47,Valladolid,168,Torrecilla de la Torre,30,19,11
47,Valladolid,171,Torrelobatón,433,227,206
47,Valladolid,172,Torrescárcela,160,87,73
47,Valladolid,173,Traspinedo,1090,594,496
47,Valladolid,174,Trigueros del Valle,296,160,136
47,Valladolid,175,Tudela de Duero,8551,4364,4187
47,Valladolid,176,"Unión de Campos, La",254,124,130
47,Valladolid,177,Urones de Castroponce,109,62,47
47,Valladolid,178,Urueña,192,104,88
47,Valladolid,179,Valbuena de Duero,475,252,223
47,Valladolid,180,Valdearcos de la Vega,71,39,32
47,Valladolid,181,Valdenebro de los Valles,208,105,103
47,Valladolid,182,Valdestillas,1665,870,795
47,Valladolid,183,Valdunquillo,141,70,71
47,Valladolid,186,Valladolid,299715,140893,158822
47,Valladolid,184,Valoria la Buena,668,354,314
47,Valladolid,185,Valverde de Campos,104,63,41
47,Valladolid,187,Vega de Ruiponce,100,62,38
47,Valladolid,188,Vega de Valdetronco,109,62,47
47,Valladolid,189,Velascálvaro,166,92,74
47,Valladolid,190,Velilla,113,53,60
47,Valladolid,191,Velliza,108,69,39
47,Valladolid,192,Ventosa de la Cuesta,110,63,47
47,Valladolid,193,Viana de Cega,2021,1068,953
47,Valladolid,195,Villabáñez,519,288,231
47,Valladolid,196,Villabaruz de Campos,35,15,20
47,Valladolid,197,Villabrágima,1040,553,487
47,Valladolid,198,Villacarralón,88,51,37
47,Valladolid,199,Villacid de Campos,77,48,29
47,Valladolid,200,Villaco,90,57,33
47,Valladolid,203,Villafrades de Campos,68,36,32
47,Valladolid,204,Villafranca de Duero,279,142,137
47,Valladolid,205,Villafrechós,491,266,225
47,Valladolid,206,Villafuerte,86,49,37
47,Valladolid,207,Villagarcía de Campos,322,187,135
47,Valladolid,208,Villagómez la Nueva,65,34,31
47,Valladolid,209,Villalán de Campos,39,25,14
47,Valladolid,210,Villalar de los Comuneros,458,221,237
47,Valladolid,211,Villalba de la Loma,54,29,25
47,Valladolid,212,Villalba de los Alcores,409,221,188
47,Valladolid,213,Villalbarba,121,63,58
47,Valladolid,214,Villalón de Campos,1652,808,844
47,Valladolid,215,Villamuriel de Campos,56,27,29
47,Valladolid,216,Villán de Tordesillas,123,73,50
47,Valladolid,217,Villanubla,2671,1391,1280
47,Valladolid,218,Villanueva de Duero,1165,606,559
47,Valladolid,219,Villanueva de la Condesa,58,31,27
47,Valladolid,220,Villanueva de los Caballeros,169,85,84
47,Valladolid,221,Villanueva de los Infantes,111,68,43
47,Valladolid,222,Villanueva de San Mancio,84,46,38
47,Valladolid,223,Villardefrades,168,94,74
47,Valladolid,224,Villarmentero de Esgueva,101,55,46
47,Valladolid,225,Villasexmir,79,46,33
47,Valladolid,226,Villavaquerín,173,97,76
47,Valladolid,227,Villavellid,61,37,24
47,Valladolid,228,Villaverde de Medina,517,278,239
47,Valladolid,229,Villavicencio de los Caballeros,221,112,109
47,Valladolid,194,Viloria,349,180,169
47,Valladolid,230,Wamba,335,178,157
47,Valladolid,231,Zaratán,6201,3183,3018
47,Valladolid,232,"Zarza, La",116,63,53
49,Zamora,2,Abezames,63,32,31
49,Zamora,3,Alcañices,1076,555,521
49,Zamora,4,Alcubilla de Nogales,131,71,60
49,Zamora,5,Alfaraz de Sayago,136,78,58
49,Zamora,6,Algodre,153,85,68
49,Zamora,7,Almaraz de Duero,408,206,202
49,Zamora,8,Almeida de Sayago,479,255,224
49,Zamora,9,Andavías,440,229,211
49,Zamora,10,Arcenillas,413,208,205
49,Zamora,11,Arcos de la Polvorosa,236,127,109
49,Zamora,12,Argañín,79,39,40
49,Zamora,13,Argujillo,256,128,128
49,Zamora,14,Arquillinos,119,61,58
49,Zamora,15,Arrabalde,239,118,121
49,Zamora,16,Aspariegos,262,120,142
49,Zamora,17,Asturianos,257,129,128
49,Zamora,18,Ayoó de Vidriales,339,173,166
49,Zamora,19,Barcial del Barco,261,141,120
49,Zamora,20,Belver de los Montes,291,158,133
49,Zamora,21,Benavente,18237,8828,9409
49,Zamora,22,Benegiles,327,172,155
49,Zamora,23,Bermillo de Sayago,1057,561,496
49,Zamora,24,"Bóveda de Toro, La",748,373,375
49,Zamora,25,Bretó,182,106,76
49,Zamora,26,Bretocino,232,123,109
49,Zamora,27,Brime de Sog,144,70,74
49,Zamora,28,Brime de Urz,119,69,50
49,Zamora,29,Burganes de Valverde,675,352,323
49,Zamora,30,Bustillo del Oro,91,48,43
49,Zamora,31,Cabañas de Sayago,157,85,72
49,Zamora,32,Calzadilla de Tera,331,154,177
49,Zamora,33,Camarzana de Tera,839,422,417
49,Zamora,34,Cañizal,460,238,222
49,Zamora,35,Cañizo,245,132,113
49,Zamora,36,Carbajales de Alba,558,284,274
49,Zamora,37,Carbellino,200,109,91
49,Zamora,38,Casaseca de Campeán,101,55,46
49,Zamora,39,Casaseca de las Chanas,385,209,176
49,Zamora,40,Castrillo de la Guareña,123,62,61
49,Zamora,41,Castrogonzalo,480,258,222
49,Zamora,42,Castronuevo,233,113,120
49,Zamora,43,Castroverde de Campos,318,164,154
49,Zamora,44,Cazurra,82,45,37
49,Zamora,46,Cerecinos de Campos,289,155,134
49,Zamora,47,Cerecinos del Carrizal,139,75,64
49,Zamora,48,Cernadilla,124,64,60
49,Zamora,50,Cobreros,578,316,262
49,Zamora,52,Coomonte,198,109,89
49,Zamora,53,Coreses,1061,543,518
49,Zamora,54,Corrales del Vino,1002,494,508
49,Zamora,55,Cotanes del Monte,107,57,50
49,Zamora,56,Cubillos,316,159,157
49,Zamora,57,Cubo de Benavente,119,65,54
49,Zamora,58,"Cubo de Tierra del Vino, El",335,183,152
49,Zamora,59,Cuelgamures,92,56,36
49,Zamora,61,Entrala,160,87,73
49,Zamora,62,Espadañedo,117,56,61
49,Zamora,63,Faramontanos de Tábara,355,181,174
49,Zamora,64,Fariza,529,278,251
49,Zamora,65,Fermoselle,1262,644,618
49,Zamora,66,Ferreras de Abajo,537,275,262
49,Zamora,67,Ferreras de Arriba,396,214,182
49,Zamora,68,Ferreruela,498,271,227
49,Zamora,69,Figueruela de Arriba,357,171,186
49,Zamora,71,Fonfría,789,407,382
49,Zamora,75,Fresno de la Polvorosa,144,76,68
49,Zamora,76,Fresno de la Ribera,376,202,174
49,Zamora,77,Fresno de Sayago,193,102,91
49,Zamora,78,Friera de Valverde,168,90,78
49,Zamora,79,Fuente Encalada,112,62,50
49,Zamora,80,Fuentelapeña,729,391,338
49,Zamora,82,Fuentes de Ropel,393,198,195
49,Zamora,81,Fuentesaúco,1551,772,779
49,Zamora,83,Fuentesecas,51,24,27
49,Zamora,84,Fuentespreadas,315,166,149
49,Zamora,85,Galende,1068,552,516
49,Zamora,86,Gallegos del Pan,117,69,48
49,Zamora,87,Gallegos del Río,514,280,234
49,Zamora,88,Gamones,98,57,41
49,Zamora,90,Gema,232,114,118
49,Zamora,91,Granja de Moreruela,280,146,134
49,Zamora,92,Granucillo,133,65,68
49,Zamora,93,Guarrate,334,172,162
49,Zamora,94,Hermisende,253,133,120
49,Zamora,95,"Hiniesta, La",326,170,156
49,Zamora,96,Jambrina,170,88,82
49,Zamora,97,Justel,89,54,35
49,Zamora,98,Losacino,224,122,102
49,Zamora,99,Losacio,109,61,48
49,Zamora,100,Lubián,313,169,144
49,Zamora,101,Luelmo,158,82,76
49,Zamora,102,"Maderal, El",200,104,96
49,Zamora,103,Madridanos,472,248,224
49,Zamora,104,Mahide,334,186,148
49,Zamora,105,Maire de Castroponce,152,80,72
49,Zamora,107,Malva,136,63,73
49,Zamora,108,Manganeses de la Lampreana,498,250,248
49,Zamora,109,Manganeses de la Polvorosa,683,335,348
49,Zamora,110,Manzanal de Arriba,366,197,169
49,Zamora,112,Manzanal de los Infantes,127,71,56
49,Zamora,111,Manzanal del Barco,130,66,64
49,Zamora,113,Matilla de Arzón,170,99,71
49,Zamora,114,Matilla la Seca,42,23,19
49,Zamora,115,Mayalde,196,106,90
49,Zamora,116,Melgar de Tera,390,201,189
49,Zamora,117,Micereces de Tera,479,243,236
49,Zamora,118,Milles de la Polvorosa,223,121,102
49,Zamora,119,Molacillos,262,144,118
49,Zamora,120,Molezuelas de la Carballeda,70,36,34
49,Zamora,121,Mombuey,396,216,180
49,Zamora,122,Monfarracinos,981,508,473
49,Zamora,123,Montamarta,590,310,280
49,Zamora,124,Moral de Sayago,269,153,116
49,Zamora,126,Moraleja de Sayago,262,136,126
49,Zamora,125,Moraleja del Vino,1716,875,841
49,Zamora,128,Morales de Rey,582,293,289
49,Zamora,129,Morales de Toro,987,517,470
49,Zamora,130,Morales de Valverde,180,93,87
49,Zamora,127,Morales del Vino,2950,1547,1403
49,Zamora,131,Moralina,276,142,134
49,Zamora,132,Moreruela de los Infanzones,353,185,168
49,Zamora,133,Moreruela de Tábara,323,167,156
49,Zamora,134,Muelas de los Caballeros,189,103,86
49,Zamora,135,Muelas del Pan,665,341,324
49,Zamora,136,Muga de Sayago,351,169,182
49,Zamora,137,Navianos de Valverde,196,109,87
49,Zamora,138,Olmillos de Castro,235,128,107
49,Zamora,139,Otero de Bodas,175,93,82
49,Zamora,141,Pajares de la Lampreana,351,177,174
49,Zamora,143,Palacios de Sanabria,263,134,129
49,Zamora,142,Palacios del Pan,266,137,129
49,Zamora,145,Pedralba de la Pradería,261,139,122
49,Zamora,146,"Pego, El",305,155,150
49,Zamora,147,Peleagonzalo,240,120,120
49,Zamora,148,Peleas de Abajo,288,143,145
49,Zamora,149,Peñausende,410,206,204
49,Zamora,150,Peque,141,60,81
49,Zamora,151,"Perdigón, El",710,377,333
49,Zamora,152,Pereruela,559,301,258
49,Zamora,153,Perilla de Castro,171,88,83
49,Zamora,154,Pías,135,77,58
49,Zamora,155,Piedrahita de Castro,90,48,42
49,Zamora,156,Pinilla de Toro,236,123,113
49,Zamora,157,Pino del Oro,213,114,99
49,Zamora,158,"Piñero, El",238,128,110
49,Zamora,160,Pobladura de Valderaduey,39,21,18
49,Zamora,159,Pobladura del Valle,300,155,145
49,Zamora,162,Porto,179,98,81
49,Zamora,163,Pozoantiguo,224,113,111
49,Zamora,164,Pozuelo de Tábara,164,84,80
49,Zamora,165,Prado,57,32,25
49,Zamora,166,Puebla de Sanabria,1432,700,732
49,Zamora,167,Pueblica de Valverde,199,108,91
49,Zamora,170,Quintanilla de Urz,105,54,51
49,Zamora,168,Quintanilla del Monte,105,52,53
49,Zamora,169,Quintanilla del Olmo,33,18,15
49,Zamora,171,Quiruelas de Vidriales,693,351,342
49,Zamora,172,Rabanales,545,283,262
49,Zamora,173,Rábano de Aliste,389,191,198
49,Zamora,174,Requejo,139,70,69
49,Zamora,175,Revellinos,273,144,129
49,Zamora,176,Riofrío de Aliste,701,383,318
49,Zamora,177,Rionegro del Puente,283,147,136
49,Zamora,178,Roales,889,475,414
49,Zamora,179,Robleda-Cervantes,443,239,204
49,Zamora,180,Roelos de Sayago,165,81,84
49,Zamora,181,Rosinos de la Requejada,383,204,179
49,Zamora,183,Salce,102,46,56
49,Zamora,184,Samir de los Caños,174,97,77
49,Zamora,185,San Agustín del Pozo,196,104,92
49,Zamora,186,San Cebrián de Castro,264,131,133
49,Zamora,187,San Cristóbal de Entreviñas,1417,745,672
49,Zamora,188,San Esteban del Molar,128,73,55
49,Zamora,189,San Justo,230,125,105
49,Zamora,190,San Martín de Valderaduey,57,31,26
49,Zamora,191,San Miguel de la Ribera,295,145,150
49,Zamora,192,San Miguel del Valle,139,69,70
49,Zamora,193,San Pedro de Ceque,484,247,237
49,Zamora,194,San Pedro de la Nave-Almendra,351,181,170
49,Zamora,208,San Vicente de la Cabeza,403,213,190
49,Zamora,209,San Vitero,534,300,234
49,Zamora,197,Santa Clara de Avedillo,176,89,87
49,Zamora,199,Santa Colomba de las Monjas,270,135,135
49,Zamora,200,Santa Cristina de la Polvorosa,1087,554,533
49,Zamora,201,Santa Croya de Tera,316,157,159
49,Zamora,202,Santa Eufemia del Barco,187,107,80
49,Zamora,203,Santa María de la Vega,328,167,161
49,Zamora,204,Santa María de Valverde,57,25,32
49,Zamora,205,Santibáñez de Tera,393,201,192
49,Zamora,206,Santibáñez de Vidriales,998,507,491
49,Zamora,207,Santovenia,273,132,141
49,Zamora,210,Sanzoles,524,265,259
49,Zamora,214,Tábara,787,407,380
49,Zamora,216,Tapioles,160,94,66
49,Zamora,219,Toro,8974,4380,4594
49,Zamora,220,"Torre del Valle, La",152,80,72
49,Zamora,221,Torregamones,286,150,136
49,Zamora,222,Torres del Carrizal,418,211,207
49,Zamora,223,Trabazos,913,474,439
49,Zamora,224,Trefacio,183,93,90
49,Zamora,225,Uña de Quintana,141,74,67
49,Zamora,226,Vadillo de la Guareña,266,143,123
49,Zamora,227,Valcabado,370,192,178
49,Zamora,228,Valdefinjas,51,31,20
49,Zamora,229,Valdescorriel,140,68,72
49,Zamora,230,Vallesa de la Guareña,90,48,42
49,Zamora,231,Vega de Tera,360,175,185
49,Zamora,232,Vega de Villalobos,115,53,62
49,Zamora,233,Vegalatrave,98,54,44
49,Zamora,234,Venialbo,453,247,206
49,Zamora,235,Vezdemarbán,404,202,202
49,Zamora,236,Vidayanes,94,48,46
49,Zamora,237,Videmala,168,87,81
49,Zamora,238,Villabrázaro,216,113,103
49,Zamora,239,Villabuena del Puente,715,366,349
49,Zamora,240,Villadepera,220,117,103
49,Zamora,241,Villaescusa,256,141,115
49,Zamora,242,Villafáfila,493,256,237
49,Zamora,243,Villaferrueña,112,57,55
49,Zamora,244,Villageriz,48,29,19
49,Zamora,245,Villalazán,280,137,143
49,Zamora,246,Villalba de la Lampreana,242,134,108
49,Zamora,247,Villalcampo,455,225,230
49,Zamora,248,Villalobos,255,127,128
49,Zamora,249,Villalonso,81,44,37
49,Zamora,250,Villalpando,1501,740,761
49,Zamora,251,Villalube,164,86,78
49,Zamora,252,Villamayor de Campos,310,158,152
49,Zamora,255,Villamor de los Escuderos,402,213,189
49,Zamora,256,Villanázar,299,156,143
49,Zamora,257,Villanueva de Azoague,340,174,166
49,Zamora,258,Villanueva de Campeán,116,67,49
49,Zamora,259,Villanueva de las Peras,83,44,39
49,Zamora,260,Villanueva del Campo,874,431,443
49,Zamora,263,Villar de Fallaves,46,25,21
49,Zamora,264,Villar del Buey,606,315,291
49,Zamora,261,Villaralbo,1866,949,917
49,Zamora,262,Villardeciervos,429,212,217
49,Zamora,265,Villardiegua de la Ribera,134,67,67
49,Zamora,266,Villárdiga,79,45,34
49,Zamora,267,Villardondiego,95,52,43
49,Zamora,268,Villarrín de Campos,411,223,188
49,Zamora,269,Villaseco del Pan,235,110,125
49,Zamora,270,Villavendimio,172,102,70
49,Zamora,272,Villaveza de Valverde,87,44,43
49,Zamora,271,Villaveza del Agua,195,109,86
49,Zamora,273,Viñas,197,101,96
49,Zamora,275,Zamora,62389,29072,33317
50,Zaragoza,1,Abanto,98,57,41
50,Zaragoza,2,Acered,171,96,75
50,Zaragoza,3,Agón,146,82,64
50,Zaragoza,4,Aguarón,684,357,327
50,Zaragoza,5,Aguilón,238,128,110
50,Zaragoza,6,Ainzón,1095,555,540
50,Zaragoza,7,Aladrén,47,32,15
50,Zaragoza,8,Alagón,7025,3485,3540
50,Zaragoza,9,Alarba,144,84,60
50,Zaragoza,10,Alberite de San Juan,77,45,32
50,Zaragoza,11,Albeta,134,66,68
50,Zaragoza,12,Alborge,105,55,50
50,Zaragoza,13,Alcalá de Ebro,270,127,143
50,Zaragoza,14,Alcalá de Moncayo,152,88,64
50,Zaragoza,15,Alconchel de Ariza,70,38,32
50,Zaragoza,16,Aldehuela de Liestos,53,37,16
50,Zaragoza,17,Alfajarín,2288,1179,1109
50,Zaragoza,18,Alfamén,1460,767,693
50,Zaragoza,19,Alforque,57,34,23
50,Zaragoza,20,Alhama de Aragón,1053,544,509
50,Zaragoza,21,Almochuel,30,13,17
50,Zaragoza,22,"Almolda, La",562,284,278
50,Zaragoza,23,Almonacid de la Cuba,260,129,131
50,Zaragoza,24,Almonacid de la Sierra,701,393,308
50,Zaragoza,25,"Almunia de Doña Godina, La",7660,3897,3763
50,Zaragoza,26,Alpartir,546,274,272
50,Zaragoza,27,Ambel,254,122,132
50,Zaragoza,28,Anento,93,59,34
50,Zaragoza,29,Aniñón,723,391,332
50,Zaragoza,30,Añón de Moncayo,200,118,82
50,Zaragoza,31,Aranda de Moncayo,174,110,64
50,Zaragoza,32,Arándiga,308,159,149
50,Zaragoza,33,Ardisa,72,44,28
50,Zaragoza,34,Ariza,1133,578,555
50,Zaragoza,35,Artieda,75,44,31
50,Zaragoza,36,Asín,102,53,49
50,Zaragoza,37,Atea,145,91,54
50,Zaragoza,38,Ateca,1825,942,883
50,Zaragoza,39,Azuara,551,308,243
50,Zaragoza,40,Badules,87,49,38
50,Zaragoza,41,Bagüés,11,8,3
50,Zaragoza,42,Balconchán,16,5,11
50,Zaragoza,43,Bárboles,312,170,142
50,Zaragoza,44,Bardallur,258,124,134
50,Zaragoza,45,Belchite,1526,770,756
50,Zaragoza,46,Belmonte de Gracián,206,115,91
50,Zaragoza,47,Berdejo,51,34,17
50,Zaragoza,48,Berrueco,33,19,14
50,Zaragoza,901,Biel,133,83,50
50,Zaragoza,50,Bijuesca,99,63,36
50,Zaragoza,51,Biota,959,488,471
50,Zaragoza,52,Bisimbre,99,56,43
50,Zaragoza,53,Boquiñeni,844,420,424
50,Zaragoza,54,Bordalba,58,38,20
50,Zaragoza,55,Borja,4946,2505,2441
50,Zaragoza,56,Botorrita,506,273,233
50,Zaragoza,57,Brea de Aragón,1682,852,830
50,Zaragoza,58,Bubierca,66,36,30
50,Zaragoza,59,Bujaraloz,1001,524,477
50,Zaragoza,60,Bulbuente,218,122,96
50,Zaragoza,61,Bureta,222,115,107
50,Zaragoza,62,"Burgo de Ebro, El",2431,1226,1205
50,Zaragoza,63,"Buste, El",68,37,31
50,Zaragoza,64,Cabañas de Ebro,501,263,238
50,Zaragoza,65,Cabolafuente,34,19,15
50,Zaragoza,66,Cadrete,3749,1990,1759
50,Zaragoza,67,Calatayud,20173,9932,10241
50,Zaragoza,68,Calatorao,2845,1501,1344
50,Zaragoza,69,Calcena,75,44,31
50,Zaragoza,70,Calmarza,64,36,28
50,Zaragoza,71,Campillo de Aragón,155,83,72
50,Zaragoza,72,Carenas,174,90,84
50,Zaragoza,73,Cariñena,3339,1683,1656
50,Zaragoza,74,Caspe,9491,4913,4578
50,Zaragoza,75,Castejón de Alarba,91,56,35
50,Zaragoza,76,Castejón de las Armas,87,50,37
50,Zaragoza,77,Castejón de Valdejasa,221,113,108
50,Zaragoza,78,Castiliscar,262,139,123
50,Zaragoza,79,Cervera de la Cañada,286,158,128
50,Zaragoza,80,Cerveruela,38,24,14
50,Zaragoza,81,Cetina,606,310,296
50,Zaragoza,92,Chiprana,481,249,232
50,Zaragoza,93,Chodes,112,62,50
50,Zaragoza,82,Cimballa,103,55,48
50,Zaragoza,83,Cinco Olivas,114,54,60
50,Zaragoza,84,Clarés de Ribota,72,43,29
50,Zaragoza,85,Codo,191,99,92
50,Zaragoza,86,Codos,198,125,73
50,Zaragoza,87,Contamina,35,21,14
50,Zaragoza,88,Cosuenda,372,199,173
50,Zaragoza,89,Cuarte de Huerva,12862,6569,6293
50,Zaragoza,90,Cubel,175,83,92
50,Zaragoza,91,"Cuerlas, Las",44,23,21
50,Zaragoza,94,Daroca,2044,1010,1034
50,Zaragoza,95,Ejea de los Caballeros,16596,8465,8131
50,Zaragoza,96,Embid de Ariza,39,19,20
50,Zaragoza,98,Encinacorba,198,105,93
50,Zaragoza,99,Épila,4413,2285,2128
50,Zaragoza,100,Erla,354,178,176
50,Zaragoza,101,Escatrón,1046,519,527
50,Zaragoza,102,Fabara,1172,625,547
50,Zaragoza,104,Farlete,391,192,199
50,Zaragoza,105,Fayón,347,179,168
50,Zaragoza,106,"Fayos, Los",136,77,59
50,Zaragoza,107,Figueruelas,1230,611,619
50,Zaragoza,108,Fombuena,52,32,20
50,Zaragoza,109,"Frago, El",107,67,40
50,Zaragoza,110,"Frasno, El",386,209,177
50,Zaragoza,111,Fréscano,203,108,95
50,Zaragoza,113,Fuendejalón,817,428,389
50,Zaragoza,114,Fuendetodos,126,71,55
50,Zaragoza,115,Fuentes de Ebro,4554,2369,2185
50,Zaragoza,116,Fuentes de Jiloca,245,131,114
50,Zaragoza,117,Gallocanta,162,91,71
50,Zaragoza,118,Gallur,2643,1334,1309
50,Zaragoza,119,Gelsa,1055,551,504
50,Zaragoza,120,Godojos,52,27,25
50,Zaragoza,121,Gotor,314,168,146
50,Zaragoza,122,Grisel,75,46,29
50,Zaragoza,123,Grisén,625,318,307
50,Zaragoza,124,Herrera de los Navarros,526,279,247
50,Zaragoza,125,Ibdes,413,218,195
50,Zaragoza,126,Illueca,3044,1507,1537
50,Zaragoza,128,Isuerre,31,19,12
50,Zaragoza,129,Jaraba,301,157,144
50,Zaragoza,130,Jarque,448,245,203
50,Zaragoza,131,Jaulín,250,134,116
50,Zaragoza,132,"Joyosa, La",1058,548,510
50,Zaragoza,133,Lagata,119,67,52
50,Zaragoza,134,Langa del Castillo,133,66,67
50,Zaragoza,135,Layana,105,60,45
50,Zaragoza,136,Lécera,687,382,305
50,Zaragoza,138,Lechón,51,30,21
50,Zaragoza,137,Leciñena,1199,611,588
50,Zaragoza,139,Letux,349,197,152
50,Zaragoza,140,Litago,171,95,76
50,Zaragoza,141,Lituénigo,119,62,57
50,Zaragoza,142,Lobera de Onsella,30,16,14
50,Zaragoza,143,Longares,798,448,350
50,Zaragoza,144,Longás,32,21,11
50,Zaragoza,146,Lucena de Jalón,237,132,105
50,Zaragoza,147,Luceni,971,490,481
50,Zaragoza,148,Luesia,310,169,141
50,Zaragoza,149,Luesma,34,21,13
50,Zaragoza,150,Lumpiaque,834,423,411
50,Zaragoza,151,Luna,726,383,343
50,Zaragoza,152,Maella,2004,1083,921
50,Zaragoza,153,Magallón,1150,597,553
50,Zaragoza,154,Mainar,151,81,70
50,Zaragoza,155,Malanquilla,105,66,39
50,Zaragoza,156,Maleján,254,130,124
50,Zaragoza,160,Mallén,3140,1631,1509
50,Zaragoza,157,Malón,349,178,171
50,Zaragoza,159,Maluenda,951,456,495
50,Zaragoza,161,Manchones,99,57,42
50,Zaragoza,162,Mara,185,94,91
50,Zaragoza,163,María de Huerva,5619,2868,2751
50,Zaragoza,902,Marracos,89,50,39
50,Zaragoza,164,Mediana de Aragón,468,226,242
50,Zaragoza,165,Mequinenza,2329,1193,1136
50,Zaragoza,166,Mesones de Isuela,274,137,137
50,Zaragoza,167,Mezalocha,248,143,105
50,Zaragoza,168,Mianos,32,20,12
50,Zaragoza,169,Miedes de Aragón,454,239,215
50,Zaragoza,170,Monegrillo,419,234,185
50,Zaragoza,171,Moneva,103,63,40
50,Zaragoza,172,Monreal de Ariza,208,118,90
50,Zaragoza,173,Monterde,168,101,67
50,Zaragoza,174,Montón,94,55,39
50,Zaragoza,175,Morata de Jalón,1146,556,590
50,Zaragoza,176,Morata de Jiloca,282,162,120
50,Zaragoza,177,Morés,335,178,157
50,Zaragoza,178,Moros,364,185,179
50,Zaragoza,179,Moyuela,258,136,122
50,Zaragoza,180,Mozota,136,66,70
50,Zaragoza,181,Muel,1324,683,641
50,Zaragoza,182,"Muela, La",5238,2737,2501
50,Zaragoza,183,Munébrega,403,219,184
50,Zaragoza,184,Murero,119,68,51
50,Zaragoza,185,Murillo de Gállego,175,103,72
50,Zaragoza,186,Navardún,41,25,16
50,Zaragoza,187,Nigüella,69,41,28
50,Zaragoza,188,Nombrevilla,31,18,13
50,Zaragoza,189,Nonaspe,964,513,451
50,Zaragoza,190,Novallas,838,445,393
50,Zaragoza,191,Novillas,546,273,273
50,Zaragoza,192,Nuévalos,332,180,152
50,Zaragoza,193,Nuez de Ebro,838,425,413
50,Zaragoza,194,Olvés,104,62,42
50,Zaragoza,195,Orcajo,57,37,20
50,Zaragoza,196,Orera,120,63,57
50,Zaragoza,197,Orés,106,63,43
50,Zaragoza,198,Oseja,55,35,20
50,Zaragoza,199,Osera de Ebro,396,195,201
50,Zaragoza,200,Paniza,650,340,310
50,Zaragoza,201,Paracuellos de Jiloca,583,305,278
50,Zaragoza,202,Paracuellos de la Ribera,171,91,80
50,Zaragoza,203,Pastriz,1314,624,690
50,Zaragoza,204,Pedrola,3453,1784,1669
50,Zaragoza,205,"Pedrosas, Las",106,52,54
50,Zaragoza,206,Perdiguera,596,318,278
50,Zaragoza,207,Piedratajada,110,57,53
50,Zaragoza,208,Pina de Ebro,2435,1241,1194
50,Zaragoza,209,Pinseque,3850,1991,1859
50,Zaragoza,210,"Pintanos, Los",37,23,14
50,Zaragoza,211,Plasencia de Jalón,315,176,139
50,Zaragoza,212,Pleitas,41,16,25
50,Zaragoza,213,Plenas,102,56,46
50,Zaragoza,214,Pomer,27,18,9
50,Zaragoza,215,Pozuel de Ariza,23,13,10
50,Zaragoza,216,Pozuelo de Aragón,281,152,129
50,Zaragoza,217,Pradilla de Ebro,562,300,262
50,Zaragoza,218,Puebla de Albortón,122,77,45
50,Zaragoza,219,"Puebla de Alfindén, La",6109,3123,2986
50,Zaragoza,220,Puendeluna,46,26,20
50,Zaragoza,221,Purujosa,37,26,11
50,Zaragoza,222,Quinto,1960,999,961
50,Zaragoza,223,Remolinos,1088,556,532
50,Zaragoza,224,Retascón,73,44,29
50,Zaragoza,225,Ricla,2894,1519,1375
50,Zaragoza,227,Romanos,119,65,54
50,Zaragoza,228,Rueda de Jalón,316,173,143
50,Zaragoza,229,Ruesca,72,37,35
50,Zaragoza,241,Sabiñán,699,375,324
50,Zaragoza,230,Sádaba,1347,690,657
50,Zaragoza,231,Salillas de Jalón,305,157,148
50,Zaragoza,232,Salvatierra de Esca,212,100,112
50,Zaragoza,233,Samper del Salz,112,63,49
50,Zaragoza,234,San Martín de la Virgen de Moncayo,287,160,127
50,Zaragoza,235,San Mateo de Gállego,3077,1579,1498
50,Zaragoza,236,Santa Cruz de Grío,118,70,48
50,Zaragoza,237,Santa Cruz de Moncayo,121,63,58
50,Zaragoza,238,Santa Eulalia de Gállego,99,53,46
50,Zaragoza,239,Santed,63,41,22
50,Zaragoza,240,Sástago,1175,594,581
50,Zaragoza,242,Sediles,100,62,38
50,Zaragoza,243,Sestrica,387,220,167
50,Zaragoza,244,Sierra de Luna,250,132,118
50,Zaragoza,245,Sigüés,94,50,44
50,Zaragoza,246,Sisamón,33,22,11
50,Zaragoza,247,Sobradiel,1074,512,562
50,Zaragoza,248,Sos del Rey Católico,588,309,279
50,Zaragoza,249,Tabuenca,331,190,141
50,Zaragoza,250,Talamantes,52,26,26
50,Zaragoza,251,Tarazona,10538,5202,5336
50,Zaragoza,252,Tauste,6892,3430,3462
50,Zaragoza,253,Terrer,479,258,221
50,Zaragoza,254,Tierga,190,103,87
50,Zaragoza,255,Tobed,224,118,106
50,Zaragoza,256,Torralba de los Frailes,88,46,42
50,Zaragoza,257,Torralba de Ribota,181,103,78
50,Zaragoza,258,Torralbilla,57,33,24
50,Zaragoza,259,Torrehermosa,65,36,29
50,Zaragoza,260,Torrelapaja,34,21,13
50,Zaragoza,261,Torrellas,254,133,121
50,Zaragoza,262,Torres de Berrellén,1469,766,703
50,Zaragoza,263,Torrijo de la Cañada,210,118,92
50,Zaragoza,264,Tosos,192,106,86
50,Zaragoza,265,Trasmoz,86,49,37
50,Zaragoza,266,Trasobares,121,74,47
50,Zaragoza,267,Uncastillo,662,311,351
50,Zaragoza,268,Undués de Lerda,59,32,27
50,Zaragoza,269,Urrea de Jalón,402,215,187
50,Zaragoza,270,Urriés,38,20,18
50,Zaragoza,271,Used,276,153,123
50,Zaragoza,272,Utebo,18593,9239,9354
50,Zaragoza,274,Val de San Martín,65,37,28
50,Zaragoza,273,Valdehorna,30,15,15
50,Zaragoza,275,Valmadrid,124,75,49
50,Zaragoza,276,Valpalmas,135,64,71
50,Zaragoza,277,Valtorres,64,31,33
50,Zaragoza,278,Velilla de Ebro,224,120,104
50,Zaragoza,279,Velilla de Jiloca,100,49,51
50,Zaragoza,280,Vera de Moncayo,375,191,184
50,Zaragoza,281,Vierlas,73,39,34
50,Zaragoza,283,Villadoz,90,52,38
50,Zaragoza,284,Villafeliche,168,89,79
50,Zaragoza,285,Villafranca de Ebro,821,403,418
50,Zaragoza,286,Villalba de Perejil,93,47,46
50,Zaragoza,287,Villalengua,324,176,148
50,Zaragoza,903,Villamayor de Gállego,2721,1365,1356
50,Zaragoza,288,Villanueva de Gállego,4656,2365,2291
50,Zaragoza,290,Villanueva de Huerva,462,239,223
50,Zaragoza,289,Villanueva de Jiloca,52,25,27
50,Zaragoza,291,Villar de los Navarros,102,57,45
50,Zaragoza,292,Villarreal de Huerva,260,145,115
50,Zaragoza,293,Villarroya de la Sierra,467,244,223
50,Zaragoza,294,Villarroya del Campo,71,37,34
50,Zaragoza,282,"Vilueña, La",88,45,43
50,Zaragoza,295,Vistabella,50,28,22
50,Zaragoza,296,"Zaida, La",463,230,233
50,Zaragoza,297,Zaragoza,664938,318419,346519
50,Zaragoza,298,Zuera,8253,4268,3985
51,Ceuta,1,Ceuta,84959,43034,41925
52,Melilla,1,Melilla,86120,43629,42491
