province_code,province_name,cmun,municipality_name,population_total,population_male,population_female
02,Albacete,1,Abengibre,760,369,391
02,Albacete,2,Alatoz,491,268,223
02,Albacete,3,Albacete,173206,84585,88621
02,Albacete,4,Albatana,655,332,323
02,Albacete,5,Alborea,666,350,316
02,Albacete,6,Alcadozo,648,355,293
02,Albacete,7,Alcalá del Júcar,1129,604,525
02,Albacete,8,Alcaraz,1304,678,626
02,Albacete,9,Almansa,24282,12044,12238
02,Albacete,10,Alpera,2268,1186,1082
02,Albacete,11,Ayna,601,334,267
02,Albacete,12,Balazote,2408,1236,1172
02,Albacete,14,"Ballestero, El",414,217,197
02,Albacete,13,Balsa de Ves,134,78,56
02,Albacete,15,Barrax,1849,955,894
02,Albacete,16,Bienservida,567,309,258
02,Albacete,17,Bogarra,740,391,349
02,Albacete,18,Bonete,980,518,462
02,Albacete,19,"Bonillo, El",2651,1349,1302
02,Albacete,20,Carcelén,481,249,232
02,Albacete,21,Casas de Juan Núñez,1349,729,620
02,Albacete,22,Casas de Lázaro,324,186,138
02,Albacete,23,Casas de Ves,556,295,261
02,Albacete,24,Casas-Ibáñez,4581,2314,2267
02,Albacete,25,Caudete,10146,5188,4958
02,Albacete,26,Cenizate,1143,577,566
02,Albacete,29,Chinchilla de Monte-Aragón,4565,2363,2202
02,Albacete,27,Corral-Rubio,302,159,143
02,Albacete,28,Cotillas,131,74,57
02,Albacete,30,Elche de la Sierra,3576,1751,1825
02,Albacete,31,Férez,617,309,308
02,Albacete,32,Fuensanta,289,157,132
02,Albacete,33,Fuente-Álamo,2431,1278,1153
02,Albacete,34,Fuentealbilla,1827,951,876
02,Albacete,35,"Gineta, La",2611,1356,1255
02,Albacete,36,Golosalvo,92,50,42
02,Albacete,37,Hellín,30516,15344,15172
02,Albacete,38,"Herrera, La",307,161,146
02,Albacete,39,Higueruela,1147,600,547
02,Albacete,40,Hoya-Gonzalo,614,323,291
02,Albacete,41,Jorquera,346,188,158
02,Albacete,42,Letur,929,466,463
02,Albacete,43,Lezuza,1291,674,617
02,Albacete,44,Liétor,1080,562,518
02,Albacete,45,Madrigueras,4675,2386,2289
02,Albacete,46,Mahora,1491,771,720
02,Albacete,47,Masegoso,139,79,60
02,Albacete,48,Minaya,1435,724,711
02,Albacete,49,Molinicos,824,425,399
02,Albacete,50,Montalvos,89,52,37
02,Albacete,51,Montealegre del Castillo,2040,1065,975
02,Albacete,52,Motilleja,661,362,299
02,Albacete,53,Munera,3409,1764,1645
02,Albacete,54,Navas de Jorquera,520,273,247
02,Albacete,55,Nerpio,1174,659,515
02,Albacete,56,Ontur,1913,959,954
02,Albacete,57,Ossa de Montiel,2209,1135,1074
02,Albacete,58,Paterna del Madera,351,193,158
02,Albacete,60,Peñas de San Pedro,1447,853,594
02,Albacete,59,Peñascosa,329,191,138
02,Albacete,61,Pétrola,669,351,318
02,Albacete,62,Povedilla,393,213,180
02,Albacete,901,Pozo Cañada,2703,1374,1329
02,Albacete,63,Pozohondo,1551,813,738
02,Albacete,64,Pozo-Lorente,392,200,192
02,Albacete,65,Pozuelo,470,255,215
02,Albacete,66,"Recueja, La",221,122,99
02,Albacete,67,Riópar,1326,673,653
02,Albacete,68,Robledo,394,215,179
02,Albacete,69,"Roda, La",15542,7821,7721
02,Albacete,70,Salobre,435,232,203
02,Albacete,71,San Pedro,1191,612,579
02,Albacete,72,Socovos,1705,883,822
02,Albacete,73,Tarazona de la Mancha,6138,3168,2970
02,Albacete,74,Tobarra,7824,4053,3771
02,Albacete,75,Valdeganga,1950,998,952
02,Albacete,76,Vianos,322,166,156
02,Albacete,77,Villa de Ves,61,34,27
02,Albacete,78,Villalgordo del Júcar,1086,570,516
02,Albacete,79,Villamalea,3929,2011,1918
02,Albacete,80,Villapalacios,553,291,262
02,Albacete,81,Villarrobledo,25189,12450,12739
02,Albacete,82,Villatoya,114,67,47
02,Albacete,83,Villavaliente,209,127,82
02,Albacete,84,Villaverde de Guadalimar,311,171,140
02,Albacete,85,Viveros,308,161,147
02,Albacete,86,Yeste,2478,1292,1186
03,Alicante/Alacant,2,Agost,5067,2566,2501
03,Alicante/Alacant,3,Agres,619,338,281
03,Alicante/Alacant,4,Aigües,1146,566,580
03,Alicante/Alacant,14,Alacant/Alicante,349282,168377,180905
03,Alicante/Alacant,5,Albatera,13092,6682,6410
03,Alicante/Alacant,6,Alcalalí,1397,701,696
03,Alicante/Alacant,9,Alcoi/Alcoy,59493,29124,30369
03,Alicante/Alacant,8,Alcoleja,188,100,88
03,Alicante/Alacant,7,Alcosser,259,130,129
03,Alicante/Alacant,10,Alfafara,419,196,223
03,Alicante/Alacant,11,"Alfàs del Pi, l'",20518,10102,10416
03,Alicante/Alacant,12,Algorfa,3635,1834,1801
03,Alicante/Alacant,13,Algueña,1395,714,681
03,Alicante/Alacant,15,Almoradí,21874,10985,10889
03,Alicante/Alacant,16,Almudaina,110,54,56
03,Alicante/Alacant,17,"Alqueria d'Asnar, l'",511,258,253
03,Alicante/Alacant,18,Altea,23820,11638,12182
03,Alicante/Alacant,19,Aspe,21473,10789,10684
03,Alicante/Alacant,1,"Atzúbia, l'",608,313,295
03,Alicante/Alacant,20,Balones,119,59,60
03,Alicante/Alacant,21,Banyeres de Mariola,7255,3677,3578
03,Alicante/Alacant,22,Benasau,173,84,89
03,Alicante/Alacant,23,Beneixama,1697,846,851
03,Alicante/Alacant,24,Benejúzar,5625,2813,2812
03,Alicante/Alacant,25,Benferri,2023,1046,977
03,Alicante/Alacant,26,Beniarbeig,2353,1191,1162
03,Alicante/Alacant,27,Beniardà,252,124,128
03,Alicante/Alacant,28,Beniarrés,1089,556,533
03,Alicante/Alacant,30,Benidoleig,1218,605,613
03,Alicante/Alacant,31,Benidorm,72342,35817,36525
03,Alicante/Alacant,32,Benifallim,111,60,51
03,Alicante/Alacant,33,Benifato,140,78,62
03,Alicante/Alacant,29,Benigembla,537,263,274
03,Alicante/Alacant,34,Benijófar,3473,1686,1787
03,Alicante/Alacant,35,Benilloba,737,388,349
03,Alicante/Alacant,36,Benillup,105,55,50
03,Alicante/Alacant,37,Benimantell,534,270,264
03,Alicante/Alacant,38,Benimarfull,422,219,203
03,Alicante/Alacant,39,Benimassot,105,56,49
03,Alicante/Alacant,40,Benimeli,455,213,242
03,Alicante/Alacant,41,Benissa,12279,6060,6219
03,Alicante/Alacant,43,Biar,3607,1762,1845
03,Alicante/Alacant,44,Bigastro,7361,3694,3667
03,Alicante/Alacant,45,Bolulla,440,221,219
03,Alicante/Alacant,46,Busot,3534,1763,1771
03,Alicante/Alacant,49,Callosa de Segura,19484,9932,9552
03,Alicante/Alacant,48,Callosa d'en Sarrià,7708,3973,3735
03,Alicante/Alacant,47,Calp,25854,12795,13059
03,Alicante/Alacant,51,"Camp de Mirra, el/Campo de Mirra",442,230,212
03,Alicante/Alacant,50,"Campello, el",29993,14551,15442
03,Alicante/Alacant,52,Cañada,1210,596,614
03,Alicante/Alacant,53,Castalla,11365,5767,5598
03,Alicante/Alacant,54,Castell de Castells,445,235,210
03,Alicante/Alacant,75,"Castell de Guadalest, el",274,135,139
03,Alicante/Alacant,55,Catral,9275,4670,4605
03,Alicante/Alacant,56,Cocentaina,11309,5695,5614
03,Alicante/Alacant,57,Confrides,297,161,136
03,Alicante/Alacant,58,Cox,7513,3790,3723
03,Alicante/Alacant,59,Crevillent,30191,15290,14901
03,Alicante/Alacant,61,Daya Nueva,1767,861,906
03,Alicante/Alacant,62,Daya Vieja,667,329,338
03,Alicante/Alacant,63,Dénia,45622,22205,23417
03,Alicante/Alacant,64,Dolores,7919,3949,3970
03,Alicante/Alacant,66,Elda,53034,25844,27190
03,Alicante/Alacant,65,Elx/Elche,238293,117760,120533
03,Alicante/Alacant,67,Fageca,101,50,51
03,Alicante/Alacant,68,Famorca,45,24,21
03,Alicante/Alacant,69,Finestrat,8836,4515,4321
03,Alicante/Alacant,77,"Fondó de les Neus, el/Hondón de las Nieves",2698,1381,1317
03,Alicante/Alacant,70,Formentera del Segura,4618,2364,2254
03,Alicante/Alacant,72,Gaianes,555,281,274
03,Alicante/Alacant,71,Gata de Gorgos,6515,3324,3191
03,Alicante/Alacant,73,Gorga,284,149,135
03,Alicante/Alacant,74,Granja de Rocamora,2686,1385,1301
03,Alicante/Alacant,76,Guardamar del Segura,17328,8442,8886
03,Alicante/Alacant,78,Hondón de los Frailes,1311,673,638
03,Alicante/Alacant,79,Ibi,23920,11945,11975
03,Alicante/Alacant,80,Jacarilla,2108,1072,1036
03,Alicante/Alacant,85,Llíber,946,474,472
03,Alicante/Alacant,86,Millena,254,135,119
03,Alicante/Alacant,88,Monforte del Cid,8777,4558,4219
03,Alicante/Alacant,89,Monòver/Monóvar,12542,6244,6298
03,Alicante/Alacant,903,"Montesinos, Los",5477,2762,2715
03,Alicante/Alacant,91,Murla,575,269,306
03,Alicante/Alacant,92,Muro de Alcoy,9253,4633,4620
03,Alicante/Alacant,90,Mutxamel,27078,13531,13547
03,Alicante/Alacant,93,Novelda,25771,12801,12970
03,Alicante/Alacant,94,"Nucia, la",18970,9620,9350
03,Alicante/Alacant,95,Ondara,7308,3639,3669
03,Alicante/Alacant,96,Onil,7763,3904,3859
03,Alicante/Alacant,97,Orba,2379,1165,1214
03,Alicante/Alacant,99,Orihuela,82449,40745,41704
03,Alicante/Alacant,84,"Orxa, l'/Lorcha",587,294,293
03,Alicante/Alacant,98,Orxeta,840,430,410
03,Alicante/Alacant,100,Parcent,1003,489,514
03,Alicante/Alacant,101,Pedreguer,8558,4267,4291
03,Alicante/Alacant,102,Pego,10485,5202,5283
03,Alicante/Alacant,103,Penàguila,313,156,157
03,Alicante/Alacant,104,Petrer,33914,16751,17163
03,Alicante/Alacant,902,Pilar de la Horadada,23428,11986,11442
03,Alicante/Alacant,105,"Pinós, el/Pinoso",8281,4214,4067
03,Alicante/Alacant,106,Planes,699,378,321
03,Alicante/Alacant,42,"Poble Nou de Benitatxell, el/Benitachell",4858,2373,2485
03,Alicante/Alacant,901,"Poblets, els",2763,1302,1461
03,Alicante/Alacant,107,Polop,5339,2679,2660
03,Alicante/Alacant,60,Quatretondeta,136,77,59
03,Alicante/Alacant,109,Rafal,4800,2392,2408
03,Alicante/Alacant,110,"Ràfol d'Almúnia, el",721,367,354
03,Alicante/Alacant,111,Redován,8183,4244,3939
03,Alicante/Alacant,112,Relleu,1248,640,608
03,Alicante/Alacant,113,Rojales,17451,8794,8657
03,Alicante/Alacant,114,"Romana, la",2632,1383,1249
03,Alicante/Alacant,115,Sagra,442,215,227
03,Alicante/Alacant,116,Salinas,1733,885,848
03,Alicante/Alacant,118,San Fulgencio,9443,4758,4685
03,Alicante/Alacant,904,San Isidro,2208,1142,1066
03,Alicante/Alacant,120,San Miguel de Salinas,6798,3419,3379
03,Alicante/Alacant,117,Sanet y Negrals,737,372,365
03,Alicante/Alacant,119,Sant Joan d'Alacant,25275,12210,13065
03,Alicante/Alacant,122,Sant Vicent del Raspeig/San Vicente del Raspeig,59928,29575,30353
03,Alicante/Alacant,121,Santa Pola,37816,18924,18892
03,Alicante/Alacant,123,Sax,10072,5030,5042
03,Alicante/Alacant,124,Sella,607,321,286
03,Alicante/Alacant,125,Senija,670,344,326
03,Alicante/Alacant,127,Tàrbena,630,334,296
03,Alicante/Alacant,128,Teulada,12515,6249,6266
03,Alicante/Alacant,129,Tibi,1808,948,860
03,Alicante/Alacant,130,Tollos,40,27,13
03,Alicante/Alacant,131,Tormos,339,164,175
03,Alicante/Alacant,132,"Torre de les Maçanes, la/Torremanzanas",714,376,338
03,Alicante/Alacant,133,Torrevieja,89290,43252,46038
03,Alicante/Alacant,134,"Vall d'Alcalà, la",174,91,83
03,Alicante/Alacant,136,"Vall de Gallinera, la",581,301,280
03,Alicante/Alacant,137,"Vall de Laguar, la",873,436,437
03,Alicante/Alacant,135,"Vall d'Ebo, la",230,120,110
03,Alicante/Alacant,138,"Verger, el",5101,2508,2593
03,Alicante/Alacant,139,"Vila Joiosa, la/Villajoyosa",36093,17835,18258
03,Alicante/Alacant,140,Villena,34144,17102,17042
03,Alicante/Alacant,82,Xàbia/Jávea,29760,14857,14903
03,Alicante/Alacant,81,Xaló,2964,1474,1490
03,Alicante/Alacant,83,Xixona/Jijona,7032,3433,3599
04,Almería,1,Abla,1255,650,605
04,Almería,2,Abrucena,1275,675,600
04,Almería,3,Adra,25195,12858,12337
04,Almería,4,Albanchez,682,366,316
04,Almería,5,Alboloduy,596,293,303
04,Almería,6,Albox,12311,6276,6035
04,Almería,7,Alcolea,803,418,385
04,Almería,8,Alcóntar,560,307,253
04,Almería,9,Alcudia de Monteagud,132,68,64
04,Almería,10,Alhabia,708,374,334
04,Almería,11,Alhama de Almería,3817,1932,1885
04,Almería,12,Alicún,221,108,113
04,Almería,13,Almería,200578,97592,102986
04,Almería,14,Almócita,207,105,102
04,Almería,15,Alsodux,146,82,64
04,Almería,16,Antas,3417,1780,1637
04,Almería,17,Arboleas,4439,2201,2238
04,Almería,18,Armuña de Almanzora,335,167,168
04,Almería,19,Bacares,237,124,113
04,Almería,904,Balanegra,2931,1528,1403
04,Almería,20,Bayárcal,326,170,156
04,Almería,21,Bayarque,221,104,117
04,Almería,22,Bédar,1012,506,506
04,Almería,23,Beires,144,78,66
04,Almería,24,Benahadux,4643,2294,2349
04,Almería,26,Benitagla,58,33,25
04,Almería,27,Benizalón,254,144,110
04,Almería,28,Bentarique,241,131,110
04,Almería,29,Berja,12917,6670,6247
04,Almería,30,Canjáyar,1153,597,556
04,Almería,31,Cantoria,3573,1804,1769
04,Almería,32,Carboneras,8375,4303,4072
04,Almería,33,Castro de Filabres,109,58,51
04,Almería,36,Chercos,302,154,148
04,Almería,37,Chirivel,1540,795,745
04,Almería,34,Cóbdar,202,109,93
04,Almería,35,Cuevas del Almanzora,15023,7812,7211
04,Almería,38,Dalías,4202,2084,2118
04,Almería,902,"Ejido, El",89975,47198,42777
04,Almería,41,Enix,588,323,265
04,Almería,43,Felix,767,446,321
04,Almería,44,Fines,2235,1184,1051
04,Almería,45,Fiñana,1991,1009,982
04,Almería,46,Fondón,1094,568,526
04,Almería,47,Gádor,3029,1591,1438
04,Almería,48,"Gallardos, Los",3034,1521,1513
04,Almería,49,Garrucha,10336,5397,4939
04,Almería,50,Gérgal,1191,667,524
04,Almería,51,Huécija,533,258,275
04,Almería,52,Huércal de Almería,18507,9350,9157
04,Almería,53,Huércal-Overa,20425,10163,10262
04,Almería,54,Íllar,451,237,214
04,Almería,55,Instinción,484,248,236
04,Almería,56,Laroya,198,112,86
04,Almería,57,Láujar de Andarax,1611,811,800
04,Almería,58,Líjar,389,210,179
04,Almería,59,Lubrín,1422,715,707
04,Almería,60,Lucainena de las Torres,704,360,344
04,Almería,61,Lúcar,829,415,414
04,Almería,62,Macael,5381,2728,2653
04,Almería,63,María,1209,625,584
04,Almería,64,Mojácar,7386,3628,3758
04,Almería,903,"Mojonera, La",8778,4831,3947
04,Almería,65,Nacimiento,508,269,239
04,Almería,66,Níjar,32858,18496,14362
04,Almería,67,Ohanes,550,284,266
04,Almería,68,Olula de Castro,189,104,85
04,Almería,69,Olula del Río,6354,3244,3110
04,Almería,70,Oria,2233,1174,1059
04,Almería,71,Padules,437,230,207
04,Almería,72,Partaloa,924,462,462
04,Almería,73,Paterna del Río,387,218,169
04,Almería,74,Pechina,4358,2250,2108
04,Almería,75,Pulpí,11247,5827,5420
04,Almería,76,Purchena,1551,794,757
04,Almería,77,Rágol,297,149,148
04,Almería,78,Rioja,1594,815,779
04,Almería,79,Roquetas de Mar,106510,55142,51368
04,Almería,80,Santa Cruz de Marchena,237,126,111
04,Almería,81,Santa Fe de Mondújar,494,256,238
04,Almería,82,Senés,288,159,129
04,Almería,83,Serón,2105,1095,1010
04,Almería,84,Sierro,379,204,175
04,Almería,85,Somontín,521,274,247
04,Almería,86,Sorbas,2527,1318,1209
04,Almería,87,Suflí,229,119,110
04,Almería,88,Tabernas,4032,2095,1937
04,Almería,89,Taberno,958,472,486
04,Almería,90,Tahal,373,192,181
04,Almería,91,Terque,400,211,189
04,Almería,92,Tíjola,3518,1759,1759
04,Almería,901,"Tres Villas, Las",581,319,262
04,Almería,93,Turre,4092,2103,1989
04,Almería,94,Turrillas,278,154,124
04,Almería,95,Uleila del Campo,820,409,411
04,Almería,96,Urrácal,378,193,185
04,Almería,97,Velefique,258,146,112
04,Almería,98,Vélez-Blanco,1914,981,933
04,Almería,99,Vélez-Rubio,6558,3189,3369
04,Almería,100,Vera,18919,9632,9287
04,Almería,101,Viator,6160,3135,3025
04,Almería,102,Vícar,28245,15331,12914
04,Almería,103,Zurgena,2972,1505,1467
01,Araba/Álava,51,Agurain/Salvatierra,5085,2583,2502
01,Araba/Álava,1,Alegría-Dulantzi,2975,1539,1436
01,Araba/Álava,2,Amurrio,10313,5134,5179
01,Araba/Álava,49,Añana,156,95,61
01,Araba/Álava,3,Aramaio,1409,732,677
01,Araba/Álava,6,Armiñón,232,120,112
01,Araba/Álava,37,Arraia-Maeztu,812,450,362
01,Araba/Álava,8,Arratzua-Ubarrundia,1043,559,484
01,Araba/Álava,4,Artziniega,1832,898,934
01,Araba/Álava,9,Asparrena,1609,817,792
01,Araba/Álava,10,Ayala/Aiara,2918,1479,1439
01,Araba/Álava,11,Baños de Ebro/Mañueta,295,168,127
01,Araba/Álava,13,Barrundia,897,493,404
01,Araba/Álava,14,Berantevilla,451,237,214
01,Araba/Álava,16,Bernedo,540,321,219
01,Araba/Álava,17,Campezo/Kanpezu,1072,564,508
01,Araba/Álava,21,Elburgo/Burgelu,638,332,306
01,Araba/Álava,22,Elciego,964,484,480
01,Araba/Álava,23,Elvillar/Bilar,313,151,162
01,Araba/Álava,47,Erriberabeitia,1423,762,661
01,Araba/Álava,46,Erriberagoitia/Ribera Alta,828,494,334
01,Araba/Álava,56,Harana/Valle de Arana,219,120,99
01,Araba/Álava,901,Iruña Oka/Iruña de Oca,3597,1918,1679
01,Araba/Álava,27,Iruraiz-Gauna,541,295,246
01,Araba/Álava,19,Kripan,174,92,82
01,Araba/Álava,20,Kuartango,401,232,169
01,Araba/Álava,28,Labastida/Bastida,1566,815,751
01,Araba/Álava,30,Lagrán,172,97,75
01,Araba/Álava,31,Laguardia,1472,775,697
01,Araba/Álava,32,Lanciego/Lantziego,708,361,347
01,Araba/Álava,902,Lantarón,938,525,413
01,Araba/Álava,33,Lapuebla de Labarca,865,445,420
01,Araba/Álava,36,Laudio/Llodio,17917,8685,9232
01,Araba/Álava,58,Legutio,2048,1066,982
01,Araba/Álava,34,Leza,220,112,108
01,Araba/Álava,39,Moreda de Álava/Moreda Araba,208,110,98
01,Araba/Álava,41,Navaridas,197,108,89
01,Araba/Álava,42,Okondo,1198,628,570
01,Araba/Álava,43,Oyón-Oion,3405,1729,1676
01,Araba/Álava,44,Peñacerrada-Urizaharra,302,180,122
01,Araba/Álava,52,Samaniego,305,152,153
01,Araba/Álava,53,San Millán/Donemiliaga,726,392,334
01,Araba/Álava,54,Urkabustaiz,1434,750,684
01,Araba/Álava,55,Valdegovía/Gaubea,1066,583,483
01,Araba/Álava,57,Villabuena de Álava/Eskuernaga,285,148,137
01,Araba/Álava,59,Vitoria-Gasteiz,255886,124348,131538
01,Araba/Álava,60,Yécora/Iekora,249,127,122
01,Araba/Álava,61,Zalduondo,196,106,90
01,Araba/Álava,62,Zambrana,422,231,191
01,Araba/Álava,18,Zigoitia,1821,974,847
01,Araba/Álava,63,Zuia,2343,1227,1116
33,Asturias,1,Allande,1552,767,785
33,Asturias,2,Aller,10076,4946,5130
33,Asturias,3,Amieva,599,336,263
33,Asturias,4,Avilés,75518,35623,39895
33,Asturias,5,Belmonte de Miranda,1399,747,652
33,Asturias,6,Bimenes,1669,820,849
33,Asturias,7,Boal,1412,722,690
33,Asturias,8,Cabrales,1918,962,956
33,Asturias,9,Cabranes,1105,561,544
33,Asturias,10,Candamo,1932,944,988
33,Asturias,12,Cangas de Onís,6362,3068,3294
33,Asturias,11,Cangas del Narcea,11596,5640,5956
33,Asturias,13,Caravia,496,260,236
33,Asturias,14,Carreño,10177,4897,5280
33,Asturias,15,Caso,1449,837,612
33,Asturias,16,Castrillón,22103,10663,11440
33,Asturias,17,Castropol,3289,1607,1682
33,Asturias,18,Coaña,3304,1625,1679
33,Asturias,19,Colunga,3187,1580,1607
33,Asturias,20,Corvera de Asturias,15612,7641,7971
33,Asturias,21,Cudillero,4909,2420,2489
33,Asturias,22,Degaña,805,411,394
33,Asturias,23,"Franco, El",3749,1827,1922
33,Asturias,24,Gijón,268313,126085,142228
33,Asturias,25,Gozón,10470,5117,5353
33,Asturias,26,Grado,9616,4668,4948
33,Asturias,27,Grandas de Salime,765,392,373
33,Asturias,28,Ibias,1121,645,476
33,Asturias,29,Illano,288,149,139
33,Asturias,30,Illas,1061,538,523
33,Asturias,31,Langreo,37978,18080,19898
33,Asturias,32,Laviana,12355,5924,6431
33,Asturias,33,Lena,10312,4969,5343
33,Asturias,35,Llanera,13948,6887,7061
33,Asturias,36,Llanes,13524,6574,6950
33,Asturias,37,Mieres,36195,17187,19008
33,Asturias,38,Morcín,2540,1277,1263
33,Asturias,39,Muros de Nalón,1955,949,1006
33,Asturias,40,Nava,5186,2550,2636
33,Asturias,41,Navia,8136,3913,4223
33,Asturias,42,Noreña,5058,2430,2628
33,Asturias,43,Onís,746,401,345
33,Asturias,44,Oviedo,217584,100640,116944
33,Asturias,45,Parres,5208,2554,2654
33,Asturias,46,Peñamellera Alta,535,281,254
33,Asturias,47,Peñamellera Baja,1221,604,617
33,Asturias,48,Pesoz,138,75,63
33,Asturias,49,Piloña,6822,3329,3493
33,Asturias,50,Ponga,579,342,237
33,Asturias,51,Pravia,7830,3823,4007
33,Asturias,52,Proaza,709,419,290
33,Asturias,53,Quirós,1175,682,493
33,Asturias,54,"Regueras, Las",1888,960,928
33,Asturias,55,Ribadedeva,1731,842,889
33,Asturias,56,Ribadesella,5548,2638,2910
33,Asturias,57,Ribera de Arriba,1857,931,926
33,Asturias,58,Riosa,1755,891,864
33,Asturias,59,Salas,4806,2383,2423
33,Asturias,61,San Martín de Oscos,344,170,174
33,Asturias,60,San Martín del Rey Aurelio,15431,7395,8036
33,Asturias,63,San Tirso de Abres,412,193,219
33,Asturias,62,Santa Eulalia de Oscos,431,223,208
33,Asturias,64,Santo Adriano,286,140,146
33,Asturias,65,Sariego,1271,612,659
33,Asturias,66,Siero,52194,25493,26701
33,Asturias,67,Sobrescobio,851,451,400
33,Asturias,68,Somiedo,1083,640,443
33,Asturias,69,Soto del Barco,3818,1869,1949
33,Asturias,70,Tapia de Casariego,3652,1773,1879
33,Asturias,71,Taramundi,576,276,300
33,Asturias,72,Teverga,1565,862,703
33,Asturias,73,Tineo,8857,4477,4380
33,Asturias,34,Valdés,10958,5397,5561
33,Asturias,74,Vegadeo,3885,1868,2017
33,Asturias,75,Villanueva de Oscos,261,132,129
33,Asturias,76,Villaviciosa,15000,7421,7579
33,Asturias,77,Villayón,1104,569,535
33,Asturias,78,Yernes y Tameza,133,70,63
05,Ávila,1,Adanero,204,115,89
05,Ávila,2,"Adrada, La",2727,1387,1340
05,Ávila,5,Albornos,175,90,85
05,Ávila,7,Aldeanueva de Santa Cruz,100,53,47
05,Ávila,8,Aldeaseca,210,104,106
05,Ávila,10,"Aldehuela, La",148,76,72
05,Ávila,12,Amavida,135,73,62
05,Ávila,13,"Arenal, El",964,463,501
05,Ávila,14,Arenas de San Pedro,6464,3143,3321
05,Ávila,15,Arevalillo,60,28,32
05,Ávila,16,Arévalo,7768,3769,3999
05,Ávila,17,Aveinte,75,44,31
05,Ávila,18,Avellaneda,24,15,9
05,Ávila,19,Ávila,57741,27485,30256
05,Ávila,21,"Barco de Ávila, El",2276,1097,1179
05,Ávila,22,"Barraco, El",2005,1010,995
05,Ávila,23,Barromán,176,95,81
05,Ávila,24,Becedas,164,88,76
05,Ávila,25,Becedillas,70,37,33
05,Ávila,26,Bercial de Zapardiel,178,94,84
05,Ávila,27,"Berlanas, Las",326,174,152
05,Ávila,29,Bernuy-Zapardiel,88,49,39
05,Ávila,30,Berrocalejo de Aragona,48,28,20
05,Ávila,33,Blascomillán,169,87,82
05,Ávila,34,Blasconuño de Matacabras,15,9,6
05,Ávila,35,Blascosancho,106,55,51
05,Ávila,36,"Bohodón, El",107,56,51
05,Ávila,37,Bohoyo,215,125,90
05,Ávila,38,Bonilla de la Sierra,180,108,72
05,Ávila,39,Brabos,39,26,13
05,Ávila,40,Bularros,57,37,20
05,Ávila,41,Burgohondo,1240,650,590
05,Ávila,42,Cabezas de Alambre,156,74,82
05,Ávila,43,Cabezas del Pozo,89,43,46
05,Ávila,44,Cabezas del Villar,234,131,103
05,Ávila,45,Cabizuela,88,45,43
05,Ávila,46,Canales,36,20,16
05,Ávila,47,Candeleda,5001,2514,2487
05,Ávila,48,Cantiveros,97,57,40
05,Ávila,49,Cardeñosa,419,228,191
05,Ávila,51,"Carrera, La",161,91,70
05,Ávila,52,Casas del Puerto,85,45,40
05,Ávila,53,Casasola,66,39,27
05,Ávila,54,Casavieja,1410,726,684
05,Ávila,55,Casillas,663,361,302
05,Ávila,56,Castellanos de Zapardiel,135,75,60
05,Ávila,57,Cebreros,3256,1691,1565
05,Ávila,58,Cepeda la Mora,67,40,27
05,Ávila,67,Chamartín,61,35,26
05,Ávila,59,Cillán,72,43,29
05,Ávila,60,Cisla,99,54,45
05,Ávila,61,"Colilla, La",366,189,177
05,Ávila,62,Collado de Contreras,143,72,71
05,Ávila,63,Collado del Mirón,24,14,10
05,Ávila,64,Constanzana,98,58,40
05,Ávila,65,Crespos,465,247,218
05,Ávila,66,Cuevas del Valle,508,282,226
05,Ávila,903,Diego del Carpio,108,67,41
05,Ávila,69,Donjimeno,76,42,34
05,Ávila,70,Donvidas,31,20,11
05,Ávila,72,Espinosa de los Caballeros,102,53,49
05,Ávila,73,Flores de Ávila,271,144,127
05,Ávila,74,Fontiveros,716,370,346
05,Ávila,75,Fresnedilla,106,52,54
05,Ávila,76,"Fresno, El",595,307,288
05,Ávila,77,Fuente el Saúz,158,88,70
05,Ávila,78,Fuentes de Año,89,52,37
05,Ávila,79,Gallegos de Altamiros,58,34,24
05,Ávila,80,Gallegos de Sobrinos,46,23,23
05,Ávila,81,Garganta del Villar,41,27,14
05,Ávila,82,Gavilanes,547,302,245
05,Ávila,83,Gemuño,150,78,72
05,Ávila,85,Gil García,44,22,22
05,Ávila,84,Gilbuena,49,33,16
05,Ávila,86,Gimialcón,74,45,29
05,Ávila,87,Gotarrendura,167,61,106
05,Ávila,88,Grandes y San Martín,36,17,19
05,Ávila,89,Guisando,488,245,243
05,Ávila,90,Gutierre-Muñoz,61,32,29
05,Ávila,92,Hernansancho,147,82,65
05,Ávila,93,Herradón de Pinares,487,275,212
05,Ávila,94,Herreros de Suso,149,83,66
05,Ávila,95,Higuera de las Dueñas,275,154,121
05,Ávila,96,"Hija de Dios, La",80,48,32
05,Ávila,97,"Horcajada, La",465,235,230
05,Ávila,99,Horcajo de las Torres,454,253,201
05,Ávila,100,"Hornillo, El",266,146,120
05,Ávila,102,"Hoyo de Pinares, El",2153,1114,1039
05,Ávila,101,Hoyocasero,328,187,141
05,Ávila,103,Hoyorredondo,60,32,28
05,Ávila,106,Hoyos de Miguel Muñoz,27,15,12
05,Ávila,104,Hoyos del Collado,29,17,12
05,Ávila,105,Hoyos del Espino,345,182,163
05,Ávila,107,Hurtumpascual,43,26,17
05,Ávila,108,Junciana,43,24,19
05,Ávila,109,Langa,440,224,216
05,Ávila,110,Lanzahíta,799,407,392
05,Ávila,113,"Llanos de Tormes, Los",65,30,35
05,Ávila,112,"Losar del Barco, El",116,67,49
05,Ávila,114,Madrigal de las Altas Torres,1338,690,648
05,Ávila,115,Maello,705,383,322
05,Ávila,116,Malpartida de Corneja,99,50,49
05,Ávila,117,Mamblas,197,112,85
05,Ávila,118,Mancera de Arriba,71,38,33
05,Ávila,119,Manjabálago y Ortigosa de Rioalmar,36,18,18
05,Ávila,120,Marlín,34,21,13
05,Ávila,121,Martiherrero,356,186,170
05,Ávila,122,Martínez,114,61,53
05,Ávila,123,Mediana de Voltoya,117,61,56
05,Ávila,124,Medinilla,78,40,38
05,Ávila,125,Mengamuñoz,56,29,27
05,Ávila,126,Mesegar de Corneja,76,40,36
05,Ávila,127,Mijares,730,405,325
05,Ávila,128,Mingorría,389,202,187
05,Ávila,129,"Mirón, El",98,63,35
05,Ávila,130,Mironcillo,109,58,51
05,Ávila,131,Mirueña de los Infanzones,88,49,39
05,Ávila,132,Mombeltrán,917,484,433
05,Ávila,133,Monsalupe,59,32,27
05,Ávila,134,Moraleja de Matacabras,53,29,24
05,Ávila,135,Muñana,483,252,231
05,Ávila,136,Muñico,78,45,33
05,Ávila,138,Muñogalindo,301,151,150
05,Ávila,139,Muñogrande,71,38,33
05,Ávila,140,Muñomer del Peco,112,57,55
05,Ávila,141,Muñopepe,103,53,50
05,Ávila,142,Muñosancho,88,48,40
05,Ávila,143,Muñotello,51,28,23
05,Ávila,144,Narrillos del Álamo,60,33,27
05,Ávila,145,Narrillos del Rebollar,37,24,13
05,Ávila,149,Narros de Saldueña,111,57,54
05,Ávila,147,Narros del Castillo,148,81,67
05,Ávila,148,Narros del Puerto,28,15,13
05,Ávila,152,Nava de Arévalo,677,343,334
05,Ávila,153,Nava del Barco,85,44,41
05,Ávila,151,Navacepedilla de Corneja,94,51,43
05,Ávila,154,Navadijos,39,27,12
05,Ávila,155,Navaescurial,52,31,21
05,Ávila,156,Navahondilla,358,212,146
05,Ávila,157,Navalacruz,218,126,92
05,Ávila,158,Navalmoral,364,193,171
05,Ávila,159,Navalonguilla,194,98,96
05,Ávila,160,Navalosa,323,186,137
05,Ávila,161,Navalperal de Pinares,792,419,373
05,Ávila,162,Navalperal de Tormes,83,48,35
05,Ávila,163,Navaluenga,2164,1083,1081
05,Ávila,164,Navaquesera,40,20,20
05,Ávila,165,Navarredonda de Gredos,442,230,212
05,Ávila,166,Navarredondilla,179,100,79
05,Ávila,167,Navarrevisca,304,175,129
05,Ávila,168,"Navas del Marqués, Las",5362,2736,2626
05,Ávila,169,Navatalgordo,238,135,103
05,Ávila,170,Navatejares,55,25,30
05,Ávila,171,Neila de San Miguel,62,34,28
05,Ávila,172,Niharra,177,102,75
05,Ávila,173,Ojos-Albos,91,47,44
05,Ávila,174,Orbita,70,39,31
05,Ávila,175,"Oso, El",136,80,56
05,Ávila,176,Padiernos,276,155,121
05,Ávila,177,Pajares de Adaja,135,73,62
05,Ávila,178,Palacios de Goda,407,221,186
05,Ávila,179,Papatrigo,221,108,113
05,Ávila,180,"Parral, El",61,38,23
05,Ávila,181,Pascualcobo,38,25,13
05,Ávila,182,Pedro Bernardo,771,405,366
05,Ávila,183,Pedro-Rodríguez,135,71,64
05,Ávila,184,Peguerinos,303,167,136
05,Ávila,185,Peñalba de Ávila,103,58,45
05,Ávila,186,Piedrahíta,1662,799,863
05,Ávila,187,Piedralaves,2136,1061,1075
05,Ávila,188,Poveda,34,19,15
05,Ávila,189,Poyales del Hoyo,493,268,225
05,Ávila,190,Pozanco,56,35,21
05,Ávila,191,Pradosegar,119,67,52
05,Ávila,192,Puerto Castilla,100,61,39
05,Ávila,193,Rasueros,161,90,71
05,Ávila,194,Riocabado,131,78,53
05,Ávila,195,Riofrío,195,120,75
05,Ávila,196,Rivilla de Barajas,62,29,33
05,Ávila,197,Salobral,111,60,51
05,Ávila,198,Salvadiós,77,39,38
05,Ávila,199,San Bartolomé de Béjar,54,29,25
05,Ávila,200,San Bartolomé de Corneja,37,21,16
05,Ávila,201,San Bartolomé de Pinares,501,276,225
05,Ávila,206,San Esteban de los Patos,20,13,7
05,Ávila,208,San Esteban de Zapardiel,39,21,18
05,Ávila,207,San Esteban del Valle,745,383,362
05,Ávila,209,San García de Ingelmos,70,46,24
05,Ávila,901,San Juan de Gredos,248,135,113
05,Ávila,210,San Juan de la Encinilla,65,33,32
05,Ávila,211,San Juan de la Nava,435,242,193
05,Ávila,212,San Juan del Molinillo,234,124,110
05,Ávila,213,San Juan del Olmo,80,52,28
05,Ávila,214,San Lorenzo de Tormes,32,17,15
05,Ávila,215,San Martín de la Vega del Alberche,161,97,64
05,Ávila,216,San Martín del Pimpollar,220,127,93
05,Ávila,217,San Miguel de Corneja,70,37,33
05,Ávila,218,San Miguel de Serrezuela,103,56,47
05,Ávila,219,San Pascual,43,26,17
05,Ávila,220,San Pedro del Arroyo,500,265,235
05,Ávila,231,San Vicente de Arévalo,166,93,73
05,Ávila,204,Sanchidrián,710,369,341
05,Ávila,205,Sanchorreja,80,41,39
05,Ávila,222,Santa Cruz de Pinares,172,102,70
05,Ávila,221,Santa Cruz del Valle,322,166,156
05,Ávila,226,Santa María de los Caballeros,67,42,25
05,Ávila,224,Santa María del Arroyo,101,55,46
05,Ávila,225,Santa María del Berrocal,374,190,184
05,Ávila,902,Santa María del Cubillo,315,177,138
05,Ávila,227,Santa María del Tiétar,533,276,257
05,Ávila,228,Santiago del Collado,168,106,62
05,Ávila,904,Santiago del Tormes,110,60,50
05,Ávila,229,Santo Domingo de las Posadas,72,38,34
05,Ávila,230,Santo Tomé de Zabarcos,70,42,28
05,Ávila,232,"Serrada, La",137,70,67
05,Ávila,233,Serranillos,279,154,125
05,Ávila,234,Sigeres,41,20,21
05,Ávila,235,Sinlabajos,136,63,73
05,Ávila,236,Solana de Ávila,107,62,45
05,Ávila,237,Solana de Rioalmar,149,87,62
05,Ávila,238,Solosancho,779,418,361
05,Ávila,239,Sotalbo,247,146,101
05,Ávila,240,Sotillo de la Adrada,4870,2425,2445
05,Ávila,241,"Tiemblo, El",4445,2264,2181
05,Ávila,242,Tiñosillos,759,388,371
05,Ávila,243,Tolbaños,82,47,35
05,Ávila,244,Tormellas,36,23,13
05,Ávila,245,Tornadizos de Ávila,456,223,233
05,Ávila,247,"Torre, La",223,123,100
05,Ávila,246,Tórtoles,37,22,15
05,Ávila,249,Umbrías,103,52,51
05,Ávila,251,Vadillo de la Sierra,58,37,21
05,Ávila,252,Valdecasa,57,36,21
05,Ávila,253,Vega de Santa María,76,38,38
05,Ávila,254,Velayos,211,106,105
05,Ávila,256,Villaflor,102,55,47
05,Ávila,257,Villafranca de la Sierra,130,76,54
05,Ávila,905,Villanueva de Ávila,230,125,105
05,Ávila,258,Villanueva de Gómez,115,66,49
05,Ávila,259,Villanueva del Aceral,97,45,52
05,Ávila,260,Villanueva del Campillo,105,58,47
05,Ávila,261,Villar de Corneja,37,23,14
05,Ávila,262,Villarejo del Valle,327,176,151
05,Ávila,263,Villatoro,152,85,67
05,Ávila,264,Viñegra de Moraña,47,23,24
05,Ávila,265,Vita,79,46,33
05,Ávila,266,Zapardiel de la Cañada,83,45,38
05,Ávila,267,Zapardiel de la Ribera,84,44,40
06,Badajoz,1,Acedera,814,422,392
06,Badajoz,2,Aceuchal,5446,2699,2747
06,Badajoz,3,Ahillones,797,400,397
06,Badajoz,4,Alange,1831,944,887
06,Badajoz,5,"Albuera, La",2002,1033,969
06,Badajoz,6,Alburquerque,5063,2533,2530
06,Badajoz,7,Alconchel,1634,829,805
06,Badajoz,8,Alconera,758,383,375
06,Badajoz,9,Aljucén,261,143,118
06,Badajoz,10,Almendral,1195,604,591
06,Badajoz,11,Almendralejo,33948,16755,17193
06,Badajoz,12,Arroyo de San Serván,4038,2029,2009
06,Badajoz,13,Atalaya,278,145,133
06,Badajoz,14,Azuaga,7624,3777,3847
06,Badajoz,15,Badajoz,150190,72584,77606
06,Badajoz,16,Barcarrota,3452,1743,1709
06,Badajoz,17,Baterno,243,133,110
06,Badajoz,18,Benquerencia de la Serena,783,392,391
06,Badajoz,19,Berlanga,2219,1104,1115
06,Badajoz,20,Bienvenida,2031,1031,1000
06,Badajoz,21,Bodonal de la Sierra,1001,507,494
06,Badajoz,22,Burguillos del Cerro,3015,1485,1530
06,Badajoz,23,Cabeza del Buey,4583,2289,2294
06,Badajoz,24,Cabeza la Vaca,1272,662,610
06,Badajoz,25,Calamonte,6095,3017,3078
06,Badajoz,26,Calera de León,917,471,446
06,Badajoz,27,Calzadilla de los Barros,699,353,346
06,Badajoz,28,Campanario,4742,2341,2401
06,Badajoz,29,Campillo de Llerena,1329,657,672
06,Badajoz,30,Capilla,155,82,73
06,Badajoz,31,Carmonita,518,259,259
06,Badajoz,32,"Carrascalejo, El",78,43,35
06,Badajoz,33,Casas de Don Pedro,1380,707,673
06,Badajoz,34,Casas de Reina,203,104,99
06,Badajoz,35,Castilblanco,852,436,416
06,Badajoz,36,Castuera,5567,2777,2790
06,Badajoz,42,Cheles,1162,574,588
06,Badajoz,37,"Codosera, La",2004,1046,958
06,Badajoz,38,Cordobilla de Lácara,838,441,397
06,Badajoz,39,"Coronada, La",2153,1049,1104
06,Badajoz,40,Corte de Peleas,1163,571,592
06,Badajoz,41,Cristina,553,280,273
06,Badajoz,43,Don Álvaro,814,433,381
06,Badajoz,44,Don Benito,37485,18467,19018
06,Badajoz,45,Entrín Bajo,546,278,268
06,Badajoz,46,Esparragalejo,1510,747,763
06,Badajoz,47,Esparragosa de la Serena,960,484,476
06,Badajoz,48,Esparragosa de Lares,875,435,440
06,Badajoz,49,Feria,1050,505,545
06,Badajoz,50,Fregenal de la Sierra,4753,2326,2427
06,Badajoz,51,Fuenlabrada de los Montes,1736,847,889
06,Badajoz,52,Fuente de Cantos,4638,2301,2337
06,Badajoz,53,Fuente del Arco,668,345,323
06,Badajoz,54,Fuente del Maestre,6626,3269,3357
06,Badajoz,55,Fuentes de León,2198,1084,1114
06,Badajoz,56,Garbayuela,494,260,234
06,Badajoz,57,Garlitos,539,270,269
06,Badajoz,58,"Garrovilla, La",2297,1131,1166
06,Badajoz,59,Granja de Torrehermosa,1933,957,976
06,Badajoz,903,Guadiana,2416,1187,1229
06,Badajoz,60,Guareña,6668,3331,3337
06,Badajoz,61,"Haba, La",1208,606,602
06,Badajoz,62,Helechosa de los Montes,587,337,250
06,Badajoz,63,Herrera del Duque,3413,1718,1695
06,Badajoz,64,Higuera de la Serena,901,461,440
06,Badajoz,65,Higuera de Llerena,350,179,171
06,Badajoz,66,Higuera de Vargas,1882,954,928
06,Badajoz,67,Higuera la Real,2199,1113,1086
06,Badajoz,68,Hinojosa del Valle,477,230,247
06,Badajoz,69,Hornachos,3418,1709,1709
06,Badajoz,70,Jerez de los Caballeros,9147,4485,4662
06,Badajoz,71,"Lapa, La",294,150,144
06,Badajoz,73,Llera,806,408,398
06,Badajoz,74,Llerena,5650,2807,2843
06,Badajoz,72,Lobón,2745,1411,1334
06,Badajoz,75,Magacela,489,253,236
06,Badajoz,76,Maguilla,943,473,470
06,Badajoz,77,Malcocinado,356,196,160
06,Badajoz,78,Malpartida de la Serena,524,271,253
06,Badajoz,79,Manchita,751,381,370
06,Badajoz,80,Medellín,2237,1142,1095
06,Badajoz,81,Medina de las Torres,1153,600,553
06,Badajoz,82,Mengabril,488,264,224
06,Badajoz,83,Mérida,59461,28873,30588
06,Badajoz,84,Mirandilla,1223,609,614
06,Badajoz,85,Monesterio,4254,2158,2096
06,Badajoz,86,Montemolín,1280,618,662
06,Badajoz,87,Monterrubio de la Serena,2237,1103,1134
06,Badajoz,88,Montijo,15312,7557,7755
06,Badajoz,89,"Morera, La",703,361,342
06,Badajoz,90,"Nava de Santiago, La",909,455,454
06,Badajoz,91,Navalvillar de Pela,4364,2196,2168
06,Badajoz,92,Nogales,627,313,314
06,Badajoz,93,Oliva de la Frontera,4967,2498,2469
06,Badajoz,94,Oliva de Mérida,1669,842,827
06,Badajoz,95,Olivenza,11776,5844,5932
06,Badajoz,96,Orellana de la Sierra,275,149,126
06,Badajoz,97,Orellana la Vieja,2594,1330,1264
06,Badajoz,98,Palomas,657,330,327
06,Badajoz,99,"Parra, La",1283,663,620
06,Badajoz,100,Peñalsordo,831,413,418
06,Badajoz,101,Peraleda del Zaucejo,477,242,235
06,Badajoz,102,Puebla de Alcocer,1130,560,570
06,Badajoz,103,Puebla de la Calzada,5812,2924,2888
06,Badajoz,104,Puebla de la Reina,707,344,363
06,Badajoz,107,Puebla de Obando,1816,923,893
06,Badajoz,108,Puebla de Sancho Pérez,2640,1335,1305
06,Badajoz,105,Puebla del Maestre,642,337,305
06,Badajoz,106,Puebla del Prior,448,231,217
06,Badajoz,902,Pueblonuevo del Guadiana,1953,977,976
06,Badajoz,109,Quintana de la Serena,4469,2256,2213
06,Badajoz,110,Reina,143,74,69
06,Badajoz,111,Rena,614,321,293
06,Badajoz,112,Retamal de Llerena,433,228,205
06,Badajoz,113,Ribera del Fresno,3193,1599,1594
06,Badajoz,114,Risco,122,58,64
06,Badajoz,115,"Roca de la Sierra, La",1436,709,727
06,Badajoz,116,Salvaleón,1671,844,827
06,Badajoz,117,Salvatierra de los Barros,1573,776,797
06,Badajoz,119,San Pedro de Mérida,879,451,428
06,Badajoz,123,San Vicente de Alcántara,5262,2642,2620
06,Badajoz,118,Sancti-Spíritus,154,84,70
06,Badajoz,120,Santa Amalia,3939,1990,1949
06,Badajoz,121,Santa Marta,4136,2074,2062
06,Badajoz,122,"Santos de Maimona, Los",8096,4063,4033
06,Badajoz,124,Segura de León,1783,896,887
06,Badajoz,125,Siruela,1802,910,892
06,Badajoz,126,Solana de los Barros,2538,1276,1262
06,Badajoz,127,Talarrubias,3274,1646,1628
06,Badajoz,128,Talavera la Real,5282,2637,2645
06,Badajoz,129,Táliga,662,331,331
06,Badajoz,130,Tamurejo,205,104,101
06,Badajoz,131,Torre de Miguel Sesmero,1230,626,604
06,Badajoz,132,Torremayor,1010,495,515
06,Badajoz,133,Torremejía,2246,1173,1073
06,Badajoz,134,Trasierra,607,318,289
06,Badajoz,135,Trujillanos,1401,713,688
06,Badajoz,136,Usagre,1747,866,881
06,Badajoz,137,Valdecaballeros,1066,551,515
06,Badajoz,901,Valdelacalzada,2762,1388,1374
06,Badajoz,138,Valdetorres,1155,566,589
06,Badajoz,139,Valencia de las Torres,502,266,236
06,Badajoz,140,Valencia del Mombuey,725,375,350
06,Badajoz,141,Valencia del Ventoso,1900,958,942
06,Badajoz,146,Valle de la Serena,1111,567,544
06,Badajoz,147,Valle de Matamoros,346,178,168
06,Badajoz,148,Valle de Santa Ana,1113,548,565
06,Badajoz,142,Valverde de Burguillos,280,141,139
06,Badajoz,143,Valverde de Leganés,4209,2091,2118
06,Badajoz,144,Valverde de Llerena,557,283,274
06,Badajoz,145,Valverde de Mérida,1018,514,504
06,Badajoz,149,Villafranca de los Barros,12366,6093,6273
06,Badajoz,150,Villagarcía de la Torre,883,444,439
06,Badajoz,151,Villagonzalo,1212,592,620
06,Badajoz,152,Villalba de los Barros,1441,717,724
06,Badajoz,153,Villanueva de la Serena,25751,12522,13229
06,Badajoz,154,Villanueva del Fresno,3272,1664,1608
06,Badajoz,156,Villar de Rena,1320,683,637
06,Badajoz,155,Villar del Rey,2101,1132,969
06,Badajoz,157,Villarta de los Montes,403,207,196
06,Badajoz,158,Zafra,16672,7998,8674
06,Badajoz,159,Zahínos,2766,1385,1381
06,Badajoz,160,Zalamea de la Serena,3428,1737,1691
06,Badajoz,162,"Zarza, La",3369,1690,1679
06,Badajoz,161,Zarza-Capilla,297,146,151
07,"Balears, Illes",2,Alaior,9748,4896,4852
07,"Balears, Illes",1,Alaró,5909,2875,3034
07,"Balears, Illes",3,Alcúdia,21322,10793,10529
07,"Balears, Illes",4,Algaida,6170,3122,3048
07,"Balears, Illes",5,Andratx,11833,5936,5897
07,"Balears, Illes",901,Ariany,963,502,461
07,"Balears, Illes",6,Artà,8208,4109,4099
07,"Balears, Illes",7,Banyalbufar,577,309,268
07,"Balears, Illes",8,Binissalem,9172,4537,4635
07,"Balears, Illes",9,Búger,1148,605,543
07,"Balears, Illes",10,Bunyola,7286,3549,3737
07,"Balears, Illes",11,Calvià,53162,26514,26648
07,"Balears, Illes",12,Campanet,2790,1387,1403
07,"Balears, Illes",13,Campos,11763,5888,5875
07,"Balears, Illes",14,Capdepera,12340,6251,6089
07,"Balears, Illes",64,"Castell, Es",7670,3855,3815
07,"Balears, Illes",15,Ciutadella de Menorca,31443,15689,15754
07,"Balears, Illes",16,Consell,4304,2126,2178
07,"Balears, Illes",17,Costitx,1490,733,757
07,"Balears, Illes",18,Deià,675,328,347
07,"Balears, Illes",26,Eivissa,51996,26114,25882
07,"Balears, Illes",19,Escorca,194,118,76
07,"Balears, Illes",20,Esporles,5236,2562,2674
07,"Balears, Illes",21,Estellencs,359,192,167
07,"Balears, Illes",22,Felanitx,18592,9306,9286
07,"Balears, Illes",23,Ferreries,5051,2517,2534
07,"Balears, Illes",24,Formentera,11171,5746,5425
07,"Balears, Illes",25,Fornalutx,717,351,366
07,"Balears, Illes",27,Inca,34577,17389,17188
07,"Balears, Illes",28,Lloret de Vistalegre,1589,801,788
07,"Balears, Illes",29,Lloseta,6378,3181,3197
07,"Balears, Illes",30,Llubí,2438,1211,1227
07,"Balears, Illes",31,Llucmajor,39040,19628,19412
07,"Balears, Illes",33,Manacor,46395,23219,23176
07,"Balears, Illes",34,Mancor de la Vall,1639,824,815
07,"Balears, Illes",32,Maó,29902,14564,15338
07,"Balears, Illes",35,Maria de la Salut,2336,1204,1132
07,"Balears, Illes",36,Marratxí,39440,19798,19642
07,"Balears, Illes",37,"Mercadal, Es",5939,3033,2906
07,"Balears, Illes",902,"Migjorn Gran, Es",1563,779,784
07,"Balears, Illes",38,Montuïri,3144,1586,1558
07,"Balears, Illes",39,Muro,7825,3952,3873
07,"Balears, Illes",40,Palma,423350,206618,216732
07,"Balears, Illes",41,Petra,3118,1530,1588
07,"Balears, Illes",44,"Pobla, Sa",14164,7131,7033
07,"Balears, Illes",42,Pollença,17279,8588,8691
07,"Balears, Illes",43,Porreres,5741,2913,2828
07,"Balears, Illes",45,Puigpunyent,2055,1021,1034
07,"Balears, Illes",59,"Salines, Ses",5044,2496,2548
07,"Balears, Illes",46,Sant Antoni de Portmany,28237,14725,13512
07,"Balears, Illes",49,Sant Joan,2195,1079,1116
07,"Balears, Illes",50,Sant Joan de Labritja,6838,3465,3373
07,"Balears, Illes",48,Sant Josep de sa Talaia,29506,15147,14359
07,"Balears, Illes",51,Sant Llorenç des Cardassar,9227,4608,4619
07,"Balears, Illes",52,Sant Lluís,7019,3551,3468
07,"Balears, Illes",53,Santa Eugènia,1843,920,923
07,"Balears, Illes",54,Santa Eulària des Riu,41228,20837,20391
07,"Balears, Illes",55,Santa Margalida,13160,6782,6378
07,"Balears, Illes",56,Santa María del Camí,7552,3767,3785
07,"Balears, Illes",57,Santanyí,12480,6261,6219
07,"Balears, Illes",58,Selva,4289,2108,2181
07,"Balears, Illes",47,Sencelles,3795,1918,1877
07,"Balears, Illes",60,Sineu,4369,2157,2212
07,"Balears, Illes",61,Sóller,13610,6720,6890
07,"Balears, Illes",62,Son Servera,11932,5896,6036
07,"Balears, Illes",63,Valldemossa,2037,1031,1006
07,"Balears, Illes",65,Vilafranca de Bonany,3699,1868,1831
08,Barcelona,1,Abrera,12848,6462,6386
08,Barcelona,2,Aguilar de Segarra,294,158,136
08,Barcelona,14,Aiguafreda,2567,1242,1325
08,Barcelona,3,Alella,10139,4946,5193
08,Barcelona,4,Alpens,273,149,124
08,Barcelona,5,"Ametlla del Vallès, L'",9296,4666,4630
08,Barcelona,6,Arenys de Mar,16342,7948,8394
08,Barcelona,7,Arenys de Munt,9413,4724,4689
08,Barcelona,8,Argençola,222,116,106
08,Barcelona,9,Argentona,12846,6349,6497
08,Barcelona,10,Artés,5994,3024,2970
08,Barcelona,11,Avià,2249,1120,1129
08,Barcelona,12,Avinyó,2289,1153,1136
08,Barcelona,13,Avinyonet del Penedès,1732,917,815
08,Barcelona,15,Badalona,225957,111330,114627
08,Barcelona,904,Badia del Vallès,13074,6391,6683
08,Barcelona,16,Bagà,2149,1079,1070
08,Barcelona,17,Balenyà,3969,2015,1954
08,Barcelona,18,Balsareny,3307,1668,1639
08,Barcelona,252,Barberà del Vallès,33322,16345,16977
08,Barcelona,19,Barcelona,1660122,789758,870364
08,Barcelona,20,Begues,7432,3690,3742
08,Barcelona,21,Bellprat,72,45,27
08,Barcelona,22,Berga,16959,8350,8609
08,Barcelona,23,Bigues i Riells del Fai,9949,5032,4917
08,Barcelona,24,Borredà,430,243,187
08,Barcelona,25,"Bruc, El",2268,1195,1073
08,Barcelona,26,"Brull, El",287,156,131
08,Barcelona,27,"Cabanyes, Les",998,513,485
08,Barcelona,28,Cabrera d'Anoia,1665,892,773
08,Barcelona,29,Cabrera de Mar,4945,2480,2465
08,Barcelona,30,Cabrils,7799,3858,3941
08,Barcelona,31,Calaf,3566,1797,1769
08,Barcelona,34,Calders,1097,565,532
08,Barcelona,33,Caldes de Montbui,18109,9023,9086
08,Barcelona,32,Caldes d'Estrac,3223,1543,1680
08,Barcelona,35,Calella,19862,9569,10293
08,Barcelona,37,Calldetenes,2601,1323,1278
08,Barcelona,38,Callús,2099,1029,1070
08,Barcelona,36,Calonge de Segarra,188,95,93
08,Barcelona,39,Campins,589,302,287
08,Barcelona,40,Canet de Mar,15010,7300,7710
08,Barcelona,41,Canovelles,17051,8789,8262
08,Barcelona,42,Cànoves i Samalús,3322,1692,1630
08,Barcelona,43,Canyelles,5218,2727,2491
08,Barcelona,44,Capellades,5417,2679,2738
08,Barcelona,45,Capolat,88,42,46
08,Barcelona,46,Cardedeu,19023,9211,9812
08,Barcelona,47,Cardona,4569,2256,2313
08,Barcelona,48,Carme,783,404,379
08,Barcelona,49,Casserres,1630,811,819
08,Barcelona,57,Castell de l'Areny,69,39,30
08,Barcelona,52,Castellar de n'Hug,171,93,78
08,Barcelona,50,Castellar del Riu,169,94,75
08,Barcelona,51,Castellar del Vallès,25150,12432,12718
08,Barcelona,53,Castellbell i el Vilar,4054,2077,1977
08,Barcelona,54,Castellbisbal,12813,6423,6390
08,Barcelona,55,Castellcir,778,409,369
08,Barcelona,56,Castelldefels,68427,33378,35049
08,Barcelona,58,Castellet i la Gornal,2572,1345,1227
08,Barcelona,60,Castellfollit de Riubregós,162,88,74
08,Barcelona,59,Castellfollit del Boix,461,236,225
08,Barcelona,61,Castellgalí,2311,1183,1128
08,Barcelona,62,Castellnou de Bages,1427,746,681
08,Barcelona,63,Castellolí,651,311,340
08,Barcelona,64,Castellterçol,2735,1392,1343
08,Barcelona,65,Castellví de la Marca,1674,856,818
08,Barcelona,66,Castellví de Rosanes,2089,1031,1058
08,Barcelona,67,Centelles,7726,3788,3938
08,Barcelona,268,Cercs,1196,601,595
08,Barcelona,266,Cerdanyola del Vallès,57879,28138,29741
08,Barcelona,68,Cervelló,9469,4788,4681
08,Barcelona,69,Collbató,4828,2490,2338
08,Barcelona,70,Collsuspina,387,193,194
08,Barcelona,71,Copons,340,173,167
08,Barcelona,72,Corbera de Llobregat,15466,7762,7704
08,Barcelona,73,Cornellà de Llobregat,90303,43825,46478
08,Barcelona,74,Cubelles,16914,8501,8413
08,Barcelona,75,Dosrius,5910,2961,2949
08,Barcelona,76,Esparreguera,22442,11357,11085
08,Barcelona,77,Esplugues de Llobregat,46921,22350,24571
08,Barcelona,78,"Espunyola, L'",266,129,137
08,Barcelona,254,"Esquirol, L'",2263,1123,1140
08,Barcelona,79,"Estany, L'",405,223,182
08,Barcelona,134,Figaró-Montmany,1158,558,600
08,Barcelona,80,Fígols,47,26,21
08,Barcelona,82,Fogars de la Selva,1632,845,787
08,Barcelona,81,Fogars de Montclús,482,263,219
08,Barcelona,83,Folgueroles,2268,1149,1119
08,Barcelona,84,Fonollosa,1558,793,765
08,Barcelona,85,Font-rubí,1456,786,670
08,Barcelona,86,"Franqueses del Vallès, Les",20522,10343,10179
08,Barcelona,90,Gaià,177,90,87
08,Barcelona,87,Gallifa,183,97,86
08,Barcelona,88,"Garriga, La",17052,8190,8862
08,Barcelona,89,Gavà,47593,23190,24403
08,Barcelona,91,Gelida,7953,4011,3942
08,Barcelona,92,Gironella,4980,2475,2505
08,Barcelona,93,Gisclareny,27,15,12
08,Barcelona,94,"Granada, La",2218,1102,1116
08,Barcelona,95,Granera,93,57,36
08,Barcelona,96,Granollers,63092,31137,31955
08,Barcelona,97,Gualba,1661,842,819
08,Barcelona,99,Guardiola de Berguedà,939,483,456
08,Barcelona,100,Gurb,2697,1397,1300
08,Barcelona,101,"Hospitalet de Llobregat, L'",274455,133258,141197
08,Barcelona,162,"Hostalets de Pierola, Els",3188,1619,1569
08,Barcelona,102,Igualada,41164,20248,20916
08,Barcelona,103,Jorba,828,427,401
08,Barcelona,104,"Llacuna, La",952,501,451
08,Barcelona,105,"Llagosta, La",13169,6478,6691
08,Barcelona,107,Lliçà d'Amunt,16092,8196,7896
08,Barcelona,108,Lliçà de Vall,6714,3413,3301
08,Barcelona,106,Llinars del Vallès,10499,5171,5328
08,Barcelona,109,Lluçà,292,143,149
08,Barcelona,110,Malgrat de Mar,19213,9457,9756
08,Barcelona,111,Malla,266,135,131
08,Barcelona,112,Manlleu,21172,10601,10571
08,Barcelona,113,Manresa,78877,38646,40231
08,Barcelona,242,Marganell,293,148,145
08,Barcelona,114,Martorell,28760,14616,14144
08,Barcelona,115,Martorelles,4904,2460,2444
08,Barcelona,116,"Masies de Roda, Les",751,389,362
08,Barcelona,117,"Masies de Voltregà, Les",3222,1593,1629
08,Barcelona,118,"Masnou, El",24181,11614,12567
08,Barcelona,119,Masquefa,9839,5016,4823
08,Barcelona,120,Matadepera,9899,4956,4943
08,Barcelona,121,Mataró,129870,64330,65540
08,Barcelona,122,Mediona,2628,1351,1277
08,Barcelona,138,Moià,6690,3438,3252
08,Barcelona,123,Molins de Rei,26555,12947,13608
08,Barcelona,124,Mollet del Vallès,51824,25431,26393
08,Barcelona,128,Monistrol de Calders,751,394,357
08,Barcelona,127,Monistrol de Montserrat,3179,1623,1556
08,Barcelona,125,Montcada i Reixac,36891,18189,18702
08,Barcelona,130,Montclar,129,66,63
08,Barcelona,131,Montesquiu,1110,551,559
08,Barcelona,126,Montgat,12462,6155,6307
08,Barcelona,132,Montmajor,482,247,235
08,Barcelona,133,Montmaneu,198,109,89
08,Barcelona,135,Montmeló,8825,4312,4513
08,Barcelona,136,Montornès del Vallès,16800,8425,8375
08,Barcelona,137,Montseny,379,193,186
08,Barcelona,129,Muntanyola,721,379,342
08,Barcelona,139,Mura,228,118,110
08,Barcelona,140,Navarcles,6109,2976,3133
08,Barcelona,141,Navàs,6150,3017,3133
08,Barcelona,142,"Nou de Berguedà, La",170,86,84
08,Barcelona,143,Òdena,3720,1922,1798
08,Barcelona,145,Olèrdola,3968,2067,1901
08,Barcelona,146,Olesa de Bonesvalls,2110,1091,1019
08,Barcelona,147,Olesa de Montserrat,24446,12182,12264
08,Barcelona,148,Olivella,4414,2288,2126
08,Barcelona,149,Olost,1218,596,622
08,Barcelona,144,Olvan,890,445,445
08,Barcelona,150,Orís,355,185,170
08,Barcelona,151,Oristà,587,305,282
08,Barcelona,152,Orpí,163,86,77
08,Barcelona,153,Òrrius,799,404,395
08,Barcelona,154,Pacs del Penedès,909,456,453
08,Barcelona,155,Palafolls,9819,4924,4895
08,Barcelona,156,Palau-solità i Plegamans,15130,7383,7747
08,Barcelona,157,Pallejà,11736,5833,5903
08,Barcelona,905,"Palma de Cervelló, La",3040,1484,1556
08,Barcelona,158,"Papiol, El",4325,2160,2165
08,Barcelona,159,Parets del Vallès,18893,9455,9438
08,Barcelona,160,Perafita,423,219,204
08,Barcelona,161,Piera,17203,8845,8358
08,Barcelona,163,Pineda de Mar,28751,14229,14522
08,Barcelona,164,"Pla del Penedès, El",1317,670,647
08,Barcelona,165,"Pobla de Claramunt, La",2309,1184,1125
08,Barcelona,166,"Pobla de Lillet, La",1089,522,567
08,Barcelona,167,Polinyà,8482,4269,4213
08,Barcelona,182,"Pont de Vilomara i Rocafort, El",4101,2118,1983
08,Barcelona,168,Pontons,523,285,238
08,Barcelona,169,"Prat de Llobregat, El",65516,32022,33494
08,Barcelona,171,Prats de Lluçanès,2681,1344,1337
08,Barcelona,170,"Prats de Rei, Els",558,299,259
08,Barcelona,230,Premià de Dalt,10532,5241,5291
08,Barcelona,172,Premià de Mar,28767,14018,14749
08,Barcelona,174,Puigdàlber,571,279,292
08,Barcelona,175,Puig-reig,4399,2207,2192
08,Barcelona,176,Pujalt,219,120,99
08,Barcelona,177,"Quar, La",40,26,14
08,Barcelona,178,Rajadell,571,299,272
08,Barcelona,179,Rellinars,923,492,431
08,Barcelona,180,Ripollet,39269,19373,19896
08,Barcelona,181,"Roca del Vallès, La",10913,5476,5437
08,Barcelona,183,Roda de Ter,6680,3378,3302
08,Barcelona,184,Rubí,80044,39546,40498
08,Barcelona,185,Rubió,254,143,111
08,Barcelona,901,Rupit i Pruit,277,135,142
08,Barcelona,187,Sabadell,218300,105946,112354
08,Barcelona,188,Sagàs,151,81,70
08,Barcelona,190,Saldes,303,172,131
08,Barcelona,191,Sallent,6835,3342,3493
08,Barcelona,194,Sant Adrià de Besòs,37925,18646,19279
08,Barcelona,195,Sant Agustí de Lluçanès,109,57,52
08,Barcelona,196,Sant Andreu de la Barca,26910,13208,13702
08,Barcelona,197,Sant Andreu de Llavaneres,11831,5781,6050
08,Barcelona,198,Sant Antoni de Vilamajor,6577,3269,3308
08,Barcelona,199,Sant Bartomeu del Grau,945,499,446
08,Barcelona,200,Sant Boi de Llobregat,83919,40828,43091
08,Barcelona,201,Sant Boi de Lluçanès,572,296,276
08,Barcelona,203,Sant Cebrià de Vallalta,3792,1966,1826
08,Barcelona,202,Sant Celoni,18479,9202,9277
08,Barcelona,204,Sant Climent de Llobregat,4190,2095,2095
08,Barcelona,205,Sant Cugat del Vallès,97530,47492,50038
08,Barcelona,206,Sant Cugat Sesgarrigues,1026,502,524
08,Barcelona,207,Sant Esteve de Palautordera,3045,1507,1538
08,Barcelona,208,Sant Esteve Sesrovires,7906,3936,3970
08,Barcelona,210,Sant Feliu de Codines,6527,3298,3229
08,Barcelona,211,Sant Feliu de Llobregat,46056,22369,23687
08,Barcelona,212,Sant Feliu Sasserra,620,326,294
08,Barcelona,209,Sant Fost de Campsentelles,9197,4561,4636
08,Barcelona,213,Sant Fruitós de Bages,9156,4531,4625
08,Barcelona,215,Sant Hipòlit de Voltregà,3711,1865,1846
08,Barcelona,193,Sant Iscle de Vallalta,1441,752,689
08,Barcelona,216,Sant Jaume de Frontanyà,29,15,14
08,Barcelona,218,Sant Joan de Vilatorrada,10959,5440,5519
08,Barcelona,217,Sant Joan Despí,34568,16725,17843
08,Barcelona,903,Sant Julià de Cerdanyola,242,135,107
08,Barcelona,220,Sant Julià de Vilatorta,3230,1604,1626
08,Barcelona,221,Sant Just Desvern,20462,9858,10604
08,Barcelona,222,Sant Llorenç d'Hortons,2572,1299,1273
08,Barcelona,223,Sant Llorenç Savall,2545,1271,1274
08,Barcelona,225,Sant Martí d'Albars,121,60,61
08,Barcelona,224,Sant Martí de Centelles,1247,629,618
08,Barcelona,226,Sant Martí de Tous,1268,638,630
08,Barcelona,227,Sant Martí Sarroca,3380,1692,1688
08,Barcelona,228,Sant Martí Sesgueioles,359,186,173
08,Barcelona,229,Sant Mateu de Bages,633,326,307
08,Barcelona,231,Sant Pere de Ribes,31786,15702,16084
08,Barcelona,232,Sant Pere de Riudebitlles,2462,1244,1218
08,Barcelona,233,Sant Pere de Torelló,2568,1320,1248
08,Barcelona,234,Sant Pere de Vilamajor,4862,2460,2402
08,Barcelona,189,Sant Pere Sallavinera,162,84,78
08,Barcelona,235,Sant Pol de Mar,5791,2829,2962
08,Barcelona,236,Sant Quintí de Mediona,2407,1229,1178
08,Barcelona,237,Sant Quirze de Besora,2115,1026,1089
08,Barcelona,238,Sant Quirze del Vallès,20241,9900,10341
08,Barcelona,239,Sant Quirze Safaja,677,363,314
08,Barcelona,240,Sant Sadurní d'Anoia,12945,6373,6572
08,Barcelona,241,Sant Sadurní d'Osormort,89,53,36
08,Barcelona,98,Sant Salvador de Guardiola,3430,1753,1677
08,Barcelona,262,Sant Vicenç de Castellet,10068,5067,5001
08,Barcelona,264,Sant Vicenç de Montalt,6701,3333,3368
08,Barcelona,265,Sant Vicenç de Torelló,2083,1047,1036
08,Barcelona,263,Sant Vicenç dels Horts,28406,14094,14312
08,Barcelona,243,Santa Cecília de Voltregà,184,102,82
08,Barcelona,244,Santa Coloma de Cervelló,8393,4077,4316
08,Barcelona,245,Santa Coloma de Gramenet,119862,59151,60711
08,Barcelona,246,Santa Eugènia de Berga,2303,1179,1124
08,Barcelona,247,Santa Eulàlia de Riuprimer,1450,728,722
08,Barcelona,248,Santa Eulàlia de Ronçana,7846,3928,3918
08,Barcelona,249,Santa Fe del Penedès,362,179,183
08,Barcelona,250,Santa Margarida de Montbui,10456,5247,5209
08,Barcelona,251,Santa Margarida i els Monjos,7650,3887,3763
08,Barcelona,253,Santa Maria de Besora,165,89,76
08,Barcelona,256,Santa Maria de Martorelles,881,446,435
08,Barcelona,255,Santa Maria de Merlès,174,89,85
08,Barcelona,257,Santa Maria de Miralles,138,74,64
08,Barcelona,259,Santa Maria de Palautordera,9872,4965,4907
08,Barcelona,258,Santa Maria d'Oló,1086,543,543
08,Barcelona,260,Santa Perpètua de Mogoda,25928,12977,12951
08,Barcelona,261,Santa Susanna,3887,1946,1941
08,Barcelona,192,Santpedor,7693,3830,3863
08,Barcelona,267,Sentmenat,9474,4791,4683
08,Barcelona,269,Seva,3770,1949,1821
08,Barcelona,270,Sitges,31954,16010,15944
08,Barcelona,271,Sobremunt,86,34,52
08,Barcelona,272,Sora,217,116,101
08,Barcelona,273,Subirats,3243,1674,1569
08,Barcelona,274,Súria,6046,2930,3116
08,Barcelona,276,Tagamanent,344,179,165
08,Barcelona,277,Talamanca,223,122,101
08,Barcelona,278,Taradell,6809,3423,3386
08,Barcelona,275,Tavèrnoles,340,173,167
08,Barcelona,280,Tavertet,126,68,58
08,Barcelona,281,Teià,6696,3285,3411
08,Barcelona,279,Terrassa,225277,110614,114663
08,Barcelona,282,Tiana,9198,4442,4756
08,Barcelona,283,Tona,8455,4162,4293
08,Barcelona,284,Tordera,18409,9338,9071
08,Barcelona,285,Torelló,14902,7447,7455
08,Barcelona,286,"Torre de Claramunt, La",4018,2096,1922
08,Barcelona,287,Torrelavit,1499,777,722
08,Barcelona,288,Torrelles de Foix,2608,1374,1234
08,Barcelona,289,Torrelles de Llobregat,6225,3080,3145
08,Barcelona,290,Ullastrell,2162,1077,1085
08,Barcelona,291,Vacarisses,7460,3851,3609
08,Barcelona,292,Vallbona d'Anoia,1428,732,696
08,Barcelona,293,Vallcebre,273,144,129
08,Barcelona,294,Vallgorguina,3204,1630,1574
08,Barcelona,295,Vallirana,15823,7897,7926
08,Barcelona,296,Vallromanes,2705,1389,1316
08,Barcelona,297,Veciana,179,101,78
08,Barcelona,298,Vic,48364,24478,23886
08,Barcelona,299,Vilada,434,233,201
08,Barcelona,301,Viladecans,66677,32866,33811
08,Barcelona,300,Viladecavalls,7809,3866,3943
08,Barcelona,305,Vilafranca del Penedès,40714,19816,20898
08,Barcelona,306,Vilalba Sasserra,753,384,369
08,Barcelona,303,Vilanova de Sau,310,147,163
08,Barcelona,302,Vilanova del Camí,12758,6399,6359
08,Barcelona,902,Vilanova del Vallès,5600,2839,2761
08,Barcelona,307,Vilanova i la Geltrú,68854,33250,35604
08,Barcelona,214,Vilassar de Dalt,9230,4552,4678
08,Barcelona,219,Vilassar de Mar,21055,10087,10968
08,Barcelona,304,Vilobí del Penedès,1141,584,557
08,Barcelona,308,Viver i Serrateix,173,89,84
48,Bizkaia,1,Abadiño,7708,3864,3844
48,Bizkaia,2,Abanto y Ciérvana-Abanto Zierbena,9402,4674,4728
48,Bizkaia,911,Ajangiz,478,250,228
48,Bizkaia,912,Alonsotegi,2950,1461,1489
48,Bizkaia,3,Amorebieta-Etxano,19570,9577,9993
48,Bizkaia,4,Amoroto,392,206,186
48,Bizkaia,5,Arakaldo,164,75,89
48,Bizkaia,6,Arantzazu,389,198,191
48,Bizkaia,93,Areatza,1247,605,642
48,Bizkaia,9,Arrankudiaga-Zollo,991,494,497
48,Bizkaia,914,Arratzu,426,199,227
48,Bizkaia,10,Arrieta,581,300,281
48,Bizkaia,11,Arrigorriaga,11954,5869,6085
48,Bizkaia,23,Artea,754,383,371
48,Bizkaia,8,Artzentales,726,381,345
48,Bizkaia,91,Atxondo,1367,688,679
48,Bizkaia,70,Aulesti,655,325,330
48,Bizkaia,12,Bakio,2811,1397,1414
48,Bizkaia,90,Balmaseda,7593,3658,3935
48,Bizkaia,13,Barakaldo,101229,49025,52204
48,Bizkaia,14,Barrika,1533,765,768
48,Bizkaia,15,Basauri,40413,19559,20854
48,Bizkaia,92,Bedia,1114,543,571
48,Bizkaia,16,Berango,7454,3640,3814
48,Bizkaia,17,Bermeo,16878,8291,8587
48,Bizkaia,18,Berriatua,1216,661,555
48,Bizkaia,19,Berriz,4543,2250,2293
48,Bizkaia,20,Bilbao,346096,163991,182105
48,Bizkaia,21,Busturia,1644,825,819
48,Bizkaia,901,Derio,7071,3460,3611
48,Bizkaia,26,Dima,1496,768,728
48,Bizkaia,27,Durango,29767,14516,15251
48,Bizkaia,28,Ea,822,430,392
48,Bizkaia,31,Elantxobe,348,167,181
48,Bizkaia,32,Elorrio,7292,3582,3710
48,Bizkaia,902,Erandio,24411,11784,12627
48,Bizkaia,33,Ereño,277,150,127
48,Bizkaia,34,Ermua,15599,7726,7873
48,Bizkaia,79,Errigoiti,509,274,235
48,Bizkaia,29,Etxebarri,11975,5969,6006
48,Bizkaia,30,Etxebarria,782,396,386
48,Bizkaia,906,Forua,916,444,472
48,Bizkaia,35,Fruiz,551,273,278
48,Bizkaia,36,Galdakao,29332,14414,14918
48,Bizkaia,37,Galdames,834,445,389
48,Bizkaia,38,Gamiz-Fika,1395,703,692
48,Bizkaia,39,Garai,334,163,171
48,Bizkaia,40,Gatika,1623,811,812
48,Bizkaia,41,Gautegiz Arteaga,889,443,446
48,Bizkaia,46,Gernika-Lumo,17050,8203,8847
48,Bizkaia,44,Getxo,76104,35602,40502
48,Bizkaia,47,Gizaburuaga,197,104,93
48,Bizkaia,42,Gordexola,1678,866,812
48,Bizkaia,43,Gorliz,6058,2980,3078
48,Bizkaia,45,Güeñes,6740,3240,3500
48,Bizkaia,48,Ibarrangelu,695,358,337
48,Bizkaia,94,Igorre,4296,2115,2181
48,Bizkaia,49,Ispaster,731,379,352
48,Bizkaia,910,Iurreta,3738,1854,1884
48,Bizkaia,50,Izurtza,227,147,80
48,Bizkaia,22,Karrantza Harana/Valle de Carranza,2713,1408,1305
48,Bizkaia,907,Kortezubi,440,214,226
48,Bizkaia,51,Lanestosa,246,135,111
48,Bizkaia,52,Larrabetzu,2056,1004,1052
48,Bizkaia,53,Laukiz,1225,600,625
48,Bizkaia,54,Leioa,32491,15857,16634
48,Bizkaia,57,Lekeitio,7143,3522,3621
48,Bizkaia,55,Lemoa,3547,1781,1766
48,Bizkaia,56,Lemoiz,1318,691,627
48,Bizkaia,81,Lezama,2448,1220,1228
48,Bizkaia,903,Loiu,2297,1105,1192
48,Bizkaia,58,Mallabia,1160,591,569
48,Bizkaia,59,Mañaria,533,273,260
48,Bizkaia,60,Markina-Xemein,5037,2529,2508
48,Bizkaia,61,Maruri-Jatabe,1069,556,513
48,Bizkaia,62,Mendata,385,200,185
48,Bizkaia,63,Mendexa,425,221,204
48,Bizkaia,64,Meñaka,763,400,363
48,Bizkaia,66,Morga,414,219,195
48,Bizkaia,68,Mundaka,1843,918,925
48,Bizkaia,69,Mungia,17882,8689,9193
48,Bizkaia,7,Munitibar-Arbatzegi Gerrikaitz,470,255,215
48,Bizkaia,908,Murueta,337,176,161
48,Bizkaia,71,Muskiz,7342,3567,3775
48,Bizkaia,67,Muxika,1517,796,721
48,Bizkaia,909,Nabarniz,269,135,134
48,Bizkaia,73,Ondarroa,8179,4069,4110
48,Bizkaia,75,Orozko,2654,1318,1336
48,Bizkaia,83,Ortuella,8536,4164,4372
48,Bizkaia,72,Otxandio,1323,677,646
48,Bizkaia,77,Plentzia,4361,2123,2238
48,Bizkaia,78,Portugalete,44629,21309,23320
48,Bizkaia,82,Santurtzi,46057,22074,23983
48,Bizkaia,84,Sestao,27834,13413,14421
48,Bizkaia,904,Sondika,4523,2177,2346
48,Bizkaia,85,Sopela,14872,7374,7498
48,Bizkaia,86,Sopuerta,2731,1369,1362
48,Bizkaia,76,Sukarrieta,355,185,170
48,Bizkaia,87,Trucios-Turtzioz,521,273,248
48,Bizkaia,88,Ubide,173,86,87
48,Bizkaia,65,Ugao-Miraballes,4164,2089,2075
48,Bizkaia,89,Urduliz,5469,2690,2779
48,Bizkaia,74,Urduña/Orduña,4179,2150,2029
48,Bizkaia,80,Valle de Trápaga-Trapagaran,11911,5804,6107
48,Bizkaia,95,Zaldibar,3005,1533,1472
48,Bizkaia,96,Zalla,8319,4063,4256
48,Bizkaia,905,Zamudio,3294,1639,1655
48,Bizkaia,97,Zaratamo,1610,808,802
48,Bizkaia,24,Zeanuri,1247,627,620
48,Bizkaia,25,Zeberio,1081,547,534
48,Bizkaia,913,Zierbena,1496,786,710
48,Bizkaia,915,Ziortza-Bolibar,398,208,190
09,Burgos,1,Abajas,28,18,10
09,Burgos,3,Adrada de Haza,202,98,104
09,Burgos,6,Aguas Cándidas,60,40,20
09,Burgos,7,Aguilar de Bureba,54,34,20
09,Burgos,9,Albillos,221,120,101
09,Burgos,10,Alcocero de Mola,41,29,12
09,Burgos,11,Alfoz de Bricia,71,47,24
09,Burgos,907,Alfoz de Quintanadueñas,2180,1148,1032
09,Burgos,12,Alfoz de Santa Gadea,99,52,47
09,Burgos,13,Altable,46,27,19
09,Burgos,14,"Altos, Los",201,125,76
09,Burgos,16,Ameyugo,114,57,57
09,Burgos,17,Anguix,157,102,55
09,Burgos,18,Aranda de Duero,33626,16349,17277
09,Burgos,19,Arandilla,156,102,54
09,Burgos,20,Arauzo de Miel,276,152,124
09,Burgos,21,Arauzo de Salce,48,24,24
09,Burgos,22,Arauzo de Torre,64,39,25
09,Burgos,23,Arcos,1826,956,870
09,Burgos,24,Arenillas de Riopisuerga,174,105,69
09,Burgos,25,Arija,110,58,52
09,Burgos,26,Arlanzón,431,260,171
09,Burgos,27,Arraya de Oca,44,26,18
09,Burgos,29,Atapuerca,180,106,74
09,Burgos,30,"Ausines, Los",162,98,64
09,Burgos,32,Avellanosa de Muñó,101,55,46
09,Burgos,33,Bahabón de Esgueva,78,42,36
09,Burgos,34,"Balbases, Los",302,166,136
09,Burgos,35,Baños de Valdearados,318,183,135
09,Burgos,36,Bañuelos de Bureba,34,20,14
09,Burgos,37,Barbadillo de Herreros,106,65,41
09,Burgos,38,Barbadillo del Mercado,141,76,65
09,Burgos,39,Barbadillo del Pez,69,39,30
09,Burgos,41,Barrio de Muñó,31,18,13
09,Burgos,43,"Barrios de Bureba, Los",186,99,87
09,Burgos,44,Barrios de Colina,57,31,26
09,Burgos,45,Basconcillos del Tozo,298,174,124
09,Burgos,46,Bascuñana,20,14,6
09,Burgos,47,Belbimbre,56,28,28
09,Burgos,48,Belorado,1798,909,889
09,Burgos,50,Berberana,50,29,21
09,Burgos,51,Berlangas de Roa,191,108,83
09,Burgos,52,Berzosa de Bureba,26,19,7
09,Burgos,54,Bozoó,101,60,41
09,Burgos,55,Brazacorta,47,31,16
09,Burgos,56,Briviesca,6414,3217,3197
09,Burgos,57,Bugedo,194,117,77
09,Burgos,58,Buniel,626,346,280
09,Burgos,59,Burgos,174451,82934,91517
09,Burgos,60,Busto de Bureba,140,78,62
09,Burgos,61,Cabañes de Esgueva,158,87,71
09,Burgos,62,Cabezón de la Sierra,39,16,23
09,Burgos,64,Caleruega,393,200,193
09,Burgos,65,Campillo de Aranda,174,96,78
09,Burgos,66,Campolara,50,35,15
09,Burgos,67,Canicosa de la Sierra,422,230,192
09,Burgos,68,Cantabrana,22,13,9
09,Burgos,70,Carazo,41,26,15
09,Burgos,71,Carcedo de Bureba,50,27,23
09,Burgos,72,Carcedo de Burgos,488,261,227
09,Burgos,73,Cardeñadijo,1452,786,666
09,Burgos,74,Cardeñajimeno,1195,632,563
09,Burgos,75,Cardeñuela Riopico,109,64,45
09,Burgos,76,Carrias,24,18,6
09,Burgos,77,Cascajares de Bureba,28,14,14
09,Burgos,78,Cascajares de la Sierra,28,15,13
09,Burgos,79,Castellanos de Castro,50,30,20
09,Burgos,83,Castil de Peones,26,13,13
09,Burgos,82,Castildelgado,35,20,15
09,Burgos,84,Castrillo de la Reina,165,107,58
09,Burgos,85,Castrillo de la Vega,613,330,283
09,Burgos,88,Castrillo de Riopisuerga,57,36,21
09,Burgos,86,Castrillo del Val,835,462,373
09,Burgos,90,Castrillo Mota de Judíos,51,26,25
09,Burgos,91,Castrojeriz,763,399,364
09,Burgos,63,Cavia,245,142,103
09,Burgos,93,Cayuela,183,104,79
09,Burgos,94,Cebrecos,56,34,22
09,Burgos,95,Celada del Camino,91,45,46
09,Burgos,98,Cerezo de Río Tirón,494,274,220
09,Burgos,100,Cerratón de Juarros,50,34,16
09,Burgos,101,Ciadoncha,75,47,28
09,Burgos,102,Cillaperlata,34,22,12
09,Burgos,103,Cilleruelo de Abajo,203,124,79
09,Burgos,104,Cilleruelo de Arriba,48,27,21
09,Burgos,105,Ciruelos de Cervera,107,61,46
09,Burgos,108,Cogollos,616,346,270
09,Burgos,109,Condado de Treviño,1479,810,669
09,Burgos,110,Contreras,91,55,36
09,Burgos,112,Coruña del Conde,100,62,38
09,Burgos,113,Covarrubias,529,288,241
09,Burgos,114,Cubillo del Campo,103,56,47
09,Burgos,115,Cubo de Bureba,101,58,43
09,Burgos,117,"Cueva de Roa, La",95,50,45
09,Burgos,119,Cuevas de San Clemente,44,19,25
09,Burgos,120,Encío,43,23,20
09,Burgos,122,Espinosa de Cervera,82,51,31
09,Burgos,124,Espinosa de los Monteros,1633,838,795
09,Burgos,123,Espinosa del Camino,44,26,18
09,Burgos,125,Estépar,636,366,270
09,Burgos,127,Fontioso,56,32,24
09,Burgos,128,Frandovínez,98,54,44
09,Burgos,129,Fresneda de la Sierra Tirón,101,65,36
09,Burgos,130,Fresneña,68,44,24
09,Burgos,131,Fresnillo de las Dueñas,688,358,330
09,Burgos,132,Fresno de Río Tirón,167,101,66
09,Burgos,133,Fresno de Rodilla,47,27,20
09,Burgos,134,Frías,267,140,127
09,Burgos,135,Fuentebureba,43,26,17
09,Burgos,136,Fuentecén,232,132,100
09,Burgos,137,Fuentelcésped,266,137,129
09,Burgos,138,Fuentelisendo,104,56,48
09,Burgos,139,Fuentemolinos,99,67,32
09,Burgos,140,Fuentenebro,135,80,55
09,Burgos,141,Fuentespina,809,425,384
09,Burgos,143,Galbarros,29,18,11
09,Burgos,144,"Gallega, La",42,29,13
09,Burgos,148,Grijalba,107,54,53
09,Burgos,149,Grisaleña,59,42,17
09,Burgos,151,Gumiel de Izán,594,324,270
09,Burgos,152,Gumiel de Mercado,385,214,171
09,Burgos,154,Hacinas,150,92,58
09,Burgos,155,Haza,29,20,9
09,Burgos,159,Hontanas,68,40,28
09,Burgos,160,Hontangas,93,60,33
09,Burgos,162,Hontoria de la Cantera,168,93,75
09,Burgos,164,Hontoria de Valdearados,164,100,64
09,Burgos,163,Hontoria del Pinar,617,331,286
09,Burgos,166,"Hormazas, Las",99,53,46
09,Burgos,167,Hornillos del Camino,54,29,25
09,Burgos,168,"Horra, La",306,170,136
09,Burgos,169,Hortigüela,107,71,36
09,Burgos,170,Hoyales de Roa,208,111,97
09,Burgos,172,Huérmeces,157,85,72
09,Burgos,173,Huerta de Arriba,125,69,56
09,Burgos,174,Huerta de Rey,880,481,399
09,Burgos,175,Humada,115,79,36
09,Burgos,176,Hurones,54,35,19
09,Burgos,177,Ibeas de Juarros,1411,748,663
09,Burgos,178,Ibrillos,33,25,8
09,Burgos,179,Iglesiarrubia,47,24,23
09,Burgos,180,Iglesias,144,76,68
09,Burgos,181,Isar,282,150,132
09,Burgos,182,Itero del Castillo,78,47,31
09,Burgos,183,Jaramillo de la Fuente,42,28,14
09,Burgos,184,Jaramillo Quemado,10,8,2
09,Burgos,189,Junta de Traslaloma,124,71,53
09,Burgos,190,Junta de Villalba de Losa,80,43,37
09,Burgos,191,Jurisdicción de Lara,43,26,17
09,Burgos,192,Jurisdicción de San Zadornil,68,40,28
09,Burgos,194,Lerma,2585,1293,1292
09,Burgos,195,Llano de Bureba,48,35,13
09,Burgos,196,Madrigal del Monte,148,89,59
09,Burgos,197,Madrigalejo del Monte,188,111,77
09,Burgos,198,Mahamud,101,57,44
09,Burgos,199,Mambrilla de Castrejón,112,69,43
09,Burgos,200,Mambrillas de Lara,55,32,23
09,Burgos,201,Mamolar,29,15,14
09,Burgos,202,Manciles,23,14,9
09,Burgos,206,Mazuela,55,32,23
09,Burgos,208,Mecerreyes,192,105,87
09,Burgos,209,Medina de Pomar,5866,2986,2880
09,Burgos,211,Melgar de Fernamental,1525,849,676
09,Burgos,213,Merindad de Cuesta-Urria,274,162,112
09,Burgos,214,Merindad de Montija,739,445,294
09,Burgos,906,Merindad de Río Ubierna,1430,802,628
09,Burgos,215,Merindad de Sotoscueva,427,247,180
09,Burgos,216,Merindad de Valdeporres,418,213,205
09,Burgos,217,Merindad de Valdivielso,403,224,179
09,Burgos,218,Milagros,417,218,199
09,Burgos,219,Miranda de Ebro,35639,17586,18053
09,Burgos,220,Miraveche,94,60,34
09,Burgos,221,Modúbar de la Emparedada,777,426,351
09,Burgos,223,Monasterio de la Sierra,39,26,13
09,Burgos,224,Monasterio de Rodilla,158,86,72
09,Burgos,225,Moncalvillo,85,50,35
09,Burgos,226,Monterrubio de la Demanda,58,34,24
09,Burgos,227,Montorio,150,85,65
09,Burgos,228,Moradillo de Roa,166,90,76
09,Burgos,229,Nava de Roa,206,110,96
09,Burgos,230,Navas de Bureba,26,12,14
09,Burgos,231,Nebreda,52,34,18
09,Burgos,232,Neila,124,69,55
09,Burgos,235,Olmedillo de Roa,186,107,79
09,Burgos,236,Olmillos de Muñó,35,20,15
09,Burgos,238,Oña,967,502,465
09,Burgos,239,Oquillas,47,25,22
09,Burgos,241,Orbaneja Riopico,358,200,158
09,Burgos,242,Padilla de Abajo,66,41,25
09,Burgos,243,Padilla de Arriba,89,57,32
09,Burgos,244,Padrones de Bureba,69,33,36
09,Burgos,246,Palacios de la Sierra,695,357,338
09,Burgos,247,Palacios de Riopisuerga,19,9,10
09,Burgos,248,Palazuelos de la Sierra,95,56,39
09,Burgos,249,Palazuelos de Muñó,55,30,25
09,Burgos,250,Pampliega,288,158,130
09,Burgos,251,Pancorbo,433,228,205
09,Burgos,253,Pardilla,106,65,41
09,Burgos,255,Partido de la Sierra en Tobalina,88,55,33
09,Burgos,256,Pedrosa de Duero,478,285,193
09,Burgos,259,Pedrosa de Río Úrbel,259,154,105
09,Burgos,257,Pedrosa del Páramo,90,54,36
09,Burgos,258,Pedrosa del Príncipe,169,95,74
09,Burgos,261,Peñaranda de Duero,470,243,227
09,Burgos,262,Peral de Arlanza,172,95,77
09,Burgos,265,Piérnigas,37,22,15
09,Burgos,266,Pineda de la Sierra,95,63,32
09,Burgos,267,Pineda Trasmonte,106,65,41
09,Burgos,268,Pinilla de los Barruecos,100,60,40
09,Burgos,269,Pinilla de los Moros,35,20,15
09,Burgos,270,Pinilla Trasmonte,166,94,72
09,Burgos,272,Poza de la Sal,286,158,128
09,Burgos,273,Prádanos de Bureba,59,36,23
09,Burgos,274,Pradoluengo,1076,552,524
09,Burgos,275,Presencio,198,115,83
09,Burgos,276,"Puebla de Arganzón, La",552,287,265
09,Burgos,277,Puentedura,117,75,42
09,Burgos,279,Quemada,249,148,101
09,Burgos,281,Quintana del Pidio,150,79,71
09,Burgos,280,Quintanabureba,32,18,14
09,Burgos,283,Quintanaélez,49,26,23
09,Burgos,287,Quintanaortuño,284,153,131
09,Burgos,288,Quintanapalla,106,53,53
09,Burgos,289,Quintanar de la Sierra,1534,801,733
09,Burgos,292,Quintanavides,69,39,30
09,Burgos,294,Quintanilla de la Mata,112,71,41
09,Burgos,901,Quintanilla del Agua y Tordueles,346,189,157
09,Burgos,295,Quintanilla del Coco,51,26,25
09,Burgos,298,Quintanilla San García,70,40,30
09,Burgos,301,Quintanilla Vivar,898,477,421
09,Burgos,297,"Quintanillas, Las",384,226,158
09,Burgos,302,Rabanera del Pinar,101,63,38
09,Burgos,303,Rábanos,83,52,31
09,Burgos,304,Rabé de las Calzadas,254,125,129
09,Burgos,306,Rebolledo de la Torre,96,57,39
09,Burgos,307,Redecilla del Camino,104,63,41
09,Burgos,308,Redecilla del Campo,68,41,27
09,Burgos,309,Regumiel de la Sierra,317,181,136
09,Burgos,310,Reinoso,16,12,4
09,Burgos,311,Retuerta,62,37,25
09,Burgos,314,Revilla del Campo,102,63,39
09,Burgos,316,Revilla Vallejera,119,69,50
09,Burgos,312,"Revilla y Ahedo, La",95,56,39
09,Burgos,315,Revillarruz,611,325,286
09,Burgos,317,Rezmondo,19,7,12
09,Burgos,318,Riocavado de la Sierra,54,35,19
09,Burgos,321,Roa,2220,1145,1075
09,Burgos,323,Rojas,59,37,22
09,Burgos,325,Royuela de Río Franco,175,104,71
09,Burgos,326,Rubena,202,114,88
09,Burgos,327,Rublacedo de Abajo,32,15,17
09,Burgos,328,Rucandio,69,33,36
09,Burgos,329,Salas de Bureba,135,79,56
09,Burgos,330,Salas de los Infantes,1970,1018,952
09,Burgos,332,Saldaña de Burgos,203,118,85
09,Burgos,334,Salinillas de Bureba,48,34,14
09,Burgos,335,San Adrián de Juarros,93,60,33
09,Burgos,337,San Juan del Monte,142,76,66
09,Burgos,338,San Mamés de Burgos,327,190,137
09,Burgos,339,San Martín de Rubiales,143,87,56
09,Burgos,340,San Millán de Lara,63,46,17
09,Burgos,360,San Vicente del Valle,29,19,10
09,Burgos,343,Santa Cecilia,105,63,42
09,Burgos,345,Santa Cruz de la Salceda,136,77,59
09,Burgos,346,Santa Cruz del Valle Urbión,101,66,35
09,Burgos,347,Santa Gadea del Cid,161,87,74
09,Burgos,348,Santa Inés,155,87,68
09,Burgos,350,Santa María del Campo,509,279,230
09,Burgos,351,Santa María del Invierno,64,47,17
09,Burgos,352,Santa María del Mercadillo,101,69,32
09,Burgos,353,Santa María Rivarredonda,91,55,36
09,Burgos,354,Santa Olalla de Bureba,41,27,14
09,Burgos,355,Santibáñez de Esgueva,79,44,35
09,Burgos,356,Santibáñez del Val,72,41,31
09,Burgos,358,Santo Domingo de Silos,261,165,96
09,Burgos,361,Sargentes de la Lora,128,72,56
09,Burgos,362,Sarracín,260,137,123
09,Burgos,363,Sasamón,934,530,404
09,Burgos,365,"Sequera de Haza, La",27,20,7
09,Burgos,366,Solarana,74,45,29
09,Burgos,368,Sordillos,21,12,9
09,Burgos,369,Sotillo de la Ribera,479,249,230
09,Burgos,372,Sotragero,296,167,129
09,Burgos,373,Sotresgudo,428,253,175
09,Burgos,374,Susinos del Páramo,117,72,45
09,Burgos,375,Tamarón,59,31,28
09,Burgos,377,Tardajos,799,427,372
09,Burgos,378,Tejada,34,19,15
09,Burgos,380,Terradillos de Esgueva,67,34,33
09,Burgos,381,Tinieblas de la Sierra,26,14,12
09,Burgos,382,Tobar,25,18,7
09,Burgos,384,Tordómar,311,169,142
09,Burgos,386,Torrecilla del Monte,82,46,36
09,Burgos,387,Torregalindo,117,70,47
09,Burgos,388,Torrelara,32,21,11
09,Burgos,389,Torrepadre,69,40,29
09,Burgos,390,Torresandino,576,299,277
09,Burgos,391,Tórtoles de Esgueva,406,222,184
09,Burgos,392,Tosantos,53,28,25
09,Burgos,394,Trespaderne,733,363,370
09,Burgos,395,Tubilla del Agua,140,85,55
09,Burgos,396,Tubilla del Lago,167,88,79
09,Burgos,398,Úrbel del Castillo,62,44,18
09,Burgos,400,Vadocondes,371,200,171
09,Burgos,403,Valdeande,99,60,39
09,Burgos,405,Valdezate,118,68,50
09,Burgos,406,Valdorros,345,199,146
09,Burgos,408,Vallarta de Bureba,42,27,15
09,Burgos,904,Valle de las Navas,544,317,227
09,Burgos,908,Valle de Losa,501,283,218
09,Burgos,409,Valle de Manzanedo,124,62,62
09,Burgos,410,Valle de Mena,4096,2067,2029
09,Burgos,411,Valle de Oca,164,95,69
09,Burgos,902,Valle de Santibáñez,487,286,201
09,Burgos,905,Valle de Sedano,428,241,187
09,Burgos,412,Valle de Tobalina,879,479,400
09,Burgos,413,Valle de Valdebezana,469,255,214
09,Burgos,414,Valle de Valdelaguna,196,120,76
09,Burgos,415,Valle de Valdelucio,326,183,143
09,Burgos,416,Valle de Zamanzas,49,32,17
09,Burgos,417,Vallejera,41,24,17
09,Burgos,418,Valles de Palenzuela,79,41,38
09,Burgos,419,Valluércanes,68,46,22
09,Burgos,407,Valmala,28,14,14
09,Burgos,422,"Vid de Bureba, La",24,13,11
09,Burgos,421,"Vid y Barrios, La",262,152,110
09,Burgos,423,Vileña,26,16,10
09,Burgos,427,Villadiego,1468,805,663
09,Burgos,428,Villaescusa de Roa,99,50,49
09,Burgos,429,Villaescusa la Sombría,54,37,17
09,Burgos,430,Villaespasa,26,16,10
09,Burgos,431,Villafranca Montes de Oca,117,71,46
09,Burgos,432,Villafruela,146,87,59
09,Burgos,433,Villagalijo,56,33,23
09,Burgos,434,Villagonzalo Pedernales,1862,980,882
09,Burgos,437,Villahoz,310,167,143
09,Burgos,438,Villalba de Duero,698,369,329
09,Burgos,439,Villalbilla de Burgos,1495,795,700
09,Burgos,440,Villalbilla de Gumiel,89,57,32
09,Burgos,441,Villaldemiro,90,53,37
09,Burgos,442,Villalmanzo,424,224,200
09,Burgos,443,Villamayor de los Montes,163,81,82
09,Burgos,444,Villamayor de Treviño,59,31,28
09,Burgos,445,Villambistia,45,35,10
09,Burgos,446,Villamedianilla,9,6,3
09,Burgos,447,Villamiel de la Sierra,42,25,17
09,Burgos,448,Villangómez,225,138,87
09,Burgos,449,Villanueva de Argaño,121,70,51
09,Burgos,450,Villanueva de Carazo,27,17,10
09,Burgos,451,Villanueva de Gumiel,284,144,140
09,Burgos,454,Villanueva de Teba,43,28,15
09,Burgos,455,Villaquirán de la Puebla,44,27,17
09,Burgos,456,Villaquirán de los Infantes,148,79,69
09,Burgos,903,Villarcayo de Merindad de Castilla la Vieja,4018,2047,1971
09,Burgos,458,Villariezo,719,393,326
09,Burgos,460,Villasandino,177,99,78
09,Burgos,463,Villasur de Herreros,274,161,113
09,Burgos,464,Villatuelda,53,29,24
09,Burgos,466,Villaverde del Monte,114,67,47
09,Burgos,467,Villaverde-Mogina,74,51,23
09,Burgos,471,Villayerno Morquillas,213,112,101
09,Burgos,472,Villazopeque,52,30,22
09,Burgos,473,Villegas,84,44,40
09,Burgos,476,Villoruebo,69,46,23
09,Burgos,424,Viloria de Rioja,37,23,14
09,Burgos,425,Vilviestre del Pinar,508,284,224
09,Burgos,478,Vizcaínos,47,36,11
09,Burgos,480,Zael,116,58,58
09,Burgos,482,Zarzosa de Río Pisuerga,31,20,11
09,Burgos,483,Zazuar,206,105,101
09,Burgos,485,Zuñeda,57,30,27
10,Cáceres,1,Abadía,338,185,153
10,Cáceres,2,Abertura,377,190,187
10,Cáceres,3,Acebo,582,285,297
10,Cáceres,4,Acehúche,802,406,396
10,Cáceres,5,Aceituna,581,299,282
10,Cáceres,6,Ahigal,1361,680,681
10,Cáceres,903,Alagón del Río,913,450,463
10,Cáceres,7,Albalá,657,342,315
10,Cáceres,8,Alcántara,1348,672,676
10,Cáceres,9,Alcollarín,255,131,124
10,Cáceres,10,Alcuéscar,2459,1277,1182
10,Cáceres,12,Aldea del Cano,606,298,308
10,Cáceres,13,"Aldea del Obispo, La",297,160,137
10,Cáceres,11,Aldeacentenera,597,324,273
10,Cáceres,14,Aldeanueva de la Vera,2015,984,1031
10,Cáceres,15,Aldeanueva del Camino,725,361,364
10,Cáceres,16,Aldehuela de Jerte,362,185,177
10,Cáceres,17,Alía,755,389,366
10,Cáceres,18,Aliseda,1710,874,836
10,Cáceres,19,Almaraz,1647,836,811
10,Cáceres,20,Almoharín,1799,892,907
10,Cáceres,21,Arroyo de la Luz,5565,2747,2818
10,Cáceres,23,Arroyomolinos,809,413,396
10,Cáceres,22,Arroyomolinos de la Vera,425,214,211
10,Cáceres,24,Baños de Montemayor,735,341,394
10,Cáceres,25,Barrado,373,193,180
10,Cáceres,26,Belvís de Monroy,721,372,349
10,Cáceres,27,Benquerencia,86,47,39
10,Cáceres,28,Berrocalejo,120,63,57
10,Cáceres,29,Berzocana,396,205,191
10,Cáceres,30,Bohonal de Ibor,488,238,250
10,Cáceres,31,Botija,185,97,88
10,Cáceres,32,Brozas,1734,859,875
10,Cáceres,33,Cabañas del Castillo,400,209,191
10,Cáceres,34,Cabezabellosa,344,176,168
10,Cáceres,35,Cabezuela del Valle,2149,1084,1065
10,Cáceres,36,Cabrero,341,189,152
10,Cáceres,37,Cáceres,96215,45996,50219
10,Cáceres,38,Cachorrilla,92,46,46
10,Cáceres,39,Cadalso,419,212,207
10,Cáceres,40,Calzadilla,459,236,223
10,Cáceres,41,Caminomorisco,1132,596,536
10,Cáceres,42,Campillo de Deleitosa,83,39,44
10,Cáceres,43,Campo Lugar,833,413,420
10,Cáceres,44,Cañamero,1615,848,767
10,Cáceres,45,Cañaveral,1009,506,503
10,Cáceres,46,Carbajo,179,90,89
10,Cáceres,47,Carcaboso,1078,549,529
10,Cáceres,48,Carrascalejo,230,119,111
10,Cáceres,49,Casar de Cáceres,4431,2188,2243
10,Cáceres,50,Casar de Palomero,1017,524,493
10,Cáceres,51,Casares de las Hurdes,404,214,190
10,Cáceres,52,Casas de Don Antonio,191,102,89
10,Cáceres,53,Casas de Don Gómez,321,176,145
10,Cáceres,56,Casas de Millán,549,278,271
10,Cáceres,57,Casas de Miravete,114,75,39
10,Cáceres,54,Casas del Castañar,579,290,289
10,Cáceres,55,Casas del Monte,769,394,375
10,Cáceres,58,Casatejada,1360,711,649
10,Cáceres,59,Casillas de Coria,343,171,172
10,Cáceres,60,Castañar de Ibor,1013,523,490
10,Cáceres,61,Ceclavín,1780,902,878
10,Cáceres,62,Cedillo,433,221,212
10,Cáceres,63,Cerezo,144,70,74
10,Cáceres,64,Cilleros,1562,792,770
10,Cáceres,65,Collado de la Vera,261,136,125
10,Cáceres,66,Conquista de la Sierra,190,111,79
10,Cáceres,67,Coria,12166,5962,6204
10,Cáceres,68,Cuacos de Yuste,833,425,408
10,Cáceres,69,"Cumbre, La",840,426,414
10,Cáceres,70,Deleitosa,685,347,338
10,Cáceres,71,Descargamaría,103,58,45
10,Cáceres,72,Eljas,865,442,423
10,Cáceres,73,Escurial,863,457,406
10,Cáceres,75,Fresnedoso de Ibor,241,129,112
10,Cáceres,76,Galisteo,858,424,434
10,Cáceres,77,Garciaz,687,353,334
10,Cáceres,79,Garganta la Olla,898,469,429
10,Cáceres,78,"Garganta, La",353,186,167
10,Cáceres,80,Gargantilla,371,192,179
10,Cáceres,81,Gargüera,176,93,83
10,Cáceres,82,Garrovillas de Alconétar,1974,964,1010
10,Cáceres,83,Garvín,99,55,44
10,Cáceres,84,Gata,1372,700,672
10,Cáceres,85,"Gordo, El",364,196,168
10,Cáceres,86,"Granja, La",316,164,152
10,Cáceres,87,Guadalupe,1787,888,899
10,Cáceres,88,Guijo de Coria,195,107,88
10,Cáceres,89,Guijo de Galisteo,1509,758,751
10,Cáceres,90,Guijo de Granadilla,493,257,236
10,Cáceres,91,Guijo de Santa Bárbara,378,201,177
10,Cáceres,92,Herguijuela,266,140,126
10,Cáceres,93,Hernán-Pérez,416,205,211
10,Cáceres,94,Herrera de Alcántara,228,126,102
10,Cáceres,95,Herreruela,321,165,156
10,Cáceres,96,Hervás,3907,1916,1991
10,Cáceres,97,Higuera de Albalat,105,59,46
10,Cáceres,98,Hinojal,391,197,194
10,Cáceres,99,Holguera,607,303,304
10,Cáceres,100,Hoyos,851,422,429
10,Cáceres,101,Huélaga,210,101,109
10,Cáceres,102,Ibahernando,531,266,265
10,Cáceres,103,Jaraicejo,444,213,231
10,Cáceres,104,Jaraíz de la Vera,6664,3349,3315
10,Cáceres,105,Jarandilla de la Vera,2845,1407,1438
10,Cáceres,106,Jarilla,139,72,67
10,Cáceres,107,Jerte,1238,616,622
10,Cáceres,108,Ladrillar,191,113,78
10,Cáceres,109,Logrosán,1913,983,930
10,Cáceres,110,Losar de la Vera,2718,1367,1351
10,Cáceres,111,Madrigal de la Vera,1542,809,733
10,Cáceres,112,Madrigalejo,1712,861,851
10,Cáceres,113,Madroñera,2357,1177,1180
10,Cáceres,114,Majadas,1293,649,644
10,Cáceres,115,Malpartida de Cáceres,4086,2040,2046
10,Cáceres,116,Malpartida de Plasencia,4618,2282,2336
10,Cáceres,117,Marchagaz,241,132,109
10,Cáceres,118,Mata de Alcántara,284,146,138
10,Cáceres,119,Membrío,572,284,288
10,Cáceres,120,Mesas de Ibor,150,76,74
10,Cáceres,121,Miajadas,9359,4653,4706
10,Cáceres,122,Millanes,233,119,114
10,Cáceres,123,Mirabel,650,328,322
10,Cáceres,124,Mohedas de Granadilla,834,417,417
10,Cáceres,125,Monroy,899,465,434
10,Cáceres,126,Montánchez,1598,801,797
10,Cáceres,127,Montehermoso,5619,2860,2759
10,Cáceres,128,Moraleja,6585,3268,3317
10,Cáceres,129,Morcillo,358,172,186
10,Cáceres,130,Navaconcejo,2065,1043,1022
10,Cáceres,131,Navalmoral de la Mata,16895,8162,8733
10,Cáceres,132,Navalvillar de Ibor,383,196,187
10,Cáceres,133,Navas del Madroño,1243,612,631
10,Cáceres,134,Navezuelas,648,333,315
10,Cáceres,135,Nuñomoral,1225,660,565
10,Cáceres,136,Oliva de Plasencia,299,173,126
10,Cáceres,137,Palomero,406,212,194
10,Cáceres,138,Pasarón de la Vera,580,282,298
10,Cáceres,139,Pedroso de Acim,90,52,38
10,Cáceres,140,Peraleda de la Mata,1409,706,703
10,Cáceres,141,Peraleda de San Román,298,173,125
10,Cáceres,142,Perales del Puerto,911,461,450
10,Cáceres,143,Pescueza,137,60,77
10,Cáceres,144,"Pesga, La",976,508,468
10,Cáceres,145,Piedras Albas,130,63,67
10,Cáceres,146,Pinofranqueado,1749,918,831
10,Cáceres,147,Piornal,1470,751,719
10,Cáceres,148,Plasencia,39412,18898,20514
10,Cáceres,149,Plasenzuela,498,240,258
10,Cáceres,150,Portaje,373,183,190
10,Cáceres,151,Portezuelo,216,115,101
10,Cáceres,152,Pozuelo de Zarzón,444,221,223
10,Cáceres,905,Pueblonuevo de Miramontes,782,385,397
10,Cáceres,153,Puerto de Santa Cruz,267,137,130
10,Cáceres,154,Rebollar,200,105,95
10,Cáceres,155,Riolobos,1190,582,608
10,Cáceres,156,Robledillo de Gata,86,50,36
10,Cáceres,157,Robledillo de la Vera,263,133,130
10,Cáceres,158,Robledillo de Trujillo,356,183,173
10,Cáceres,159,Robledollano,312,172,140
10,Cáceres,160,Romangordo,246,119,127
10,Cáceres,901,Rosalejo,1326,680,646
10,Cáceres,161,Ruanes,75,42,33
10,Cáceres,162,Salorino,538,282,256
10,Cáceres,163,Salvatierra de Santiago,257,132,125
10,Cáceres,164,San Martín de Trevejo,723,350,373
10,Cáceres,165,Santa Ana,301,153,148
10,Cáceres,166,Santa Cruz de la Sierra,319,163,156
10,Cáceres,167,Santa Cruz de Paniagua,280,159,121
10,Cáceres,168,Santa Marta de Magasca,284,146,138
10,Cáceres,169,Santiago de Alcántara,475,230,245
10,Cáceres,170,Santiago del Campo,245,124,121
10,Cáceres,171,Santibáñez el Alto,361,192,169
10,Cáceres,172,Santibáñez el Bajo,713,372,341
10,Cáceres,173,Saucedilla,947,495,452
10,Cáceres,174,Segura de Toro,181,96,85
10,Cáceres,175,Serradilla,1493,749,744
10,Cáceres,176,Serrejón,405,206,199
10,Cáceres,177,Sierra de Fuentes,2020,1036,984
10,Cáceres,178,Talaván,776,404,372
10,Cáceres,179,Talaveruela de la Vera,302,155,147
10,Cáceres,180,Talayuela,7273,3852,3421
10,Cáceres,181,Tejeda de Tiétar,763,402,361
10,Cáceres,904,Tiétar,844,456,388
10,Cáceres,182,Toril,164,103,61
10,Cáceres,183,Tornavacas,985,522,463
10,Cáceres,184,"Torno, El",838,438,400
10,Cáceres,187,Torre de Don Miguel,483,250,233
10,Cáceres,188,Torre de Santa María,529,263,266
10,Cáceres,185,Torrecilla de los Ángeles,662,345,317
10,Cáceres,186,Torrecillas de la Tiesa,1050,533,517
10,Cáceres,190,Torrejón el Rubio,519,263,256
10,Cáceres,189,Torrejoncillo,2819,1369,1450
10,Cáceres,191,Torremenga,611,316,295
10,Cáceres,192,Torremocha,739,375,364
10,Cáceres,193,Torreorgaz,1682,839,843
10,Cáceres,194,Torrequemada,567,278,289
10,Cáceres,195,Trujillo,8605,4192,4413
10,Cáceres,196,Valdastillas,311,158,153
10,Cáceres,197,Valdecañas de Tajo,109,56,53
10,Cáceres,198,Valdefuentes,1104,531,573
10,Cáceres,199,Valdehúncar,194,105,89
10,Cáceres,200,Valdelacasa de Tajo,339,178,161
10,Cáceres,201,Valdemorales,215,106,109
10,Cáceres,202,Valdeobispo,636,313,323
10,Cáceres,203,Valencia de Alcántara,5236,2571,2665
10,Cáceres,204,Valverde de la Vera,467,232,235
10,Cáceres,205,Valverde del Fresno,2106,1061,1045
10,Cáceres,902,Vegaviana,848,436,412
10,Cáceres,206,Viandar de la Vera,225,115,110
10,Cáceres,207,Villa del Campo,438,212,226
10,Cáceres,208,Villa del Rey,116,58,58
10,Cáceres,209,Villamesías,276,142,134
10,Cáceres,210,Villamiel,379,190,189
10,Cáceres,211,Villanueva de la Sierra,496,252,244
10,Cáceres,212,Villanueva de la Vera,2087,1046,1041
10,Cáceres,214,Villar de Plasencia,230,120,110
10,Cáceres,213,Villar del Pedroso,548,279,269
10,Cáceres,215,Villasbuenas de Gata,383,188,195
10,Cáceres,216,Zarza de Granadilla,1799,916,883
10,Cáceres,217,Zarza de Montánchez,515,265,250
10,Cáceres,218,Zarza la Mayor,1134,568,566
10,Cáceres,219,Zorita,1267,626,641
11,Cádiz,1,Alcalá de los Gazules,5205,2672,2533
11,Cádiz,2,Alcalá del Valle,4995,2497,2498
11,Cádiz,3,Algar,1444,739,705
11,Cádiz,4,Algeciras,123639,60849,62790
11,Cádiz,5,Algodonales,5498,2780,2718
11,Cádiz,6,Arcos de la Frontera,30953,15432,15521
11,Cádiz,7,Barbate,22811,11374,11437
11,Cádiz,8,"Barrios, Los",24219,12137,12082
11,Cádiz,901,Benalup-Casas Viejas,7164,3636,3528
11,Cádiz,9,Benaocaz,714,386,328
11,Cádiz,10,Bornos,7559,3771,3788
11,Cádiz,11,"Bosque, El",2224,1117,1107
11,Cádiz,12,Cádiz,111811,52724,59087
11,Cádiz,13,Castellar de la Frontera,3020,1490,1530
11,Cádiz,15,Chiclana de la Frontera,88709,44267,44442
11,Cádiz,16,Chipiona,19649,9813,9836
11,Cádiz,14,Conil de la Frontera,23661,11852,11809
11,Cádiz,17,Espera,3802,1897,1905
11,Cádiz,18,"Gastor, El",1697,864,833
11,Cádiz,19,Grazalema,2002,992,1010
11,Cádiz,20,Jerez de la Frontera,213231,104044,109187
11,Cádiz,21,Jimena de la Frontera,6675,3396,3279
11,Cádiz,22,"Línea de la Concepción, La",63773,31283,32490
11,Cádiz,23,Medina Sidonia,11738,5905,5833
11,Cádiz,24,Olvera,7887,3881,4006
11,Cádiz,25,Paterna de Rivera,5441,2816,2625
11,Cádiz,26,Prado del Rey,5634,2763,2871
11,Cádiz,27,"Puerto de Santa María, El",89813,43850,45963
11,Cádiz,28,Puerto Real,42069,21131,20938
11,Cádiz,29,Puerto Serrano,6929,3516,3413
11,Cádiz,30,Rota,29675,14714,14961
11,Cádiz,31,San Fernando,93927,45720,48207
11,Cádiz,902,San José del Valle,4486,2277,2209
11,Cádiz,903,San Martín del Tesorillo,2742,1414,1328
11,Cádiz,33,San Roque,33646,16742,16904
11,Cádiz,32,Sanlúcar de Barrameda,69805,34770,35035
11,Cádiz,34,Setenil de las Bodegas,2638,1365,1273
11,Cádiz,35,Tarifa,18621,9323,9298
11,Cádiz,36,Torre Alháquime,799,404,395
11,Cádiz,37,Trebujena,7000,3476,3524
11,Cádiz,38,Ubrique,16363,8056,8307
11,Cádiz,39,Vejer de la Frontera,12864,6408,6456
11,Cádiz,40,Villaluenga del Rosario,480,241,239
11,Cádiz,41,Villamartín,12165,6126,6039
11,Cádiz,42,Zahara,1362,688,674
39,Cantabria,1,Alfoz de Lloredo,2471,1276,1195
39,Cantabria,2,Ampuero,4455,2230,2225
39,Cantabria,3,Anievas,268,146,122
39,Cantabria,4,Arenas de Iguña,1742,880,862
39,Cantabria,5,Argoños,1860,945,915
39,Cantabria,6,Arnuero,2255,1135,1120
39,Cantabria,7,Arredondo,478,270,208
39,Cantabria,8,"Astillero, El",18220,8878,9342
39,Cantabria,9,Bárcena de Cicero,4653,2382,2271
39,Cantabria,10,Bárcena de Pie de Concha,674,343,331
39,Cantabria,11,Bareyo,2144,1067,1077
39,Cantabria,12,Cabezón de la Sal,8181,3909,4272
39,Cantabria,13,Cabezón de Liébana,565,320,245
39,Cantabria,14,Cabuérniga,995,518,477
39,Cantabria,15,Camaleño,963,536,427
39,Cantabria,16,Camargo,30349,14817,15532
39,Cantabria,27,Campoo de Enmedio,3763,1923,1840
39,Cantabria,17,Campoo de Yuso,680,359,321
39,Cantabria,18,Cartes,5800,2890,2910
39,Cantabria,19,Castañeda,3160,1605,1555
39,Cantabria,20,Castro-Urdiales,33225,16407,16818
39,Cantabria,21,Cieza,552,281,271
39,Cantabria,22,Cillorigo de Liébana,1344,708,636
39,Cantabria,23,Colindres,8549,4185,4364
39,Cantabria,24,Comillas,2135,1012,1123
39,Cantabria,25,"Corrales de Buelna, Los",10785,5267,5518
39,Cantabria,26,Corvera de Toranzo,2096,1052,1044
39,Cantabria,28,Entrambasaguas,5568,2778,2790
39,Cantabria,29,Escalante,749,382,367
39,Cantabria,30,Guriezo,2438,1271,1167
39,Cantabria,31,Hazas de Cesto,1782,879,903
39,Cantabria,32,Hermandad de Campoo de Suso,1588,874,714
39,Cantabria,33,Herrerías,600,339,261
39,Cantabria,34,Lamasón,257,161,96
39,Cantabria,35,Laredo,10849,5158,5691
39,Cantabria,36,Liendo,1242,639,603
39,Cantabria,37,Liérganes,2397,1192,1205
39,Cantabria,38,Limpias,1975,985,990
39,Cantabria,39,Luena,622,337,285
39,Cantabria,40,Marina de Cudeyo,5148,2562,2586
39,Cantabria,41,Mazcuerras,2083,1065,1018
39,Cantabria,42,Medio Cudeyo,7696,3699,3997
39,Cantabria,43,Meruelo,2230,1100,1130
39,Cantabria,44,Miengo,5199,2678,2521
39,Cantabria,45,Miera,393,206,187
39,Cantabria,46,Molledo,1476,724,752
39,Cantabria,47,Noja,2741,1359,1382
39,Cantabria,48,Penagos,2244,1133,1111
39,Cantabria,49,Peñarrubia,316,164,152
39,Cantabria,50,Pesaguero,282,158,124
39,Cantabria,51,Pesquera,70,44,26
39,Cantabria,52,Piélagos,26605,13175,13430
39,Cantabria,53,Polaciones,210,134,76
39,Cantabria,54,Polanco,6175,3059,3116
39,Cantabria,55,Potes,1336,619,717
39,Cantabria,56,Puente Viesgo,2884,1470,1414
39,Cantabria,57,Ramales de la Victoria,3027,1516,1511
39,Cantabria,58,Rasines,975,502,473
39,Cantabria,59,Reinosa,8570,4021,4549
39,Cantabria,60,Reocín,8422,4148,4274
39,Cantabria,61,Ribamontán al Mar,4636,2369,2267
39,Cantabria,62,Ribamontán al Monte,2498,1261,1237
39,Cantabria,63,Rionansa,1034,575,459
39,Cantabria,64,Riotuerto,1666,806,860
39,Cantabria,65,"Rozas de Valdearroyo, Las",262,145,117
39,Cantabria,66,Ruente,1052,573,479
39,Cantabria,67,Ruesga,809,446,363
39,Cantabria,68,Ruiloba,778,401,377
39,Cantabria,69,San Felices de Buelna,2390,1199,1191
39,Cantabria,70,San Miguel de Aguayo,178,91,87
39,Cantabria,71,San Pedro del Romeral,445,243,202
39,Cantabria,72,San Roque de Riomiera,351,208,143
39,Cantabria,80,San Vicente de la Barquera,4038,1963,2075
39,Cantabria,73,Santa Cruz de Bezana,13689,6704,6985
39,Cantabria,74,Santa María de Cayón,9316,4631,4685
39,Cantabria,75,Santander,172726,79525,93201
39,Cantabria,76,Santillana del Mar,4245,2064,2181
39,Cantabria,77,Santiurde de Reinosa,247,142,105
39,Cantabria,78,Santiurde de Toranzo,1732,910,822
39,Cantabria,79,Santoña,10892,5291,5601
39,Cantabria,81,Saro,518,271,247
39,Cantabria,82,Selaya,1845,939,906
39,Cantabria,83,Soba,1108,623,485
39,Cantabria,84,Solórzano,1080,575,505
39,Cantabria,85,Suances,9091,4454,4637
39,Cantabria,86,"Tojos, Los",380,227,153
39,Cantabria,87,Torrelavega,51361,24196,27165
39,Cantabria,88,Tresviso,58,38,20
39,Cantabria,89,Tudanca,155,105,50
39,Cantabria,90,Udías,945,473,472
39,Cantabria,95,Val de San Vicente,2783,1416,1367
39,Cantabria,91,Valdáliga,2167,1117,1050
39,Cantabria,92,Valdeolea,882,480,402
39,Cantabria,93,Valdeprado del Río,331,189,142
39,Cantabria,94,Valderredible,954,545,409
39,Cantabria,101,Valle de Villaverde,254,144,110
39,Cantabria,96,Vega de Liébana,702,373,329
39,Cantabria,97,Vega de Pas,741,398,343
39,Cantabria,98,Villacarriedo,1674,866,808
39,Cantabria,99,Villaescusa,3949,1960,1989
39,Cantabria,100,Villafufre,999,518,481
39,Cantabria,102,Voto,2947,1554,1393
12,Castellón/Castelló,2,Aín,130,71,59
12,Castellón/Castelló,3,Albocàsser,1302,655,647
12,Castellón/Castelló,4,Alcalà de Xivert,7160,3620,3540
12,Castellón/Castelló,5,"Alcora, l'",10526,5268,5258
12,Castellón/Castelló,6,Alcudia de Veo,203,109,94
12,Castellón/Castelló,7,Alfondeguilla,873,434,439
12,Castellón/Castelló,8,Algimia de Almonacid,249,137,112
12,Castellón/Castelló,9,Almassora,27989,14011,13978
12,Castellón/Castelló,10,Almedíjar,280,155,125
12,Castellón/Castelló,11,Almenara,6591,3302,3289
12,Castellón/Castelló,901,"Alqueries, les/Alquerías del Niño Perdido",4539,2281,2258
12,Castellón/Castelló,12,Altura,3695,1912,1783
12,Castellón/Castelló,13,Arañuel,165,91,74
12,Castellón/Castelló,14,Ares del Maestrat,174,104,70
12,Castellón/Castelló,15,Argelita,156,84,72
12,Castellón/Castelló,16,Artana,1980,1010,970
12,Castellón/Castelló,1,Atzeneta del Maestrat,1319,671,648
12,Castellón/Castelló,17,Ayódar,178,96,82
12,Castellón/Castelló,18,Azuébar,336,183,153
12,Castellón/Castelló,20,Barracas,198,103,95
12,Castellón/Castelló,22,Bejís,409,241,168
12,Castellón/Castelló,24,Benafer,164,82,82
12,Castellón/Castelló,25,Benafigos,135,78,57
12,Castellón/Castelló,26,Benassal,1026,527,499
12,Castellón/Castelló,27,Benicarló,28681,14432,14249
12,Castellón/Castelló,28,Benicàssim/Benicasim,19951,9808,10143
12,Castellón/Castelló,29,Benlloc,1108,562,546
12,Castellón/Castelló,21,Betxí,5580,2760,2820
12,Castellón/Castelló,32,Borriana/Burriana,35750,17769,17981
12,Castellón/Castelló,31,Borriol,5865,3004,2861
12,Castellón/Castelló,33,Cabanes,3222,1651,1571
12,Castellón/Castelló,34,Càlig,2013,1013,1000
12,Castellón/Castelló,36,Canet lo Roig,685,352,333
12,Castellón/Castelló,37,Castell de Cabres,19,11,8
12,Castellón/Castelló,38,Castellfort,188,98,90
12,Castellón/Castelló,39,Castellnovo,888,456,432
12,Castellón/Castelló,40,Castelló de la Plana,176238,85021,91217
12,Castellón/Castelló,41,Castillo de Villamalefa,109,72,37
12,Castellón/Castelló,42,Catí,724,361,363
12,Castellón/Castelló,43,Caudiel,716,358,358
12,Castellón/Castelló,44,Cervera del Maestre,656,317,339
12,Castellón/Castelló,53,Chilches/Xilxes,2981,1531,1450
12,Castellón/Castelló,56,Chóvar,310,161,149
12,Castellón/Castelló,45,Cinctorres,427,207,220
12,Castellón/Castelló,46,Cirat,223,127,96
12,Castellón/Castelló,48,Cortes de Arenoso,304,156,148
12,Castellón/Castelló,49,Costur,535,282,253
12,Castellón/Castelló,50,"Coves de Vinromà, les",1831,934,897
12,Castellón/Castelló,51,Culla,480,247,233
12,Castellón/Castelló,57,Eslida,758,383,375
12,Castellón/Castelló,58,Espadilla,90,50,40
12,Castellón/Castelló,59,Fanzara,294,154,140
12,Castellón/Castelló,60,Figueroles,518,258,260
12,Castellón/Castelló,61,Forcall,473,227,246
12,Castellón/Castelló,63,Fuente la Reina,59,31,28
12,Castellón/Castelló,64,Fuentes de Ayódar,98,55,43
12,Castellón/Castelló,65,Gaibiel,197,109,88
12,Castellón/Castelló,67,Geldo,650,325,325
12,Castellón/Castelló,68,Herbers,62,39,23
12,Castellón/Castelló,69,Higueras,50,24,26
12,Castellón/Castelló,70,"Jana, la",678,348,330
12,Castellón/Castelló,71,Jérica,1794,895,899
12,Castellón/Castelló,74,"Llosa, la",1003,489,514
12,Castellón/Castelló,72,Llucena/Lucena del Cid,1369,683,686
12,Castellón/Castelló,73,Ludiente,155,88,67
12,Castellón/Castelló,75,"Mata de Morella, la",179,96,83
12,Castellón/Castelló,76,Matet,84,52,32
12,Castellón/Castelló,77,Moncofa,7747,3946,3801
12,Castellón/Castelló,78,Montán,399,199,200
12,Castellón/Castelló,79,Montanejos,603,313,290
12,Castellón/Castelló,80,Morella,2492,1223,1269
12,Castellón/Castelló,81,Navajas,840,431,409
12,Castellón/Castelló,82,Nules,13827,6938,6889
12,Castellón/Castelló,83,Olocau del Rey,126,66,60
12,Castellón/Castelló,84,Onda,25547,12795,12752
12,Castellón/Castelló,85,Orpesa/Oropesa del Mar,10958,5596,5362
12,Castellón/Castelló,87,Palanques,36,21,15
12,Castellón/Castelló,88,Pavías,74,45,29
12,Castellón/Castelló,89,Peníscola/Peñíscola,8449,4303,4146
12,Castellón/Castelló,90,Pina de Montalgrao,119,65,54
12,Castellón/Castelló,93,"Pobla de Benifassà, la",235,135,100
12,Castellón/Castelló,94,"Pobla Tornesa, la",1309,670,639
12,Castellón/Castelló,91,Portell de Morella,166,85,81
12,Castellón/Castelló,92,Puebla de Arenoso,169,95,74
12,Castellón/Castelló,95,Ribesalbes,1135,584,551
12,Castellón/Castelló,96,Rossell,891,467,424
12,Castellón/Castelló,97,Sacañet,86,53,33
12,Castellón/Castelló,98,"Salzadella, la",660,346,314
12,Castellón/Castelló,101,San Rafael del Río,494,246,248
12,Castellón/Castelló,902,Sant Joan de Moró,3516,1803,1713
12,Castellón/Castelló,99,Sant Jordi/San Jorge,1249,654,595
12,Castellón/Castelló,100,Sant Mateu,1987,979,1008
12,Castellón/Castelló,102,Santa Magdalena de Pulpis,784,411,373
12,Castellón/Castelló,104,Segorbe,9425,4648,4777
12,Castellón/Castelló,103,"Serratella, la",110,51,59
12,Castellón/Castelló,105,Sierra Engarcerán,1045,549,496
12,Castellón/Castelló,106,Soneja,1508,744,764
12,Castellón/Castelló,107,Sot de Ferrer,474,256,218
12,Castellón/Castelló,108,Suera/Sueras,572,296,276
12,Castellón/Castelló,109,Tales,852,435,417
12,Castellón/Castelló,110,Teresa,250,137,113
12,Castellón/Castelló,111,Tírig,430,217,213
12,Castellón/Castelló,112,Todolella,144,86,58
12,Castellón/Castelló,113,Toga,112,60,52
12,Castellón/Castelló,114,Torás,256,137,119
12,Castellón/Castelló,115,"Toro, El",248,128,120
12,Castellón/Castelló,116,Torralba del Pinar,69,34,35
12,Castellón/Castelló,119,"Torre d'en Besora, la",164,88,76
12,Castellón/Castelló,120,"Torre d'en Doménec, la",175,94,81
12,Castellón/Castelló,117,Torreblanca,5630,2862,2768
12,Castellón/Castelló,118,Torrechiva,114,58,56
12,Castellón/Castelló,121,Traiguera,1336,681,655
12,Castellón/Castelló,122,"Useres, les/Useras",985,511,474
12,Castellón/Castelló,124,Vall d'Alba,3054,1596,1458
12,Castellón/Castelló,125,Vall de Almonacid,286,149,137
12,Castellón/Castelló,126,"Vall d'Uixó, la",31611,15488,16123
12,Castellón/Castelló,123,Vallat,66,31,35
12,Castellón/Castelló,127,Vallibona,62,38,24
12,Castellón/Castelló,128,Vilafamés,1915,1026,889
12,Castellón/Castelló,129,Vilafranca/Villafranca del Cid,2148,1089,1059
12,Castellón/Castelló,132,Vilanova d'Alcolea,575,304,271
12,Castellón/Castelló,134,Vilar de Canes,159,79,80
12,Castellón/Castelló,135,Vila-real,51852,25739,26113
12,Castellón/Castelló,136,"Vilavella, la",3074,1526,1548
12,Castellón/Castelló,130,Villahermosa del Río,488,265,223
12,Castellón/Castelló,131,Villamalur,95,58,37
12,Castellón/Castelló,133,Villanueva de Viver,110,61,49
12,Castellón/Castelló,137,Villores,54,26,28
12,Castellón/Castelló,138,Vinaròs,29686,14598,15088
12,Castellón/Castelló,139,Vistabella del Maestrat,369,197,172
12,Castellón/Castelló,140,Viver,1683,873,810
12,Castellón/Castelló,52,Xert,686,342,344
12,Castellón/Castelló,55,Xodos/Chodos,117,72,45
12,Castellón/Castelló,141,Zorita del Maestrazgo,117,58,59
12,Castellón/Castelló,142,Zucaina,176,98,78
51,Ceuta,1,Ceuta,83039,41894,41145
13,Ciudad Real,1,Abenójar,1328,686,642
13,Ciudad Real,2,Agudo,1611,813,798
13,Ciudad Real,3,Alamillo,469,241,228
13,Ciudad Real,4,Albaladejo,1046,551,495
13,Ciudad Real,5,Alcázar de San Juan,30928,15036,15892
13,Ciudad Real,6,Alcoba,551,279,272
13,Ciudad Real,7,Alcolea de Calatrava,1382,697,685
13,Ciudad Real,8,Alcubillas,445,220,225
13,Ciudad Real,9,Aldea del Rey,1573,787,786
13,Ciudad Real,10,Alhambra,967,491,476
13,Ciudad Real,11,Almadén,4968,2405,2563
13,Ciudad Real,12,Almadenejos,397,203,194
13,Ciudad Real,13,Almagro,8958,4433,4525
13,Ciudad Real,14,Almedina,485,262,223
13,Ciudad Real,15,Almodóvar del Campo,5788,2907,2881
13,Ciudad Real,16,Almuradiel,746,374,372
13,Ciudad Real,17,Anchuras,268,142,126
13,Ciudad Real,903,Arenales de San Gregorio,597,313,284
13,Ciudad Real,18,Arenas de San Juan,1022,521,501
13,Ciudad Real,19,Argamasilla de Alba,6888,3468,3420
13,Ciudad Real,20,Argamasilla de Calatrava,5801,2904,2897
13,Ciudad Real,21,Arroba de los Montes,415,224,191
13,Ciudad Real,22,Ballesteros de Calatrava,371,189,182
13,Ciudad Real,23,Bolaños de Calatrava,11991,6187,5804
13,Ciudad Real,24,Brazatortas,1007,535,472
13,Ciudad Real,25,Cabezarados,303,164,139
13,Ciudad Real,26,Cabezarrubias del Puerto,494,257,237
13,Ciudad Real,27,Calzada de Calatrava,3779,1892,1887
13,Ciudad Real,28,Campo de Criptana,12960,6499,6461
13,Ciudad Real,29,Cañada de Calatrava,101,59,42
13,Ciudad Real,30,Caracuel de Calatrava,137,82,55
13,Ciudad Real,31,Carrión de Calatrava,3184,1617,1567
13,Ciudad Real,32,Carrizosa,1137,569,568
13,Ciudad Real,33,Castellar de Santiago,1803,917,886
13,Ciudad Real,38,Chillón,1772,851,921
13,Ciudad Real,34,Ciudad Real,75303,35660,39643
13,Ciudad Real,35,Corral de Calatrava,1113,541,572
13,Ciudad Real,36,"Cortijos, Los",857,457,400
13,Ciudad Real,37,Cózar,933,482,451
13,Ciudad Real,39,Daimiel,17629,8871,8758
13,Ciudad Real,40,Fernán Caballero,984,495,489
13,Ciudad Real,41,Fontanarejo,237,134,103
13,Ciudad Real,42,Fuencaliente,1008,529,479
13,Ciudad Real,43,Fuenllana,204,111,93
13,Ciudad Real,44,Fuente el Fresno,3072,1584,1488
13,Ciudad Real,45,Granátula de Calatrava,696,340,356
13,Ciudad Real,46,Guadalmez,715,349,366
13,Ciudad Real,47,Herencia,8385,4270,4115
13,Ciudad Real,48,Hinojosas de Calatrava,497,259,238
13,Ciudad Real,49,Horcajo de los Montes,789,405,384
13,Ciudad Real,50,"Labores, Las",546,291,255
13,Ciudad Real,904,Llanos del Caudillo,681,332,349
13,Ciudad Real,51,Luciana,371,197,174
13,Ciudad Real,52,Malagón,7745,3859,3886
13,Ciudad Real,53,Manzanares,17732,8806,8926
13,Ciudad Real,54,Membrilla,5825,2906,2919
13,Ciudad Real,55,Mestanza,663,347,316
13,Ciudad Real,56,Miguelturra,15769,7934,7835
13,Ciudad Real,57,Montiel,1225,642,583
13,Ciudad Real,58,Moral de Calatrava,5109,2581,2528
13,Ciudad Real,59,Navalpino,207,106,101
13,Ciudad Real,60,Navas de Estena,286,151,135
13,Ciudad Real,61,Pedro Muñoz,7480,3796,3684
13,Ciudad Real,62,Picón,679,355,324
13,Ciudad Real,63,Piedrabuena,4352,2213,2139
13,Ciudad Real,64,Poblete,2863,1458,1405
13,Ciudad Real,65,Porzuna,3509,1817,1692
13,Ciudad Real,66,Pozuelo de Calatrava,3709,1902,1807
13,Ciudad Real,67,"Pozuelos de Calatrava, Los",368,188,180
13,Ciudad Real,68,Puebla de Don Rodrigo,1108,615,493
13,Ciudad Real,69,Puebla del Príncipe,658,345,313
13,Ciudad Real,70,Puerto Lápice,883,438,445
13,Ciudad Real,71,Puertollano,45127,21706,23421
13,Ciudad Real,72,Retuerta del Bullaque,880,482,398
13,Ciudad Real,901,"Robledo, El",1061,559,502
13,Ciudad Real,902,Ruidera,540,265,275
13,Ciudad Real,73,Saceruela,530,277,253
13,Ciudad Real,74,San Carlos del Valle,1082,556,526
13,Ciudad Real,75,San Lorenzo de Calatrava,199,110,89
13,Ciudad Real,76,Santa Cruz de los Cáñamos,491,234,257
13,Ciudad Real,77,Santa Cruz de Mudela,3872,1931,1941
13,Ciudad Real,78,Socuéllamos,12123,6118,6005
13,Ciudad Real,80,Solana del Pino,329,171,158
13,Ciudad Real,79,"Solana, La",15242,7787,7455
13,Ciudad Real,81,Terrinches,600,313,287
13,Ciudad Real,82,Tomelloso,36304,18142,18162
13,Ciudad Real,83,Torralba de Calatrava,3057,1517,1540
13,Ciudad Real,84,Torre de Juan Abad,970,477,493
13,Ciudad Real,85,Torrenueva,2651,1335,1316
13,Ciudad Real,86,Valdemanco del Esteras,161,87,74
13,Ciudad Real,87,Valdepeñas,30411,14806,15605
13,Ciudad Real,88,Valenzuela de Calatrava,654,309,345
13,Ciudad Real,89,Villahermosa,1718,845,873
13,Ciudad Real,90,Villamanrique,1084,530,554
13,Ciudad Real,91,Villamayor de Calatrava,638,321,317
13,Ciudad Real,92,Villanueva de la Fuente,1923,990,933
13,Ciudad Real,93,Villanueva de los Infantes,4775,2385,2390
13,Ciudad Real,94,Villanueva de San Carlos,277,143,134
13,Ciudad Real,95,Villar del Pozo,54,31,23
13,Ciudad Real,96,Villarrubia de los Ojos,9667,4847,4820
13,Ciudad Real,97,Villarta de San Juan,2710,1364,1346
13,Ciudad Real,98,Viso del Marqués,2135,1039,1096
14,Córdoba,1,Adamuz,4092,2082,2010
14,Córdoba,2,Aguilar de la Frontera,13282,6602,6680
14,Córdoba,3,Alcaracejos,1493,728,765
14,Córdoba,4,Almedinilla,2340,1163,1177
14,Córdoba,5,Almodóvar del Río,7995,4015,3980
14,Córdoba,6,Añora,1507,745,762
14,Córdoba,7,Baena,18533,9278,9255
14,Córdoba,8,Belalcázar,3138,1545,1593
14,Córdoba,9,Belmez,2802,1351,1451
14,Córdoba,10,Benamejí,4979,2454,2525
14,Córdoba,11,"Blázquez, Los",643,326,317
14,Córdoba,12,Bujalance,7186,3591,3595
14,Córdoba,13,Cabra,20070,9758,10312
14,Córdoba,14,Cañete de las Torres,2829,1449,1380
14,Córdoba,15,Carcabuey,2318,1182,1136
14,Córdoba,16,Cardeña,1437,725,712
14,Córdoba,17,"Carlota, La",14258,7087,7171
14,Córdoba,18,"Carpio, El",4327,2135,2192
14,Córdoba,19,Castro del Río,7665,3774,3891
14,Córdoba,20,Conquista,371,187,184
14,Córdoba,21,Córdoba,323763,155314,168449
14,Córdoba,22,Doña Mencía,4511,2181,2330
14,Córdoba,23,Dos Torres,2383,1199,1184
14,Córdoba,24,Encinas Reales,2252,1104,1148
14,Córdoba,25,Espejo,3209,1602,1607
14,Córdoba,26,Espiel,2386,1205,1181
14,Córdoba,27,Fernán-Núñez,9611,4756,4855
14,Córdoba,901,Fuente Carreteros,1089,559,530
14,Córdoba,28,Fuente la Lancha,354,179,175
14,Córdoba,29,Fuente Obejuna,4415,2290,2125
14,Córdoba,30,Fuente Palmera,9850,4920,4930
14,Córdoba,31,Fuente-Tójar,692,335,357
14,Córdoba,32,"Granjuela, La",410,198,212
14,Córdoba,33,Guadalcázar,1533,783,750
14,Córdoba,902,"Guijarrosa, La",1336,684,652
14,Córdoba,34,"Guijo, El",341,177,164
14,Córdoba,35,Hinojosa del Duque,6579,3243,3336
14,Córdoba,36,Hornachuelos,4415,2203,2212
14,Córdoba,37,Iznájar,3804,1934,1870
14,Córdoba,38,Lucena,42813,21264,21549
14,Córdoba,39,Luque,2860,1436,1424
14,Córdoba,40,Montalbán de Córdoba,4465,2199,2266
14,Córdoba,41,Montemayor,3872,1960,1912
14,Córdoba,42,Montilla,22298,11049,11249
14,Córdoba,43,Montoro,9125,4506,4619
14,Córdoba,44,Monturque,1929,970,959
14,Córdoba,45,Moriles,3658,1841,1817
14,Córdoba,46,Nueva Carteya,5317,2708,2609
14,Córdoba,47,Obejo,2076,1094,982
14,Córdoba,48,Palenciana,1441,736,705
14,Córdoba,49,Palma del Río,20688,10243,10445
14,Córdoba,50,Pedro Abad,2775,1400,1375
14,Córdoba,51,Pedroche,1485,734,751
14,Córdoba,52,Peñarroya-Pueblonuevo,10317,4986,5331
14,Córdoba,53,Posadas,7256,3598,3658
14,Córdoba,54,Pozoblanco,16946,8235,8711
14,Córdoba,55,Priego de Córdoba,22003,10708,11295
14,Córdoba,56,Puente Genil,29781,14691,15090
14,Córdoba,57,"Rambla, La",7473,3732,3741
14,Córdoba,58,Rute,9779,4896,4883
14,Córdoba,59,San Sebastián de los Ballesteros,833,423,410
14,Córdoba,61,Santa Eufemia,710,351,359
14,Córdoba,60,Santaella,4640,2341,2299
14,Córdoba,62,Torrecampo,1003,494,509
14,Córdoba,63,Valenzuela,1045,525,520
14,Córdoba,64,Valsequillo,356,173,183
14,Córdoba,65,"Victoria, La",2312,1148,1164
14,Córdoba,66,Villa del Río,6882,3428,3454
14,Córdoba,67,Villafranca de Córdoba,4866,2475,2391
14,Córdoba,68,Villaharta,628,303,325
14,Córdoba,69,Villanueva de Córdoba,8460,4194,4266
14,Córdoba,70,Villanueva del Duque,1406,710,696
14,Córdoba,71,Villanueva del Rey,1000,487,513
14,Córdoba,72,Villaralto,1088,550,538
14,Córdoba,73,Villaviciosa de Córdoba,3085,1573,1512
14,Córdoba,74,"Viso, El",2507,1269,1238
14,Córdoba,75,Zuheros,621,318,303
15,"Coruña, A",1,Abegondo,5584,2763,2821
15,"Coruña, A",2,Ames,32482,15617,16865
15,"Coruña, A",3,Aranga,1815,924,891
15,"Coruña, A",4,Ares,6132,3019,3113
15,"Coruña, A",5,Arteixo,33516,16539,16977
15,"Coruña, A",6,Arzúa,5901,2919,2982
15,"Coruña, A",7,"Baña, A",3332,1577,1755
15,"Coruña, A",8,Bergondo,6951,3402,3549
15,"Coruña, A",9,Betanzos,13082,6234,6848
15,"Coruña, A",10,Boimorto,1849,930,919
15,"Coruña, A",11,Boiro,18984,9200,9784
15,"Coruña, A",12,Boqueixón,4146,2025,2121
15,"Coruña, A",13,Brión,8145,3913,4232
15,"Coruña, A",14,Cabana de Bergantiños,4123,2001,2122
15,"Coruña, A",15,Cabanas,3300,1601,1699
15,"Coruña, A",16,Camariñas,5151,2526,2625
15,"Coruña, A",17,Cambre,24739,12060,12679
15,"Coruña, A",18,"Capela, A",1185,582,603
15,"Coruña, A",19,Carballo,31416,15329,16087
15,"Coruña, A",901,Cariño,3769,1856,1913
15,"Coruña, A",20,Carnota,3815,1821,1994
15,"Coruña, A",21,Carral,6700,3285,3415
15,"Coruña, A",22,Cedeira,6529,3245,3284
15,"Coruña, A",23,Cee,7660,3658,4002
15,"Coruña, A",24,Cerceda,5058,2518,2540
15,"Coruña, A",25,Cerdido,1033,507,526
15,"Coruña, A",27,Coirós,1923,949,974
15,"Coruña, A",28,Corcubión,1647,829,818
15,"Coruña, A",29,Coristanco,5779,2773,3006
15,"Coruña, A",30,"Coruña, A",247376,114547,132829
15,"Coruña, A",31,Culleredo,30864,14825,16039
15,"Coruña, A",32,Curtis,4135,2096,2039
15,"Coruña, A",33,Dodro,2659,1264,1395
15,"Coruña, A",34,Dumbría,2856,1361,1495
15,"Coruña, A",35,Fene,12561,5966,6595
15,"Coruña, A",36,Ferrol,63890,30082,33808
15,"Coruña, A",37,Fisterra,4697,2380,2317
15,"Coruña, A",38,Frades,2246,1116,1130
15,"Coruña, A",39,Irixoa,1316,664,652
15,"Coruña, A",41,"Laracha, A",11543,5688,5855
15,"Coruña, A",40,Laxe,2939,1472,1467
15,"Coruña, A",42,Lousame,3145,1562,1583
15,"Coruña, A",43,Malpica de Bergantiños,5241,2562,2679
15,"Coruña, A",44,Mañón,1244,617,627
15,"Coruña, A",45,Mazaricos,3737,1782,1955
15,"Coruña, A",46,Melide,7553,3696,3857
15,"Coruña, A",47,Mesía,2418,1217,1201
15,"Coruña, A",48,Miño,6753,3359,3394
15,"Coruña, A",49,Moeche,1206,586,620
15,"Coruña, A",50,Monfero,1838,935,903
15,"Coruña, A",51,Mugardos,5228,2540,2688
15,"Coruña, A",53,Muros,8251,3983,4268
15,"Coruña, A",52,Muxía,4450,2129,2321
15,"Coruña, A",54,Narón,39051,18891,20160
15,"Coruña, A",55,Neda,4910,2382,2528
15,"Coruña, A",56,Negreira,6901,3326,3575
15,"Coruña, A",57,Noia,14115,6764,7351
15,"Coruña, A",58,Oleiros,37809,18166,19643
15,"Coruña, A",59,Ordes,12669,6186,6483
15,"Coruña, A",60,Oroso,7622,3747,3875
15,"Coruña, A",61,Ortigueira,5477,2607,2870
15,"Coruña, A",62,Outes,6082,2915,3167
15,"Coruña, A",902,Oza-Cesuras,5203,2627,2576
15,"Coruña, A",64,Paderne,2436,1199,1237
15,"Coruña, A",65,Padrón,8355,4049,4306
15,"Coruña, A",66,"Pino, O",4553,2280,2273
15,"Coruña, A",67,"Pobra do Caramiñal, A",9227,4529,4698
15,"Coruña, A",68,Ponteceso,5399,2709,2690
15,"Coruña, A",69,Pontedeume,7520,3615,3905
15,"Coruña, A",70,"Pontes de García Rodríguez, As",9867,4790,5077
15,"Coruña, A",71,Porto do Son,9125,4527,4598
15,"Coruña, A",72,Rianxo,10854,5344,5510
15,"Coruña, A",73,Ribeira,27030,13341,13689
15,"Coruña, A",74,Rois,4397,2096,2301
15,"Coruña, A",75,Sada,16874,8228,8646
15,"Coruña, A",76,San Sadurniño,2751,1359,1392
15,"Coruña, A",77,Santa Comba,9342,4545,4797
15,"Coruña, A",78,Santiago de Compostela,98687,45839,52848
15,"Coruña, A",79,Santiso,1473,764,709
15,"Coruña, A",80,Sobrado,1777,923,854
15,"Coruña, A",81,"Somozas, As",1068,542,526
15,"Coruña, A",82,Teo,19034,9318,9716
15,"Coruña, A",83,Toques,1074,549,525
15,"Coruña, A",84,Tordoia,3168,1512,1656
15,"Coruña, A",85,Touro,3382,1686,1696
15,"Coruña, A",86,Trazo,3019,1476,1543
15,"Coruña, A",88,Val do Dubra,3761,1834,1927
15,"Coruña, A",87,Valdoviño,6889,3362,3527
15,"Coruña, A",89,Vedra,5019,2458,2561
15,"Coruña, A",91,Vilarmaior,1234,629,605
15,"Coruña, A",90,Vilasantar,1232,652,580
15,"Coruña, A",92,Vimianzo,6840,3298,3542
15,"Coruña, A",93,Zas,4308,2082,2226
16,Cuenca,1,Abia de la Obispalía,61,38,23
16,Cuenca,2,"Acebrón, El",226,111,115
16,Cuenca,3,Alarcón,172,79,93
16,Cuenca,4,Albaladejo del Cuende,225,120,105
16,Cuenca,5,Albalate de las Nogueras,267,137,130
16,Cuenca,6,Albendea,118,58,60
16,Cuenca,7,"Alberca de Záncara, La",1553,785,768
16,Cuenca,8,Alcalá de la Vega,79,46,33
16,Cuenca,9,Alcantud,53,30,23
16,Cuenca,10,Alcázar del Rey,159,87,72
16,Cuenca,11,Alcohujate,19,10,9
16,Cuenca,12,Alconchel de la Estrella,77,47,30
16,Cuenca,13,Algarra,29,17,12
16,Cuenca,14,Aliaguilla,620,320,300
16,Cuenca,15,"Almarcha, La",434,234,200
16,Cuenca,16,Almendros,244,127,117
16,Cuenca,17,Almodóvar del Pinar,398,207,191
16,Cuenca,18,Almonacid del Marquesado,434,224,210
16,Cuenca,19,Altarejos,210,116,94
16,Cuenca,20,Arandilla del Arroyo,11,6,5
16,Cuenca,905,Arcas,2094,1059,1035
16,Cuenca,22,Arcos de la Sierra,77,45,32
16,Cuenca,24,Arguisuelas,133,67,66
16,Cuenca,25,Arrancacepas,16,9,7
16,Cuenca,26,Atalaya del Cañavate,105,58,47
16,Cuenca,27,Barajas de Melo,1012,544,468
16,Cuenca,29,Barchín del Hoyo,92,60,32
16,Cuenca,30,Bascuñana de San Pedro,24,20,4
16,Cuenca,31,Beamud,52,29,23
16,Cuenca,32,Belinchón,398,206,192
16,Cuenca,33,Belmonte,1782,886,896
16,Cuenca,34,Belmontejo,135,77,58
16,Cuenca,35,Beteta,235,123,112
16,Cuenca,36,Boniches,145,73,72
16,Cuenca,38,Buciegas,38,24,14
16,Cuenca,39,Buenache de Alarcón,453,238,215
16,Cuenca,40,Buenache de la Sierra,114,64,50
16,Cuenca,41,Buendía,418,222,196
16,Cuenca,42,Campillo de Altobuey,1287,654,633
16,Cuenca,43,Campillos-Paravientos,105,60,45
16,Cuenca,44,Campillos-Sierra,29,14,15
16,Cuenca,901,Campos del Paraíso,672,346,326
16,Cuenca,45,Canalejas del Arroyo,169,91,78
16,Cuenca,46,Cañada del Hoyo,244,136,108
16,Cuenca,47,Cañada Juncosa,217,119,98
16,Cuenca,48,Cañamares,449,242,207
16,Cuenca,49,"Cañavate, El",138,69,69
16,Cuenca,50,Cañaveras,229,114,115
16,Cuenca,51,Cañaveruelas,116,58,58
16,Cuenca,52,Cañete,804,415,389
16,Cuenca,53,Cañizares,442,241,201
16,Cuenca,55,Carboneras de Guadazaón,774,403,371
16,Cuenca,56,Cardenete,474,250,224
16,Cuenca,57,Carrascosa,67,42,25
16,Cuenca,58,Carrascosa de Haro,96,47,49
16,Cuenca,60,Casas de Benítez,809,408,401
16,Cuenca,61,Casas de Fernando Alonso,1132,592,540
16,Cuenca,62,Casas de Garcimolina,34,21,13
16,Cuenca,63,Casas de Guijarro,110,61,49
16,Cuenca,64,Casas de Haro,848,452,396
16,Cuenca,65,Casas de los Pinos,419,212,207
16,Cuenca,66,Casasimarro,3157,1640,1517
16,Cuenca,67,Castejón,117,68,49
16,Cuenca,68,Castillejo de Iniesta,107,58,49
16,Cuenca,70,Castillejo-Sierra,35,17,18
16,Cuenca,72,Castillo de Garcimuñoz,131,79,52
16,Cuenca,71,Castillo-Albaráñez,23,10,13
16,Cuenca,73,Cervera del Llano,210,103,107
16,Cuenca,23,Chillarón de Cuenca,771,399,372
16,Cuenca,81,Chumillas,61,36,25
16,Cuenca,74,"Cierva, La",38,21,17
16,Cuenca,78,Cuenca,53512,25296,28216
16,Cuenca,79,Cueva del Hierro,29,17,12
16,Cuenca,82,Enguídanos,315,173,142
16,Cuenca,83,Fresneda de Altarejos,37,19,18
16,Cuenca,84,Fresneda de la Sierra,40,24,16
16,Cuenca,85,"Frontera, La",146,80,66
16,Cuenca,86,Fuente de Pedro Naharro,1234,648,586
16,Cuenca,87,Fuentelespino de Haro,239,119,120
16,Cuenca,88,Fuentelespino de Moya,107,57,50
16,Cuenca,904,Fuentenava de Jábaga,579,301,278
16,Cuenca,89,Fuentes,463,250,213
16,Cuenca,91,Fuertescusa,70,40,30
16,Cuenca,92,Gabaldón,156,92,64
16,Cuenca,93,Garaballa,62,31,31
16,Cuenca,94,Gascueña,140,83,57
16,Cuenca,95,Graja de Campalbo,89,48,41
16,Cuenca,96,Graja de Iniesta,357,187,170
16,Cuenca,97,Henarejos,134,67,67
16,Cuenca,98,"Herrumblar, El",756,385,371
16,Cuenca,99,"Hinojosa, La",191,98,93
16,Cuenca,100,"Hinojosos, Los",731,375,356
16,Cuenca,101,"Hito, El",145,80,65
16,Cuenca,102,Honrubia,1554,782,772
16,Cuenca,103,Hontanaya,256,145,111
16,Cuenca,104,Hontecillas,55,30,25
16,Cuenca,106,Horcajo de Santiago,3671,1869,1802
16,Cuenca,107,Huélamo,76,42,34
16,Cuenca,108,Huelves,89,48,41
16,Cuenca,109,Huérguina,48,26,22
16,Cuenca,110,Huerta de la Obispalía,140,80,60
16,Cuenca,111,Huerta del Marquesado,177,97,80
16,Cuenca,112,Huete,1708,877,831
16,Cuenca,113,Iniesta,4453,2220,2233
16,Cuenca,115,Laguna del Marquesado,57,34,23
16,Cuenca,116,Lagunaseca,49,30,19
16,Cuenca,117,Landete,1230,620,610
16,Cuenca,118,Ledaña,1622,818,804
16,Cuenca,119,Leganiel,220,115,105
16,Cuenca,121,"Majadas, Las",225,117,108
16,Cuenca,122,Mariana,319,169,150
16,Cuenca,123,Masegosa,65,38,27
16,Cuenca,124,"Mesas, Las",2276,1176,1100
16,Cuenca,125,Minglanilla,2280,1175,1105
16,Cuenca,126,Mira,912,464,448
16,Cuenca,128,Monreal del Llano,46,26,20
16,Cuenca,129,Montalbanejo,87,43,44
16,Cuenca,130,Montalbo,697,356,341
16,Cuenca,131,Monteagudo de las Salinas,134,78,56
16,Cuenca,132,Mota de Altarejos,29,20,9
16,Cuenca,133,Mota del Cuervo,6108,3027,3081
16,Cuenca,134,Motilla del Palancar,6119,3063,3056
16,Cuenca,135,Moya,170,93,77
16,Cuenca,137,Narboneta,53,34,19
16,Cuenca,139,Olivares de Júcar,310,160,150
16,Cuenca,140,Olmeda de la Cuesta,22,13,9
16,Cuenca,141,Olmeda del Rey,127,64,63
16,Cuenca,142,Olmedilla de Alarcón,133,78,55
16,Cuenca,143,Olmedilla de Eliz,22,17,5
16,Cuenca,145,Osa de la Vega,443,226,217
16,Cuenca,146,Pajarón,78,37,41
16,Cuenca,147,Pajaroncillo,58,32,26
16,Cuenca,148,Palomares del Campo,557,283,274
16,Cuenca,149,Palomera,189,89,100
16,Cuenca,150,Paracuellos,94,50,44
16,Cuenca,151,Paredes,75,42,33
16,Cuenca,152,"Parra de las Vegas, La",34,24,10
16,Cuenca,153,"Pedernoso, El",1124,562,562
16,Cuenca,154,"Pedroñeras, Las",6550,3357,3193
16,Cuenca,155,"Peral, El",654,372,282
16,Cuenca,156,"Peraleja, La",84,53,31
16,Cuenca,157,"Pesquera, La",219,117,102
16,Cuenca,158,"Picazo, El",690,357,333
16,Cuenca,159,Pinarejo,190,94,96
16,Cuenca,160,Pineda de Gigüela,60,40,20
16,Cuenca,161,Piqueras del Castillo,46,28,18
16,Cuenca,162,Portalrubio de Guadamejud,36,20,16
16,Cuenca,163,Portilla,56,29,27
16,Cuenca,165,Poyatos,74,47,27
16,Cuenca,166,Pozoamargo,271,146,125
16,Cuenca,908,Pozorrubielos de la Mancha,171,92,79
16,Cuenca,167,Pozorrubio de Santiago,323,155,168
16,Cuenca,169,"Pozuelo, El",45,28,17
16,Cuenca,170,Priego,903,460,443
16,Cuenca,171,"Provencio, El",2396,1204,1192
16,Cuenca,172,Puebla de Almenara,331,172,159
16,Cuenca,174,Puebla del Salvador,199,105,94
16,Cuenca,175,Quintanar del Rey,7554,3885,3669
16,Cuenca,176,Rada de Haro,51,32,19
16,Cuenca,177,Reíllo,112,67,45
16,Cuenca,181,Rozalén del Monte,59,27,32
16,Cuenca,185,Saceda-Trasierra,39,25,14
16,Cuenca,186,Saelices,466,246,220
16,Cuenca,187,Salinas del Manzano,73,42,31
16,Cuenca,188,Salmeroncillos,103,60,43
16,Cuenca,189,Salvacañete,300,154,146
16,Cuenca,190,San Clemente,6776,3412,3364
16,Cuenca,191,San Lorenzo de la Parrilla,1106,581,525
16,Cuenca,192,San Martín de Boniches,45,26,19
16,Cuenca,193,San Pedro Palmiches,58,35,23
16,Cuenca,194,Santa Cruz de Moya,224,112,112
16,Cuenca,196,Santa María de los Llanos,683,364,319
16,Cuenca,195,Santa María del Campo Rus,531,278,253
16,Cuenca,197,Santa María del Val,65,37,28
16,Cuenca,198,Sisante,1636,845,791
16,Cuenca,199,Solera de Gabaldón,31,18,13
16,Cuenca,909,Sotorribas,698,366,332
16,Cuenca,202,Talayuelas,875,457,418
16,Cuenca,203,Tarancón,16257,8029,8228
16,Cuenca,204,Tébar,299,167,132
16,Cuenca,205,Tejadillos,104,50,54
16,Cuenca,206,Tinajas,189,103,86
16,Cuenca,209,Torralba,109,66,43
16,Cuenca,211,Torrejoncillo del Rey,342,193,149
16,Cuenca,212,Torrubia del Campo,311,152,159
16,Cuenca,213,Torrubia del Castillo,44,29,15
16,Cuenca,215,Tragacete,268,156,112
16,Cuenca,216,Tresjuncos,270,151,119
16,Cuenca,217,Tribaldos,97,53,44
16,Cuenca,218,Uclés,247,132,115
16,Cuenca,219,Uña,88,51,37
16,Cuenca,906,"Valdecolmenas, Los",71,47,24
16,Cuenca,224,Valdemeca,82,48,34
16,Cuenca,225,Valdemorillo de la Sierra,53,32,21
16,Cuenca,227,Valdemoro-Sierra,110,63,47
16,Cuenca,228,Valdeolivas,211,134,77
16,Cuenca,902,Valdetórtola,123,69,54
16,Cuenca,903,"Valeras, Las",1587,850,737
16,Cuenca,231,Valhermoso de la Fuente,75,41,34
16,Cuenca,173,"Valle de Altomira, El",208,113,95
16,Cuenca,234,Valsalobre,21,11,10
16,Cuenca,236,Valverde de Júcar,1085,537,548
16,Cuenca,237,Valverdejo,91,48,43
16,Cuenca,238,Vara de Rey,474,238,236
16,Cuenca,239,Vega del Codorno,142,84,58
16,Cuenca,240,Vellisca,119,65,54
16,Cuenca,242,Villaconejos de Trabaque,325,171,154
16,Cuenca,243,Villaescusa de Haro,490,260,230
16,Cuenca,244,Villagarcía del Llano,754,376,378
16,Cuenca,245,Villalba de la Sierra,532,263,269
16,Cuenca,246,Villalba del Rey,488,263,225
16,Cuenca,247,Villalgordo del Marquesado,63,39,24
16,Cuenca,248,Villalpardo,1008,500,508
16,Cuenca,249,Villamayor de Santiago,2405,1235,1170
16,Cuenca,250,Villanueva de Guadamejud,62,40,22
16,Cuenca,251,Villanueva de la Jara,2292,1167,1125
16,Cuenca,253,Villar de Cañas,391,212,179
16,Cuenca,254,Villar de Domingo García,226,114,112
16,Cuenca,255,Villar de la Encina,154,76,78
16,Cuenca,263,Villar de Olalla,1425,761,664
16,Cuenca,258,Villar del Humo,186,101,85
16,Cuenca,259,Villar del Infantado,30,17,13
16,Cuenca,910,Villar y Velasco,78,45,33
16,Cuenca,264,Villarejo de Fuentes,396,198,198
16,Cuenca,265,Villarejo de la Peñuela,23,13,10
16,Cuenca,266,Villarejo-Periesteban,387,194,193
16,Cuenca,269,Villares del Saz,464,245,219
16,Cuenca,270,Villarrubio,207,114,93
16,Cuenca,271,Villarta,848,420,428
16,Cuenca,272,Villas de la Ventosa,219,121,98
16,Cuenca,273,Villaverde y Pasaconsol,339,181,158
16,Cuenca,274,Víllora,135,75,60
16,Cuenca,275,Vindel,17,11,6
16,Cuenca,276,Yémeda,19,13,6
16,Cuenca,277,Zafra de Záncara,93,55,38
16,Cuenca,278,Zafrilla,53,28,25
16,Cuenca,279,Zarza de Tajo,273,150,123
16,Cuenca,280,Zarzuela,148,82,66
20,Gipuzkoa,1,Abaltzisketa,326,185,141
20,Gipuzkoa,2,Aduna,506,270,236
20,Gipuzkoa,16,Aia,2136,1124,1012
20,Gipuzkoa,3,Aizarnazabal,771,394,377
20,Gipuzkoa,4,Albiztur,325,169,156
20,Gipuzkoa,5,Alegia,1771,923,848
20,Gipuzkoa,6,Alkiza,371,181,190
20,Gipuzkoa,906,Altzaga,173,85,88
20,Gipuzkoa,7,Altzo,448,237,211
20,Gipuzkoa,8,Amezketa,937,498,439
20,Gipuzkoa,9,Andoain,14555,7221,7334
20,Gipuzkoa,10,Anoeta,2095,1075,1020
20,Gipuzkoa,11,Antzuola,2082,1035,1047
20,Gipuzkoa,12,Arama,189,91,98
20,Gipuzkoa,13,Aretxabaleta,7155,3572,3583
20,Gipuzkoa,55,Arrasate/Mondragón,21867,10732,11135
20,Gipuzkoa,14,Asteasu,1546,785,761
20,Gipuzkoa,903,Astigarraga,7666,3900,3766
20,Gipuzkoa,15,Ataun,1694,881,813
20,Gipuzkoa,17,Azkoitia,11636,5774,5862
20,Gipuzkoa,18,Azpeitia,15183,7606,7577
20,Gipuzkoa,904,Baliarrain,149,83,66
20,Gipuzkoa,19,Beasain,13970,6983,6987
20,Gipuzkoa,20,Beizama,134,84,50
20,Gipuzkoa,21,Belauntza,286,151,135
20,Gipuzkoa,22,Berastegi,1083,556,527
20,Gipuzkoa,74,Bergara,14487,7148,7339
20,Gipuzkoa,23,Berrobi,575,306,269
20,Gipuzkoa,24,Bidania-Goiatz,538,278,260
20,Gipuzkoa,29,Deba,5393,2670,2723
20,Gipuzkoa,69,Donostia/San Sebastián,188743,89152,99591
20,Gipuzkoa,30,Eibar,27234,13219,14015
20,Gipuzkoa,31,Elduain,237,116,121
20,Gipuzkoa,33,Elgeta,1119,563,556
20,Gipuzkoa,32,Elgoibar,11500,5660,5840
20,Gipuzkoa,67,Errenteria,39231,18944,20287
20,Gipuzkoa,66,Errezil,582,305,277
20,Gipuzkoa,34,Eskoriatza,4194,2102,2092
20,Gipuzkoa,35,Ezkio-Itsaso,604,307,297
20,Gipuzkoa,38,Gabiria,506,268,238
20,Gipuzkoa,37,Gaintza,124,71,53
20,Gipuzkoa,907,Gaztelu,168,86,82
20,Gipuzkoa,39,Getaria,2868,1436,1432
20,Gipuzkoa,40,Hernani,20527,10053,10474
20,Gipuzkoa,41,Hernialde,313,165,148
20,Gipuzkoa,36,Hondarribia,16887,8384,8503
20,Gipuzkoa,42,Ibarra,4130,2029,2101
20,Gipuzkoa,43,Idiazabal,2275,1146,1129
20,Gipuzkoa,44,Ikaztegieta,487,249,238
20,Gipuzkoa,45,Irun,62920,30803,32117
20,Gipuzkoa,46,Irura,1887,981,906
20,Gipuzkoa,47,Itsasondo,656,337,319
20,Gipuzkoa,48,Larraul,257,144,113
20,Gipuzkoa,902,Lasarte-Oria,19133,9236,9897
20,Gipuzkoa,49,Lazkao,6013,3008,3005
20,Gipuzkoa,50,Leaburu,394,211,183
20,Gipuzkoa,51,Legazpi,8341,4189,4152
20,Gipuzkoa,52,Legorreta,1464,735,729
20,Gipuzkoa,68,Leintz-Gatzaga,194,110,84
20,Gipuzkoa,53,Lezo,6008,2978,3030
20,Gipuzkoa,54,Lizartza,637,334,303
20,Gipuzkoa,901,Mendaro,2010,1014,996
20,Gipuzkoa,57,Mutiloa,262,131,131
20,Gipuzkoa,56,Mutriku,5313,2673,2640
20,Gipuzkoa,63,Oiartzun,10331,5127,5204
20,Gipuzkoa,58,Olaberria,918,466,452
20,Gipuzkoa,59,Oñati,11567,5709,5858
20,Gipuzkoa,76,Ordizia,10641,5301,5340
20,Gipuzkoa,905,Orendain,240,114,126
20,Gipuzkoa,60,Orexa,108,61,47
20,Gipuzkoa,61,Orio,6125,3063,3062
20,Gipuzkoa,62,Ormaiztegi,1228,627,601
20,Gipuzkoa,64,Pasaia,15857,7610,8247
20,Gipuzkoa,70,Segura,1460,735,725
20,Gipuzkoa,65,Soraluze-Placencia de las Armas,3751,1898,1853
20,Gipuzkoa,71,Tolosa,20065,9711,10354
20,Gipuzkoa,72,Urnieta,6200,3108,3092
20,Gipuzkoa,77,Urretxu,6739,3339,3400
20,Gipuzkoa,73,Usurbil,6345,3167,3178
20,Gipuzkoa,75,Villabona,5826,2881,2945
20,Gipuzkoa,78,Zaldibia,1735,879,856
20,Gipuzkoa,79,Zarautz,23152,11229,11923
20,Gipuzkoa,25,Zegama,1542,785,757
20,Gipuzkoa,26,Zerain,280,133,147
20,Gipuzkoa,27,Zestoa,3785,1973,1812
20,Gipuzkoa,28,Zizurkil,2975,1497,1478
20,Gipuzkoa,81,Zumaia,10211,5057,5154
20,Gipuzkoa,80,Zumarraga,9681,4757,4924
17,Girona,1,Agullana,923,455,468
17,Girona,2,Aiguaviva,770,384,386
17,Girona,3,Albanyà,171,88,83
17,Girona,4,Albons,819,425,394
17,Girona,6,Alp,1719,899,820
17,Girona,7,Amer,2423,1198,1225
17,Girona,8,Anglès,5884,2958,2926
17,Girona,9,Arbúcies,6531,3349,3182
17,Girona,10,Argelaguer,428,214,214
17,Girona,11,"Armentera, L'",1061,539,522
17,Girona,12,Avinyonet de Puigventós,1681,843,838
17,Girona,15,Banyoles,20506,10175,10331
17,Girona,16,Bàscara,1059,541,518
17,Girona,13,Begur,4216,2098,2118
17,Girona,18,Bellcaire d'Empordà,730,355,375
17,Girona,19,Besalú,2518,1186,1332
17,Girona,20,Bescanó,5178,2596,2582
17,Girona,21,Beuda,212,109,103
17,Girona,22,"Bisbal d'Empordà, La",11383,5696,5687
17,Girona,234,Biure,240,130,110
17,Girona,23,Blanes,41653,20715,20938
17,Girona,29,Boadella i les Escaules,262,131,131
17,Girona,24,Bolvir,506,257,249
17,Girona,25,Bordils,1794,902,892
17,Girona,26,Borrassà,797,410,387
17,Girona,27,Breda,3898,1909,1989
17,Girona,28,Brunyola i Sant Martí Sapresa,398,204,194
17,Girona,31,Cabanelles,276,152,124
17,Girona,30,Cabanes,941,492,449
17,Girona,32,Cadaqués,2912,1419,1493
17,Girona,33,Caldes de Malavella,8418,4183,4235
17,Girona,34,Calonge i Sant Antoni,12043,6001,6042
17,Girona,35,Camós,719,354,365
17,Girona,36,Campdevànol,3212,1584,1628
17,Girona,37,Campelles,164,89,75
17,Girona,38,Campllong,535,266,269
17,Girona,39,Camprodon,2487,1209,1278
17,Girona,40,Canet d'Adri,749,382,367
17,Girona,41,Cantallops,325,168,157
17,Girona,42,Capmany,668,342,326
17,Girona,44,Cassà de la Selva,10836,5548,5288
17,Girona,46,Castellfollit de la Roca,941,480,461
17,Girona,47,Castelló d'Empúries,11731,5922,5809
17,Girona,48,Castell-Platja d'Aro,12566,6094,6472
17,Girona,189,"Cellera de Ter, La",2012,986,1026
17,Girona,49,Celrà,5486,2745,2741
17,Girona,50,Cervià de Ter,1007,514,493
17,Girona,51,Cistella,298,149,149
17,Girona,54,Colera,479,247,232
17,Girona,55,Colomers,207,104,103
17,Girona,57,Corçà,1295,666,629
17,Girona,56,Cornellà del Terri,2401,1204,1197
17,Girona,58,Crespià,242,125,117
17,Girona,901,"Cruïlles, Monells i Sant Sadurní de l'Heura",1323,675,648
17,Girona,60,Darnius,546,287,259
17,Girona,61,Das,257,132,125
17,Girona,62,"Escala, L'",10478,5267,5211
17,Girona,63,Espinelves,248,121,127
17,Girona,64,Espolla,409,205,204
17,Girona,65,Esponellà,467,243,224
17,Girona,5,"Far d'Empordà, El",612,308,304
17,Girona,66,Figueres,47879,23669,24210
17,Girona,67,Flaçà,1155,559,596
17,Girona,68,Foixà,292,152,140
17,Girona,69,Fontanals de Cerdanya,533,278,255
17,Girona,70,Fontanilles,170,95,75
17,Girona,71,Fontcoberta,1439,736,703
17,Girona,902,Forallac,1752,852,900
17,Girona,73,Fornells de la Selva,2732,1350,1382
17,Girona,74,Fortià,786,380,406
17,Girona,75,Garrigàs,463,242,221
17,Girona,76,Garrigoles,190,100,90
17,Girona,77,Garriguella,972,495,477
17,Girona,78,Ger,507,277,230
17,Girona,79,Girona,104320,50165,54155
17,Girona,80,Gombrèn,200,99,101
17,Girona,81,Gualta,430,250,180
17,Girona,82,Guils de Cerdanya,598,319,279
17,Girona,83,Hostalric,4410,2208,2202
17,Girona,84,Isòvol,341,188,153
17,Girona,85,Jafre,388,201,187
17,Girona,86,"Jonquera, La",3387,1693,1694
17,Girona,87,Juià,335,178,157
17,Girona,88,Lladó,849,423,426
17,Girona,89,Llagostera,9208,4611,4597
17,Girona,90,Llambilles,715,365,350
17,Girona,91,Llanars,536,269,267
17,Girona,92,Llançà,4839,2374,2465
17,Girona,93,Llers,1216,609,607
17,Girona,94,Llívia,1506,785,721
17,Girona,95,Lloret de Mar,41559,20830,20729
17,Girona,96,"Llosses, Les",203,117,86
17,Girona,102,Maçanet de Cabrenys,750,375,375
17,Girona,103,Maçanet de la Selva,7823,4035,3788
17,Girona,97,Madremanya,294,143,151
17,Girona,98,Maià de Montcal,466,255,211
17,Girona,100,Masarac,299,161,138
17,Girona,101,Massanes,832,439,393
17,Girona,99,Meranges,114,63,51
17,Girona,105,Mieres,353,174,179
17,Girona,106,Mollet de Peralada,215,112,103
17,Girona,107,Molló,376,181,195
17,Girona,109,Montagut i Oix,979,512,467
17,Girona,110,Mont-ras,1671,844,827
17,Girona,111,Navata,1465,719,746
17,Girona,112,Ogassa,228,125,103
17,Girona,114,Olot,37975,19292,18683
17,Girona,115,Ordis,393,211,182
17,Girona,116,Osor,420,225,195
17,Girona,117,Palafrugell,23848,11838,12010
17,Girona,118,Palamós,18293,8930,9363
17,Girona,119,Palau de Santa Eulàlia,128,73,55
17,Girona,121,Palau-sator,314,172,142
17,Girona,120,Palau-saverdera,1495,753,742
17,Girona,123,Palol de Revardit,469,232,237
17,Girona,124,Pals,2539,1307,1232
17,Girona,125,Pardines,169,95,74
17,Girona,126,Parlavà,413,204,209
17,Girona,128,Pau,555,273,282
17,Girona,129,Pedret i Marzà,182,89,93
17,Girona,130,"Pera, La",450,227,223
17,Girona,132,Peralada,2018,994,1024
17,Girona,133,"Planes d'Hostoles, Les",1756,880,876
17,Girona,134,Planoles,315,174,141
17,Girona,135,Pont de Molins,557,276,281
17,Girona,136,Pontós,281,148,133
17,Girona,137,Porqueres,4723,2343,2380
17,Girona,140,"Port de la Selva, El",1045,529,516
17,Girona,138,Portbou,1066,527,539
17,Girona,139,"Preses, Les",1903,945,958
17,Girona,141,Puigcerdà,9764,4898,4866
17,Girona,142,Quart,4026,2040,1986
17,Girona,43,Queralbs,197,102,95
17,Girona,143,Rabós,203,99,104
17,Girona,144,Regencós,269,143,126
17,Girona,145,Ribes de Freser,1839,937,902
17,Girona,146,Riells i Viabrea,4426,2251,2175
17,Girona,147,Ripoll,10731,5311,5420
17,Girona,148,Riudarenes,2332,1188,1144
17,Girona,149,Riudaura,526,261,265
17,Girona,150,Riudellots de la Selva,2092,1066,1026
17,Girona,151,Riumors,234,122,112
17,Girona,152,Roses,20140,10214,9926
17,Girona,153,Rupià,316,155,161
17,Girona,154,Sales de Llierca,167,85,82
17,Girona,155,Salt,33242,17517,15725
17,Girona,157,Sant Andreu Salou,171,83,88
17,Girona,183,Sant Aniol de Finestres,364,186,178
17,Girona,158,Sant Climent Sescebes,679,402,277
17,Girona,159,Sant Feliu de Buixalleu,862,443,419
17,Girona,160,Sant Feliu de Guíxols,22751,11125,11626
17,Girona,161,Sant Feliu de Pallerols,1601,849,752
17,Girona,162,Sant Ferriol,248,138,110
17,Girona,163,Sant Gregori,4201,2109,2092
17,Girona,164,Sant Hilari Sacalm,5913,2988,2925
17,Girona,165,Sant Jaume de Llierca,870,429,441
17,Girona,167,Sant Joan de les Abadesses,3298,1637,1661
17,Girona,168,Sant Joan de Mollet,524,261,263
17,Girona,185,Sant Joan les Fonts,3086,1563,1523
17,Girona,166,Sant Jordi Desvalls,845,409,436
17,Girona,169,Sant Julià de Ramis,3723,1878,1845
17,Girona,903,Sant Julià del Llor i Bonmatí,1359,703,656
17,Girona,171,Sant Llorenç de la Muga,275,139,136
17,Girona,172,Sant Martí de Llémena,709,364,345
17,Girona,173,Sant Martí Vell,269,146,123
17,Girona,174,Sant Miquel de Campmajor,247,135,112
17,Girona,175,Sant Miquel de Fluvià,833,435,398
17,Girona,176,Sant Mori,173,87,86
17,Girona,177,Sant Pau de Segúries,742,366,376
17,Girona,178,Sant Pere Pescador,2122,1126,996
17,Girona,180,Santa Coloma de Farners,13634,6874,6760
17,Girona,181,Santa Cristina d'Aro,5664,2879,2785
17,Girona,182,Santa Llogaia d'Àlguema,382,182,200
17,Girona,184,Santa Pau,1616,815,801
17,Girona,186,Sarrià de Ter,5327,2646,2681
17,Girona,187,"Saus, Camallera i Llampaies",872,431,441
17,Girona,188,"Selva de Mar, La",221,109,112
17,Girona,190,Serinyà,1158,592,566
17,Girona,191,Serra de Daró,237,124,113
17,Girona,192,Setcases,185,103,82
17,Girona,193,Sils,6624,3392,3232
17,Girona,52,Siurana,186,88,98
17,Girona,194,Susqueda,97,59,38
17,Girona,195,"Tallada d'Empordà, La",475,251,224
17,Girona,196,Terrades,346,166,180
17,Girona,197,Torrent,170,91,79
17,Girona,198,Torroella de Fluvià,768,393,375
17,Girona,199,Torroella de Montgrí,12356,6316,6040
17,Girona,200,Tortellà,822,385,437
17,Girona,201,Toses,189,108,81
17,Girona,202,Tossa de Mar,6206,3146,3060
17,Girona,204,Ullà,1193,644,549
17,Girona,205,Ullastret,261,135,126
17,Girona,203,Ultramort,224,117,107
17,Girona,206,Urús,212,109,103
17,Girona,14,"Vajol, La",98,57,41
17,Girona,208,"Vall de Bianya, La",1356,672,684
17,Girona,207,"Vall d'en Bas, La",3178,1599,1579
17,Girona,170,Vallfogona de Ripollès,222,117,105
17,Girona,209,Vall-llobrega,908,456,452
17,Girona,210,Ventalló,903,458,445
17,Girona,211,Verges,1165,574,591
17,Girona,212,Vidrà,178,89,89
17,Girona,213,Vidreres,8339,4300,4039
17,Girona,214,Vilabertran,995,497,498
17,Girona,215,Vilablareix,3511,1753,1758
17,Girona,217,Viladamat,488,247,241
17,Girona,216,Viladasens,222,122,100
17,Girona,218,Vilademuls,842,434,408
17,Girona,220,Viladrau,1133,568,565
17,Girona,221,Vilafant,5642,2789,2853
17,Girona,223,Vilajuïga,1153,572,581
17,Girona,224,Vilallonga de Ter,399,218,181
17,Girona,225,Vilamacolum,379,214,165
17,Girona,226,Vilamalla,1188,601,587
17,Girona,227,Vilamaniscle,198,112,86
17,Girona,228,Vilanant,413,201,212
17,Girona,230,Vila-sacra,785,376,409
17,Girona,222,Vilaür,167,88,79
17,Girona,233,Vilobí d'Onyar,3278,1704,1574
17,Girona,232,Vilopriu,200,104,96
18,Granada,1,Agrón,239,126,113
18,Granada,2,Alamedilla,562,288,274
18,Granada,3,Albolote,19474,9531,9943
18,Granada,4,Albondón,735,400,335
18,Granada,5,Albuñán,419,215,204
18,Granada,6,Albuñol,7391,4089,3302
18,Granada,7,Albuñuelas,785,394,391
18,Granada,10,Aldeire,594,306,288
18,Granada,11,Alfacar,5688,2893,2795
18,Granada,12,Algarinejo,2396,1229,1167
18,Granada,13,Alhama de Granada,5655,2939,2716
18,Granada,14,Alhendín,10216,5154,5062
18,Granada,15,Alicún de Ortega,450,227,223
18,Granada,16,Almegíjar,335,165,170
18,Granada,17,Almuñécar,27305,13593,13712
18,Granada,904,Alpujarra de la Sierra,940,522,418
18,Granada,18,Alquife,581,297,284
18,Granada,20,Arenas del Rey,617,325,292
18,Granada,21,Armilla,25059,12357,12702
18,Granada,22,Atarfe,20024,10034,9990
18,Granada,23,Baza,20579,10198,10381
18,Granada,24,Beas de Granada,992,522,470
18,Granada,25,Beas de Guadix,315,160,155
18,Granada,27,Benalúa,3324,1631,1693
18,Granada,28,Benalúa de las Villas,1030,541,489
18,Granada,29,Benamaurel,2250,1122,1128
18,Granada,30,Bérchules,690,379,311
18,Granada,32,Bubión,309,163,146
18,Granada,33,Busquístar,319,163,156
18,Granada,34,Cacín,527,277,250
18,Granada,35,Cádiar,1539,816,723
18,Granada,36,Cájar,5447,2691,2756
18,Granada,114,"Calahorra, La",683,350,333
18,Granada,37,Calicasas,650,322,328
18,Granada,38,Campotéjar,1250,623,627
18,Granada,39,Caniles,3910,1993,1917
18,Granada,40,Cáñar,397,211,186
18,Granada,42,Capileira,582,287,295
18,Granada,43,Carataunas,234,125,109
18,Granada,44,Cástaras,224,132,92
18,Granada,45,Castilléjar,1288,679,609
18,Granada,46,Castril,1992,1038,954
18,Granada,47,Cenes de la Vega,8231,4107,4124
18,Granada,59,Chauchina,5679,2800,2879
18,Granada,61,Chimeneas,1238,650,588
18,Granada,62,Churriana de la Vega,16445,8097,8348
18,Granada,48,Cijuela,3630,1841,1789
18,Granada,49,Cogollos de Guadix,658,376,282
18,Granada,50,Cogollos de la Vega,2064,1056,1008
18,Granada,51,Colomera,1290,679,611
18,Granada,53,Cortes de Baza,1810,904,906
18,Granada,54,Cortes y Graena,977,511,466
18,Granada,912,Cuevas del Campo,1793,891,902
18,Granada,56,Cúllar,3965,1979,1986
18,Granada,57,Cúllar Vega,7770,3935,3835
18,Granada,63,Darro,1658,846,812
18,Granada,64,Dehesas de Guadix,395,194,201
18,Granada,65,Dehesas Viejas,650,333,317
18,Granada,66,Deifontes,2624,1321,1303
18,Granada,67,Diezma,799,434,365
18,Granada,68,Dílar,2264,1138,1126
18,Granada,69,Dólar,624,333,291
18,Granada,915,Domingo Pérez de Granada,836,443,393
18,Granada,70,Dúdar,378,200,178
18,Granada,71,Dúrcal,7233,3635,3598
18,Granada,72,Escúzar,841,443,398
18,Granada,74,Ferreira,317,165,152
18,Granada,76,Fonelas,987,523,464
18,Granada,77,Fornes,543,287,256
18,Granada,78,Freila,894,469,425
18,Granada,79,Fuente Vaqueros,4594,2298,2296
18,Granada,905,"Gabias, Las",22829,11520,11309
18,Granada,82,Galera,1108,556,552
18,Granada,83,Gobernador,252,128,124
18,Granada,84,Gójar,6203,3129,3074
18,Granada,85,Gor,757,393,364
18,Granada,86,Gorafe,382,197,185
18,Granada,87,Granada,230595,106426,124169
18,Granada,88,Guadahortuna,1816,930,886
18,Granada,89,Guadix,18527,9211,9316
18,Granada,906,"Guájares, Los",1157,625,532
18,Granada,93,Gualchos,5308,2823,2485
18,Granada,94,Güéjar Sierra,2909,1546,1363
18,Granada,95,Güevéjar,2677,1390,1287
18,Granada,96,Huélago,365,189,176
18,Granada,97,Huéneja,1192,643,549
18,Granada,98,Huéscar,7220,3576,3644
18,Granada,99,Huétor de Santillán,1929,987,942
18,Granada,100,Huétor Tájar,10673,5381,5292
18,Granada,101,Huétor Vega,12159,6076,6083
18,Granada,102,Íllora,9951,5041,4910
18,Granada,103,Ítrabo,960,473,487
18,Granada,105,Iznalloz,5161,2641,2520
18,Granada,106,Játar,582,318,264
18,Granada,107,Jayena,993,519,474
18,Granada,108,Jérez del Marquesado,983,494,489
18,Granada,109,Jete,994,526,468
18,Granada,111,Jun,4061,2066,1995
18,Granada,112,Juviles,146,78,68
18,Granada,115,Láchar,3755,1902,1853
18,Granada,116,Lanjarón,3664,1835,1829
18,Granada,117,Lanteira,555,297,258
18,Granada,119,Lecrín,2258,1141,1117
18,Granada,120,Lentegí,339,170,169
18,Granada,121,Lobras,149,73,76
18,Granada,122,Loja,20580,10271,10309
18,Granada,123,Lugros,305,156,149
18,Granada,124,Lújar,480,263,217
18,Granada,126,"Malahá, La",1845,924,921
18,Granada,127,Maracena,22275,10855,11420
18,Granada,128,Marchal,411,194,217
18,Granada,132,Moclín,3558,1781,1777
18,Granada,133,Molvízar,2752,1423,1329
18,Granada,134,Monachil,8349,4236,4113
18,Granada,135,Montefrío,5376,2812,2564
18,Granada,136,Montejícar,2039,1051,988
18,Granada,137,Montillana,1069,575,494
18,Granada,138,Moraleda de Zafayona,3130,1579,1551
18,Granada,909,Morelábor,585,313,272
18,Granada,140,Motril,58939,28877,30062
18,Granada,141,Murtas,458,257,201
18,Granada,903,Nevada,1105,572,533
18,Granada,143,Nigüelas,1228,625,603
18,Granada,144,Nívar,1093,561,532
18,Granada,145,Ogíjares,14803,7312,7491
18,Granada,146,Orce,1147,559,588
18,Granada,147,Órgiva,5709,2853,2856
18,Granada,148,Otívar,1034,539,495
18,Granada,150,Padul,9436,4716,4720
18,Granada,151,Pampaneira,310,157,153
18,Granada,152,Pedro Martínez,1160,579,581
18,Granada,153,Peligros,11676,5752,5924
18,Granada,154,"Peza, La",1128,583,545
18,Granada,910,"Pinar, El",867,459,408
18,Granada,157,Pinos Genil,1595,816,779
18,Granada,158,Pinos Puente,9664,4827,4837
18,Granada,159,Píñar,1099,597,502
18,Granada,161,Polícar,274,147,127
18,Granada,162,Polopos,1644,901,743
18,Granada,163,Pórtugos,388,199,189
18,Granada,164,Puebla de Don Fadrique,2207,1125,1082
18,Granada,165,Pulianas,5559,2774,2785
18,Granada,167,Purullena,2313,1166,1147
18,Granada,168,Quéntar,956,498,458
18,Granada,170,Rubite,406,234,172
18,Granada,171,Salar,2617,1312,1305
18,Granada,173,Salobreña,12562,6248,6314
18,Granada,174,Santa Cruz del Comercio,530,274,256
18,Granada,175,Santa Fe,15105,7430,7675
18,Granada,176,Soportújar,283,154,129
18,Granada,177,Sorvilán,524,287,237
18,Granada,901,"Taha, La",769,377,392
18,Granada,178,Torre-Cardela,736,389,347
18,Granada,916,Torrenueva Costa,3115,1646,1469
18,Granada,179,Torvizcón,618,326,292
18,Granada,180,Trevélez,702,370,332
18,Granada,181,Turón,219,131,88
18,Granada,182,Ugíjar,2574,1284,1290
18,Granada,914,Valderrubio,2060,1021,1039
18,Granada,907,Valle del Zalabí,2116,1072,1044
18,Granada,902,"Valle, El",936,475,461
18,Granada,183,Válor,676,356,320
18,Granada,911,Vegas del Genil,12165,6165,6000
18,Granada,184,Vélez de Benaudalla,3013,1542,1471
18,Granada,185,Ventas de Huelma,651,362,289
18,Granada,149,Villa de Otura,7466,3759,3707
18,Granada,908,Villamena,986,510,476
18,Granada,187,Villanueva de las Torres,527,292,235
18,Granada,188,Villanueva Mesía,2009,975,1034
18,Granada,189,Víznar,1003,524,479
18,Granada,192,Zafarraya,2157,1163,994
18,Granada,913,Zagra,865,447,418
18,Granada,193,"Zubia, La",19885,9831,10054
18,Granada,194,Zújar,2568,1307,1261
19,Guadalajara,1,Abánades,62,38,24
19,Guadalajara,2,Ablanque,66,42,24
19,Guadalajara,3,Adobes,30,18,12
19,Guadalajara,4,Alaminos,62,32,30
19,Guadalajara,5,Alarilla,138,84,54
19,Guadalajara,6,Albalate de Zorita,1132,629,503
19,Guadalajara,7,Albares,523,266,257
19,Guadalajara,8,Albendiego,45,30,15
19,Guadalajara,9,Alcocer,336,168,168
19,Guadalajara,10,Alcolea de las Peñas,12,8,4
19,Guadalajara,11,Alcolea del Pinar,329,192,137
19,Guadalajara,13,Alcoroches,131,81,50
19,Guadalajara,15,Aldeanueva de Guadalajara,104,63,41
19,Guadalajara,16,Algar de Mesa,46,33,13
19,Guadalajara,17,Algora,98,58,40
19,Guadalajara,18,Alhóndiga,169,100,69
19,Guadalajara,19,Alique,14,6,8
19,Guadalajara,20,Almadrones,55,38,17
19,Guadalajara,21,Almoguera,1415,715,700
19,Guadalajara,22,Almonacid de Zorita,638,325,313
19,Guadalajara,23,Alocén,154,80,74
19,Guadalajara,24,Alovera,13407,6809,6598
19,Guadalajara,27,Alustante,131,74,57
19,Guadalajara,31,Angón,7,6,1
19,Guadalajara,32,Anguita,157,82,75
19,Guadalajara,33,Anquela del Ducado,56,31,25
19,Guadalajara,34,Anquela del Pedregal,27,17,10
19,Guadalajara,36,Aranzueque,381,200,181
19,Guadalajara,37,Arbancón,145,84,61
19,Guadalajara,38,Arbeteta,19,15,4
19,Guadalajara,39,Argecilla,70,50,20
19,Guadalajara,40,Armallones,55,31,24
19,Guadalajara,41,Armuña de Tajuña,269,133,136
19,Guadalajara,42,Arroyo de las Fraguas,33,18,15
19,Guadalajara,43,Atanzón,94,64,30
19,Guadalajara,44,Atienza,434,251,183
19,Guadalajara,45,Auñón,146,78,68
19,Guadalajara,46,Azuqueca de Henares,35498,17878,17620
19,Guadalajara,47,Baides,56,27,29
19,Guadalajara,48,Baños de Tajo,15,10,5
19,Guadalajara,49,Bañuelos,13,11,2
19,Guadalajara,50,Barriopedro,20,12,8
19,Guadalajara,51,Berninches,50,35,15
19,Guadalajara,52,"Bodera, La",21,14,7
19,Guadalajara,53,Brihuega,2734,1416,1318
19,Guadalajara,54,Budia,208,122,86
19,Guadalajara,55,Bujalaro,47,23,24
19,Guadalajara,57,Bustares,68,41,27
19,Guadalajara,58,Cabanillas del Campo,11034,5550,5484
19,Guadalajara,59,Campillo de Dueñas,76,46,30
19,Guadalajara,60,Campillo de Ranas,155,95,60
19,Guadalajara,61,Campisábalos,84,58,26
19,Guadalajara,64,Canredondo,87,55,32
19,Guadalajara,65,Cantalojas,126,69,57
19,Guadalajara,66,Cañizar,71,42,29
19,Guadalajara,67,"Cardoso de la Sierra, El",55,34,21
19,Guadalajara,70,Casa de Uceda,100,60,40
19,Guadalajara,71,"Casar, El",13327,6736,6591
19,Guadalajara,73,Casas de San Galindo,19,14,5
19,Guadalajara,74,Caspueñas,138,83,55
19,Guadalajara,75,Castejón de Henares,61,38,23
19,Guadalajara,76,Castellar de la Muela,23,13,10
19,Guadalajara,78,Castilforte,58,35,23
19,Guadalajara,79,Castilnuevo,8,6,2
19,Guadalajara,80,Cendejas de Enmedio,69,38,31
19,Guadalajara,81,Cendejas de la Torre,23,17,6
19,Guadalajara,82,Centenera,147,85,62
19,Guadalajara,103,Checa,285,164,121
19,Guadalajara,104,Chequilla,14,8,6
19,Guadalajara,106,Chillarón del Rey,85,50,35
19,Guadalajara,105,Chiloeches,3977,2063,1914
19,Guadalajara,86,Cifuentes,1682,865,817
19,Guadalajara,87,Cincovillas,23,13,10
19,Guadalajara,88,Ciruelas,141,77,64
19,Guadalajara,89,Ciruelos del Pinar,29,17,12
19,Guadalajara,90,Cobeta,101,49,52
19,Guadalajara,91,Cogollor,21,14,7
19,Guadalajara,92,Cogolludo,561,324,237
19,Guadalajara,95,Condemios de Abajo,12,10,2
19,Guadalajara,96,Condemios de Arriba,116,67,49
19,Guadalajara,97,Congostrina,13,10,3
19,Guadalajara,98,Copernal,38,24,14
19,Guadalajara,99,Corduente,310,175,135
19,Guadalajara,102,"Cubillo de Uceda, El",118,70,48
19,Guadalajara,107,Driebes,349,199,150
19,Guadalajara,108,Durón,115,62,53
19,Guadalajara,109,Embid,30,18,12
19,Guadalajara,110,Escamilla,64,41,23
19,Guadalajara,111,Escariche,188,117,71
19,Guadalajara,112,Escopete,68,36,32
19,Guadalajara,113,Espinosa de Henares,663,340,323
19,Guadalajara,114,Esplegares,37,21,16
19,Guadalajara,115,Establés,29,18,11
19,Guadalajara,116,Estriégana,12,9,3
19,Guadalajara,117,Fontanar,2637,1379,1258
19,Guadalajara,118,Fuembellida,11,7,4
19,Guadalajara,119,Fuencemillán,84,53,31
19,Guadalajara,120,Fuentelahiguera de Albatages,109,65,44
19,Guadalajara,121,Fuentelencina,324,175,149
19,Guadalajara,122,Fuentelsaz,90,46,44
19,Guadalajara,123,Fuentelviejo,53,32,21
19,Guadalajara,124,Fuentenovilla,587,325,262
19,Guadalajara,125,Gajanejos,61,37,24
19,Guadalajara,126,Galápagos,2673,1386,1287
19,Guadalajara,127,Galve de Sorbe,96,53,43
19,Guadalajara,129,Gascueña de Bornova,31,21,10
19,Guadalajara,130,Guadalajara,89010,42787,46223
19,Guadalajara,132,Henche,85,44,41
19,Guadalajara,133,Heras de Ayuso,224,129,95
19,Guadalajara,134,Herrería,20,12,8
19,Guadalajara,135,Hiendelaencina,115,69,46
19,Guadalajara,136,Hijes,20,11,9
19,Guadalajara,138,Hita,319,177,142
19,Guadalajara,139,Hombrados,51,28,23
19,Guadalajara,142,Hontoba,431,242,189
19,Guadalajara,143,Horche,2778,1396,1382
19,Guadalajara,145,Hortezuela de Océn,37,21,16
19,Guadalajara,146,"Huerce, La",56,34,22
19,Guadalajara,147,Huérmeces del Cerro,41,29,12
19,Guadalajara,148,Huertahernando,56,37,19
19,Guadalajara,150,Hueva,112,68,44
19,Guadalajara,151,Humanes,1724,880,844
19,Guadalajara,152,Illana,878,481,397
19,Guadalajara,153,Iniéstola,18,13,5
19,Guadalajara,154,"Inviernas, Las",58,40,18
19,Guadalajara,155,Irueste,68,45,23
19,Guadalajara,156,Jadraque,1417,742,675
19,Guadalajara,157,Jirueque,49,32,17
19,Guadalajara,159,Ledanca,105,52,53
19,Guadalajara,160,Loranca de Tajuña,1509,834,675
19,Guadalajara,161,Lupiana,293,158,135
19,Guadalajara,162,Luzaga,68,37,31
19,Guadalajara,163,Luzón,64,31,33
19,Guadalajara,165,Majaelrayo,53,36,17
19,Guadalajara,166,Málaga del Fresno,172,102,70
19,Guadalajara,167,Malaguilla,193,108,85
19,Guadalajara,168,Mandayona,300,149,151
19,Guadalajara,169,Mantiel,29,18,11
19,Guadalajara,170,Maranchón,213,112,101
19,Guadalajara,171,Marchamalo,8273,4145,4128
19,Guadalajara,172,Masegoso de Tajuña,74,41,33
19,Guadalajara,173,Matarrubia,70,46,24
19,Guadalajara,174,Matillas,104,56,48
19,Guadalajara,175,Mazarete,27,15,12
19,Guadalajara,176,Mazuecos,312,175,137
19,Guadalajara,177,Medranda,68,33,35
19,Guadalajara,178,Megina,31,20,11
19,Guadalajara,179,Membrillera,95,58,37
19,Guadalajara,181,Miedes de Atienza,58,38,20
19,Guadalajara,182,"Mierla, La",40,24,16
19,Guadalajara,184,Millana,113,67,46
19,Guadalajara,183,Milmarcos,70,40,30
19,Guadalajara,185,"Miñosa, La",30,17,13
19,Guadalajara,186,Mirabueno,90,52,38
19,Guadalajara,187,Miralrío,56,34,22
19,Guadalajara,188,Mochales,40,19,21
19,Guadalajara,189,Mohernando,172,97,75
19,Guadalajara,190,Molina de Aragón,3288,1626,1662
19,Guadalajara,191,Monasterio,15,7,8
19,Guadalajara,192,Mondéjar,2839,1478,1361
19,Guadalajara,193,Montarrón,30,19,11
19,Guadalajara,194,Moratilla de los Meleros,107,59,48
19,Guadalajara,195,Morenilla,53,28,25
19,Guadalajara,196,Muduex,109,60,49
19,Guadalajara,197,"Navas de Jadraque, Las",35,22,13
19,Guadalajara,198,Negredo,13,6,7
19,Guadalajara,199,Ocentejo,16,11,5
19,Guadalajara,200,"Olivar, El",87,44,43
19,Guadalajara,201,Olmeda de Cobeta,61,31,30
19,Guadalajara,202,"Olmeda de Jadraque, La",19,12,7
19,Guadalajara,203,"Ordial, El",35,23,12
19,Guadalajara,204,Orea,196,114,82
19,Guadalajara,208,Pálmaces de Jadraque,46,31,15
19,Guadalajara,209,Pardos,37,22,15
19,Guadalajara,210,Paredes de Sigüenza,26,13,13
19,Guadalajara,211,Pareja,464,277,187
19,Guadalajara,212,Pastrana,901,445,456
19,Guadalajara,213,"Pedregal, El",63,43,20
19,Guadalajara,214,Peñalén,79,44,35
19,Guadalajara,215,Peñalver,181,111,70
19,Guadalajara,216,Peralejos de las Truchas,158,78,80
19,Guadalajara,217,Peralveche,83,59,24
19,Guadalajara,218,Pinilla de Jadraque,51,34,17
19,Guadalajara,219,Pinilla de Molina,11,10,1
19,Guadalajara,220,Pioz,5131,2661,2470
19,Guadalajara,221,Piqueras,36,26,10
19,Guadalajara,222,"Pobo de Dueñas, El",100,53,47
19,Guadalajara,223,Poveda de la Sierra,113,63,50
19,Guadalajara,224,Pozo de Almoguera,113,67,46
19,Guadalajara,225,Pozo de Guadalajara,1626,875,751
19,Guadalajara,226,Prádena de Atienza,56,39,17
19,Guadalajara,227,Prados Redondos,50,39,11
19,Guadalajara,228,Puebla de Beleña,52,36,16
19,Guadalajara,229,Puebla de Valles,67,37,30
19,Guadalajara,230,Quer,1031,547,484
19,Guadalajara,231,Rebollosa de Jadraque,10,6,4
19,Guadalajara,232,"Recuenco, El",71,43,28
19,Guadalajara,233,Renera,102,68,34
19,Guadalajara,234,Retiendas,54,35,19
19,Guadalajara,235,Riba de Saelices,103,60,43
19,Guadalajara,237,Rillo de Gallo,44,26,18
19,Guadalajara,238,Riofrío del Llano,64,38,26
19,Guadalajara,239,Robledillo de Mohernando,178,106,72
19,Guadalajara,240,Robledo de Corpes,45,24,21
19,Guadalajara,241,Romanillos de Atienza,31,22,9
19,Guadalajara,242,Romanones,116,64,52
19,Guadalajara,243,Rueda de la Sierra,38,27,11
19,Guadalajara,244,Sacecorbo,102,66,36
19,Guadalajara,245,Sacedón,1566,803,763
19,Guadalajara,246,Saelices de la Sal,47,28,19
19,Guadalajara,247,Salmerón,144,80,64
19,Guadalajara,248,San Andrés del Congosto,75,48,27
19,Guadalajara,249,San Andrés del Rey,39,21,18
19,Guadalajara,250,Santiuste,15,11,4
19,Guadalajara,251,Saúca,47,25,22
19,Guadalajara,252,Sayatón,63,35,28
19,Guadalajara,254,Selas,36,18,18
19,Guadalajara,901,Semillas,30,19,11
19,Guadalajara,255,Setiles,81,47,34
19,Guadalajara,256,Sienes,45,26,19
19,Guadalajara,257,Sigüenza,4708,2428,2280
19,Guadalajara,258,Solanillos del Extremo,86,58,28
19,Guadalajara,259,Somolinos,27,14,13
19,Guadalajara,260,"Sotillo, El",34,17,17
19,Guadalajara,261,Sotodosos,30,17,13
19,Guadalajara,262,Tamajón,148,83,65
19,Guadalajara,263,Taragudo,52,33,19
19,Guadalajara,264,Taravilla,42,27,15
19,Guadalajara,265,Tartanedo,162,90,72
19,Guadalajara,266,Tendilla,312,167,145
19,Guadalajara,267,Terzaga,19,11,8
19,Guadalajara,268,Tierzo,37,19,18
19,Guadalajara,269,"Toba, La",74,51,23
19,Guadalajara,271,Tordellego,43,23,20
19,Guadalajara,270,Tordelrábano,16,12,4
19,Guadalajara,272,Tordesilos,92,51,41
19,Guadalajara,274,Torija,1725,889,836
19,Guadalajara,279,Torre del Burgo,467,268,199
19,Guadalajara,277,Torrecuadrada de Molina,19,13,6
19,Guadalajara,278,Torrecuadradilla,29,17,12
19,Guadalajara,280,Torrejón del Rey,6210,3236,2974
19,Guadalajara,281,Torremocha de Jadraque,20,12,8
19,Guadalajara,282,Torremocha del Campo,191,111,80
19,Guadalajara,283,Torremocha del Pinar,35,18,17
19,Guadalajara,284,Torremochuela,6,5,1
19,Guadalajara,285,Torrubia,23,15,8
19,Guadalajara,286,Tórtola de Henares,1382,733,649
19,Guadalajara,287,Tortuera,169,86,83
19,Guadalajara,288,Tortuero,20,15,5
19,Guadalajara,289,Traíd,22,14,8
19,Guadalajara,290,Trijueque,1560,824,736
19,Guadalajara,291,Trillo,1388,736,652
19,Guadalajara,293,Uceda,3143,1619,1524
19,Guadalajara,294,Ujados,25,12,13
19,Guadalajara,296,Utande,33,25,8
19,Guadalajara,297,Valdarachas,46,23,23
19,Guadalajara,298,Valdearenas,87,50,37
19,Guadalajara,299,Valdeavellano,108,59,49
19,Guadalajara,300,Valdeaveruelo,1206,621,585
19,Guadalajara,301,Valdeconcha,47,30,17
19,Guadalajara,302,Valdegrudas,51,34,17
19,Guadalajara,303,Valdelcubo,38,25,13
19,Guadalajara,304,Valdenuño Fernández,335,183,152
19,Guadalajara,305,Valdepeñas de la Sierra,146,88,58
19,Guadalajara,306,Valderrebollo,29,16,13
19,Guadalajara,307,Valdesotos,29,19,10
19,Guadalajara,308,Valfermoso de Tajuña,85,52,33
19,Guadalajara,309,Valhermoso,21,14,7
19,Guadalajara,310,Valtablado del Río,8,5,3
19,Guadalajara,311,Valverde de los Arroyos,91,52,39
19,Guadalajara,314,Viana de Jadraque,39,25,14
19,Guadalajara,317,Villanueva de Alcorón,140,82,58
19,Guadalajara,318,Villanueva de Argecilla,34,19,15
19,Guadalajara,319,Villanueva de la Torre,6603,3344,3259
19,Guadalajara,321,Villares de Jadraque,46,31,15
19,Guadalajara,322,Villaseca de Henares,24,15,9
19,Guadalajara,323,Villaseca de Uceda,49,28,21
19,Guadalajara,324,Villel de Mesa,164,97,67
19,Guadalajara,325,Viñuelas,186,96,90
19,Guadalajara,326,Yebes,5220,2674,2546
19,Guadalajara,327,Yebra,490,266,224
19,Guadalajara,329,Yélamos de Abajo,59,27,32
19,Guadalajara,330,Yélamos de Arriba,84,50,34
19,Guadalajara,331,Yunquera de Henares,4429,2264,2165
19,Guadalajara,332,"Yunta, La",94,53,41
19,Guadalajara,333,Zaorejas,112,75,37
19,Guadalajara,334,Zarzuela de Jadraque,60,39,21
19,Guadalajara,335,Zorita de los Canes,58,34,24
21,Huelva,1,Alájar,780,400,380
21,Huelva,2,Aljaraque,22259,11095,11164
21,Huelva,3,"Almendro, El",848,435,413
21,Huelva,4,Almonaster la Real,1793,940,853
21,Huelva,5,Almonte,25233,12515,12718
21,Huelva,6,Alosno,3971,1963,2008
21,Huelva,7,Aracena,8340,4118,4222
21,Huelva,8,Aroche,3030,1510,1520
21,Huelva,9,Arroyomolinos de León,943,474,469
21,Huelva,10,Ayamonte,21645,10848,10797
21,Huelva,11,Beas,4359,2179,2180
21,Huelva,12,Berrocal,296,154,142
21,Huelva,13,Bollullos Par del Condado,14263,7065,7198
21,Huelva,14,Bonares,6101,3021,3080
21,Huelva,15,Cabezas Rubias,704,369,335
21,Huelva,16,Cala,1140,574,566
21,Huelva,17,Calañas,2754,1396,1358
21,Huelva,18,"Campillo, El",2015,984,1031
21,Huelva,19,Campofrío,745,378,367
21,Huelva,20,Cañaveral de León,382,198,184
21,Huelva,21,Cartaya,21128,10762,10366
21,Huelva,22,Castaño del Robledo,222,125,97
21,Huelva,23,"Cerro de Andévalo, El",2272,1138,1134
21,Huelva,30,Chucena,2235,1121,1114
21,Huelva,24,Corteconcepción,563,295,268
21,Huelva,25,Cortegana,4649,2346,2303
21,Huelva,26,Cortelazor,299,144,155
21,Huelva,27,Cumbres de Enmedio,63,35,28
21,Huelva,28,Cumbres de San Bartolomé,366,190,176
21,Huelva,29,Cumbres Mayores,1731,857,874
21,Huelva,31,Encinasola,1269,640,629
21,Huelva,32,Escacena del Campo,2325,1121,1204
21,Huelva,33,Fuenteheridos,806,419,387
21,Huelva,34,Galaroza,1381,692,689
21,Huelva,35,Gibraleón,12940,6489,6451
21,Huelva,36,"Granada de Río-Tinto, La",247,121,126
21,Huelva,37,"Granado, El",498,258,240
21,Huelva,38,Higuera de la Sierra,1306,677,629
21,Huelva,39,Hinojales,329,165,164
21,Huelva,40,Hinojos,4094,2066,2028
21,Huelva,41,Huelva,142532,68375,74157
21,Huelva,42,Isla Cristina,21603,10867,10736
21,Huelva,43,Jabugo,2208,1109,1099
21,Huelva,44,Lepe,28813,14879,13934
21,Huelva,45,Linares de la Sierra,283,136,147
21,Huelva,46,Lucena del Puerto,3278,1736,1542
21,Huelva,47,Manzanilla,2147,1097,1050
21,Huelva,48,"Marines, Los",416,217,199
21,Huelva,49,Minas de Riotinto,3703,1775,1928
21,Huelva,50,Moguer,22956,11579,11377
21,Huelva,51,"Nava, La",259,136,123
21,Huelva,52,Nerva,5081,2455,2626
21,Huelva,53,Niebla,4244,2129,2115
21,Huelva,54,"Palma del Condado, La",10726,5344,5382
21,Huelva,55,Palos de la Frontera,12537,6446,6091
21,Huelva,56,Paterna del Campo,3465,1768,1697
21,Huelva,57,Paymogo,1137,570,567
21,Huelva,58,Puebla de Guzmán,3115,1600,1515
21,Huelva,59,Puerto Moral,282,138,144
21,Huelva,60,Punta Umbría,16069,8161,7908
21,Huelva,61,Rociana del Condado,8048,3968,4080
21,Huelva,62,Rosal de la Frontera,1665,811,854
21,Huelva,63,San Bartolomé de la Torre,3997,2035,1962
21,Huelva,64,San Juan del Puerto,9659,4856,4803
21,Huelva,66,San Silvestre de Guzmán,662,343,319
21,Huelva,65,Sanlúcar de Guadiana,422,209,213
21,Huelva,67,Santa Ana la Real,475,223,252
21,Huelva,68,Santa Bárbara de Casa,1102,548,554
21,Huelva,69,Santa Olalla del Cala,2038,1038,1000
21,Huelva,70,Trigueros,7989,3950,4039
21,Huelva,71,Valdelarco,243,118,125
21,Huelva,72,Valverde del Camino,12655,6230,6425
21,Huelva,73,Villablanca,2921,1472,1449
21,Huelva,74,Villalba del Alcor,3335,1633,1702
21,Huelva,75,Villanueva de las Cruces,393,192,201
21,Huelva,76,Villanueva de los Castillejos,2953,1500,1453
21,Huelva,77,Villarrasa,2148,1077,1071
21,Huelva,78,Zalamea la Real,2973,1488,1485
21,Huelva,902,"Zarza-Perrunal, La",1215,613,602
21,Huelva,79,Zufre,753,394,359
22,Huesca,1,Abiego,261,134,127
22,Huesca,2,Abizanda,162,87,75
22,Huesca,3,Adahuesca,210,118,92
22,Huesca,4,Agüero,143,82,61
22,Huesca,907,Aínsa-Sobrarbe,2297,1161,1136
22,Huesca,6,Aisa,324,175,149
22,Huesca,7,Albalate de Cinca,1138,630,508
22,Huesca,8,Albalatillo,200,111,89
22,Huesca,9,Albelda,702,357,345
22,Huesca,11,Albero Alto,125,72,53
22,Huesca,12,Albero Bajo,130,72,58
22,Huesca,13,Alberuela de Tubo,308,159,149
22,Huesca,14,Alcalá de Gurrea,231,120,111
22,Huesca,15,Alcalá del Obispo,370,210,160
22,Huesca,16,Alcampell,624,293,331
22,Huesca,17,Alcolea de Cinca,1092,573,519
22,Huesca,18,Alcubierre,412,224,188
22,Huesca,19,Alerre,221,121,100
22,Huesca,20,Alfántega,130,66,64
22,Huesca,21,Almudévar,2439,1230,1209
22,Huesca,22,Almunia de San Juan,722,374,348
22,Huesca,23,Almuniente,440,230,210
22,Huesca,24,Alquézar,348,179,169
22,Huesca,25,Altorricón,1429,778,651
22,Huesca,27,Angüés,373,198,175
22,Huesca,28,Ansó,418,206,212
22,Huesca,29,Antillón,133,70,63
22,Huesca,32,Aragüés del Puerto,120,68,52
22,Huesca,35,Arén,308,165,143
22,Huesca,36,Argavieso,119,71,48
22,Huesca,37,Arguis,160,85,75
22,Huesca,39,Ayerbe,1073,530,543
22,Huesca,40,Azanuy-Alins,175,86,89
22,Huesca,41,Azara,170,91,79
22,Huesca,42,Azlor,154,70,84
22,Huesca,43,Baélls,91,53,38
22,Huesca,44,Bailo,262,162,100
22,Huesca,45,Baldellou,90,53,37
22,Huesca,46,Ballobar,879,454,425
22,Huesca,47,Banastás,334,168,166
22,Huesca,48,Barbastro,17295,8436,8859
22,Huesca,49,Barbués,86,52,34
22,Huesca,50,Barbuñales,96,48,48
22,Huesca,51,Bárcabo,117,64,53
22,Huesca,52,Belver de Cinca,1306,750,556
22,Huesca,53,Benabarre,1168,600,568
22,Huesca,54,Benasque,2306,1245,1061
22,Huesca,246,Beranuy,68,41,27
22,Huesca,55,Berbegal,322,170,152
22,Huesca,57,Bielsa,482,253,229
22,Huesca,58,Bierge,253,143,110
22,Huesca,59,Biescas,1602,845,757
22,Huesca,60,Binaced,1577,865,712
22,Huesca,61,Binéfar,10070,5320,4750
22,Huesca,62,Bisaurri,183,100,83
22,Huesca,63,Biscarrués,186,97,89
22,Huesca,64,Blecua y Torres,186,100,86
22,Huesca,66,Boltaña,1104,585,519
22,Huesca,67,Bonansa,92,51,41
22,Huesca,68,Borau,87,49,38
22,Huesca,69,Broto,599,327,272
22,Huesca,72,Caldearenas,242,144,98
22,Huesca,74,Campo,463,246,217
22,Huesca,75,Camporrélls,151,78,73
22,Huesca,76,Canal de Berdún,337,184,153
22,Huesca,77,Candasnos,418,227,191
22,Huesca,78,Canfranc,596,334,262
22,Huesca,79,Capdesaso,204,88,116
22,Huesca,80,Capella,360,187,173
22,Huesca,81,Casbas de Huesca,291,167,124
22,Huesca,83,Castejón de Monegros,478,254,224
22,Huesca,84,Castejón de Sos,833,420,413
22,Huesca,82,Castejón del Puente,328,173,155
22,Huesca,85,Castelflorite,102,51,51
22,Huesca,86,Castiello de Jaca,242,134,108
22,Huesca,87,Castigaleu,96,60,36
22,Huesca,88,Castillazuelo,162,84,78
22,Huesca,89,Castillonroy,324,173,151
22,Huesca,94,Chalamera,130,71,59
22,Huesca,95,Chía,92,57,35
22,Huesca,96,Chimillas,396,208,188
22,Huesca,90,Colungo,128,71,57
22,Huesca,99,Esplús,673,350,323
22,Huesca,102,Estada,203,119,84
22,Huesca,103,Estadilla,840,424,416
22,Huesca,105,Estopiñán del Castillo,116,60,56
22,Huesca,106,Fago,26,16,10
22,Huesca,107,Fanlo,113,67,46
22,Huesca,109,Fiscal,386,213,173
22,Huesca,110,Fonz,886,453,433
22,Huesca,111,Foradada del Toscar,158,86,72
22,Huesca,112,Fraga,15373,7858,7515
22,Huesca,113,"Fueva, La",600,318,282
22,Huesca,114,Gistaín,122,71,51
22,Huesca,115,"Grado, El",391,203,188
22,Huesca,116,Grañén,1731,891,840
22,Huesca,117,Graus,3415,1687,1728
22,Huesca,119,Gurrea de Gállego,1450,746,704
22,Huesca,122,Hoz de Jaca,76,40,36
22,Huesca,908,Hoz y Costean,240,134,106
22,Huesca,124,Huerto,228,123,105
22,Huesca,125,Huesca,54136,25912,28224
22,Huesca,126,Ibieca,108,60,48
22,Huesca,127,Igriés,719,376,343
22,Huesca,128,Ilche,188,97,91
22,Huesca,129,Isábena,233,117,116
22,Huesca,130,Jaca,13620,6658,6962
22,Huesca,131,Jasa,102,61,41
22,Huesca,133,Labuerda,162,84,78
22,Huesca,135,Laluenga,202,107,95
22,Huesca,136,Lalueza,882,459,423
22,Huesca,137,Lanaja,1173,626,547
22,Huesca,139,Laperdiguera,91,46,45
22,Huesca,141,Lascellas-Ponzano,135,83,52
22,Huesca,142,Lascuarre,138,69,69
22,Huesca,143,Laspaúles,234,125,109
22,Huesca,144,Laspuña,279,159,120
22,Huesca,149,Loarre,350,194,156
22,Huesca,150,Loporzano,580,318,262
22,Huesca,151,Loscorrales,99,49,50
22,Huesca,905,Lupiñén-Ortilla,342,173,169
22,Huesca,155,Monesma y Cajigar,66,37,29
22,Huesca,156,Monflorite-Lascasas,468,247,221
22,Huesca,157,Montanuy,241,140,101
22,Huesca,158,Monzón,17839,9020,8819
22,Huesca,160,Naval,265,145,120
22,Huesca,162,Novales,172,79,93
22,Huesca,163,Nueno,574,327,247
22,Huesca,164,Olvena,67,32,35
22,Huesca,165,Ontiñena,519,270,249
22,Huesca,167,Osso de Cinca,638,366,272
22,Huesca,168,Palo,32,16,16
22,Huesca,170,Panticosa,894,474,420
22,Huesca,172,Peñalba,726,424,302
22,Huesca,173,"Peñas de Riglos, Las",272,172,100
22,Huesca,174,Peralta de Alcofea,614,308,306
22,Huesca,175,Peralta de Calasanz,272,148,124
22,Huesca,176,Peraltilla,225,107,118
22,Huesca,177,Perarrúa,113,58,55
22,Huesca,178,Pertusa,137,79,58
22,Huesca,181,Piracés,96,48,48
22,Huesca,182,Plan,281,146,135
22,Huesca,184,Poleñino,197,102,95
22,Huesca,186,Pozán de Vero,235,113,122
22,Huesca,187,"Puebla de Castro, La",419,219,200
22,Huesca,188,Puente de Montañana,100,48,52
22,Huesca,902,Puente la Reina de Jaca,276,144,132
22,Huesca,189,Puértolas,222,116,106
22,Huesca,190,"Pueyo de Araguás, El",173,96,77
22,Huesca,193,Pueyo de Santa Cruz,329,159,170
22,Huesca,195,Quicena,329,157,172
22,Huesca,197,Robres,523,276,247
22,Huesca,199,Sabiñánigo,9423,4703,4720
22,Huesca,200,Sahún,319,158,161
22,Huesca,201,Salas Altas,312,164,148
22,Huesca,202,Salas Bajas,191,95,96
22,Huesca,203,Salillas,104,58,46
22,Huesca,204,Sallent de Gállego,1554,784,770
22,Huesca,205,San Esteban de Litera,620,325,295
22,Huesca,207,San Juan de Plan,154,84,70
22,Huesca,903,San Miguel del Cinca,799,414,385
22,Huesca,206,Sangarrén,211,119,92
22,Huesca,208,Santa Cilia,251,127,124
22,Huesca,209,Santa Cruz de la Serós,192,109,83
22,Huesca,906,Santa María de Dulcis,206,114,92
22,Huesca,212,Santaliestra y San Quílez,77,48,29
22,Huesca,213,Sariñena,4131,2144,1987
22,Huesca,214,Secastilla,148,70,78
22,Huesca,215,Seira,161,92,69
22,Huesca,217,Sena,486,261,225
22,Huesca,218,Senés de Alcubierre,45,21,24
22,Huesca,220,Sesa,157,91,66
22,Huesca,221,Sesué,126,65,61
22,Huesca,222,Siétamo,686,385,301
22,Huesca,223,Sopeira,91,50,41
22,Huesca,904,"Sotonera, La",915,489,426
22,Huesca,225,Tamarite de Litera,3393,1756,1637
22,Huesca,226,Tardienta,929,460,469
22,Huesca,227,Tella-Sin,227,127,100
22,Huesca,228,Tierz,823,405,418
22,Huesca,229,Tolva,125,70,55
22,Huesca,230,Torla-Ordesa,312,164,148
22,Huesca,232,Torralba de Aragón,109,63,46
22,Huesca,233,Torre la Ribera,97,50,47
22,Huesca,234,Torrente de Cinca,1121,585,536
22,Huesca,235,Torres de Alcanadre,82,47,35
22,Huesca,236,Torres de Barbués,260,127,133
22,Huesca,239,Tramaced,108,68,40
22,Huesca,242,Valfarta,62,37,25
22,Huesca,243,Valle de Bardají,60,39,21
22,Huesca,901,Valle de Hecho,799,432,367
22,Huesca,244,Valle de Lierp,60,38,22
22,Huesca,245,Velilla de Cinca,497,264,233
22,Huesca,909,Vencillón,408,221,187
22,Huesca,247,Viacamp y Litera,40,25,15
22,Huesca,248,Vicién,139,82,57
22,Huesca,249,Villanova,176,91,85
22,Huesca,250,Villanúa,553,288,265
22,Huesca,251,Villanueva de Sigena,341,188,153
22,Huesca,252,Yebra de Basa,161,95,66
22,Huesca,253,Yésero,63,34,29
22,Huesca,254,Zaidín,1784,926,858
23,Jaén,1,Albanchez de Mágina,958,501,457
23,Jaén,2,Alcalá la Real,21587,10672,10915
23,Jaén,3,Alcaudete,10265,5048,5217
23,Jaén,4,Aldeaquemada,468,245,223
23,Jaén,5,Andújar,35788,17469,18319
23,Jaén,6,Arjona,5349,2633,2716
23,Jaén,7,Arjonilla,3539,1792,1747
23,Jaén,8,Arquillos,1680,852,828
23,Jaén,905,Arroyo del Ojanco,2187,1102,1085
23,Jaén,9,Baeza,15723,7796,7927
23,Jaén,10,Bailén,17211,8535,8676
23,Jaén,11,Baños de la Encina,2558,1305,1253
23,Jaén,12,Beas de Segura,4984,2576,2408
23,Jaén,902,Bedmar y Garcíez,2605,1322,1283
23,Jaén,14,Begíjar,2967,1493,1474
23,Jaén,15,Bélmez de la Moraleda,1525,743,782
23,Jaén,16,Benatae,437,223,214
23,Jaén,17,Cabra del Santo Cristo,1695,885,810
23,Jaén,18,Cambil,2643,1383,1260
23,Jaén,19,Campillo de Arenas,1708,859,849
23,Jaén,20,Canena,1780,935,845
23,Jaén,21,Carboneros,606,311,295
23,Jaén,901,Cárcheles,1300,686,614
23,Jaén,24,"Carolina, La",14801,7340,7461
23,Jaén,25,Castellar,3173,1610,1563
23,Jaén,26,Castillo de Locubín,3901,1930,1971
23,Jaén,27,Cazalilla,738,368,370
23,Jaén,28,Cazorla,7067,3432,3635
23,Jaén,29,Chiclana de Segura,896,462,434
23,Jaén,30,Chilluévar,1363,676,687
23,Jaén,31,Escañuela,934,459,475
23,Jaén,32,Espeluy,604,300,304
23,Jaén,33,Frailes,1565,781,784
23,Jaén,34,Fuensanta de Martos,3023,1524,1499
23,Jaén,35,Fuerte del Rey,1352,703,649
23,Jaén,37,Génave,561,298,263
23,Jaén,38,"Guardia de Jaén, La",5175,2644,2531
23,Jaén,39,Guarromán,2782,1426,1356
23,Jaén,41,Higuera de Calatrava,605,321,284
23,Jaén,42,Hinojares,348,180,168
23,Jaén,43,Hornos,574,278,296
23,Jaén,44,Huelma,5559,2742,2817
23,Jaén,45,Huesa,2436,1225,1211
23,Jaén,46,Ibros,2737,1376,1361
23,Jaén,47,"Iruela, La",1881,943,938
23,Jaén,48,Iznatoraf,902,451,451
23,Jaén,49,Jabalquinto,1962,989,973
23,Jaén,50,Jaén,111888,53724,58164
23,Jaén,51,Jamilena,3319,1664,1655
23,Jaén,52,Jimena,1223,595,628
23,Jaén,53,Jódar,11449,5705,5744
23,Jaén,40,Lahiguera,1604,794,810
23,Jaén,54,Larva,444,231,213
23,Jaén,55,Linares,55096,26884,28212
23,Jaén,56,Lopera,3579,1830,1749
23,Jaén,57,Lupión,806,392,414
23,Jaén,58,Mancha Real,11375,5660,5715
23,Jaén,59,Marmolejo,6586,3290,3296
23,Jaén,60,Martos,24363,12087,12276
23,Jaén,61,Mengíbar,10041,5014,5027
23,Jaén,62,Montizón,1606,824,782
23,Jaén,63,Navas de San Juan,4427,2241,2186
23,Jaén,64,Noalejo,1826,931,895
23,Jaén,65,Orcera,1735,869,866
23,Jaén,66,Peal de Becerro,5325,2660,2665
23,Jaén,67,Pegalajar,2822,1429,1393
23,Jaén,69,Porcuna,5975,3008,2967
23,Jaén,70,Pozo Alcón,4594,2374,2220
23,Jaén,71,Puente de Génave,2168,1108,1060
23,Jaén,72,"Puerta de Segura, La",2226,1113,1113
23,Jaén,73,Quesada,5015,2547,2468
23,Jaén,74,Rus,3453,1750,1703
23,Jaén,75,Sabiote,3823,1894,1929
23,Jaén,76,Santa Elena,866,451,415
23,Jaén,77,Santiago de Calatrava,657,345,312
23,Jaén,904,Santiago-Pontones,2729,1415,1314
23,Jaén,79,Santisteban del Puerto,4442,2285,2157
23,Jaén,80,Santo Tomé,2081,1063,1018
23,Jaén,81,Segura de la Sierra,1710,844,866
23,Jaén,82,Siles,2137,1083,1054
23,Jaén,84,Sorihuela del Guadalimar,1043,542,501
23,Jaén,85,Torreblascopedro,2434,1237,1197
23,Jaén,86,Torredelcampo,13871,6945,6926
23,Jaén,87,Torredonjimeno,13301,6563,6738
23,Jaén,88,Torreperogil,7108,3480,3628
23,Jaén,90,Torres,1349,697,652
23,Jaén,91,Torres de Albánchez,746,391,355
23,Jaén,92,Úbeda,33810,16476,17334
23,Jaén,93,Valdepeñas de Jaén,3566,1761,1805
23,Jaén,94,Vilches,4238,2129,2109
23,Jaén,95,Villacarrillo,10344,5222,5122
23,Jaén,96,Villanueva de la Reina,2964,1499,1465
23,Jaén,97,Villanueva del Arzobispo,7933,4091,3842
23,Jaén,98,Villardompardo,920,459,461
23,Jaén,99,"Villares, Los",6079,3059,3020
23,Jaén,101,Villarrodrigo,383,208,175
23,Jaén,903,Villatorres,4261,2179,2082
24,León,1,Acebedo,182,102,80
24,León,2,Algadefe,290,150,140
24,León,3,Alija del Infantado,593,302,291
24,León,4,Almanza,626,350,276
24,León,5,"Antigua, La",331,192,139
24,León,6,Ardón,558,308,250
24,León,7,Arganza,798,405,393
24,León,8,Astorga,10321,4837,5484
24,León,9,Balboa,261,147,114
24,León,10,"Bañeza, La",10047,4805,5242
24,León,11,Barjas,160,91,69
24,León,12,"Barrios de Luna, Los",300,173,127
24,León,14,Bembibre,8196,3934,4262
24,León,15,Benavides,2367,1176,1191
24,León,16,Benuza,455,275,180
24,León,17,Bercianos del Páramo,524,269,255
24,León,18,Bercianos del Real Camino,186,101,85
24,León,19,Berlanga del Bierzo,322,148,174
24,León,20,Boca de Huérgano,435,256,179
24,León,21,Boñar,1804,922,882
24,León,22,Borrenes,304,167,137
24,León,23,Brazuelo,323,178,145
24,León,24,"Burgo Ranero, El",683,359,324
24,León,25,Burón,294,172,122
24,León,26,Bustillo del Páramo,1076,561,515
24,León,27,Cabañas Raras,1316,691,625
24,León,28,Cabreros del Río,401,218,183
24,León,29,Cabrillanes,719,381,338
24,León,30,Cacabelos,4793,2363,2430
24,León,31,Calzada del Coto,222,132,90
24,León,32,Campazas,109,55,54
24,León,33,Campo de Villavidel,200,113,87
24,León,34,Camponaraya,4096,2033,2063
24,León,36,Candín,283,156,127
24,León,37,Cármenes,337,191,146
24,León,38,Carracedelo,3431,1718,1713
24,León,39,Carrizo,2208,1112,1096
24,León,40,Carrocera,445,232,213
24,León,41,Carucedo,495,247,248
24,León,42,Castilfalé,65,39,26
24,León,43,Castrillo de Cabrera,106,64,42
24,León,44,Castrillo de la Valduerna,142,69,73
24,León,46,Castrocalbón,925,483,442
24,León,47,Castrocontrigo,682,378,304
24,León,49,Castropodame,1588,823,765
24,León,50,Castrotierra de Valmadrigal,107,55,52
24,León,51,Cea,378,199,179
24,León,52,Cebanico,144,84,60
24,León,53,Cebrones del Río,435,238,197
24,León,65,Chozas de Abajo,2677,1369,1308
24,León,54,Cimanes de la Vega,441,222,219
24,León,55,Cimanes del Tejar,742,405,337
24,León,56,Cistierna,2951,1455,1496
24,León,57,Congosto,1436,714,722
24,León,58,Corbillos de los Oteros,183,103,80
24,León,59,Corullón,849,431,418
24,León,60,Crémenes,530,286,244
24,León,61,Cuadros,2088,1053,1035
24,León,62,Cubillas de los Oteros,138,77,61
24,León,63,Cubillas de Rueda,393,211,182
24,León,64,Cubillos del Sil,1741,910,831
24,León,66,Destriana,431,206,225
24,León,67,Encinedo,623,335,288
24,León,68,"Ercina, La",442,235,207
24,León,69,Escobar de Campos,33,21,12
24,León,70,Fabero,4112,2019,2093
24,León,71,Folgoso de la Ribera,1005,488,517
24,León,73,Fresno de la Vega,464,236,228
24,León,74,Fuentes de Carbajal,77,50,27
24,León,76,Garrafe de Torío,1646,878,768
24,León,77,Gordaliza del Pino,246,119,127
24,León,78,Gordoncillo,325,160,165
24,León,79,Gradefes,944,521,423
24,León,80,Grajal de Campos,221,114,107
24,León,81,Gusendos de los Oteros,128,64,64
24,León,82,Hospital de Órbigo,961,480,481
24,León,83,Igüeña,1083,561,522
24,León,84,Izagre,143,72,71
24,León,86,Joarilla de las Matas,240,131,109
24,León,87,Laguna Dalga,621,339,282
24,León,88,Laguna de Negrillos,1050,535,515
24,León,89,León,121281,54837,66444
24,León,92,Llamas de la Ribera,798,420,378
24,León,90,Lucillo,361,188,173
24,León,91,Luyego,568,316,252
24,León,93,Magaz de Cepeda,354,191,163
24,León,94,Mansilla de las Mulas,1654,841,813
24,León,95,Mansilla Mayor,324,174,150
24,León,96,Maraña,120,76,44
24,León,97,Matadeón de los Oteros,224,114,110
24,León,98,Matallana de Torío,1258,649,609
24,León,99,Matanza,174,96,78
24,León,100,Molinaseca,872,478,394
24,León,101,Murias de Paredes,349,189,160
24,León,102,Noceda del Bierzo,613,315,298
24,León,103,Oencia,284,167,117
24,León,104,"Omañas, Las",257,137,120
24,León,105,Onzonilla,1880,968,912
24,León,106,Oseja de Sajambre,230,140,90
24,León,107,Pajares de los Oteros,241,144,97
24,León,108,Palacios de la Valduerna,351,174,177
24,León,109,Palacios del Sil,867,479,388
24,León,110,Páramo del Sil,1214,623,591
24,León,112,Peranzanes,270,161,109
24,León,113,Pobladura de Pelayo García,354,182,172
24,León,114,"Pola de Gordón, La",2880,1450,1430
24,León,115,Ponferrada,62963,29727,33236
24,León,116,Posada de Valdeón,420,240,180
24,León,117,Pozuelo del Páramo,405,195,210
24,León,118,Prado de la Guzpeña,109,64,45
24,León,119,Priaranza del Bierzo,731,358,373
24,León,120,Prioro,347,202,145
24,León,121,Puebla de Lillo,674,381,293
24,León,122,Puente de Domingo Flórez,1406,729,677
24,León,123,Quintana del Castillo,724,397,327
24,León,124,Quintana del Marco,332,186,146
24,León,125,Quintana y Congosto,416,221,195
24,León,127,Regueras de Arriba,264,140,124
24,León,129,Reyero,127,70,57
24,León,130,Riaño,474,260,214
24,León,131,Riego de la Vega,718,387,331
24,León,132,Riello,603,341,262
24,León,133,Rioseco de Tapia,382,212,170
24,León,134,"Robla, La",3637,1801,1836
24,León,136,Roperuelos del Páramo,505,257,248
24,León,137,Sabero,1046,532,514
24,León,139,Sahagún,2456,1202,1254
24,León,141,San Adrián del Valle,92,54,38
24,León,142,San Andrés del Rabanedo,29961,14246,15715
24,León,144,San Cristóbal de la Polantera,642,332,310
24,León,145,San Emiliano,602,344,258
24,León,146,San Esteban de Nogales,253,132,121
24,León,148,San Justo de la Vega,1761,905,856
24,León,149,San Millán de los Caballeros,177,94,83
24,León,150,San Pedro Bercianos,227,121,106
24,León,143,Sancedo,532,275,257
24,León,151,Santa Colomba de Curueño,496,257,239
24,León,152,Santa Colomba de Somoza,496,270,226
24,León,153,Santa Cristina de Valmadrigal,281,142,139
24,León,154,Santa Elena de Jamuz,1038,548,490
24,León,155,Santa María de la Isla,453,236,217
24,León,158,Santa María de Ordás,337,189,148
24,León,156,Santa María del Monte de Cea,212,117,95
24,León,157,Santa María del Páramo,3041,1485,1556
24,León,159,Santa Marina del Rey,1772,883,889
24,León,160,Santas Martas,732,390,342
24,León,161,Santiago Millas,364,205,159
24,León,162,Santovenia de la Valdoncina,2081,1047,1034
24,León,163,Sariegos,5413,2683,2730
24,León,164,Sena de Luna,395,194,201
24,León,165,Sobrado,302,153,149
24,León,166,Soto de la Vega,1487,783,704
24,León,167,Soto y Amío,729,369,360
24,León,168,Toral de los Guzmanes,499,276,223
24,León,206,Toral de los Vados,1779,888,891
24,León,169,Toreno,2898,1459,1439
24,León,170,Torre del Bierzo,2026,1035,991
24,León,171,Trabadelo,337,190,147
24,León,172,Truchas,404,218,186
24,León,173,Turcia,973,495,478
24,León,174,Urdiales del Páramo,457,246,211
24,León,185,Val de San Lorenzo,502,242,260
24,León,175,Valdefresno,2302,1199,1103
24,León,176,Valdefuentes del Páramo,308,167,141
24,León,177,Valdelugueros,507,283,224
24,León,178,Valdemora,66,28,38
24,León,179,Valdepiélago,288,167,121
24,León,180,Valdepolo,1197,645,552
24,León,181,Valderas,1524,786,738
24,León,182,Valderrey,425,220,205
24,León,183,Valderrueda,831,459,372
24,León,184,Valdesamario,179,103,76
24,León,187,Valdevimbre,905,468,437
24,León,188,Valencia de Don Juan,5185,2534,2651
24,León,191,Vallecillo,105,62,43
24,León,189,Valverde de la Virgen,7687,3969,3718
24,León,190,Valverde-Enrique,156,78,78
24,León,193,"Vecilla, La",384,213,171
24,León,196,Vega de Espinareda,2016,1027,989
24,León,197,Vega de Infanzones,848,431,417
24,León,198,Vega de Valcarce,561,285,276
24,León,194,Vegacervera,262,137,125
24,León,199,Vegaquemada,437,251,186
24,León,201,Vegas del Condado,1157,659,498
24,León,202,Villablino,7845,3793,4052
24,León,203,Villabraz,113,64,49
24,León,205,Villadangos del Páramo,1222,627,595
24,León,207,Villademor de la Vega,284,148,136
24,León,209,Villafranca del Bierzo,2694,1289,1405
24,León,210,Villagatón,661,373,288
24,León,211,Villamandos,282,148,134
24,León,901,Villamanín,894,467,427
24,León,212,Villamañán,1067,550,517
24,León,213,Villamartín de Don Sancho,162,87,75
24,León,214,Villamejil,652,354,298
24,León,215,Villamol,134,69,65
24,León,216,Villamontán de la Valduerna,693,352,341
24,León,217,Villamoratiel de las Matas,127,71,56
24,León,218,Villanueva de las Manzanas,496,256,240
24,León,219,Villaobispo de Otero,532,292,240
24,León,902,Villaornate y Castro,345,172,173
24,León,221,Villaquejida,808,409,399
24,León,222,Villaquilambre,18765,9309,9456
24,León,223,Villarejo de Órbigo,2908,1431,1477
24,León,224,Villares de Órbigo,567,304,263
24,León,225,Villasabariego,1121,581,540
24,León,226,Villaselán,181,103,78
24,León,227,Villaturiel,1886,979,907
24,León,228,Villazala,612,335,277
24,León,229,Villazanzo de Valderaduey,379,220,159
24,León,230,Zotes del Páramo,408,226,182
25,Lleida,1,Abella de la Conca,167,87,80
25,Lleida,2,Àger,582,320,262
25,Lleida,3,Agramunt,5516,2773,2743
25,Lleida,38,Aitona,2557,1349,1208
25,Lleida,4,"Alamús, Els",794,398,396
25,Lleida,5,Alàs i Cerc,322,158,164
25,Lleida,6,"Albagés, L'",356,189,167
25,Lleida,7,Albatàrrec,2238,1142,1096
25,Lleida,8,Albesa,1588,852,736
25,Lleida,9,"Albi, L'",764,388,376
25,Lleida,10,Alcanó,243,123,120
25,Lleida,11,Alcarràs,9787,5071,4716
25,Lleida,12,Alcoletge,3495,1863,1632
25,Lleida,13,Alfarràs,2783,1450,1333
25,Lleida,14,Alfés,286,156,130
25,Lleida,15,Algerri,434,233,201
25,Lleida,16,Alguaire,3012,1592,1420
25,Lleida,17,Alins,282,153,129
25,Lleida,19,Almacelles,6847,3685,3162
25,Lleida,20,Almatret,307,172,135
25,Lleida,21,Almenar,3379,1811,1568
25,Lleida,22,Alòs de Balaguer,114,66,48
25,Lleida,23,Alpicat,6394,3206,3188
25,Lleida,24,Alt Àneu,447,257,190
25,Lleida,27,Anglesola,1361,686,675
25,Lleida,29,Arbeca,2109,1078,1031
25,Lleida,31,Arres,71,49,22
25,Lleida,32,Arsèguel,77,41,36
25,Lleida,33,Artesa de Lleida,1512,802,710
25,Lleida,34,Artesa de Segre,3504,1813,1691
25,Lleida,36,Aspa,217,111,106
25,Lleida,37,"Avellanes i Santa Linya, Les",445,246,199
25,Lleida,39,Baix Pallars,349,188,161
25,Lleida,40,Balaguer,17649,9053,8596
25,Lleida,41,Barbens,929,518,411
25,Lleida,42,"Baronia de Rialb, La",225,118,107
25,Lleida,44,Bassella,221,120,101
25,Lleida,45,Bausen,70,38,32
25,Lleida,46,Belianes,510,248,262
25,Lleida,170,Bellaguarda,289,151,138
25,Lleida,47,Bellcaire d'Urgell,1231,626,605
25,Lleida,48,Bell-lloc d'Urgell,2378,1195,1183
25,Lleida,49,Bellmunt d'Urgell,176,94,82
25,Lleida,50,Bellpuig,5150,2726,2424
25,Lleida,51,Bellver de Cerdanya,2250,1155,1095
25,Lleida,52,Bellvís,2263,1160,1103
25,Lleida,53,Benavent de Segrià,1579,831,748
25,Lleida,55,Biosca,184,101,83
25,Lleida,57,"Bòrdes, Es",278,156,122
25,Lleida,58,"Borges Blanques, Les",6215,3171,3044
25,Lleida,59,Bossòst,1137,555,582
25,Lleida,56,Bovera,258,138,120
25,Lleida,60,Cabanabona,61,28,33
25,Lleida,61,Cabó,99,50,49
25,Lleida,62,Camarasa,786,402,384
25,Lleida,63,Canejan,97,50,47
25,Lleida,904,Castell de Mur,179,99,80
25,Lleida,64,Castellar de la Ribera,142,73,69
25,Lleida,67,Castelldans,893,466,427
25,Lleida,68,Castellnou de Seana,706,372,334
25,Lleida,69,Castelló de Farfanya,531,279,252
25,Lleida,70,Castellserà,989,509,480
25,Lleida,71,Cava,44,29,15
25,Lleida,72,Cervera,9453,4820,4633
25,Lleida,73,Cervià de les Garrigues,645,351,294
25,Lleida,74,Ciutadilla,188,100,88
25,Lleida,75,Clariana de Cardener,158,83,75
25,Lleida,76,"Cogul, El",155,88,67
25,Lleida,77,Coll de Nargó,568,296,272
25,Lleida,163,"Coma i la Pedra, La",275,155,120
25,Lleida,161,Conca de Dalt,436,228,208
25,Lleida,78,Corbins,1486,809,677
25,Lleida,79,Cubells,344,180,164
25,Lleida,81,"Espluga Calba, L'",324,164,160
25,Lleida,82,Espot,386,209,177
25,Lleida,88,Estamariu,133,75,58
25,Lleida,85,Estaràs,164,84,80
25,Lleida,86,Esterri d'Àneu,874,434,440
25,Lleida,87,Esterri de Cardós,61,31,30
25,Lleida,89,Farrera,124,69,55
25,Lleida,908,Fígols i Alinyà,255,148,107
25,Lleida,92,"Floresta, La",155,89,66
25,Lleida,93,Fondarella,780,390,390
25,Lleida,94,Foradada,179,100,79
25,Lleida,96,"Fuliola, La",1223,611,612
25,Lleida,97,Fulleda,87,46,41
25,Lleida,98,Gavet de la Conca,257,125,132
25,Lleida,912,Gimenells i el Pla de la Font,1108,590,518
25,Lleida,99,Golmés,1902,967,935
25,Lleida,100,Gósol,230,126,104
25,Lleida,101,"Granadella, La",750,427,323
25,Lleida,102,"Granja d'Escarp, La",927,535,392
25,Lleida,103,Granyanella,149,85,64
25,Lleida,105,Granyena de les Garrigues,157,96,61
25,Lleida,104,Granyena de Segarra,152,81,71
25,Lleida,109,Guimerà,255,139,116
25,Lleida,903,"Guingueta d'Àneu, La",285,156,129
25,Lleida,110,Guissona,7603,4033,3570
25,Lleida,111,Guixers,131,77,54
25,Lleida,115,Isona i Conca Dellà,1061,578,483
25,Lleida,112,Ivars de Noguera,332,179,153
25,Lleida,113,Ivars d'Urgell,1607,868,739
25,Lleida,114,Ivorra,99,56,43
25,Lleida,910,Josa i Tuixén,125,74,51
25,Lleida,118,Juncosa,382,197,185
25,Lleida,119,Juneda,3478,1845,1633
25,Lleida,121,Les,994,510,484
25,Lleida,122,Linyola,2744,1387,1357
25,Lleida,123,Lladorre,254,131,123
25,Lleida,124,Lladurs,185,100,85
25,Lleida,125,Llardecans,419,226,193
25,Lleida,126,Llavorsí,343,171,172
25,Lleida,120,Lleida,143094,71273,71821
25,Lleida,127,Lles de Cerdanya,292,172,120
25,Lleida,128,Llimiana,133,75,58
25,Lleida,129,Llobera,212,122,90
25,Lleida,133,Maials,908,504,404
25,Lleida,130,Maldà,240,120,120
25,Lleida,131,Massalcoreig,563,314,249
25,Lleida,132,Massoteres,215,111,104
25,Lleida,134,Menàrguens,774,407,367
25,Lleida,135,Miralcamp,1366,703,663
25,Lleida,137,Mollerussa,15037,7747,7290
25,Lleida,136,"Molsosa, La",102,48,54
25,Lleida,139,Montellà i Martinet,631,332,299
25,Lleida,140,Montferrer i Castellbò,1093,586,507
25,Lleida,138,Montgai,633,328,305
25,Lleida,142,Montoliu de Lleida,483,250,233
25,Lleida,141,Montoliu de Segarra,183,105,78
25,Lleida,143,Montornès de Segarra,91,44,47
25,Lleida,145,Nalec,94,53,41
25,Lleida,25,Naut Aran,1921,1001,920
25,Lleida,146,Navès,315,157,158
25,Lleida,148,Odèn,248,141,107
25,Lleida,149,Oliana,1864,921,943
25,Lleida,150,Oliola,198,106,92
25,Lleida,151,Olius,995,514,481
25,Lleida,152,"Oluges, Les",164,92,72
25,Lleida,153,"Omellons, Els",197,105,92
25,Lleida,154,"Omells de na Gaia, Els",120,66,54
25,Lleida,155,Organyà,797,409,388
25,Lleida,156,Os de Balaguer,1083,543,540
25,Lleida,157,Ossó de Sió,197,100,97
25,Lleida,158,"Palau d'Anglesola, El",2188,1084,1104
25,Lleida,164,Penelles,428,247,181
25,Lleida,165,Peramola,345,175,170
25,Lleida,166,Pinell de Solsonès,194,108,86
25,Lleida,167,Pinós,280,153,127
25,Lleida,911,"Plans de Sió, Els",515,279,236
25,Lleida,168,"Poal, El",655,335,320
25,Lleida,169,"Pobla de Cérvoles, La",201,111,90
25,Lleida,171,"Pobla de Segur, La",3035,1524,1511
25,Lleida,30,"Pont de Bar, El",163,96,67
25,Lleida,173,"Pont de Suert, El",2371,1199,1172
25,Lleida,172,Ponts,2710,1401,1309
25,Lleida,174,"Portella, La",753,431,322
25,Lleida,175,Prats i Sansor,254,138,116
25,Lleida,176,Preixana,403,209,194
25,Lleida,177,Preixens,411,208,203
25,Lleida,179,Prullans,269,129,140
25,Lleida,180,Puiggròs,257,131,126
25,Lleida,181,Puigverd d'Agramunt,260,147,113
25,Lleida,182,Puigverd de Lleida,1397,722,675
25,Lleida,183,Rialp,669,336,333
25,Lleida,905,Ribera d'Ondara,457,237,220
25,Lleida,185,Ribera d'Urgellet,938,479,459
25,Lleida,186,Riner,267,128,139
25,Lleida,913,Riu de Cerdanya,95,53,42
25,Lleida,189,Rosselló,3329,1713,1616
25,Lleida,190,Salàs de Pallars,348,190,158
25,Lleida,191,Sanaüja,391,202,189
25,Lleida,196,Sant Esteve de la Sarga,129,82,47
25,Lleida,192,Sant Guim de Freixenet,1152,604,548
25,Lleida,197,Sant Guim de la Plana,200,102,98
25,Lleida,193,Sant Llorenç de Morunys,1002,489,513
25,Lleida,902,Sant Martí de Riucorb,655,340,315
25,Lleida,194,Sant Ramon,489,258,231
25,Lleida,201,Sarroca de Bellera,119,67,52
25,Lleida,200,Sarroca de Lleida,387,214,173
25,Lleida,202,Senterada,160,93,67
25,Lleida,35,"Sentiu de Sió, La",445,226,219
25,Lleida,204,Seròs,1893,1022,871
25,Lleida,203,"Seu d'Urgell, La",12568,6131,6437
25,Lleida,205,Sidamon,766,407,359
25,Lleida,206,"Soleràs, El",321,171,150
25,Lleida,207,Solsona,9171,4550,4621
25,Lleida,208,Soriguera,440,230,210
25,Lleida,209,Sort,2211,1087,1124
25,Lleida,210,Soses,1855,980,875
25,Lleida,211,Sudanell,885,495,390
25,Lleida,212,Sunyer,331,180,151
25,Lleida,215,Talarn,591,374,217
25,Lleida,216,Talavera,277,153,124
25,Lleida,217,Tàrrega,18268,9073,9195
25,Lleida,218,Tarrés,117,58,59
25,Lleida,219,Tarroja de Segarra,180,96,84
25,Lleida,220,Térmens,1341,696,645
25,Lleida,221,Tírvia,144,71,73
25,Lleida,222,Tiurana,67,33,34
25,Lleida,223,Torà,1201,609,592
25,Lleida,224,"Torms, Els",142,72,70
25,Lleida,225,Tornabous,857,464,393
25,Lleida,227,"Torre de Cabdella, La",794,392,402
25,Lleida,226,Torrebesses,294,154,140
25,Lleida,228,Torrefarrera,4852,2466,2386
25,Lleida,907,Torrefeta i Florejacs,612,329,283
25,Lleida,230,Torregrossa,2186,1143,1043
25,Lleida,231,Torrelameu,751,445,306
25,Lleida,232,Torres de Segre,2285,1197,1088
25,Lleida,233,Torre-serona,405,210,195
25,Lleida,234,Tremp,5961,2937,3024
25,Lleida,43,"Vall de Boí, La",1090,587,503
25,Lleida,901,Vall de Cardós,379,208,171
25,Lleida,238,Vallbona de les Monges,222,115,107
25,Lleida,240,Vallfogona de Balaguer,1990,1004,986
25,Lleida,906,"Valls d'Aguilar, Les",270,150,120
25,Lleida,239,"Valls de Valira, Les",792,412,380
25,Lleida,909,"Vansa i Fórnols, La",181,91,90
25,Lleida,242,Verdú,884,415,469
25,Lleida,243,Vielha e Mijaran,5765,2928,2837
25,Lleida,244,Vilagrassa,621,332,289
25,Lleida,245,Vilaller,505,280,225
25,Lleida,247,Vilamòs,167,92,75
25,Lleida,248,Vilanova de Bellpuig,1183,592,591
25,Lleida,254,Vilanova de la Barca,1090,595,495
25,Lleida,249,Vilanova de l'Aguda,196,95,101
25,Lleida,250,Vilanova de Meià,442,285,157
25,Lleida,251,Vilanova de Segrià,1045,563,482
25,Lleida,252,Vila-sana,766,386,380
25,Lleida,253,"Vilosell, El",190,99,91
25,Lleida,255,Vinaixa,445,234,211
27,Lugo,1,Abadín,2203,1078,1125
27,Lugo,2,Alfoz,1553,745,808
27,Lugo,3,Antas de Ulla,1887,929,958
27,Lugo,4,Baleira,1153,613,540
27,Lugo,901,Baralla,2484,1307,1177
27,Lugo,5,Barreiros,3020,1468,1552
27,Lugo,6,Becerreá,2711,1359,1352
27,Lugo,7,Begonte,2925,1468,1457
27,Lugo,8,Bóveda,1405,708,697
27,Lugo,902,Burela,9454,4756,4698
27,Lugo,9,Carballedo,2080,1045,1035
27,Lugo,10,Castro de Rei,5015,2506,2509
27,Lugo,11,Castroverde,2548,1307,1241
27,Lugo,12,Cervantes,1209,703,506
27,Lugo,13,Cervo,4200,2057,2143
27,Lugo,16,Chantada,8006,3887,4119
27,Lugo,14,"Corgo, O",3396,1753,1643
27,Lugo,15,Cospeito,4257,2091,2166
27,Lugo,17,Folgoso do Courel,1004,526,478
27,Lugo,18,"Fonsagrada, A",3186,1668,1518
27,Lugo,19,Foz,10163,4934,5229
27,Lugo,20,Friol,3616,1845,1771
27,Lugo,22,Guitiriz,5194,2613,2581
27,Lugo,23,Guntín,2551,1304,1247
27,Lugo,24,"Incio, O",1524,780,744
27,Lugo,26,Láncara,2492,1274,1218
27,Lugo,27,Lourenzá,2115,1031,1084
27,Lugo,28,Lugo,98214,45397,52817
27,Lugo,29,Meira,1753,882,871
27,Lugo,30,Mondoñedo,3439,1620,1819
27,Lugo,31,Monforte de Lemos,18234,8669,9565
27,Lugo,32,Monterroso,3593,1783,1810
27,Lugo,33,Muras,600,306,294
27,Lugo,34,Navia de Suarna,988,545,443
27,Lugo,35,Negueira de Muñiz,240,134,106
27,Lugo,37,"Nogais, As",958,507,451
27,Lugo,38,Ourol,980,506,474
27,Lugo,39,Outeiro de Rei,5359,2745,2614
27,Lugo,40,Palas de Rei,3346,1694,1652
27,Lugo,41,Pantón,2423,1196,1227
27,Lugo,42,Paradela,1638,828,810
27,Lugo,43,"Páramo, O",1305,648,657
27,Lugo,44,"Pastoriza, A",2810,1416,1394
27,Lugo,45,Pedrafita do Cebreiro,909,495,414
27,Lugo,47,"Pobra do Brollón, A",1565,774,791
27,Lugo,46,Pol,1582,797,785
27,Lugo,48,"Pontenova, A",2126,1026,1100
27,Lugo,49,Portomarín,1345,693,652
27,Lugo,50,Quiroga,3099,1485,1614
27,Lugo,56,Rábade,1503,741,762
27,Lugo,51,Ribadeo,9828,4625,5203
27,Lugo,52,Ribas de Sil,914,463,451
27,Lugo,53,Ribeira de Piquín,497,263,234
27,Lugo,54,Riotorto,1200,608,592
27,Lugo,55,Samos,1210,643,567
27,Lugo,57,Sarria,13221,6452,6769
27,Lugo,58,"Saviñao, O",3504,1767,1737
27,Lugo,59,Sober,2178,1056,1122
27,Lugo,60,Taboada,2657,1283,1374
27,Lugo,61,Trabada,1107,542,565
27,Lugo,62,Triacastela,622,302,320
27,Lugo,63,"Valadouro, O",1890,901,989
27,Lugo,64,"Vicedo, O",1613,789,824
27,Lugo,65,Vilalba,13870,6712,7158
27,Lugo,66,Viveiro,15221,7462,7759
27,Lugo,21,Xermade,1734,851,883
27,Lugo,25,Xove,3330,1722,1608
28,Madrid,1,"Acebeda, La",67,34,33
28,Madrid,2,Ajalvir,4779,2483,2296
28,Madrid,3,Alameda del Valle,274,144,130
28,Madrid,4,"Álamo, El",10322,5069,5253
28,Madrid,5,Alcalá de Henares,199184,96342,102842
28,Madrid,6,Alcobendas,119416,56903,62513
28,Madrid,7,Alcorcón,171772,82226,89546
28,Madrid,8,Aldea del Fresno,3408,1743,1665
28,Madrid,9,Algete,20991,10279,10712
28,Madrid,10,Alpedrete,15312,7513,7799
28,Madrid,11,Ambite,684,337,347
28,Madrid,12,Anchuelo,1379,719,660
28,Madrid,13,Aranjuez,60668,29482,31186
28,Madrid,14,Arganda del Rey,58990,29449,29541
28,Madrid,15,Arroyomolinos,35972,17885,18087
28,Madrid,16,"Atazar, El",104,60,44
28,Madrid,17,Batres,1872,966,906
28,Madrid,18,Becerril de la Sierra,6277,3128,3149
28,Madrid,19,Belmonte de Tajo,1840,950,890
28,Madrid,21,"Berrueco, El",802,412,390
28,Madrid,20,Berzosa del Lozoya,217,121,96
28,Madrid,22,Boadilla del Monte,64742,31617,33125
28,Madrid,23,"Boalo, El",8424,4201,4223
28,Madrid,24,Braojos,212,128,84
28,Madrid,25,Brea de Tajo,543,313,230
28,Madrid,26,Brunete,11014,5366,5648
28,Madrid,27,Buitrago del Lozoya,1967,957,1010
28,Madrid,28,Bustarviejo,2743,1354,1389
28,Madrid,29,Cabanillas de la Sierra,939,490,449
28,Madrid,30,"Cabrera, La",2882,1413,1469
28,Madrid,31,Cadalso de los Vidrios,3173,1653,1520
28,Madrid,32,Camarma de Esteruelas,7792,3947,3845
28,Madrid,33,Campo Real,6781,3429,3352
28,Madrid,34,Canencia,460,241,219
28,Madrid,35,Carabaña,2273,1147,1126
28,Madrid,36,Casarrubuelos,4062,2089,1973
28,Madrid,37,Cenicientos,2097,1049,1048
28,Madrid,38,Cercedilla,7648,3776,3872
28,Madrid,39,Cervera de Buitrago,164,95,69
28,Madrid,51,Chapinería,2604,1292,1312
28,Madrid,52,Chinchón,5664,2836,2828
28,Madrid,40,Ciempozuelos,25866,13030,12836
28,Madrid,41,Cobeña,7698,3766,3932
28,Madrid,46,Collado Mediano,7490,3722,3768
28,Madrid,47,Collado Villalba,65657,31764,33893
28,Madrid,43,Colmenar de Oreja,8649,4397,4252
28,Madrid,42,Colmenar del Arroyo,1947,1012,935
28,Madrid,45,Colmenar Viejo,55198,27226,27972
28,Madrid,44,Colmenarejo,9534,4697,4837
28,Madrid,48,Corpa,798,399,399
28,Madrid,49,Coslada,80171,39002,41169
28,Madrid,50,Cubas de la Sagra,6817,3444,3373
28,Madrid,53,Daganzo de Arriba,10611,5293,5318
28,Madrid,54,"Escorial, El",16873,8293,8580
28,Madrid,55,Estremera,1453,749,704
28,Madrid,56,Fresnedillas de la Oliva,1791,905,886
28,Madrid,57,Fresno de Torote,2522,1327,1195
28,Madrid,58,Fuenlabrada,188736,92192,96544
28,Madrid,59,Fuente el Saz de Jarama,7182,3615,3567
28,Madrid,60,Fuentidueña de Tajo,2270,1131,1139
28,Madrid,61,Galapagar,35273,17119,18154
28,Madrid,62,Garganta de los Montes,420,228,192
28,Madrid,63,Gargantilla del Lozoya y Pinilla de Buitrago,388,219,169
28,Madrid,64,Gascones,229,127,102
28,Madrid,65,Getafe,185899,90494,95405
28,Madrid,66,Griñón,10087,5008,5079
28,Madrid,67,Guadalix de la Sierra,6814,3414,3400
28,Madrid,68,Guadarrama,17063,8396,8667
28,Madrid,69,"Hiruela, La",74,47,27
28,Madrid,70,Horcajo de la Sierra-Aoslos,234,116,118
28,Madrid,71,Horcajuelo de la Sierra,108,55,53
28,Madrid,72,Hoyo de Manzanares,8973,4515,4458
28,Madrid,73,Humanes de Madrid,19902,9908,9994
28,Madrid,74,Leganés,190665,91731,98934
28,Madrid,75,Loeches,9108,4568,4540
28,Madrid,76,Lozoya,621,324,297
28,Madrid,901,Lozoyuela-Navas-Sieteiglesias,1483,769,714
28,Madrid,78,Madarcos,72,36,36
28,Madrid,79,Madrid,3332035,1555507,1776528
28,Madrid,80,Majadahonda,72548,34263,38285
28,Madrid,82,Manzanares el Real,9386,4714,4672
28,Madrid,83,Meco,15404,7725,7679
28,Madrid,84,Mejorada del Campo,24274,12035,12239
28,Madrid,85,Miraflores de la Sierra,6945,3544,3401
28,Madrid,86,"Molar, El",9759,4944,4815
28,Madrid,87,"Molinos, Los",4786,2383,2403
28,Madrid,88,Montejo de la Sierra,381,197,184
28,Madrid,89,Moraleja de Enmedio,5453,2760,2693
28,Madrid,90,Moralzarzal,14124,7032,7092
28,Madrid,91,Morata de Tajuña,8115,4096,4019
28,Madrid,92,Móstoles,211265,102147,109118
28,Madrid,93,Navacerrada,3282,1605,1677
28,Madrid,94,Navalafuente,1637,831,806
28,Madrid,95,Navalagamella,2982,1539,1443
28,Madrid,96,Navalcarnero,31974,15867,16107
28,Madrid,97,Navarredonda y San Mamés,150,95,55
28,Madrid,99,Navas del Rey,3244,1689,1555
28,Madrid,100,Nuevo Baztán,7050,3576,3474
28,Madrid,101,Olmeda de las Fuentes,402,207,195
28,Madrid,102,Orusco de Tajuña,1415,737,678
28,Madrid,104,Paracuellos de Jarama,27000,13486,13514
28,Madrid,106,Parla,133004,65905,67099
28,Madrid,107,Patones,566,263,303
28,Madrid,108,Pedrezuela,6400,3233,3167
28,Madrid,109,Pelayos de la Presa,2982,1516,1466
28,Madrid,110,Perales de Tajuña,3176,1589,1587
28,Madrid,111,Pezuela de las Torres,977,509,468
28,Madrid,112,Pinilla del Valle,204,108,96
28,Madrid,113,Pinto,55208,27202,28006
28,Madrid,114,Piñuécar-Gandullas,178,92,86
28,Madrid,115,Pozuelo de Alarcón,88784,42429,46355
28,Madrid,116,Pozuelo del Rey,1254,650,604
28,Madrid,117,Prádena del Rincón,150,84,66
28,Madrid,118,Puebla de la Sierra,99,57,42
28,Madrid,902,Puentes Viejas,760,401,359
28,Madrid,119,Quijorna,3863,1909,1954
28,Madrid,120,Rascafría,1736,931,805
28,Madrid,121,Redueña,304,169,135
28,Madrid,122,Ribatejada,912,472,440
28,Madrid,123,Rivas-Vaciamadrid,100275,49599,50676
28,Madrid,124,Robledillo de la Jara,135,70,65
28,Madrid,125,Robledo de Chavela,4705,2450,2255
28,Madrid,126,Robregordo,79,45,34
28,Madrid,127,"Rozas de Madrid, Las",98086,47284,50802
28,Madrid,128,Rozas de Puerto Real,578,338,240
28,Madrid,129,San Agustín del Guadalix,13650,6631,7019
28,Madrid,130,San Fernando de Henares,38974,18928,20046
28,Madrid,131,San Lorenzo de El Escorial,18489,8826,9663
28,Madrid,132,San Martín de la Vega,20304,10304,10000
28,Madrid,133,San Martín de Valdeiglesias,9003,4474,4529
28,Madrid,134,San Sebastián de los Reyes,92734,44957,47777
28,Madrid,135,Santa María de la Alameda,1517,822,695
28,Madrid,136,Santorcaz,942,474,468
28,Madrid,137,"Santos de la Humosa, Los",2772,1416,1356
28,Madrid,138,"Serna del Monte, La",106,56,50
28,Madrid,140,Serranillos del Valle,4625,2268,2357
28,Madrid,141,Sevilla la Nueva,9551,4668,4883
28,Madrid,143,Somosierra,85,51,34
28,Madrid,144,Soto del Real,9399,4636,4763
28,Madrid,145,Talamanca de Jarama,4355,2110,2245
28,Madrid,146,Tielmes,2742,1379,1363
28,Madrid,147,Titulcia,1362,709,653
28,Madrid,148,Torrejón de Ardoz,137711,67409,70302
28,Madrid,149,Torrejón de la Calzada,10222,5063,5159
28,Madrid,150,Torrejón de Velasco,4756,2352,2404
28,Madrid,151,Torrelaguna,4949,2468,2481
28,Madrid,152,Torrelodones,25115,12130,12985
28,Madrid,153,Torremocha de Jarama,1144,584,560
28,Madrid,154,Torres de la Alameda,7737,3977,3760
28,Madrid,903,Tres Cantos,51453,24924,26529
28,Madrid,155,Valdaracete,633,328,305
28,Madrid,156,Valdeavero,1782,912,870
28,Madrid,157,Valdelaguna,1045,529,516
28,Madrid,158,Valdemanco,1066,550,516
28,Madrid,159,Valdemaqueda,820,419,401
28,Madrid,160,Valdemorillo,13651,6845,6806
28,Madrid,161,Valdemoro,81394,40018,41376
28,Madrid,162,Valdeolmos-Alalpardo,4523,2313,2210
28,Madrid,163,Valdepiélagos,623,325,298
28,Madrid,164,Valdetorres de Jarama,4990,2482,2508
28,Madrid,165,Valdilecha,3191,1642,1549
28,Madrid,166,Valverde de Alcalá,535,283,252
28,Madrid,167,Velilla de San Antonio,13376,6686,6690
28,Madrid,168,"Vellón, El",2200,1140,1060
28,Madrid,169,Venturada,2554,1327,1227
28,Madrid,171,Villa del Prado,7273,3697,3576
28,Madrid,170,Villaconejos,3499,1794,1705
28,Madrid,172,Villalbilla,16823,8495,8328
28,Madrid,173,Villamanrique de Tajo,800,418,382
28,Madrid,174,Villamanta,2774,1410,1364
28,Madrid,175,Villamantilla,1576,783,793
28,Madrid,176,Villanueva de la Cañada,23593,11458,12135
28,Madrid,178,Villanueva de Perales,1671,861,810
28,Madrid,177,Villanueva del Pardillo,17731,8580,9151
28,Madrid,179,Villar del Olmo,2258,1132,1126
28,Madrid,180,Villarejo de Salvanés,7746,3834,3912
28,Madrid,181,Villaviciosa de Odón,28750,13889,14861
28,Madrid,182,Villavieja del Lozoya,314,166,148
28,Madrid,183,Zarzalejo,1810,931,879
29,Málaga,1,Alameda,5434,2743,2691
29,Málaga,2,Alcaucín,2554,1301,1253
29,Málaga,3,Alfarnate,1059,552,507
29,Málaga,4,Alfarnatejo,380,196,184
29,Málaga,5,Algarrobo,6773,3375,3398
29,Málaga,6,Algatocín,829,442,387
29,Málaga,7,Alhaurín de la Torre,43674,21662,22012
29,Málaga,8,Alhaurín el Grande,26879,13381,13498
29,Málaga,9,Almáchar,1848,949,899
29,Málaga,10,Almargen,1924,974,950
29,Málaga,11,Almogía,3967,2065,1902
29,Málaga,12,Álora,13512,6812,6700
29,Málaga,13,Alozaina,2065,1041,1024
29,Málaga,14,Alpandeire,281,139,142
29,Málaga,15,Antequera,41178,20208,20970
29,Málaga,16,Árchez,391,197,194
29,Málaga,17,Archidona,8050,4075,3975
29,Málaga,18,Ardales,2522,1275,1247
29,Málaga,19,Arenas,1264,650,614
29,Málaga,20,Arriate,4068,2010,2058
29,Málaga,21,Atajate,185,98,87
29,Málaga,22,Benadalid,230,112,118
29,Málaga,23,Benahavís,9244,4612,4632
29,Málaga,24,Benalauría,460,240,220
29,Málaga,25,Benalmádena,75801,37050,38751
29,Málaga,26,Benamargosa,1557,802,755
29,Málaga,27,Benamocarra,3079,1549,1530
29,Málaga,28,Benaoján,1437,735,702
29,Málaga,29,Benarrabá,454,237,217
29,Málaga,30,"Borge, El",925,472,453
29,Málaga,31,"Burgo, El",1780,906,874
29,Málaga,32,Campillos,8435,4226,4209
29,Málaga,33,Canillas de Aceituno,1767,920,847
29,Málaga,34,Canillas de Albaida,801,393,408
29,Málaga,35,Cañete la Real,1598,786,812
29,Málaga,36,Carratraca,750,391,359
29,Málaga,37,Cartajima,232,121,111
29,Málaga,38,Cártama,28412,14352,14060
29,Málaga,39,Casabermeja,3910,2037,1873
29,Málaga,40,Casarabonela,2522,1351,1171
29,Málaga,41,Casares,8111,4166,3945
29,Málaga,42,Coín,25023,12542,12481
29,Málaga,43,Colmenar,3494,1793,1701
29,Málaga,44,Comares,1339,715,624
29,Málaga,45,Cómpeta,3875,1939,1936
29,Málaga,46,Cortes de la Frontera,3014,1566,1448
29,Málaga,47,Cuevas Bajas,1337,649,688
29,Málaga,49,Cuevas de San Marcos,3647,1830,1817
29,Málaga,48,Cuevas del Becerro,1592,783,809
29,Málaga,50,Cútar,592,304,288
29,Málaga,51,Estepona,76975,37624,39351
29,Málaga,52,Faraján,280,138,142
29,Málaga,53,Frigiliana,3322,1662,1660
29,Málaga,54,Fuengirola,85598,41521,44077
29,Málaga,55,Fuente de Piedra,2891,1431,1460
29,Málaga,56,Gaucín,1591,823,768
29,Málaga,57,Genalguacil,410,204,206
29,Málaga,58,Guaro,2307,1186,1121
29,Málaga,59,Humilladero,3331,1660,1671
29,Málaga,60,Igualeja,774,389,385
29,Málaga,61,Istán,1621,804,817
29,Málaga,62,Iznate,915,471,444
29,Málaga,63,Jimera de Líbar,400,210,190
29,Málaga,64,Jubrique,561,286,275
29,Málaga,65,Júzcar,243,137,106
29,Málaga,66,Macharaviaya,523,289,234
29,Málaga,67,Málaga,586384,281265,305119
29,Málaga,68,Manilva,17857,8979,8878
29,Málaga,69,Marbella,156295,74623,81672
29,Málaga,70,Mijas,91691,45335,46356
29,Málaga,71,Moclinejo,1220,625,595
29,Málaga,72,Mollina,5413,2691,2722
29,Málaga,73,Monda,2937,1529,1408
29,Málaga,903,Montecorto,588,314,274
29,Málaga,74,Montejaque,970,487,483
29,Málaga,75,Nerja,21913,10751,11162
29,Málaga,76,Ojén,4480,2296,2184
29,Málaga,77,Parauta,280,145,135
29,Málaga,79,Periana,3290,1702,1588
29,Málaga,80,Pizarra,9886,4960,4926
29,Málaga,81,Pujerra,279,139,140
29,Málaga,82,Rincón de la Victoria,51300,25044,26256
29,Málaga,83,Riogordo,2795,1462,1333
29,Málaga,84,Ronda,33329,16130,17199
29,Málaga,85,Salares,187,101,86
29,Málaga,86,Sayalonga,1647,865,782
29,Málaga,87,Sedella,611,342,269
29,Málaga,904,Serrato,447,224,223
29,Málaga,88,Sierra de Yeguas,3418,1707,1711
29,Málaga,89,Teba,3678,1842,1836
29,Málaga,90,Tolox,2347,1200,1147
29,Málaga,901,Torremolinos,70434,35209,35225
29,Málaga,91,Torrox,20932,10536,10396
29,Málaga,92,Totalán,767,389,378
29,Málaga,93,Valle de Abdalajís,2441,1232,1209
29,Málaga,94,Vélez-Málaga,85377,42009,43368
29,Málaga,95,Villanueva de Algaidas,4113,2079,2034
29,Málaga,902,Villanueva de la Concepción,3302,1594,1708
29,Málaga,98,Villanueva de Tapia,1405,711,694
29,Málaga,96,Villanueva del Rosario,3348,1638,1710
29,Málaga,97,Villanueva del Trabuco,5360,2677,2683
29,Málaga,99,Viñuela,2059,1071,988
29,Málaga,100,Yunquera,2823,1437,1386
52,Melilla,1,Melilla,85491,43047,42444
30,Murcia,1,Abanilla,6216,3163,3053
30,Murcia,2,Abarán,12964,6473,6491
30,Murcia,3,Águilas,36862,18364,18498
30,Murcia,4,Albudeite,1390,705,685
30,Murcia,5,Alcantarilla,43049,21315,21734
30,Murcia,902,"Alcázares, Los",18598,9483,9115
30,Murcia,6,Aledo,1123,554,569
30,Murcia,7,Alguazas,10218,5277,4941
30,Murcia,8,Alhama de Murcia,23280,11769,11511
30,Murcia,9,Archena,20110,10546,9564
30,Murcia,10,Beniel,11501,5978,5523
30,Murcia,11,Blanca,6756,3481,3275
30,Murcia,12,Bullas,11664,5864,5800
30,Murcia,13,Calasparra,10161,5150,5011
30,Murcia,14,Campos del Río,2143,1017,1126
30,Murcia,15,Caravaca de la Cruz,25756,12850,12906
30,Murcia,16,Cartagena,218050,108296,109754
30,Murcia,17,Cehegín,14485,7236,7249
30,Murcia,18,Ceutí,12668,6393,6275
30,Murcia,19,Cieza,35286,17672,17614
30,Murcia,20,Fortuna,11094,5863,5231
30,Murcia,21,Fuente Álamo de Murcia,18063,9429,8634
30,Murcia,22,Jumilla,26784,14030,12754
30,Murcia,23,Librilla,5729,2928,2801
30,Murcia,24,Lorca,98447,50526,47921
30,Murcia,25,Lorquí,7706,3924,3782
30,Murcia,26,Mazarrón,34462,17918,16544
30,Murcia,27,Molina de Segura,76074,37879,38195
30,Murcia,28,Moratalla,7588,3841,3747
30,Murcia,29,Mula,17382,8843,8539
30,Murcia,30,Murcia,469177,230043,239134
30,Murcia,31,Ojós,539,283,256
30,Murcia,32,Pliego,3937,2039,1898
30,Murcia,33,Puerto Lumbreras,17346,9023,8323
30,Murcia,34,Ricote,1240,662,578
30,Murcia,35,San Javier,35241,17672,17569
30,Murcia,36,San Pedro del Pinatar,27691,13836,13855
30,Murcia,901,Santomera,16245,8087,8158
30,Murcia,37,Torre-Pacheco,39037,20157,18880
30,Murcia,38,"Torres de Cotillas, Las",22183,11218,10965
30,Murcia,39,Totana,33149,17032,16117
30,Murcia,40,Ulea,874,454,420
30,Murcia,41,"Unión, La",20897,10569,10328
30,Murcia,42,Villanueva del Río Segura,3771,1963,1808
30,Murcia,43,Yecla,35521,17863,17658
31,Navarra,1,Abáigar,82,47,35
31,Navarra,2,Abárzuza/Abartzuza,514,253,261
31,Navarra,3,Abaurregaina/Abaurrea Alta,115,70,45
31,Navarra,4,Abaurrepea/Abaurrea Baja,29,18,11
31,Navarra,5,Aberin,368,197,171
31,Navarra,6,Ablitas,2610,1319,1291
31,Navarra,7,Adiós,172,97,75
31,Navarra,8,Aguilar de Codés,76,43,33
31,Navarra,9,Aibar/Oibar,769,410,359
31,Navarra,11,Allín/Allin,908,493,415
31,Navarra,12,Allo,988,506,482
31,Navarra,10,Altsasu/Alsasua,7590,3816,3774
31,Navarra,13,Améscoa Baja,724,397,327
31,Navarra,14,Ancín/Antzin,343,185,158
31,Navarra,15,Andosilla,2882,1453,1429
31,Navarra,16,Ansoáin/Antsoain,10608,5165,5443
31,Navarra,17,Anue,491,263,228
31,Navarra,18,Añorbe,628,341,287
31,Navarra,19,Aoiz/Agoitz,2970,1489,1481
31,Navarra,20,Araitz,525,286,239
31,Navarra,25,Arakil,987,528,459
31,Navarra,21,Aranarache/Aranaratxe,70,41,29
31,Navarra,23,Aranguren,12517,6276,6241
31,Navarra,24,Arano,110,62,48
31,Navarra,22,Arantza,609,323,286
31,Navarra,26,Aras,148,78,70
31,Navarra,27,Arbizu,1126,590,536
31,Navarra,28,Arce/Artzi,296,164,132
31,Navarra,29,"Arcos, Los",1151,570,581
31,Navarra,30,Arellano,159,89,70
31,Navarra,31,Areso,267,138,129
31,Navarra,32,Arguedas,2313,1176,1137
31,Navarra,33,Aria,49,32,17
31,Navarra,34,Aribe,34,19,15
31,Navarra,35,Armañanzas,54,27,27
31,Navarra,36,Arróniz,1035,552,483
31,Navarra,37,Arruazu,119,66,53
31,Navarra,38,Artajona,1772,912,860
31,Navarra,39,Artazu,116,57,59
31,Navarra,40,Atez/Atetz,214,121,93
31,Navarra,58,Auritz/Burguete,233,127,106
31,Navarra,41,Ayegui/Aiegi,2531,1321,1210
31,Navarra,42,Azagra,3749,1887,1862
31,Navarra,43,Azuelo,37,12,25
31,Navarra,44,Bakaiku,343,181,162
31,Navarra,901,Barañáin/Barañain,19575,9424,10151
31,Navarra,45,Barásoain,602,313,289
31,Navarra,46,Barbarin,46,26,20
31,Navarra,47,Bargota,257,125,132
31,Navarra,48,Barillas,259,139,120
31,Navarra,49,Basaburua,845,479,366
31,Navarra,50,Baztan,7831,3959,3872
31,Navarra,137,Beintza-Labaien,218,128,90
31,Navarra,51,Beire,301,148,153
31,Navarra,52,Belascoáin,138,67,71
31,Navarra,250,Bera,3792,1865,1927
31,Navarra,53,Berbinzana,672,345,327
31,Navarra,905,Beriáin,4129,2039,2090
31,Navarra,902,Berrioplano/Berriobeiti,7541,3832,3709
31,Navarra,903,Berriozar,10919,5484,5435
31,Navarra,54,Bertizarana,635,313,322
31,Navarra,55,Betelu,373,191,182
31,Navarra,253,Bidaurreta,165,85,80
31,Navarra,56,Biurrun-Olcoz,246,131,115
31,Navarra,57,Buñuel,2309,1136,1173
31,Navarra,59,Burgui/Burgi,195,114,81
31,Navarra,60,Burlada/Burlata,20865,10038,10827
31,Navarra,61,"Busto, El",52,26,26
31,Navarra,62,Cabanillas,1379,712,667
31,Navarra,63,Cabredo,75,42,33
31,Navarra,64,Cadreita,2186,1154,1032
31,Navarra,65,Caparroso,2786,1452,1334
31,Navarra,66,Cárcar,1150,588,562
31,Navarra,67,Carcastillo,2435,1222,1213
31,Navarra,68,Cascante,4050,2016,2034
31,Navarra,69,Cáseda,969,506,463
31,Navarra,70,Castejón,4435,2226,2209
31,Navarra,71,Castillonuevo,15,10,5
31,Navarra,193,Cendea de Olza/Oltza Zendea,1836,919,917
31,Navarra,72,Cintruénigo,8265,4293,3972
31,Navarra,74,Cirauqui/Zirauki,467,247,220
31,Navarra,75,Ciriza/Ziritza,158,79,79
31,Navarra,76,Cizur,3891,1996,1895
31,Navarra,77,Corella,8629,4351,4278
31,Navarra,78,Cortes,3149,1609,1540
31,Navarra,79,Desojo,72,37,35
31,Navarra,80,Dicastillo,574,303,271
31,Navarra,81,Donamaria,455,228,227
31,Navarra,221,Doneztebe/Santesteban,1858,913,945
31,Navarra,83,Echarri/Etxarri,75,38,37
31,Navarra,87,Elgorriaga,205,102,103
31,Navarra,89,Enériz/Eneritz,301,152,149
31,Navarra,90,Eratsun,155,93,62
31,Navarra,91,Ergoiena,380,204,176
31,Navarra,92,Erro,812,453,359
31,Navarra,94,Eslava,103,50,53
31,Navarra,95,Esparza de Salazar/Espartza Zaraitzu,74,37,37
31,Navarra,96,Espronceda,108,56,52
31,Navarra,97,Estella-Lizarra,14195,6907,7288
31,Navarra,98,Esteribar,2832,1454,1378
31,Navarra,99,Etayo,68,38,30
31,Navarra,82,Etxalar,833,441,392
31,Navarra,84,Etxarri Aranatz,2521,1303,1218
31,Navarra,85,Etxauri,653,334,319
31,Navarra,100,Eulate,276,152,124
31,Navarra,101,Ezcabarte,1837,960,877
31,Navarra,93,Ezcároz/Ezkaroze,299,170,129
31,Navarra,102,Ezkurra,142,97,45
31,Navarra,103,Ezprogui,53,25,28
31,Navarra,104,Falces,2375,1220,1155
31,Navarra,105,Fitero,2146,1086,1060
31,Navarra,106,Fontellas,1005,516,489
31,Navarra,107,Funes,2543,1358,1185
31,Navarra,108,Fustiñana,2457,1224,1233
31,Navarra,109,Galar,2353,1211,1142
31,Navarra,110,Gallipienzo/Galipentzu,96,53,43
31,Navarra,111,Gallués/Galoze,93,62,31
31,Navarra,112,Garaioa,84,50,34
31,Navarra,113,Garde,139,77,62
31,Navarra,114,Garínoain,523,278,245
31,Navarra,115,Garralda,186,94,92
31,Navarra,116,Genevilla,67,41,26
31,Navarra,117,Goizueta,708,373,335
31,Navarra,118,Goñi,172,102,70
31,Navarra,119,Güesa/Gorza,37,22,15
31,Navarra,120,Guesálaz/Gesalatz,431,243,188
31,Navarra,121,Guirguillano,71,37,34
31,Navarra,256,Hiriberri/Villanueva de Aezkoa,101,57,44
31,Navarra,122,Huarte/Uharte,7562,3780,3782
31,Navarra,124,Ibargoiti,282,158,124
31,Navarra,259,Igantzi,572,305,267
31,Navarra,125,Igúzquiza,301,152,149
31,Navarra,126,Imotz,421,233,188
31,Navarra,127,Irañeta,165,90,75
31,Navarra,904,Irurtzun,2316,1200,1116
31,Navarra,128,Isaba/Izaba,404,197,207
31,Navarra,129,Ituren,532,262,270
31,Navarra,130,Iturmendi,418,215,203
31,Navarra,131,Iza/Itza,1330,717,613
31,Navarra,132,Izagaondoa,159,108,51
31,Navarra,133,Izalzu/Itzaltzu,38,22,16
31,Navarra,134,Jaurrieta,176,104,72
31,Navarra,135,Javier,122,30,92
31,Navarra,136,Juslapeña/Txulapain,564,308,256
31,Navarra,138,Lakuntza,1297,679,618
31,Navarra,139,Lana,156,89,67
31,Navarra,140,Lantz,150,86,64
31,Navarra,141,Lapoblación,120,69,51
31,Navarra,142,Larraga,2087,1092,995
31,Navarra,143,Larraona,100,49,51
31,Navarra,144,Larraun,910,494,416
31,Navarra,145,Lazagurría,182,94,88
31,Navarra,146,Leache/Leatxe,37,21,16
31,Navarra,147,Legarda,135,74,61
31,Navarra,148,Legaria,108,52,56
31,Navarra,149,Leitza,3016,1550,1466
31,Navarra,908,Lekunberri,1689,867,822
31,Navarra,150,Leoz/Leotz,211,135,76
31,Navarra,151,Lerga,49,27,22
31,Navarra,152,Lerín,1798,940,858
31,Navarra,153,Lesaka,2731,1380,1351
31,Navarra,154,Lezaun,244,142,102
31,Navarra,155,Liédena,323,169,154
31,Navarra,156,Lizoain-Arriasgoiti/Lizoainibar-Arriasgoiti,303,179,124
31,Navarra,157,Lodosa,4894,2491,2403
31,Navarra,158,Lónguida/Longida,309,167,142
31,Navarra,159,Lumbier,1326,708,618
31,Navarra,160,Luquin,129,68,61
31,Navarra,248,Luzaide/Valcarlos,304,166,138
31,Navarra,161,Mañeru,445,233,212
31,Navarra,162,Marañón,52,30,22
31,Navarra,163,Marcilla,2875,1438,1437
31,Navarra,164,Mélida,715,368,347
31,Navarra,165,Mendavia,3496,1753,1743
31,Navarra,166,Mendaza,289,144,145
31,Navarra,167,Mendigorria,1191,621,570
31,Navarra,168,Metauten,271,152,119
31,Navarra,169,Milagro,3549,1804,1745
31,Navarra,170,Mirafuentes,58,29,29
31,Navarra,171,Miranda de Arga,917,490,427
31,Navarra,172,Monreal/Elo,503,278,225
31,Navarra,173,Monteagudo,1102,578,524
31,Navarra,174,Morentin,116,54,62
31,Navarra,175,Mues,79,45,34
31,Navarra,176,Murchante,4237,2138,2099
31,Navarra,177,Murieta,346,177,169
31,Navarra,178,Murillo el Cuende,685,361,324
31,Navarra,179,Murillo el Fruto,674,362,312
31,Navarra,180,Muruzábal,269,126,143
31,Navarra,181,Navascués/Nabaskoze,121,70,51
31,Navarra,182,Nazar,46,25,21
31,Navarra,88,Noáin (Valle de Elorz)/Noain (Elortzibar),8429,4233,4196
31,Navarra,183,Obanos,920,454,466
31,Navarra,185,Ochagavía/Otsagabia,490,266,224
31,Navarra,184,Oco,68,38,30
31,Navarra,186,Odieta,373,203,170
31,Navarra,187,Oiz,133,72,61
31,Navarra,188,Olaibar,409,230,179
31,Navarra,189,Olazti/Olazagutía,1483,752,731
31,Navarra,190,Olejua,49,27,22
31,Navarra,191,Olite/Erriberri,4019,2022,1997
31,Navarra,192,Olóriz/Oloritz,221,126,95
31,Navarra,195,Orbaizeta,191,91,100
31,Navarra,196,Orbara,29,15,14
31,Navarra,197,Orísoain,74,44,30
31,Navarra,906,Orkoien,4051,2054,1997
31,Navarra,198,Oronz/Orontze,47,25,22
31,Navarra,199,Oroz-Betelu/Orotz-Betelu,145,87,58
31,Navarra,211,Orreaga/Roncesvalles,19,10,9
31,Navarra,200,Oteiza,923,490,433
31,Navarra,201,Pamplona/Iruña,205762,97080,108682
31,Navarra,202,Peralta/Azkoien,5979,3038,2941
31,Navarra,203,Petilla de Aragón,28,16,12
31,Navarra,204,Piedramillera,41,26,15
31,Navarra,205,Pitillas,530,256,274
31,Navarra,206,Puente la Reina/Gares,2944,1490,1454
31,Navarra,207,Pueyo/Puiu,346,189,157
31,Navarra,208,Ribaforada,3715,1918,1797
31,Navarra,209,Romanzado/Erromantzatua,188,102,86
31,Navarra,210,Roncal/Erronkari,209,107,102
31,Navarra,212,Sada,130,78,52
31,Navarra,213,Saldías,124,69,55
31,Navarra,214,Salinas de Oro/Jaitz,109,59,50
31,Navarra,215,San Adrián,6429,3210,3219
31,Navarra,217,San Martín de Unx,377,198,179
31,Navarra,216,Sangüesa/Zangoza,4814,2442,2372
31,Navarra,219,Sansol,87,42,45
31,Navarra,220,Santacara,863,445,418
31,Navarra,222,Sarriés/Sartze,62,43,19
31,Navarra,223,Sartaguda,1328,683,645
31,Navarra,224,Sesma,1226,638,588
31,Navarra,225,Sorlada,48,29,19
31,Navarra,226,Sunbilla,672,344,328
31,Navarra,227,Tafalla,10698,5316,5382
31,Navarra,228,Tiebas-Muruarte de Reta,660,356,304
31,Navarra,229,Tirapu,54,29,25
31,Navarra,230,Torralba del Río,98,52,46
31,Navarra,231,Torres del Río,117,62,55
31,Navarra,232,Tudela,37791,18628,19163
31,Navarra,233,Tulebras,148,66,82
31,Navarra,234,Ucar,190,111,79
31,Navarra,123,Uharte Arakil,806,417,389
31,Navarra,235,Ujué/Uxue,171,94,77
31,Navarra,236,Ultzama,1636,843,793
31,Navarra,237,Unciti,225,133,92
31,Navarra,238,Unzué/Untzue,158,83,75
31,Navarra,239,Urdazubi/Urdax,362,183,179
31,Navarra,240,Urdiain,638,333,305
31,Navarra,241,Urraul Alto,135,88,47
31,Navarra,242,Urraul Bajo,326,149,177
31,Navarra,244,Urroz,177,98,79
31,Navarra,243,Urroz-Villa,418,219,199
31,Navarra,245,Urzainqui/Urzainki,79,46,33
31,Navarra,246,Uterga,169,94,75
31,Navarra,247,Uztárroz/Uztarroze,139,68,71
31,Navarra,86,Valle de Egüés/Eguesibar,22121,11037,11084
31,Navarra,194,Valle de Ollo/Ollaran,435,237,198
31,Navarra,260,Valle de Yerri/Deierri,1581,820,761
31,Navarra,249,Valtierra,2424,1222,1202
31,Navarra,251,Viana,4370,2228,2142
31,Navarra,252,Vidángoz/Bidankoze,75,44,31
31,Navarra,254,Villafranca,3004,1549,1455
31,Navarra,255,Villamayor de Monjardín,117,59,58
31,Navarra,257,Villatuerta,1266,627,639
31,Navarra,258,Villava/Atarrabia,10067,4891,5176
31,Navarra,261,Yesa,294,171,123
31,Navarra,262,Zabalza/Zabaltza,289,155,134
31,Navarra,73,Ziordia,352,187,165
31,Navarra,907,Zizur Mayor/Zizur Nagusia,15715,7715,8000
31,Navarra,263,Zubieta,292,149,143
31,Navarra,264,Zugarramurdi,231,112,119
31,Navarra,265,Zúñiga,89,52,37
32,Ourense,1,Allariz,6378,3177,3201
32,Ourense,2,Amoeiro,2391,1203,1188
32,Ourense,3,"Arnoia, A",1002,489,513
32,Ourense,4,Avión,1754,799,955
32,Ourense,5,Baltar,884,475,409
32,Ourense,6,Bande,1482,746,736
32,Ourense,7,Baños de Molgas,1535,762,773
32,Ourense,8,Barbadás,11140,5385,5755
32,Ourense,9,"Barco de Valdeorras, O",13277,6424,6853
32,Ourense,10,Beade,364,188,176
32,Ourense,11,Beariz,946,431,515
32,Ourense,12,"Blancos, Os",716,393,323
32,Ourense,13,Boborás,2232,1066,1166
32,Ourense,14,"Bola, A",1069,512,557
32,Ourense,15,"Bolo, O",806,408,398
32,Ourense,16,Calvos de Randín,679,344,335
32,Ourense,18,Carballeda de Avia,1218,599,619
32,Ourense,17,Carballeda de Valdeorras,1373,697,676
32,Ourense,19,"Carballiño, O",13968,6501,7467
32,Ourense,20,Cartelle,2521,1246,1275
32,Ourense,22,Castrelo de Miño,1337,670,667
32,Ourense,21,Castrelo do Val,989,511,478
32,Ourense,23,Castro Caldelas,1222,635,587
32,Ourense,24,Celanova,5709,2680,3029
32,Ourense,25,Cenlle,1087,536,551
32,Ourense,29,Chandrexa de Queixa,493,258,235
32,Ourense,26,Coles,3176,1588,1588
32,Ourense,27,Cortegada,1032,507,525
32,Ourense,28,Cualedro,1606,843,763
32,Ourense,30,Entrimo,1098,521,577
32,Ourense,31,Esgos,1099,554,545
32,Ourense,33,Gomesende,667,340,327
32,Ourense,34,"Gudiña, A",1180,602,578
32,Ourense,35,"Irixo, O",1391,674,717
32,Ourense,38,Larouco,444,210,234
32,Ourense,39,Laza,1167,614,553
32,Ourense,40,Leiro,1481,729,752
32,Ourense,41,Lobeira,768,387,381
32,Ourense,42,Lobios,1786,885,901
32,Ourense,43,Maceda,2878,1429,1449
32,Ourense,44,Manzaneda,832,405,427
32,Ourense,45,Maside,2743,1363,1380
32,Ourense,46,Melón,1123,542,581
32,Ourense,47,"Merca, A",1954,984,970
32,Ourense,48,"Mezquita, A",1007,520,487
32,Ourense,49,Montederramo,688,369,319
32,Ourense,50,Monterrei,2424,1233,1191
32,Ourense,51,Muíños,1439,721,718
32,Ourense,52,Nogueira de Ramuín,2085,1054,1031
32,Ourense,53,Oímbra,1730,942,788
32,Ourense,54,Ourense,104250,47322,56928
32,Ourense,55,Paderne de Allariz,1368,687,681
32,Ourense,56,Padrenda,1614,801,813
32,Ourense,57,Parada de Sil,520,281,239
32,Ourense,58,"Pereiro de Aguiar, O",6647,3422,3225
32,Ourense,59,"Peroxa, A",1779,874,905
32,Ourense,60,Petín,875,442,433
32,Ourense,61,Piñor,1151,593,558
32,Ourense,63,"Pobra de Trives, A",1977,967,1010
32,Ourense,64,Pontedeva,468,231,237
32,Ourense,62,Porqueira,841,395,446
32,Ourense,65,Punxín,751,366,385
32,Ourense,66,Quintela de Leirado,607,288,319
32,Ourense,67,Rairiz de Veiga,1220,626,594
32,Ourense,68,Ramirás,1521,723,798
32,Ourense,69,Ribadavia,4973,2443,2530
32,Ourense,71,Riós,1414,721,693
32,Ourense,72,"Rúa, A",4141,2076,2065
32,Ourense,73,Rubiá,1384,681,703
32,Ourense,74,San Amaro,1049,508,541
32,Ourense,75,San Cibrao das Viñas,5675,2866,2809
32,Ourense,76,San Cristovo de Cea,2003,994,1009
32,Ourense,70,San Xoán de Río,518,264,254
32,Ourense,77,Sandiás,1134,539,595
32,Ourense,78,Sarreaus,1095,537,558
32,Ourense,79,Taboadela,1487,765,722
32,Ourense,80,"Teixeira, A",342,180,162
32,Ourense,81,Toén,2378,1219,1159
32,Ourense,82,Trasmiras,1228,610,618
32,Ourense,83,"Veiga, A",925,490,435
32,Ourense,84,Verea,964,473,491
32,Ourense,85,Verín,13612,6538,7074
32,Ourense,86,Viana do Bolo,2750,1385,1365
32,Ourense,87,Vilamarín,1866,944,922
32,Ourense,88,Vilamartín de Valdeorras,1851,937,914
32,Ourense,89,Vilar de Barrio,1201,604,597
32,Ourense,90,Vilar de Santos,792,393,399
32,Ourense,91,Vilardevós,1702,904,798
32,Ourense,92,Vilariño de Conso,521,300,221
32,Ourense,32,Xinzo de Limia,9529,4604,4925
32,Ourense,36,Xunqueira de Ambía,1368,691,677
32,Ourense,37,Xunqueira de Espadanedo,689,345,344
34,Palencia,1,Abarca de Campos,42,25,17
34,Palencia,3,Abia de las Torres,167,90,77
34,Palencia,4,Aguilar de Campoo,6733,3246,3487
34,Palencia,5,Alar del Rey,922,467,455
34,Palencia,6,Alba de Cerrato,82,48,34
34,Palencia,9,Amayuelas de Arriba,36,22,14
34,Palencia,10,Ampudia,589,298,291
34,Palencia,11,Amusco,422,239,183
34,Palencia,12,Antigüedad,340,189,151
34,Palencia,15,Arconada,45,27,18
34,Palencia,17,Astudillo,1036,519,517
34,Palencia,18,Autilla del Pino,210,117,93
34,Palencia,19,Autillo de Campos,129,67,62
34,Palencia,20,Ayuela,53,35,18
34,Palencia,22,Baltanás,1212,621,591
34,Palencia,24,Baquerín de Campos,25,15,10
34,Palencia,25,Bárcena de Campos,54,25,29
34,Palencia,27,Barruelo de Santullán,1182,593,589
34,Palencia,28,Báscones de Ojeda,134,71,63
34,Palencia,29,Becerril de Campos,756,377,379
34,Palencia,31,Belmonte de Campos,33,17,16
34,Palencia,32,Berzosilla,43,24,19
34,Palencia,33,Boada de Campos,19,14,5
34,Palencia,35,Boadilla de Rioseco,99,60,39
34,Palencia,34,Boadilla del Camino,117,68,49
34,Palencia,36,Brañosera,254,142,112
34,Palencia,37,Buenavista de Valdavia,309,173,136
34,Palencia,38,Bustillo de la Vega,275,154,121
34,Palencia,39,Bustillo del Páramo de Carrión,52,32,20
34,Palencia,41,Calahorra de Boedo,87,42,45
34,Palencia,42,Calzada de los Molinos,305,169,136
34,Palencia,45,Capillas,71,41,30
34,Palencia,46,Cardeñosa de Volpejera,59,35,24
34,Palencia,47,Carrión de los Condes,2005,971,1034
34,Palencia,48,Castil de Vela,57,29,28
34,Palencia,49,Castrejón de la Peña,323,174,149
34,Palencia,50,Castrillo de Don Juan,181,102,79
34,Palencia,51,Castrillo de Onielo,99,52,47
34,Palencia,52,Castrillo de Villavega,174,97,77
34,Palencia,53,Castromocho,202,107,95
34,Palencia,55,Cervatos de la Cueza,261,145,116
34,Palencia,56,Cervera de Pisuerga,2265,1111,1154
34,Palencia,57,Cevico de la Torre,466,238,228
34,Palencia,58,Cevico Navero,178,105,73
34,Palencia,59,Cisneros,409,201,208
34,Palencia,60,Cobos de Cerrato,133,75,58
34,Palencia,61,Collazos de Boedo,106,62,44
34,Palencia,62,Congosto de Valdavia,141,87,54
34,Palencia,63,Cordovilla la Real,129,70,59
34,Palencia,66,Cubillas de Cerrato,62,36,26
34,Palencia,67,Dehesa de Montejo,133,79,54
34,Palencia,68,Dehesa de Romanos,53,34,19
34,Palencia,69,Dueñas,2597,1315,1282
34,Palencia,70,Espinosa de Cerrato,123,72,51
34,Palencia,71,Espinosa de Villagonzalo,167,89,78
34,Palencia,72,Frechilla,135,69,66
34,Palencia,73,Fresno del Río,178,86,92
34,Palencia,74,Frómista,755,380,375
34,Palencia,76,Fuentes de Nava,593,308,285
34,Palencia,77,Fuentes de Valdepero,481,246,235
34,Palencia,79,Grijota,2690,1392,1298
34,Palencia,80,Guardo,5653,2788,2865
34,Palencia,81,Guaza de Campos,57,34,23
34,Palencia,82,Hérmedes de Cerrato,74,38,36
34,Palencia,83,Herrera de Pisuerga,1889,929,960
34,Palencia,84,Herrera de Valdecañas,151,84,67
34,Palencia,86,Hontoria de Cerrato,110,56,54
34,Palencia,87,Hornillos de Cerrato,171,91,80
34,Palencia,88,Husillos,392,217,175
34,Palencia,89,Itero de la Vega,146,84,62
34,Palencia,91,Lagartos,121,66,55
34,Palencia,92,Lantadilla,281,150,131
34,Palencia,94,Ledigos,64,33,31
34,Palencia,903,Loma de Ucieza,184,114,70
34,Palencia,96,Lomas,41,27,14
34,Palencia,98,Magaz de Pisuerga,1011,533,478
34,Palencia,99,Manquillos,52,34,18
34,Palencia,100,Mantinos,143,83,60
34,Palencia,101,Marcilla de Campos,49,22,27
34,Palencia,102,Mazariegos,208,125,83
34,Palencia,103,Mazuecos de Valdeginate,86,55,31
34,Palencia,104,Melgar de Yuso,262,153,109
34,Palencia,106,Meneses de Campos,96,54,42
34,Palencia,107,Micieces de Ojeda,71,42,29
34,Palencia,108,Monzón de Campos,578,310,268
34,Palencia,109,Moratinos,65,35,30
34,Palencia,110,Mudá,75,45,30
34,Palencia,112,Nogal de las Huertas,44,25,19
34,Palencia,113,Olea de Boedo,36,13,23
34,Palencia,114,Olmos de Ojeda,179,114,65
34,Palencia,116,Osornillo,59,32,27
34,Palencia,901,Osorno la Mayor,1170,609,561
34,Palencia,120,Palencia,76331,35884,40447
34,Palencia,121,Palenzuela,213,121,92
34,Palencia,122,Páramo de Boedo,105,63,42
34,Palencia,123,Paredes de Nava,1895,961,934
34,Palencia,124,Payo de Ojeda,59,37,22
34,Palencia,125,Pedraza de Campos,76,42,34
34,Palencia,126,Pedrosa de la Vega,286,162,124
34,Palencia,127,Perales,115,54,61
34,Palencia,904,"Pernía, La",318,185,133
34,Palencia,129,Pino del Río,162,98,64
34,Palencia,130,Piña de Campos,196,105,91
34,Palencia,131,Población de Arroyo,45,25,20
34,Palencia,132,Población de Campos,126,72,54
34,Palencia,133,Población de Cerrato,101,58,43
34,Palencia,134,Polentinos,44,22,22
34,Palencia,135,Pomar de Valdivia,484,266,218
34,Palencia,136,Poza de la Vega,167,94,73
34,Palencia,137,Pozo de Urama,19,14,5
34,Palencia,139,Prádanos de Ojeda,178,98,80
34,Palencia,140,"Puebla de Valdavia, La",84,46,38
34,Palencia,141,Quintana del Puente,259,140,119
34,Palencia,143,Quintanilla de Onsoña,180,100,80
34,Palencia,146,Reinoso de Cerrato,56,35,21
34,Palencia,147,Renedo de la Vega,199,111,88
34,Palencia,149,Requena de Campos,27,15,12
34,Palencia,151,Respenda de la Peña,147,90,57
34,Palencia,152,Revenga de Campos,136,65,71
34,Palencia,154,Revilla de Collazos,78,43,35
34,Palencia,155,Ribas de Campos,153,79,74
34,Palencia,156,Riberos de la Cueza,55,33,22
34,Palencia,157,Saldaña,2904,1489,1415
34,Palencia,158,Salinas de Pisuerga,312,162,150
34,Palencia,159,San Cebrián de Campos,415,242,173
34,Palencia,160,San Cebrián de Mudá,146,80,66
34,Palencia,161,San Cristóbal de Boedo,19,13,6
34,Palencia,163,San Mamés de Campos,46,24,22
34,Palencia,165,San Román de la Cuba,53,32,21
34,Palencia,167,Santa Cecilia del Alcor,96,53,43
34,Palencia,168,Santa Cruz de Boedo,49,29,20
34,Palencia,169,Santervás de la Vega,402,226,176
34,Palencia,170,Santibáñez de Ecla,47,27,20
34,Palencia,171,Santibáñez de la Peña,962,464,498
34,Palencia,174,Santoyo,188,104,84
34,Palencia,175,"Serna, La",89,53,36
34,Palencia,177,Soto de Cerrato,175,100,75
34,Palencia,176,Sotobañado y Priorato,158,91,67
34,Palencia,178,Tabanera de Cerrato,138,74,64
34,Palencia,179,Tabanera de Valdavia,23,14,9
34,Palencia,180,Támara de Campos,75,39,36
34,Palencia,181,Tariego de Cerrato,483,253,230
34,Palencia,182,Torquemada,949,514,435
34,Palencia,184,Torremormojón,45,28,17
34,Palencia,185,Triollo,73,43,30
34,Palencia,186,Valbuena de Pisuerga,54,28,26
34,Palencia,189,Valdeolmillos,56,33,23
34,Palencia,190,Valderrábano,49,26,23
34,Palencia,192,Valde-Ucieza,82,51,31
34,Palencia,196,Valle de Cerrato,82,45,37
34,Palencia,902,Valle del Retortillo,170,93,77
34,Palencia,199,Velilla del Río Carrión,1145,582,563
34,Palencia,23,Venta de Baños,6284,3174,3110
34,Palencia,201,Vertavillo,163,84,79
34,Palencia,93,"Vid de Ojeda, La",93,56,37
34,Palencia,202,Villabasta de Valdavia,33,19,14
34,Palencia,204,Villacidaler,46,27,19
34,Palencia,205,Villaconancio,55,32,23
34,Palencia,206,Villada,850,430,420
34,Palencia,208,Villaeles de Valdavia,49,31,18
34,Palencia,210,Villahán,99,59,40
34,Palencia,211,Villaherreros,214,113,101
34,Palencia,213,Villalaco,57,33,24
34,Palencia,214,Villalba de Guardo,202,111,91
34,Palencia,215,Villalcázar de Sirga,174,89,85
34,Palencia,216,Villalcón,53,29,24
34,Palencia,217,Villalobón,1871,937,934
34,Palencia,218,Villaluenga de la Vega,524,302,222
34,Palencia,220,Villamartín de Campos,175,95,80
34,Palencia,221,Villamediana,181,110,71
34,Palencia,222,Villameriel,111,64,47
34,Palencia,223,Villamoronta,252,152,100
34,Palencia,224,Villamuera de la Cueza,38,25,13
34,Palencia,225,Villamuriel de Cerrato,6459,3315,3144
34,Palencia,227,Villanueva del Rebollar,69,37,32
34,Palencia,228,Villanuño de Valdavia,92,51,41
34,Palencia,229,Villaprovedo,52,36,16
34,Palencia,230,Villarmentero de Campos,20,13,7
34,Palencia,231,Villarrabé,183,95,88
34,Palencia,232,Villarramiel,819,434,385
34,Palencia,233,Villasarracino,136,81,55
34,Palencia,234,Villasila de Valdavia,64,43,21
34,Palencia,236,Villaturde,138,72,66
34,Palencia,237,Villaumbrales,643,322,321
34,Palencia,238,Villaviudas,360,174,186
34,Palencia,240,Villerías de Campos,73,39,34
34,Palencia,241,Villodre,21,12,9
34,Palencia,242,Villodrigo,107,55,52
34,Palencia,243,Villoldo,336,181,155
34,Palencia,245,Villota del Páramo,305,176,129
34,Palencia,246,Villovieco,66,36,30
35,"Palmas, Las",1,Agaete,5568,2802,2766
35,"Palmas, Las",2,Agüimes,32643,16422,16221
35,"Palmas, Las",20,"Aldea de San Nicolás, La",7506,3893,3613
35,"Palmas, Las",3,Antigua,13523,7094,6429
35,"Palmas, Las",4,Arrecife,64826,32459,32367
35,"Palmas, Las",5,Artenara,1032,598,434
35,"Palmas, Las",6,Arucas,38601,19090,19511
35,"Palmas, Las",7,Betancuria,816,434,382
35,"Palmas, Las",8,Firgas,7669,3887,3782
35,"Palmas, Las",9,Gáldar,24678,12360,12318
35,"Palmas, Las",10,Haría,5507,2818,2689
35,"Palmas, Las",11,Ingenio,32354,16294,16060
35,"Palmas, Las",12,Mogán,20845,10721,10124
35,"Palmas, Las",13,Moya,7889,3991,3898
35,"Palmas, Las",14,"Oliva, La",29099,15055,14044
35,"Palmas, Las",15,Pájara,21271,10988,10283
35,"Palmas, Las",16,"Palmas de Gran Canaria, Las",378027,181846,196181
35,"Palmas, Las",17,Puerto del Rosario,43390,21811,21579
35,"Palmas, Las",18,San Bartolomé,19200,9509,9691
35,"Palmas, Las",19,San Bartolomé de Tirajana,53912,28282,25630
35,"Palmas, Las",21,Santa Brígida,18510,9234,9276
35,"Palmas, Las",22,Santa Lucía de Tirajana,75677,37587,38090
35,"Palmas, Las",23,Santa María de Guía de Gran Canaria,13948,6945,7003
35,"Palmas, Las",24,Teguise,23881,11962,11919
35,"Palmas, Las",25,Tejeda,1844,1008,836
35,"Palmas, Las",26,Telde,102487,50233,52254
35,"Palmas, Las",27,Teror,12799,6547,6252
35,"Palmas, Las",28,Tías,21433,10900,10533
35,"Palmas, Las",29,Tinajo,6759,3428,3331
35,"Palmas, Las",30,Tuineje,15967,8139,7828
35,"Palmas, Las",32,Valleseco,3733,1950,1783
35,"Palmas, Las",31,Valsequillo de Gran Canaria,9667,4860,4807
35,"Palmas, Las",33,Vega de San Mateo,7782,3993,3789
35,"Palmas, Las",34,Yaiza,17415,8932,8483
36,Pontevedra,20,Agolada,2254,1120,1134
36,Pontevedra,1,Arbo,2647,1367,1280
36,Pontevedra,3,Baiona,12407,6109,6298
36,Pontevedra,2,Barro,3651,1783,1868
36,Pontevedra,4,Bueu,11922,5857,6065
36,Pontevedra,5,Caldas de Reis,9620,4659,4961
36,Pontevedra,6,Cambados,13681,6605,7076
36,Pontevedra,7,Campo Lameiro,1723,822,901
36,Pontevedra,8,Cangas,26807,13288,13519
36,Pontevedra,9,"Cañiza, A",5090,2489,2601
36,Pontevedra,10,Catoira,3289,1593,1696
36,Pontevedra,902,Cerdedo-Cotobade,5687,2773,2914
36,Pontevedra,13,Covelo,2426,1259,1167
36,Pontevedra,14,Crecente,1978,969,1009
36,Pontevedra,15,Cuntis,4549,2161,2388
36,Pontevedra,16,Dozón,1017,526,491
36,Pontevedra,17,"Estrada, A",20081,9665,10416
36,Pontevedra,18,Forcarei,3186,1518,1668
36,Pontevedra,19,Fornelos de Montes,1647,802,845
36,Pontevedra,21,Gondomar,15043,7502,7541
36,Pontevedra,22,"Grove, O",10828,5318,5510
36,Pontevedra,23,"Guarda, A",9998,4929,5069
36,Pontevedra,901,"Illa de Arousa, A",4876,2402,2474
36,Pontevedra,24,Lalín,20282,9904,10378
36,Pontevedra,25,"Lama, A",2520,1267,1253
36,Pontevedra,26,Marín,24197,11970,12227
36,Pontevedra,27,Meaño,5258,2569,2689
36,Pontevedra,28,Meis,4706,2262,2444
36,Pontevedra,29,Moaña,19315,9387,9928
36,Pontevedra,30,Mondariz,4444,2200,2244
36,Pontevedra,31,Mondariz-Balneario,703,356,347
36,Pontevedra,32,Moraña,4126,2008,2118
36,Pontevedra,33,Mos,15076,7432,7644
36,Pontevedra,34,"Neves, As",3739,1841,1898
36,Pontevedra,35,Nigrán,18045,8856,9189
36,Pontevedra,36,Oia,3104,1528,1576
36,Pontevedra,37,Pazos de Borbén,2993,1466,1527
36,Pontevedra,41,Poio,17297,8520,8777
36,Pontevedra,43,Ponte Caldelas,5553,2657,2896
36,Pontevedra,42,Ponteareas,23154,11208,11946
36,Pontevedra,44,Pontecesures,3096,1525,1571
36,Pontevedra,38,Pontevedra,82535,38885,43650
36,Pontevedra,39,"Porriño, O",20562,10116,10446
36,Pontevedra,40,Portas,2823,1362,1461
36,Pontevedra,45,Redondela,28937,13994,14943
36,Pontevedra,46,Ribadumia,5189,2535,2654
36,Pontevedra,47,Rodeiro,2260,1142,1118
36,Pontevedra,48,"Rosal, O",6431,3157,3274
36,Pontevedra,49,Salceda de Caselas,9421,4701,4720
36,Pontevedra,50,Salvaterra de Miño,10274,5107,5167
36,Pontevedra,51,Sanxenxo,17854,8827,9027
36,Pontevedra,52,Silleda,8876,4343,4533
36,Pontevedra,53,Soutomaior,7603,3783,3820
36,Pontevedra,54,Tomiño,13836,6942,6894
36,Pontevedra,55,Tui,17327,8404,8923
36,Pontevedra,56,Valga,5704,2783,2921
36,Pontevedra,57,Vigo,293652,138310,155342
36,Pontevedra,59,Vila de Cruces,5082,2530,2552
36,Pontevedra,58,Vilaboa,5950,2927,3023
36,Pontevedra,60,Vilagarcía de Arousa,37689,18020,19669
36,Pontevedra,61,Vilanova de Arousa,10225,4969,5256
26,"Rioja, La",1,Ábalos,258,146,112
26,"Rioja, La",2,Agoncillo,1228,665,563
26,"Rioja, La",3,Aguilar del Río Alhama,428,219,209
26,"Rioja, La",4,Ajamil de Cameros,90,55,35
26,"Rioja, La",5,Albelda de Iregua,3738,1921,1817
26,"Rioja, La",6,Alberite,2628,1348,1280
26,"Rioja, La",7,Alcanadre,669,347,322
26,"Rioja, La",8,Aldeanueva de Ebro,2726,1419,1307
26,"Rioja, La",9,Alesanco,474,241,233
26,"Rioja, La",10,Alesón,98,55,43
26,"Rioja, La",11,Alfaro,9823,4921,4902
26,"Rioja, La",12,Almarza de Cameros,39,25,14
26,"Rioja, La",13,Anguciana,435,244,191
26,"Rioja, La",14,Anguiano,499,274,225
26,"Rioja, La",15,Arenzana de Abajo,251,135,116
26,"Rioja, La",16,Arenzana de Arriba,33,23,10
26,"Rioja, La",17,Arnedillo,436,216,220
26,"Rioja, La",18,Arnedo,15201,7587,7614
26,"Rioja, La",19,Arrúbal,582,307,275
26,"Rioja, La",20,Ausejo,795,425,370
26,"Rioja, La",21,Autol,4834,2435,2399
26,"Rioja, La",22,Azofra,215,117,98
26,"Rioja, La",23,Badarán,496,251,245
26,"Rioja, La",24,Bañares,201,109,92
26,"Rioja, La",26,Baños de Río Tobía,1608,814,794
26,"Rioja, La",25,Baños de Rioja,84,52,32
26,"Rioja, La",27,Berceo,139,88,51
26,"Rioja, La",28,Bergasa,163,86,77
26,"Rioja, La",29,Bergasillas Bajera,39,21,18
26,"Rioja, La",30,Bezares,26,13,13
26,"Rioja, La",31,Bobadilla,97,49,48
26,"Rioja, La",32,Brieva de Cameros,43,27,16
26,"Rioja, La",33,Briñas,182,91,91
26,"Rioja, La",34,Briones,739,388,351
26,"Rioja, La",35,Cabezón de Cameros,23,15,8
26,"Rioja, La",36,Calahorra,24994,12250,12744
26,"Rioja, La",37,Camprovín,174,95,79
26,"Rioja, La",38,Canales de la Sierra,81,55,26
26,"Rioja, La",39,Canillas de Río Tuerto,50,30,20
26,"Rioja, La",40,Cañas,92,51,41
26,"Rioja, La",41,Cárdenas,132,72,60
26,"Rioja, La",42,Casalarreina,1062,531,531
26,"Rioja, La",43,Castañares de Rioja,385,177,208
26,"Rioja, La",44,Castroviejo,62,34,28
26,"Rioja, La",45,Cellorigo,10,4,6
26,"Rioja, La",46,Cenicero,2067,1063,1004
26,"Rioja, La",47,Cervera del Río Alhama,2262,1163,1099
26,"Rioja, La",48,Cidamón,22,11,11
26,"Rioja, La",49,Cihuri,207,105,102
26,"Rioja, La",50,Cirueña,198,123,75
26,"Rioja, La",51,Clavijo,296,173,123
26,"Rioja, La",52,Cordovín,153,76,77
26,"Rioja, La",53,Corera,283,142,141
26,"Rioja, La",54,Cornago,304,174,130
26,"Rioja, La",55,Corporales,38,24,14
26,"Rioja, La",56,Cuzcurrita de Río Tirón,566,297,269
26,"Rioja, La",57,Daroca de Rioja,60,38,22
26,"Rioja, La",58,Enciso,174,113,61
26,"Rioja, La",59,Entrena,1637,858,779
26,"Rioja, La",60,Estollo,93,55,38
26,"Rioja, La",61,Ezcaray,2080,1078,1002
26,"Rioja, La",62,Foncea,94,55,39
26,"Rioja, La",63,Fonzaleche,130,84,46
26,"Rioja, La",64,Fuenmayor,3259,1630,1629
26,"Rioja, La",65,Galbárruli,89,55,34
26,"Rioja, La",66,Galilea,394,199,195
26,"Rioja, La",67,Gallinero de Cameros,17,10,7
26,"Rioja, La",68,Gimileo,112,59,53
26,"Rioja, La",69,Grañón,235,130,105
26,"Rioja, La",70,Grávalos,170,92,78
26,"Rioja, La",71,Haro,11763,5798,5965
26,"Rioja, La",72,Herce,325,167,158
26,"Rioja, La",73,Herramélluri,109,58,51
26,"Rioja, La",74,Hervías,133,72,61
26,"Rioja, La",75,Hormilla,441,231,210
26,"Rioja, La",76,Hormilleja,131,70,61
26,"Rioja, La",77,Hornillos de Cameros,15,8,7
26,"Rioja, La",78,Hornos de Moncalvillo,96,57,39
26,"Rioja, La",79,Huércanos,858,475,383
26,"Rioja, La",80,Igea,648,366,282
26,"Rioja, La",81,Jalón de Cameros,23,10,13
26,"Rioja, La",82,Laguna de Cameros,115,64,51
26,"Rioja, La",83,Lagunilla del Jubera,394,218,176
26,"Rioja, La",84,Lardero,11321,5666,5655
26,"Rioja, La",86,Ledesma de la Cogolla,16,12,4
26,"Rioja, La",87,Leiva,246,122,124
26,"Rioja, La",88,Leza de Río Leza,40,24,16
26,"Rioja, La",89,Logroño,150583,71340,79243
26,"Rioja, La",91,Lumbreras de Cameros,145,100,45
26,"Rioja, La",92,Manjarrés,108,67,41
26,"Rioja, La",93,Mansilla de la Sierra,60,44,16
26,"Rioja, La",94,Manzanares de Rioja,58,37,21
26,"Rioja, La",95,Matute,86,52,34
26,"Rioja, La",96,Medrano,350,190,160
26,"Rioja, La",98,Munilla,100,57,43
26,"Rioja, La",99,Murillo de Río Leza,1643,833,810
26,"Rioja, La",100,Muro de Aguas,57,37,20
26,"Rioja, La",101,Muro en Cameros,40,22,18
26,"Rioja, La",102,Nájera,8059,3994,4065
26,"Rioja, La",103,Nalda,1329,720,609
26,"Rioja, La",104,Navajún,8,7,1
26,"Rioja, La",105,Navarrete,3040,1529,1511
26,"Rioja, La",106,Nestares,83,50,33
26,"Rioja, La",107,Nieva de Cameros,87,54,33
26,"Rioja, La",109,Ochánduri,87,51,36
26,"Rioja, La",108,Ocón,318,195,123
26,"Rioja, La",110,Ojacastro,172,102,70
26,"Rioja, La",111,Ollauri,312,169,143
26,"Rioja, La",112,Ortigosa de Cameros,222,136,86
26,"Rioja, La",113,Pazuengos,27,22,5
26,"Rioja, La",114,Pedroso,89,54,35
26,"Rioja, La",115,Pinillos,25,14,11
26,"Rioja, La",117,Pradejón,3817,1985,1832
26,"Rioja, La",118,Pradillo,67,37,30
26,"Rioja, La",119,Préjano,211,115,96
26,"Rioja, La",120,Quel,2151,1155,996
26,"Rioja, La",121,Rabanera,33,25,8
26,"Rioja, La",122,"Rasillo de Cameros, El",149,86,63
26,"Rioja, La",123,"Redal, El",148,87,61
26,"Rioja, La",124,Ribafrecha,1041,540,501
26,"Rioja, La",125,Rincón de Soto,4021,2092,1929
26,"Rioja, La",126,Robres del Castillo,27,17,10
26,"Rioja, La",127,Rodezno,202,114,88
26,"Rioja, La",128,Sajazarra,130,74,56
26,"Rioja, La",129,San Asensio,1097,582,515
26,"Rioja, La",130,San Millán de la Cogolla,214,144,70
26,"Rioja, La",131,San Millán de Yécora,35,25,10
26,"Rioja, La",132,San Román de Cameros,126,79,47
26,"Rioja, La",139,San Torcuato,63,33,30
26,"Rioja, La",142,San Vicente de la Sonsierra,1010,535,475
26,"Rioja, La",134,Santa Coloma,98,57,41
26,"Rioja, La",135,Santa Engracia del Jubera,198,119,79
26,"Rioja, La",136,Santa Eulalia Bajera,117,67,50
26,"Rioja, La",138,Santo Domingo de la Calzada,6283,3135,3148
26,"Rioja, La",140,Santurde de Rioja,280,150,130
26,"Rioja, La",141,Santurdejo,101,60,41
26,"Rioja, La",143,Sojuela,603,333,270
26,"Rioja, La",144,Sorzano,221,124,97
26,"Rioja, La",145,Sotés,260,143,117
26,"Rioja, La",146,Soto en Cameros,86,50,36
26,"Rioja, La",147,Terroba,41,20,21
26,"Rioja, La",148,Tirgo,171,89,82
26,"Rioja, La",149,Tobía,46,26,20
26,"Rioja, La",150,Tormantos,122,71,51
26,"Rioja, La",153,Torre en Cameros,9,7,2
26,"Rioja, La",151,Torrecilla en Cameros,434,243,191
26,"Rioja, La",152,Torrecilla sobre Alesanco,54,32,22
26,"Rioja, La",154,Torremontalbo,8,7,1
26,"Rioja, La",155,Treviana,141,75,66
26,"Rioja, La",157,Tricio,356,178,178
26,"Rioja, La",158,Tudelilla,356,191,165
26,"Rioja, La",160,Uruñuela,984,505,479
26,"Rioja, La",161,Valdemadera,12,9,3
26,"Rioja, La",162,Valgañón,137,81,56
26,"Rioja, La",163,Ventosa,194,99,95
26,"Rioja, La",164,Ventrosa,51,30,21
26,"Rioja, La",165,Viguera,378,219,159
26,"Rioja, La",166,Villalba de Rioja,169,95,74
26,"Rioja, La",167,Villalobar de Rioja,72,46,26
26,"Rioja, La",168,Villamediana de Iregua,8954,4494,4460
26,"Rioja, La",169,Villanueva de Cameros,74,45,29
26,"Rioja, La",170,"Villar de Arnedo, El",616,332,284
26,"Rioja, La",171,Villar de Torre,153,96,57
26,"Rioja, La",172,Villarejo,28,22,6
26,"Rioja, La",173,Villarroya,3,2,1
26,"Rioja, La",174,Villarta-Quintana,136,79,57
26,"Rioja, La",175,Villavelayo,42,28,14
26,"Rioja, La",176,Villaverde de Rioja,76,44,32
26,"Rioja, La",177,Villoslada de Cameros,348,223,125
26,"Rioja, La",178,Viniegra de Abajo,73,47,26
26,"Rioja, La",179,Viniegra de Arriba,41,28,13
26,"Rioja, La",180,Zarratón,259,134,125
26,"Rioja, La",181,Zarzosa,13,9,4
26,"Rioja, La",183,Zorraquín,86,44,42
37,Salamanca,1,Abusejo,150,79,71
37,Salamanca,2,Agallas,126,71,55
37,Salamanca,3,Ahigal de los Aceiteros,94,52,42
37,Salamanca,4,Ahigal de Villarino,31,18,13
37,Salamanca,5,"Alameda de Gardón, La",79,38,41
37,Salamanca,6,"Alamedilla, La",108,54,54
37,Salamanca,7,Alaraz,437,229,208
37,Salamanca,8,Alba de Tormes,5058,2547,2511
37,Salamanca,9,Alba de Yeltes,201,110,91
37,Salamanca,10,"Alberca, La",1061,515,546
37,Salamanca,11,"Alberguería de Argañán, La",103,57,46
37,Salamanca,12,Alconada,140,78,62
37,Salamanca,15,Aldea del Obispo,275,150,125
37,Salamanca,13,Aldeacipreste,94,52,42
37,Salamanca,14,Aldeadávila de la Ribera,1131,571,560
37,Salamanca,16,Aldealengua,668,337,331
37,Salamanca,17,Aldeanueva de Figueroa,254,136,118
37,Salamanca,18,Aldeanueva de la Sierra,106,68,38
37,Salamanca,19,Aldearrodrigo,146,81,65
37,Salamanca,20,Aldearrubia,514,274,240
37,Salamanca,21,Aldeaseca de Alba,66,39,27
37,Salamanca,22,Aldeaseca de la Frontera,254,131,123
37,Salamanca,23,Aldeatejada,2518,1275,1243
37,Salamanca,24,Aldeavieja de Tormes,100,54,46
37,Salamanca,25,Aldehuela de la Bóveda,271,145,126
37,Salamanca,26,Aldehuela de Yeltes,191,104,87
37,Salamanca,27,Almenara de Tormes,299,162,137
37,Salamanca,28,Almendra,125,68,57
37,Salamanca,29,Anaya de Alba,187,111,76
37,Salamanca,30,Añover de Tormes,89,48,41
37,Salamanca,31,Arabayona de Mógica,333,190,143
37,Salamanca,32,Arapiles,725,393,332
37,Salamanca,33,Arcediano,100,53,47
37,Salamanca,34,"Arco, El",93,45,48
37,Salamanca,35,Armenteros,256,159,97
37,Salamanca,37,"Atalaya, La",100,53,47
37,Salamanca,38,Babilafuente,927,488,439
37,Salamanca,39,Bañobárez,280,142,138
37,Salamanca,40,Barbadillo,395,217,178
37,Salamanca,41,Barbalos,71,42,29
37,Salamanca,42,Barceo,48,29,19
37,Salamanca,44,Barruecopardo,418,235,183
37,Salamanca,45,"Bastida, La",28,15,13
37,Salamanca,46,Béjar,12021,5697,6324
37,Salamanca,47,Beleña,277,136,141
37,Salamanca,49,Bermellar,131,67,64
37,Salamanca,50,Berrocal de Huebra,75,40,35
37,Salamanca,51,Berrocal de Salvatierra,72,41,31
37,Salamanca,52,Boada,273,142,131
37,Salamanca,54,"Bodón, El",245,135,110
37,Salamanca,55,Bogajo,130,72,58
37,Salamanca,56,"Bouza, La",47,19,28
37,Salamanca,57,Bóveda del Río Almar,199,104,95
37,Salamanca,58,Brincones,60,32,28
37,Salamanca,59,Buenamadre,116,58,58
37,Salamanca,60,Buenavista,373,193,180
37,Salamanca,61,"Cabaco, El",238,124,114
37,Salamanca,63,"Cabeza de Béjar, La",58,40,18
37,Salamanca,65,Cabeza del Caballo,248,133,115
37,Salamanca,62,Cabezabellosa de la Calzada,75,47,28
37,Salamanca,67,Cabrerizos,4224,2110,2114
37,Salamanca,68,Cabrillas,324,164,160
37,Salamanca,69,Calvarrasa de Abajo,1191,618,573
37,Salamanca,70,Calvarrasa de Arriba,597,318,279
37,Salamanca,71,"Calzada de Béjar, La",88,51,37
37,Salamanca,72,Calzada de Don Diego,137,72,65
37,Salamanca,73,Calzada de Valdunciel,702,350,352
37,Salamanca,74,Campillo de Azaba,141,87,54
37,Salamanca,77,"Campo de Peñaranda, El",263,151,112
37,Salamanca,78,Candelario,841,433,408
37,Salamanca,79,Canillas de Abajo,75,50,25
37,Salamanca,80,Cantagallo,275,140,135
37,Salamanca,81,Cantalapiedra,909,457,452
37,Salamanca,82,Cantalpino,817,440,377
37,Salamanca,83,Cantaracillo,188,98,90
37,Salamanca,85,Carbajosa de la Sagrada,7555,3747,3808
37,Salamanca,86,Carpio de Azaba,111,59,52
37,Salamanca,87,Carrascal de Barregas,1415,736,679
37,Salamanca,88,Carrascal del Obispo,192,107,85
37,Salamanca,89,Casafranca,72,35,37
37,Salamanca,90,"Casas del Conde, Las",61,29,32
37,Salamanca,91,Casillas de Flores,179,87,92
37,Salamanca,92,Castellanos de Moriscos,2989,1533,1456
37,Salamanca,185,Castellanos de Villiquera,683,361,322
37,Salamanca,96,Castillejo de Martín Viejo,219,131,88
37,Salamanca,97,Castraz,37,24,13
37,Salamanca,98,Cepeda,290,147,143
37,Salamanca,99,Cereceda de la Sierra,66,34,32
37,Salamanca,100,Cerezal de Peñahorcada,73,37,36
37,Salamanca,101,Cerralbo,119,64,55
37,Salamanca,102,"Cerro, El",368,186,182
37,Salamanca,103,Cespedosa de Tormes,501,268,233
37,Salamanca,114,Chagarcía Medianero,80,45,35
37,Salamanca,104,Cilleros de la Bastida,21,12,9
37,Salamanca,106,Cipérez,242,126,116
37,Salamanca,107,Ciudad Rodrigo,11810,5653,6157
37,Salamanca,108,Coca de Alba,102,51,51
37,Salamanca,109,Colmenar de Montemayor,179,107,72
37,Salamanca,110,Cordovilla,111,62,49
37,Salamanca,112,Cristóbal,166,100,66
37,Salamanca,113,"Cubo de Don Sancho, El",396,209,187
37,Salamanca,115,Dios le Guarde,122,66,56
37,Salamanca,116,Doñinos de Ledesma,67,35,32
37,Salamanca,117,Doñinos de Salamanca,2288,1206,1082
37,Salamanca,118,Éjeme,144,83,61
37,Salamanca,120,Encina de San Silvestre,111,52,59
37,Salamanca,119,"Encina, La",101,60,41
37,Salamanca,121,Encinas de Abajo,618,319,299
37,Salamanca,122,Encinas de Arriba,235,117,118
37,Salamanca,123,Encinasola de los Comendadores,153,85,68
37,Salamanca,124,Endrinal,203,117,86
37,Salamanca,125,Escurial de la Sierra,233,129,104
37,Salamanca,126,Espadaña,34,20,14
37,Salamanca,127,Espeja,211,113,98
37,Salamanca,128,Espino de la Orbada,240,132,108
37,Salamanca,129,Florida de Liébana,251,141,110
37,Salamanca,130,Forfoleda,208,114,94
37,Salamanca,131,Frades de la Sierra,181,102,79
37,Salamanca,132,"Fregeneda, La",310,155,155
37,Salamanca,133,Fresnedoso,102,57,45
37,Salamanca,134,Fresno Alhándiga,191,102,89
37,Salamanca,135,"Fuente de San Esteban, La",1284,654,630
37,Salamanca,136,Fuenteguinaldo,662,322,340
37,Salamanca,137,Fuenteliante,89,43,46
37,Salamanca,138,Fuenterroble de Salvatierra,253,133,120
37,Salamanca,139,Fuentes de Béjar,233,123,110
37,Salamanca,140,Fuentes de Oñoro,1043,560,483
37,Salamanca,141,Gajates,146,73,73
37,Salamanca,142,Galindo y Perahuy,665,379,286
37,Salamanca,143,Galinduste,394,190,204
37,Salamanca,144,Galisancho,333,180,153
37,Salamanca,145,Gallegos de Argañán,269,135,134
37,Salamanca,146,Gallegos de Solmirón,109,62,47
37,Salamanca,147,Garcibuey,200,114,86
37,Salamanca,148,Garcihernández,418,217,201
37,Salamanca,149,Garcirrey,57,33,24
37,Salamanca,150,Gejuelo del Barro,31,18,13
37,Salamanca,151,Golpejas,148,79,69
37,Salamanca,152,Gomecello,409,217,192
37,Salamanca,154,Guadramiro,133,82,51
37,Salamanca,155,Guijo de Ávila,77,42,35
37,Salamanca,156,Guijuelo,5484,2776,2708
37,Salamanca,157,Herguijuela de Ciudad Rodrigo,70,42,28
37,Salamanca,158,Herguijuela de la Sierra,230,127,103
37,Salamanca,159,Herguijuela del Campo,66,33,33
37,Salamanca,160,Hinojosa de Duero,600,303,297
37,Salamanca,161,Horcajo de Montemayor,110,57,53
37,Salamanca,162,Horcajo Medianero,212,114,98
37,Salamanca,163,"Hoya, La",31,19,12
37,Salamanca,164,Huerta,278,155,123
37,Salamanca,165,Iruelos,26,11,15
37,Salamanca,166,Ituero de Azaba,205,107,98
37,Salamanca,167,Juzbado,189,97,92
37,Salamanca,168,Lagunilla,436,239,197
37,Salamanca,169,Larrodrigo,183,102,81
37,Salamanca,170,Ledesma,1539,755,784
37,Salamanca,171,Ledrada,447,231,216
37,Salamanca,172,Linares de Riofrío,923,508,415
37,Salamanca,173,Lumbrales,1517,776,741
37,Salamanca,175,Machacón,444,226,218
37,Salamanca,174,Macotera,1003,522,481
37,Salamanca,176,Madroñal,140,79,61
37,Salamanca,177,"Maíllo, El",290,167,123
37,Salamanca,178,Malpartida,90,47,43
37,Salamanca,179,Mancera de Abajo,203,105,98
37,Salamanca,180,"Manzano, El",60,31,29
37,Salamanca,181,Martiago,264,146,118
37,Salamanca,183,Martín de Yeltes,397,200,197
37,Salamanca,182,Martinamor,79,51,28
37,Salamanca,184,Masueco,262,138,124
37,Salamanca,186,"Mata de Ledesma, La",104,58,46
37,Salamanca,187,Matilla de los Caños del Río,628,306,322
37,Salamanca,188,"Maya, La",159,90,69
37,Salamanca,189,Membribe de la Sierra,102,60,42
37,Salamanca,190,Mieza,179,90,89
37,Salamanca,191,"Milano, El",93,59,34
37,Salamanca,192,Miranda de Azán,455,250,205
37,Salamanca,193,Miranda del Castañar,392,214,178
37,Salamanca,194,Mogarraz,253,130,123
37,Salamanca,195,Molinillo,47,26,21
37,Salamanca,196,Monforte de la Sierra,59,29,30
37,Salamanca,197,Monleón,89,54,35
37,Salamanca,198,Monleras,241,120,121
37,Salamanca,199,Monsagro,133,77,56
37,Salamanca,200,Montejo,211,117,94
37,Salamanca,201,Montemayor del Río,266,142,124
37,Salamanca,202,Monterrubio de Armuña,1315,677,638
37,Salamanca,203,Monterrubio de la Sierra,152,87,65
37,Salamanca,204,Morasverdes,245,128,117
37,Salamanca,205,Morille,227,120,107
37,Salamanca,206,Moríñigo,87,47,40
37,Salamanca,207,Moriscos,552,298,254
37,Salamanca,208,Moronta,74,45,29
37,Salamanca,209,Mozárbez,514,272,242
37,Salamanca,211,Narros de Matalayegua,208,116,92
37,Salamanca,213,Nava de Béjar,76,44,32
37,Salamanca,214,Nava de Francia,122,64,58
37,Salamanca,215,Nava de Sotrobal,165,96,69
37,Salamanca,212,Navacarros,132,72,60
37,Salamanca,216,Navales,305,167,138
37,Salamanca,217,Navalmoral de Béjar,60,29,31
37,Salamanca,218,Navamorales,43,28,15
37,Salamanca,219,Navarredonda de la Rinconada,156,80,76
37,Salamanca,221,Navasfrías,370,200,170
37,Salamanca,222,Negrilla de Palencia,80,47,33
37,Salamanca,223,Olmedo de Camaces,100,56,44
37,Salamanca,224,"Orbada, La",181,94,87
37,Salamanca,225,Pajares de la Laguna,109,58,51
37,Salamanca,226,Palacios del Arzobispo,151,82,69
37,Salamanca,228,Palaciosrubios,305,163,142
37,Salamanca,229,Palencia de Negrilla,145,90,55
37,Salamanca,230,Parada de Arriba,259,135,124
37,Salamanca,231,Parada de Rubiales,249,136,113
37,Salamanca,232,Paradinas de San Juan,394,234,160
37,Salamanca,233,Pastores,54,31,23
37,Salamanca,234,"Payo, El",325,162,163
37,Salamanca,235,Pedraza de Alba,222,115,107
37,Salamanca,236,Pedrosillo de Alba,124,73,51
37,Salamanca,237,Pedrosillo de los Aires,321,190,131
37,Salamanca,238,Pedrosillo el Ralo,129,67,62
37,Salamanca,239,"Pedroso de la Armuña, El",209,110,99
37,Salamanca,240,Pelabravo,1323,719,604
37,Salamanca,241,Pelarrodríguez,162,97,65
37,Salamanca,242,Pelayos,74,44,30
37,Salamanca,243,"Peña, La",72,40,32
37,Salamanca,244,Peñacaballera,155,74,81
37,Salamanca,245,Peñaparda,319,163,156
37,Salamanca,246,Peñaranda de Bracamonte,6079,2985,3094
37,Salamanca,247,Peñarandilla,184,103,81
37,Salamanca,248,Peralejos de Abajo,168,92,76
37,Salamanca,249,Peralejos de Arriba,35,23,12
37,Salamanca,250,Pereña de la Ribera,312,171,141
37,Salamanca,251,Peromingo,122,60,62
37,Salamanca,252,Pinedas,106,63,43
37,Salamanca,253,"Pino de Tormes, El",155,87,68
37,Salamanca,254,Pitiegua,179,101,78
37,Salamanca,255,Pizarral,60,37,23
37,Salamanca,256,Poveda de las Cintas,197,113,84
37,Salamanca,257,Pozos de Hinojo,54,29,25
37,Salamanca,258,Puebla de Azaba,145,82,63
37,Salamanca,259,Puebla de San Medel,33,18,15
37,Salamanca,260,Puebla de Yeltes,142,76,66
37,Salamanca,261,Puente del Congosto,223,130,93
37,Salamanca,262,Puertas,67,40,27
37,Salamanca,263,Puerto de Béjar,360,174,186
37,Salamanca,264,Puerto Seguro,68,31,37
37,Salamanca,265,Rágama,204,100,104
37,Salamanca,266,"Redonda, La",64,37,27
37,Salamanca,267,Retortillo,174,91,83
37,Salamanca,268,"Rinconada de la Sierra, La",108,64,44
37,Salamanca,269,Robleda,462,256,206
37,Salamanca,270,Robliza de Cojos,190,103,87
37,Salamanca,271,Rollán,341,192,149
37,Salamanca,272,Saelices el Chico,173,98,75
37,Salamanca,273,"Sagrada, La",84,46,38
37,Salamanca,303,"Sahugo, El",177,98,79
37,Salamanca,274,Salamanca,143954,65035,78919
37,Salamanca,275,Saldeana,105,63,42
37,Salamanca,276,Salmoral,114,68,46
37,Salamanca,277,Salvatierra de Tormes,78,39,39
37,Salamanca,278,San Cristóbal de la Cuesta,1114,581,533
37,Salamanca,284,San Esteban de la Sierra,371,211,160
37,Salamanca,285,San Felices de los Gallegos,354,190,164
37,Salamanca,286,San Martín del Castañar,240,131,109
37,Salamanca,287,San Miguel de Valero,316,167,149
37,Salamanca,36,San Miguel del Robledo,48,26,22
37,Salamanca,288,San Morales,354,190,164
37,Salamanca,289,San Muñoz,211,103,108
37,Salamanca,291,San Pedro de Rozados,277,156,121
37,Salamanca,290,San Pedro del Valle,149,86,63
37,Salamanca,292,San Pelayo de Guareña,92,53,39
37,Salamanca,280,Sanchón de la Ribera,70,35,35
37,Salamanca,281,Sanchón de la Sagrada,36,21,15
37,Salamanca,282,Sanchotello,222,113,109
37,Salamanca,279,Sancti-Spíritus,738,399,339
37,Salamanca,283,Sando,118,69,49
37,Salamanca,293,Santa María de Sando,98,50,48
37,Salamanca,294,Santa Marta de Tormes,14683,7130,7553
37,Salamanca,296,Santiago de la Puebla,290,151,139
37,Salamanca,297,Santibáñez de Béjar,452,228,224
37,Salamanca,298,Santibáñez de la Sierra,157,90,67
37,Salamanca,299,Santiz,246,135,111
37,Salamanca,300,"Santos, Los",592,298,294
37,Salamanca,301,Sardón de los Frailes,98,54,44
37,Salamanca,302,Saucelle,254,129,125
37,Salamanca,304,Sepulcro-Hilario,164,90,74
37,Salamanca,305,Sequeros,215,100,115
37,Salamanca,306,Serradilla del Arroyo,248,135,113
37,Salamanca,307,Serradilla del Llano,145,81,64
37,Salamanca,309,"Sierpe, La",41,20,21
37,Salamanca,310,Sieteiglesias de Tormes,175,83,92
37,Salamanca,311,Sobradillo,182,93,89
37,Salamanca,312,Sorihuela,256,134,122
37,Salamanca,313,Sotoserrano,525,277,248
37,Salamanca,314,Tabera de Abajo,102,56,46
37,Salamanca,315,"Tala, La",78,42,36
37,Salamanca,316,Tamames,792,398,394
37,Salamanca,317,Tarazona de Guareña,272,150,122
37,Salamanca,318,Tardáguila,192,120,72
37,Salamanca,319,"Tejado, El",91,52,39
37,Salamanca,320,Tejeda y Segoyuela,94,52,42
37,Salamanca,321,Tenebrón,133,73,60
37,Salamanca,322,Terradillos,3104,1544,1560
37,Salamanca,323,Topas,512,267,245
37,Salamanca,324,Tordillos,324,174,150
37,Salamanca,325,"Tornadizo, El",87,51,36
37,Salamanca,327,Torresmenudas,185,102,83
37,Salamanca,328,Trabanca,175,85,90
37,Salamanca,329,Tremedal de Tormes,37,20,17
37,Salamanca,330,Valdecarros,314,160,154
37,Salamanca,331,Valdefuentes de Sangusín,187,104,83
37,Salamanca,332,Valdehijaderos,83,45,38
37,Salamanca,333,Valdelacasa,198,114,84
37,Salamanca,334,Valdelageve,70,39,31
37,Salamanca,335,Valdelosa,417,213,204
37,Salamanca,336,Valdemierque,58,37,21
37,Salamanca,337,Valderrodrigo,133,70,63
37,Salamanca,338,Valdunciel,101,53,48
37,Salamanca,339,Valero,301,172,129
37,Salamanca,343,Vallejera de Riofrío,67,38,29
37,Salamanca,340,Valsalabroso,119,66,53
37,Salamanca,341,Valverde de Valdelacasa,54,27,27
37,Salamanca,342,Valverdón,267,137,130
37,Salamanca,344,Vecinos,226,112,114
37,Salamanca,345,Vega de Tirados,159,81,78
37,Salamanca,346,"Veguillas, Las",274,136,138
37,Salamanca,347,"Vellés, La",517,278,239
37,Salamanca,348,Ventosa del Río Almar,104,57,47
37,Salamanca,349,"Vídola, La",112,56,56
37,Salamanca,351,Villaflores,260,130,130
37,Salamanca,352,Villagonzalo de Tormes,226,140,86
37,Salamanca,353,Villalba de los Llanos,113,65,48
37,Salamanca,354,Villamayor,7539,3754,3785
37,Salamanca,355,Villanueva del Conde,179,93,86
37,Salamanca,356,Villar de Argañán,98,55,43
37,Salamanca,357,Villar de Ciervo,266,144,122
37,Salamanca,358,Villar de Gallimazo,195,126,69
37,Salamanca,359,Villar de la Yegua,159,87,72
37,Salamanca,360,Villar de Peralonso,209,107,102
37,Salamanca,361,Villar de Samaniego,79,45,34
37,Salamanca,362,Villares de la Reina,6576,3229,3347
37,Salamanca,363,Villares de Yeltes,101,48,53
37,Salamanca,364,Villarino de los Aires,775,407,368
37,Salamanca,365,Villarmayor,165,93,72
37,Salamanca,366,Villarmuerto,39,27,12
37,Salamanca,367,Villasbuenas,168,93,75
37,Salamanca,368,Villasdardo,23,8,15
37,Salamanca,369,Villaseco de los Gamitos,130,73,57
37,Salamanca,370,Villaseco de los Reyes,296,173,123
37,Salamanca,371,Villasrubias,245,131,114
37,Salamanca,372,Villaverde de Guareña,140,75,65
37,Salamanca,373,Villavieja de Yeltes,696,370,326
37,Salamanca,374,Villoria,1267,647,620
37,Salamanca,375,Villoruela,738,372,366
37,Salamanca,350,Vilvestre,394,199,195
37,Salamanca,376,Vitigudino,2363,1135,1228
37,Salamanca,377,Yecla de Yeltes,221,114,107
37,Salamanca,378,Zamarra,75,43,32
37,Salamanca,379,Zamayón,191,116,75
37,Salamanca,380,Zarapicos,60,36,24
37,Salamanca,381,"Zarza de Pumareda, La",138,84,54
37,Salamanca,382,Zorita de la Frontera,152,74,78
38,Santa Cruz de Tenerife,1,Adeje,50167,25085,25082
38,Santa Cruz de Tenerife,2,Agulo,1113,555,558
38,Santa Cruz de Tenerife,3,Alajeró,2056,1084,972
38,Santa Cruz de Tenerife,4,Arafo,5712,2878,2834
38,Santa Cruz de Tenerife,5,Arico,9020,4640,4380
38,Santa Cruz de Tenerife,6,Arona,85249,42981,42268
38,Santa Cruz de Tenerife,7,Barlovento,1944,983,961
38,Santa Cruz de Tenerife,8,Breña Alta,7305,3560,3745
38,Santa Cruz de Tenerife,9,Breña Baja,5963,3023,2940
38,Santa Cruz de Tenerife,10,Buenavista del Norte,4710,2344,2366
38,Santa Cruz de Tenerife,11,Candelaria,28694,13816,14878
38,Santa Cruz de Tenerife,12,Fasnia,2984,1567,1417
38,Santa Cruz de Tenerife,13,Frontera,4465,2236,2229
38,Santa Cruz de Tenerife,14,Fuencaliente de la Palma,1841,927,914
38,Santa Cruz de Tenerife,15,Garachico,4936,2463,2473
38,Santa Cruz de Tenerife,16,Garafía,1916,993,923
38,Santa Cruz de Tenerife,17,Granadilla de Abona,54942,27299,27643
38,Santa Cruz de Tenerife,18,"Guancha, La",5562,2723,2839
38,Santa Cruz de Tenerife,19,Guía de Isora,22301,11091,11210
38,Santa Cruz de Tenerife,20,Güímar,21536,10610,10926
38,Santa Cruz de Tenerife,21,Hermigua,1838,961,877
38,Santa Cruz de Tenerife,22,Icod de los Vinos,23971,11734,12237
38,Santa Cruz de Tenerife,24,"Llanos de Aridane, Los",20189,9780,10409
38,Santa Cruz de Tenerife,25,"Matanza de Acentejo, La",9092,4545,4547
38,Santa Cruz de Tenerife,26,"Orotava, La",42454,20744,21710
38,Santa Cruz de Tenerife,27,"Paso, El",7967,3971,3996
38,Santa Cruz de Tenerife,901,"Pinar de El Hierro, El",2016,1051,965
38,Santa Cruz de Tenerife,28,Puerto de la Cruz,30849,15066,15783
38,Santa Cruz de Tenerife,29,Puntagorda,2320,1176,1144
38,Santa Cruz de Tenerife,30,Puntallana,2605,1297,1308
38,Santa Cruz de Tenerife,31,"Realejos, Los",37207,18230,18977
38,Santa Cruz de Tenerife,32,"Rosario, El",17866,9064,8802
38,Santa Cruz de Tenerife,33,San Andrés y Sauces,4219,2106,2113
38,Santa Cruz de Tenerife,23,San Cristóbal de La Laguna,159034,76428,82606
38,Santa Cruz de Tenerife,34,San Juan de la Rambla,4908,2454,2454
38,Santa Cruz de Tenerife,35,San Miguel de Abona,22606,11347,11259
38,Santa Cruz de Tenerife,36,San Sebastián de la Gomera,9501,4732,4769
38,Santa Cruz de Tenerife,37,Santa Cruz de la Palma,15441,7379,8062
38,Santa Cruz de Tenerife,38,Santa Cruz de Tenerife,209395,99515,109880
38,Santa Cruz de Tenerife,39,Santa Úrsula,15285,7547,7738
38,Santa Cruz de Tenerife,40,Santiago del Teide,11972,5934,6038
38,Santa Cruz de Tenerife,41,"Sauzal, El",9145,4553,4592
38,Santa Cruz de Tenerife,42,"Silos, Los",4679,2340,2339
38,Santa Cruz de Tenerife,43,Tacoronte,24652,12279,12373
38,Santa Cruz de Tenerife,44,"Tanque, El",2784,1343,1441
38,Santa Cruz de Tenerife,45,Tazacorte,4575,2353,2222
38,Santa Cruz de Tenerife,46,Tegueste,11344,5583,5761
38,Santa Cruz de Tenerife,47,Tijarafe,2640,1334,1306
38,Santa Cruz de Tenerife,49,Valle Gran Rey,4719,2397,2322
38,Santa Cruz de Tenerife,50,Vallehermoso,2935,1522,1413
38,Santa Cruz de Tenerife,48,Valverde,5165,2579,2586
38,Santa Cruz de Tenerife,51,"Victoria de Acentejo, La",9228,4566,4662
38,Santa Cruz de Tenerife,52,Vilaflor de Chasna,1823,921,902
38,Santa Cruz de Tenerife,53,Villa de Mazo,4950,2515,2435
40,Segovia,1,Abades,859,421,438
40,Segovia,2,Adrada de Pirón,38,22,16
40,Segovia,3,Adrados,122,71,51
40,Segovia,4,Aguilafuente,562,287,275
40,Segovia,5,Alconada de Maderuelo,24,15,9
40,Segovia,12,Aldea Real,281,148,133
40,Segovia,6,Aldealcorvo,18,11,7
40,Segovia,7,Aldealengua de Pedraza,83,50,33
40,Segovia,8,Aldealengua de Santa María,66,34,32
40,Segovia,9,Aldeanueva de la Serrezuela,42,29,13
40,Segovia,10,Aldeanueva del Codonal,110,59,51
40,Segovia,13,Aldeasoña,64,36,28
40,Segovia,14,Aldehorno,55,32,23
40,Segovia,15,Aldehuela del Codonal,23,12,11
40,Segovia,16,Aldeonte,55,32,23
40,Segovia,17,Anaya,120,61,59
40,Segovia,18,Añe,69,41,28
40,Segovia,19,Arahuetes,25,18,7
40,Segovia,20,Arcones,191,99,92
40,Segovia,21,Arevalillo de Cega,18,12,6
40,Segovia,22,Armuña,238,135,103
40,Segovia,24,Ayllón,1124,585,539
40,Segovia,25,Barbolla,143,85,58
40,Segovia,26,Basardilla,148,73,75
40,Segovia,28,Bercial,107,56,51
40,Segovia,29,Bercimuel,34,20,14
40,Segovia,30,Bernardos,475,264,211
40,Segovia,31,Bernuy de Porreros,1059,547,512
40,Segovia,32,Boceguillas,699,354,345
40,Segovia,33,Brieva,91,53,38
40,Segovia,34,Caballar,74,44,30
40,Segovia,35,Cabañas de Polendos,203,106,97
40,Segovia,36,Cabezuela,626,328,298
40,Segovia,37,Calabazas de Fuentidueña,25,16,9
40,Segovia,39,Campo de San Pedro,255,145,110
40,Segovia,40,Cantalejo,3546,1774,1772
40,Segovia,41,Cantimpalos,1364,727,637
40,Segovia,161,Carabias,57,41,16
40,Segovia,43,Carbonero el Mayor,2492,1277,1215
40,Segovia,44,Carrascal del Río,137,74,63
40,Segovia,45,Casla,155,83,72
40,Segovia,46,Castillejo de Mesleón,111,63,48
40,Segovia,47,Castro de Fuentidueña,46,29,17
40,Segovia,48,Castrojimeno,31,16,15
40,Segovia,49,Castroserna de Abajo,36,21,15
40,Segovia,51,Castroserracín,35,18,17
40,Segovia,52,Cedillo de la Torre,85,45,40
40,Segovia,53,Cerezo de Abajo,126,69,57
40,Segovia,54,Cerezo de Arriba,134,72,62
40,Segovia,65,Chañe,699,356,343
40,Segovia,55,Cilleruelo de San Mamés,33,22,11
40,Segovia,56,Cobos de Fuentidueña,36,16,20
40,Segovia,57,Coca,1741,871,870
40,Segovia,58,Codorniz,317,162,155
40,Segovia,59,Collado Hermoso,128,69,59
40,Segovia,60,Condado de Castilnovo,85,47,38
40,Segovia,61,Corral de Ayllón,75,42,33
40,Segovia,902,Cozuelos de Fuentidueña,114,62,52
40,Segovia,62,Cubillo,72,46,26
40,Segovia,63,Cuéllar,9608,4827,4781
40,Segovia,905,Cuevas de Provanco,127,74,53
40,Segovia,68,Domingo García,32,18,14
40,Segovia,69,Donhierro,86,47,39
40,Segovia,70,Duruelo,160,98,62
40,Segovia,71,Encinas,37,19,18
40,Segovia,72,Encinillas,340,188,152
40,Segovia,73,Escalona del Prado,475,253,222
40,Segovia,74,Escarabajosa de Cabezas,281,149,132
40,Segovia,75,Escobar de Polendos,176,97,79
40,Segovia,76,"Espinar, El",9814,4934,4880
40,Segovia,77,Espirdo,1543,796,747
40,Segovia,78,Fresneda de Cuéllar,174,103,71
40,Segovia,79,Fresno de Cantespino,303,164,139
40,Segovia,80,Fresno de la Fuente,77,45,32
40,Segovia,81,Frumales,124,68,56
40,Segovia,82,Fuente de Santa Cruz,109,58,51
40,Segovia,83,Fuente el Olmo de Fuentidueña,278,93,185
40,Segovia,84,Fuente el Olmo de Íscar,51,31,20
40,Segovia,86,Fuentepelayo,775,401,374
40,Segovia,87,Fuentepiñel,72,43,29
40,Segovia,88,Fuenterrebollo,316,169,147
40,Segovia,89,Fuentesaúco de Fuentidueña,244,131,113
40,Segovia,91,Fuentesoto,96,57,39
40,Segovia,92,Fuentidueña,144,82,62
40,Segovia,93,Gallegos,95,51,44
40,Segovia,94,Garcillán,519,280,239
40,Segovia,95,Gomezserracín,636,326,310
40,Segovia,97,Grajera,256,144,112
40,Segovia,99,Honrubia de la Cuesta,52,31,21
40,Segovia,100,Hontalbilla,302,167,135
40,Segovia,101,Hontanares de Eresma,1601,830,771
40,Segovia,103,"Huertos, Los",171,91,80
40,Segovia,104,Ituero y Lama,437,223,214
40,Segovia,105,Juarros de Riomoros,45,27,18
40,Segovia,106,Juarros de Voltoya,186,94,92
40,Segovia,107,Labajos,110,61,49
40,Segovia,108,Laguna de Contreras,110,67,43
40,Segovia,109,Languilla,83,48,35
40,Segovia,110,Lastras de Cuéllar,318,169,149
40,Segovia,111,Lastras del Pozo,65,34,31
40,Segovia,112,"Lastrilla, La",4559,2304,2255
40,Segovia,113,"Losa, La",537,292,245
40,Segovia,115,Maderuelo,109,63,46
40,Segovia,903,Marazoleja,97,65,32
40,Segovia,118,Marazuela,52,31,21
40,Segovia,119,Martín Miguel,248,147,101
40,Segovia,120,Martín Muñoz de la Dehesa,317,164,153
40,Segovia,121,Martín Muñoz de las Posadas,259,147,112
40,Segovia,122,Marugán,757,415,342
40,Segovia,124,Mata de Cuéllar,266,142,124
40,Segovia,123,Matabuena,203,118,85
40,Segovia,125,"Matilla, La",73,44,29
40,Segovia,126,Melque de Cercos,69,40,29
40,Segovia,127,Membibre de la Hoz,46,24,22
40,Segovia,128,Migueláñez,131,73,58
40,Segovia,129,Montejo de Arévalo,163,92,71
40,Segovia,130,Montejo de la Vega de la Serrezuela,128,78,50
40,Segovia,131,Monterrubio,61,33,28
40,Segovia,132,Moral de Hornuez,42,25,17
40,Segovia,134,Mozoncillo,880,488,392
40,Segovia,135,Muñopedro,306,158,148
40,Segovia,136,Muñoveros,142,69,73
40,Segovia,138,Nava de la Asunción,2753,1415,1338
40,Segovia,139,Navafría,286,154,132
40,Segovia,140,Navalilla,96,51,45
40,Segovia,141,Navalmanzano,1040,553,487
40,Segovia,142,Navares de Ayuso,46,23,23
40,Segovia,143,Navares de Enmedio,91,50,41
40,Segovia,144,Navares de las Cuevas,20,13,7
40,Segovia,145,Navas de Oro,1272,650,622
40,Segovia,904,Navas de Riofrío,413,197,216
40,Segovia,146,Navas de San Antonio,371,206,165
40,Segovia,148,Nieva,249,123,126
40,Segovia,149,Olombrada,489,270,219
40,Segovia,150,Orejana,62,36,26
40,Segovia,151,Ortigosa de Pestaño,49,25,24
40,Segovia,901,Ortigosa del Monte,576,293,283
40,Segovia,152,Otero de Herreros,959,491,468
40,Segovia,154,Pajarejos,26,14,12
40,Segovia,155,Palazuelos de Eresma,5830,3018,2812
40,Segovia,156,Pedraza,358,203,155
40,Segovia,157,Pelayos del Arroyo,45,25,20
40,Segovia,158,Perosillo,18,12,6
40,Segovia,159,Pinarejos,178,102,76
40,Segovia,160,Pinarnegrillo,101,58,43
40,Segovia,162,Prádena,487,256,231
40,Segovia,163,Puebla de Pedraza,51,28,23
40,Segovia,164,Rapariegos,197,107,90
40,Segovia,181,Real Sitio de San Ildefonso,5183,2524,2659
40,Segovia,165,Rebollo,75,38,37
40,Segovia,166,Remondo,307,151,156
40,Segovia,168,Riaguas de San Bartolomé,29,20,9
40,Segovia,170,Riaza,2150,1138,1012
40,Segovia,171,Ribota,47,34,13
40,Segovia,172,Riofrío de Riaza,39,25,14
40,Segovia,173,Roda de Eresma,250,131,119
40,Segovia,174,Sacramenia,352,173,179
40,Segovia,176,Samboal,464,246,218
40,Segovia,177,San Cristóbal de Cuéllar,152,85,67
40,Segovia,178,San Cristóbal de la Vega,83,45,38
40,Segovia,906,San Cristóbal de Segovia,3152,1588,1564
40,Segovia,182,San Martín y Mudrián,232,114,118
40,Segovia,183,San Miguel de Bernuy,136,65,71
40,Segovia,184,San Pedro de Gaíllos,306,157,149
40,Segovia,179,Sanchonuño,1012,503,509
40,Segovia,180,Sangarcía,289,158,131
40,Segovia,185,Santa María la Real de Nieva,891,501,390
40,Segovia,186,Santa Marta del Cerro,56,29,27
40,Segovia,188,Santiuste de Pedraza,84,55,29
40,Segovia,189,Santiuste de San Juan Bautista,534,290,244
40,Segovia,190,Santo Domingo de Pirón,48,26,22
40,Segovia,191,Santo Tomé del Puerto,248,140,108
40,Segovia,192,Sauquillo de Cabezas,141,81,60
40,Segovia,193,Sebúlcor,254,134,120
40,Segovia,194,Segovia,51011,23791,27220
40,Segovia,195,Sepúlveda,990,497,493
40,Segovia,196,Sequera de Fresno,44,29,15
40,Segovia,198,Sotillo,30,16,14
40,Segovia,199,Sotosalbos,135,76,59
40,Segovia,200,Tabanera la Luenga,54,27,27
40,Segovia,201,Tolocirio,42,19,23
40,Segovia,206,Torre Val de San Pedro,190,99,91
40,Segovia,202,Torreadrada,52,28,24
40,Segovia,203,Torrecaballeros,1454,748,706
40,Segovia,204,Torrecilla del Pinar,180,97,83
40,Segovia,205,Torreiglesias,256,129,127
40,Segovia,207,Trescasas,1103,570,533
40,Segovia,208,Turégano,1004,519,485
40,Segovia,210,Urueñas,100,69,31
40,Segovia,211,Valdeprados,61,34,27
40,Segovia,212,Valdevacas de Montejo,29,16,13
40,Segovia,213,Valdevacas y Guijar,85,49,36
40,Segovia,218,Valle de Tabladillo,76,45,31
40,Segovia,219,Vallelado,702,368,334
40,Segovia,220,Valleruela de Pedraza,80,38,42
40,Segovia,221,Valleruela de Sepúlveda,54,25,29
40,Segovia,214,Valseca,228,124,104
40,Segovia,215,Valtiendas,78,49,29
40,Segovia,216,Valverde del Majano,1152,574,578
40,Segovia,222,Veganzones,204,106,98
40,Segovia,223,Vegas de Matute,329,192,137
40,Segovia,224,Ventosilla y Tejadilla,15,10,5
40,Segovia,225,Villacastín,1530,777,753
40,Segovia,228,Villaverde de Íscar,585,305,280
40,Segovia,229,Villaverde de Montejo,24,16,8
40,Segovia,230,Villeguillo,123,68,55
40,Segovia,231,Yanguas de Eresma,123,67,56
40,Segovia,233,Zarzuela del Monte,494,253,241
40,Segovia,234,Zarzuela del Pinar,410,216,194
41,Sevilla,1,Aguadulce,2046,1017,1029
41,Sevilla,2,Alanís,1675,836,839
41,Sevilla,3,Albaida del Aljarafe,3254,1600,1654
41,Sevilla,4,Alcalá de Guadaíra,76547,37948,38599
41,Sevilla,5,Alcalá del Río,12288,6242,6046
41,Sevilla,6,Alcolea del Río,3307,1648,1659
41,Sevilla,7,"Algaba, La",16618,8201,8417
41,Sevilla,8,Algámitas,1251,651,600
41,Sevilla,9,Almadén de la Plata,1324,689,635
41,Sevilla,10,Almensilla,6537,3252,3285
41,Sevilla,11,Arahal,19491,9666,9825
41,Sevilla,12,Aznalcázar,4820,2450,2370
41,Sevilla,13,Aznalcóllar,6057,3077,2980
41,Sevilla,14,Badolatosa,3089,1596,1493
41,Sevilla,15,Benacazón,7324,3693,3631
41,Sevilla,16,Bollullos de la Mitación,11160,5540,5620
41,Sevilla,17,Bormujos,22780,11260,11520
41,Sevilla,18,Brenes,12804,6359,6445
41,Sevilla,19,Burguillos,7098,3582,3516
41,Sevilla,20,"Cabezas de San Juan, Las",16400,8173,8227
41,Sevilla,21,Camas,28157,13791,14366
41,Sevilla,22,"Campana, La",5137,2571,2566
41,Sevilla,23,Cantillana,10782,5423,5359
41,Sevilla,901,Cañada Rosal,3391,1678,1713
41,Sevilla,24,Carmona,29551,14909,14642
41,Sevilla,25,Carrión de los Céspedes,2597,1258,1339
41,Sevilla,26,Casariche,5305,2716,2589
41,Sevilla,27,Castilblanco de los Arroyos,5107,2582,2525
41,Sevilla,28,Castilleja de Guzmán,2874,1474,1400
41,Sevilla,29,Castilleja de la Cuesta,17167,8313,8854
41,Sevilla,30,Castilleja del Campo,622,313,309
41,Sevilla,31,"Castillo de las Guardas, El",1500,796,704
41,Sevilla,32,Cazalla de la Sierra,4660,2294,2366
41,Sevilla,33,Constantina,5742,2846,2896
41,Sevilla,34,Coria del Río,30887,15308,15579
41,Sevilla,35,Coripe,1215,584,631
41,Sevilla,36,"Coronil, El",4690,2352,2338
41,Sevilla,37,"Corrales, Los",3996,2030,1966
41,Sevilla,903,"Cuervo de Sevilla, El",8635,4346,4289
41,Sevilla,38,Dos Hermanas,138981,68066,70915
41,Sevilla,39,Écija,39530,19445,20085
41,Sevilla,40,Espartinas,16505,8290,8215
41,Sevilla,41,Estepa,12373,6110,6263
41,Sevilla,42,Fuentes de Andalucía,7217,3585,3632
41,Sevilla,43,"Garrobo, El",825,420,405
41,Sevilla,44,Gelves,10388,5153,5235
41,Sevilla,45,Gerena,7833,3889,3944
41,Sevilla,46,Gilena,3686,1871,1815
41,Sevilla,47,Gines,13481,6600,6881
41,Sevilla,48,Guadalcanal,2545,1278,1267
41,Sevilla,49,Guillena,13682,6919,6763
41,Sevilla,50,Herrera,6544,3259,3285
41,Sevilla,51,Huévar del Aljarafe,3289,1687,1602
41,Sevilla,902,Isla Mayor,5741,2854,2887
41,Sevilla,52,Lantejuela,3851,1963,1888
41,Sevilla,53,Lebrija,27727,13845,13882
41,Sevilla,54,Lora de Estepa,888,464,424
41,Sevilla,55,Lora del Río,18316,9034,9282
41,Sevilla,56,"Luisiana, La",4608,2313,2295
41,Sevilla,57,"Madroño, El",297,149,148
41,Sevilla,58,Mairena del Alcor,24125,12044,12081
41,Sevilla,59,Mairena del Aljarafe,47541,23002,24539
41,Sevilla,60,Marchena,19271,9539,9732
41,Sevilla,61,Marinaleda,2577,1304,1273
41,Sevilla,62,Martín de la Jara,2642,1368,1274
41,Sevilla,63,"Molares, Los",3559,1808,1751
41,Sevilla,64,Montellano,7003,3510,3493
41,Sevilla,65,Morón de la Frontera,27229,13382,13847
41,Sevilla,66,"Navas de la Concepción, Las",1523,751,772
41,Sevilla,67,Olivares,9427,4727,4700
41,Sevilla,68,Osuna,17418,8665,8753
41,Sevilla,69,"Palacios y Villafranca, Los",38698,19277,19421
41,Sevilla,904,"Palmar de Troya, El",2325,1159,1166
41,Sevilla,70,Palomares del Río,9161,4582,4579
41,Sevilla,71,Paradas,6798,3371,3427
41,Sevilla,72,Pedrera,5104,2535,2569
41,Sevilla,73,"Pedroso, El",2054,1017,1037
41,Sevilla,74,Peñaflor,3646,1834,1812
41,Sevilla,75,Pilas,14052,7039,7013
41,Sevilla,76,Pruna,2542,1288,1254
41,Sevilla,77,"Puebla de Cazalla, La",10884,5418,5466
41,Sevilla,78,"Puebla de los Infantes, La",2966,1452,1514
41,Sevilla,79,"Puebla del Río, La",11862,5833,6029
41,Sevilla,80,"Real de la Jara, El",1523,766,757
41,Sevilla,81,"Rinconada, La",40162,19965,20197
41,Sevilla,82,"Roda de Andalucía, La",4222,2090,2132
41,Sevilla,83,"Ronquillo, El",1441,732,709
41,Sevilla,84,"Rubio, El",3305,1655,1650
41,Sevilla,85,Salteras,5627,2727,2900
41,Sevilla,86,San Juan de Aznalfarache,22472,10863,11609
41,Sevilla,88,San Nicolás del Puerto,608,317,291
41,Sevilla,87,Sanlúcar la Mayor,14172,6972,7200
41,Sevilla,89,Santiponce,8539,4224,4315
41,Sevilla,90,"Saucejo, El",4246,2116,2130
41,Sevilla,91,Sevilla,684025,323988,360037
41,Sevilla,92,Tocina,9420,4677,4743
41,Sevilla,93,Tomares,25374,12499,12875
41,Sevilla,94,Umbrete,9376,4674,4702
41,Sevilla,95,Utrera,51718,25487,26231
41,Sevilla,96,Valencina de la Concepción,8029,3923,4106
41,Sevilla,97,Villamanrique de la Condesa,4640,2277,2363
41,Sevilla,100,Villanueva de San Juan,994,499,495
41,Sevilla,98,Villanueva del Ariscal,6814,3302,3512
41,Sevilla,99,Villanueva del Río y Minas,4939,2494,2445
41,Sevilla,101,Villaverde del Río,7700,3910,3790
41,Sevilla,102,"Viso del Alcor, El",19265,9567,9698
42,Soria,1,Abejar,376,189,187
42,Soria,3,Adradas,61,35,26
42,Soria,4,Ágreda,3056,1564,1492
42,Soria,6,Alconaba,198,131,67
42,Soria,7,Alcubilla de Avellaneda,114,63,51
42,Soria,8,Alcubilla de las Peñas,58,37,21
42,Soria,9,Aldealafuente,79,47,32
42,Soria,10,Aldealices,21,15,6
42,Soria,11,Aldealpozo,20,8,12
42,Soria,12,Aldealseñor,25,16,9
42,Soria,13,Aldehuela de Periáñez,34,19,15
42,Soria,14,"Aldehuelas, Las",61,36,25
42,Soria,15,Alentisque,26,16,10
42,Soria,16,Aliud,21,14,7
42,Soria,17,Almajano,178,94,84
42,Soria,18,Almaluez,125,75,50
42,Soria,19,Almarza,620,346,274
42,Soria,20,Almazán,5426,2782,2644
42,Soria,21,Almazul,61,42,19
42,Soria,22,Almenar de Soria,225,141,84
42,Soria,23,Alpanseque,53,33,20
42,Soria,24,Arancón,82,53,29
42,Soria,25,Arcos de Jalón,1525,780,745
42,Soria,26,Arenillas,49,29,20
42,Soria,27,Arévalo de la Sierra,69,44,25
42,Soria,28,Ausejo de la Sierra,109,57,52
42,Soria,29,Baraona,130,76,54
42,Soria,30,Barca,107,67,40
42,Soria,31,Barcones,26,15,11
42,Soria,32,Bayubas de Abajo,150,80,70
42,Soria,33,Bayubas de Arriba,62,35,27
42,Soria,34,Beratón,46,23,23
42,Soria,35,Berlanga de Duero,852,444,408
42,Soria,36,Blacos,41,21,20
42,Soria,37,Bliecos,27,17,10
42,Soria,38,Borjabad,30,18,12
42,Soria,39,Borobia,231,133,98
42,Soria,41,Buberos,28,14,14
42,Soria,42,Buitrago,75,41,34
42,Soria,43,Burgo de Osma-Ciudad de Osma,5166,2574,2592
42,Soria,44,Cabrejas del Campo,51,30,21
42,Soria,45,Cabrejas del Pinar,301,171,130
42,Soria,46,Calatañazor,45,26,19
42,Soria,48,Caltojar,52,35,17
42,Soria,49,Candilichera,102,63,39
42,Soria,50,Cañamaque,27,19,8
42,Soria,51,Carabantes,20,12,8
42,Soria,52,Caracena,15,10,5
42,Soria,53,Carrascosa de Abajo,17,11,6
42,Soria,54,Carrascosa de la Sierra,20,15,5
42,Soria,55,Casarejos,146,77,69
42,Soria,56,Castilfrío de la Sierra,38,23,15
42,Soria,58,Castillejo de Robledo,101,59,42
42,Soria,57,Castilruiz,156,87,69
42,Soria,59,Centenera de Andaluz,24,12,12
42,Soria,60,Cerbón,29,21,8
42,Soria,61,Cidones,311,186,125
42,Soria,62,Cigudosa,15,11,4
42,Soria,63,Cihuela,40,26,14
42,Soria,64,Ciria,71,38,33
42,Soria,65,Cirujales del Río,20,15,5
42,Soria,68,Coscurita,66,42,24
42,Soria,69,Covaleda,1582,826,756
42,Soria,70,Cubilla,24,16,8
42,Soria,71,Cubo de la Solana,170,101,69
42,Soria,73,Cueva de Ágreda,71,44,27
42,Soria,75,Dévanos,77,44,33
42,Soria,76,Deza,181,102,79
42,Soria,78,Duruelo de la Sierra,1050,541,509
42,Soria,79,Escobosa de Almazán,19,12,7
42,Soria,80,Espeja de San Marcelino,147,89,58
42,Soria,81,Espejón,136,71,65
42,Soria,82,Estepa de San Juan,13,8,5
42,Soria,83,Frechilla de Almazán,20,11,9
42,Soria,84,Fresno de Caracena,22,13,9
42,Soria,85,Fuentearmegil,153,90,63
42,Soria,86,Fuentecambrón,32,19,13
42,Soria,87,Fuentecantos,68,34,34
42,Soria,88,Fuentelmonge,64,36,28
42,Soria,89,Fuentelsaz de Soria,62,32,30
42,Soria,90,Fuentepinilla,80,47,33
42,Soria,92,Fuentes de Magaña,53,31,22
42,Soria,93,Fuentestrún,47,30,17
42,Soria,94,Garray,767,406,361
42,Soria,95,Golmayo,3014,1572,1442
42,Soria,96,Gómara,299,170,129
42,Soria,97,Gormaz,28,19,9
42,Soria,98,Herrera de Soria,11,8,3
42,Soria,100,Hinojosa del Campo,26,18,8
42,Soria,103,Langa de Duero,699,377,322
42,Soria,105,Liceras,49,27,22
42,Soria,106,"Losilla, La",13,9,4
42,Soria,107,Magaña,67,42,25
42,Soria,108,Maján,9,6,3
42,Soria,110,Matalebreras,75,50,25
42,Soria,111,Matamala de Almazán,260,145,115
42,Soria,113,Medinaceli,679,350,329
42,Soria,115,Miño de Medinaceli,87,52,35
42,Soria,116,Miño de San Esteban,39,26,13
42,Soria,117,Molinos de Duero,161,92,69
42,Soria,118,Momblona,18,15,3
42,Soria,119,Monteagudo de las Vicarías,173,87,86
42,Soria,120,Montejo de Tiermes,148,93,55
42,Soria,121,Montenegro de Cameros,52,35,17
42,Soria,123,Morón de Almazán,198,105,93
42,Soria,124,Muriel de la Fuente,55,37,18
42,Soria,125,Muriel Viejo,75,48,27
42,Soria,127,Nafría de Ucero,38,20,18
42,Soria,128,Narros,68,42,26
42,Soria,129,Navaleno,741,397,344
42,Soria,130,Nepas,52,36,16
42,Soria,131,Nolay,50,29,21
42,Soria,132,Noviercas,165,91,74
42,Soria,134,Ólvega,3782,1980,1802
42,Soria,135,Oncala,62,40,22
42,Soria,139,Pinilla del Campo,18,10,8
42,Soria,140,Portillo de Soria,13,10,3
42,Soria,141,"Póveda de Soria, La",107,65,42
42,Soria,142,Pozalmuro,48,24,24
42,Soria,144,Quintana Redonda,508,291,217
42,Soria,145,Quintanas de Gormaz,130,76,54
42,Soria,148,Quiñonería,9,5,4
42,Soria,149,"Rábanos, Los",447,247,200
42,Soria,151,Rebollar,36,19,17
42,Soria,152,Recuerda,63,39,24
42,Soria,153,Rello,20,12,8
42,Soria,154,Renieblas,113,75,38
42,Soria,155,Retortillo de Soria,143,81,62
42,Soria,156,Reznos,25,15,10
42,Soria,157,"Riba de Escalote, La",10,7,3
42,Soria,158,Rioseco de Soria,130,78,52
42,Soria,159,Rollamienta,45,30,15
42,Soria,160,"Royo, El",259,142,117
42,Soria,161,Salduero,140,78,62
42,Soria,162,San Esteban de Gormaz,2950,1564,1386
42,Soria,163,San Felices,60,37,23
42,Soria,164,San Leonardo de Yagüe,1986,1014,972
42,Soria,165,San Pedro Manrique,614,348,266
42,Soria,166,Santa Cruz de Yanguas,57,32,25
42,Soria,167,Santa María de Huerta,246,138,108
42,Soria,168,Santa María de las Hoyas,102,57,45
42,Soria,171,Serón de Nágima,116,64,52
42,Soria,172,Soliedra,32,18,14
42,Soria,173,Soria,40096,18901,21195
42,Soria,174,Sotillo del Rincón,185,105,80
42,Soria,175,Suellacabras,31,15,16
42,Soria,176,Tajahuerce,23,12,11
42,Soria,177,Tajueco,56,34,22
42,Soria,178,Talveila,102,66,36
42,Soria,181,Tardelcuende,424,226,198
42,Soria,182,Taroda,43,23,20
42,Soria,183,Tejado,96,59,37
42,Soria,184,Torlengua,48,31,17
42,Soria,185,Torreblacos,26,13,13
42,Soria,187,Torrubia de Soria,56,39,17
42,Soria,188,Trévago,53,26,27
42,Soria,189,Ucero,85,48,37
42,Soria,190,Vadillo,82,44,38
42,Soria,191,Valdeavellano de Tera,209,114,95
42,Soria,192,Valdegeña,37,27,10
42,Soria,193,Valdelagua del Cerro,13,8,5
42,Soria,194,Valdemaluque,141,69,72
42,Soria,195,Valdenebro,92,52,40
42,Soria,196,Valdeprado,8,3,5
42,Soria,197,Valderrodilla,63,35,28
42,Soria,198,Valtajeros,19,13,6
42,Soria,200,Velamazán,67,47,20
42,Soria,201,Velilla de la Sierra,28,18,10
42,Soria,202,Velilla de los Ajos,16,10,6
42,Soria,204,Viana de Duero,50,36,14
42,Soria,205,Villaciervos,77,47,30
42,Soria,206,Villanueva de Gormaz,8,5,3
42,Soria,207,Villar del Ala,52,26,26
42,Soria,208,Villar del Campo,24,14,10
42,Soria,209,Villar del Río,161,97,64
42,Soria,211,"Villares de Soria, Los",82,47,35
42,Soria,212,Villasayas,65,44,21
42,Soria,213,Villaseca de Arciel,23,15,8
42,Soria,215,Vinuesa,853,443,410
42,Soria,216,Vizmanos,31,20,11
42,Soria,217,Vozmediano,36,24,12
42,Soria,218,Yanguas,113,72,41
42,Soria,219,Yelo,40,24,16
43,Tarragona,1,Aiguamúrcia,974,506,468
43,Tarragona,2,Albinyana,2666,1362,1304
43,Tarragona,3,"Albiol, L'",535,288,247
43,Tarragona,4,Alcanar,9827,4965,4862
43,Tarragona,5,Alcover,5278,2614,2664
43,Tarragona,904,"Aldea, L'",4445,2402,2043
43,Tarragona,6,Aldover,867,444,423
43,Tarragona,7,"Aleixar, L'",940,486,454
43,Tarragona,8,Alfara de Carles,361,191,170
43,Tarragona,9,Alforja,1965,992,973
43,Tarragona,10,Alió,508,250,258
43,Tarragona,11,Almoster,1310,658,652
43,Tarragona,12,Altafulla,5693,2753,2940
43,Tarragona,13,"Ametlla de Mar, L'",7325,3714,3611
43,Tarragona,906,"Ampolla, L'",3603,1829,1774
43,Tarragona,14,Amposta,22270,11294,10976
43,Tarragona,16,"Arboç, L'",5713,2902,2811
43,Tarragona,15,Arbolí,129,79,50
43,Tarragona,17,"Argentera, L'",133,75,58
43,Tarragona,18,Arnes,455,218,237
43,Tarragona,19,Ascó,1638,850,788
43,Tarragona,20,Banyeres del Penedès,3356,1690,1666
43,Tarragona,21,Barberà de la Conca,486,265,221
43,Tarragona,22,Batea,1869,929,940
43,Tarragona,23,Bellmunt del Priorat,284,147,137
43,Tarragona,24,Bellvei,2368,1223,1145
43,Tarragona,25,Benifallet,733,357,376
43,Tarragona,26,Benissanet,1159,631,528
43,Tarragona,27,"Bisbal de Falset, La",207,118,89
43,Tarragona,28,"Bisbal del Penedès, La",4148,2168,1980
43,Tarragona,29,Blancafort,393,202,191
43,Tarragona,30,Bonastre,745,403,342
43,Tarragona,31,"Borges del Camp, Les",2194,1127,1067
43,Tarragona,32,Bot,559,284,275
43,Tarragona,33,Botarell,1156,588,568
43,Tarragona,34,Bràfim,693,348,345
43,Tarragona,35,Cabacés,304,168,136
43,Tarragona,36,Cabra del Camp,1282,669,613
43,Tarragona,37,Calafell,30631,15345,15286
43,Tarragona,903,Camarles,3332,1709,1623
43,Tarragona,38,Cambrils,36496,17829,18667
43,Tarragona,907,"Canonja, La",5922,2890,3032
43,Tarragona,39,Capafonts,110,63,47
43,Tarragona,40,Capçanes,424,213,211
43,Tarragona,41,Caseres,241,119,122
43,Tarragona,42,Castellvell del Camp,3018,1518,1500
43,Tarragona,43,"Catllar, El",5115,2671,2444
43,Tarragona,45,Colldejou,161,93,68
43,Tarragona,46,Conesa,120,60,60
43,Tarragona,47,Constantí,6788,3490,3298
43,Tarragona,48,Corbera d'Ebre,1011,536,475
43,Tarragona,49,Cornudella de Montsant,993,529,464
43,Tarragona,50,Creixell,4084,2054,2030
43,Tarragona,51,Cunit,15278,7525,7753
43,Tarragona,901,Deltebre,11818,5945,5873
43,Tarragona,53,Duesaigües,225,122,103
43,Tarragona,54,"Espluga de Francolí, L'",3733,1841,1892
43,Tarragona,55,Falset,2809,1429,1380
43,Tarragona,56,"Fatarella, La",874,434,440
43,Tarragona,57,"Febró, La",38,23,15
43,Tarragona,58,"Figuera, La",119,68,51
43,Tarragona,59,Figuerola del Camp,337,166,171
43,Tarragona,60,Flix,3343,1684,1659
43,Tarragona,61,Forès,47,29,18
43,Tarragona,62,Freginals,411,222,189
43,Tarragona,63,"Galera, La",715,369,346
43,Tarragona,64,Gandesa,3140,1592,1548
43,Tarragona,65,Garcia,547,277,270
43,Tarragona,66,"Garidells, Els",198,98,100
43,Tarragona,67,Ginestar,794,420,374
43,Tarragona,68,Godall,614,306,308
43,Tarragona,69,Gratallops,237,134,103
43,Tarragona,70,"Guiamets, Els",267,136,131
43,Tarragona,71,Horta de Sant Joan,1169,595,574
43,Tarragona,72,"Lloar, El",105,56,49
43,Tarragona,73,Llorac,97,51,46
43,Tarragona,74,Llorenç del Penedès,2391,1171,1220
43,Tarragona,76,Marçà,589,318,271
43,Tarragona,75,Margalef,106,67,39
43,Tarragona,77,Mas de Barberans,544,274,270
43,Tarragona,78,Masdenverge,1137,591,546
43,Tarragona,79,Masllorenç,576,319,257
43,Tarragona,80,"Masó, La",296,155,141
43,Tarragona,81,Maspujols,856,443,413
43,Tarragona,82,"Masroig, El",466,252,214
43,Tarragona,83,"Milà, El",181,87,94
43,Tarragona,84,Miravet,690,365,325
43,Tarragona,85,"Molar, El",314,156,158
43,Tarragona,86,Montblanc,7456,3797,3659
43,Tarragona,88,Montbrió del Camp,3086,1594,1492
43,Tarragona,89,Montferri,435,235,200
43,Tarragona,90,"Montmell, El",1887,1008,879
43,Tarragona,91,Mont-ral,183,102,81
43,Tarragona,92,Mont-roig del Camp,13592,6962,6630
43,Tarragona,93,Móra d'Ebre,5649,2852,2797
43,Tarragona,94,Móra la Nova,3244,1626,1618
43,Tarragona,95,"Morell, El",3893,2012,1881
43,Tarragona,96,"Morera de Montsant, La",153,87,66
43,Tarragona,97,"Nou de Gaià, La",635,313,322
43,Tarragona,98,Nulles,544,286,258
43,Tarragona,100,"Pallaresos, Els",4963,2492,2471
43,Tarragona,99,"Palma d'Ebre, La",341,165,176
43,Tarragona,101,Passanant i Belltall,180,106,74
43,Tarragona,102,Paüls,555,282,273
43,Tarragona,103,Perafort,1292,667,625
43,Tarragona,104,"Perelló, El",2915,1505,1410
43,Tarragona,105,"Piles, Les",229,128,101
43,Tarragona,106,"Pinell de Brai, El",1006,508,498
43,Tarragona,107,Pira,509,266,243
43,Tarragona,108,"Pla de Santa Maria, El",2395,1227,1168
43,Tarragona,109,"Pobla de Mafumet, La",4076,2052,2024
43,Tarragona,110,"Pobla de Massaluca, La",341,192,149
43,Tarragona,111,"Pobla de Montornès, La",3221,1659,1562
43,Tarragona,112,Poboleda,330,166,164
43,Tarragona,113,"Pont d'Armentera, El",490,243,247
43,Tarragona,141,Pontils,128,72,56
43,Tarragona,114,Porrera,435,223,212
43,Tarragona,115,Pradell de la Teixeta,171,87,84
43,Tarragona,116,Prades,656,350,306
43,Tarragona,117,Prat de Comte,188,99,89
43,Tarragona,118,Pratdip,723,372,351
43,Tarragona,119,Puigpelat,1215,631,584
43,Tarragona,120,Querol,584,326,258
43,Tarragona,136,"Ràpita, La",15046,7330,7716
43,Tarragona,121,Rasquera,804,396,408
43,Tarragona,122,Renau,158,83,75
43,Tarragona,123,Reus,108479,52592,55887
43,Tarragona,124,"Riba, La",572,318,254
43,Tarragona,125,Riba-roja d'Ebre,1150,617,533
43,Tarragona,126,"Riera de Gaià, La",1778,891,887
43,Tarragona,127,Riudecanyes,1349,704,645
43,Tarragona,128,Riudecols,1211,619,592
43,Tarragona,129,Riudoms,6810,3457,3353
43,Tarragona,130,Rocafort de Queralt,243,133,110
43,Tarragona,131,Roda de Berà,7829,3962,3867
43,Tarragona,132,Rodonyà,526,284,242
43,Tarragona,133,Roquetes,8302,4276,4026
43,Tarragona,134,"Rourell, El",385,196,189
43,Tarragona,135,Salomó,542,283,259
43,Tarragona,905,Salou,30224,15390,14834
43,Tarragona,137,Sant Jaume dels Domenys,2785,1422,1363
43,Tarragona,902,Sant Jaume d'Enveja,3661,1844,1817
43,Tarragona,138,Santa Bàrbara,3758,1915,1843
43,Tarragona,139,Santa Coloma de Queralt,2805,1415,1390
43,Tarragona,140,Santa Oliva,3657,1865,1792
43,Tarragona,142,Sarral,1606,808,798
43,Tarragona,143,Savallà del Comtat,53,28,25
43,Tarragona,144,"Secuita, La",1800,904,896
43,Tarragona,145,"Selva del Camp, La",5736,2847,2889
43,Tarragona,146,Senan,44,28,16
43,Tarragona,44,"Sénia, La",5623,2816,2807
43,Tarragona,147,Solivella,629,338,291
43,Tarragona,148,Tarragona,138262,67247,71015
43,Tarragona,149,Tivenys,915,468,447
43,Tarragona,150,Tivissa,1635,831,804
43,Tarragona,151,"Torre de Fontaubella, La",120,65,55
43,Tarragona,152,"Torre de l'Espanyol, La",619,319,300
43,Tarragona,153,Torredembarra,17670,8629,9041
43,Tarragona,154,Torroja del Priorat,139,76,63
43,Tarragona,155,Tortosa,34639,17329,17310
43,Tarragona,156,Ulldecona,6417,3381,3036
43,Tarragona,157,Ulldemolins,418,230,188
43,Tarragona,158,Vallclara,95,59,36
43,Tarragona,159,Vallfogona de Riucorb,93,54,39
43,Tarragona,160,Vallmoll,1942,979,963
43,Tarragona,161,Valls,25014,12646,12368
43,Tarragona,162,Vandellòs i l'Hospitalet de l'Infant,6984,3458,3526
43,Tarragona,163,"Vendrell, El",39601,19586,20015
43,Tarragona,164,Vespella de Gaià,494,262,232
43,Tarragona,165,Vilabella,723,369,354
43,Tarragona,175,Vilalba dels Arcs,619,311,308
43,Tarragona,166,Vilallonga del Camp,2423,1222,1201
43,Tarragona,168,Vilanova de Prades,113,60,53
43,Tarragona,167,Vilanova d'Escornalbou,594,306,288
43,Tarragona,169,Vilaplana,552,294,258
43,Tarragona,170,Vila-rodona,1362,720,642
43,Tarragona,171,Vila-seca,23176,11642,11534
43,Tarragona,172,Vilaverd,477,253,224
43,Tarragona,173,"Vilella Alta, La",128,71,57
43,Tarragona,174,"Vilella Baixa, La",197,108,89
43,Tarragona,176,Vimbodí i Poblet,900,480,420
43,Tarragona,177,Vinebre,415,219,196
43,Tarragona,178,Vinyols i els Arcs,2323,1206,1117
43,Tarragona,52,Xerta,1164,574,590
44,Teruel,1,Ababuj,70,43,27
44,Teruel,2,Abejuela,55,35,20
44,Teruel,3,Aguatón,15,7,8
44,Teruel,4,Aguaviva,565,269,296
44,Teruel,5,Aguilar del Alfambra,83,43,40
44,Teruel,6,Alacón,212,110,102
44,Teruel,7,Alba,187,110,77
44,Teruel,8,Albalate del Arzobispo,1955,1016,939
44,Teruel,9,Albarracín,1015,515,500
44,Teruel,10,Albentosa,302,160,142
44,Teruel,11,Alcaine,48,31,17
44,Teruel,12,Alcalá de la Selva,382,207,175
44,Teruel,13,Alcañiz,16151,8061,8090
44,Teruel,14,Alcorisa,3243,1654,1589
44,Teruel,16,Alfambra,482,259,223
44,Teruel,17,Aliaga,343,200,143
44,Teruel,21,Allepuz,121,61,60
44,Teruel,22,Alloza,540,275,265
44,Teruel,23,Allueva,27,17,10
44,Teruel,18,Almohaja,17,12,5
44,Teruel,19,Alobras,71,45,26
44,Teruel,20,Alpeñés,25,15,10
44,Teruel,24,Anadón,33,21,12
44,Teruel,25,Andorra,7214,3581,3633
44,Teruel,26,Arcos de las Salinas,116,71,45
44,Teruel,27,Arens de Lledó,205,99,106
44,Teruel,28,Argente,193,98,95
44,Teruel,29,Ariño,649,332,317
44,Teruel,31,Azaila,98,57,41
44,Teruel,32,Bádenas,21,12,9
44,Teruel,33,Báguena,270,151,119
44,Teruel,34,Bañón,151,87,64
44,Teruel,35,Barrachina,120,66,54
44,Teruel,36,Bea,28,18,10
44,Teruel,37,Beceite,569,286,283
44,Teruel,39,Bello,217,109,108
44,Teruel,38,Belmonte de San José,127,63,64
44,Teruel,40,Berge,226,116,110
44,Teruel,41,Bezas,64,39,25
44,Teruel,42,Blancas,135,78,57
44,Teruel,43,Blesa,78,55,23
44,Teruel,44,Bordón,112,64,48
44,Teruel,45,Bronchales,454,255,199
44,Teruel,46,Bueña,54,27,27
44,Teruel,47,Burbáguena,376,208,168
44,Teruel,48,Cabra de Mora,71,42,29
44,Teruel,49,Calaceite,979,485,494
44,Teruel,50,Calamocha,4505,2262,2243
44,Teruel,51,Calanda,3759,1882,1877
44,Teruel,52,Calomarde,73,43,30
44,Teruel,53,Camañas,132,72,60
44,Teruel,54,Camarena de la Sierra,134,74,60
44,Teruel,55,Camarillas,119,64,55
44,Teruel,56,Caminreal,617,331,286
44,Teruel,59,Cantavieja,726,378,348
44,Teruel,60,Cañada de Benatanduz,34,22,12
44,Teruel,61,"Cañada de Verich, La",88,53,35
44,Teruel,62,Cañada Vellida,40,27,13
44,Teruel,63,Cañizar del Olivar,103,58,45
44,Teruel,64,Cascante del Río,70,41,29
44,Teruel,65,Castejón de Tornos,68,38,30
44,Teruel,66,Castel de Cabra,89,49,40
44,Teruel,70,"Castellar, El",55,37,18
44,Teruel,71,Castellote,678,345,333
44,Teruel,67,Castelnou,108,55,53
44,Teruel,68,Castelserás,795,421,374
44,Teruel,74,Cedrillas,653,332,321
44,Teruel,75,Celadas,345,198,147
44,Teruel,76,Cella,2644,1355,1289
44,Teruel,77,"Cerollera, La",75,49,26
44,Teruel,80,"Codoñera, La",320,169,151
44,Teruel,82,Corbalán,113,59,54
44,Teruel,84,Cortes de Aragón,61,28,33
44,Teruel,85,Cosa,61,38,23
44,Teruel,86,Cretas,556,283,273
44,Teruel,87,Crivillén,90,51,39
44,Teruel,88,"Cuba, La",49,25,24
44,Teruel,89,Cubla,71,46,25
44,Teruel,90,Cucalón,78,51,27
44,Teruel,92,"Cuervo, El",98,47,51
44,Teruel,93,Cuevas de Almudén,119,66,53
44,Teruel,94,Cuevas Labradas,135,70,65
44,Teruel,96,Ejulve,176,90,86
44,Teruel,97,Escorihuela,141,71,70
44,Teruel,99,Escucha,766,415,351
44,Teruel,100,Estercuel,196,111,85
44,Teruel,101,Ferreruela de Huerva,71,39,32
44,Teruel,102,Fonfría,32,19,13
44,Teruel,103,Formiche Alto,159,89,70
44,Teruel,105,Fórnoles,84,45,39
44,Teruel,106,Fortanete,222,124,98
44,Teruel,107,Foz-Calanda,279,144,135
44,Teruel,108,"Fresneda, La",463,250,213
44,Teruel,109,Frías de Albarracín,111,69,42
44,Teruel,110,Fuenferrada,37,25,12
44,Teruel,111,Fuentes Calientes,81,47,34
44,Teruel,112,Fuentes Claras,435,233,202
44,Teruel,113,Fuentes de Rubielos,169,94,75
44,Teruel,114,Fuentespalda,288,148,140
44,Teruel,115,Galve,144,74,70
44,Teruel,116,Gargallo,91,48,43
44,Teruel,117,Gea de Albarracín,452,248,204
44,Teruel,118,"Ginebrosa, La",192,109,83
44,Teruel,119,Griegos,140,84,56
44,Teruel,120,Guadalaviar,242,128,114
44,Teruel,121,Gúdar,70,41,29
44,Teruel,122,Híjar,1797,926,871
44,Teruel,123,Hinojosa de Jarque,104,59,45
44,Teruel,124,"Hoz de la Vieja, La",87,44,43
44,Teruel,125,Huesa del Común,64,39,25
44,Teruel,126,"Iglesuela del Cid, La",382,197,185
44,Teruel,127,Jabaloyas,74,44,30
44,Teruel,128,Jarque de la Val,64,31,33
44,Teruel,129,Jatiel,46,27,19
44,Teruel,130,Jorcas,43,22,21
44,Teruel,131,Josa,37,25,12
44,Teruel,132,Lagueruela,72,43,29
44,Teruel,133,Lanzuela,28,19,9
44,Teruel,135,Libros,101,62,39
44,Teruel,136,Lidón,51,29,22
44,Teruel,137,Linares de Mora,232,131,101
44,Teruel,141,Lledó,171,89,82
44,Teruel,138,Loscos,116,73,43
44,Teruel,142,Maicas,32,20,12
44,Teruel,143,Manzanera,540,298,242
44,Teruel,144,Martín del Río,370,175,195
44,Teruel,145,Mas de las Matas,1237,635,602
44,Teruel,146,"Mata de los Olmos, La",281,151,130
44,Teruel,147,Mazaleón,487,258,229
44,Teruel,148,Mezquita de Jarque,82,42,40
44,Teruel,149,Mirambel,105,60,45
44,Teruel,150,Miravete de la Sierra,28,20,8
44,Teruel,151,Molinos,225,119,106
44,Teruel,152,Monforte de Moyuela,83,55,28
44,Teruel,153,Monreal del Campo,2486,1222,1264
44,Teruel,154,Monroyo,315,172,143
44,Teruel,155,Montalbán,1180,596,584
44,Teruel,156,Monteagudo del Castillo,43,25,18
44,Teruel,157,Monterde de Albarracín,56,32,24
44,Teruel,158,Mora de Rubielos,1568,783,785
44,Teruel,159,Moscardón,56,30,26
44,Teruel,160,Mosqueruela,538,294,244
44,Teruel,161,Muniesa,571,304,267
44,Teruel,163,Noguera de Albarracín,131,74,57
44,Teruel,164,Nogueras,32,21,11
44,Teruel,165,Nogueruelas,192,113,79
44,Teruel,167,Obón,35,21,14
44,Teruel,168,Odón,207,102,105
44,Teruel,169,Ojos Negros,330,185,145
44,Teruel,171,Olba,279,145,134
44,Teruel,172,Oliete,349,189,160
44,Teruel,173,"Olmos, Los",119,69,50
44,Teruel,174,Orihuela del Tremedal,453,255,198
44,Teruel,175,Orrios,122,67,55
44,Teruel,176,Palomar de Arroyos,167,98,69
44,Teruel,177,Pancrudo,114,67,47
44,Teruel,178,"Parras de Castellote, Las",61,35,26
44,Teruel,179,Peñarroya de Tastavins,443,234,209
44,Teruel,180,Peracense,75,36,39
44,Teruel,181,Peralejos,86,46,40
44,Teruel,182,Perales del Alfambra,264,132,132
44,Teruel,183,Pitarque,65,32,33
44,Teruel,184,Plou,49,29,20
44,Teruel,185,"Pobo, El",102,65,37
44,Teruel,187,"Portellada, La",242,124,118
44,Teruel,189,Pozondón,54,34,20
44,Teruel,190,Pozuel del Campo,66,36,30
44,Teruel,191,"Puebla de Híjar, La",917,478,439
44,Teruel,192,"Puebla de Valverde, La",470,252,218
44,Teruel,193,Puertomingalvo,137,73,64
44,Teruel,194,Ráfales,150,87,63
44,Teruel,195,Rillo,97,58,39
44,Teruel,196,Riodeva,132,62,70
44,Teruel,197,Ródenas,62,34,28
44,Teruel,198,Royuela,231,119,112
44,Teruel,199,Rubiales,42,22,20
44,Teruel,200,Rubielos de la Cérida,30,18,12
44,Teruel,201,Rubielos de Mora,627,316,311
44,Teruel,203,Salcedillo,10,6,4
44,Teruel,204,Saldón,21,15,6
44,Teruel,205,Samper de Calanda,725,380,345
44,Teruel,206,San Agustín,134,83,51
44,Teruel,207,San Martín del Río,135,69,66
44,Teruel,208,Santa Cruz de Nogueras,23,15,8
44,Teruel,209,Santa Eulalia,1017,520,497
44,Teruel,210,Sarrión,1197,607,590
44,Teruel,211,Segura de los Baños,42,27,15
44,Teruel,212,Seno,41,18,23
44,Teruel,213,Singra,80,47,33
44,Teruel,215,Terriente,206,120,86
44,Teruel,216,Teruel,36267,17214,19053
44,Teruel,217,Toril y Masegoso,33,26,7
44,Teruel,218,Tormón,33,20,13
44,Teruel,219,Tornos,191,102,89
44,Teruel,220,Torralba de los Sisones,148,80,68
44,Teruel,223,Torre de Arcas,82,37,45
44,Teruel,224,Torre de las Arcas,24,13,11
44,Teruel,225,Torre del Compte,118,62,56
44,Teruel,227,Torre los Negros,76,41,35
44,Teruel,221,Torrecilla de Alcañiz,440,233,207
44,Teruel,222,Torrecilla del Rebollar,125,79,46
44,Teruel,226,Torrelacárcel,135,79,56
44,Teruel,228,Torremocha de Jiloca,110,56,54
44,Teruel,229,Torres de Albarracín,191,102,89
44,Teruel,230,Torrevelilla,169,87,82
44,Teruel,231,Torrijas,36,17,19
44,Teruel,232,Torrijo del Campo,502,260,242
44,Teruel,234,Tramacastiel,62,35,27
44,Teruel,235,Tramacastilla,109,52,57
44,Teruel,236,Tronchón,61,33,28
44,Teruel,237,Urrea de Gaén,447,228,219
44,Teruel,238,Utrillas,3088,1579,1509
44,Teruel,239,Valacloche,26,14,12
44,Teruel,240,Valbona,192,110,82
44,Teruel,241,Valdealgorfa,589,287,302
44,Teruel,243,Valdecuenca,31,17,14
44,Teruel,244,Valdelinares,80,49,31
44,Teruel,245,Valdeltormo,313,151,162
44,Teruel,246,Valderrobres,2517,1276,1241
44,Teruel,247,Valjunquera,331,168,163
44,Teruel,249,"Vallecillo, El",37,22,15
44,Teruel,250,Veguillas de la Sierra,20,12,8
44,Teruel,251,Villafranca del Campo,302,162,140
44,Teruel,252,Villahermosa del Campo,93,58,35
44,Teruel,256,Villanueva del Rebollar de la Sierra,44,25,19
44,Teruel,257,Villar del Cobo,163,99,64
44,Teruel,258,Villar del Salz,59,35,24
44,Teruel,260,Villarluengo,181,102,79
44,Teruel,261,Villarquemado,865,455,410
44,Teruel,262,Villarroya de los Pinares,168,88,80
44,Teruel,263,Villastar,543,278,265
44,Teruel,264,Villel,326,183,143
44,Teruel,265,Vinaceite,200,108,92
44,Teruel,266,Visiedo,130,62,68
44,Teruel,267,Vivel del Río Martín,67,35,32
44,Teruel,268,"Zoma, La",27,14,13
45,Toledo,1,Ajofrín,2340,1180,1160
45,Toledo,2,Alameda de la Sagra,4149,2181,1968
45,Toledo,3,Albarreal de Tajo,735,375,360
45,Toledo,4,Alcabón,762,384,378
45,Toledo,5,Alcañizo,283,133,150
45,Toledo,6,Alcaudete de la Jara,1640,824,816
45,Toledo,7,Alcolea de Tajo,839,424,415
45,Toledo,8,Aldea en Cabo,204,106,98
45,Toledo,9,Aldeanueva de Barbarroya,452,233,219
45,Toledo,10,Aldeanueva de San Bartolomé,414,211,203
45,Toledo,11,Almendral de la Cañada,333,174,159
45,Toledo,12,Almonacid de Toledo,926,467,459
45,Toledo,13,Almorox,2396,1261,1135
45,Toledo,14,Añover de Tajo,5215,2628,2587
45,Toledo,15,Arcicóllar,1075,538,537
45,Toledo,16,Argés,6961,3477,3484
45,Toledo,17,Azután,292,142,150
45,Toledo,18,Barcience,1039,554,485
45,Toledo,19,Bargas,10978,5489,5489
45,Toledo,20,Belvís de la Jara,1492,772,720
45,Toledo,21,Borox,4114,2188,1926
45,Toledo,22,Buenaventura,377,187,190
45,Toledo,23,Burguillos de Toledo,3647,1903,1744
45,Toledo,24,Burujón,1300,662,638
45,Toledo,25,Cabañas de la Sagra,2107,1091,1016
45,Toledo,26,Cabañas de Yepes,295,155,140
45,Toledo,27,Cabezamesada,356,196,160
45,Toledo,28,Calera y Chozas,4754,2399,2355
45,Toledo,29,Caleruela,202,102,100
45,Toledo,30,Calzada de Oropesa,498,274,224
45,Toledo,31,Camarena,4439,2305,2134
45,Toledo,32,Camarenilla,629,318,311
45,Toledo,33,"Campillo de la Jara, El",330,176,154
45,Toledo,34,Camuñas,1765,923,842
45,Toledo,35,Cardiel de los Montes,398,209,189
45,Toledo,36,Carmena,848,434,414
45,Toledo,37,"Carpio de Tajo, El",1862,932,930
45,Toledo,38,Carranque,5274,2736,2538
45,Toledo,39,Carriches,270,133,137
45,Toledo,40,"Casar de Escalona, El",2011,1067,944
45,Toledo,41,Casarrubios del Monte,6671,3470,3201
45,Toledo,42,Casasbuenas,178,95,83
45,Toledo,43,Castillo de Bayuela,905,456,449
45,Toledo,45,Cazalegas,1973,1029,944
45,Toledo,46,Cebolla,3191,1588,1603
45,Toledo,47,Cedillo del Condado,4204,2179,2025
45,Toledo,48,"Cerralbos, Los",421,227,194
45,Toledo,49,Cervera de los Montes,500,258,242
45,Toledo,56,Chozas de Canales,4751,2462,2289
45,Toledo,57,Chueca,254,126,128
45,Toledo,50,Ciruelos,642,342,300
45,Toledo,51,Cobeja,2556,1344,1212
45,Toledo,52,Cobisa,4452,2238,2214
45,Toledo,53,Consuegra,9805,4958,4847
45,Toledo,54,Corral de Almaguer,5219,2739,2480
45,Toledo,55,Cuerva,1264,657,607
45,Toledo,58,Domingo Pérez,387,190,197
45,Toledo,59,Dosbarrios,2223,1147,1076
45,Toledo,60,Erustes,225,120,105
45,Toledo,61,Escalona,3669,1882,1787
45,Toledo,62,Escalonilla,1469,717,752
45,Toledo,63,Espinoso del Rey,422,248,174
45,Toledo,64,Esquivias,5778,2947,2831
45,Toledo,65,"Estrella, La",298,161,137
45,Toledo,66,Fuensalida,12329,6241,6088
45,Toledo,67,Gálvez,3002,1517,1485
45,Toledo,68,Garciotum,215,107,108
45,Toledo,69,Gerindote,2617,1321,1296
45,Toledo,70,Guadamur,1802,908,894
45,Toledo,71,"Guardia, La",2136,1082,1054
45,Toledo,72,"Herencias, Las",794,419,375
45,Toledo,73,Herreruela de Oropesa,317,172,145
45,Toledo,74,Hinojosa de San Vicente,381,209,172
45,Toledo,75,Hontanar,145,88,57
45,Toledo,76,Hormigos,949,522,427
45,Toledo,77,Huecas,849,436,413
45,Toledo,78,Huerta de Valdecarábanos,1760,892,868
45,Toledo,79,"Iglesuela del Tiétar, La",444,236,208
45,Toledo,80,Illán de Vacas,3,3,0
45,Toledo,81,Illescas,31327,15749,15578
45,Toledo,82,Lagartera,1306,644,662
45,Toledo,83,Layos,873,441,432
45,Toledo,84,Lillo,2518,1311,1207
45,Toledo,85,Lominchar,2639,1400,1239
45,Toledo,86,Lucillos,597,313,284
45,Toledo,87,Madridejos,10169,5089,5080
45,Toledo,88,Magán,4038,2048,1990
45,Toledo,89,Malpica de Tajo,1649,847,802
45,Toledo,90,Manzaneque,394,200,194
45,Toledo,91,Maqueda,496,246,250
45,Toledo,92,Marjaliza,256,131,125
45,Toledo,93,Marrupe,157,78,79
45,Toledo,94,Mascaraque,430,215,215
45,Toledo,95,"Mata, La",881,432,449
45,Toledo,96,Mazarambroz,1259,657,602
45,Toledo,97,Mejorada,1374,701,673
45,Toledo,98,Menasalbas,2482,1289,1193
45,Toledo,99,Méntrida,6019,3057,2962
45,Toledo,100,Mesegar de Tajo,205,111,94
45,Toledo,101,Miguel Esteban,4779,2404,2375
45,Toledo,102,Mocejón,5069,2539,2530
45,Toledo,103,Mohedas de la Jara,394,210,184
45,Toledo,104,Montearagón,573,307,266
45,Toledo,105,Montesclaros,381,201,180
45,Toledo,106,Mora,9782,4914,4868
45,Toledo,107,Nambroca,5151,2616,2535
45,Toledo,108,"Nava de Ricomalillo, La",496,261,235
45,Toledo,109,Navahermosa,3618,1894,1724
45,Toledo,110,Navalcán,1861,961,900
45,Toledo,111,Navalmoralejo,50,26,24
45,Toledo,112,"Navalmorales, Los",2134,1098,1036
45,Toledo,113,"Navalucillos, Los",1956,994,962
45,Toledo,114,Navamorcuende,608,299,309
45,Toledo,115,Noblejas,3911,1964,1947
45,Toledo,116,Noez,942,486,456
45,Toledo,117,Nombela,907,491,416
45,Toledo,118,Novés,3388,1728,1660
45,Toledo,119,Numancia de la Sagra,5455,2838,2617
45,Toledo,120,Nuño Gómez,159,89,70
45,Toledo,121,Ocaña,13868,6935,6933
45,Toledo,122,Olías del Rey,8705,4401,4304
45,Toledo,123,Ontígola,4916,2582,2334
45,Toledo,124,Orgaz,2600,1310,1290
45,Toledo,125,Oropesa,2600,1245,1355
45,Toledo,126,Otero,419,224,195
45,Toledo,127,Palomeque,1143,624,519
45,Toledo,128,Pantoja,3551,1785,1766
45,Toledo,129,Paredes de Escalona,126,70,56
45,Toledo,130,Parrillas,352,185,167
45,Toledo,131,Pelahustán,337,195,142
45,Toledo,132,Pepino,3163,1622,1541
45,Toledo,133,Polán,3884,1949,1935
45,Toledo,134,Portillo de Toledo,2308,1168,1140
45,Toledo,135,"Puebla de Almoradiel, La",4952,2525,2427
45,Toledo,136,"Puebla de Montalbán, La",7885,3985,3900
45,Toledo,137,"Pueblanueva, La",2158,1114,1044
45,Toledo,138,"Puente del Arzobispo, El",1171,589,582
45,Toledo,139,Puerto de San Vicente,162,89,73
45,Toledo,140,Pulgar,1528,788,740
45,Toledo,141,Quero,1012,517,495
45,Toledo,142,Quintanar de la Orden,11119,5507,5612
45,Toledo,143,Quismondo,1721,849,872
45,Toledo,144,"Real de San Vicente, El",975,519,456
45,Toledo,145,Recas,4876,2700,2176
45,Toledo,146,Retamoso de la Jara,109,56,53
45,Toledo,147,Rielves,806,404,402
45,Toledo,148,Robledo del Mazo,247,136,111
45,Toledo,149,"Romeral, El",568,279,289
45,Toledo,150,San Bartolomé de las Abiertas,619,333,286
45,Toledo,151,San Martín de Montalbán,724,375,349
45,Toledo,152,San Martín de Pusa,590,318,272
45,Toledo,153,San Pablo de los Montes,1679,844,835
45,Toledo,154,San Román de los Montes,2071,1060,1011
45,Toledo,155,Santa Ana de Pusa,346,205,141
45,Toledo,156,Santa Cruz de la Zarza,4098,2086,2012
45,Toledo,157,Santa Cruz del Retamar,3901,2016,1885
45,Toledo,158,Santa Olalla,3436,1732,1704
45,Toledo,901,Santo Domingo-Caudilla,1165,608,557
45,Toledo,159,Sartajada,109,66,43
45,Toledo,160,Segurilla,1384,704,680
45,Toledo,161,Seseña,29271,15046,14225
45,Toledo,162,Sevilleja de la Jara,643,355,288
45,Toledo,163,Sonseca,11205,5704,5501
45,Toledo,164,Sotillo de las Palomas,173,88,85
45,Toledo,165,Talavera de la Reina,84137,40349,43788
45,Toledo,166,Tembleque,1955,989,966
45,Toledo,167,"Toboso, El",1667,833,834
45,Toledo,168,Toledo,86070,40930,45140
45,Toledo,169,Torralba de Oropesa,192,105,87
45,Toledo,171,"Torre de Esteban Hambrán, La",1846,929,917
45,Toledo,170,Torrecilla de la Jara,211,117,94
45,Toledo,172,Torrico,701,356,345
45,Toledo,173,Torrijos,13885,6817,7068
45,Toledo,174,Totanés,350,178,172
45,Toledo,175,Turleque,702,352,350
45,Toledo,176,Ugena,5723,2951,2772
45,Toledo,177,Urda,2491,1255,1236
45,Toledo,179,Valdeverdeja,559,283,276
45,Toledo,180,Valmojado,4672,2346,2326
45,Toledo,181,Velada,2889,1482,1407
45,Toledo,182,"Ventas con Peña Aguilera, Las",1139,574,565
45,Toledo,183,"Ventas de Retamosa, Las",4088,2148,1940
45,Toledo,184,"Ventas de San Julián, Las",229,107,122
45,Toledo,186,"Villa de Don Fadrique, La",3569,1774,1795
45,Toledo,185,Villacañas,9511,4742,4769
45,Toledo,187,Villafranca de los Caballeros,4846,2449,2397
45,Toledo,188,Villaluenga de la Sagra,4162,2105,2057
45,Toledo,189,Villamiel de Toledo,1056,537,519
45,Toledo,190,Villaminaya,498,255,243
45,Toledo,191,Villamuelas,613,320,293
45,Toledo,192,Villanueva de Alcardete,2985,1534,1451
45,Toledo,193,Villanueva de Bogas,695,356,339
45,Toledo,194,Villarejo de Montalbán,69,35,34
45,Toledo,195,Villarrubia de Santiago,2535,1288,1247
45,Toledo,196,Villaseca de la Sagra,1851,923,928
45,Toledo,197,Villasequilla,2604,1334,1270
45,Toledo,198,Villatobas,2753,1410,1343
45,Toledo,199,"Viso de San Juan, El",5970,3185,2785
45,Toledo,200,"Yébenes, Los",5717,2908,2809
45,Toledo,201,Yeles,6176,3269,2907
45,Toledo,202,Yepes,5397,2738,2659
45,Toledo,203,Yuncler,4842,2486,2356
45,Toledo,204,Yunclillos,820,430,390
45,Toledo,205,Yuncos,11762,5986,5776
46,Valencia/València,1,Ademuz,1004,538,466
46,Valencia/València,2,Ador,1699,890,809
46,Valencia/València,4,Agullent,2400,1193,1207
46,Valencia/València,42,Aielo de Malferit,4601,2323,2278
46,Valencia/València,43,Aielo de Rugat,163,88,75
46,Valencia/València,5,Alaquàs,29825,14492,15333
46,Valencia/València,6,Albaida,6102,3013,3089
46,Valencia/València,7,Albal,17024,8501,8523
46,Valencia/València,8,Albalat de la Ribera,3411,1719,1692
46,Valencia/València,9,Albalat dels Sorells,4158,2042,2116
46,Valencia/València,10,Albalat dels Tarongers,1428,749,679
46,Valencia/València,11,Alberic,10815,5387,5428
46,Valencia/València,12,Alborache,1389,727,662
46,Valencia/València,13,Alboraia/Alboraya,25792,12547,13245
46,Valencia/València,14,Albuixech,4343,2102,2241
46,Valencia/València,16,Alcàntera de Xúquer,1414,708,706
46,Valencia/València,15,Alcàsser,10575,5277,5298
46,Valencia/València,18,Alcublas,635,334,301
46,Valencia/València,20,"Alcúdia de Crespins, l'",5361,2631,2730
46,Valencia/València,19,"Alcúdia, l'",12197,5999,6198
46,Valencia/València,21,Aldaia,33376,16712,16664
46,Valencia/València,22,Alfafar,21879,10679,11200
46,Valencia/València,24,Alfara de la Baronia,611,304,307
46,Valencia/València,25,Alfara del Patriarca,3455,1602,1853
46,Valencia/València,26,Alfarp,1618,828,790
46,Valencia/València,27,Alfarrasí,1183,581,602
46,Valencia/València,23,Alfauir,477,245,232
46,Valencia/València,28,Algar de Palancia,527,281,246
46,Valencia/València,29,Algemesí,27438,13614,13824
46,Valencia/València,30,Algímia d'Alfara,1109,547,562
46,Valencia/València,31,Alginet,14442,7294,7148
46,Valencia/València,32,Almàssera,7504,3668,3836
46,Valencia/València,33,Almiserà,279,137,142
46,Valencia/València,34,Almoines,2519,1266,1253
46,Valencia/València,35,Almussafes,8996,4476,4520
46,Valencia/València,36,Alpuente,667,366,301
46,Valencia/València,37,"Alqueria de la Comtessa, l'",1523,742,781
46,Valencia/València,17,Alzira,46421,22657,23764
46,Valencia/València,38,Andilla,311,208,103
46,Valencia/València,39,Anna,2593,1298,1295
46,Valencia/València,40,Antella,1114,542,572
46,Valencia/València,41,Aras de los Olmos,381,213,168
46,Valencia/València,3,Atzeneta d'Albaida,1161,583,578
46,Valencia/València,44,Ayora,5223,2573,2650
46,Valencia/València,46,Barx,1476,767,709
46,Valencia/València,45,Barxeta,1595,818,777
46,Valencia/València,47,Bèlgida,632,315,317
46,Valencia/València,48,Bellreguard,4811,2402,2409
46,Valencia/València,49,Bellús,306,156,150
46,Valencia/València,50,Benagéber,168,100,68
46,Valencia/València,51,Benaguasil,11877,6043,5834
46,Valencia/València,52,Benavites,674,327,347
46,Valencia/València,53,Beneixida,655,313,342
46,Valencia/València,54,Benetússer,15879,7742,8137
46,Valencia/València,55,Beniarjó,1872,942,930
46,Valencia/València,56,Beniatjar,217,118,99
46,Valencia/València,57,Benicolet,599,291,308
46,Valencia/València,904,Benicull de Xúquer,1134,573,561
46,Valencia/València,60,Benifaió,11984,5895,6089
46,Valencia/València,59,Benifairó de la Valldigna,1554,767,787
46,Valencia/València,58,Benifairó de les Valls,2320,1127,1193
46,Valencia/València,61,Beniflá,484,236,248
46,Valencia/València,62,Benigànim,5716,2907,2809
46,Valencia/València,63,Benimodo,2279,1154,1125
46,Valencia/València,64,Benimuslem,665,358,307
46,Valencia/València,65,Beniparrell,2074,1050,1024
46,Valencia/València,66,Benirredrà,1571,742,829
46,Valencia/València,67,Benissanó,2385,1176,1209
46,Valencia/València,68,Benissoda,460,248,212
46,Valencia/València,69,Benissuera,185,93,92
46,Valencia/València,70,Bétera,26759,13321,13438
46,Valencia/València,71,Bicorp,549,266,283
46,Valencia/València,72,Bocairent,4115,2070,2045
46,Valencia/València,73,Bolbaite,1334,657,677
46,Valencia/València,74,Bonrepòs i Mirambell,3907,1912,1995
46,Valencia/València,75,Bufali,156,82,74
46,Valencia/València,76,Bugarra,783,398,385
46,Valencia/València,77,Buñol,9579,4765,4814
46,Valencia/València,78,Burjassot,39702,19055,20647
46,Valencia/València,79,Calles,431,249,182
46,Valencia/València,80,Camporrobles,1189,611,578
46,Valencia/València,81,Canals,13162,6548,6614
46,Valencia/València,82,Canet d'En Berenguer,7265,3653,3612
46,Valencia/València,83,Carcaixent,20777,10335,10442
46,Valencia/València,84,Càrcer,1826,879,947
46,Valencia/València,85,Carlet,16141,8089,8052
46,Valencia/València,86,Carrícola,102,51,51
46,Valencia/València,87,Casas Altas,146,72,74
46,Valencia/València,88,Casas Bajas,173,88,85
46,Valencia/València,89,Casinos,3091,1556,1535
46,Valencia/València,257,Castelló,6891,3387,3504
46,Valencia/València,90,Castelló de Rugat,2322,1181,1141
46,Valencia/València,91,Castellonet de la Conquesta,149,80,69
46,Valencia/València,92,Castielfabib,297,159,138
46,Valencia/València,93,Catadau,2939,1478,1461
46,Valencia/València,94,Catarroja,29316,14487,14829
46,Valencia/València,95,Caudete de las Fuentes,693,362,331
46,Valencia/València,96,Cerdà,360,186,174
46,Valencia/València,107,Chella,2445,1221,1224
46,Valencia/València,106,Chelva,1645,850,795
46,Valencia/València,108,Chera,483,255,228
46,Valencia/València,109,Cheste,8962,4622,4340
46,Valencia/València,111,Chiva,16750,8570,8180
46,Valencia/València,112,Chulilla,687,368,319
46,Valencia/València,97,Cofrentes,1130,566,564
46,Valencia/València,98,Corbera,3118,1537,1581
46,Valencia/València,99,Cortes de Pallás,753,409,344
46,Valencia/València,100,Cotes,314,161,153
46,Valencia/València,105,Cullera,23753,11958,11795
46,Valencia/València,113,Daimús,3348,1681,1667
46,Valencia/València,114,Domeño,684,337,347
46,Valencia/València,115,Dos Aguas,340,195,145
46,Valencia/València,116,"Eliana, l'",19054,9344,9710
46,Valencia/València,117,Emperador,717,371,346
46,Valencia/València,118,Enguera,4781,2392,2389
46,Valencia/València,119,"Énova, l'",914,471,443
46,Valencia/València,120,Estivella,1598,774,824
46,Valencia/València,121,Estubeny,114,56,58
46,Valencia/València,122,Faura,3619,1809,1810
46,Valencia/València,123,Favara,2664,1365,1299
46,Valencia/València,126,Foios,7641,3733,3908
46,Valencia/València,128,"Font de la Figuera, la",2031,1034,997
46,Valencia/València,127,"Font d'en Carròs, la",3858,1934,1924
46,Valencia/València,124,Fontanars dels Alforins,951,492,459
46,Valencia/València,125,Fortaleny,1004,496,508
46,Valencia/València,129,Fuenterrobles,688,373,315
46,Valencia/València,131,Gandia,78108,38281,39827
46,Valencia/València,902,Gátova,410,208,202
46,Valencia/València,130,Gavarda,1058,504,554
46,Valencia/València,132,"Genovés, el",2778,1413,1365
46,Valencia/València,133,Gestalgar,569,295,274
46,Valencia/València,134,Gilet,3818,1937,1881
46,Valencia/València,135,Godella,13414,6463,6951
46,Valencia/València,136,Godelleta,4148,2137,2011
46,Valencia/València,137,"Granja de la Costera, la",288,145,143
46,Valencia/València,138,Guadasséquies,480,236,244
46,Valencia/València,139,Guadassuar,5961,2885,3076
46,Valencia/València,140,Guardamar de la Safor,605,304,301
46,Valencia/València,141,Higueruelas,522,276,246
46,Valencia/València,142,Jalance,810,420,390
46,Valencia/València,144,Jarafuel,765,403,362
46,Valencia/València,154,Llanera de Ranes,1054,540,514
46,Valencia/València,155,Llaurí,1208,610,598
46,Valencia/València,147,Llíria,24518,12344,12174
46,Valencia/València,152,Llocnou de la Corona,124,59,65
46,Valencia/València,153,Llocnou de Sant Jeroni,567,284,283
46,Valencia/València,151,Llocnou d'En Fenollet,908,466,442
46,Valencia/València,156,Llombai,2687,1332,1355
46,Valencia/València,157,"Llosa de Ranes, la",3681,1872,1809
46,Valencia/València,150,Llutxent,2324,1181,1143
46,Valencia/València,148,Loriguilla,2171,1124,1047
46,Valencia/València,149,Losa del Obispo,520,261,259
46,Valencia/València,158,Macastre,1437,752,685
46,Valencia/València,159,Manises,31573,15630,15943
46,Valencia/València,160,Manuel,2500,1244,1256
46,Valencia/València,161,Marines,1955,1007,948
46,Valencia/València,162,Massalavés,1739,885,854
46,Valencia/València,163,Massalfassar,2609,1300,1309
46,Valencia/València,164,Massamagrell,16766,8264,8502
46,Valencia/València,165,Massanassa,10146,4958,5188
46,Valencia/València,166,Meliana,10918,5354,5564
46,Valencia/València,167,Millares,330,165,165
46,Valencia/València,168,Miramar,2978,1493,1485
46,Valencia/València,169,Mislata,45644,22137,23507
46,Valencia/València,170,Moixent/Mogente,4383,2195,2188
46,Valencia/València,171,Moncada,22067,10710,11357
46,Valencia/València,173,Montaverner,1617,800,817
46,Valencia/València,174,Montesa,1132,575,557
46,Valencia/València,175,Montitxelvo/Montichelvo,558,274,284
46,Valencia/València,176,Montroi/Montroy,3295,1746,1549
46,Valencia/València,172,Montserrat,9312,4815,4497
46,Valencia/València,177,Museros,6741,3432,3309
46,Valencia/València,178,Nàquera/Náquera,8102,4182,3920
46,Valencia/València,179,Navarrés,3061,1529,1532
46,Valencia/València,180,Novetlè/Novelé,856,420,436
46,Valencia/València,181,Oliva,25558,12553,13005
46,Valencia/València,183,"Olleria, l'",8421,4237,4184
46,Valencia/València,182,Olocau,2303,1219,1084
46,Valencia/València,184,Ontinyent,36194,17842,18352
46,Valencia/València,185,Otos,436,221,215
46,Valencia/València,186,Paiporta,27184,13312,13872
46,Valencia/València,187,Palma de Gandía,1735,916,819
46,Valencia/València,188,Palmera,1043,522,521
46,Valencia/València,189,"Palomar, el",574,292,282
46,Valencia/València,190,Paterna,73488,36161,37327
46,Valencia/València,191,Pedralba,3048,1600,1448
46,Valencia/València,192,Petrés,1096,545,551
46,Valencia/València,193,Picanya,11760,5825,5935
46,Valencia/València,194,Picassent,22236,11164,11072
46,Valencia/València,195,Piles,3031,1496,1535
46,Valencia/València,196,Pinet,155,78,77
46,Valencia/València,199,"Pobla de Farnals, la",8699,4371,4328
46,Valencia/València,202,"Pobla de Vallbona, la",26435,13258,13177
46,Valencia/València,200,"Pobla del Duc, la",2438,1174,1264
46,Valencia/València,203,"Pobla Llarga, la",4529,2273,2256
46,Valencia/València,197,Polinyà de Xúquer,2550,1309,1241
46,Valencia/València,198,Potries,1080,555,525
46,Valencia/València,205,Puçol,20731,10212,10519
46,Valencia/València,201,Puebla de San Miguel,53,35,18
46,Valencia/València,204,"Puig de Santa Maria, el",8992,4375,4617
46,Valencia/València,101,Quart de les Valls,1050,499,551
46,Valencia/València,102,Quart de Poblet,25590,12425,13165
46,Valencia/València,103,Quartell,1672,786,886
46,Valencia/València,104,Quatretonda,2190,1096,1094
46,Valencia/València,206,Quesa,661,338,323
46,Valencia/València,207,Rafelbunyol,9467,4617,4850
46,Valencia/València,208,Rafelcofer,1372,670,702
46,Valencia/València,209,Rafelguaraf,2351,1158,1193
46,Valencia/València,210,Ráfol de Salem,467,242,225
46,Valencia/València,212,Real,2410,1248,1162
46,Valencia/València,211,"Real de Gandia, el",2649,1341,1308
46,Valencia/València,213,Requena,20387,10230,10157
46,Valencia/València,214,Riba-roja de Túria,23555,11887,11668
46,Valencia/València,215,Riola,1780,886,894
46,Valencia/València,216,Rocafort,7570,3695,3875
46,Valencia/València,217,Rotglà i Corberà,1165,580,585
46,Valencia/València,218,Ròtova,1292,655,637
46,Valencia/València,219,Rugat,166,91,75
46,Valencia/València,220,Sagunt/Sagunto,70128,34175,35953
46,Valencia/València,221,Salem,401,203,198
46,Valencia/València,903,San Antonio de Benagéber,10200,5042,5158
46,Valencia/València,222,Sant Joanet,544,272,272
46,Valencia/València,223,Sedaví,10637,5225,5412
46,Valencia/València,224,Segart,166,88,78
46,Valencia/València,225,Sellent,381,194,187
46,Valencia/València,226,Sempere,31,16,15
46,Valencia/València,227,Senyera,1122,547,575
46,Valencia/València,228,Serra,3608,1826,1782
46,Valencia/València,229,Siete Aguas,1229,636,593
46,Valencia/València,230,Silla,19683,9747,9936
46,Valencia/València,231,Simat de la Valldigna,3251,1613,1638
46,Valencia/València,232,Sinarcas,1113,586,527
46,Valencia/València,233,Sollana,4959,2431,2528
46,Valencia/València,234,Sot de Chera,423,225,198
46,Valencia/València,235,Sueca,28086,13904,14182
46,Valencia/València,236,Sumacàrcer,1062,515,547
46,Valencia/València,237,Tavernes Blanques,9456,4599,4857
46,Valencia/València,238,Tavernes de la Valldigna,17443,8637,8806
46,Valencia/València,239,Teresa de Cofrentes,611,317,294
46,Valencia/València,240,Terrateig,291,150,141
46,Valencia/València,241,Titaguas,505,260,245
46,Valencia/València,242,Torrebaja,404,219,185
46,Valencia/València,243,Torrella,143,78,65
46,Valencia/València,244,Torrent,87295,42763,44532
46,Valencia/València,245,Torres Torres,745,406,339
46,Valencia/València,246,Tous,1352,675,677
46,Valencia/València,247,Tuéjar,1201,643,558
46,Valencia/València,248,Turís,7259,3785,3474
46,Valencia/València,249,Utiel,11632,5799,5833
46,Valencia/València,250,València,807693,383065,424628
46,Valencia/València,251,Vallada,3063,1555,1508
46,Valencia/València,252,Vallanca,144,75,69
46,Valencia/València,253,Vallés,151,85,66
46,Valencia/València,254,Venta del Moro,1164,626,538
46,Valencia/València,255,Vilallonga/Villalonga,4667,2304,2363
46,Valencia/València,256,Vilamarxant,10772,5562,5210
46,Valencia/València,258,Villar del Arzobispo,3700,1878,1822
46,Valencia/València,259,Villargordo del Cabriel,577,291,286
46,Valencia/València,260,Vinalesa,3495,1690,1805
46,Valencia/València,145,Xàtiva,30072,14717,15355
46,Valencia/València,143,Xeraco,5923,2974,2949
46,Valencia/València,146,Xeresa,2263,1136,1127
46,Valencia/València,110,Xirivella,30749,15155,15594
46,Valencia/València,261,Yátova,2205,1148,1057
46,Valencia/València,262,"Yesa, La",235,127,108
46,Valencia/València,263,Zarra,364,198,166
47,Valladolid,1,Adalia,51,30,21
47,Valladolid,2,Aguasal,19,12,7
47,Valladolid,3,Aguilar de Campos,266,159,107
47,Valladolid,4,Alaejos,1380,731,649
47,Valladolid,5,Alcazarén,645,344,301
47,Valladolid,6,Aldea de San Miguel,215,119,96
47,Valladolid,7,Aldeamayor de San Martín,6035,3107,2928
47,Valladolid,8,Almenara de Adaja,23,13,10
47,Valladolid,9,Amusquillo,103,63,40
47,Valladolid,10,Arroyo de la Encomienda,21946,10972,10974
47,Valladolid,11,Ataquines,554,303,251
47,Valladolid,12,Bahabón,81,38,43
47,Valladolid,13,Barcial de la Loma,99,55,44
47,Valladolid,14,Barruelo del Valle,51,28,23
47,Valladolid,15,Becilla de Valderaduey,211,120,91
47,Valladolid,16,Benafarces,69,38,31
47,Valladolid,17,Bercero,177,100,77
47,Valladolid,18,Berceruelo,37,22,15
47,Valladolid,19,Berrueces,98,55,43
47,Valladolid,20,Bobadilla del Campo,282,160,122
47,Valladolid,21,Bocigas,76,41,35
47,Valladolid,22,Bocos de Duero,80,43,37
47,Valladolid,23,Boecillo,4297,2164,2133
47,Valladolid,24,Bolaños de Campos,245,139,106
47,Valladolid,25,Brahojos de Medina,102,55,47
47,Valladolid,26,Bustillo de Chaves,72,42,30
47,Valladolid,27,Cabezón de Pisuerga,3823,1948,1875
47,Valladolid,28,Cabezón de Valderaduey,36,19,17
47,Valladolid,29,Cabreros del Monte,56,30,26
47,Valladolid,30,Campaspero,1035,579,456
47,Valladolid,31,"Campillo, El",202,117,85
47,Valladolid,32,Camporredondo,153,90,63
47,Valladolid,33,Canalejas de Peñafiel,233,124,109
47,Valladolid,34,Canillas de Esgueva,70,42,28
47,Valladolid,35,Carpio,945,511,434
47,Valladolid,36,Casasola de Arión,221,131,90
47,Valladolid,37,Castrejón de Trabancos,181,93,88
47,Valladolid,38,Castrillo de Duero,130,72,58
47,Valladolid,39,Castrillo-Tejeriego,157,88,69
47,Valladolid,40,Castrobol,52,25,27
47,Valladolid,41,Castrodeza,146,93,53
47,Valladolid,42,Castromembibre,51,35,16
47,Valladolid,43,Castromonte,331,177,154
47,Valladolid,44,Castronuevo de Esgueva,387,212,175
47,Valladolid,45,Castronuño,790,390,400
47,Valladolid,46,Castroponce,133,71,62
47,Valladolid,47,Castroverde de Cerrato,195,124,71
47,Valladolid,48,Ceinos de Campos,183,110,73
47,Valladolid,49,Cervillego de la Cruz,95,55,40
47,Valladolid,50,Cigales,5360,2747,2613
47,Valladolid,51,Ciguñuela,356,188,168
47,Valladolid,52,Cistérniga,9182,4615,4567
47,Valladolid,53,Cogeces de Íscar,143,72,71
47,Valladolid,54,Cogeces del Monte,641,349,292
47,Valladolid,55,Corcos,218,122,96
47,Valladolid,56,Corrales de Duero,103,59,44
47,Valladolid,57,Cubillas de Santa Marta,389,222,167
47,Valladolid,58,Cuenca de Campos,198,103,95
47,Valladolid,59,Curiel de Duero,121,76,45
47,Valladolid,60,Encinas de Esgueva,213,118,95
47,Valladolid,61,Esguevillas de Esgueva,266,148,118
47,Valladolid,62,Fombellida,180,104,76
47,Valladolid,63,Fompedraza,106,58,48
47,Valladolid,64,Fontihoyuelo,36,22,14
47,Valladolid,65,Fresno el Viejo,854,455,399
47,Valladolid,66,Fuensaldaña,2076,1067,1009
47,Valladolid,67,Fuente el Sol,149,79,70
47,Valladolid,68,Fuente-Olmedo,37,17,20
47,Valladolid,69,Gallegos de Hornija,108,54,54
47,Valladolid,70,Gatón de Campos,33,20,13
47,Valladolid,71,Geria,486,234,252
47,Valladolid,73,Herrín de Campos,113,63,50
47,Valladolid,74,Hornillos de Eresma,190,111,79
47,Valladolid,75,Íscar,6326,3192,3134
47,Valladolid,76,Laguna de Duero,22672,11232,11440
47,Valladolid,77,Langayo,253,159,94
47,Valladolid,79,Llano de Olmedo,45,21,24
47,Valladolid,78,Lomoviejo,165,89,76
47,Valladolid,80,Manzanillo,53,29,24
47,Valladolid,81,Marzales,45,21,24
47,Valladolid,82,Matapozuelos,1008,510,498
47,Valladolid,83,Matilla de los Caños,103,56,47
47,Valladolid,84,Mayorga,1418,701,717
47,Valladolid,86,Medina de Rioseco,4483,2202,2281
47,Valladolid,85,Medina del Campo,20090,9817,10273
47,Valladolid,87,Megeces,422,224,198
47,Valladolid,88,Melgar de Abajo,113,59,54
47,Valladolid,89,Melgar de Arriba,168,96,72
47,Valladolid,90,Mojados,3331,1722,1609
47,Valladolid,91,Monasterio de Vega,81,45,36
47,Valladolid,92,Montealegre de Campos,101,61,40
47,Valladolid,93,Montemayor de Pililla,848,454,394
47,Valladolid,94,Moral de la Reina,139,75,64
47,Valladolid,95,Moraleja de las Panaderas,40,23,17
47,Valladolid,96,Morales de Campos,131,74,57
47,Valladolid,97,Mota del Marqués,330,181,149
47,Valladolid,98,Mucientes,667,340,327
47,Valladolid,99,"Mudarra, La",163,85,78
47,Valladolid,100,Muriel,116,59,57
47,Valladolid,101,Nava del Rey,1925,978,947
47,Valladolid,102,Nueva Villa de las Torres,282,162,120
47,Valladolid,103,Olivares de Duero,321,181,140
47,Valladolid,104,Olmedo,3563,1780,1783
47,Valladolid,105,Olmos de Esgueva,193,107,86
47,Valladolid,106,Olmos de Peñafiel,41,23,18
47,Valladolid,109,Palazuelo de Vedija,160,84,76
47,Valladolid,110,"Parrilla, La",490,245,245
47,Valladolid,111,"Pedraja de Portillo, La",1175,603,572
47,Valladolid,112,Pedrajas de San Esteban,3382,1720,1662
47,Valladolid,113,Pedrosa del Rey,150,84,66
47,Valladolid,114,Peñafiel,5172,2638,2534
47,Valladolid,115,Peñaflor de Hornija,337,182,155
47,Valladolid,116,Pesquera de Duero,424,226,198
47,Valladolid,117,Piña de Esgueva,313,163,150
47,Valladolid,118,Piñel de Abajo,157,90,67
47,Valladolid,119,Piñel de Arriba,89,48,41
47,Valladolid,121,Pollos,590,335,255
47,Valladolid,122,Portillo,2371,1218,1153
47,Valladolid,123,Pozal de Gallinas,530,281,249
47,Valladolid,124,Pozaldez,494,266,228
47,Valladolid,125,Pozuelo de la Orden,54,32,22
47,Valladolid,126,Puras,43,23,20
47,Valladolid,127,Quintanilla de Arriba,160,90,70
47,Valladolid,129,Quintanilla de Onésimo,1004,531,473
47,Valladolid,130,Quintanilla de Trigueros,99,51,48
47,Valladolid,128,Quintanilla del Molar,49,24,25
47,Valladolid,131,Rábano,171,87,84
47,Valladolid,132,Ramiro,48,27,21
47,Valladolid,133,Renedo de Esgueva,3936,1993,1943
47,Valladolid,134,Roales de Campos,165,92,73
47,Valladolid,135,Robladillo,90,52,38
47,Valladolid,137,Roturas,26,16,10
47,Valladolid,138,Rubí de Bracamonte,221,126,95
47,Valladolid,139,Rueda,1118,574,544
47,Valladolid,140,Saelices de Mayorga,112,71,41
47,Valladolid,141,Salvador de Zapardiel,106,60,46
47,Valladolid,142,San Cebrián de Mazote,114,66,48
47,Valladolid,143,San Llorente,100,59,41
47,Valladolid,144,San Martín de Valvení,89,46,43
47,Valladolid,145,San Miguel del Arroyo,650,348,302
47,Valladolid,146,San Miguel del Pino,353,181,172
47,Valladolid,147,San Pablo de la Moraleja,108,64,44
47,Valladolid,148,San Pedro de Latarce,437,240,197
47,Valladolid,149,San Pelayo,51,26,25
47,Valladolid,150,San Román de Hornija,289,138,151
47,Valladolid,151,San Salvador,23,14,9
47,Valladolid,156,San Vicente del Palacio,164,87,77
47,Valladolid,152,Santa Eufemia del Arroyo,72,41,31
47,Valladolid,153,Santervás de Campos,111,60,51
47,Valladolid,154,Santibáñez de Valcorba,184,108,76
47,Valladolid,155,Santovenia de Pisuerga,4636,2353,2283
47,Valladolid,157,Sardón de Duero,608,322,286
47,Valladolid,158,"Seca, La",1038,544,494
47,Valladolid,159,Serrada,1128,587,541
47,Valladolid,160,Siete Iglesias de Trabancos,434,227,207
47,Valladolid,161,Simancas,5493,2785,2708
47,Valladolid,162,Tamariz de Campos,86,48,38
47,Valladolid,163,Tiedra,283,144,139
47,Valladolid,164,Tordehumos,388,210,178
47,Valladolid,165,Tordesillas,8681,4362,4319
47,Valladolid,169,Torre de Esgueva,62,33,29
47,Valladolid,170,Torre de Peñafiel,53,32,21
47,Valladolid,166,Torrecilla de la Abadesa,253,118,135
47,Valladolid,167,Torrecilla de la Orden,229,115,114
47,Valladolid,168,Torrecilla de la Torre,24,16,8
47,Valladolid,171,Torrelobatón,386,202,184
47,Valladolid,172,Torrescárcela,164,88,76
47,Valladolid,173,Traspinedo,1242,648,594
47,Valladolid,174,Trigueros del Valle,322,172,150
47,Valladolid,175,Tudela de Duero,8780,4452,4328
47,Valladolid,176,"Unión de Campos, La",207,102,105
47,Valladolid,177,Urones de Castroponce,95,59,36
47,Valladolid,178,Urueña,197,107,90
47,Valladolid,179,Valbuena de Duero,402,229,173
47,Valladolid,180,Valdearcos de la Vega,71,43,28
47,Valladolid,181,Valdenebro de los Valles,191,108,83
47,Valladolid,182,Valdestillas,1583,821,762
47,Valladolid,183,Valdunquillo,126,62,64
47,Valladolid,186,Valladolid,297459,139241,158218
47,Valladolid,184,Valoria la Buena,704,384,320
47,Valladolid,185,Valverde de Campos,103,58,45
47,Valladolid,187,Vega de Ruiponce,80,47,33
47,Valladolid,188,Vega de Valdetronco,91,51,40
47,Valladolid,189,Velascálvaro,163,85,78
47,Valladolid,190,Velilla,112,56,56
47,Valladolid,191,Velliza,126,82,44
47,Valladolid,192,Ventosa de la Cuesta,108,58,50
47,Valladolid,193,Viana de Cega,2255,1170,1085
47,Valladolid,195,Villabáñez,504,271,233
47,Valladolid,196,Villabaruz de Campos,27,13,14
47,Valladolid,197,Villabrágima,1034,549,485
47,Valladolid,198,Villacarralón,64,42,22
47,Valladolid,199,Villacid de Campos,79,46,33
47,Valladolid,200,Villaco,74,49,25
47,Valladolid,203,Villafrades de Campos,63,29,34
47,Valladolid,204,Villafranca de Duero,231,130,101
47,Valladolid,205,Villafrechós,453,245,208
47,Valladolid,206,Villafuerte,87,51,36
47,Valladolid,207,Villagarcía de Campos,283,166,117
47,Valladolid,208,Villagómez la Nueva,54,30,24
47,Valladolid,209,Villalán de Campos,31,20,11
47,Valladolid,210,Villalar de los Comuneros,484,232,252
47,Valladolid,211,Villalba de la Loma,61,31,30
47,Valladolid,212,Villalba de los Alcores,388,216,172
47,Valladolid,213,Villalbarba,106,53,53
47,Valladolid,214,Villalón de Campos,1526,751,775
47,Valladolid,215,Villamuriel de Campos,55,28,27
47,Valladolid,216,Villán de Tordesillas,125,70,55
47,Valladolid,217,Villanubla,2911,1518,1393
47,Valladolid,218,Villanueva de Duero,1235,653,582
47,Valladolid,219,Villanueva de la Condesa,58,26,32
47,Valladolid,220,Villanueva de los Caballeros,163,91,72
47,Valladolid,221,Villanueva de los Infantes,104,63,41
47,Valladolid,222,Villanueva de San Mancio,103,56,47
47,Valladolid,223,Villardefrades,140,82,58
47,Valladolid,224,Villarmentero de Esgueva,99,53,46
47,Valladolid,225,Villasexmir,71,42,29
47,Valladolid,226,Villavaquerín,152,85,67
47,Valladolid,227,Villavellid,55,31,24
47,Valladolid,228,Villaverde de Medina,546,289,257
47,Valladolid,229,Villavicencio de los Caballeros,234,122,112
47,Valladolid,194,Viloria,353,186,167
47,Valladolid,230,Wamba,303,163,140
47,Valladolid,231,Zaratán,6342,3213,3129
47,Valladolid,232,"Zarza, La",116,67,49
49,Zamora,2,Abezames,64,35,29
49,Zamora,3,Alcañices,1048,551,497
49,Zamora,4,Alcubilla de Nogales,107,59,48
49,Zamora,5,Alfaraz de Sayago,123,72,51
49,Zamora,6,Algodre,142,75,67
49,Zamora,7,Almaraz de Duero,393,207,186
49,Zamora,8,Almeida de Sayago,410,225,185
49,Zamora,9,Andavías,430,218,212
49,Zamora,10,Arcenillas,448,227,221
49,Zamora,11,Arcos de la Polvorosa,214,120,94
49,Zamora,12,Argañín,74,38,36
49,Zamora,13,Argujillo,214,111,103
49,Zamora,14,Arquillinos,116,62,54
49,Zamora,15,Arrabalde,213,111,102
49,Zamora,16,Aspariegos,228,99,129
49,Zamora,17,Asturianos,263,134,129
49,Zamora,18,Ayoó de Vidriales,278,143,135
49,Zamora,19,Barcial del Barco,243,125,118
49,Zamora,20,Belver de los Montes,253,142,111
49,Zamora,21,Benavente,17261,8323,8938
49,Zamora,22,Benegiles,276,150,126
49,Zamora,23,Bermillo de Sayago,998,530,468
49,Zamora,24,"Bóveda de Toro, La",664,338,326
49,Zamora,25,Bretó,178,105,73
49,Zamora,26,Bretocino,209,109,100
49,Zamora,27,Brime de Sog,121,57,64
49,Zamora,28,Brime de Urz,103,62,41
49,Zamora,29,Burganes de Valverde,617,324,293
49,Zamora,30,Bustillo del Oro,84,48,36
49,Zamora,31,Cabañas de Sayago,139,75,64
49,Zamora,32,Calzadilla de Tera,292,147,145
49,Zamora,33,Camarzana de Tera,736,373,363
49,Zamora,34,Cañizal,423,225,198
49,Zamora,35,Cañizo,204,115,89
49,Zamora,36,Carbajales de Alba,487,250,237
49,Zamora,37,Carbellino,185,103,82
49,Zamora,38,Casaseca de Campeán,97,56,41
49,Zamora,39,Casaseca de las Chanas,361,193,168
49,Zamora,40,Castrillo de la Guareña,121,65,56
49,Zamora,41,Castrogonzalo,431,235,196
49,Zamora,42,Castronuevo,206,107,99
49,Zamora,43,Castroverde de Campos,259,141,118
49,Zamora,44,Cazurra,71,38,33
49,Zamora,46,Cerecinos de Campos,244,134,110
49,Zamora,47,Cerecinos del Carrizal,108,65,43
49,Zamora,48,Cernadilla,113,58,55
49,Zamora,50,Cobreros,536,297,239
49,Zamora,52,Coomonte,175,95,80
49,Zamora,53,Coreses,1036,535,501
49,Zamora,54,Corrales del Vino,928,457,471
49,Zamora,55,Cotanes del Monte,82,44,38
49,Zamora,56,Cubillos,303,151,152
49,Zamora,57,Cubo de Benavente,119,64,55
49,Zamora,58,"Cubo de Tierra del Vino, El",315,172,143
49,Zamora,59,Cuelgamures,79,47,32
49,Zamora,61,Entrala,138,77,61
49,Zamora,62,Espadañedo,111,63,48
49,Zamora,63,Faramontanos de Tábara,334,176,158
49,Zamora,64,Fariza,494,258,236
49,Zamora,65,Fermoselle,1142,582,560
49,Zamora,66,Ferreras de Abajo,464,223,241
49,Zamora,67,Ferreras de Arriba,356,197,159
49,Zamora,68,Ferreruela,431,241,190
49,Zamora,69,Figueruela de Arriba,326,161,165
49,Zamora,71,Fonfría,783,409,374
49,Zamora,75,Fresno de la Polvorosa,116,61,55
49,Zamora,76,Fresno de la Ribera,342,176,166
49,Zamora,77,Fresno de Sayago,151,75,76
49,Zamora,78,Friera de Valverde,130,70,60
49,Zamora,79,Fuente Encalada,93,51,42
49,Zamora,80,Fuentelapeña,639,339,300
49,Zamora,82,Fuentes de Ropel,380,202,178
49,Zamora,81,Fuentesaúco,1588,806,782
49,Zamora,83,Fuentesecas,48,27,21
49,Zamora,84,Fuentespreadas,290,156,134
49,Zamora,85,Galende,996,504,492
49,Zamora,86,Gallegos del Pan,112,64,48
49,Zamora,87,Gallegos del Río,473,271,202
49,Zamora,88,Gamones,96,53,43
49,Zamora,90,Gema,195,101,94
49,Zamora,91,Granja de Moreruela,246,129,117
49,Zamora,92,Granucillo,112,62,50
49,Zamora,93,Guarrate,315,162,153
49,Zamora,94,Hermisende,233,124,109
49,Zamora,95,"Hiniesta, La",306,164,142
49,Zamora,96,Jambrina,146,79,67
49,Zamora,97,Justel,81,55,26
49,Zamora,98,Losacino,195,108,87
49,Zamora,99,Losacio,96,54,42
49,Zamora,100,Lubián,306,159,147
49,Zamora,101,Luelmo,147,81,66
49,Zamora,102,"Maderal, El",175,94,81
49,Zamora,103,Madridanos,456,240,216
49,Zamora,104,Mahide,320,181,139
49,Zamora,105,Maire de Castroponce,140,76,64
49,Zamora,107,Malva,108,50,58
49,Zamora,108,Manganeses de la Lampreana,450,236,214
49,Zamora,109,Manganeses de la Polvorosa,628,305,323
49,Zamora,110,Manzanal de Arriba,356,192,164
49,Zamora,112,Manzanal de los Infantes,136,73,63
49,Zamora,111,Manzanal del Barco,127,65,62
49,Zamora,113,Matilla de Arzón,158,91,67
49,Zamora,114,Matilla la Seca,35,19,16
49,Zamora,115,Mayalde,163,93,70
49,Zamora,116,Melgar de Tera,352,184,168
49,Zamora,117,Micereces de Tera,425,217,208
49,Zamora,118,Milles de la Polvorosa,198,111,87
49,Zamora,119,Molacillos,240,130,110
49,Zamora,120,Molezuelas de la Carballeda,47,26,21
49,Zamora,121,Mombuey,396,209,187
49,Zamora,122,Monfarracinos,980,506,474
49,Zamora,123,Montamarta,551,300,251
49,Zamora,124,Moral de Sayago,263,155,108
49,Zamora,126,Moraleja de Sayago,297,153,144
49,Zamora,125,Moraleja del Vino,1775,900,875
49,Zamora,128,Morales de Rey,525,260,265
49,Zamora,129,Morales de Toro,917,469,448
49,Zamora,130,Morales de Valverde,155,80,75
49,Zamora,127,Morales del Vino,3079,1593,1486
49,Zamora,131,Moralina,220,116,104
49,Zamora,132,Moreruela de los Infanzones,321,160,161
49,Zamora,133,Moreruela de Tábara,287,155,132
49,Zamora,134,Muelas de los Caballeros,202,118,84
49,Zamora,135,Muelas del Pan,590,318,272
49,Zamora,136,Muga de Sayago,322,158,164
49,Zamora,137,Navianos de Valverde,166,95,71
49,Zamora,138,Olmillos de Castro,197,107,90
49,Zamora,139,Otero de Bodas,160,81,79
49,Zamora,141,Pajares de la Lampreana,297,152,145
49,Zamora,143,Palacios de Sanabria,239,122,117
49,Zamora,142,Palacios del Pan,239,124,115
49,Zamora,145,Pedralba de la Pradería,204,114,90
49,Zamora,146,"Pego, El",282,145,137
49,Zamora,147,Peleagonzalo,300,150,150
49,Zamora,148,Peleas de Abajo,269,124,145
49,Zamora,149,Peñausende,373,194,179
49,Zamora,150,Peque,124,55,69
49,Zamora,151,"Perdigón, El",669,356,313
49,Zamora,152,Pereruela,506,280,226
49,Zamora,153,Perilla de Castro,159,91,68
49,Zamora,154,Pías,99,56,43
49,Zamora,155,Piedrahita de Castro,110,60,50
49,Zamora,156,Pinilla de Toro,196,102,94
49,Zamora,157,Pino del Oro,178,88,90
49,Zamora,158,"Piñero, El",225,113,112
49,Zamora,160,Pobladura de Valderaduey,37,22,15
49,Zamora,159,Pobladura del Valle,277,145,132
49,Zamora,162,Porto,171,96,75
49,Zamora,163,Pozoantiguo,202,104,98
49,Zamora,164,Pozuelo de Tábara,155,87,68
49,Zamora,165,Prado,53,31,22
49,Zamora,166,Puebla de Sanabria,1376,667,709
49,Zamora,167,Pueblica de Valverde,181,99,82
49,Zamora,170,Quintanilla de Urz,103,50,53
49,Zamora,168,Quintanilla del Monte,100,55,45
49,Zamora,169,Quintanilla del Olmo,45,25,20
49,Zamora,171,Quiruelas de Vidriales,629,332,297
49,Zamora,172,Rabanales,494,265,229
49,Zamora,173,Rábano de Aliste,320,164,156
49,Zamora,174,Requejo,118,67,51
49,Zamora,175,Revellinos,248,132,116
49,Zamora,176,Riofrío de Aliste,618,344,274
49,Zamora,177,Rionegro del Puente,233,126,107
49,Zamora,178,Roales,1010,530,480
49,Zamora,179,Robleda-Cervantes,415,220,195
49,Zamora,180,Roelos de Sayago,149,74,75
49,Zamora,181,Rosinos de la Requejada,316,170,146
49,Zamora,183,Salce,86,38,48
49,Zamora,184,Samir de los Caños,165,92,73
49,Zamora,185,San Agustín del Pozo,172,87,85
49,Zamora,186,San Cebrián de Castro,240,122,118
49,Zamora,187,San Cristóbal de Entreviñas,1344,703,641
49,Zamora,188,San Esteban del Molar,100,57,43
49,Zamora,189,San Justo,206,112,94
49,Zamora,190,San Martín de Valderaduey,48,24,24
49,Zamora,191,San Miguel de la Ribera,260,134,126
49,Zamora,192,San Miguel del Valle,117,61,56
49,Zamora,193,San Pedro de Ceque,429,229,200
49,Zamora,194,San Pedro de la Nave-Almendra,322,168,154
49,Zamora,208,San Vicente de la Cabeza,322,171,151
49,Zamora,209,San Vitero,447,250,197
49,Zamora,197,Santa Clara de Avedillo,169,82,87
49,Zamora,199,Santa Colomba de las Monjas,238,118,120
49,Zamora,200,Santa Cristina de la Polvorosa,1039,534,505
49,Zamora,201,Santa Croya de Tera,268,135,133
49,Zamora,202,Santa Eufemia del Barco,178,104,74
49,Zamora,203,Santa María de la Vega,293,153,140
49,Zamora,204,Santa María de Valverde,52,24,28
49,Zamora,205,Santibáñez de Tera,347,178,169
49,Zamora,206,Santibáñez de Vidriales,853,435,418
49,Zamora,207,Santovenia,243,130,113
49,Zamora,210,Sanzoles,471,246,225
49,Zamora,214,Tábara,759,369,390
49,Zamora,216,Tapioles,133,79,54
49,Zamora,219,Toro,8349,4081,4268
49,Zamora,220,"Torre del Valle, La",134,73,61
49,Zamora,221,Torregamones,230,119,111
49,Zamora,222,Torres del Carrizal,415,216,199
49,Zamora,223,Trabazos,859,459,400
49,Zamora,224,Trefacio,171,96,75
49,Zamora,225,Uña de Quintana,127,71,56
49,Zamora,226,Vadillo de la Guareña,254,142,112
49,Zamora,227,Valcabado,406,210,196
49,Zamora,228,Valdefinjas,58,37,21
49,Zamora,229,Valdescorriel,127,67,60
49,Zamora,230,Vallesa de la Guareña,72,40,32
49,Zamora,231,Vega de Tera,309,159,150
49,Zamora,232,Vega de Villalobos,89,40,49
49,Zamora,233,Vegalatrave,77,42,35
49,Zamora,234,Venialbo,427,227,200
49,Zamora,235,Vezdemarbán,428,226,202
49,Zamora,236,Vidayanes,82,40,42
49,Zamora,237,Videmala,145,75,70
49,Zamora,238,Villabrázaro,260,141,119
49,Zamora,239,Villabuena del Puente,603,309,294
49,Zamora,240,Villadepera,180,101,79
49,Zamora,241,Villaescusa,236,127,109
49,Zamora,242,Villafáfila,449,231,218
49,Zamora,243,Villaferrueña,108,54,54
49,Zamora,244,Villageriz,64,35,29
49,Zamora,245,Villalazán,250,125,125
49,Zamora,246,Villalba de la Lampreana,215,121,94
49,Zamora,247,Villalcampo,393,200,193
49,Zamora,248,Villalobos,207,105,102
49,Zamora,249,Villalonso,72,35,37
49,Zamora,250,Villalpando,1417,685,732
49,Zamora,251,Villalube,153,82,71
49,Zamora,252,Villamayor de Campos,336,177,159
49,Zamora,255,Villamor de los Escuderos,372,198,174
49,Zamora,256,Villanázar,265,144,121
49,Zamora,257,Villanueva de Azoague,368,192,176
49,Zamora,258,Villanueva de Campeán,128,68,60
49,Zamora,259,Villanueva de las Peras,86,42,44
49,Zamora,260,Villanueva del Campo,778,383,395
49,Zamora,263,Villar de Fallaves,48,27,21
49,Zamora,264,Villar del Buey,518,272,246
49,Zamora,261,Villaralbo,1798,908,890
49,Zamora,262,Villardeciervos,388,194,194
49,Zamora,265,Villardiegua de la Ribera,115,58,57
49,Zamora,266,Villárdiga,67,39,28
49,Zamora,267,Villardondiego,138,82,56
49,Zamora,268,Villarrín de Campos,397,210,187
49,Zamora,269,Villaseco del Pan,215,101,114
49,Zamora,270,Villavendimio,156,98,58
49,Zamora,272,Villaveza de Valverde,68,35,33
49,Zamora,271,Villaveza del Agua,172,92,80
49,Zamora,273,Viñas,158,86,72
49,Zamora,275,Zamora,59259,27397,31862
50,Zaragoza,1,Abanto,86,55,31
50,Zaragoza,2,Acered,139,81,58
50,Zaragoza,3,Agón,134,76,58
50,Zaragoza,4,Aguarón,580,314,266
50,Zaragoza,5,Aguilón,268,148,120
50,Zaragoza,6,Ainzón,1055,554,501
50,Zaragoza,7,Aladrén,64,41,23
50,Zaragoza,8,Alagón,7257,3634,3623
50,Zaragoza,9,Alarba,94,52,42
50,Zaragoza,10,Alberite de San Juan,82,46,36
50,Zaragoza,11,Albeta,141,70,71
50,Zaragoza,12,Alborge,105,58,47
50,Zaragoza,13,Alcalá de Ebro,240,113,127
50,Zaragoza,14,Alcalá de Moncayo,151,85,66
50,Zaragoza,15,Alconchel de Ariza,76,45,31
50,Zaragoza,16,Aldehuela de Liestos,51,36,15
50,Zaragoza,17,Alfajarín,2439,1238,1201
50,Zaragoza,18,Alfamén,1472,763,709
50,Zaragoza,19,Alforque,65,38,27
50,Zaragoza,20,Alhama de Aragón,925,486,439
50,Zaragoza,21,Almochuel,20,11,9
50,Zaragoza,22,"Almolda, La",548,270,278
50,Zaragoza,23,Almonacid de la Cuba,227,115,112
50,Zaragoza,24,Almonacid de la Sierra,775,445,330
50,Zaragoza,25,"Almunia de Doña Godina, La",7914,4113,3801
50,Zaragoza,26,Alpartir,570,298,272
50,Zaragoza,27,Ambel,248,124,124
50,Zaragoza,28,Anento,111,81,30
50,Zaragoza,29,Aniñón,676,347,329
50,Zaragoza,30,Añón de Moncayo,214,122,92
50,Zaragoza,31,Aranda de Moncayo,129,85,44
50,Zaragoza,32,Arándiga,266,148,118
50,Zaragoza,33,Ardisa,76,47,29
50,Zaragoza,34,Ariza,1059,537,522
50,Zaragoza,35,Artieda,80,45,35
50,Zaragoza,36,Asín,101,55,46
50,Zaragoza,37,Atea,137,81,56
50,Zaragoza,38,Ateca,1697,884,813
50,Zaragoza,39,Azuara,527,292,235
50,Zaragoza,40,Badules,75,41,34
50,Zaragoza,41,Bagüés,18,8,10
50,Zaragoza,42,Balconchán,17,5,12
50,Zaragoza,43,Bárboles,289,162,127
50,Zaragoza,44,Bardallur,232,116,116
50,Zaragoza,45,Belchite,1530,773,757
50,Zaragoza,46,Belmonte de Gracián,178,99,79
50,Zaragoza,47,Berdejo,37,26,11
50,Zaragoza,48,Berrueco,33,20,13
50,Zaragoza,901,Biel,167,103,64
50,Zaragoza,50,Bijuesca,95,64,31
50,Zaragoza,51,Biota,855,428,427
50,Zaragoza,52,Bisimbre,84,44,40
50,Zaragoza,53,Boquiñeni,780,390,390
50,Zaragoza,54,Bordalba,49,30,19
50,Zaragoza,55,Borja,5076,2579,2497
50,Zaragoza,56,Botorrita,574,310,264
50,Zaragoza,57,Brea de Aragón,1522,771,751
50,Zaragoza,58,Bubierca,59,29,30
50,Zaragoza,59,Bujaraloz,967,497,470
50,Zaragoza,60,Bulbuente,242,131,111
50,Zaragoza,61,Bureta,212,112,100
50,Zaragoza,62,"Burgo de Ebro, El",2660,1342,1318
50,Zaragoza,63,"Buste, El",64,36,28
50,Zaragoza,64,Cabañas de Ebro,487,255,232
50,Zaragoza,65,Cabolafuente,46,27,19
50,Zaragoza,66,Cadrete,4486,2350,2136
50,Zaragoza,67,Calatayud,19677,9659,10018
50,Zaragoza,68,Calatorao,2889,1500,1389
50,Zaragoza,69,Calcena,75,44,31
50,Zaragoza,70,Calmarza,58,33,25
50,Zaragoza,71,Campillo de Aragón,119,70,49
50,Zaragoza,72,Carenas,186,100,86
50,Zaragoza,73,Cariñena,3397,1716,1681
50,Zaragoza,74,Caspe,10336,5479,4857
50,Zaragoza,75,Castejón de Alarba,89,58,31
50,Zaragoza,76,Castejón de las Armas,86,44,42
50,Zaragoza,77,Castejón de Valdejasa,202,102,100
50,Zaragoza,78,Castiliscar,217,113,104
50,Zaragoza,79,Cervera de la Cañada,272,154,118
50,Zaragoza,80,Cerveruela,37,25,12
50,Zaragoza,81,Cetina,564,288,276
50,Zaragoza,92,Chiprana,531,275,256
50,Zaragoza,93,Chodes,94,50,44
50,Zaragoza,82,Cimballa,87,43,44
50,Zaragoza,83,Cinco Olivas,104,52,52
50,Zaragoza,84,Clarés de Ribota,74,42,32
50,Zaragoza,85,Codo,213,117,96
50,Zaragoza,86,Codos,228,149,79
50,Zaragoza,87,Contamina,38,22,16
50,Zaragoza,88,Cosuenda,335,171,164
50,Zaragoza,89,Cuarte de Huerva,14701,7460,7241
50,Zaragoza,90,Cubel,148,69,79
50,Zaragoza,91,"Cuerlas, Las",41,22,19
50,Zaragoza,94,Daroca,1957,963,994
50,Zaragoza,95,Ejea de los Caballeros,17135,8797,8338
50,Zaragoza,96,Embid de Ariza,31,18,13
50,Zaragoza,98,Encinacorba,183,97,86
50,Zaragoza,99,Épila,4494,2320,2174
50,Zaragoza,100,Erla,363,184,179
50,Zaragoza,101,Escatrón,1174,595,579
50,Zaragoza,102,Fabara,1065,585,480
50,Zaragoza,104,Farlete,408,201,207
50,Zaragoza,105,Fayón,422,241,181
50,Zaragoza,106,"Fayos, Los",128,70,58
50,Zaragoza,107,Figueruelas,1250,618,632
50,Zaragoza,108,Fombuena,57,32,25
50,Zaragoza,109,"Frago, El",126,79,47
50,Zaragoza,110,"Frasno, El",363,203,160
50,Zaragoza,111,Fréscano,200,110,90
50,Zaragoza,113,Fuendejalón,756,406,350
50,Zaragoza,114,Fuendetodos,150,87,63
50,Zaragoza,115,Fuentes de Ebro,4626,2403,2223
50,Zaragoza,116,Fuentes de Jiloca,219,121,98
50,Zaragoza,117,Gallocanta,123,68,55
50,Zaragoza,118,Gallur,2576,1298,1278
50,Zaragoza,119,Gelsa,996,524,472
50,Zaragoza,120,Godojos,61,34,27
50,Zaragoza,121,Gotor,307,163,144
50,Zaragoza,122,Grisel,93,52,41
50,Zaragoza,123,Grisén,646,331,315
50,Zaragoza,124,Herrera de los Navarros,502,278,224
50,Zaragoza,125,Ibdes,378,196,182
50,Zaragoza,126,Illueca,2711,1381,1330
50,Zaragoza,128,Isuerre,33,16,17
50,Zaragoza,129,Jaraba,281,157,124
50,Zaragoza,130,Jarque de Moncayo,399,209,190
50,Zaragoza,131,Jaulín,291,155,136
50,Zaragoza,132,"Joyosa, La",1152,587,565
50,Zaragoza,133,Lagata,111,62,49
50,Zaragoza,134,Langa del Castillo,115,61,54
50,Zaragoza,135,Layana,96,54,42
50,Zaragoza,136,Lécera,616,318,298
50,Zaragoza,138,Lechón,46,27,19
50,Zaragoza,137,Leciñena,1103,563,540
50,Zaragoza,139,Letux,337,183,154
50,Zaragoza,140,Litago,196,115,81
50,Zaragoza,141,Lituénigo,123,63,60
50,Zaragoza,142,Lobera de Onsella,26,14,12
50,Zaragoza,143,Longares,852,511,341
50,Zaragoza,144,Longás,44,27,17
50,Zaragoza,146,Lucena de Jalón,234,126,108
50,Zaragoza,147,Luceni,990,500,490
50,Zaragoza,148,Luesia,335,179,156
50,Zaragoza,149,Luesma,39,22,17
50,Zaragoza,150,Lumpiaque,848,446,402
50,Zaragoza,151,Luna,680,361,319
50,Zaragoza,152,Maella,2100,1149,951
50,Zaragoza,153,Magallón,1110,574,536
50,Zaragoza,154,Mainar,176,94,82
50,Zaragoza,155,Malanquilla,79,53,26
50,Zaragoza,156,Maleján,268,147,121
50,Zaragoza,160,Mallén,2939,1520,1419
50,Zaragoza,157,Malón,431,216,215
50,Zaragoza,159,Maluenda,902,456,446
50,Zaragoza,161,Manchones,99,54,45
50,Zaragoza,162,Mara,163,77,86
50,Zaragoza,163,María de Huerva,6335,3194,3141
50,Zaragoza,902,Marracos,87,45,42
50,Zaragoza,164,Mediana de Aragón,441,220,221
50,Zaragoza,165,Mequinenza,2272,1144,1128
50,Zaragoza,166,Mesones de Isuela,260,138,122
50,Zaragoza,167,Mezalocha,224,120,104
50,Zaragoza,168,Mianos,26,14,12
50,Zaragoza,169,Miedes de Aragón,425,222,203
50,Zaragoza,170,Monegrillo,384,211,173
50,Zaragoza,171,Moneva,124,72,52
50,Zaragoza,172,Monreal de Ariza,175,107,68
50,Zaragoza,173,Monterde,160,105,55
50,Zaragoza,174,Montón,87,56,31
50,Zaragoza,175,Morata de Jalón,1058,528,530
50,Zaragoza,176,Morata de Jiloca,251,143,108
50,Zaragoza,177,Morés,304,162,142
50,Zaragoza,178,Moros,285,146,139
50,Zaragoza,179,Moyuela,241,138,103
50,Zaragoza,180,Mozota,129,68,61
50,Zaragoza,181,Muel,1450,756,694
50,Zaragoza,182,"Muela, La",6416,3333,3083
50,Zaragoza,183,Munébrega,369,195,174
50,Zaragoza,184,Murero,106,58,48
50,Zaragoza,185,Murillo de Gállego,203,119,84
50,Zaragoza,186,Navardún,38,23,15
50,Zaragoza,187,Nigüella,60,35,25
50,Zaragoza,188,Nombrevilla,37,21,16
50,Zaragoza,189,Nonaspe,1025,559,466
50,Zaragoza,190,Novallas,846,448,398
50,Zaragoza,191,Novillas,509,256,253
50,Zaragoza,192,Nuévalos,317,172,145
50,Zaragoza,193,Nuez de Ebro,912,454,458
50,Zaragoza,194,Olvés,102,56,46
50,Zaragoza,195,Orcajo,59,37,22
50,Zaragoza,196,Orera,103,57,46
50,Zaragoza,197,Orés,91,55,36
50,Zaragoza,198,Oseja,47,32,15
50,Zaragoza,199,Osera de Ebro,400,203,197
50,Zaragoza,200,Paniza,594,324,270
50,Zaragoza,201,Paracuellos de Jiloca,584,309,275
50,Zaragoza,202,Paracuellos de la Ribera,115,64,51
50,Zaragoza,203,Pastriz,1316,644,672
50,Zaragoza,204,Pedrola,3667,1899,1768
50,Zaragoza,205,"Pedrosas, Las",99,49,50
50,Zaragoza,206,Perdiguera,552,300,252
50,Zaragoza,207,Piedratajada,89,51,38
50,Zaragoza,208,Pina de Ebro,2456,1253,1203
50,Zaragoza,209,Pinseque,4342,2224,2118
50,Zaragoza,210,"Pintanos, Los",40,27,13
50,Zaragoza,211,Plasencia de Jalón,353,194,159
50,Zaragoza,212,Pleitas,34,13,21
50,Zaragoza,213,Plenas,105,58,47
50,Zaragoza,214,Pomer,26,19,7
50,Zaragoza,215,Pozuel de Ariza,23,12,11
50,Zaragoza,216,Pozuelo de Aragón,257,138,119
50,Zaragoza,217,Pradilla de Ebro,558,308,250
50,Zaragoza,218,Puebla de Albortón,131,75,56
50,Zaragoza,219,"Puebla de Alfindén, La",6414,3274,3140
50,Zaragoza,220,Puendeluna,44,28,16
50,Zaragoza,221,Purujosa,30,19,11
50,Zaragoza,222,Quinto,1869,953,916
50,Zaragoza,223,Remolinos,1010,508,502
50,Zaragoza,224,Retascón,71,38,33
50,Zaragoza,225,Ricla,2987,1619,1368
50,Zaragoza,227,Romanos,149,79,70
50,Zaragoza,228,Rueda de Jalón,323,171,152
50,Zaragoza,229,Ruesca,70,29,41
50,Zaragoza,241,Sabiñán,673,355,318
50,Zaragoza,230,Sádaba,1263,637,626
50,Zaragoza,231,Salillas de Jalón,351,175,176
50,Zaragoza,232,Salvatierra de Esca,204,101,103
50,Zaragoza,233,Samper del Salz,92,49,43
50,Zaragoza,234,San Martín de la Virgen de Moncayo,271,155,116
50,Zaragoza,235,San Mateo de Gállego,3441,1752,1689
50,Zaragoza,236,Santa Cruz de Grío,97,65,32
50,Zaragoza,237,Santa Cruz de Moncayo,126,68,58
50,Zaragoza,238,Santa Eulalia de Gállego,94,53,41
50,Zaragoza,239,Santed,67,42,25
50,Zaragoza,240,Sástago,1088,545,543
50,Zaragoza,242,Sediles,108,62,46
50,Zaragoza,243,Sestrica,341,196,145
50,Zaragoza,244,Sierra de Luna,271,138,133
50,Zaragoza,245,Sigüés,70,39,31
50,Zaragoza,246,Sisamón,44,28,16
50,Zaragoza,247,Sobradiel,1116,533,583
50,Zaragoza,248,Sos del Rey Católico,583,310,273
50,Zaragoza,249,Tabuenca,315,193,122
50,Zaragoza,250,Talamantes,84,41,43
50,Zaragoza,251,Tarazona,10720,5319,5401
50,Zaragoza,252,Tauste,6828,3426,3402
50,Zaragoza,253,Terrer,550,301,249
50,Zaragoza,254,Tierga,174,99,75
50,Zaragoza,255,Tobed,201,108,93
50,Zaragoza,256,Torralba de los Frailes,72,39,33
50,Zaragoza,257,Torralba de Ribota,176,95,81
50,Zaragoza,258,Torralbilla,43,27,16
50,Zaragoza,259,Torrehermosa,73,36,37
50,Zaragoza,260,Torrelapaja,32,21,11
50,Zaragoza,261,Torrellas,237,126,111
50,Zaragoza,262,Torres de Berrellén,1498,783,715
50,Zaragoza,263,Torrijo de la Cañada,201,118,83
50,Zaragoza,264,Tosos,163,96,67
50,Zaragoza,265,Trasmoz,83,46,37
50,Zaragoza,266,Trasobares,123,73,50
50,Zaragoza,267,Uncastillo,625,299,326
50,Zaragoza,268,Undués de Lerda,52,29,23
50,Zaragoza,269,Urrea de Jalón,438,247,191
50,Zaragoza,270,Urriés,49,23,26
50,Zaragoza,271,Used,269,146,123
50,Zaragoza,272,Utebo,18955,9378,9577
50,Zaragoza,274,Val de San Martín,62,38,24
50,Zaragoza,273,Valdehorna,32,19,13
50,Zaragoza,275,Valmadrid,126,76,50
50,Zaragoza,276,Valpalmas,136,67,69
50,Zaragoza,277,Valtorres,72,36,36
50,Zaragoza,278,Velilla de Ebro,202,106,96
50,Zaragoza,279,Velilla de Jiloca,67,31,36
50,Zaragoza,280,Vera de Moncayo,315,171,144
50,Zaragoza,281,Vierlas,85,47,38
50,Zaragoza,283,Villadoz,82,45,37
50,Zaragoza,284,Villafeliche,146,87,59
50,Zaragoza,285,Villafranca de Ebro,840,432,408
50,Zaragoza,286,Villalba de Perejil,91,41,50
50,Zaragoza,287,Villalengua,289,159,130
50,Zaragoza,903,Villamayor de Gállego,2866,1455,1411
50,Zaragoza,288,Villanueva de Gállego,4806,2401,2405
50,Zaragoza,290,Villanueva de Huerva,385,203,182
50,Zaragoza,289,Villanueva de Jiloca,69,34,35
50,Zaragoza,291,Villar de los Navarros,148,82,66
50,Zaragoza,292,Villarreal de Huerva,278,157,121
50,Zaragoza,293,Villarroya de la Sierra,430,230,200
50,Zaragoza,294,Villarroya del Campo,71,39,32
50,Zaragoza,282,"Vilueña, La",63,34,29
50,Zaragoza,295,Vistabella,51,30,21
50,Zaragoza,296,"Zaida, La",439,224,215
50,Zaragoza,297,Zaragoza,682513,326270,356243
50,Zaragoza,298,Zuera,8677,4455,4222
