province_code,province_name,cmun,municipality_name,population_total,population_male,population_female
02,Albacete,1,Abengibre,819,409,410
02,Albacete,2,Alatoz,572,318,254
02,Albacete,3,Albacete,172693,84702,87991
02,Albacete,4,Albatana,774,394,380
02,Albacete,5,Alborea,825,426,399
02,Albacete,6,Alcadozo,708,375,333
02,Albacete,7,Alcalá del Júcar,1314,698,616
02,Albacete,8,Alcaraz,1551,786,765
02,Albacete,9,Almansa,25279,12560,12719
02,Albacete,10,Alpera,2406,1232,1174
02,Albacete,11,Ayna,751,407,344
02,Albacete,12,Balazote,2401,1249,1152
02,Albacete,14,"Ballestero, El",462,239,223
02,Albacete,13,Balsa de Ves,179,99,80
02,Albacete,15,Barrax,1934,1002,932
02,Albacete,16,Bienservida,696,360,336
02,Albacete,17,Bogarra,970,512,458
02,Albacete,18,Bonete,1209,620,589
02,Albacete,19,"Bonillo, El",2968,1508,1460
02,Albacete,20,Carcelén,600,320,280
02,Albacete,21,Casas de Juan Núñez,1423,736,687
02,Albacete,22,Casas de Lázaro,406,224,182
02,Albacete,23,Casas de Ves,701,373,328
02,Albacete,24,Casas-Ibáñez,4753,2467,2286
02,Albacete,25,Caudete,10250,5187,5063
02,Albacete,26,Cenizate,1296,673,623
02,Albacete,29,Chinchilla de Monte-Aragón,4067,2103,1964
02,Albacete,27,Corral-Rubio,382,206,176
02,Albacete,28,Cotillas,147,77,70
02,Albacete,30,Elche de la Sierra,3901,1972,1929
02,Albacete,31,Férez,736,364,372
02,Albacete,32,Fuensanta,342,192,150
02,Albacete,33,Fuente-Álamo,2652,1409,1243
02,Albacete,34,Fuentealbilla,1964,1000,964
02,Albacete,35,"Gineta, La",2560,1314,1246
02,Albacete,36,Golosalvo,118,61,57
02,Albacete,37,Hellín,31029,15458,15571
02,Albacete,38,"Herrera, La",345,171,174
02,Albacete,39,Higueruela,1288,661,627
02,Albacete,40,Hoya-Gonzalo,718,379,339
02,Albacete,41,Jorquera,408,215,193
02,Albacete,42,Letur,1032,509,523
02,Albacete,43,Lezuza,1542,782,760
02,Albacete,44,Liétor,1357,701,656
02,Albacete,45,Madrigueras,4759,2434,2325
02,Albacete,46,Mahora,1427,722,705
02,Albacete,47,Masegoso,126,68,58
02,Albacete,48,Minaya,1637,838,799
02,Albacete,49,Molinicos,960,502,458
02,Albacete,50,Montalvos,113,61,52
02,Albacete,51,Montealegre del Castillo,2186,1119,1067
02,Albacete,52,Motilleja,574,295,279
02,Albacete,53,Munera,3714,1880,1834
02,Albacete,54,Navas de Jorquera,550,282,268
02,Albacete,55,Nerpio,1434,775,659
02,Albacete,56,Ontur,2217,1105,1112
02,Albacete,57,Ossa de Montiel,2593,1302,1291
02,Albacete,58,Paterna del Madera,396,208,188
02,Albacete,60,Peñas de San Pedro,1379,795,584
02,Albacete,59,Peñascosa,373,188,185
02,Albacete,61,Pétrola,782,407,375
02,Albacete,62,Povedilla,521,270,251
02,Albacete,901,Pozo Cañada,2867,1445,1422
02,Albacete,63,Pozohondo,1770,936,834
02,Albacete,64,Pozo-Lorente,431,215,216
02,Albacete,65,Pozuelo,567,301,266
02,Albacete,66,"Recueja, La",290,145,145
02,Albacete,67,Riópar,1480,751,729
02,Albacete,68,Robledo,436,225,211
02,Albacete,69,"Roda, La",16398,8305,8093
02,Albacete,70,Salobre,605,317,288
02,Albacete,71,San Pedro,1243,635,608
02,Albacete,72,Socovos,1934,994,940
02,Albacete,73,Tarazona de la Mancha,6678,3384,3294
02,Albacete,74,Tobarra,8021,4070,3951
02,Albacete,75,Valdeganga,1963,991,972
02,Albacete,76,Vianos,385,191,194
02,Albacete,77,Villa de Ves,50,28,22
02,Albacete,78,Villalgordo del Júcar,1222,639,583
02,Albacete,79,Villamalea,4096,2044,2052
02,Albacete,80,Villapalacios,650,347,303
02,Albacete,81,Villarrobledo,26513,13202,13311
02,Albacete,82,Villatoya,119,63,56
02,Albacete,83,Villavaliente,264,149,115
02,Albacete,84,Villaverde de Guadalimar,402,219,183
02,Albacete,85,Viveros,302,149,153
02,Albacete,86,Yeste,3052,1570,1482
03,Alicante/Alacant,1,Adsubia,744,385,359
03,Alicante/Alacant,2,Agost,4787,2411,2376
03,Alicante/Alacant,3,Agres,565,304,261
03,Alicante/Alacant,4,Aigües,1073,570,503
03,Alicante/Alacant,5,Albatera,11983,6117,5866
03,Alicante/Alacant,6,Alcalalí,1401,701,700
03,Alicante/Alacant,7,Alcocer de Planes,241,123,118
03,Alicante/Alacant,8,Alcoleja,199,103,96
03,Alicante/Alacant,9,Alcoy/Alcoi,60105,29211,30894
03,Alicante/Alacant,10,Alfafara,415,200,215
03,Alicante/Alacant,11,"Alfàs del Pi, l'",21969,10959,11010
03,Alicante/Alacant,12,Algorfa,5004,2479,2525
03,Alicante/Alacant,13,Algueña,1528,771,757
03,Alicante/Alacant,14,Alicante/Alacant,335052,162869,172183
03,Alicante/Alacant,15,Almoradí,19788,10017,9771
03,Alicante/Alacant,16,Almudaina,128,67,61
03,Alicante/Alacant,17,"Alqueria d'Asnar, l'",512,236,276
03,Alicante/Alacant,18,Altea,24333,12046,12287
03,Alicante/Alacant,19,Aspe,20341,10263,10078
03,Alicante/Alacant,20,Balones,147,76,71
03,Alicante/Alacant,21,Banyeres de Mariola,7157,3579,3578
03,Alicante/Alacant,22,Benasau,157,79,78
03,Alicante/Alacant,23,Beneixama,1778,881,897
03,Alicante/Alacant,24,Benejúzar,5453,2719,2734
03,Alicante/Alacant,25,Benferri,1927,1023,904
03,Alicante/Alacant,26,Beniarbeig,1915,953,962
03,Alicante/Alacant,27,Beniardá,188,98,90
03,Alicante/Alacant,28,Beniarrés,1268,625,643
03,Alicante/Alacant,30,Benidoleig,1333,658,675
03,Alicante/Alacant,31,Benidorm,73768,37157,36611
03,Alicante/Alacant,32,Benifallim,123,63,60
03,Alicante/Alacant,33,Benifato,198,100,98
03,Alicante/Alacant,29,Benigembla,566,291,275
03,Alicante/Alacant,34,Benijófar,3514,1724,1790
03,Alicante/Alacant,35,Benilloba,794,401,393
03,Alicante/Alacant,36,Benillup,110,49,61
03,Alicante/Alacant,37,Benimantell,487,226,261
03,Alicante/Alacant,38,Benimarfull,423,210,213
03,Alicante/Alacant,39,Benimassot,113,60,53
03,Alicante/Alacant,40,Benimeli,435,214,221
03,Alicante/Alacant,41,Benissa,13932,6978,6954
03,Alicante/Alacant,42,"Benitachell/Poble Nou de Benitatxell, el",5720,2864,2856
03,Alicante/Alacant,43,Biar,3689,1790,1899
03,Alicante/Alacant,44,Bigastro,6730,3439,3291
03,Alicante/Alacant,45,Bolulla,448,222,226
03,Alicante/Alacant,46,Busot,3429,1730,1699
03,Alicante/Alacant,49,Callosa de Segura,17992,9065,8927
03,Alicante/Alacant,48,Callosa d'En Sarrià,7371,3728,3643
03,Alicante/Alacant,47,Calp,29442,14874,14568
03,Alicante/Alacant,50,"Campello, el",28184,13913,14271
03,Alicante/Alacant,51,"Campo de Mirra/Camp de Mirra, el",435,223,212
03,Alicante/Alacant,52,Cañada,1249,612,637
03,Alicante/Alacant,53,Castalla,10579,5342,5237
03,Alicante/Alacant,54,Castell de Castells,483,240,243
03,Alicante/Alacant,75,"Castell de Guadalest, el",236,120,116
03,Alicante/Alacant,55,Catral,8648,4408,4240
03,Alicante/Alacant,56,Cocentaina,11558,5837,5721
03,Alicante/Alacant,57,Confrides,243,139,104
03,Alicante/Alacant,58,Cox,7135,3653,3482
03,Alicante/Alacant,59,Crevillent,28382,14435,13947
03,Alicante/Alacant,61,Daya Nueva,1956,985,971
03,Alicante/Alacant,62,Daya Vieja,770,390,380
03,Alicante/Alacant,63,Dénia,44450,21844,22606
03,Alicante/Alacant,64,Dolores,7314,3658,3656
03,Alicante/Alacant,65,Elche/Elx,230224,114517,115707
03,Alicante/Alacant,66,Elda,54056,26409,27647
03,Alicante/Alacant,67,Facheca,101,55,46
03,Alicante/Alacant,68,Famorca,51,26,25
03,Alicante/Alacant,69,Finestrat,7095,3641,3454
03,Alicante/Alacant,77,"Fondó de les Neus, el/Hondón de las Nieves",3041,1542,1499
03,Alicante/Alacant,70,Formentera del Segura,4629,2391,2238
03,Alicante/Alacant,72,Gaianes,446,234,212
03,Alicante/Alacant,71,Gata de Gorgos,6270,3185,3085
03,Alicante/Alacant,73,Gorga,264,140,124
03,Alicante/Alacant,74,Granja de Rocamora,2437,1278,1159
03,Alicante/Alacant,76,Guardamar del Segura,16957,8506,8451
03,Alicante/Alacant,78,Hondón de los Frailes,1217,641,576
03,Alicante/Alacant,79,Ibi,23634,11823,11811
03,Alicante/Alacant,80,Jacarilla,2038,1025,1013
03,Alicante/Alacant,82,Jávea/Xàbia,33149,16572,16577
03,Alicante/Alacant,83,Jijona/Xixona,7366,3560,3806
03,Alicante/Alacant,85,Llíber,1091,545,546
03,Alicante/Alacant,84,"Lorcha/Orxa, l'",710,357,353
03,Alicante/Alacant,86,Millena,215,111,104
03,Alicante/Alacant,88,Monforte del Cid,7807,4087,3720
03,Alicante/Alacant,89,Monóvar/Monòver,12720,6328,6392
03,Alicante/Alacant,903,"Montesinos, Los",5043,2528,2515
03,Alicante/Alacant,91,Murla,604,294,310
03,Alicante/Alacant,92,Muro de Alcoy,9062,4502,4560
03,Alicante/Alacant,90,Mutxamel,23707,11829,11878
03,Alicante/Alacant,93,Novelda,26517,13199,13318
03,Alicante/Alacant,94,"Nucia, la",19524,9894,9630
03,Alicante/Alacant,95,Ondara,6613,3306,3307
03,Alicante/Alacant,96,Onil,7544,3779,3765
03,Alicante/Alacant,97,Orba,2570,1279,1291
03,Alicante/Alacant,99,Orihuela,91260,45752,45508
03,Alicante/Alacant,98,Orxeta,916,473,443
03,Alicante/Alacant,100,Parcent,1104,541,563
03,Alicante/Alacant,101,Pedreguer,7757,3860,3897
03,Alicante/Alacant,102,Pego,10957,5597,5360
03,Alicante/Alacant,103,Penàguila,321,167,154
03,Alicante/Alacant,104,Petrer,34757,17346,17411
03,Alicante/Alacant,902,Pilar de la Horadada,23670,12176,11494
03,Alicante/Alacant,105,"Pinós, el/Pinoso",7874,3969,3905
03,Alicante/Alacant,106,Planes,817,428,389
03,Alicante/Alacant,901,"Poblets, els",3402,1645,1757
03,Alicante/Alacant,107,Polop,4688,2394,2294
03,Alicante/Alacant,60,Quatretondeta,117,56,61
03,Alicante/Alacant,109,Rafal,4170,2095,2075
03,Alicante/Alacant,110,"Ràfol d'Almúnia, el",719,360,359
03,Alicante/Alacant,111,Redován,7672,3981,3691
03,Alicante/Alacant,112,Relleu,1330,662,668
03,Alicante/Alacant,113,Rojales,21686,11069,10617
03,Alicante/Alacant,114,"Romana, la",2474,1290,1184
03,Alicante/Alacant,115,Sagra,432,222,210
03,Alicante/Alacant,116,Salinas,1586,803,783
03,Alicante/Alacant,118,San Fulgencio,12688,6407,6281
03,Alicante/Alacant,904,San Isidro,1901,980,921
03,Alicante/Alacant,120,San Miguel de Salinas,7012,3513,3499
03,Alicante/Alacant,122,San Vicente del Raspeig/Sant Vicent del Raspeig,55781,27734,28047
03,Alicante/Alacant,117,Sanet y Negrals,664,328,336
03,Alicante/Alacant,119,Sant Joan d'Alacant,23026,11156,11870
03,Alicante/Alacant,121,Santa Pola,34134,17310,16824
03,Alicante/Alacant,123,Sax,10091,5084,5007
03,Alicante/Alacant,124,Sella,615,331,284
03,Alicante/Alacant,125,Senija,661,346,315
03,Alicante/Alacant,127,Tàrbena,797,415,382
03,Alicante/Alacant,128,Teulada,14452,7263,7189
03,Alicante/Alacant,129,Tibi,1757,916,841
03,Alicante/Alacant,130,Tollos,38,21,17
03,Alicante/Alacant,131,Tormos,386,196,190
03,Alicante/Alacant,132,"Torremanzanas/Torre de les Maçanes, la",770,406,364
03,Alicante/Alacant,133,Torrevieja,105205,53027,52178
03,Alicante/Alacant,134,"Vall d'Alcalà, la",177,94,83
03,Alicante/Alacant,136,Vall de Gallinera,609,322,287
03,Alicante/Alacant,137,"Vall de Laguar, la",942,463,479
03,Alicante/Alacant,135,"Vall d'Ebo, la",281,146,135
03,Alicante/Alacant,138,"Verger, el",4856,2445,2411
03,Alicante/Alacant,139,"Villajoyosa/Vila Joiosa, la",33834,16969,16865
03,Alicante/Alacant,140,Villena,34834,17407,17427
03,Alicante/Alacant,81,Xaló,3323,1672,1651
04,Almería,1,Abla,1422,738,684
04,Almería,2,Abrucena,1299,671,628
04,Almería,3,Adra,24761,12518,12243
04,Almería,4,Albánchez,648,325,323
04,Almería,5,Alboloduy,645,318,327
04,Almería,6,Albox,10409,5292,5117
04,Almería,7,Alcolea,850,445,405
04,Almería,8,Alcóntar,618,330,288
04,Almería,9,Alcudia de Monteagud,141,74,67
04,Almería,10,Alhabia,671,341,330
04,Almería,11,Alhama de Almería,3815,1935,1880
04,Almería,12,Alicún,244,126,118
04,Almería,13,Almería,192697,93730,98967
04,Almería,14,Almócita,177,86,91
04,Almería,15,Alsodux,149,78,71
04,Almería,16,Antas,3288,1659,1629
04,Almería,17,Arboleas,5126,2569,2557
04,Almería,18,Armuña de Almanzora,338,169,169
04,Almería,19,Bacares,273,136,137
04,Almería,20,Bayárcal,347,190,157
04,Almería,21,Bayarque,216,110,106
04,Almería,22,Bédar,1113,569,544
04,Almería,23,Beires,114,55,59
04,Almería,24,Benahadux,4222,2098,2124
04,Almería,26,Benitagla,73,40,33
04,Almería,27,Benizalón,281,145,136
04,Almería,28,Bentarique,260,144,116
04,Almería,29,Berja,15521,7876,7645
04,Almería,30,Canjáyar,1405,726,679
04,Almería,31,Cantoria,3926,2008,1918
04,Almería,32,Carboneras,8035,4165,3870
04,Almería,33,Castro de Filabres,148,73,75
04,Almería,36,Chercos,284,151,133
04,Almería,37,Chirivel,1795,924,871
04,Almería,34,Cóbdar,146,80,66
04,Almería,35,Cuevas del Almanzora,13108,6782,6326
04,Almería,38,Dalías,3972,1958,2014
04,Almería,902,"Ejido, El",82983,43623,39360
04,Almería,41,Enix,451,258,193
04,Almería,43,Felix,667,364,303
04,Almería,44,Fines,2244,1181,1063
04,Almería,45,Fiñana,2270,1142,1128
04,Almería,46,Fondón,990,512,478
04,Almería,47,Gádor,3226,1689,1537
04,Almería,48,"Gallardos, Los",2848,1459,1389
04,Almería,49,Garrucha,8663,4454,4209
04,Almería,50,Gérgal,1075,551,524
04,Almería,51,Huécija,533,257,276
04,Almería,52,Huércal de Almería,16442,8433,8009
04,Almería,53,Huércal-Overa,18925,9445,9480
04,Almería,54,Illar,366,188,178
04,Almería,55,Instinción,480,225,255
04,Almería,56,Laroya,177,95,82
04,Almería,57,Láujar de Andarax,1671,835,836
04,Almería,58,Líjar,448,231,217
04,Almería,59,Lubrín,1708,847,861
04,Almería,60,Lucainena de las Torres,650,343,307
04,Almería,61,Lúcar,854,433,421
04,Almería,62,Macael,5738,2917,2821
04,Almería,63,María,1352,687,665
04,Almería,64,Mojácar,8360,4227,4133
04,Almería,903,"Mojonera, La",8844,4851,3993
04,Almería,65,Nacimiento,517,271,246
04,Almería,66,Níjar,28245,15433,12812
04,Almería,67,Ohanes,710,349,361
04,Almería,68,Olula de Castro,171,87,84
04,Almería,69,Olula del Río,6444,3314,3130
04,Almería,70,Oria,2366,1219,1147
04,Almería,71,Padules,500,262,238
04,Almería,72,Partaloa,979,482,497
04,Almería,73,Paterna del Río,431,235,196
04,Almería,74,Pechina,3736,1898,1838
04,Almería,75,Pulpí,8871,4609,4262
04,Almería,76,Purchena,1727,901,826
04,Almería,77,Rágol,340,179,161
04,Almería,78,Rioja,1397,694,703
04,Almería,79,Roquetas de Mar,87868,45427,42441
04,Almería,80,Santa Cruz de Marchena,214,104,110
04,Almería,81,Santa Fe de Mondújar,419,211,208
04,Almería,82,Senés,311,166,145
04,Almería,83,Serón,2290,1160,1130
04,Almería,84,Sierro,436,231,205
04,Almería,85,Somontín,521,260,261
04,Almería,86,Sorbas,2765,1466,1299
04,Almería,87,Suflí,251,131,120
04,Almería,88,Tabernas,3696,1923,1773
04,Almería,89,Taberno,1130,555,575
04,Almería,90,Tahal,441,236,205
04,Almería,91,Terque,456,234,222
04,Almería,92,Tíjola,3840,1900,1940
04,Almería,901,"Tres Villas, Las",603,314,289
04,Almería,93,Turre,3960,2035,1925
04,Almería,94,Turrillas,243,138,105
04,Almería,95,Uleila del Campo,963,500,463
04,Almería,96,Urrácal,329,162,167
04,Almería,97,Velefique,292,161,131
04,Almería,98,Vélez-Blanco,2066,1075,991
04,Almería,99,Vélez-Rubio,6841,3346,3495
04,Almería,100,Vera,15424,7886,7538
04,Almería,101,Viator,5600,2859,2741
04,Almería,102,Vícar,24233,12771,11462
04,Almería,103,Zurgena,3201,1593,1608
01,Araba/Álava,1,Alegría-Dulantzi,2870,1482,1388
01,Araba/Álava,2,Amurrio,10139,5081,5058
01,Araba/Álava,49,Añana,154,85,69
01,Araba/Álava,3,Aramaio,1491,789,702
01,Araba/Álava,6,Armiñón,237,121,116
01,Araba/Álava,37,Arraia-Maeztu,731,415,316
01,Araba/Álava,8,Arratzua-Ubarrundia,981,525,456
01,Araba/Álava,4,Artziniega,1832,928,904
01,Araba/Álava,9,Asparrena,1671,845,826
01,Araba/Álava,10,Ayala/Aiara,2935,1467,1468
01,Araba/Álava,11,Baños de Ebro/Mañueta,323,181,142
01,Araba/Álava,13,Barrundia,924,510,414
01,Araba/Álava,14,Berantevilla,479,246,233
01,Araba/Álava,16,Bernedo,567,333,234
01,Araba/Álava,17,Campezo/Kanpezu,1127,598,529
01,Araba/Álava,21,Elburgo/Burgelu,617,326,291
01,Araba/Álava,22,Elciego,1045,511,534
01,Araba/Álava,23,Elvillar/Bilar,357,180,177
01,Araba/Álava,46,Erriberagoitia/Ribera Alta,758,431,327
01,Araba/Álava,56,Harana/Valle de Arana,260,152,108
01,Araba/Álava,901,Iruña Oka/Iruña de Oca,3100,1597,1503
01,Araba/Álava,27,Iruraiz-Gauna,517,284,233
01,Araba/Álava,19,Kripan,198,106,92
01,Araba/Álava,20,Kuartango,357,204,153
01,Araba/Álava,28,Labastida/Bastida,1476,765,711
01,Araba/Álava,30,Lagrán,170,86,84
01,Araba/Álava,31,Laguardia,1528,795,733
01,Araba/Álava,32,Lanciego/Lantziego,685,351,334
01,Araba/Álava,902,Lantarón,937,525,412
01,Araba/Álava,33,Lapuebla de Labarca,828,430,398
01,Araba/Álava,36,Laudio/Llodio,18510,9152,9358
01,Araba/Álava,58,Legutio,1749,926,823
01,Araba/Álava,34,Leza,213,112,101
01,Araba/Álava,39,Moreda de Álava/Moreda Araba,238,118,120
01,Araba/Álava,41,Navaridas,223,131,92
01,Araba/Álava,42,Okondo,1149,608,541
01,Araba/Álava,43,Oyón-Oion,3279,1681,1598
01,Araba/Álava,44,Peñacerrada-Urizaharra,269,165,104
01,Araba/Álava,47,Ribera Baja/Erribera Beitia,1334,733,601
01,Araba/Álava,51,Salvatierra/Agurain,4995,2520,2475
01,Araba/Álava,52,Samaniego,326,179,147
01,Araba/Álava,53,San Millán/Donemiliaga,743,399,344
01,Araba/Álava,54,Urkabustaiz,1300,690,610
01,Araba/Álava,55,Valdegovía/Gaubea,1044,572,472
01,Araba/Álava,57,Villabuena de Álava/Eskuernaga,310,162,148
01,Araba/Álava,59,Vitoria-Gasteiz,241386,118459,122927
01,Araba/Álava,60,Yécora/Iekora,265,136,129
01,Araba/Álava,61,Zalduondo,186,104,82
01,Araba/Álava,62,Zambrana,422,224,198
01,Araba/Álava,18,Zigoitia,1755,943,812
01,Araba/Álava,63,Zuia,2427,1259,1168
33,Asturias,1,Allande,1891,964,927
33,Asturias,2,Aller,11906,5864,6042
33,Asturias,3,Amieva,772,413,359
33,Asturias,4,Avilés,82568,39357,43211
33,Asturias,5,Belmonte de Miranda,1711,884,827
33,Asturias,6,Bimenes,1812,861,951
33,Asturias,7,Boal,1776,888,888
33,Asturias,8,Cabrales,2140,1086,1054
33,Asturias,9,Cabranes,1081,556,525
33,Asturias,10,Candamo,2097,1023,1074
33,Asturias,12,Cangas de Onís,6784,3313,3471
33,Asturias,11,Cangas del Narcea,13878,6918,6960
33,Asturias,13,Caravia,504,258,246
33,Asturias,14,Carreño,10858,5263,5595
33,Asturias,15,Caso,1746,975,771
33,Asturias,16,Castrillón,22851,11121,11730
33,Asturias,17,Castropol,3677,1774,1903
33,Asturias,18,Coaña,3446,1677,1769
33,Asturias,19,Colunga,3607,1756,1851
33,Asturias,20,Corvera de Asturias,16146,7939,8207
33,Asturias,21,Cudillero,5568,2751,2817
33,Asturias,22,Degaña,1119,582,537
33,Asturias,23,"Franco, El",3960,1948,2012
33,Asturias,24,Gijón,275274,129984,145290
33,Asturias,25,Gozón,10760,5260,5500
33,Asturias,26,Grado,10595,5128,5467
33,Asturias,27,Grandas de Salime,973,486,487
33,Asturias,28,Ibias,1580,864,716
33,Asturias,29,Illano,416,216,200
33,Asturias,30,Illas,1048,534,514
33,Asturias,31,Langreo,43070,20460,22610
33,Asturias,32,Laviana,13892,6684,7208
33,Asturias,33,Lena,12162,5884,6278
33,Asturias,35,Llanera,14138,7011,7127
33,Asturias,36,Llanes,13572,6628,6944
33,Asturias,37,Mieres,41730,19767,21963
33,Asturias,38,Morcín,2820,1404,1416
33,Asturias,39,Muros de Nalón,1890,901,989
33,Asturias,40,Nava,5511,2700,2811
33,Asturias,41,Navia,8845,4298,4547
33,Asturias,42,Noreña,5435,2638,2797
33,Asturias,43,Onís,784,413,371
33,Asturias,44,Oviedo,225089,104902,120187
33,Asturias,45,Parres,5615,2754,2861
33,Asturias,46,Peñamellera Alta,563,282,281
33,Asturias,47,Peñamellera Baja,1331,662,669
33,Asturias,48,Pesoz,183,89,94
33,Asturias,49,Piloña,7650,3773,3877
33,Asturias,50,Ponga,679,402,277
33,Asturias,51,Pravia,8919,4337,4582
33,Asturias,52,Proaza,794,450,344
33,Asturias,53,Quirós,1291,720,571
33,Asturias,54,"Regueras, Las",1931,976,955
33,Asturias,55,Ribadedeva,1888,912,976
33,Asturias,56,Ribadesella,6097,2921,3176
33,Asturias,57,Ribera de Arriba,1943,985,958
33,Asturias,58,Riosa,2137,1087,1050
33,Asturias,59,Salas,5578,2764,2814
33,Asturias,61,San Martín de Oscos,472,237,235
33,Asturias,60,San Martín del Rey Aurelio,17770,8567,9203
33,Asturias,63,San Tirso de Abres,515,250,265
33,Asturias,62,Santa Eulalia de Oscos,500,261,239
33,Asturias,64,Santo Adriano,260,129,131
33,Asturias,65,Sariego,1303,625,678
33,Asturias,66,Siero,52301,25528,26773
33,Asturias,67,Sobrescobio,877,467,410
33,Asturias,68,Somiedo,1314,762,552
33,Asturias,69,Soto del Barco,4052,1991,2061
33,Asturias,70,Tapia de Casariego,3971,1923,2048
33,Asturias,71,Taramundi,737,355,382
33,Asturias,72,Teverga,1853,971,882
33,Asturias,73,Tineo,10344,5196,5148
33,Asturias,34,Valdés,12871,6309,6562
33,Asturias,74,Vegadeo,4045,1960,2085
33,Asturias,75,Villanueva de Oscos,330,158,172
33,Asturias,76,Villaviciosa,14971,7387,7584
33,Asturias,77,Villayón,1430,730,700
33,Asturias,78,Yernes y Tameza,168,93,75
05,Ávila,1,Adanero,216,115,101
05,Ávila,2,"Adrada, La",2705,1422,1283
05,Ávila,5,Albornos,205,108,97
05,Ávila,7,Aldeanueva de Santa Cruz,135,76,59
05,Ávila,8,Aldeaseca,253,120,133
05,Ávila,10,"Aldehuela, La",186,95,91
05,Ávila,12,Amavida,156,79,77
05,Ávila,13,"Arenal, El",1022,522,500
05,Ávila,14,Arenas de San Pedro,6795,3313,3482
05,Ávila,15,Arevalillo,92,46,46
05,Ávila,16,Arévalo,8203,4004,4199
05,Ávila,17,Aveinte,86,46,40
05,Ávila,18,Avellaneda,31,17,14
05,Ávila,19,Ávila,59258,28484,30774
05,Ávila,21,"Barco de Ávila, El",2653,1303,1350
05,Ávila,22,"Barraco, El",2033,1042,991
05,Ávila,23,Barromán,197,107,90
05,Ávila,24,Becedas,250,133,117
05,Ávila,25,Becedillas,114,64,50
05,Ávila,26,Bercial de Zapardiel,224,113,111
05,Ávila,27,"Berlanas, Las",348,176,172
05,Ávila,29,Bernuy-Zapardiel,136,80,56
05,Ávila,30,Berrocalejo de Aragona,44,22,22
05,Ávila,33,Blascomillán,202,106,96
05,Ávila,34,Blasconuño de Matacabras,15,10,5
05,Ávila,35,Blascosancho,106,50,56
05,Ávila,36,"Bohodón, El",133,72,61
05,Ávila,37,Bohoyo,329,177,152
05,Ávila,38,Bonilla de la Sierra,122,73,49
05,Ávila,39,Brabos,48,29,19
05,Ávila,40,Bularros,74,46,28
05,Ávila,41,Burgohondo,1255,661,594
05,Ávila,42,Cabezas de Alambre,173,88,85
05,Ávila,43,Cabezas del Pozo,77,42,35
05,Ávila,44,Cabezas del Villar,288,167,121
05,Ávila,45,Cabizuela,104,51,53
05,Ávila,46,Canales,47,23,24
05,Ávila,47,Candeleda,5177,2633,2544
05,Ávila,48,Cantiveros,138,71,67
05,Ávila,49,Cardeñosa,482,256,226
05,Ávila,51,"Carrera, La",205,110,95
05,Ávila,52,Casas del Puerto,104,57,47
05,Ávila,53,Casasola,81,42,39
05,Ávila,54,Casavieja,1560,794,766
05,Ávila,55,Casillas,752,399,353
05,Ávila,56,Castellanos de Zapardiel,102,52,50
05,Ávila,57,Cebreros,3370,1725,1645
05,Ávila,58,Cepeda la Mora,88,47,41
05,Ávila,67,Chamartín,76,45,31
05,Ávila,59,Cillán,108,64,44
05,Ávila,60,Cisla,126,63,63
05,Ávila,61,"Colilla, La",343,174,169
05,Ávila,62,Collado de Contreras,210,111,99
05,Ávila,63,Collado del Mirón,38,24,14
05,Ávila,64,Constanzana,123,73,50
05,Ávila,65,Crespos,528,286,242
05,Ávila,66,Cuevas del Valle,541,297,244
05,Ávila,903,Diego del Carpio,166,92,74
05,Ávila,69,Donjimeno,92,57,35
05,Ávila,70,Donvidas,43,23,20
05,Ávila,72,Espinosa de los Caballeros,99,54,45
05,Ávila,73,Flores de Ávila,342,189,153
05,Ávila,74,Fontiveros,821,434,387
05,Ávila,75,Fresnedilla,110,50,60
05,Ávila,76,"Fresno, El",593,301,292
05,Ávila,77,Fuente el Saúz,196,108,88
05,Ávila,78,Fuentes de Año,130,73,57
05,Ávila,79,Gallegos de Altamiros,71,44,27
05,Ávila,80,Gallegos de Sobrinos,66,30,36
05,Ávila,81,Garganta del Villar,41,27,14
05,Ávila,82,Gavilanes,653,345,308
05,Ávila,83,Gemuño,146,78,68
05,Ávila,85,Gil García,38,20,18
05,Ávila,84,Gilbuena,80,50,30
05,Ávila,86,Gimialcón,90,54,36
05,Ávila,87,Gotarrendura,159,56,103
05,Ávila,88,Grandes y San Martín,28,14,14
05,Ávila,89,Guisando,564,282,282
05,Ávila,90,Gutierre-Muñoz,79,41,38
05,Ávila,92,Hernansancho,187,104,83
05,Ávila,93,Herradón de Pinares,498,280,218
05,Ávila,94,Herreros de Suso,154,81,73
05,Ávila,95,Higuera de las Dueñas,330,183,147
05,Ávila,96,"Hija de Dios, La",86,45,41
05,Ávila,97,"Horcajada, La",541,276,265
05,Ávila,99,Horcajo de las Torres,585,329,256
05,Ávila,100,"Hornillo, El",326,172,154
05,Ávila,102,"Hoyo de Pinares, El",2418,1262,1156
05,Ávila,101,Hoyocasero,292,166,126
05,Ávila,103,Hoyorredondo,79,43,36
05,Ávila,106,Hoyos de Miguel Muñoz,39,19,20
05,Ávila,104,Hoyos del Collado,34,20,14
05,Ávila,105,Hoyos del Espino,397,212,185
05,Ávila,107,Hurtumpascual,66,41,25
05,Ávila,108,Junciana,58,29,29
05,Ávila,109,Langa,531,271,260
05,Ávila,110,Lanzahíta,938,504,434
05,Ávila,113,"Llanos de Tormes, Los",93,43,50
05,Ávila,112,"Losar del Barco, El",134,68,66
05,Ávila,114,Madrigal de las Altas Torres,1573,805,768
05,Ávila,115,Maello,715,369,346
05,Ávila,116,Malpartida de Corneja,132,69,63
05,Ávila,117,Mamblas,224,122,102
05,Ávila,118,Mancera de Arriba,98,56,42
05,Ávila,119,Manjabálago,37,22,15
05,Ávila,120,Marlín,35,21,14
05,Ávila,121,Martiherrero,301,157,144
05,Ávila,122,Martínez,147,79,68
05,Ávila,123,Mediana de Voltoya,105,53,52
05,Ávila,124,Medinilla,122,59,63
05,Ávila,125,Mengamuñoz,64,32,32
05,Ávila,126,Mesegar de Corneja,78,43,35
05,Ávila,127,Mijares,783,413,370
05,Ávila,128,Mingorría,414,213,201
05,Ávila,129,"Mirón, El",148,88,60
05,Ávila,130,Mironcillo,101,54,47
05,Ávila,131,Mirueña de los Infanzones,106,54,52
05,Ávila,132,Mombeltrán,1152,602,550
05,Ávila,133,Monsalupe,61,32,29
05,Ávila,134,Moraleja de Matacabras,53,32,21
05,Ávila,135,Muñana,429,225,204
05,Ávila,136,Muñico,113,60,53
05,Ávila,138,Muñogalindo,412,218,194
05,Ávila,139,Muñogrande,68,41,27
05,Ávila,140,Muñomer del Peco,134,68,66
05,Ávila,141,Muñopepe,104,63,41
05,Ávila,142,Muñosancho,118,60,58
05,Ávila,143,Muñotello,65,34,31
05,Ávila,144,Narrillos del Álamo,93,49,44
05,Ávila,145,Narrillos del Rebollar,53,27,26
05,Ávila,149,Narros de Saldueña,123,69,54
05,Ávila,147,Narros del Castillo,186,103,83
05,Ávila,148,Narros del Puerto,31,14,17
05,Ávila,152,Nava de Arévalo,830,441,389
05,Ávila,153,Nava del Barco,105,55,50
05,Ávila,151,Navacepedilla de Corneja,114,61,53
05,Ávila,154,Navadijos,44,30,14
05,Ávila,155,Navaescurial,58,35,23
05,Ávila,156,Navahondilla,340,196,144
05,Ávila,157,Navalacruz,261,131,130
05,Ávila,158,Navalmoral,364,190,174
05,Ávila,159,Navalonguilla,275,146,129
05,Ávila,160,Navalosa,348,193,155
05,Ávila,161,Navalperal de Pinares,959,495,464
05,Ávila,162,Navalperal de Tormes,104,56,48
05,Ávila,163,Navaluenga,2076,1024,1052
05,Ávila,164,Navaquesera,33,14,19
05,Ávila,165,Navarredonda de Gredos,467,242,225
05,Ávila,166,Navarredondilla,246,123,123
05,Ávila,167,Navarrevisca,295,161,134
05,Ávila,168,"Navas del Marqués, Las",5608,2850,2758
05,Ávila,169,Navatalgordo,234,120,114
05,Ávila,170,Navatejares,55,25,30
05,Ávila,171,Neila de San Miguel,79,39,40
05,Ávila,172,Niharra,161,88,73
05,Ávila,173,Ojos-Albos,58,35,23
05,Ávila,174,Orbita,84,43,41
05,Ávila,175,"Oso, El",202,116,86
05,Ávila,176,Padiernos,286,150,136
05,Ávila,177,Pajares de Adaja,185,93,92
05,Ávila,178,Palacios de Goda,445,233,212
05,Ávila,179,Papatrigo,261,132,129
05,Ávila,180,"Parral, El",88,46,42
05,Ávila,181,Pascualcobo,38,22,16
05,Ávila,182,Pedro Bernardo,938,511,427
05,Ávila,183,Pedro-Rodríguez,177,92,85
05,Ávila,184,Peguerinos,331,192,139
05,Ávila,185,Peñalba de Ávila,117,65,52
05,Ávila,186,Piedrahíta,1965,942,1023
05,Ávila,187,Piedralaves,2300,1172,1128
05,Ávila,188,Poveda,58,35,23
05,Ávila,189,Poyales del Hoyo,579,314,265
05,Ávila,190,Pozanco,58,37,21
05,Ávila,191,Pradosegar,122,63,59
05,Ávila,192,Puerto Castilla,109,68,41
05,Ávila,193,Rasueros,222,127,95
05,Ávila,194,Riocabado,164,89,75
05,Ávila,195,Riofrío,225,130,95
05,Ávila,196,Rivilla de Barajas,70,32,38
05,Ávila,197,Salobral,126,63,63
05,Ávila,198,Salvadiós,83,44,39
05,Ávila,199,San Bartolomé de Béjar,48,25,23
05,Ávila,200,San Bartolomé de Corneja,60,29,31
05,Ávila,201,San Bartolomé de Pinares,613,318,295
05,Ávila,206,San Esteban de los Patos,36,18,18
05,Ávila,208,San Esteban de Zapardiel,47,24,23
05,Ávila,207,San Esteban del Valle,811,426,385
05,Ávila,209,San García de Ingelmos,93,55,38
05,Ávila,901,San Juan de Gredos,291,156,135
05,Ávila,210,San Juan de la Encinilla,97,51,46
05,Ávila,211,San Juan de la Nava,535,274,261
05,Ávila,212,San Juan del Molinillo,254,147,107
05,Ávila,213,San Juan del Olmo,124,74,50
05,Ávila,214,San Lorenzo de Tormes,45,24,21
05,Ávila,215,San Martín de la Vega del Alberche,195,116,79
05,Ávila,216,San Martín del Pimpollar,184,106,78
05,Ávila,217,San Miguel de Corneja,70,38,32
05,Ávila,218,San Miguel de Serrezuela,134,73,61
05,Ávila,219,San Pascual,50,32,18
05,Ávila,220,San Pedro del Arroyo,464,238,226
05,Ávila,231,San Vicente de Arévalo,213,113,100
05,Ávila,204,Sanchidrián,818,421,397
05,Ávila,205,Sanchorreja,86,43,43
05,Ávila,222,Santa Cruz de Pinares,140,77,63
05,Ávila,221,Santa Cruz del Valle,421,217,204
05,Ávila,226,Santa María de los Caballeros,80,46,34
05,Ávila,224,Santa María del Arroyo,105,54,51
05,Ávila,225,Santa María del Berrocal,438,229,209
05,Ávila,902,Santa María del Cubillo,340,195,145
05,Ávila,227,Santa María del Tiétar,553,291,262
05,Ávila,228,Santiago del Collado,186,115,71
05,Ávila,904,Santiago del Tormes,165,94,71
05,Ávila,229,Santo Domingo de las Posadas,82,42,40
05,Ávila,230,Santo Tomé de Zabarcos,99,55,44
05,Ávila,232,"Serrada, La",96,50,46
05,Ávila,233,Serranillos,273,151,122
05,Ávila,234,Sigeres,51,24,27
05,Ávila,235,Sinlabajos,144,73,71
05,Ávila,236,Solana de Ávila,144,76,68
05,Ávila,237,Solana de Rioalmar,197,106,91
05,Ávila,238,Solosancho,936,496,440
05,Ávila,239,Sotalbo,229,126,103
05,Ávila,240,Sotillo de la Adrada,4830,2419,2411
05,Ávila,241,"Tiemblo, El",4257,2153,2104
05,Ávila,242,Tiñosillos,812,414,398
05,Ávila,243,Tolbaños,105,55,50
05,Ávila,244,Tormellas,63,35,28
05,Ávila,245,Tornadizos de Ávila,370,178,192
05,Ávila,247,"Torre, La",288,155,133
05,Ávila,246,Tórtoles,71,37,34
05,Ávila,249,Umbrías,119,59,60
05,Ávila,251,Vadillo de la Sierra,76,46,30
05,Ávila,252,Valdecasa,65,39,26
05,Ávila,253,Vega de Santa María,86,44,42
05,Ávila,254,Velayos,254,129,125
05,Ávila,256,Villaflor,128,64,64
05,Ávila,257,Villafranca de la Sierra,142,78,64
05,Ávila,905,Villanueva de Ávila,232,118,114
05,Ávila,258,Villanueva de Gómez,138,74,64
05,Ávila,259,Villanueva del Aceral,145,71,74
05,Ávila,260,Villanueva del Campillo,100,58,42
05,Ávila,261,Villar de Corneja,55,28,27
05,Ávila,262,Villarejo del Valle,408,212,196
05,Ávila,263,Villatoro,188,106,82
05,Ávila,264,Viñegra de Moraña,55,31,24
05,Ávila,265,Vita,79,47,32
05,Ávila,266,Zapardiel de la Cañada,110,54,56
05,Ávila,267,Zapardiel de la Ribera,117,61,56
06,Badajoz,1,Acedera,826,414,412
06,Badajoz,2,Aceuchal,5566,2772,2794
06,Badajoz,3,Ahillones,989,494,495
06,Badajoz,4,Alange,1952,993,959
06,Badajoz,5,"Albuera, La",2069,1057,1012
06,Badajoz,6,Alburquerque,5544,2806,2738
06,Badajoz,7,Alconchel,1866,940,926
06,Badajoz,8,Alconera,746,364,382
06,Badajoz,9,Aljucén,245,136,109
06,Badajoz,10,Almendral,1319,644,675
06,Badajoz,11,Almendralejo,35101,17660,17441
06,Badajoz,12,Arroyo de San Serván,4258,2177,2081
06,Badajoz,13,Atalaya,312,158,154
06,Badajoz,14,Azuaga,7959,3975,3984
06,Badajoz,15,Badajoz,150621,73329,77292
06,Badajoz,16,Barcarrota,3683,1887,1796
06,Badajoz,17,Baterno,326,177,149
06,Badajoz,18,Benquerencia de la Serena,904,442,462
06,Badajoz,19,Berlanga,2458,1224,1234
06,Badajoz,20,Bienvenida,2247,1164,1083
06,Badajoz,21,Bodonal de la Sierra,1098,561,537
06,Badajoz,22,Burguillos del Cerro,3280,1627,1653
06,Badajoz,23,Cabeza del Buey,5354,2650,2704
06,Badajoz,24,Cabeza la Vaca,1417,723,694
06,Badajoz,25,Calamonte,6360,3156,3204
06,Badajoz,26,Calera de León,1009,510,499
06,Badajoz,27,Calzadilla de los Barros,858,440,418
06,Badajoz,28,Campanario,5202,2548,2654
06,Badajoz,29,Campillo de Llerena,1427,724,703
06,Badajoz,30,Capilla,180,91,89
06,Badajoz,31,Carmonita,557,275,282
06,Badajoz,32,"Carrascalejo, El",79,42,37
06,Badajoz,33,Casas de Don Pedro,1598,812,786
06,Badajoz,34,Casas de Reina,193,91,102
06,Badajoz,35,Castilblanco,1135,567,568
06,Badajoz,36,Castuera,6324,3124,3200
06,Badajoz,42,Cheles,1219,580,639
06,Badajoz,37,"Codosera, La",2284,1188,1096
06,Badajoz,38,Cordobilla de Lácara,974,494,480
06,Badajoz,39,"Coronada, La",2208,1086,1122
06,Badajoz,40,Corte de Peleas,1301,660,641
06,Badajoz,41,Cristina,566,294,272
06,Badajoz,43,Don Álvaro,750,383,367
06,Badajoz,44,Don Benito,37149,18403,18746
06,Badajoz,45,Entrín Bajo,573,290,283
06,Badajoz,46,Esparragalejo,1513,734,779
06,Badajoz,47,Esparragosa de la Serena,1049,536,513
06,Badajoz,48,Esparragosa de Lares,997,489,508
06,Badajoz,49,Feria,1268,616,652
06,Badajoz,50,Fregenal de la Sierra,5078,2478,2600
06,Badajoz,51,Fuenlabrada de los Montes,1941,946,995
06,Badajoz,52,Fuente de Cantos,5021,2472,2549
06,Badajoz,53,Fuente del Arco,734,372,362
06,Badajoz,54,Fuente del Maestre,6952,3443,3509
06,Badajoz,55,Fuentes de León,2449,1204,1245
06,Badajoz,56,Garbayuela,551,291,260
06,Badajoz,57,Garlitos,643,334,309
06,Badajoz,58,"Garrovilla, La",2393,1202,1191
06,Badajoz,59,Granja de Torrehermosa,2240,1129,1111
06,Badajoz,903,Guadiana del Caudillo,2501,1233,1268
06,Badajoz,60,Guareña,7274,3667,3607
06,Badajoz,61,"Haba, La",1307,662,645
06,Badajoz,62,Helechosa de los Montes,707,396,311
06,Badajoz,63,Herrera del Duque,3691,1889,1802
06,Badajoz,64,Higuera de la Serena,1020,535,485
06,Badajoz,65,Higuera de Llerena,351,176,175
06,Badajoz,66,Higuera de Vargas,2057,1037,1020
06,Badajoz,67,Higuera la Real,2413,1234,1179
06,Badajoz,68,Hinojosa del Valle,519,260,259
06,Badajoz,69,Hornachos,3804,1904,1900
06,Badajoz,70,Jerez de los Caballeros,9719,4837,4882
06,Badajoz,71,"Lapa, La",285,143,142
06,Badajoz,73,Llera,904,471,433
06,Badajoz,74,Llerena,5976,2974,3002
06,Badajoz,72,Lobón,2866,1488,1378
06,Badajoz,75,Magacela,561,293,268
06,Badajoz,76,Maguilla,1009,499,510
06,Badajoz,77,Malcocinado,413,226,187
06,Badajoz,78,Malpartida de la Serena,605,304,301
06,Badajoz,79,Manchita,748,387,361
06,Badajoz,80,Medellín,2342,1168,1174
06,Badajoz,81,Medina de las Torres,1290,658,632
06,Badajoz,82,Mengabril,474,246,228
06,Badajoz,83,Mérida,59049,28870,30179
06,Badajoz,84,Mirandilla,1346,682,664
06,Badajoz,85,Monesterio,4361,2213,2148
06,Badajoz,86,Montemolín,1469,714,755
06,Badajoz,87,Monterrubio de la Serena,2593,1261,1332
06,Badajoz,88,Montijo,16121,8001,8120
06,Badajoz,89,"Morera, La",741,369,372
06,Badajoz,90,"Nava de Santiago, La",1029,513,516
06,Badajoz,91,Navalvillar de Pela,4769,2400,2369
06,Badajoz,92,Nogales,690,348,342
06,Badajoz,93,Oliva de la Frontera,5482,2762,2720
06,Badajoz,94,Oliva de Mérida,1802,921,881
06,Badajoz,95,Olivenza,12043,6017,6026
06,Badajoz,96,Orellana de la Sierra,265,143,122
06,Badajoz,97,Orellana la Vieja,2930,1520,1410
06,Badajoz,98,Palomas,709,350,359
06,Badajoz,99,"Parra, La",1379,706,673
06,Badajoz,100,Peñalsordo,1104,541,563
06,Badajoz,101,Peraleda del Zaucejo,587,301,286
06,Badajoz,102,Puebla de Alcocer,1240,612,628
06,Badajoz,103,Puebla de la Calzada,6002,2974,3028
06,Badajoz,104,Puebla de la Reina,817,404,413
06,Badajoz,107,Puebla de Obando,1930,971,959
06,Badajoz,108,Puebla de Sancho Pérez,2842,1437,1405
06,Badajoz,105,Puebla del Maestre,769,391,378
06,Badajoz,106,Puebla del Prior,519,262,257
06,Badajoz,902,Pueblonuevo del Guadiana,2059,1039,1020
06,Badajoz,109,Quintana de la Serena,4928,2490,2438
06,Badajoz,110,Reina,182,88,94
06,Badajoz,111,Rena,669,349,320
06,Badajoz,112,Retamal de Llerena,492,257,235
06,Badajoz,113,Ribera del Fresno,3483,1737,1746
06,Badajoz,114,Risco,146,71,75
06,Badajoz,115,"Roca de la Sierra, La",1489,728,761
06,Badajoz,116,Salvaleón,1958,969,989
06,Badajoz,117,Salvatierra de los Barros,1751,867,884
06,Badajoz,119,San Pedro de Mérida,878,440,438
06,Badajoz,123,San Vicente de Alcántara,5752,2886,2866
06,Badajoz,118,Sancti-Spíritus,228,122,106
06,Badajoz,120,Santa Amalia,4267,2163,2104
06,Badajoz,121,Santa Marta,4289,2170,2119
06,Badajoz,122,"Santos de Maimona, Los",8231,4192,4039
06,Badajoz,124,Segura de León,2055,1020,1035
06,Badajoz,125,Siruela,2079,1038,1041
06,Badajoz,126,Solana de los Barros,2758,1385,1373
06,Badajoz,127,Talarrubias,3625,1821,1804
06,Badajoz,128,Talavera la Real,5548,2807,2741
06,Badajoz,129,Táliga,743,373,370
06,Badajoz,130,Tamurejo,246,123,123
06,Badajoz,131,Torre de Miguel Sesmero,1268,638,630
06,Badajoz,132,Torremayor,1039,491,548
06,Badajoz,133,Torremejía,2258,1162,1096
06,Badajoz,134,Trasierra,666,356,310
06,Badajoz,135,Trujillanos,1456,776,680
06,Badajoz,136,Usagre,1891,943,948
06,Badajoz,137,Valdecaballeros,1175,599,576
06,Badajoz,901,Valdelacalzada,2851,1478,1373
06,Badajoz,138,Valdetorres,1255,635,620
06,Badajoz,139,Valencia de las Torres,672,362,310
06,Badajoz,140,Valencia del Mombuey,781,388,393
06,Badajoz,141,Valencia del Ventoso,2166,1080,1086
06,Badajoz,146,Valle de la Serena,1369,684,685
06,Badajoz,147,Valle de Matamoros,413,206,207
06,Badajoz,148,Valle de Santa Ana,1174,582,592
06,Badajoz,142,Valverde de Burguillos,311,163,148
06,Badajoz,143,Valverde de Leganés,4230,2124,2106
06,Badajoz,144,Valverde de Llerena,673,333,340
06,Badajoz,145,Valverde de Mérida,1132,580,552
06,Badajoz,149,Villafranca de los Barros,13378,6582,6796
06,Badajoz,150,Villagarcía de la Torre,984,518,466
06,Badajoz,151,Villagonzalo,1302,634,668
06,Badajoz,152,Villalba de los Barros,1601,814,787
06,Badajoz,153,Villanueva de la Serena,26157,12808,13349
06,Badajoz,154,Villanueva del Fresno,3579,1773,1806
06,Badajoz,156,Villar de Rena,1422,743,679
06,Badajoz,155,Villar del Rey,2319,1224,1095
06,Badajoz,157,Villarta de los Montes,542,270,272
06,Badajoz,158,Zafra,16762,8102,8660
06,Badajoz,159,Zahínos,2864,1420,1444
06,Badajoz,160,Zalamea de la Serena,3853,1921,1932
06,Badajoz,162,"Zarza, La",3622,1847,1775
06,Badajoz,161,Zarza-Capilla,369,177,192
07,"Balears, Illes",2,Alaior,9769,4892,4877
07,"Balears, Illes",1,Alaró,5217,2589,2628
07,"Balears, Illes",3,Alcúdia,20163,10241,9922
07,"Balears, Illes",4,Algaida,5382,2777,2605
07,"Balears, Illes",5,Andratx,10748,5416,5332
07,"Balears, Illes",901,Ariany,914,476,438
07,"Balears, Illes",6,Artà,7415,3691,3724
07,"Balears, Illes",7,Banyalbufar,583,326,257
07,"Balears, Illes",8,Binissalem,7792,3846,3946
07,"Balears, Illes",9,Búger,1029,521,508
07,"Balears, Illes",10,Bunyola,6619,3281,3338
07,"Balears, Illes",11,Calvià,52272,26268,26004
07,"Balears, Illes",12,Campanet,2581,1257,1324
07,"Balears, Illes",13,Campos,10144,5117,5027
07,"Balears, Illes",14,Capdepera,11247,5689,5558
07,"Balears, Illes",64,"Castell, Es",7956,4044,3912
07,"Balears, Illes",15,Ciutadella de Menorca,29629,14788,14841
07,"Balears, Illes",16,Consell,3834,1956,1878
07,"Balears, Illes",17,Costitx,1192,595,597
07,"Balears, Illes",18,Deyá,756,383,373
07,"Balears, Illes",26,Eivissa,50401,25692,24709
07,"Balears, Illes",19,Escorca,252,145,107
07,"Balears, Illes",20,Esporles,4991,2482,2509
07,"Balears, Illes",21,Estellencs,369,194,175
07,"Balears, Illes",22,Felanitx,17359,8785,8574
07,"Balears, Illes",23,Ferreries,4610,2339,2271
07,"Balears, Illes",24,Formentera,11374,5927,5447
07,"Balears, Illes",25,Fornalutx,692,352,340
07,"Balears, Illes",27,Inca,31032,15668,15364
07,"Balears, Illes",28,Lloret de Vistalegre,1251,627,624
07,"Balears, Illes",29,Lloseta,5680,2846,2834
07,"Balears, Illes",30,Llubí,2324,1155,1169
07,"Balears, Illes",31,Llucmajor,37257,18839,18418
07,"Balears, Illes",33,Manacor,41049,20519,20530
07,"Balears, Illes",34,Mancor de la Vall,1321,659,662
07,"Balears, Illes",32,Maó,28765,14102,14663
07,"Balears, Illes",35,Maria de la Salut,2140,1094,1046
07,"Balears, Illes",36,Marratxí,35258,17744,17514
07,"Balears, Illes",37,"Mercadal, Es",5425,2766,2659
07,"Balears, Illes",902,"Migjorn Gran, Es",1520,750,770
07,"Balears, Illes",38,Montuïri,2838,1443,1395
07,"Balears, Illes",39,Muro,6977,3522,3455
07,"Balears, Illes",40,Palma de Mallorca,398162,194123,204039
07,"Balears, Illes",41,Petra,2806,1370,1436
07,"Balears, Illes",44,"Pobla, Sa",12901,6586,6315
07,"Balears, Illes",42,Pollença,16200,8063,8137
07,"Balears, Illes",43,Porreres,5496,2830,2666
07,"Balears, Illes",45,Puigpunyent,2010,997,1013
07,"Balears, Illes",59,"Salines, Ses",5273,2665,2608
07,"Balears, Illes",46,Sant Antoni de Portmany,23314,12133,11181
07,"Balears, Illes",49,Sant Joan,1973,971,1002
07,"Balears, Illes",50,Sant Joan de Labritja,5677,2941,2736
07,"Balears, Illes",48,Sant Josep de sa Talaia,24498,12841,11657
07,"Balears, Illes",51,Sant Llorenç des Cardassar,7857,3901,3956
07,"Balears, Illes",52,Sant Lluís,7509,3793,3716
07,"Balears, Illes",53,Santa Eugènia,1723,869,854
07,"Balears, Illes",54,Santa Eulalia del Río,36464,18626,17838
07,"Balears, Illes",55,Santa Margalida,12243,6248,5995
07,"Balears, Illes",56,Santa María del Camí,6500,3239,3261
07,"Balears, Illes",57,Santanyí,11784,5961,5823
07,"Balears, Illes",58,Selva,3869,1951,1918
07,"Balears, Illes",47,Sencelles,3234,1631,1603
07,"Balears, Illes",60,Sineu,3715,1845,1870
07,"Balears, Illes",61,Sóller,14229,7139,7090
07,"Balears, Illes",62,Son Servera,11146,5584,5562
07,"Balears, Illes",63,Valldemossa,2042,1045,997
07,"Balears, Illes",65,Vilafranca de Bonany,2922,1448,1474
08,Barcelona,1,Abrera,12055,6152,5903
08,Barcelona,2,Aguilar de Segarra,242,128,114
08,Barcelona,14,Aiguafreda,2502,1209,1293
08,Barcelona,3,Alella,9690,4736,4954
08,Barcelona,4,Alpens,304,167,137
08,Barcelona,5,"Ametlla del Vallès, L'",8227,4129,4098
08,Barcelona,6,Arenys de Mar,15224,7457,7767
08,Barcelona,7,Arenys de Munt,8588,4357,4231
08,Barcelona,8,Argençola,215,117,98
08,Barcelona,9,Argentona,11920,5860,6060
08,Barcelona,10,Artés,5607,2813,2794
08,Barcelona,11,Avià,2289,1140,1149
08,Barcelona,12,Avinyó,2316,1161,1155
08,Barcelona,13,Avinyonet del Penedès,1705,903,802
08,Barcelona,15,Badalona,219708,109305,110403
08,Barcelona,904,Badia del Vallès,13531,6586,6945
08,Barcelona,16,Bagà,2299,1146,1153
08,Barcelona,17,Balenyà,3728,1874,1854
08,Barcelona,18,Balsareny,3474,1747,1727
08,Barcelona,252,Barberà del Vallès,32580,16153,16427
08,Barcelona,19,Barcelona,1611822,763701,848121
08,Barcelona,20,Begues,6590,3274,3316
08,Barcelona,21,Bellprat,89,52,37
08,Barcelona,22,Berga,16609,8174,8435
08,Barcelona,23,Bigues i Riells,8747,4472,4275
08,Barcelona,24,Borredà,580,315,265
08,Barcelona,25,"Bruc, El",2027,1083,944
08,Barcelona,26,"Brull, El",266,142,124
08,Barcelona,27,"Cabanyes, Les",969,497,472
08,Barcelona,28,Cabrera d'Anoia,1338,706,632
08,Barcelona,29,Cabrera de Mar,4529,2272,2257
08,Barcelona,30,Cabrils,7181,3529,3652
08,Barcelona,31,Calaf,3504,1821,1683
08,Barcelona,34,Calders,953,487,466
08,Barcelona,33,Caldes de Montbui,17156,8562,8594
08,Barcelona,32,Caldes d'Estrac,2760,1313,1447
08,Barcelona,35,Calella,18469,9092,9377
08,Barcelona,37,Calldetenes,2479,1266,1213
08,Barcelona,38,Callús,1896,934,962
08,Barcelona,36,Calonge de Segarra,203,102,101
08,Barcelona,39,Campins,544,276,268
08,Barcelona,40,Canet de Mar,14124,6893,7231
08,Barcelona,41,Canovelles,16009,8300,7709
08,Barcelona,42,Cànoves i Samalús,2877,1473,1404
08,Barcelona,43,Canyelles,4319,2200,2119
08,Barcelona,44,Capellades,5374,2682,2692
08,Barcelona,45,Capolat,87,36,51
08,Barcelona,46,Cardedeu,17533,8645,8888
08,Barcelona,47,Cardona,5006,2458,2548
08,Barcelona,48,Carme,831,437,394
08,Barcelona,49,Casserres,1594,792,802
08,Barcelona,57,Castell de l'Areny,72,42,30
08,Barcelona,52,Castellar de n'Hug,166,92,74
08,Barcelona,50,Castellar del Riu,170,95,75
08,Barcelona,51,Castellar del Vallès,23455,11556,11899
08,Barcelona,53,Castellbell i el Vilar,3643,1862,1781
08,Barcelona,54,Castellbisbal,12369,6324,6045
08,Barcelona,55,Castellcir,704,358,346
08,Barcelona,56,Castelldefels,63077,31251,31826
08,Barcelona,58,Castellet i la Gornal,2261,1133,1128
08,Barcelona,60,Castellfollit de Riubregós,183,100,83
08,Barcelona,59,Castellfollit del Boix,424,214,210
08,Barcelona,61,Castellgalí,2023,1049,974
08,Barcelona,62,Castellnou de Bages,1216,613,603
08,Barcelona,63,Castellolí,556,269,287
08,Barcelona,64,Castellterçol,2402,1186,1216
08,Barcelona,65,Castellví de la Marca,1619,817,802
08,Barcelona,66,Castellví de Rosanes,1746,860,886
08,Barcelona,67,Centelles,7346,3601,3745
08,Barcelona,268,Cercs,1272,642,630
08,Barcelona,266,Cerdanyola del Vallès,57642,28331,29311
08,Barcelona,68,Cervelló,8721,4367,4354
08,Barcelona,69,Collbató,4367,2249,2118
08,Barcelona,70,Collsuspina,338,181,157
08,Barcelona,71,Copons,325,160,165
08,Barcelona,72,Corbera de Llobregat,14315,7129,7186
08,Barcelona,73,Cornellà de Llobregat,86687,42472,44215
08,Barcelona,74,Cubelles,14528,7341,7187
08,Barcelona,75,Dosrius,5185,2632,2553
08,Barcelona,76,Esparreguera,21926,11136,10790
08,Barcelona,77,Esplugues de Llobregat,46667,22590,24077
08,Barcelona,78,"Espunyola, L'",265,134,131
08,Barcelona,79,"Estany, L'",411,203,208
08,Barcelona,134,Figaró-Montmany,1110,563,547
08,Barcelona,80,Fígols,45,24,21
08,Barcelona,82,Fogars de la Selva,1484,777,707
08,Barcelona,81,Fogars de Montclús,473,252,221
08,Barcelona,83,Folgueroles,2249,1135,1114
08,Barcelona,84,Fonollosa,1446,747,699
08,Barcelona,85,Font-rubí,1415,729,686
08,Barcelona,86,"Franqueses del Vallès, Les",19074,9734,9340
08,Barcelona,90,Gaià,159,89,70
08,Barcelona,87,Gallifa,200,105,95
08,Barcelona,88,"Garriga, La",15586,7551,8035
08,Barcelona,89,Gavà,46377,22904,23473
08,Barcelona,91,Gelida,7123,3552,3571
08,Barcelona,92,Gironella,4940,2428,2512
08,Barcelona,93,Gisclareny,29,17,12
08,Barcelona,94,"Granada, La",2055,1041,1014
08,Barcelona,95,Granera,76,50,26
08,Barcelona,96,Granollers,59753,29588,30165
08,Barcelona,97,Gualba,1394,707,687
08,Barcelona,99,Guardiola de Berguedà,978,529,449
08,Barcelona,100,Gurb,2570,1338,1232
08,Barcelona,101,"Hospitalet de Llobregat, L'",254056,123674,130382
08,Barcelona,162,"Hostalets de Pierola, Els",2935,1513,1422
08,Barcelona,102,Igualada,38978,19112,19866
08,Barcelona,103,Jorba,849,424,425
08,Barcelona,104,"Llacuna, La",934,503,431
08,Barcelona,105,"Llagosta, La",13447,6668,6779
08,Barcelona,107,Lliçà d'Amunt,14659,7459,7200
08,Barcelona,108,Lliçà de Vall,6426,3261,3165
08,Barcelona,106,Llinars del Vallès,9554,4726,4828
08,Barcelona,109,Lluçà,242,120,122
08,Barcelona,110,Malgrat de Mar,18429,9265,9164
08,Barcelona,111,Malla,262,130,132
08,Barcelona,112,Manlleu,20435,10195,10240
08,Barcelona,113,Manresa,76170,37289,38881
08,Barcelona,242,Marganell,309,148,161
08,Barcelona,114,Martorell,28108,14523,13585
08,Barcelona,115,Martorelles,4882,2440,2442
08,Barcelona,116,"Masies de Roda, Les",744,361,383
08,Barcelona,117,"Masies de Voltregà, Les",3171,1559,1612
08,Barcelona,118,"Masnou, El",22595,10848,11747
08,Barcelona,119,Masquefa,8429,4275,4154
08,Barcelona,120,Matadepera,8784,4395,4389
08,Barcelona,121,Mataró,124099,61885,62214
08,Barcelona,122,Mediona,2353,1182,1171
08,Barcelona,138,Moià,5766,2920,2846
08,Barcelona,123,Molins de Rei,24878,12096,12782
08,Barcelona,124,Mollet del Vallès,51954,25825,26129
08,Barcelona,128,Monistrol de Calders,686,352,334
08,Barcelona,127,Monistrol de Montserrat,2993,1524,1469
08,Barcelona,125,Montcada i Reixac,34863,17293,17570
08,Barcelona,130,Montclar,120,60,60
08,Barcelona,131,Montesquiu,912,462,450
08,Barcelona,126,Montgat,11055,5458,5597
08,Barcelona,132,Montmajor,463,238,225
08,Barcelona,133,Montmaneu,169,91,78
08,Barcelona,135,Montmeló,8860,4360,4500
08,Barcelona,136,Montornès del Vallès,16150,8227,7923
08,Barcelona,137,Montseny,320,164,156
08,Barcelona,129,Muntanyola,585,301,284
08,Barcelona,139,Mura,205,112,93
08,Barcelona,140,Navarcles,5973,2920,3053
08,Barcelona,141,Navàs,6146,3058,3088
08,Barcelona,142,"Nou de Berguedà, La",150,76,74
08,Barcelona,143,Òdena,3629,1859,1770
08,Barcelona,145,Olèrdola,3626,1879,1747
08,Barcelona,146,Olesa de Bonesvalls,1720,892,828
08,Barcelona,147,Olesa de Montserrat,23742,11931,11811
08,Barcelona,148,Olivella,3617,1902,1715
08,Barcelona,149,Olost,1184,593,591
08,Barcelona,144,Olvan,889,443,446
08,Barcelona,150,Orís,284,144,140
08,Barcelona,151,Oristà,555,277,278
08,Barcelona,152,Orpí,135,76,59
08,Barcelona,153,Òrrius,662,338,324
08,Barcelona,154,Pacs del Penedès,892,446,446
08,Barcelona,155,Palafolls,9081,4536,4545
08,Barcelona,156,Palau-solità i Plegamans,14454,7182,7272
08,Barcelona,157,Pallejà,11208,5624,5584
08,Barcelona,905,"Palma de Cervelló, La",2991,1504,1487
08,Barcelona,158,"Papiol, El",4041,2010,2031
08,Barcelona,159,Parets del Vallès,18580,9331,9249
08,Barcelona,160,Perafita,422,215,207
08,Barcelona,161,Piera,15057,7674,7383
08,Barcelona,163,Pineda de Mar,26157,13114,13043
08,Barcelona,164,"Pla del Penedès, El",1195,601,594
08,Barcelona,165,"Pobla de Claramunt, La",2219,1114,1105
08,Barcelona,166,"Pobla de Lillet, La",1192,591,601
08,Barcelona,167,Polinyà,8158,4166,3992
08,Barcelona,182,"Pont de Vilomara i Rocafort, El",3769,1965,1804
08,Barcelona,168,Pontons,504,271,233
08,Barcelona,169,"Prat de Llobregat, El",63419,31310,32109
08,Barcelona,171,Prats de Lluçanès,2679,1335,1344
08,Barcelona,170,"Prats de Rei, Els",551,292,259
08,Barcelona,230,Premià de Dalt,10319,5172,5147
08,Barcelona,172,Premià de Mar,28136,13834,14302
08,Barcelona,174,Puigdàlber,533,266,267
08,Barcelona,175,Puig-reig,4264,2076,2188
08,Barcelona,176,Pujalt,198,106,92
08,Barcelona,177,"Quar, La",61,36,25
08,Barcelona,178,Rajadell,537,277,260
08,Barcelona,179,Rellinars,747,386,361
08,Barcelona,180,Ripollet,37234,18506,18728
08,Barcelona,181,"Roca del Vallès, La",10396,5220,5176
08,Barcelona,183,Roda de Ter,6133,3003,3130
08,Barcelona,184,Rubí,74468,37016,37452
08,Barcelona,185,Rubió,212,116,96
08,Barcelona,901,Rupit i Pruit,295,151,144
08,Barcelona,187,Sabadell,207649,101101,106548
08,Barcelona,188,Sagàs,155,81,74
08,Barcelona,190,Saldes,298,169,129
08,Barcelona,191,Sallent,6809,3281,3528
08,Barcelona,194,Sant Adrià de Besòs,34822,17115,17707
08,Barcelona,195,Sant Agustí de Lluçanès,92,47,45
08,Barcelona,196,Sant Andreu de la Barca,27329,13734,13595
08,Barcelona,197,Sant Andreu de Llavaneres,10558,5218,5340
08,Barcelona,198,Sant Antoni de Vilamajor,5717,2865,2852
08,Barcelona,199,Sant Bartomeu del Grau,888,454,434
08,Barcelona,200,Sant Boi de Llobregat,83408,41257,42151
08,Barcelona,201,Sant Boi de Lluçanès,552,274,278
08,Barcelona,203,Sant Cebrià de Vallalta,3368,1751,1617
08,Barcelona,202,Sant Celoni,17286,8588,8698
08,Barcelona,204,Sant Climent de Llobregat,3920,1974,1946
08,Barcelona,205,Sant Cugat del Vallès,86108,42029,44079
08,Barcelona,206,Sant Cugat Sesgarrigues,974,487,487
08,Barcelona,207,Sant Esteve de Palautordera,2544,1239,1305
08,Barcelona,208,Sant Esteve Sesrovires,7546,3766,3780
08,Barcelona,210,Sant Feliu de Codines,6025,3030,2995
08,Barcelona,211,Sant Feliu de Llobregat,43769,21320,22449
08,Barcelona,212,Sant Feliu Sasserra,645,337,308
08,Barcelona,209,Sant Fost de Campsentelles,8539,4263,4276
08,Barcelona,213,Sant Fruitós de Bages,8283,4151,4132
08,Barcelona,215,Sant Hipòlit de Voltregà,3521,1751,1770
08,Barcelona,193,Sant Iscle de Vallalta,1323,680,643
08,Barcelona,216,Sant Jaume de Frontanyà,25,16,9
08,Barcelona,218,Sant Joan de Vilatorrada,10793,5411,5382
08,Barcelona,217,Sant Joan Despí,32812,16052,16760
08,Barcelona,903,Sant Julià de Cerdanyola,248,140,108
08,Barcelona,220,Sant Julià de Vilatorta,3076,1512,1564
08,Barcelona,221,Sant Just Desvern,16859,8040,8819
08,Barcelona,222,Sant Llorenç d'Hortons,2535,1273,1262
08,Barcelona,223,Sant Llorenç Savall,2401,1225,1176
08,Barcelona,225,Sant Martí d'Albars,105,53,52
08,Barcelona,224,Sant Martí de Centelles,1109,567,542
08,Barcelona,226,Sant Martí de Tous,1184,601,583
08,Barcelona,227,Sant Martí Sarroca,3168,1554,1614
08,Barcelona,228,Sant Martí Sesgueioles,382,192,190
08,Barcelona,229,Sant Mateu de Bages,637,329,308
08,Barcelona,231,Sant Pere de Ribes,28730,14448,14282
08,Barcelona,232,Sant Pere de Riudebitlles,2346,1184,1162
08,Barcelona,233,Sant Pere de Torelló,2445,1249,1196
08,Barcelona,234,Sant Pere de Vilamajor,4293,2157,2136
08,Barcelona,189,Sant Pere Sallavinera,171,95,76
08,Barcelona,235,Sant Pol de Mar,5066,2557,2509
08,Barcelona,236,Sant Quintí de Mediona,2165,1101,1064
08,Barcelona,237,Sant Quirze de Besora,2167,1070,1097
08,Barcelona,238,Sant Quirze del Vallès,19408,9488,9920
08,Barcelona,239,Sant Quirze Safaja,659,348,311
08,Barcelona,240,Sant Sadurní d'Anoia,12603,6177,6426
08,Barcelona,241,Sant Sadurní d'Osormort,88,49,39
08,Barcelona,98,Sant Salvador de Guardiola,3122,1590,1532
08,Barcelona,262,Sant Vicenç de Castellet,9385,4651,4734
08,Barcelona,264,Sant Vicenç de Montalt,5951,3004,2947
08,Barcelona,265,Sant Vicenç de Torelló,2013,994,1019
08,Barcelona,263,Sant Vicenç dels Horts,28181,14114,14067
08,Barcelona,243,Santa Cecília de Voltregà,179,93,86
08,Barcelona,244,Santa Coloma de Cervelló,8060,3950,4110
08,Barcelona,245,Santa Coloma de Gramenet,120029,60280,59749
08,Barcelona,246,Santa Eugènia de Berga,2244,1146,1098
08,Barcelona,247,Santa Eulàlia de Riuprimer,1231,621,610
08,Barcelona,248,Santa Eulàlia de Ronçana,7042,3530,3512
08,Barcelona,249,Santa Fe del Penedès,378,195,183
08,Barcelona,250,Santa Margarida de Montbui,9690,4853,4837
08,Barcelona,251,Santa Margarida i els Monjos,7288,3694,3594
08,Barcelona,253,Santa Maria de Besora,163,82,81
08,Barcelona,254,Santa Maria de Corcó,2202,1113,1089
08,Barcelona,256,Santa Maria de Martorelles,847,422,425
08,Barcelona,255,Santa Maria de Merlès,175,86,89
08,Barcelona,257,Santa Maria de Miralles,133,67,66
08,Barcelona,259,Santa Maria de Palautordera,9195,4700,4495
08,Barcelona,258,Santa Maria d'Oló,1060,545,515
08,Barcelona,260,Santa Perpètua de Mogoda,25473,13016,12457
08,Barcelona,261,Santa Susanna,3325,1700,1625
08,Barcelona,192,Santpedor,7346,3656,3690
08,Barcelona,267,Sentmenat,8655,4384,4271
08,Barcelona,269,Seva,3481,1778,1703
08,Barcelona,270,Sitges,29140,14562,14578
08,Barcelona,271,Sobremunt,90,42,48
08,Barcelona,272,Sora,173,95,78
08,Barcelona,273,Subirats,3027,1540,1487
08,Barcelona,274,Súria,6121,2963,3158
08,Barcelona,276,Tagamanent,318,169,149
08,Barcelona,277,Talamanca,147,79,68
08,Barcelona,278,Taradell,6231,3137,3094
08,Barcelona,275,Tavèrnoles,315,157,158
08,Barcelona,280,Tavertet,127,70,57
08,Barcelona,281,Teià,6144,3047,3097
08,Barcelona,279,Terrassa,215055,106237,108818
08,Barcelona,282,Tiana,8221,3939,4282
08,Barcelona,283,Tona,8085,3998,4087
08,Barcelona,284,Tordera,16363,8336,8027
08,Barcelona,285,Torelló,13908,6827,7081
08,Barcelona,286,"Torre de Claramunt, La",3827,1977,1850
08,Barcelona,287,Torrelavit,1400,737,663
08,Barcelona,288,Torrelles de Foix,2360,1241,1119
08,Barcelona,289,Torrelles de Llobregat,5776,2863,2913
08,Barcelona,290,Ullastrell,2030,1021,1009
08,Barcelona,291,Vacarisses,6260,3227,3033
08,Barcelona,292,Vallbona d'Anoia,1431,730,701
08,Barcelona,293,Vallcebre,264,153,111
08,Barcelona,294,Vallgorguina,2746,1415,1331
08,Barcelona,295,Vallirana,14625,7299,7326
08,Barcelona,296,Vallromanes,2542,1289,1253
08,Barcelona,297,Veciana,176,102,74
08,Barcelona,298,Vic,41647,20660,20987
08,Barcelona,299,Vilada,462,246,216
08,Barcelona,301,Viladecans,65444,32527,32917
08,Barcelona,300,Viladecavalls,7397,3714,3683
08,Barcelona,305,Vilafranca del Penedès,38929,19232,19697
08,Barcelona,306,Vilalba Sasserra,689,343,346
08,Barcelona,303,Vilanova de Sau,330,164,166
08,Barcelona,302,Vilanova del Camí,12533,6293,6240
08,Barcelona,902,Vilanova del Vallès,5152,2622,2530
08,Barcelona,307,Vilanova i la Geltrú,66275,32285,33990
08,Barcelona,214,Vilassar de Dalt,8879,4370,4509
08,Barcelona,219,Vilassar de Mar,20030,9687,10343
08,Barcelona,304,Vilobí del Penedès,1099,557,542
08,Barcelona,308,Viver i Serrateix,177,90,87
48,Bizkaia,1,Abadiño,7458,3697,3761
48,Bizkaia,2,Abanto y Ciérvana-Abanto Zierbena,9758,4813,4945
48,Bizkaia,911,Ajangiz,450,229,221
48,Bizkaia,912,Alonsotegi,2827,1386,1441
48,Bizkaia,3,Amorebieta-Etxano,18650,9226,9424
48,Bizkaia,4,Amoroto,402,206,196
48,Bizkaia,5,Arakaldo,130,70,60
48,Bizkaia,6,Arantzazu,364,181,183
48,Bizkaia,93,Areatza,1227,586,641
48,Bizkaia,9,Arrankudiaga,964,474,490
48,Bizkaia,914,Arratzu,387,197,190
48,Bizkaia,10,Arrieta,545,276,269
48,Bizkaia,11,Arrigorriaga,12374,6032,6342
48,Bizkaia,23,Artea,760,384,376
48,Bizkaia,8,Artzentales,728,381,347
48,Bizkaia,91,Atxondo,1386,713,673
48,Bizkaia,70,Aulesti,648,324,324
48,Bizkaia,12,Bakio,2628,1334,1294
48,Bizkaia,90,Balmaseda,7833,3829,4004
48,Bizkaia,13,Barakaldo,100502,48702,51800
48,Bizkaia,14,Barrika,1534,758,776
48,Bizkaia,15,Basauri,41799,20349,21450
48,Bizkaia,92,Bedia,1020,481,539
48,Bizkaia,16,Berango,6947,3405,3542
48,Bizkaia,17,Bermeo,17159,8498,8661
48,Bizkaia,18,Berriatua,1249,692,557
48,Bizkaia,19,Berriz,4829,2431,2398
48,Bizkaia,20,Bilbao,349356,164941,184415
48,Bizkaia,21,Busturia,1717,861,856
48,Bizkaia,901,Derio,5828,2837,2991
48,Bizkaia,26,Dima,1404,717,687
48,Bizkaia,27,Durango,28691,14134,14557
48,Bizkaia,28,Ea,864,443,421
48,Bizkaia,31,Elantxobe,393,186,207
48,Bizkaia,32,Elorrio,7294,3584,3710
48,Bizkaia,902,Erandio,24457,11991,12466
48,Bizkaia,33,Ereño,249,128,121
48,Bizkaia,34,Ermua,16247,8149,8098
48,Bizkaia,79,Errigoiti,532,294,238
48,Bizkaia,29,Etxebarri,10572,5293,5279
48,Bizkaia,30,Etxebarria,805,412,393
48,Bizkaia,906,Forua,978,497,481
48,Bizkaia,35,Fruiz,547,280,267
48,Bizkaia,36,Galdakao,29219,14441,14778
48,Bizkaia,37,Galdames,822,440,382
48,Bizkaia,38,Gamiz-Fika,1348,675,673
48,Bizkaia,39,Garai,330,167,163
48,Bizkaia,40,Gatika,1611,825,786
48,Bizkaia,41,Gautegiz Arteaga,895,465,430
48,Bizkaia,46,Gernika-Lumo,16863,8129,8734
48,Bizkaia,44,Getxo,79839,37562,42277
48,Bizkaia,47,Gizaburuaga,215,106,109
48,Bizkaia,42,Gordexola,1717,863,854
48,Bizkaia,43,Gorliz,5607,2778,2829
48,Bizkaia,45,Güeñes,6522,3190,3332
48,Bizkaia,48,Ibarrangelu,632,317,315
48,Bizkaia,94,Igorre,4229,2059,2170
48,Bizkaia,49,Ispaster,715,371,344
48,Bizkaia,910,Iurreta,3856,1916,1940
48,Bizkaia,50,Izurtza,279,174,105
48,Bizkaia,22,Karrantza Harana/Valle de Carranza,2775,1441,1334
48,Bizkaia,907,Kortezubi,445,224,221
48,Bizkaia,51,Lanestosa,270,137,133
48,Bizkaia,52,Larrabetzu,2016,983,1033
48,Bizkaia,53,Laukiz,1148,584,564
48,Bizkaia,54,Leioa,30637,14960,15677
48,Bizkaia,57,Lekeitio,7374,3613,3761
48,Bizkaia,55,Lemoa,3475,1743,1732
48,Bizkaia,56,Lemoiz,1137,596,541
48,Bizkaia,81,Lezama,2448,1201,1247
48,Bizkaia,903,Loiu,2484,1236,1248
48,Bizkaia,58,Mallabia,1212,605,607
48,Bizkaia,59,Mañaria,517,276,241
48,Bizkaia,60,Markina-Xemein,4982,2564,2418
48,Bizkaia,61,Maruri-Jatabe,948,478,470
48,Bizkaia,62,Mendata,368,194,174
48,Bizkaia,63,Mendexa,440,220,220
48,Bizkaia,64,Meñaka,745,382,363
48,Bizkaia,66,Morga,427,217,210
48,Bizkaia,68,Mundaka,1929,930,999
48,Bizkaia,69,Mungia,17022,8319,8703
48,Bizkaia,7,Munitibar-Arbatzegi Gerrikaitz,458,246,212
48,Bizkaia,908,Murueta,311,166,145
48,Bizkaia,71,Muskiz,7620,3785,3835
48,Bizkaia,67,Muxika,1457,752,705
48,Bizkaia,909,Nabarniz,232,121,111
48,Bizkaia,73,Ondarroa,8687,4388,4299
48,Bizkaia,75,Orozko,2613,1300,1313
48,Bizkaia,83,Ortuella,8397,4095,4302
48,Bizkaia,72,Otxandio,1291,670,621
48,Bizkaia,77,Plentzia,4347,2100,2247
48,Bizkaia,78,Portugalete,47233,22629,24604
48,Bizkaia,82,Santurtzi,47020,22816,24204
48,Bizkaia,84,Sestao,28651,13890,14761
48,Bizkaia,904,Sondika,4550,2200,2350
48,Bizkaia,85,Sopelana,12977,6364,6613
48,Bizkaia,86,Sopuerta,2575,1321,1254
48,Bizkaia,76,Sukarrieta,360,183,177
48,Bizkaia,87,Trucios-Turtzioz,535,278,257
48,Bizkaia,88,Ubide,176,87,89
48,Bizkaia,65,Ugao-Miraballes,4094,2060,2034
48,Bizkaia,89,Urduliz,3770,1881,1889
48,Bizkaia,74,Urduña/Orduña,4246,2171,2075
48,Bizkaia,80,Valle de Trápaga-Trapagaran,12100,5917,6183
48,Bizkaia,95,Zaldibar,3042,1517,1525
48,Bizkaia,96,Zalla,8511,4172,4339
48,Bizkaia,905,Zamudio,3272,1638,1634
48,Bizkaia,97,Zaratamo,1650,825,825
48,Bizkaia,24,Zeanuri,1290,657,633
48,Bizkaia,25,Zeberio,1084,543,541
48,Bizkaia,913,Zierbena,1479,789,690
48,Bizkaia,915,Ziortza-Bolibar,429,230,199
09,Burgos,1,Abajas,32,18,14
09,Burgos,3,Adrada de Haza,237,124,113
09,Burgos,6,Aguas Cándidas,62,39,23
09,Burgos,7,Aguilar de Bureba,67,39,28
09,Burgos,9,Albillos,221,117,104
09,Burgos,10,Alcocero de Mola,33,24,9
09,Burgos,11,Alfoz de Bricia,82,48,34
09,Burgos,907,Alfoz de Quintanadueñas,2001,1080,921
09,Burgos,12,Alfoz de Santa Gadea,107,63,44
09,Burgos,13,Altable,49,28,21
09,Burgos,14,"Altos, Los",173,105,68
09,Burgos,16,Ameyugo,99,56,43
09,Burgos,17,Anguix,126,74,52
09,Burgos,18,Aranda de Duero,33257,16364,16893
09,Burgos,19,Arandilla,175,108,67
09,Burgos,20,Arauzo de Miel,364,196,168
09,Burgos,21,Arauzo de Salce,69,39,30
09,Burgos,22,Arauzo de Torre,91,51,40
09,Burgos,23,Arcos,1460,787,673
09,Burgos,24,Arenillas de Riopisuerga,187,104,83
09,Burgos,25,Arija,159,82,77
09,Burgos,26,Arlanzón,452,262,190
09,Burgos,27,Arraya de Oca,48,27,21
09,Burgos,29,Atapuerca,193,108,85
09,Burgos,30,"Ausines, Los",142,85,57
09,Burgos,32,Avellanosa de Muñó,122,65,57
09,Burgos,33,Bahabón de Esgueva,100,62,38
09,Burgos,34,"Balbases, Los",340,189,151
09,Burgos,35,Baños de Valdearados,377,219,158
09,Burgos,36,Bañuelos de Bureba,31,20,11
09,Burgos,37,Barbadillo de Herreros,115,66,49
09,Burgos,38,Barbadillo del Mercado,158,88,70
09,Burgos,39,Barbadillo del Pez,79,49,30
09,Burgos,41,Barrio de Muñó,31,16,15
09,Burgos,43,"Barrios de Bureba, Los",222,135,87
09,Burgos,44,Barrios de Colina,55,27,28
09,Burgos,45,Basconcillos del Tozo,302,176,126
09,Burgos,46,Bascuñana,38,24,14
09,Burgos,47,Belbimbre,75,39,36
09,Burgos,48,Belorado,2060,1080,980
09,Burgos,50,Berberana,74,38,36
09,Burgos,51,Berlangas de Roa,181,96,85
09,Burgos,52,Berzosa de Bureba,34,25,9
09,Burgos,54,Bozoó,105,60,45
09,Burgos,55,Brazacorta,77,41,36
09,Burgos,56,Briviesca,7539,3866,3673
09,Burgos,57,Bugedo,191,125,66
09,Burgos,58,Buniel,519,289,230
09,Burgos,59,Burgos,179097,85747,93350
09,Burgos,60,Busto de Bureba,186,106,80
09,Burgos,61,Cabañes de Esgueva,190,100,90
09,Burgos,62,Cabezón de la Sierra,49,22,27
09,Burgos,64,Caleruega,484,241,243
09,Burgos,65,Campillo de Aranda,181,104,77
09,Burgos,66,Campolara,61,43,18
09,Burgos,67,Canicosa de la Sierra,545,289,256
09,Burgos,68,Cantabrana,32,17,15
09,Burgos,70,Carazo,40,28,12
09,Burgos,71,Carcedo de Bureba,46,26,20
09,Burgos,72,Carcedo de Burgos,384,215,169
09,Burgos,73,Cardeñadijo,1253,685,568
09,Burgos,74,Cardeñajimeno,1019,554,465
09,Burgos,75,Cardeñuela Riopico,143,85,58
09,Burgos,76,Carrias,26,22,4
09,Burgos,77,Cascajares de Bureba,33,19,14
09,Burgos,78,Cascajares de la Sierra,39,20,19
09,Burgos,79,Castellanos de Castro,52,31,21
09,Burgos,83,Castil de Peones,33,18,15
09,Burgos,82,Castildelgado,44,25,19
09,Burgos,84,Castrillo de la Reina,206,132,74
09,Burgos,85,Castrillo de la Vega,630,335,295
09,Burgos,88,Castrillo de Riopisuerga,69,44,25
09,Burgos,86,Castrillo del Val,826,499,327
09,Burgos,90,Castrillo Matajudíos,60,32,28
09,Burgos,91,Castrojeriz,853,443,410
09,Burgos,63,Cavia,258,148,110
09,Burgos,93,Cayuela,186,103,83
09,Burgos,94,Cebrecos,47,30,17
09,Burgos,95,Celada del Camino,99,52,47
09,Burgos,98,Cerezo de Río Tirón,613,338,275
09,Burgos,100,Cerratón de Juarros,52,33,19
09,Burgos,101,Ciadoncha,92,53,39
09,Burgos,102,Cillaperlata,39,26,13
09,Burgos,103,Cilleruelo de Abajo,263,143,120
09,Burgos,104,Cilleruelo de Arriba,62,33,29
09,Burgos,105,Ciruelos de Cervera,108,61,47
09,Burgos,108,Cogollos,482,271,211
09,Burgos,109,Condado de Treviño,1437,825,612
09,Burgos,110,Contreras,87,52,35
09,Burgos,112,Coruña del Conde,126,78,48
09,Burgos,113,Covarrubias,603,319,284
09,Burgos,114,Cubillo del Campo,98,55,43
09,Burgos,115,Cubo de Bureba,98,58,40
09,Burgos,117,"Cueva de Roa, La",101,52,49
09,Burgos,119,Cuevas de San Clemente,54,20,34
09,Burgos,120,Encío,47,25,22
09,Burgos,122,Espinosa de Cervera,94,57,37
09,Burgos,124,Espinosa de los Monteros,1935,1050,885
09,Burgos,123,Espinosa del Camino,38,20,18
09,Burgos,125,Estépar,698,419,279
09,Burgos,127,Fontioso,59,31,28
09,Burgos,128,Frandovínez,102,59,43
09,Burgos,129,Fresneda de la Sierra Tirón,138,95,43
09,Burgos,130,Fresneña,94,52,42
09,Burgos,131,Fresnillo de las Dueñas,568,300,268
09,Burgos,132,Fresno de Río Tirón,185,105,80
09,Burgos,133,Fresno de Rodilla,49,29,20
09,Burgos,134,Frías,283,153,130
09,Burgos,135,Fuentebureba,44,19,25
09,Burgos,136,Fuentecén,227,130,97
09,Burgos,137,Fuentelcésped,223,111,112
09,Burgos,138,Fuentelisendo,106,58,48
09,Burgos,139,Fuentemolinos,105,68,37
09,Burgos,140,Fuentenebro,148,91,57
09,Burgos,141,Fuentespina,771,412,359
09,Burgos,143,Galbarros,29,20,9
09,Burgos,144,"Gallega, La",61,38,23
09,Burgos,148,Grijalba,112,55,57
09,Burgos,149,Grisaleña,38,26,12
09,Burgos,151,Gumiel de Izán,601,334,267
09,Burgos,152,Gumiel de Mercado,336,186,150
09,Burgos,154,Hacinas,173,96,77
09,Burgos,155,Haza,26,15,11
09,Burgos,159,Hontanas,73,44,29
09,Burgos,160,Hontangas,113,69,44
09,Burgos,162,Hontoria de la Cantera,143,81,62
09,Burgos,164,Hontoria de Valdearados,214,130,84
09,Burgos,163,Hontoria del Pinar,735,410,325
09,Burgos,166,"Hormazas, Las",111,64,47
09,Burgos,167,Hornillos del Camino,56,31,25
09,Burgos,168,"Horra, La",377,194,183
09,Burgos,169,Hortigüela,103,64,39
09,Burgos,170,Hoyales de Roa,226,113,113
09,Burgos,172,Huérmeces,128,66,62
09,Burgos,173,Huerta de Arriba,132,75,57
09,Burgos,174,Huerta de Rey,1038,556,482
09,Burgos,175,Humada,137,85,52
09,Burgos,176,Hurones,70,44,26
09,Burgos,177,Ibeas de Juarros,1445,800,645
09,Burgos,178,Ibrillos,59,33,26
09,Burgos,179,Iglesiarrubia,43,25,18
09,Burgos,180,Iglesias,135,77,58
09,Burgos,181,Isar,363,181,182
09,Burgos,182,Itero del Castillo,92,48,44
09,Burgos,183,Jaramillo de la Fuente,55,32,23
09,Burgos,184,Jaramillo Quemado,4,2,2
09,Burgos,189,Junta de Traslaloma,142,74,68
09,Burgos,190,Junta de Villalba de Losa,99,53,46
09,Burgos,191,Jurisdicción de Lara,41,22,19
09,Burgos,192,Jurisdicción de San Zadornil,62,33,29
09,Burgos,194,Lerma,2848,1443,1405
09,Burgos,195,Llano de Bureba,68,37,31
09,Burgos,196,Madrigal del Monte,173,103,70
09,Burgos,197,Madrigalejo del Monte,178,112,66
09,Burgos,198,Mahamud,126,68,58
09,Burgos,199,Mambrilla de Castrejón,97,53,44
09,Burgos,200,Mambrillas de Lara,54,31,23
09,Burgos,201,Mamolar,33,23,10
09,Burgos,202,Manciles,20,13,7
09,Burgos,206,Mazuela,65,34,31
09,Burgos,208,Mecerreyes,297,156,141
09,Burgos,209,Medina de Pomar,6050,3095,2955
09,Burgos,211,Melgar de Fernamental,1824,985,839
09,Burgos,213,Merindad de Cuesta-Urria,402,213,189
09,Burgos,214,Merindad de Montija,826,481,345
09,Burgos,906,Merindad de Río Ubierna,1397,770,627
09,Burgos,215,Merindad de Sotoscueva,444,251,193
09,Burgos,216,Merindad de Valdeporres,455,237,218
09,Burgos,217,Merindad de Valdivielso,408,241,167
09,Burgos,218,Milagros,477,255,222
09,Burgos,219,Miranda de Ebro,37648,18650,18998
09,Burgos,220,Miraveche,81,52,29
09,Burgos,221,Modúbar de la Emparedada,593,336,257
09,Burgos,223,Monasterio de la Sierra,46,30,16
09,Burgos,224,Monasterio de Rodilla,191,106,85
09,Burgos,225,Moncalvillo,98,58,40
09,Burgos,226,Monterrubio de la Demanda,67,38,29
09,Burgos,227,Montorio,188,105,83
09,Burgos,228,Moradillo de Roa,197,106,91
09,Burgos,229,Nava de Roa,224,116,108
09,Burgos,230,Navas de Bureba,36,16,20
09,Burgos,231,Nebreda,75,51,24
09,Burgos,232,Neila,184,102,82
09,Burgos,235,Olmedillo de Roa,204,119,85
09,Burgos,236,Olmillos de Muñó,39,22,17
09,Burgos,238,Oña,1124,588,536
09,Burgos,239,Oquillas,64,35,29
09,Burgos,241,Orbaneja Riopico,250,132,118
09,Burgos,242,Padilla de Abajo,100,55,45
09,Burgos,243,Padilla de Arriba,84,55,29
09,Burgos,244,Padrones de Bureba,46,23,23
09,Burgos,246,Palacios de la Sierra,749,376,373
09,Burgos,247,Palacios de Riopisuerga,32,14,18
09,Burgos,248,Palazuelos de la Sierra,70,42,28
09,Burgos,249,Palazuelos de Muñó,59,32,27
09,Burgos,250,Pampliega,359,187,172
09,Burgos,251,Pancorbo,493,266,227
09,Burgos,253,Pardilla,132,76,56
09,Burgos,255,Partido de la Sierra en Tobalina,86,51,35
09,Burgos,256,Pedrosa de Duero,438,247,191
09,Burgos,259,Pedrosa de Río Úrbel,258,157,101
09,Burgos,257,Pedrosa del Páramo,101,60,41
09,Burgos,258,Pedrosa del Príncipe,167,88,79
09,Burgos,261,Peñaranda de Duero,569,289,280
09,Burgos,262,Peral de Arlanza,170,91,79
09,Burgos,265,Piérnigas,39,26,13
09,Burgos,266,Pineda de la Sierra,98,59,39
09,Burgos,267,Pineda Trasmonte,137,82,55
09,Burgos,268,Pinilla de los Barruecos,118,72,46
09,Burgos,269,Pinilla de los Moros,39,25,14
09,Burgos,270,Pinilla Trasmonte,187,105,82
09,Burgos,272,Poza de la Sal,351,181,170
09,Burgos,273,Prádanos de Bureba,64,38,26
09,Burgos,274,Pradoluengo,1340,662,678
09,Burgos,275,Presencio,221,127,94
09,Burgos,276,"Puebla de Arganzón, La",515,291,224
09,Burgos,277,Puentedura,130,83,47
09,Burgos,279,Quemada,253,144,109
09,Burgos,281,Quintana del Pidio,172,88,84
09,Burgos,280,Quintanabureba,35,21,14
09,Burgos,283,Quintanaélez,59,30,29
09,Burgos,287,Quintanaortuño,260,142,118
09,Burgos,288,Quintanapalla,111,66,45
09,Burgos,289,Quintanar de la Sierra,1991,1047,944
09,Burgos,292,Quintanavides,97,56,41
09,Burgos,294,Quintanilla de la Mata,140,83,57
09,Burgos,901,Quintanilla del Agua y Tordueles,467,240,227
09,Burgos,295,Quintanilla del Coco,63,31,32
09,Burgos,298,Quintanilla San García,101,55,46
09,Burgos,301,Quintanilla Vivar,775,407,368
09,Burgos,297,"Quintanillas, Las",390,217,173
09,Burgos,302,Rabanera del Pinar,118,68,50
09,Burgos,303,Rábanos,92,52,40
09,Burgos,304,Rabé de las Calzadas,216,111,105
09,Burgos,306,Rebolledo de la Torre,131,69,62
09,Burgos,307,Redecilla del Camino,115,65,50
09,Burgos,308,Redecilla del Campo,73,43,30
09,Burgos,309,Regumiel de la Sierra,391,202,189
09,Burgos,310,Reinoso,11,8,3
09,Burgos,311,Retuerta,69,44,25
09,Burgos,314,Revilla del Campo,106,69,37
09,Burgos,316,Revilla Vallejera,87,55,32
09,Burgos,312,"Revilla y Ahedo, La",124,68,56
09,Burgos,315,Revillarruz,497,255,242
09,Burgos,317,Rezmondo,15,6,9
09,Burgos,318,Riocavado de la Sierra,57,35,22
09,Burgos,321,Roa,2453,1253,1200
09,Burgos,323,Rojas,73,47,26
09,Burgos,325,Royuela de Río Franco,222,133,89
09,Burgos,326,Rubena,173,101,72
09,Burgos,327,Rublacedo de Abajo,32,16,16
09,Burgos,328,Rucandio,76,40,36
09,Burgos,329,Salas de Bureba,138,82,56
09,Burgos,330,Salas de los Infantes,2130,1097,1033
09,Burgos,332,Saldaña de Burgos,190,103,87
09,Burgos,334,Salinillas de Bureba,55,39,16
09,Burgos,335,San Adrián de Juarros,85,51,34
09,Burgos,337,San Juan del Monte,150,82,68
09,Burgos,338,San Mamés de Burgos,302,173,129
09,Burgos,339,San Martín de Rubiales,151,89,62
09,Burgos,340,San Millán de Lara,73,55,18
09,Burgos,360,San Vicente del Valle,33,25,8
09,Burgos,343,Santa Cecilia,104,62,42
09,Burgos,345,Santa Cruz de la Salceda,165,97,68
09,Burgos,346,Santa Cruz del Valle Urbión,97,61,36
09,Burgos,347,Santa Gadea del Cid,163,89,74
09,Burgos,348,Santa Inés,159,82,77
09,Burgos,350,Santa María del Campo,627,338,289
09,Burgos,351,Santa María del Invierno,61,43,18
09,Burgos,352,Santa María del Mercadillo,129,73,56
09,Burgos,353,Santa María Rivarredonda,97,58,39
09,Burgos,354,Santa Olalla de Bureba,35,26,9
09,Burgos,355,Santibáñez de Esgueva,112,59,53
09,Burgos,356,Santibáñez del Val,60,38,22
09,Burgos,358,Santo Domingo de Silos,316,197,119
09,Burgos,361,Sargentes de la Lora,132,74,58
09,Burgos,362,Sarracín,263,143,120
09,Burgos,363,Sasamón,1118,625,493
09,Burgos,365,"Sequera de Haza, La",37,24,13
09,Burgos,366,Solarana,91,46,45
09,Burgos,368,Sordillos,25,16,9
09,Burgos,369,Sotillo de la Ribera,555,298,257
09,Burgos,372,Sotragero,302,166,136
09,Burgos,373,Sotresgudo,512,294,218
09,Burgos,374,Susinos del Páramo,112,71,41
09,Burgos,375,Tamarón,43,24,19
09,Burgos,377,Tardajos,825,420,405
09,Burgos,378,Tejada,33,22,11
09,Burgos,380,Terradillos de Esgueva,91,45,46
09,Burgos,381,Tinieblas de la Sierra,39,22,17
09,Burgos,382,Tobar,28,16,12
09,Burgos,384,Tordómar,351,194,157
09,Burgos,386,Torrecilla del Monte,79,44,35
09,Burgos,387,Torregalindo,136,81,55
09,Burgos,388,Torrelara,30,19,11
09,Burgos,389,Torrepadre,72,43,29
09,Burgos,390,Torresandino,709,384,325
09,Burgos,391,Tórtoles de Esgueva,490,263,227
09,Burgos,392,Tosantos,57,34,23
09,Burgos,394,Trespaderne,923,484,439
09,Burgos,395,Tubilla del Agua,154,97,57
09,Burgos,396,Tubilla del Lago,153,86,67
09,Burgos,398,Úrbel del Castillo,86,56,30
09,Burgos,400,Vadocondes,389,216,173
09,Burgos,403,Valdeande,105,67,38
09,Burgos,405,Valdezate,145,75,70
09,Burgos,406,Valdorros,321,181,140
09,Burgos,408,Vallarta de Bureba,47,30,17
09,Burgos,904,Valle de las Navas,572,328,244
09,Burgos,908,Valle de Losa,544,322,222
09,Burgos,409,Valle de Manzanedo,136,75,61
09,Burgos,410,Valle de Mena,3901,2015,1886
09,Burgos,411,Valle de Oca,176,105,71
09,Burgos,902,Valle de Santibáñez,519,290,229
09,Burgos,905,Valle de Sedano,481,279,202
09,Burgos,412,Valle de Tobalina,995,545,450
09,Burgos,413,Valle de Valdebezana,534,284,250
09,Burgos,414,Valle de Valdelaguna,199,113,86
09,Burgos,415,Valle de Valdelucio,330,173,157
09,Burgos,416,Valle de Zamanzas,74,41,33
09,Burgos,417,Vallejera,44,26,18
09,Burgos,418,Valles de Palenzuela,86,45,41
09,Burgos,419,Valluércanes,80,52,28
09,Burgos,407,Valmala,29,15,14
09,Burgos,422,"Vid de Bureba, La",21,10,11
09,Burgos,421,"Vid y Barrios, La",269,157,112
09,Burgos,423,Vileña,33,20,13
09,Burgos,427,Villadiego,1637,893,744
09,Burgos,428,Villaescusa de Roa,117,64,53
09,Burgos,429,Villaescusa la Sombría,70,52,18
09,Burgos,430,Villaespasa,19,12,7
09,Burgos,431,Villafranca Montes de Oca,130,75,55
09,Burgos,432,Villafruela,218,124,94
09,Burgos,433,Villagalijo,66,42,24
09,Burgos,434,Villagonzalo Pedernales,1723,899,824
09,Burgos,437,Villahoz,329,179,150
09,Burgos,438,Villalba de Duero,674,355,319
09,Burgos,439,Villalbilla de Burgos,1231,661,570
09,Burgos,440,Villalbilla de Gumiel,106,65,41
09,Burgos,441,Villaldemiro,71,40,31
09,Burgos,442,Villalmanzo,460,248,212
09,Burgos,443,Villamayor de los Montes,208,107,101
09,Burgos,444,Villamayor de Treviño,81,42,39
09,Burgos,445,Villambistia,44,29,15
09,Burgos,446,Villamedianilla,10,7,3
09,Burgos,447,Villamiel de la Sierra,41,24,17
09,Burgos,448,Villangómez,238,147,91
09,Burgos,449,Villanueva de Argaño,109,67,42
09,Burgos,450,Villanueva de Carazo,32,20,12
09,Burgos,451,Villanueva de Gumiel,286,146,140
09,Burgos,454,Villanueva de Teba,45,31,14
09,Burgos,455,Villaquirán de la Puebla,47,29,18
09,Burgos,456,Villaquirán de los Infantes,150,77,73
09,Burgos,903,Villarcayo de Merindad de Castilla la Vieja,4826,2558,2268
09,Burgos,458,Villariezo,573,327,246
09,Burgos,460,Villasandino,199,116,83
09,Burgos,463,Villasur de Herreros,258,149,109
09,Burgos,464,Villatuelda,47,27,20
09,Burgos,466,Villaverde del Monte,139,77,62
09,Burgos,467,Villaverde-Mogina,81,54,27
09,Burgos,471,Villayerno Morquillas,219,120,99
09,Burgos,472,Villazopeque,62,39,23
09,Burgos,473,Villegas,96,58,38
09,Burgos,476,Villoruebo,60,41,19
09,Burgos,424,Viloria de Rioja,45,26,19
09,Burgos,425,Vilviestre del Pinar,657,357,300
09,Burgos,478,Vizcaínos,49,31,18
09,Burgos,480,Zael,111,56,55
09,Burgos,482,Zarzosa de Río Pisuerga,32,20,12
09,Burgos,483,Zazuar,253,131,122
09,Burgos,485,Zuñeda,60,37,23
10,Cáceres,1,Abadía,333,187,146
10,Cáceres,2,Abertura,442,223,219
10,Cáceres,3,Acebo,612,325,287
10,Cáceres,4,Acehúche,836,405,431
10,Cáceres,5,Aceituna,603,310,293
10,Cáceres,6,Ahigal,1468,758,710
10,Cáceres,903,Alagón del Río,889,443,446
10,Cáceres,7,Albalá,761,389,372
10,Cáceres,8,Alcántara,1588,800,788
10,Cáceres,9,Alcollarín,278,135,143
10,Cáceres,10,Alcuéscar,2877,1491,1386
10,Cáceres,12,Aldea del Cano,702,342,360
10,Cáceres,13,"Aldea del Obispo, La",339,177,162
10,Cáceres,11,Aldeacentenera,644,331,313
10,Cáceres,14,Aldeanueva de la Vera,2168,1060,1108
10,Cáceres,15,Aldeanueva del Camino,797,391,406
10,Cáceres,16,Aldehuela de Jerte,379,202,177
10,Cáceres,17,Alía,968,497,471
10,Cáceres,18,Aliseda,2001,1004,997
10,Cáceres,19,Almaraz,1614,832,782
10,Cáceres,20,Almoharín,1963,947,1016
10,Cáceres,21,Arroyo de la Luz,6206,3080,3126
10,Cáceres,23,Arroyomolinos,855,453,402
10,Cáceres,22,Arroyomolinos de la Vera,485,243,242
10,Cáceres,24,Baños de Montemayor,764,365,399
10,Cáceres,25,Barrado,439,230,209
10,Cáceres,26,Belvís de Monroy,633,330,303
10,Cáceres,27,Benquerencia,81,45,36
10,Cáceres,28,Berrocalejo,134,70,64
10,Cáceres,29,Berzocana,469,241,228
10,Cáceres,30,Bohonal de Ibor,540,277,263
10,Cáceres,31,Botija,193,102,91
10,Cáceres,32,Brozas,2000,1006,994
10,Cáceres,33,Cabañas del Castillo,462,246,216
10,Cáceres,34,Cabezabellosa,396,205,191
10,Cáceres,35,Cabezuela del Valle,2431,1247,1184
10,Cáceres,36,Cabrero,351,186,165
10,Cáceres,37,Cáceres,95925,46117,49808
10,Cáceres,38,Cachorrilla,98,50,48
10,Cáceres,39,Cadalso,478,237,241
10,Cáceres,40,Calzadilla,499,250,249
10,Cáceres,41,Caminomorisco,1141,590,551
10,Cáceres,42,Campillo de Deleitosa,56,23,33
10,Cáceres,43,Campo Lugar,954,482,472
10,Cáceres,44,Cañamero,1694,873,821
10,Cáceres,45,Cañaveral,1161,568,593
10,Cáceres,46,Carbajo,224,114,110
10,Cáceres,47,Carcaboso,1115,562,553
10,Cáceres,48,Carrascalejo,291,148,143
10,Cáceres,49,Casar de Cáceres,4743,2338,2405
10,Cáceres,50,Casar de Palomero,1350,685,665
10,Cáceres,51,Casares de las Hurdes,445,223,222
10,Cáceres,52,Casas de Don Antonio,201,97,104
10,Cáceres,53,Casas de Don Gómez,312,163,149
10,Cáceres,56,Casas de Millán,659,339,320
10,Cáceres,57,Casas de Miravete,157,96,61
10,Cáceres,54,Casas del Castañar,577,281,296
10,Cáceres,55,Casas del Monte,822,416,406
10,Cáceres,58,Casatejada,1459,764,695
10,Cáceres,59,Casillas de Coria,433,208,225
10,Cáceres,60,Castañar de Ibor,1150,595,555
10,Cáceres,61,Ceclavín,1998,1016,982
10,Cáceres,62,Cedillo,490,258,232
10,Cáceres,63,Cerezo,182,90,92
10,Cáceres,64,Cilleros,1791,902,889
10,Cáceres,65,Collado de la Vera,152,83,69
10,Cáceres,66,Conquista de la Sierra,201,112,89
10,Cáceres,67,Coria,13010,6399,6611
10,Cáceres,68,Cuacos de Yuste,891,457,434
10,Cáceres,69,"Cumbre, La",926,459,467
10,Cáceres,70,Deleitosa,790,400,390
10,Cáceres,71,Descargamaría,159,86,73
10,Cáceres,72,Eljas,973,497,476
10,Cáceres,73,Escurial,818,432,386
10,Cáceres,75,Fresnedoso de Ibor,315,164,151
10,Cáceres,76,Galisteo,974,475,499
10,Cáceres,77,Garciaz,803,412,391
10,Cáceres,79,Garganta la Olla,955,511,444
10,Cáceres,78,"Garganta, La",467,255,212
10,Cáceres,80,Gargantilla,426,215,211
10,Cáceres,81,Gargüera,110,59,51
10,Cáceres,82,Garrovillas de Alconétar,2245,1104,1141
10,Cáceres,83,Garvín,104,57,47
10,Cáceres,84,Gata,1614,831,783
10,Cáceres,85,"Gordo, El",395,200,195
10,Cáceres,86,"Granja, La",362,190,172
10,Cáceres,87,Guadalupe,2004,986,1018
10,Cáceres,88,Guijo de Coria,233,126,107
10,Cáceres,89,Guijo de Galisteo,1612,815,797
10,Cáceres,90,Guijo de Granadilla,587,306,281
10,Cáceres,91,Guijo de Santa Bárbara,431,227,204
10,Cáceres,92,Herguijuela,353,179,174
10,Cáceres,93,Hernán-Pérez,495,253,242
10,Cáceres,94,Herrera de Alcántara,280,141,139
10,Cáceres,95,Herreruela,371,178,193
10,Cáceres,96,Hervás,4193,2066,2127
10,Cáceres,97,Higuera,114,73,41
10,Cáceres,98,Hinojal,447,223,224
10,Cáceres,99,Holguera,716,358,358
10,Cáceres,100,Hoyos,914,456,458
10,Cáceres,101,Huélaga,212,113,99
10,Cáceres,102,Ibahernando,575,278,297
10,Cáceres,103,Jaraicejo,535,253,282
10,Cáceres,104,Jaraíz de la Vera,6591,3285,3306
10,Cáceres,105,Jarandilla de la Vera,3050,1524,1526
10,Cáceres,106,Jarilla,152,75,77
10,Cáceres,107,Jerte,1320,677,643
10,Cáceres,108,Ladrillar,193,105,88
10,Cáceres,109,Logrosán,2110,1069,1041
10,Cáceres,110,Losar de la Vera,2855,1464,1391
10,Cáceres,111,Madrigal de la Vera,1757,925,832
10,Cáceres,112,Madrigalejo,1876,928,948
10,Cáceres,113,Madroñera,2790,1382,1408
10,Cáceres,114,Majadas,1333,672,661
10,Cáceres,115,Malpartida de Cáceres,4395,2197,2198
10,Cáceres,116,Malpartida de Plasencia,4725,2369,2356
10,Cáceres,117,Marchagaz,228,118,110
10,Cáceres,118,Mata de Alcántara,320,164,156
10,Cáceres,119,Membrío,710,339,371
10,Cáceres,120,Mesas de Ibor,177,94,83
10,Cáceres,121,Miajadas,10111,4998,5113
10,Cáceres,122,Millanes,267,140,127
10,Cáceres,123,Mirabel,691,346,345
10,Cáceres,124,Mohedas de Granadilla,903,459,444
10,Cáceres,125,Monroy,1063,540,523
10,Cáceres,126,Montánchez,1905,943,962
10,Cáceres,127,Montehermoso,5852,2998,2854
10,Cáceres,128,Moraleja,7114,3545,3569
10,Cáceres,129,Morcillo,409,196,213
10,Cáceres,130,Navaconcejo,1940,981,959
10,Cáceres,131,Navalmoral de la Mata,17274,8369,8905
10,Cáceres,132,Navalvillar de Ibor,460,231,229
10,Cáceres,133,Navas del Madroño,1396,698,698
10,Cáceres,134,Navezuelas,670,346,324
10,Cáceres,135,Nuñomoral,1383,736,647
10,Cáceres,136,Oliva de Plasencia,273,151,122
10,Cáceres,137,Palomero,380,195,185
10,Cáceres,138,Pasarón de la Vera,653,314,339
10,Cáceres,139,Pedroso de Acim,124,69,55
10,Cáceres,140,Peraleda de la Mata,1425,728,697
10,Cáceres,141,Peraleda de San Román,318,159,159
10,Cáceres,142,Perales del Puerto,979,494,485
10,Cáceres,143,Pescueza,167,80,87
10,Cáceres,144,"Pesga, La",1130,589,541
10,Cáceres,145,Piedras Albas,170,85,85
10,Cáceres,146,Pinofranqueado,1678,890,788
10,Cáceres,147,Piornal,1562,790,772
10,Cáceres,148,Plasencia,41047,19952,21095
10,Cáceres,149,Plasenzuela,481,255,226
10,Cáceres,150,Portaje,395,198,197
10,Cáceres,151,Portezuelo,262,137,125
10,Cáceres,152,Pozuelo de Zarzón,491,239,252
10,Cáceres,153,Puerto de Santa Cruz,372,191,181
10,Cáceres,154,Rebollar,227,113,114
10,Cáceres,155,Riolobos,1351,701,650
10,Cáceres,156,Robledillo de Gata,106,56,50
10,Cáceres,157,Robledillo de la Vera,306,159,147
10,Cáceres,158,Robledillo de Trujillo,398,210,188
10,Cáceres,159,Robledollano,344,191,153
10,Cáceres,160,Romangordo,257,118,139
10,Cáceres,901,Rosalejo,1544,815,729
10,Cáceres,161,Ruanes,72,44,28
10,Cáceres,162,Salorino,649,337,312
10,Cáceres,163,Salvatierra de Santiago,273,136,137
10,Cáceres,164,San Martín de Trevejo,883,443,440
10,Cáceres,165,Santa Ana,279,148,131
10,Cáceres,166,Santa Cruz de la Sierra,345,170,175
10,Cáceres,167,Santa Cruz de Paniagua,351,187,164
10,Cáceres,168,Santa Marta de Magasca,288,140,148
10,Cáceres,169,Santiago de Alcántara,606,290,316
10,Cáceres,170,Santiago del Campo,272,135,137
10,Cáceres,171,Santibáñez el Alto,379,197,182
10,Cáceres,172,Santibáñez el Bajo,751,385,366
10,Cáceres,173,Saucedilla,825,452,373
10,Cáceres,174,Segura de Toro,177,86,91
10,Cáceres,175,Serradilla,1637,830,807
10,Cáceres,176,Serrejón,459,232,227
10,Cáceres,177,Sierra de Fuentes,2044,1043,1001
10,Cáceres,178,Talaván,937,474,463
10,Cáceres,179,Talaveruela de la Vera,363,183,180
10,Cáceres,180,Talayuela,9241,4978,4263
10,Cáceres,181,Tejeda de Tiétar,858,462,396
10,Cáceres,182,Toril,189,115,74
10,Cáceres,183,Tornavacas,1176,612,564
10,Cáceres,184,"Torno, El",910,481,429
10,Cáceres,187,Torre de Don Miguel,511,273,238
10,Cáceres,188,Torre de Santa María,610,306,304
10,Cáceres,185,Torrecilla de los Ángeles,660,344,316
10,Cáceres,186,Torrecillas de la Tiesa,1161,583,578
10,Cáceres,190,Torrejón el Rubio,625,316,309
10,Cáceres,189,Torrejoncillo,3203,1563,1640
10,Cáceres,191,Torremenga,653,348,305
10,Cáceres,192,Torremocha,941,462,479
10,Cáceres,193,Torreorgaz,1743,851,892
10,Cáceres,194,Torrequemada,587,277,310
10,Cáceres,195,Trujillo,9085,4396,4689
10,Cáceres,196,Valdastillas,334,174,160
10,Cáceres,197,Valdecañas de Tajo,135,69,66
10,Cáceres,198,Valdefuentes,1328,658,670
10,Cáceres,199,Valdehúncar,194,102,92
10,Cáceres,200,Valdelacasa de Tajo,439,226,213
10,Cáceres,201,Valdemorales,210,108,102
10,Cáceres,202,Valdeobispo,728,356,372
10,Cáceres,203,Valencia de Alcántara,5957,2972,2985
10,Cáceres,204,Valverde de la Vera,529,272,257
10,Cáceres,205,Valverde del Fresno,2426,1229,1197
10,Cáceres,902,Vegaviana,870,452,418
10,Cáceres,206,Viandar de la Vera,274,134,140
10,Cáceres,207,Villa del Campo,523,259,264
10,Cáceres,208,Villa del Rey,145,76,69
10,Cáceres,209,Villamesías,261,128,133
10,Cáceres,210,Villamiel,558,277,281
10,Cáceres,211,Villanueva de la Sierra,450,224,226
10,Cáceres,212,Villanueva de la Vera,2167,1102,1065
10,Cáceres,214,Villar de Plasencia,232,117,115
10,Cáceres,213,Villar del Pedroso,649,341,308
10,Cáceres,215,Villasbuenas de Gata,400,208,192
10,Cáceres,216,Zarza de Granadilla,1872,961,911
10,Cáceres,217,Zarza de Montánchez,590,291,299
10,Cáceres,218,Zarza la Mayor,1384,685,699
10,Cáceres,219,Zorita,1549,777,772
11,Cádiz,1,Alcalá de los Gazules,5439,2789,2650
11,Cádiz,2,Alcalá del Valle,5261,2668,2593
11,Cádiz,3,Algar,1478,766,712
11,Cádiz,4,Algeciras,114277,56421,57856
11,Cádiz,5,Algodonales,5719,2909,2810
11,Cádiz,6,Arcos de la Frontera,31410,15722,15688
11,Cádiz,7,Barbate,22921,11502,11419
11,Cádiz,8,"Barrios, Los",22948,11488,11460
11,Cádiz,901,Benalup-Casas Viejas,6991,3545,3446
11,Cádiz,9,Benaocaz,715,376,339
11,Cádiz,10,Bornos,8083,4028,4055
11,Cádiz,11,"Bosque, El",2094,1047,1047
11,Cádiz,12,Cádiz,122990,58233,64757
11,Cádiz,13,Castellar de la Frontera,3123,1566,1557
11,Cádiz,15,Chiclana de la Frontera,82212,41475,40737
11,Cádiz,16,Chipiona,18930,9500,9430
11,Cádiz,14,Conil de la Frontera,22116,11191,10925
11,Cádiz,17,Espera,3946,1974,1972
11,Cádiz,18,"Gastor, El",1828,957,871
11,Cádiz,19,Grazalema,2171,1090,1081
11,Cádiz,20,Jerez de la Frontera,211670,103676,107994
11,Cádiz,21,Jimena de la Frontera,10412,5386,5026
11,Cádiz,22,"Línea de la Concepción, La",62697,30818,31879
11,Cádiz,23,Medina-Sidonia,11781,6018,5763
11,Cádiz,24,Olvera,8397,4140,4257
11,Cádiz,25,Paterna de Rivera,5667,2918,2749
11,Cádiz,26,Prado del Rey,5668,2812,2856
11,Cádiz,27,"Puerto de Santa María, El",89142,43896,45246
11,Cádiz,28,Puerto Real,41537,20951,20586
11,Cádiz,29,Puerto Serrano,7174,3639,3535
11,Cádiz,30,Rota,29136,14547,14589
11,Cádiz,31,San Fernando,96361,47425,48936
11,Cádiz,902,San José del Valle,4460,2286,2174
11,Cádiz,33,San Roque,29536,14813,14723
11,Cádiz,32,Sanlúcar de Barrameda,67301,33569,33732
11,Cádiz,34,Setenil de las Bodegas,2894,1477,1417
11,Cádiz,35,Tarifa,18085,9204,8881
11,Cádiz,36,Torre Alháquime,789,404,385
11,Cádiz,37,Trebujena,7089,3558,3531
11,Cádiz,38,Ubrique,16877,8322,8555
11,Cádiz,39,Vejer de la Frontera,12882,6474,6408
11,Cádiz,40,Villaluenga del Rosario,448,236,212
11,Cádiz,41,Villamartín,12366,6203,6163
11,Cádiz,42,Zahara,1471,751,720
39,Cantabria,1,Alfoz de Lloredo,2530,1292,1238
39,Cantabria,2,Ampuero,4255,2175,2080
39,Cantabria,3,Anievas,333,168,165
39,Cantabria,4,Arenas de Iguña,1811,925,886
39,Cantabria,5,Argoños,1711,882,829
39,Cantabria,6,Arnuero,2122,1071,1051
39,Cantabria,7,Arredondo,506,284,222
39,Cantabria,8,"Astillero, El",18005,8809,9196
39,Cantabria,9,Bárcena de Cicero,4078,2130,1948
39,Cantabria,10,Bárcena de Pie de Concha,739,365,374
39,Cantabria,11,Bareyo,2021,1020,1001
39,Cantabria,12,Cabezón de la Sal,8350,4047,4303
39,Cantabria,13,Cabezón de Liébana,650,377,273
39,Cantabria,14,Cabuérniga,1046,553,493
39,Cantabria,15,Camaleño,1000,532,468
39,Cantabria,16,Camargo,31334,15419,15915
39,Cantabria,27,Campoo de Enmedio,3802,1953,1849
39,Cantabria,17,Campoo de Yuso,685,374,311
39,Cantabria,18,Cartes,5608,2853,2755
39,Cantabria,19,Castañeda,2619,1343,1276
39,Cantabria,20,Castro-Urdiales,32309,16295,16014
39,Cantabria,21,Cieza,583,298,285
39,Cantabria,22,Cillorigo de Liébana,1339,734,605
39,Cantabria,23,Colindres,8307,4092,4215
39,Cantabria,24,Comillas,2374,1125,1249
39,Cantabria,25,"Corrales de Buelna, Los",11448,5643,5805
39,Cantabria,26,Corvera de Toranzo,2165,1114,1051
39,Cantabria,28,Entrambasaguas,4781,2456,2325
39,Cantabria,29,Escalante,770,400,370
39,Cantabria,30,Guriezo,2424,1242,1182
39,Cantabria,31,Hazas de Cesto,1538,780,758
39,Cantabria,32,Hermandad de Campoo de Suso,1744,945,799
39,Cantabria,33,Herrerías,652,363,289
39,Cantabria,34,Lamasón,294,188,106
39,Cantabria,35,Laredo,11934,5714,6220
39,Cantabria,36,Liendo,1264,652,612
39,Cantabria,37,Liérganes,2435,1213,1222
39,Cantabria,38,Limpias,1875,924,951
39,Cantabria,39,Luena,672,368,304
39,Cantabria,40,Marina de Cudeyo,5306,2668,2638
39,Cantabria,41,Mazcuerras,2104,1082,1022
39,Cantabria,42,Medio Cudeyo,7598,3702,3896
39,Cantabria,43,Meruelo,1878,955,923
39,Cantabria,44,Miengo,4654,2362,2292
39,Cantabria,45,Miera,420,218,202
39,Cantabria,46,Molledo,1613,790,823
39,Cantabria,47,Noja,2580,1285,1295
39,Cantabria,48,Penagos,2020,1034,986
39,Cantabria,49,Peñarrubia,353,190,163
39,Cantabria,50,Pesaguero,324,188,136
39,Cantabria,51,Pesquera,71,38,33
39,Cantabria,52,Piélagos,23661,11877,11784
39,Cantabria,53,Polaciones,225,142,83
39,Cantabria,54,Polanco,5585,2789,2796
39,Cantabria,55,Potes,1452,714,738
39,Cantabria,56,Puente Viesgo,2843,1445,1398
39,Cantabria,57,Ramales de la Victoria,2805,1426,1379
39,Cantabria,58,Rasines,1011,542,469
39,Cantabria,59,Reinosa,9919,4689,5230
39,Cantabria,60,Reocín,8350,4117,4233
39,Cantabria,61,Ribamontán al Mar,4513,2282,2231
39,Cantabria,62,Ribamontán al Monte,2197,1144,1053
39,Cantabria,63,Rionansa,1078,608,470
39,Cantabria,64,Riotuerto,1622,795,827
39,Cantabria,65,"Rozas de Valdearroyo, Las",284,158,126
39,Cantabria,66,Ruente,1035,548,487
39,Cantabria,67,Ruesga,973,524,449
39,Cantabria,68,Ruiloba,790,401,389
39,Cantabria,69,San Felices de Buelna,2388,1187,1201
39,Cantabria,70,San Miguel de Aguayo,175,90,85
39,Cantabria,71,San Pedro del Romeral,488,269,219
39,Cantabria,72,San Roque de Riomiera,398,231,167
39,Cantabria,80,San Vicente de la Barquera,4344,2164,2180
39,Cantabria,73,Santa Cruz de Bezana,12369,6071,6298
39,Cantabria,74,Santa María de Cayón,9060,4608,4452
39,Cantabria,75,Santander,177123,81942,95181
39,Cantabria,76,Santillana del Mar,4215,2075,2140
39,Cantabria,77,Santiurde de Reinosa,293,169,124
39,Cantabria,78,Santiurde de Toranzo,1590,816,774
39,Cantabria,79,Santoña,11382,5598,5784
39,Cantabria,81,Saro,515,265,250
39,Cantabria,82,Selaya,1997,993,1004
39,Cantabria,83,Soba,1305,702,603
39,Cantabria,84,Solórzano,1030,554,476
39,Cantabria,85,Suances,8552,4245,4307
39,Cantabria,86,"Tojos, Los",430,253,177
39,Cantabria,87,Torrelavega,54827,26146,28681
39,Cantabria,88,Tresviso,70,48,22
39,Cantabria,89,Tudanca,151,105,46
39,Cantabria,90,Udías,873,437,436
39,Cantabria,95,Val de San Vicente,2825,1459,1366
39,Cantabria,91,Valdáliga,2313,1200,1113
39,Cantabria,92,Valdeolea,1098,569,529
39,Cantabria,93,Valdeprado del Río,327,188,139
39,Cantabria,94,Valderredible,1008,565,443
39,Cantabria,101,Valle de Villaverde,340,169,171
39,Cantabria,96,Vega de Liébana,821,430,391
39,Cantabria,97,Vega de Pas,808,407,401
39,Cantabria,98,Villacarriedo,1716,901,815
39,Cantabria,99,Villaescusa,3802,1897,1905
39,Cantabria,100,Villafufre,1083,568,515
39,Cantabria,102,Voto,2795,1491,1304
12,Castellón/Castelló,2,Aín,132,68,64
12,Castellón/Castelló,3,Albocàsser,1424,704,720
12,Castellón/Castelló,4,Alcalà de Xivert,8208,4214,3994
12,Castellón/Castelló,5,"Alcora, l'",10797,5467,5330
12,Castellón/Castelló,6,Alcudia de Veo,214,112,102
12,Castellón/Castelló,7,Alfondeguilla,876,438,438
12,Castellón/Castelló,8,Algimia de Almonacid,301,175,126
12,Castellón/Castelló,9,Almazora/Almassora,26186,13227,12959
12,Castellón/Castelló,10,Almedíjar,278,142,136
12,Castellón/Castelló,11,Almenara,6149,3063,3086
12,Castellón/Castelló,901,Alquerías del Niño Perdido,4507,2232,2275
12,Castellón/Castelló,12,Altura,3898,2008,1890
12,Castellón/Castelló,13,Arañuel,185,94,91
12,Castellón/Castelló,14,Ares del Maestrat,206,112,94
12,Castellón/Castelló,15,Argelita,96,53,43
12,Castellón/Castelló,16,Artana,2015,1037,978
12,Castellón/Castelló,1,Atzeneta del Maestrat,1325,690,635
12,Castellón/Castelló,17,Ayódar,197,103,94
12,Castellón/Castelló,18,Azuébar,336,173,163
12,Castellón/Castelló,20,Barracas,193,105,88
12,Castellón/Castelló,22,Bejís,429,249,180
12,Castellón/Castelló,24,Benafer,169,87,82
12,Castellón/Castelló,25,Benafigos,161,90,71
12,Castellón/Castelló,26,Benasal,1195,609,586
12,Castellón/Castelló,27,Benicarló,26491,13247,13244
12,Castellón/Castelló,28,Benicasim/Benicàssim,18989,9596,9393
12,Castellón/Castelló,29,Benlloch,1179,613,566
12,Castellón/Castelló,21,Betxí,5815,2896,2919
12,Castellón/Castelló,32,Borriana/Burriana,34744,17288,17456
12,Castellón/Castelló,31,Borriol,5276,2691,2585
12,Castellón/Castelló,33,Cabanes,3006,1539,1467
12,Castellón/Castelló,34,Càlig,2130,1084,1046
12,Castellón/Castelló,36,Canet lo Roig,817,404,413
12,Castellón/Castelló,37,Castell de Cabres,15,10,5
12,Castellón/Castelló,38,Castellfort,222,116,106
12,Castellón/Castelló,39,Castellnovo,1026,518,508
12,Castellón/Castelló,40,Castellón de la Plana/Castelló de la Plana,180185,88404,91781
12,Castellón/Castelló,41,Castillo de Villamalefa,110,70,40
12,Castellón/Castelló,42,Catí,824,419,405
12,Castellón/Castelló,43,Caudiel,753,390,363
12,Castellón/Castelló,44,Cervera del Maestre,711,341,370
12,Castellón/Castelló,52,Chert/Xert,862,431,431
12,Castellón/Castelló,53,Chilches/Xilxes,2925,1537,1388
12,Castellón/Castelló,55,Chodos/Xodos,118,65,53
12,Castellón/Castelló,56,Chóvar,346,176,170
12,Castellón/Castelló,45,Cinctorres,459,232,227
12,Castellón/Castelló,46,Cirat,233,130,103
12,Castellón/Castelló,48,Cortes de Arenoso,327,180,147
12,Castellón/Castelló,49,Costur,575,294,281
12,Castellón/Castelló,50,"Coves de Vinromà, les",1925,970,955
12,Castellón/Castelló,51,Culla,583,300,283
12,Castellón/Castelló,57,Eslida,906,447,459
12,Castellón/Castelló,58,Espadilla,102,52,50
12,Castellón/Castelló,59,Fanzara,365,184,181
12,Castellón/Castelló,60,Figueroles,571,286,285
12,Castellón/Castelló,61,Forcall,510,253,257
12,Castellón/Castelló,63,Fuente la Reina,56,32,24
12,Castellón/Castelló,64,Fuentes de Ayódar,143,76,67
12,Castellón/Castelló,65,Gaibiel,184,103,81
12,Castellón/Castelló,67,Geldo,671,348,323
12,Castellón/Castelló,68,Herbés,57,33,24
12,Castellón/Castelló,69,Higueras,49,25,24
12,Castellón/Castelló,70,"Jana, la",739,381,358
12,Castellón/Castelló,71,Jérica,1621,818,803
12,Castellón/Castelló,74,"Llosa, la",981,493,488
12,Castellón/Castelló,72,Lucena del Cid,1446,730,716
12,Castellón/Castelló,73,Ludiente,190,105,85
12,Castellón/Castelló,75,"Mata de Morella, la",208,106,102
12,Castellón/Castelló,76,Matet,95,46,49
12,Castellón/Castelló,77,Moncofa,6501,3360,3141
12,Castellón/Castelló,78,Montán,404,198,206
12,Castellón/Castelló,79,Montanejos,607,298,309
12,Castellón/Castelló,80,Morella,2724,1349,1375
12,Castellón/Castelló,81,Navajas,798,421,377
12,Castellón/Castelló,82,Nules,13573,6758,6815
12,Castellón/Castelló,83,Olocau del Rey,133,72,61
12,Castellón/Castelló,84,Onda,25572,12967,12605
12,Castellón/Castelló,85,Oropesa del Mar/Orpesa,9878,5229,4649
12,Castellón/Castelló,87,Palanques,33,18,15
12,Castellón/Castelló,88,Pavías,59,35,24
12,Castellón/Castelló,89,Peníscola/Peñíscola,8182,4205,3977
12,Castellón/Castelló,90,Pina de Montalgrao,139,69,70
12,Castellón/Castelló,93,"Pobla de Benifassà, la",254,134,120
12,Castellón/Castelló,94,"Pobla Tornesa, la",1164,611,553
12,Castellón/Castelló,91,Portell de Morella,226,115,111
12,Castellón/Castelló,92,Puebla de Arenoso,174,93,81
12,Castellón/Castelló,95,Ribesalbes,1297,653,644
12,Castellón/Castelló,96,Rossell,1097,579,518
12,Castellón/Castelló,97,Sacañet,72,44,28
12,Castellón/Castelló,98,"Salzadella, la",817,411,406
12,Castellón/Castelló,101,San Rafael del Río,546,278,268
12,Castellón/Castelló,902,Sant Joan de Moró,3025,1580,1445
12,Castellón/Castelló,99,Sant Jordi/San Jorge,1127,579,548
12,Castellón/Castelló,100,Sant Mateu,2066,1038,1028
12,Castellón/Castelló,102,Santa Magdalena de Pulpis,891,477,414
12,Castellón/Castelló,103,Sarratella,94,48,46
12,Castellón/Castelló,104,Segorbe,9089,4460,4629
12,Castellón/Castelló,105,Sierra Engarcerán,1048,559,489
12,Castellón/Castelló,106,Soneja,1514,747,767
12,Castellón/Castelló,107,Sot de Ferrer,439,226,213
12,Castellón/Castelló,108,Sueras/Suera,650,336,314
12,Castellón/Castelló,109,Tales,889,446,443
12,Castellón/Castelló,110,Teresa,286,142,144
12,Castellón/Castelló,111,Tírig,540,286,254
12,Castellón/Castelló,112,Todolella,152,85,67
12,Castellón/Castelló,113,Toga,123,57,66
12,Castellón/Castelló,114,Torás,250,130,120
12,Castellón/Castelló,115,"Toro, El",269,151,118
12,Castellón/Castelló,116,Torralba del Pinar,49,23,26
12,Castellón/Castelló,119,"Torre d'En Besora, la",179,102,77
12,Castellón/Castelló,120,"Torre d'en Doménec, la",226,111,115
12,Castellón/Castelló,117,Torreblanca,5726,2936,2790
12,Castellón/Castelló,118,Torrechiva,90,56,34
12,Castellón/Castelló,121,Traiguera,1576,805,771
12,Castellón/Castelló,122,"Useras/Useres, les",964,497,467
12,Castellón/Castelló,124,Vall d'Alba,3041,1576,1465
12,Castellón/Castelló,125,Vall de Almonacid,270,143,127
12,Castellón/Castelló,126,"Vall d'Uixó, la",32202,15994,16208
12,Castellón/Castelló,123,Vallat,63,30,33
12,Castellón/Castelló,127,Vallibona,90,48,42
12,Castellón/Castelló,128,Vilafamés,1920,1001,919
12,Castellón/Castelló,132,Vilanova d'Alcolea,674,357,317
12,Castellón/Castelló,134,Vilar de Canes,186,100,86
12,Castellón/Castelló,135,Vila-real,51180,25518,25662
12,Castellón/Castelló,136,"Vilavella, la",3272,1633,1639
12,Castellón/Castelló,129,Villafranca del Cid/Vilafranca,2399,1184,1215
12,Castellón/Castelló,130,Villahermosa del Río,491,264,227
12,Castellón/Castelló,131,Villamalur,82,45,37
12,Castellón/Castelló,133,Villanueva de Viver,69,38,31
12,Castellón/Castelló,137,Villores,43,23,20
12,Castellón/Castelló,138,Vinaròs,28829,14318,14511
12,Castellón/Castelló,139,Vistabella del Maestrazgo,402,211,191
12,Castellón/Castelló,140,Viver,1633,851,782
12,Castellón/Castelló,141,Zorita del Maestrazgo,140,72,68
12,Castellón/Castelló,142,Zucaina,184,101,83
13,Ciudad Real,1,Abenójar,1547,793,754
13,Ciudad Real,2,Agudo,1814,925,889
13,Ciudad Real,3,Alamillo,491,248,243
13,Ciudad Real,4,Albaladejo,1461,771,690
13,Ciudad Real,5,Alcázar de San Juan,31973,15689,16284
13,Ciudad Real,6,Alcoba,659,335,324
13,Ciudad Real,7,Alcolea de Calatrava,1549,781,768
13,Ciudad Real,8,Alcubillas,543,278,265
13,Ciudad Real,9,Aldea del Rey,1857,946,911
13,Ciudad Real,10,Alhambra,1084,546,538
13,Ciudad Real,11,Almadén,5893,2836,3057
13,Ciudad Real,12,Almadenejos,483,252,231
13,Ciudad Real,13,Almagro,9100,4492,4608
13,Ciudad Real,14,Almedina,620,316,304
13,Ciudad Real,15,Almodóvar del Campo,6662,3357,3305
13,Ciudad Real,16,Almuradiel,890,438,452
13,Ciudad Real,17,Anchuras,342,185,157
13,Ciudad Real,903,Arenales de San Gregorio,703,363,340
13,Ciudad Real,18,Arenas de San Juan,1064,540,524
13,Ciudad Real,19,Argamasilla de Alba,7245,3664,3581
13,Ciudad Real,20,Argamasilla de Calatrava,6013,3034,2979
13,Ciudad Real,21,Arroba de los Montes,485,258,227
13,Ciudad Real,22,Ballesteros de Calatrava,455,232,223
13,Ciudad Real,23,Bolaños de Calatrava,12195,6228,5967
13,Ciudad Real,24,Brazatortas,1068,556,512
13,Ciudad Real,25,Cabezarados,331,170,161
13,Ciudad Real,26,Cabezarrubias del Puerto,547,288,259
13,Ciudad Real,27,Calzada de Calatrava,4238,2113,2125
13,Ciudad Real,28,Campo de Criptana,14594,7377,7217
13,Ciudad Real,29,Cañada de Calatrava,117,66,51
13,Ciudad Real,30,Caracuel de Calatrava,170,97,73
13,Ciudad Real,31,Carrión de Calatrava,3047,1526,1521
13,Ciudad Real,32,Carrizosa,1406,698,708
13,Ciudad Real,33,Castellar de Santiago,2189,1095,1094
13,Ciudad Real,38,Chillón,2007,977,1030
13,Ciudad Real,34,Ciudad Real,74872,35452,39420
13,Ciudad Real,35,Corral de Calatrava,1141,576,565
13,Ciudad Real,36,"Cortijos, Los",966,498,468
13,Ciudad Real,37,Cózar,1195,605,590
13,Ciudad Real,39,Daimiel,18706,9323,9383
13,Ciudad Real,40,Fernán Caballero,1093,541,552
13,Ciudad Real,41,Fontanarejo,287,157,130
13,Ciudad Real,42,Fuencaliente,1096,578,518
13,Ciudad Real,43,Fuenllana,268,130,138
13,Ciudad Real,44,Fuente el Fresno,3547,1834,1713
13,Ciudad Real,45,Granátula de Calatrava,863,417,446
13,Ciudad Real,46,Guadalmez,886,447,439
13,Ciudad Real,47,Herencia,9053,4630,4423
13,Ciudad Real,48,Hinojosas de Calatrava,508,261,247
13,Ciudad Real,49,Horcajo de los Montes,987,490,497
13,Ciudad Real,50,"Labores, Las",647,320,327
13,Ciudad Real,904,Llanos del Caudillo,757,389,368
13,Ciudad Real,51,Luciana,405,213,192
13,Ciudad Real,52,Malagón,8556,4246,4310
13,Ciudad Real,53,Manzanares,19118,9526,9592
13,Ciudad Real,54,Membrilla,6272,3154,3118
13,Ciudad Real,55,Mestanza,785,382,403
13,Ciudad Real,56,Miguelturra,14856,7540,7316
13,Ciudad Real,57,Montiel,1502,784,718
13,Ciudad Real,58,Moral de Calatrava,5551,2771,2780
13,Ciudad Real,59,Navalpino,250,127,123
13,Ciudad Real,60,Navas de Estena,291,160,131
13,Ciudad Real,61,Pedro Muñoz,7991,4100,3891
13,Ciudad Real,62,Picón,709,372,337
13,Ciudad Real,63,Piedrabuena,4735,2416,2319
13,Ciudad Real,64,Poblete,2159,1127,1032
13,Ciudad Real,65,Porzuna,3966,2049,1917
13,Ciudad Real,66,Pozuelo de Calatrava,3365,1717,1648
13,Ciudad Real,67,"Pozuelos de Calatrava, Los",431,226,205
13,Ciudad Real,68,Puebla de Don Rodrigo,1253,676,577
13,Ciudad Real,69,Puebla del Príncipe,780,391,389
13,Ciudad Real,70,Puerto Lápice,1004,507,497
13,Ciudad Real,71,Puertollano,51550,25132,26418
13,Ciudad Real,72,Retuerta del Bullaque,1063,587,476
13,Ciudad Real,901,"Robledo, El",1287,682,605
13,Ciudad Real,902,Ruidera,641,326,315
13,Ciudad Real,73,Saceruela,619,326,293
13,Ciudad Real,74,San Carlos del Valle,1209,622,587
13,Ciudad Real,75,San Lorenzo de Calatrava,232,118,114
13,Ciudad Real,76,Santa Cruz de los Cáñamos,559,278,281
13,Ciudad Real,77,Santa Cruz de Mudela,4537,2266,2271
13,Ciudad Real,78,Socuéllamos,13155,6714,6441
13,Ciudad Real,80,Solana del Pino,383,201,182
13,Ciudad Real,79,"Solana, La",16113,8169,7944
13,Ciudad Real,81,Terrinches,793,410,383
13,Ciudad Real,82,Tomelloso,38900,19639,19261
13,Ciudad Real,83,Torralba de Calatrava,3132,1542,1590
13,Ciudad Real,84,Torre de Juan Abad,1169,569,600
13,Ciudad Real,85,Torrenueva,2936,1473,1463
13,Ciudad Real,86,Valdemanco del Esteras,210,112,98
13,Ciudad Real,87,Valdepeñas,30869,15151,15718
13,Ciudad Real,88,Valenzuela de Calatrava,719,332,387
13,Ciudad Real,89,Villahermosa,2136,1027,1109
13,Ciudad Real,90,Villamanrique,1346,671,675
13,Ciudad Real,91,Villamayor de Calatrava,618,308,310
13,Ciudad Real,92,Villanueva de la Fuente,2372,1212,1160
13,Ciudad Real,93,Villanueva de los Infantes,5581,2764,2817
13,Ciudad Real,94,Villanueva de San Carlos,335,174,161
13,Ciudad Real,95,Villar del Pozo,91,51,40
13,Ciudad Real,96,Villarrubia de los Ojos,11072,5601,5471
13,Ciudad Real,97,Villarta de San Juan,3026,1538,1488
13,Ciudad Real,98,Viso del Marqués,2616,1291,1325
14,Córdoba,1,Adamuz,4368,2234,2134
14,Córdoba,2,Aguilar de la Frontera,13671,6898,6773
14,Córdoba,3,Alcaracejos,1529,739,790
14,Córdoba,4,Almedinilla,2501,1259,1242
14,Córdoba,5,Almodóvar del Río,7997,4034,3963
14,Córdoba,6,Añora,1554,773,781
14,Córdoba,7,Baena,20358,10381,9977
14,Córdoba,8,Belalcázar,3452,1665,1787
14,Córdoba,9,Belmez,3289,1603,1686
14,Córdoba,10,Benamejí,5121,2549,2572
14,Córdoba,11,"Blázquez, Los",721,372,349
14,Córdoba,12,Bujalance,7792,3894,3898
14,Córdoba,13,Cabra,20835,10280,10555
14,Córdoba,14,Cañete de las Torres,3087,1583,1504
14,Córdoba,15,Carcabuey,2668,1349,1319
14,Córdoba,16,Cardeña,1634,826,808
14,Córdoba,17,"Carlota, La",13903,7001,6902
14,Córdoba,18,"Carpio, El",4582,2273,2309
14,Córdoba,19,Castro del Río,8108,4035,4073
14,Córdoba,20,Conquista,455,222,233
14,Córdoba,21,Córdoba,328704,157969,170735
14,Córdoba,22,Doña Mencía,4982,2442,2540
14,Córdoba,23,Dos Torres,2494,1231,1263
14,Córdoba,24,Encinas Reales,2407,1199,1208
14,Córdoba,25,Espejo,3510,1767,1743
14,Córdoba,26,Espiel,2459,1245,1214
14,Córdoba,27,Fernán-Núñez,9848,4945,4903
14,Córdoba,28,Fuente la Lancha,360,184,176
14,Córdoba,29,Fuente Obejuna,5043,2586,2457
14,Córdoba,30,Fuente Palmera,11112,5607,5505
14,Córdoba,31,Fuente-Tójar,744,356,388
14,Córdoba,32,"Granjuela, La",498,258,240
14,Córdoba,33,Guadalcázar,1595,796,799
14,Córdoba,34,"Guijo, El",392,202,190
14,Córdoba,35,Hinojosa del Duque,7172,3497,3675
14,Córdoba,36,Hornachuelos,4703,2360,2343
14,Córdoba,37,Iznájar,4725,2383,2342
14,Córdoba,38,Lucena,42754,21282,21472
14,Córdoba,39,Luque,3229,1624,1605
14,Córdoba,40,Montalbán de Córdoba,4475,2255,2220
14,Córdoba,41,Montemayor,4069,2031,2038
14,Córdoba,42,Montilla,23752,11753,11999
14,Córdoba,43,Montoro,9801,4821,4980
14,Córdoba,44,Monturque,1990,991,999
14,Córdoba,45,Moriles,3907,1951,1956
14,Córdoba,46,Nueva Carteya,5531,2800,2731
14,Córdoba,47,Obejo,1985,1013,972
14,Córdoba,48,Palenciana,1589,796,793
14,Córdoba,49,Palma del Río,21582,10772,10810
14,Córdoba,50,Pedro Abad,2977,1510,1467
14,Córdoba,51,Pedroche,1658,812,846
14,Córdoba,52,Peñarroya-Pueblonuevo,11600,5603,5997
14,Córdoba,53,Posadas,7554,3775,3779
14,Córdoba,54,Pozoblanco,17519,8562,8957
14,Córdoba,55,Priego de Córdoba,23171,11355,11816
14,Córdoba,56,Puente Genil,30244,15072,15172
14,Córdoba,57,"Rambla, La",7580,3807,3773
14,Córdoba,58,Rute,10560,5272,5288
14,Córdoba,59,San Sebastián de los Ballesteros,840,423,417
14,Córdoba,61,Santa Eufemia,916,466,450
14,Córdoba,60,Santaella,6142,3107,3035
14,Córdoba,62,Torrecampo,1210,594,616
14,Córdoba,63,Valenzuela,1289,634,655
14,Córdoba,64,Valsequillo,392,186,206
14,Córdoba,65,"Victoria, La",2385,1188,1197
14,Córdoba,66,Villa del Río,7473,3735,3738
14,Córdoba,67,Villafranca de Córdoba,4876,2513,2363
14,Córdoba,68,Villaharta,751,378,373
14,Córdoba,69,Villanueva de Córdoba,9326,4639,4687
14,Córdoba,70,Villanueva del Duque,1582,796,786
14,Córdoba,71,Villanueva del Rey,1134,574,560
14,Córdoba,72,Villaralto,1262,617,645
14,Córdoba,73,Villaviciosa de Córdoba,3511,1778,1733
14,Córdoba,74,"Viso, El",2723,1348,1375
14,Córdoba,75,Zuheros,710,359,351
15,"Coruña, A",1,Abegondo,5664,2804,2860
15,"Coruña, A",2,Ames,29689,14361,15328
15,"Coruña, A",3,Aranga,2051,1042,1009
15,"Coruña, A",4,Ares,5801,2871,2930
15,"Coruña, A",5,Arteixo,31005,15500,15505
15,"Coruña, A",6,Arzúa,6276,3104,3172
15,"Coruña, A",7,"Baña, A",3849,1842,2007
15,"Coruña, A",8,Bergondo,6738,3246,3492
15,"Coruña, A",9,Betanzos,13445,6390,7055
15,"Coruña, A",10,Boimorto,2154,1093,1061
15,"Coruña, A",11,Boiro,19144,9373,9771
15,"Coruña, A",12,Boqueixón,4370,2155,2215
15,"Coruña, A",13,Brión,7435,3611,3824
15,"Coruña, A",14,Cabana de Bergantiños,4716,2320,2396
15,"Coruña, A",15,Cabanas,3287,1607,1680
15,"Coruña, A",16,Camariñas,5874,2875,2999
15,"Coruña, A",17,Cambre,23999,11784,12215
15,"Coruña, A",18,"Capela, A",1366,681,685
15,"Coruña, A",19,Carballo,31366,15363,16003
15,"Coruña, A",901,Cariño,4337,2165,2172
15,"Coruña, A",20,Carnota,4504,2155,2349
15,"Coruña, A",21,Carral,6123,3016,3107
15,"Coruña, A",22,Cedeira,7246,3626,3620
15,"Coruña, A",23,Cee,7808,3747,4061
15,"Coruña, A",24,Cerceda,5265,2565,2700
15,"Coruña, A",25,Cerdido,1258,604,654
15,"Coruña, A",26,Cesuras,2131,1045,1086
15,"Coruña, A",27,Coirós,1751,865,886
15,"Coruña, A",28,Corcubión,1654,809,845
15,"Coruña, A",29,Coristanco,6875,3289,3586
15,"Coruña, A",30,"Coruña, A",245923,114279,131644
15,"Coruña, A",31,Culleredo,29415,14336,15079
15,"Coruña, A",32,Curtis,4112,2058,2054
15,"Coruña, A",33,Dodro,2934,1435,1499
15,"Coruña, A",34,Dumbría,3216,1543,1673
15,"Coruña, A",35,Fene,13639,6520,7119
15,"Coruña, A",36,Ferrol,71232,33573,37659
15,"Coruña, A",37,Fisterra,4907,2481,2426
15,"Coruña, A",38,Frades,2509,1255,1254
15,"Coruña, A",39,Irixoa,1442,726,716
15,"Coruña, A",41,"Laracha, A",11375,5582,5793
15,"Coruña, A",40,Laxe,3267,1632,1635
15,"Coruña, A",42,Lousame,3493,1682,1811
15,"Coruña, A",43,Malpica de Bergantiños,5875,2847,3028
15,"Coruña, A",44,Mañón,1507,736,771
15,"Coruña, A",45,Mazaricos,4141,1965,2176
15,"Coruña, A",46,Melide,7313,3588,3725
15,"Coruña, A",47,Mesía,2849,1428,1421
15,"Coruña, A",48,Miño,5786,2861,2925
15,"Coruña, A",49,Moeche,1335,631,704
15,"Coruña, A",50,Monfero,2109,1071,1038
15,"Coruña, A",51,Mugardos,5470,2660,2810
15,"Coruña, A",53,Muros,9281,4491,4790
15,"Coruña, A",52,Muxía,5162,2509,2653
15,"Coruña, A",54,Narón,39450,19197,20253
15,"Coruña, A",55,Neda,5413,2638,2775
15,"Coruña, A",56,Negreira,7091,3428,3663
15,"Coruña, A",57,Noia,14659,7057,7602
15,"Coruña, A",58,Oleiros,34470,16795,17675
15,"Coruña, A",59,Ordes,12939,6315,6624
15,"Coruña, A",60,Oroso,7431,3693,3738
15,"Coruña, A",61,Ortigueira,6064,2886,3178
15,"Coruña, A",62,Outes,7010,3338,3672
15,"Coruña, A",63,Oza dos Ríos,3204,1620,1584
15,"Coruña, A",64,Paderne,2534,1254,1280
15,"Coruña, A",65,Padrón,8707,4168,4539
15,"Coruña, A",66,"Pino, O",4708,2350,2358
15,"Coruña, A",67,"Pobra do Caramiñal, A",9646,4708,4938
15,"Coruña, A",68,Ponteceso,5964,2989,2975
15,"Coruña, A",69,Pontedeume,8213,3952,4261
15,"Coruña, A",70,"Pontes de García Rodríguez, As",10564,5212,5352
15,"Coruña, A",71,Porto do Son,9613,4793,4820
15,"Coruña, A",72,Rianxo,11598,5667,5931
15,"Coruña, A",73,Ribeira,27811,13761,14050
15,"Coruña, A",74,Rois,4818,2297,2521
15,"Coruña, A",75,Sada,15075,7464,7611
15,"Coruña, A",76,San Sadurniño,3020,1493,1527
15,"Coruña, A",77,Santa Comba,9913,4769,5144
15,"Coruña, A",78,Santiago de Compostela,96041,44698,51343
15,"Coruña, A",79,Santiso,1785,927,858
15,"Coruña, A",80,Sobrado,2016,1031,985
15,"Coruña, A",81,"Somozas, As",1249,630,619
15,"Coruña, A",82,Teo,17942,8802,9140
15,"Coruña, A",83,Toques,1265,654,611
15,"Coruña, A",84,Tordoia,3817,1807,2010
15,"Coruña, A",85,Touro,3919,1938,1981
15,"Coruña, A",86,Trazo,3343,1639,1704
15,"Coruña, A",88,Val do Dubra,4136,1998,2138
15,"Coruña, A",87,Valdoviño,6811,3321,3490
15,"Coruña, A",89,Vedra,5008,2437,2571
15,"Coruña, A",91,Vilarmaior,1247,648,599
15,"Coruña, A",90,Vilasantar,1362,708,654
15,"Coruña, A",92,Vimianzo,7849,3787,4062
15,"Coruña, A",93,Zas,4983,2413,2570
16,Cuenca,1,Abia de la Obispalía,83,54,29
16,Cuenca,2,"Acebrón, El",238,122,116
16,Cuenca,3,Alarcón,159,75,84
16,Cuenca,4,Albaladejo del Cuende,308,159,149
16,Cuenca,5,Albalate de las Nogueras,297,160,137
16,Cuenca,6,Albendea,157,74,83
16,Cuenca,7,"Alberca de Záncara, La",1612,824,788
16,Cuenca,8,Alcalá de la Vega,111,61,50
16,Cuenca,9,Alcantud,81,43,38
16,Cuenca,10,Alcázar del Rey,158,73,85
16,Cuenca,11,Alcohujate,42,25,17
16,Cuenca,12,Alconchel de la Estrella,120,72,48
16,Cuenca,13,Algarra,22,15,7
16,Cuenca,14,Aliaguilla,735,391,344
16,Cuenca,15,"Almarcha, La",472,258,214
16,Cuenca,16,Almendros,275,150,125
16,Cuenca,17,Almodóvar del Pinar,461,241,220
16,Cuenca,18,Almonacid del Marquesado,455,235,220
16,Cuenca,19,Altarejos,188,98,90
16,Cuenca,20,Arandilla del Arroyo,20,13,7
16,Cuenca,905,Arcas del Villar,1438,728,710
16,Cuenca,22,Arcos de la Sierra,102,57,45
16,Cuenca,24,Arguisuelas,128,69,59
16,Cuenca,25,Arrancacepas,27,14,13
16,Cuenca,26,Atalaya del Cañavate,121,58,63
16,Cuenca,27,Barajas de Melo,1071,565,506
16,Cuenca,29,Barchín del Hoyo,81,47,34
16,Cuenca,30,Bascuñana de San Pedro,22,13,9
16,Cuenca,31,Beamud,53,24,29
16,Cuenca,32,Belinchón,372,192,180
16,Cuenca,33,Belmonte,2001,976,1025
16,Cuenca,34,Belmontejo,211,114,97
16,Cuenca,35,Beteta,325,155,170
16,Cuenca,36,Boniches,148,73,75
16,Cuenca,38,Buciegas,49,24,25
16,Cuenca,39,Buenache de Alarcón,583,310,273
16,Cuenca,40,Buenache de la Sierra,106,67,39
16,Cuenca,41,Buendía,453,242,211
16,Cuenca,42,Campillo de Altobuey,1561,755,806
16,Cuenca,43,Campillos-Paravientos,123,63,60
16,Cuenca,44,Campillos-Sierra,49,24,25
16,Cuenca,901,Campos del Paraíso,891,443,448
16,Cuenca,45,Canalejas del Arroyo,283,155,128
16,Cuenca,46,Cañada del Hoyo,304,150,154
16,Cuenca,47,Cañada Juncosa,286,154,132
16,Cuenca,48,Cañamares,533,286,247
16,Cuenca,49,"Cañavate, El",155,77,78
16,Cuenca,50,Cañaveras,359,188,171
16,Cuenca,51,Cañaveruelas,157,81,76
16,Cuenca,52,Cañete,831,426,405
16,Cuenca,53,Cañizares,536,282,254
16,Cuenca,55,Carboneras de Guadazaón,801,407,394
16,Cuenca,56,Cardenete,560,291,269
16,Cuenca,57,Carrascosa,95,61,34
16,Cuenca,58,Carrascosa de Haro,124,63,61
16,Cuenca,60,Casas de Benítez,985,488,497
16,Cuenca,61,Casas de Fernando Alonso,1410,747,663
16,Cuenca,62,Casas de Garcimolina,32,20,12
16,Cuenca,63,Casas de Guijarro,140,76,64
16,Cuenca,64,Casas de Haro,885,470,415
16,Cuenca,65,Casas de los Pinos,539,256,283
16,Cuenca,66,Casasimarro,3220,1666,1554
16,Cuenca,67,Castejón,151,78,73
16,Cuenca,68,Castillejo de Iniesta,209,120,89
16,Cuenca,70,Castillejo-Sierra,34,19,15
16,Cuenca,72,Castillo de Garcimuñoz,165,88,77
16,Cuenca,71,Castillo-Albaráñez,21,9,12
16,Cuenca,73,Cervera del Llano,253,131,122
16,Cuenca,23,Chillarón de Cuenca,569,307,262
16,Cuenca,81,Chumillas,63,35,28
16,Cuenca,74,"Cierva, La",52,32,20
16,Cuenca,78,Cuenca,56107,26954,29153
16,Cuenca,79,Cueva del Hierro,36,23,13
16,Cuenca,82,Enguídanos,362,193,169
16,Cuenca,83,Fresneda de Altarejos,63,32,31
16,Cuenca,84,Fresneda de la Sierra,54,29,25
16,Cuenca,85,"Frontera, La",189,101,88
16,Cuenca,86,Fuente de Pedro Naharro,1360,705,655
16,Cuenca,87,Fuentelespino de Haro,283,147,136
16,Cuenca,88,Fuentelespino de Moya,128,69,59
16,Cuenca,904,Fuentenava de Jábaga,589,304,285
16,Cuenca,89,Fuentes,474,250,224
16,Cuenca,91,Fuertescusa,81,42,39
16,Cuenca,92,Gabaldón,195,115,80
16,Cuenca,93,Garaballa,81,43,38
16,Cuenca,94,Gascueña,185,97,88
16,Cuenca,95,Graja de Campalbo,103,53,50
16,Cuenca,96,Graja de Iniesta,423,226,197
16,Cuenca,97,Henarejos,191,90,101
16,Cuenca,98,"Herrumblar, El",747,388,359
16,Cuenca,99,"Hinojosa, La",230,113,117
16,Cuenca,100,"Hinojosos, Los",940,464,476
16,Cuenca,101,"Hito, El",166,87,79
16,Cuenca,102,Honrubia,1757,889,868
16,Cuenca,103,Hontanaya,364,193,171
16,Cuenca,104,Hontecillas,66,35,31
16,Cuenca,106,Horcajo de Santiago,3881,2008,1873
16,Cuenca,107,Huélamo,116,71,45
16,Cuenca,108,Huelves,68,35,33
16,Cuenca,109,Huérguina,45,23,22
16,Cuenca,110,Huerta de la Obispalía,132,80,52
16,Cuenca,111,Huerta del Marquesado,222,131,91
16,Cuenca,112,Huete,1924,985,939
16,Cuenca,113,Iniesta,4557,2261,2296
16,Cuenca,115,Laguna del Marquesado,54,28,26
16,Cuenca,116,Lagunaseca,80,43,37
16,Cuenca,117,Landete,1329,692,637
16,Cuenca,118,Ledaña,1846,927,919
16,Cuenca,119,Leganiel,203,106,97
16,Cuenca,121,"Majadas, Las",294,152,142
16,Cuenca,122,Mariana,315,161,154
16,Cuenca,123,Masegosa,88,50,38
16,Cuenca,124,"Mesas, Las",2535,1320,1215
16,Cuenca,125,Minglanilla,2413,1256,1157
16,Cuenca,126,Mira,1017,514,503
16,Cuenca,128,Monreal del Llano,73,39,34
16,Cuenca,129,Montalbanejo,123,62,61
16,Cuenca,130,Montalbo,683,372,311
16,Cuenca,131,Monteagudo de las Salinas,128,76,52
16,Cuenca,132,Mota de Altarejos,39,26,13
16,Cuenca,133,Mota del Cuervo,6315,3179,3136
16,Cuenca,134,Motilla del Palancar,6141,3097,3044
16,Cuenca,135,Moya,186,101,85
16,Cuenca,137,Narboneta,49,26,23
16,Cuenca,139,Olivares de Júcar,371,198,173
16,Cuenca,140,Olmeda de la Cuesta,38,17,21
16,Cuenca,141,Olmeda del Rey,140,68,72
16,Cuenca,142,Olmedilla de Alarcón,159,94,65
16,Cuenca,143,Olmedilla de Eliz,22,13,9
16,Cuenca,145,Osa de la Vega,590,304,286
16,Cuenca,146,Pajarón,90,45,45
16,Cuenca,147,Pajaroncillo,72,44,28
16,Cuenca,148,Palomares del Campo,713,358,355
16,Cuenca,149,Palomera,181,96,85
16,Cuenca,150,Paracuellos,126,62,64
16,Cuenca,151,Paredes,70,40,30
16,Cuenca,152,"Parra de las Vegas, La",40,23,17
16,Cuenca,153,"Pedernoso, El",1265,648,617
16,Cuenca,154,"Pedroñeras, Las",6886,3590,3296
16,Cuenca,155,"Peral, El",796,449,347
16,Cuenca,156,"Peraleja, La",114,59,55
16,Cuenca,157,"Pesquera, La",246,131,115
16,Cuenca,158,"Picazo, El",711,361,350
16,Cuenca,159,Pinarejo,239,113,126
16,Cuenca,160,Pineda de Gigüela,75,37,38
16,Cuenca,161,Piqueras del Castillo,61,29,32
16,Cuenca,162,Portalrubio de Guadamejud,44,22,22
16,Cuenca,163,Portilla,72,37,35
16,Cuenca,165,Poyatos,75,43,32
16,Cuenca,166,Pozoamargo,345,179,166
16,Cuenca,908,Pozorrubielos de la Mancha,268,135,133
16,Cuenca,167,Pozorrubio,364,171,193
16,Cuenca,169,"Pozuelo, El",65,39,26
16,Cuenca,170,Priego,1092,545,547
16,Cuenca,171,"Provencio, El",2636,1301,1335
16,Cuenca,172,Puebla de Almenara,436,227,209
16,Cuenca,174,Puebla del Salvador,220,121,99
16,Cuenca,175,Quintanar del Rey,7886,4124,3762
16,Cuenca,176,Rada de Haro,67,32,35
16,Cuenca,177,Reíllo,125,67,58
16,Cuenca,181,Rozalén del Monte,74,33,41
16,Cuenca,185,Saceda-Trasierra,56,35,21
16,Cuenca,186,Saelices,520,267,253
16,Cuenca,187,Salinas del Manzano,86,47,39
16,Cuenca,188,Salmeroncillos,132,74,58
16,Cuenca,189,Salvacañete,316,171,145
16,Cuenca,190,San Clemente,7463,3816,3647
16,Cuenca,191,San Lorenzo de la Parrilla,1184,592,592
16,Cuenca,192,San Martín de Boniches,49,29,20
16,Cuenca,193,San Pedro Palmiches,77,44,33
16,Cuenca,194,Santa Cruz de Moya,271,143,128
16,Cuenca,196,Santa María de los Llanos,743,389,354
16,Cuenca,195,Santa María del Campo Rus,647,322,325
16,Cuenca,197,Santa María del Val,60,32,28
16,Cuenca,198,Sisante,1856,939,917
16,Cuenca,199,Solera de Gabaldón,25,11,14
16,Cuenca,909,Sotorribas,831,422,409
16,Cuenca,202,Talayuelas,981,506,475
16,Cuenca,203,Tarancón,16071,8123,7948
16,Cuenca,204,Tébar,322,168,154
16,Cuenca,205,Tejadillos,121,57,64
16,Cuenca,206,Tinajas,232,123,109
16,Cuenca,209,Torralba,143,84,59
16,Cuenca,211,Torrejoncillo del Rey,490,250,240
16,Cuenca,212,Torrubia del Campo,295,146,149
16,Cuenca,213,Torrubia del Castillo,42,25,17
16,Cuenca,215,Tragacete,310,169,141
16,Cuenca,216,Tresjuncos,346,181,165
16,Cuenca,217,Tribaldos,110,52,58
16,Cuenca,218,Uclés,226,120,106
16,Cuenca,219,Uña,98,48,50
16,Cuenca,906,"Valdecolmenas, Los",97,58,39
16,Cuenca,224,Valdemeca,92,52,40
16,Cuenca,225,Valdemorillo de la Sierra,83,49,34
16,Cuenca,227,Valdemoro-Sierra,130,79,51
16,Cuenca,228,Valdeolivas,247,149,98
16,Cuenca,902,Valdetórtola,160,92,68
16,Cuenca,903,"Valeras, Las",1633,864,769
16,Cuenca,231,Valhermoso de la Fuente,54,29,25
16,Cuenca,173,"Valle de Altomira, El",287,163,124
16,Cuenca,234,Valsalobre,37,21,16
16,Cuenca,236,Valverde de Júcar,1258,632,626
16,Cuenca,237,Valverdejo,95,47,48
16,Cuenca,238,Vara de Rey,602,316,286
16,Cuenca,239,Vega del Codorno,149,86,63
16,Cuenca,240,Vellisca,133,73,60
16,Cuenca,242,Villaconejos de Trabaque,443,223,220
16,Cuenca,243,Villaescusa de Haro,574,287,287
16,Cuenca,244,Villagarcía del Llano,830,423,407
16,Cuenca,245,Villalba de la Sierra,529,266,263
16,Cuenca,246,Villalba del Rey,585,318,267
16,Cuenca,247,Villalgordo del Marquesado,97,49,48
16,Cuenca,248,Villalpardo,1036,503,533
16,Cuenca,249,Villamayor de Santiago,3012,1551,1461
16,Cuenca,250,Villanueva de Guadamejud,89,50,39
16,Cuenca,251,Villanueva de la Jara,2296,1155,1141
16,Cuenca,253,Villar de Cañas,479,265,214
16,Cuenca,254,Villar de Domingo García,220,115,105
16,Cuenca,255,Villar de la Encina,166,86,80
16,Cuenca,263,Villar de Olalla,1246,665,581
16,Cuenca,258,Villar del Humo,236,133,103
16,Cuenca,259,Villar del Infantado,47,29,18
16,Cuenca,910,Villar y Velasco,102,54,48
16,Cuenca,264,Villarejo de Fuentes,554,280,274
16,Cuenca,265,Villarejo de la Peñuela,25,12,13
16,Cuenca,266,Villarejo-Periesteban,336,161,175
16,Cuenca,269,Villares del Saz,586,300,286
16,Cuenca,270,Villarrubio,235,129,106
16,Cuenca,271,Villarta,983,509,474
16,Cuenca,272,Villas de la Ventosa,281,146,135
16,Cuenca,273,Villaverde y Pasaconsol,346,181,165
16,Cuenca,274,Víllora,160,79,81
16,Cuenca,275,Vindel,11,6,5
16,Cuenca,276,Yémeda,28,19,9
16,Cuenca,277,Zafra de Záncara,142,75,67
16,Cuenca,278,Zafrilla,78,37,41
16,Cuenca,279,Zarza de Tajo,302,156,146
16,Cuenca,280,Zarzuela,220,117,103
20,Gipuzkoa,1,Abaltzisketa,330,179,151
20,Gipuzkoa,2,Aduna,457,245,212
20,Gipuzkoa,16,Aia,2038,1091,947
20,Gipuzkoa,3,Aizarnazabal,770,393,377
20,Gipuzkoa,4,Albiztur,322,171,151
20,Gipuzkoa,5,Alegia,1756,892,864
20,Gipuzkoa,6,Alkiza,380,198,182
20,Gipuzkoa,906,Altzaga,164,83,81
20,Gipuzkoa,7,Altzo,409,213,196
20,Gipuzkoa,8,Amezketa,972,512,460
20,Gipuzkoa,9,Andoain,14630,7282,7348
20,Gipuzkoa,10,Anoeta,1872,976,896
20,Gipuzkoa,11,Antzuola,2189,1114,1075
20,Gipuzkoa,12,Arama,217,109,108
20,Gipuzkoa,13,Aretxabaleta,6930,3539,3391
20,Gipuzkoa,55,Arrasate/Mondragón,22051,10964,11087
20,Gipuzkoa,14,Asteasu,1513,804,709
20,Gipuzkoa,903,Astigarraga,5304,2727,2577
20,Gipuzkoa,15,Ataun,1681,891,790
20,Gipuzkoa,17,Azkoitia,11463,5751,5712
20,Gipuzkoa,18,Azpeitia,14509,7299,7210
20,Gipuzkoa,904,Baliarrain,131,74,57
20,Gipuzkoa,19,Beasain,13792,6929,6863
20,Gipuzkoa,20,Beizama,170,99,71
20,Gipuzkoa,21,Belauntza,269,148,121
20,Gipuzkoa,22,Berastegi,1067,565,502
20,Gipuzkoa,74,Bergara,14763,7348,7415
20,Gipuzkoa,23,Berrobi,564,297,267
20,Gipuzkoa,24,Bidegoian,525,278,247
20,Gipuzkoa,29,Deba,5424,2740,2684
20,Gipuzkoa,69,Donostia/San Sebastián,186500,87553,98947
20,Gipuzkoa,30,Eibar,27439,13321,14118
20,Gipuzkoa,31,Elduain,239,125,114
20,Gipuzkoa,33,Elgeta,1139,584,555
20,Gipuzkoa,32,Elgoibar,11518,5739,5779
20,Gipuzkoa,67,Errenteria,39178,19060,20118
20,Gipuzkoa,66,Errezil,606,312,294
20,Gipuzkoa,34,Eskoriatza,4064,2081,1983
20,Gipuzkoa,35,Ezkio-Itsaso,602,312,290
20,Gipuzkoa,38,Gabiria,496,262,234
20,Gipuzkoa,37,Gaintza,119,72,47
20,Gipuzkoa,907,Gaztelu,170,96,74
20,Gipuzkoa,39,Getaria,2686,1350,1336
20,Gipuzkoa,40,Hernani,19354,9491,9863
20,Gipuzkoa,41,Hernialde,352,187,165
20,Gipuzkoa,36,Hondarribia,16795,8395,8400
20,Gipuzkoa,42,Ibarra,4268,2195,2073
20,Gipuzkoa,43,Idiazabal,2299,1169,1130
20,Gipuzkoa,44,Ikaztegieta,464,242,222
20,Gipuzkoa,45,Irun,61113,29906,31207
20,Gipuzkoa,46,Irura,1665,866,799
20,Gipuzkoa,47,Itsasondo,669,324,345
20,Gipuzkoa,48,Larraul,259,144,115
20,Gipuzkoa,902,Lasarte-Oria,18024,8812,9212
20,Gipuzkoa,49,Lazkao,5486,2792,2694
20,Gipuzkoa,50,Leaburu,362,185,177
20,Gipuzkoa,51,Legazpi,8638,4394,4244
20,Gipuzkoa,52,Legorreta,1491,767,724
20,Gipuzkoa,68,Leintz-Gatzaga,258,137,121
20,Gipuzkoa,53,Lezo,6054,3013,3041
20,Gipuzkoa,54,Lizartza,637,343,294
20,Gipuzkoa,901,Mendaro,1981,1018,963
20,Gipuzkoa,57,Mutiloa,252,135,117
20,Gipuzkoa,56,Mutriku,5225,2617,2608
20,Gipuzkoa,63,Oiartzun,9995,4995,5000
20,Gipuzkoa,58,Olaberria,942,472,470
20,Gipuzkoa,59,Oñati,11202,5562,5640
20,Gipuzkoa,76,Ordizia,9767,4830,4937
20,Gipuzkoa,905,Orendain,192,101,91
20,Gipuzkoa,60,Orexa,122,65,57
20,Gipuzkoa,61,Orio,5524,2808,2716
20,Gipuzkoa,62,Ormaiztegi,1312,675,637
20,Gipuzkoa,64,Pasaia,15849,7594,8255
20,Gipuzkoa,70,Segura,1473,746,727
20,Gipuzkoa,65,Soraluze/Placencia de las Armas,4018,2024,1994
20,Gipuzkoa,71,Tolosa,18836,9051,9785
20,Gipuzkoa,72,Urnieta,6214,3108,3106
20,Gipuzkoa,77,Urretxu,6853,3428,3425
20,Gipuzkoa,73,Usurbil,6111,3123,2988
20,Gipuzkoa,75,Villabona,5882,2979,2903
20,Gipuzkoa,78,Zaldibia,1528,806,722
20,Gipuzkoa,79,Zarautz,22760,11104,11656
20,Gipuzkoa,25,Zegama,1547,802,745
20,Gipuzkoa,26,Zerain,263,127,136
20,Gipuzkoa,27,Zestoa,3650,1923,1727
20,Gipuzkoa,28,Zizurkil,2994,1516,1478
20,Gipuzkoa,81,Zumaia,9626,4774,4852
20,Gipuzkoa,80,Zumarraga,10094,5028,5066
17,Girona,1,Agullana,853,434,419
17,Girona,2,Aiguaviva,792,393,399
17,Girona,3,Albanyà,164,90,74
17,Girona,4,Albons,739,387,352
17,Girona,6,Alp,1712,908,804
17,Girona,7,Amer,2283,1099,1184
17,Girona,8,Anglès,5662,2818,2844
17,Girona,9,Arbúcies,6527,3402,3125
17,Girona,10,Argelaguer,425,223,202
17,Girona,11,"Armentera, L'",871,436,435
17,Girona,12,Avinyonet de Puigventós,1566,800,766
17,Girona,15,Banyoles,19119,9582,9537
17,Girona,16,Bàscara,974,499,475
17,Girona,13,Begur,4148,2093,2055
17,Girona,18,Bellcaire d'Empordà,664,322,342
17,Girona,19,Besalú,2406,1153,1253
17,Girona,20,Bescanó,4839,2401,2438
17,Girona,21,Beuda,188,100,88
17,Girona,22,"Bisbal d'Empordà, La",10793,5452,5341
17,Girona,234,Biure,244,130,114
17,Girona,23,Blanes,39660,19927,19733
17,Girona,29,Boadella i les Escaules,248,123,125
17,Girona,24,Bolvir,373,200,173
17,Girona,25,Bordils,1742,886,856
17,Girona,26,Borrassà,701,357,344
17,Girona,27,Breda,3755,1883,1872
17,Girona,28,Brunyola,393,199,194
17,Girona,31,Cabanelles,248,137,111
17,Girona,30,Cabanes,930,494,436
17,Girona,32,Cadaqués,2938,1448,1490
17,Girona,33,Caldes de Malavella,7032,3521,3511
17,Girona,34,Calonge,10596,5320,5276
17,Girona,35,Camós,692,354,338
17,Girona,36,Campdevànol,3422,1682,1740
17,Girona,37,Campelles,137,66,71
17,Girona,38,Campllong,515,255,260
17,Girona,39,Camprodon,2466,1219,1247
17,Girona,40,Canet d'Adri,627,321,306
17,Girona,41,Cantallops,335,169,166
17,Girona,42,Capmany,608,316,292
17,Girona,44,Cassà de la Selva,9899,5100,4799
17,Girona,46,Castellfollit de la Roca,1025,525,500
17,Girona,47,Castelló d'Empúries,11910,6049,5861
17,Girona,48,Castell-Platja d'Aro,10765,5343,5422
17,Girona,189,"Cellera de Ter, La",2062,1033,1029
17,Girona,49,Celrà,5028,2507,2521
17,Girona,50,Cervià de Ter,909,459,450
17,Girona,51,Cistella,292,143,149
17,Girona,54,Colera,559,293,266
17,Girona,55,Colomers,193,94,99
17,Girona,57,Corçà,1273,622,651
17,Girona,56,Cornellà del Terri,2258,1153,1105
17,Girona,58,Crespià,256,130,126
17,Girona,901,"Cruïlles, Monells i Sant Sadurní de l'Heura",1273,647,626
17,Girona,60,Darnius,551,275,276
17,Girona,61,Das,216,120,96
17,Girona,62,"Escala, L'",10513,5345,5168
17,Girona,63,Espinelves,193,94,99
17,Girona,64,Espolla,407,203,204
17,Girona,65,Esponellà,447,226,221
17,Girona,5,"Far d'Empordà, El",568,287,281
17,Girona,66,Figueres,45123,22386,22737
17,Girona,67,Flaçà,1049,504,545
17,Girona,68,Foixà,317,160,157
17,Girona,69,Fontanals de Cerdanya,458,231,227
17,Girona,70,Fontanilles,154,87,67
17,Girona,71,Fontcoberta,1439,699,740
17,Girona,902,Forallac,1700,832,868
17,Girona,73,Fornells de la Selva,2462,1206,1256
17,Girona,74,Fortià,682,334,348
17,Girona,75,Garrigàs,409,214,195
17,Girona,76,Garrigoles,157,87,70
17,Girona,77,Garriguella,864,433,431
17,Girona,78,Ger,456,244,212
17,Girona,79,Girona,97292,46750,50542
17,Girona,80,Gombrèn,199,98,101
17,Girona,81,Gualta,368,199,169
17,Girona,82,Guils de Cerdanya,564,300,264
17,Girona,83,Hostalric,3980,2022,1958
17,Girona,84,Isòvol,318,180,138
17,Girona,85,Jafre,407,221,186
17,Girona,86,"Jonquera, La",3135,1592,1543
17,Girona,87,Juià,353,190,163
17,Girona,88,Lladó,755,374,381
17,Girona,89,Llagostera,8200,4240,3960
17,Girona,90,Llambilles,732,375,357
17,Girona,91,Llanars,506,260,246
17,Girona,92,Llançà,5018,2480,2538
17,Girona,93,Llers,1229,621,608
17,Girona,94,Llívia,1625,888,737
17,Girona,95,Lloret de Mar,40803,21255,19548
17,Girona,96,"Llosses, Les",214,127,87
17,Girona,102,Maçanet de Cabrenys,745,383,362
17,Girona,103,Maçanet de la Selva,7202,3675,3527
17,Girona,97,Madremanya,279,134,145
17,Girona,98,Maià de Montcal,453,230,223
17,Girona,100,Masarac,296,160,136
17,Girona,101,Massanes,708,380,328
17,Girona,99,Meranges,100,56,44
17,Girona,105,Mieres,337,173,164
17,Girona,106,Mollet de Peralada,174,91,83
17,Girona,107,Molló,356,171,185
17,Girona,109,Montagut i Oix,957,506,451
17,Girona,110,Mont-ras,1785,892,893
17,Girona,111,Navata,1258,624,634
17,Girona,112,Ogassa,248,146,102
17,Girona,114,Olot,33981,16932,17049
17,Girona,115,Ordis,363,194,169
17,Girona,116,Osor,456,229,227
17,Girona,117,Palafrugell,22942,11507,11435
17,Girona,118,Palamós,17830,8722,9108
17,Girona,119,Palau de Santa Eulàlia,101,58,43
17,Girona,121,Palau-sator,306,161,145
17,Girona,120,Palau-saverdera,1461,735,726
17,Girona,123,Palol de Revardit,476,242,234
17,Girona,124,Pals,2740,1382,1358
17,Girona,125,Pardines,158,92,66
17,Girona,126,Parlavà,404,208,196
17,Girona,128,Pau,586,291,295
17,Girona,129,Pedret i Marzà,190,100,90
17,Girona,130,"Pera, La",443,214,229
17,Girona,132,Peralada,1920,964,956
17,Girona,133,"Planes d'Hostoles, Les",1686,867,819
17,Girona,134,Planoles,302,165,137
17,Girona,135,Pont de Molins,540,275,265
17,Girona,136,Pontós,222,126,96
17,Girona,137,Porqueres,4509,2232,2277
17,Girona,140,"Port de la Selva, El",990,525,465
17,Girona,138,Portbou,1280,643,637
17,Girona,139,"Preses, Les",1779,871,908
17,Girona,141,Puigcerdà,8910,4476,4434
17,Girona,142,Quart,3358,1695,1663
17,Girona,43,Queralbs,185,105,80
17,Girona,143,Rabós,185,88,97
17,Girona,144,Regencós,289,156,133
17,Girona,145,Ribes de Freser,1891,938,953
17,Girona,146,Riells i Viabrea,3954,2042,1912
17,Girona,147,Ripoll,10798,5323,5475
17,Girona,148,Riudarenes,2175,1117,1058
17,Girona,149,Riudaura,452,220,232
17,Girona,150,Riudellots de la Selva,2051,1048,1003
17,Girona,151,Riumors,243,125,118
17,Girona,152,Roses,19891,9961,9930
17,Girona,153,Rupià,241,121,120
17,Girona,154,Sales de Llierca,140,74,66
17,Girona,155,Salt,30247,16064,14183
17,Girona,157,Sant Andreu Salou,154,78,76
17,Girona,183,Sant Aniol de Finestres,355,188,167
17,Girona,158,Sant Climent Sescebes,581,325,256
17,Girona,159,Sant Feliu de Buixalleu,782,406,376
17,Girona,160,Sant Feliu de Guíxols,21945,10895,11050
17,Girona,161,Sant Feliu de Pallerols,1346,658,688
17,Girona,162,Sant Ferriol,231,134,97
17,Girona,163,Sant Gregori,3463,1751,1712
17,Girona,164,Sant Hilari Sacalm,5742,2941,2801
17,Girona,165,Sant Jaume de Llierca,799,395,404
17,Girona,167,Sant Joan de les Abadesses,3434,1697,1737
17,Girona,168,Sant Joan de Mollet,517,257,260
17,Girona,185,Sant Joan les Fonts,2893,1446,1447
17,Girona,166,Sant Jordi Desvalls,702,336,366
17,Girona,169,Sant Julià de Ramis,3469,1745,1724
17,Girona,903,Sant Julià del Llor i Bonmatí,1264,646,618
17,Girona,171,Sant Llorenç de la Muga,256,132,124
17,Girona,172,Sant Martí de Llémena,615,327,288
17,Girona,173,Sant Martí Vell,240,129,111
17,Girona,174,Sant Miquel de Campmajor,219,119,100
17,Girona,175,Sant Miquel de Fluvià,779,399,380
17,Girona,176,Sant Mori,181,95,86
17,Girona,177,Sant Pau de Segúries,677,331,346
17,Girona,178,Sant Pere Pescador,2175,1160,1015
17,Girona,180,Santa Coloma de Farners,12601,6403,6198
17,Girona,181,Santa Cristina d'Aro,5128,2612,2516
17,Girona,182,Santa Llogaia d'Àlguema,347,184,163
17,Girona,184,Santa Pau,1589,803,786
17,Girona,186,Sarrià de Ter,4892,2443,2449
17,Girona,187,"Saus, Camallera i Llampaies",781,376,405
17,Girona,188,"Selva de Mar, La",185,100,85
17,Girona,190,Serinyà,1108,569,539
17,Girona,191,Serra de Daró,203,111,92
17,Girona,192,Setcases,189,104,85
17,Girona,193,Sils,5685,2886,2799
17,Girona,52,Siurana,172,89,83
17,Girona,194,Susqueda,101,60,41
17,Girona,195,"Tallada d'Empordà, La",455,235,220
17,Girona,196,Terrades,278,134,144
17,Girona,197,Torrent,185,96,89
17,Girona,198,Torroella de Fluvià,729,366,363
17,Girona,199,Torroella de Montgrí,11472,5824,5648
17,Girona,200,Tortellà,774,372,402
17,Girona,201,Toses,149,86,63
17,Girona,202,Tossa de Mar,5910,3013,2897
17,Girona,204,Ullà,1057,584,473
17,Girona,205,Ullastret,287,142,145
17,Girona,203,Ultramort,208,114,94
17,Girona,206,Urús,183,89,94
17,Girona,14,"Vajol, La",94,55,39
17,Girona,208,"Vall de Bianya, La",1316,668,648
17,Girona,207,"Vall d'en Bas, La",2974,1484,1490
17,Girona,170,Vallfogona de Ripollès,217,119,98
17,Girona,209,Vall-llobrega,910,467,443
17,Girona,210,Ventalló,815,424,391
17,Girona,211,Verges,1210,579,631
17,Girona,212,Vidrà,166,88,78
17,Girona,213,Vidreres,7748,4003,3745
17,Girona,214,Vilabertran,917,475,442
17,Girona,215,Vilablareix,2492,1225,1267
17,Girona,217,Viladamat,453,236,217
17,Girona,216,Viladasens,218,112,106
17,Girona,218,Vilademuls,802,407,395
17,Girona,220,Viladrau,1065,538,527
17,Girona,221,Vilafant,5502,2705,2797
17,Girona,223,Vilajuïga,1220,602,618
17,Girona,224,Vilallonga de Ter,447,238,209
17,Girona,225,Vilamacolum,298,165,133
17,Girona,226,Vilamalla,1097,571,526
17,Girona,227,Vilamaniscle,158,89,69
17,Girona,228,Vilanant,384,187,197
17,Girona,230,Vila-sacra,661,323,338
17,Girona,222,Vilaür,148,72,76
17,Girona,233,Vilobí d'Onyar,3108,1612,1496
17,Girona,232,Vilopriu,200,111,89
18,Granada,1,Agrón,324,168,156
18,Granada,2,Alamedilla,695,355,340
18,Granada,3,Albolote,18082,9038,9044
18,Granada,4,Albondón,814,445,369
18,Granada,5,Albuñán,423,220,203
18,Granada,6,Albuñol,6878,3607,3271
18,Granada,7,Albuñuelas,879,441,438
18,Granada,10,Aldeire,653,345,308
18,Granada,11,Alfacar,5552,2818,2734
18,Granada,12,Algarinejo,2943,1507,1436
18,Granada,13,Alhama de Granada,6154,3266,2888
18,Granada,14,Alhendín,8020,4127,3893
18,Granada,15,Alicún de Ortega,506,263,243
18,Granada,16,Almegíjar,377,206,171
18,Granada,17,Almuñécar,25586,12605,12981
18,Granada,904,Alpujarra de la Sierra,1044,552,492
18,Granada,18,Alquife,733,365,368
18,Granada,20,Arenas del Rey,1929,1012,917
18,Granada,21,Armilla,22904,11419,11485
18,Granada,22,Atarfe,17141,8546,8595
18,Granada,23,Baza,21258,10586,10672
18,Granada,24,Beas de Granada,1016,543,473
18,Granada,25,Beas de Guadix,366,186,180
18,Granada,27,Benalúa,3301,1656,1645
18,Granada,28,Benalúa de las Villas,1252,680,572
18,Granada,29,Benamaurel,2445,1243,1202
18,Granada,30,Bérchules,759,401,358
18,Granada,32,Bubión,337,177,160
18,Granada,33,Busquístar,265,143,122
18,Granada,34,Cacín,601,300,301
18,Granada,35,Cádiar,1515,801,714
18,Granada,36,Cájar,4837,2330,2507
18,Granada,114,"Calahorra, La",754,379,375
18,Granada,37,Calicasas,564,292,272
18,Granada,38,Campotéjar,1334,691,643
18,Granada,39,Caniles,4722,2386,2336
18,Granada,40,Cáñar,462,247,215
18,Granada,42,Capileira,484,242,242
18,Granada,43,Carataunas,162,84,78
18,Granada,44,Cástaras,256,150,106
18,Granada,45,Castilléjar,1542,788,754
18,Granada,46,Castril,2335,1189,1146
18,Granada,47,Cenes de la Vega,7958,4030,3928
18,Granada,59,Chauchina,5411,2677,2734
18,Granada,61,Chimeneas,1446,751,695
18,Granada,62,Churriana de la Vega,13407,6683,6724
18,Granada,48,Cijuela,3145,1592,1553
18,Granada,49,Cogollos de Guadix,689,374,315
18,Granada,50,Cogollos de la Vega,2016,1011,1005
18,Granada,51,Colomera,1453,764,689
18,Granada,53,Cortes de Baza,2204,1109,1095
18,Granada,54,Cortes y Graena,1026,518,508
18,Granada,912,Cuevas del Campo,1938,973,965
18,Granada,56,Cúllar,4612,2322,2290
18,Granada,57,Cúllar Vega,7090,3602,3488
18,Granada,63,Darro,1444,707,737
18,Granada,64,Dehesas de Guadix,458,220,238
18,Granada,66,Deifontes,2571,1301,1270
18,Granada,67,Diezma,776,397,379
18,Granada,68,Dílar,1743,864,879
18,Granada,69,Dólar,612,313,299
18,Granada,70,Dúdar,358,193,165
18,Granada,71,Dúrcal,7281,3616,3665
18,Granada,72,Escúzar,773,396,377
18,Granada,74,Ferreira,344,178,166
18,Granada,76,Fonelas,1051,549,502
18,Granada,78,Freila,990,503,487
18,Granada,79,Fuente Vaqueros,4500,2240,2260
18,Granada,905,"Gabias, Las",18946,9696,9250
18,Granada,82,Galera,1138,565,573
18,Granada,83,Gobernador,326,158,168
18,Granada,84,Gójar,5379,2750,2629
18,Granada,85,Gor,830,422,408
18,Granada,86,Gorafe,445,224,221
18,Granada,87,Granada,237818,110644,127174
18,Granada,88,Guadahortuna,2027,1050,977
18,Granada,89,Guadix,18884,9369,9515
18,Granada,906,"Guajares, Los",1146,617,529
18,Granada,93,Gualchos,5031,2608,2423
18,Granada,94,Güejar Sierra,2956,1544,1412
18,Granada,95,Güevéjar,2546,1320,1226
18,Granada,96,Huélago,432,220,212
18,Granada,97,Huéneja,1193,622,571
18,Granada,98,Huéscar,7942,3931,4011
18,Granada,99,Huétor de Santillán,1832,934,898
18,Granada,100,Huétor Tájar,10087,5098,4989
18,Granada,101,Huétor Vega,11805,5918,5887
18,Granada,102,Illora,10638,5315,5323
18,Granada,103,Itrabo,1028,515,513
18,Granada,105,Iznalloz,6925,3567,3358
18,Granada,107,Jayena,1243,627,616
18,Granada,108,Jerez del Marquesado,1038,529,509
18,Granada,109,Jete,923,481,442
18,Granada,111,Jun,3609,1852,1757
18,Granada,112,Juviles,135,65,70
18,Granada,115,Láchar,3249,1657,1592
18,Granada,116,Lanjarón,3791,1872,1919
18,Granada,117,Lanteira,545,278,267
18,Granada,119,Lecrín,2247,1146,1101
18,Granada,120,Lentegí,346,183,163
18,Granada,121,Lobras,163,83,80
18,Granada,122,Loja,21135,10640,10495
18,Granada,123,Lugros,333,182,151
18,Granada,124,Lújar,524,278,246
18,Granada,126,"Malahá, La",1858,950,908
18,Granada,127,Maracena,21594,10697,10897
18,Granada,128,Marchal,427,193,234
18,Granada,132,Moclín,4136,2054,2082
18,Granada,133,Molvízar,2982,1529,1453
18,Granada,134,Monachil,7359,3791,3568
18,Granada,135,Montefrío,5853,2934,2919
18,Granada,136,Montejícar,2308,1171,1137
18,Granada,137,Montillana,1349,713,636
18,Granada,138,Moraleda de Zafayona,3233,1649,1584
18,Granada,909,Morelábor,736,384,352
18,Granada,140,Motril,61194,30230,30964
18,Granada,141,Murtas,605,357,248
18,Granada,903,Nevada,1174,594,580
18,Granada,143,Nigüelas,1238,620,618
18,Granada,144,Nívar,883,461,422
18,Granada,145,Ogíjares,13598,6747,6851
18,Granada,146,Orce,1292,669,623
18,Granada,147,Órgiva,5739,2851,2888
18,Granada,148,Otívar,1136,574,562
18,Granada,149,Otura,6868,3487,3381
18,Granada,150,Padul,8322,4214,4108
18,Granada,151,Pampaneira,352,180,172
18,Granada,152,Pedro Martínez,1218,598,620
18,Granada,153,Peligros,11126,5541,5585
18,Granada,154,"Peza, La",1283,667,616
18,Granada,910,"Pinar, El",1021,514,507
18,Granada,157,Pinos Genil,1406,741,665
18,Granada,158,Pinos Puente,12903,6417,6486
18,Granada,159,Píñar,1270,707,563
18,Granada,161,Polícar,225,116,109
18,Granada,162,Polopos,1686,892,794
18,Granada,163,Pórtugos,372,199,173
18,Granada,164,Puebla de Don Fadrique,2370,1219,1151
18,Granada,165,Pulianas,5326,2676,2650
18,Granada,167,Purullena,2453,1235,1218
18,Granada,168,Quéntar,1020,524,496
18,Granada,170,Rubite,501,273,228
18,Granada,171,Salar,2757,1401,1356
18,Granada,173,Salobreña,12509,6243,6266
18,Granada,174,Santa Cruz del Comercio,571,302,269
18,Granada,175,Santa Fe,15323,7574,7749
18,Granada,176,Soportújar,287,158,129
18,Granada,177,Sorvilán,572,297,275
18,Granada,901,"Taha, La",719,370,349
18,Granada,178,Torre-Cardela,860,435,425
18,Granada,179,Torvizcón,734,385,349
18,Granada,180,Trevélez,810,425,385
18,Granada,181,Turón,284,167,117
18,Granada,182,Ugíjar,2638,1301,1337
18,Granada,907,Valle del Zalabí,2259,1161,1098
18,Granada,902,"Valle, El",1052,517,535
18,Granada,183,Válor,609,315,294
18,Granada,911,Vegas del Genil,10003,5126,4877
18,Granada,184,Vélez de Benaudalla,2890,1454,1436
18,Granada,185,Ventas de Huelma,693,359,334
18,Granada,908,Villamena,1031,517,514
18,Granada,187,Villanueva de las Torres,695,378,317
18,Granada,188,Villanueva Mesía,2085,1055,1030
18,Granada,189,Víznar,982,502,480
18,Granada,192,Zafarraya,1980,1072,908
18,Granada,913,Zagra,900,461,439
18,Granada,193,"Zubia, La",18595,9151,9444
18,Granada,194,Zújar,2930,1534,1396
19,Guadalajara,1,Abánades,65,37,28
19,Guadalajara,2,Ablanque,89,51,38
19,Guadalajara,3,Adobes,45,22,23
19,Guadalajara,4,Alaminos,70,37,33
19,Guadalajara,5,Alarilla,113,73,40
19,Guadalajara,6,Albalate de Zorita,1105,616,489
19,Guadalajara,7,Albares,548,281,267
19,Guadalajara,8,Albendiego,40,27,13
19,Guadalajara,9,Alcocer,323,165,158
19,Guadalajara,10,Alcolea de las Peñas,12,8,4
19,Guadalajara,11,Alcolea del Pinar,377,207,170
19,Guadalajara,13,Alcoroches,159,94,65
19,Guadalajara,15,Aldeanueva de Guadalajara,82,46,36
19,Guadalajara,16,Algar de Mesa,57,33,24
19,Guadalajara,17,Algora,84,54,30
19,Guadalajara,18,Alhóndiga,206,113,93
19,Guadalajara,19,Alique,22,10,12
19,Guadalajara,20,Almadrones,80,50,30
19,Guadalajara,21,Almoguera,1422,747,675
19,Guadalajara,22,Almonacid de Zorita,778,370,408
19,Guadalajara,23,Alocén,193,102,91
19,Guadalajara,24,Alovera,12196,6253,5943
19,Guadalajara,27,Alustante,208,129,79
19,Guadalajara,31,Angón,16,12,4
19,Guadalajara,32,Anguita,216,113,103
19,Guadalajara,33,Anquela del Ducado,78,46,32
19,Guadalajara,34,Anquela del Pedregal,21,15,6
19,Guadalajara,36,Aranzueque,447,226,221
19,Guadalajara,37,Arbancón,171,106,65
19,Guadalajara,38,Arbeteta,36,21,15
19,Guadalajara,39,Argecilla,74,49,25
19,Guadalajara,40,Armallones,60,36,24
19,Guadalajara,41,Armuña de Tajuña,245,122,123
19,Guadalajara,42,Arroyo de las Fraguas,34,18,16
19,Guadalajara,43,Atanzón,85,53,32
19,Guadalajara,44,Atienza,482,267,215
19,Guadalajara,45,Auñón,174,98,76
19,Guadalajara,46,Azuqueca de Henares,35397,18200,17197
19,Guadalajara,47,Baides,87,42,45
19,Guadalajara,48,Baños de Tajo,15,12,3
19,Guadalajara,49,Bañuelos,22,15,7
19,Guadalajara,50,Barriopedro,20,11,9
19,Guadalajara,51,Berninches,67,39,28
19,Guadalajara,52,"Bodera, La",33,20,13
19,Guadalajara,53,Brihuega,2673,1379,1294
19,Guadalajara,54,Budia,215,119,96
19,Guadalajara,55,Bujalaro,53,31,22
19,Guadalajara,57,Bustares,80,49,31
19,Guadalajara,58,Cabanillas del Campo,9710,4867,4843
19,Guadalajara,59,Campillo de Dueñas,88,51,37
19,Guadalajara,60,Campillo de Ranas,186,117,69
19,Guadalajara,61,Campisábalos,63,41,22
19,Guadalajara,64,Canredondo,99,58,41
19,Guadalajara,65,Cantalojas,158,92,66
19,Guadalajara,66,Cañizar,74,40,34
19,Guadalajara,67,"Cardoso de la Sierra, El",70,46,24
19,Guadalajara,70,Casa de Uceda,110,62,48
19,Guadalajara,71,"Casar, El",11635,5970,5665
19,Guadalajara,73,Casas de San Galindo,23,15,8
19,Guadalajara,74,Caspueñas,104,63,41
19,Guadalajara,75,Castejón de Henares,80,47,33
19,Guadalajara,76,Castellar de la Muela,38,19,19
19,Guadalajara,78,Castilforte,60,39,21
19,Guadalajara,79,Castilnuevo,7,4,3
19,Guadalajara,80,Cendejas de Enmedio,85,45,40
19,Guadalajara,81,Cendejas de la Torre,36,23,13
19,Guadalajara,82,Centenera,100,53,47
19,Guadalajara,103,Checa,312,181,131
19,Guadalajara,104,Chequilla,13,8,5
19,Guadalajara,106,Chillarón del Rey,108,65,43
19,Guadalajara,105,Chiloeches,3265,1700,1565
19,Guadalajara,86,Cifuentes,2052,1041,1011
19,Guadalajara,87,Cincovillas,23,14,9
19,Guadalajara,88,Ciruelas,114,64,50
19,Guadalajara,89,Ciruelos del Pinar,33,19,14
19,Guadalajara,90,Cobeta,119,55,64
19,Guadalajara,91,Cogollor,32,17,15
19,Guadalajara,92,Cogolludo,673,390,283
19,Guadalajara,95,Condemios de Abajo,23,14,9
19,Guadalajara,96,Condemios de Arriba,142,76,66
19,Guadalajara,97,Congostrina,26,17,9
19,Guadalajara,98,Copernal,43,29,14
19,Guadalajara,99,Corduente,377,204,173
19,Guadalajara,102,"Cubillo de Uceda, El",163,88,75
19,Guadalajara,107,Driebes,401,208,193
19,Guadalajara,108,Durón,110,60,50
19,Guadalajara,109,Embid,48,27,21
19,Guadalajara,110,Escamilla,69,34,35
19,Guadalajara,111,Escariche,188,108,80
19,Guadalajara,112,Escopete,66,35,31
19,Guadalajara,113,Espinosa de Henares,788,420,368
19,Guadalajara,114,Esplegares,43,27,16
19,Guadalajara,115,Establés,36,22,14
19,Guadalajara,116,Estriégana,18,12,6
19,Guadalajara,117,Fontanar,2370,1254,1116
19,Guadalajara,118,Fuembellida,14,9,5
19,Guadalajara,119,Fuencemillán,123,74,49
19,Guadalajara,120,Fuentelahiguera de Albatages,135,76,59
19,Guadalajara,121,Fuentelencina,310,178,132
19,Guadalajara,122,Fuentelsaz,103,55,48
19,Guadalajara,123,Fuentelviejo,41,20,21
19,Guadalajara,124,Fuentenovilla,600,332,268
19,Guadalajara,125,Gajanejos,57,35,22
19,Guadalajara,126,Galápagos,2209,1177,1032
19,Guadalajara,127,Galve de Sorbe,124,70,54
19,Guadalajara,129,Gascueña de Bornova,45,27,18
19,Guadalajara,130,Guadalajara,84504,41227,43277
19,Guadalajara,132,Henche,100,52,48
19,Guadalajara,133,Heras de Ayuso,264,162,102
19,Guadalajara,134,Herrería,21,16,5
19,Guadalajara,135,Hiendelaencina,141,77,64
19,Guadalajara,136,Hijes,21,14,7
19,Guadalajara,138,Hita,388,215,173
19,Guadalajara,139,Hombrados,37,22,15
19,Guadalajara,142,Hontoba,328,180,148
19,Guadalajara,143,Horche,2491,1279,1212
19,Guadalajara,145,Hortezuela de Océn,59,36,23
19,Guadalajara,146,"Huerce, La",52,27,25
19,Guadalajara,147,Huérmeces del Cerro,48,30,18
19,Guadalajara,148,Huertahernando,58,40,18
19,Guadalajara,150,Hueva,138,78,60
19,Guadalajara,151,Humanes,1570,792,778
19,Guadalajara,152,Illana,808,462,346
19,Guadalajara,153,Iniéstola,28,18,10
19,Guadalajara,154,"Inviernas, Las",74,45,29
19,Guadalajara,155,Irueste,67,42,25
19,Guadalajara,156,Jadraque,1657,855,802
19,Guadalajara,157,Jirueque,65,41,24
19,Guadalajara,159,Ledanca,107,54,53
19,Guadalajara,160,Loranca de Tajuña,1373,759,614
19,Guadalajara,161,Lupiana,243,129,114
19,Guadalajara,162,Luzaga,81,46,35
19,Guadalajara,163,Luzón,72,34,38
19,Guadalajara,165,Majaelrayo,54,31,23
19,Guadalajara,166,Málaga del Fresno,201,115,86
19,Guadalajara,167,Malaguilla,136,75,61
19,Guadalajara,168,Mandayona,333,174,159
19,Guadalajara,169,Mantiel,53,30,23
19,Guadalajara,170,Maranchón,263,140,123
19,Guadalajara,171,Marchamalo,6593,3370,3223
19,Guadalajara,172,Masegoso de Tajuña,80,47,33
19,Guadalajara,173,Matarrubia,57,39,18
19,Guadalajara,174,Matillas,125,62,63
19,Guadalajara,175,Mazarete,49,22,27
19,Guadalajara,176,Mazuecos,309,162,147
19,Guadalajara,177,Medranda,96,53,43
19,Guadalajara,178,Megina,50,33,17
19,Guadalajara,179,Membrillera,103,54,49
19,Guadalajara,181,Miedes de Atienza,67,37,30
19,Guadalajara,182,"Mierla, La",33,23,10
19,Guadalajara,184,Millana,141,82,59
19,Guadalajara,183,Milmarcos,96,54,42
19,Guadalajara,185,"Miñosa, La",40,29,11
19,Guadalajara,186,Mirabueno,91,56,35
19,Guadalajara,187,Miralrío,71,41,30
19,Guadalajara,188,Mochales,59,31,28
19,Guadalajara,189,Mohernando,188,99,89
19,Guadalajara,190,Molina de Aragón,3514,1775,1739
19,Guadalajara,191,Monasterio,22,9,13
19,Guadalajara,192,Mondéjar,2686,1388,1298
19,Guadalajara,193,Montarrón,29,17,12
19,Guadalajara,194,Moratilla de los Meleros,114,63,51
19,Guadalajara,195,Morenilla,47,29,18
19,Guadalajara,196,Muduex,111,58,53
19,Guadalajara,197,"Navas de Jadraque, Las",29,19,10
19,Guadalajara,198,Negredo,25,13,12
19,Guadalajara,199,Ocentejo,23,13,10
19,Guadalajara,200,"Olivar, El",102,59,43
19,Guadalajara,201,Olmeda de Cobeta,72,36,36
19,Guadalajara,202,"Olmeda de Jadraque, La",15,7,8
19,Guadalajara,203,"Ordial, El",33,19,14
19,Guadalajara,204,Orea,210,129,81
19,Guadalajara,208,Pálmaces de Jadraque,50,28,22
19,Guadalajara,209,Pardos,50,28,22
19,Guadalajara,210,Paredes de Sigüenza,28,16,12
19,Guadalajara,211,Pareja,513,288,225
19,Guadalajara,212,Pastrana,1054,539,515
19,Guadalajara,213,"Pedregal, El",84,51,33
19,Guadalajara,214,Peñalén,90,49,41
19,Guadalajara,215,Peñalver,214,130,84
19,Guadalajara,216,Peralejos de las Truchas,148,82,66
19,Guadalajara,217,Peralveche,76,47,29
19,Guadalajara,218,Pinilla de Jadraque,59,33,26
19,Guadalajara,219,Pinilla de Molina,18,12,6
19,Guadalajara,220,Pioz,3595,1946,1649
19,Guadalajara,221,Piqueras,55,35,20
19,Guadalajara,222,"Pobo de Dueñas, El",138,73,65
19,Guadalajara,223,Poveda de la Sierra,142,78,64
19,Guadalajara,224,Pozo de Almoguera,110,60,50
19,Guadalajara,225,Pozo de Guadalajara,1298,675,623
19,Guadalajara,226,Prádena de Atienza,48,32,16
19,Guadalajara,227,Prados Redondos,78,45,33
19,Guadalajara,228,Puebla de Beleña,51,29,22
19,Guadalajara,229,Puebla de Valles,80,43,37
19,Guadalajara,230,Quer,714,390,324
19,Guadalajara,231,Rebollosa de Jadraque,14,10,4
19,Guadalajara,232,"Recuenco, El",79,45,34
19,Guadalajara,233,Renera,110,63,47
19,Guadalajara,234,Retiendas,44,26,18
19,Guadalajara,235,Riba de Saelices,115,67,48
19,Guadalajara,237,Rillo de Gallo,59,33,26
19,Guadalajara,238,Riofrío del Llano,40,24,16
19,Guadalajara,239,Robledillo de Mohernando,123,65,58
19,Guadalajara,240,Robledo de Corpes,63,33,30
19,Guadalajara,241,Romanillos de Atienza,52,30,22
19,Guadalajara,242,Romanones,118,63,55
19,Guadalajara,243,Rueda de la Sierra,56,35,21
19,Guadalajara,244,Sacecorbo,100,55,45
19,Guadalajara,245,Sacedón,1817,964,853
19,Guadalajara,246,Saelices de la Sal,52,29,23
19,Guadalajara,247,Salmerón,194,104,90
19,Guadalajara,248,San Andrés del Congosto,81,47,34
19,Guadalajara,249,San Andrés del Rey,37,16,21
19,Guadalajara,250,Santiuste,24,15,9
19,Guadalajara,251,Saúca,52,29,23
19,Guadalajara,252,Sayatón,103,59,44
19,Guadalajara,254,Selas,67,30,37
19,Guadalajara,901,Semillas,40,24,16
19,Guadalajara,255,Setiles,92,55,37
19,Guadalajara,256,Sienes,60,37,23
19,Guadalajara,257,Sigüenza,4772,2399,2373
19,Guadalajara,258,Solanillos del Extremo,102,58,44
19,Guadalajara,259,Somolinos,35,18,17
19,Guadalajara,260,"Sotillo, El",49,26,23
19,Guadalajara,261,Sotodosos,44,19,25
19,Guadalajara,262,Tamajón,155,79,76
19,Guadalajara,263,Taragudo,45,21,24
19,Guadalajara,264,Taravilla,38,23,15
19,Guadalajara,265,Tartanedo,160,88,72
19,Guadalajara,266,Tendilla,378,211,167
19,Guadalajara,267,Terzaga,19,13,6
19,Guadalajara,268,Tierzo,36,24,12
19,Guadalajara,269,"Toba, La",102,60,42
19,Guadalajara,271,Tordellego,63,33,30
19,Guadalajara,270,Tordelrábano,14,8,6
19,Guadalajara,272,Tordesilos,112,69,43
19,Guadalajara,274,Torija,1609,870,739
19,Guadalajara,279,Torre del Burgo,250,128,122
19,Guadalajara,277,Torrecuadrada de Molina,21,11,10
19,Guadalajara,278,Torrecuadradilla,31,18,13
19,Guadalajara,280,Torrejón del Rey,5169,2704,2465
19,Guadalajara,281,Torremocha de Jadraque,30,20,10
19,Guadalajara,282,Torremocha del Campo,232,133,99
19,Guadalajara,283,Torremocha del Pinar,42,19,23
19,Guadalajara,284,Torremochuela,11,6,5
19,Guadalajara,285,Torrubia,23,13,10
19,Guadalajara,286,Tórtola de Henares,993,533,460
19,Guadalajara,287,Tortuera,217,117,100
19,Guadalajara,288,Tortuero,17,10,7
19,Guadalajara,289,Traíd,34,20,14
19,Guadalajara,290,Trijueque,1387,747,640
19,Guadalajara,291,Trillo,1474,765,709
19,Guadalajara,293,Uceda,2662,1386,1276
19,Guadalajara,294,Ujados,29,17,12
19,Guadalajara,296,Utande,41,28,13
19,Guadalajara,297,Valdarachas,37,17,20
19,Guadalajara,298,Valdearenas,77,46,31
19,Guadalajara,299,Valdeavellano,84,48,36
19,Guadalajara,300,Valdeaveruelo,1080,558,522
19,Guadalajara,301,Valdeconcha,38,25,13
19,Guadalajara,302,Valdegrudas,60,39,21
19,Guadalajara,303,Valdelcubo,69,42,27
19,Guadalajara,304,Valdenuño Fernández,273,158,115
19,Guadalajara,305,Valdepeñas de la Sierra,200,115,85
19,Guadalajara,306,Valderrebollo,40,19,21
19,Guadalajara,307,Valdesotos,23,14,9
19,Guadalajara,308,Valfermoso de Tajuña,56,35,21
19,Guadalajara,309,Valhermoso,32,20,12
19,Guadalajara,310,Valtablado del Río,10,7,3
19,Guadalajara,311,Valverde de los Arroyos,89,50,39
19,Guadalajara,314,Viana de Jadraque,52,33,19
19,Guadalajara,317,Villanueva de Alcorón,188,96,92
19,Guadalajara,318,Villanueva de Argecilla,42,24,18
19,Guadalajara,319,Villanueva de la Torre,6445,3271,3174
19,Guadalajara,321,Villares de Jadraque,61,39,22
19,Guadalajara,322,Villaseca de Henares,33,18,15
19,Guadalajara,323,Villaseca de Uceda,50,28,22
19,Guadalajara,324,Villel de Mesa,197,105,92
19,Guadalajara,325,Viñuelas,127,71,56
19,Guadalajara,326,Yebes,2459,1275,1184
19,Guadalajara,327,Yebra,580,303,277
19,Guadalajara,329,Yélamos de Abajo,65,32,33
19,Guadalajara,330,Yélamos de Arriba,101,57,44
19,Guadalajara,331,Yunquera de Henares,3773,1930,1843
19,Guadalajara,332,"Yunta, La",107,59,48
19,Guadalajara,333,Zaorejas,144,93,51
19,Guadalajara,334,Zarzuela de Jadraque,36,23,13
19,Guadalajara,335,Zorita de los Canes,82,42,40
21,Huelva,1,Alájar,805,419,386
21,Huelva,2,Aljaraque,19492,9721,9771
21,Huelva,3,"Almendro, El",847,453,394
21,Huelva,4,Almonaster la Real,1809,920,889
21,Huelva,5,Almonte,22964,11515,11449
21,Huelva,6,Alosno,4152,2007,2145
21,Huelva,7,Aracena,7900,3908,3992
21,Huelva,8,Aroche,3233,1614,1619
21,Huelva,9,Arroyomolinos de León,1023,532,491
21,Huelva,10,Ayamonte,20406,10273,10133
21,Huelva,11,Beas,4336,2193,2143
21,Huelva,12,Berrocal,300,143,157
21,Huelva,13,Bollullos Par del Condado,14394,7179,7215
21,Huelva,14,Bonares,6282,3115,3167
21,Huelva,15,Cabezas Rubias,781,410,371
21,Huelva,16,Cala,1264,634,630
21,Huelva,17,Calañas,4165,2083,2082
21,Huelva,18,"Campillo, El",2169,1050,1119
21,Huelva,19,Campofrío,708,353,355
21,Huelva,20,Cañaveral de León,426,210,216
21,Huelva,21,Cartaya,19323,9959,9364
21,Huelva,22,Castaño del Robledo,209,123,86
21,Huelva,23,"Cerro de Andévalo, El",2400,1175,1225
21,Huelva,30,Chucena,2057,1053,1004
21,Huelva,24,Corteconcepción,550,271,279
21,Huelva,25,Cortegana,4898,2465,2433
21,Huelva,26,Cortelazor,277,142,135
21,Huelva,27,Cumbres de Enmedio,52,33,19
21,Huelva,28,Cumbres de San Bartolomé,437,219,218
21,Huelva,29,Cumbres Mayores,1888,947,941
21,Huelva,31,Encinasola,1353,692,661
21,Huelva,32,Escacena del Campo,1802,888,914
21,Huelva,33,Fuenteheridos,478,250,228
21,Huelva,34,Galaroza,1548,765,783
21,Huelva,35,Gibraleón,12411,6158,6253
21,Huelva,36,"Granada de Río-Tinto, La",217,111,106
21,Huelva,37,"Granado, El",566,310,256
21,Huelva,38,Higuera de la Sierra,1369,686,683
21,Huelva,39,Hinojales,298,148,150
21,Huelva,40,Hinojos,3904,1947,1957
21,Huelva,41,Huelva,148101,71413,76688
21,Huelva,42,Isla Cristina,21443,10643,10800
21,Huelva,43,Jabugo,2325,1170,1155
21,Huelva,44,Lepe,27406,14137,13269
21,Huelva,45,Linares de la Sierra,244,123,121
21,Huelva,46,Lucena del Puerto,2600,1359,1241
21,Huelva,47,Manzanilla,2142,1082,1060
21,Huelva,48,"Marines, Los",292,145,147
21,Huelva,49,Minas de Riotinto,4090,1982,2108
21,Huelva,50,Moguer,21209,10478,10731
21,Huelva,51,"Nava, La",295,147,148
21,Huelva,52,Nerva,5654,2717,2937
21,Huelva,53,Niebla,3991,2007,1984
21,Huelva,54,"Palma del Condado, La",10597,5281,5316
21,Huelva,55,Palos de la Frontera,10196,5083,5113
21,Huelva,56,Paterna del Campo,3601,1837,1764
21,Huelva,57,Paymogo,1253,625,628
21,Huelva,58,Puebla de Guzmán,3127,1597,1530
21,Huelva,59,Puerto Moral,283,145,138
21,Huelva,60,Punta Umbría,14976,7632,7344
21,Huelva,61,Rociana del Condado,7673,3863,3810
21,Huelva,62,Rosal de la Frontera,1830,928,902
21,Huelva,63,San Bartolomé de la Torre,3610,1825,1785
21,Huelva,64,San Juan del Puerto,8600,4321,4279
21,Huelva,66,San Silvestre de Guzmán,699,379,320
21,Huelva,65,Sanlúcar de Guadiana,461,235,226
21,Huelva,67,Santa Ana la Real,535,249,286
21,Huelva,68,Santa Bárbara de Casa,1098,544,554
21,Huelva,69,Santa Olalla del Cala,2023,1034,989
21,Huelva,70,Trigueros,7822,3889,3933
21,Huelva,71,Valdelarco,223,110,113
21,Huelva,72,Valverde del Camino,12766,6287,6479
21,Huelva,73,Villablanca,3012,1555,1457
21,Huelva,74,Villalba del Alcor,3395,1674,1721
21,Huelva,75,Villanueva de las Cruces,400,191,209
21,Huelva,76,Villanueva de los Castillejos,2759,1379,1380
21,Huelva,77,Villarrasa,2219,1121,1098
21,Huelva,78,Zalamea la Real,3329,1668,1661
21,Huelva,79,Zufre,896,458,438
22,Huesca,1,Abiego,279,144,135
22,Huesca,2,Abizanda,143,74,69
22,Huesca,3,Adahuesca,176,86,90
22,Huesca,4,Agüero,150,85,65
22,Huesca,907,Aínsa-Sobrarbe,2250,1174,1076
22,Huesca,6,Aisa,364,201,163
22,Huesca,7,Albalate de Cinca,1249,644,605
22,Huesca,8,Albalatillo,209,113,96
22,Huesca,9,Albelda,794,419,375
22,Huesca,11,Albero Alto,123,72,51
22,Huesca,12,Albero Bajo,121,68,53
22,Huesca,13,Alberuela de Tubo,339,176,163
22,Huesca,14,Alcalá de Gurrea,277,144,133
22,Huesca,15,Alcalá del Obispo,354,187,167
22,Huesca,16,Alcampell,724,368,356
22,Huesca,17,Alcolea de Cinca,1125,591,534
22,Huesca,18,Alcubierre,416,220,196
22,Huesca,19,Alerre,213,114,99
22,Huesca,20,Alfántega,140,66,74
22,Huesca,21,Almudévar,2514,1294,1220
22,Huesca,22,Almunia de San Juan,663,339,324
22,Huesca,23,Almuniente,538,269,269
22,Huesca,24,Alquézar,298,164,134
22,Huesca,25,Altorricón,1447,782,665
22,Huesca,27,Angüés,419,223,196
22,Huesca,28,Ansó,447,232,215
22,Huesca,29,Antillón,156,84,72
22,Huesca,32,Aragüés del Puerto,128,71,57
22,Huesca,35,Arén,326,169,157
22,Huesca,36,Argavieso,112,66,46
22,Huesca,37,Arguis,129,72,57
22,Huesca,39,Ayerbe,1111,561,550
22,Huesca,40,Azanuy-Alins,181,89,92
22,Huesca,41,Azara,197,102,95
22,Huesca,42,Azlor,133,67,66
22,Huesca,43,Baélls,109,61,48
22,Huesca,44,Bailo,301,176,125
22,Huesca,45,Baldellou,103,57,46
22,Huesca,46,Ballobar,863,452,411
22,Huesca,47,Banastás,297,157,140
22,Huesca,48,Barbastro,17210,8375,8835
22,Huesca,49,Barbués,89,48,41
22,Huesca,50,Barbuñales,98,48,50
22,Huesca,51,Bárcabo,115,69,46
22,Huesca,52,Belver de Cinca,1330,738,592
22,Huesca,53,Benabarre,1206,630,576
22,Huesca,54,Benasque,2195,1161,1034
22,Huesca,246,Beranuy,99,59,40
22,Huesca,55,Berbegal,385,195,190
22,Huesca,57,Bielsa,500,252,248
22,Huesca,58,Bierge,246,140,106
22,Huesca,59,Biescas,1568,850,718
22,Huesca,60,Binaced,1550,810,740
22,Huesca,61,Binéfar,9468,4931,4537
22,Huesca,62,Bisaurri,194,98,96
22,Huesca,63,Biscarrués,220,121,99
22,Huesca,64,Blecua y Torres,211,119,92
22,Huesca,66,Boltaña,1071,578,493
22,Huesca,67,Bonansa,86,47,39
22,Huesca,68,Borau,86,50,36
22,Huesca,69,Broto,533,281,252
22,Huesca,72,Caldearenas,212,124,88
22,Huesca,74,Campo,426,220,206
22,Huesca,75,Camporrélls,165,94,71
22,Huesca,76,Canal de Berdún,385,209,176
22,Huesca,77,Candasnos,349,178,171
22,Huesca,78,Canfranc,572,327,245
22,Huesca,79,Capdesaso,177,78,99
22,Huesca,80,Capella,371,198,173
22,Huesca,81,Casbas de Huesca,306,171,135
22,Huesca,83,Castejón de Monegros,611,320,291
22,Huesca,84,Castejón de Sos,731,373,358
22,Huesca,82,Castejón del Puente,349,178,171
22,Huesca,85,Castelflorite,135,72,63
22,Huesca,86,Castiello de Jaca,249,135,114
22,Huesca,87,Castigaleu,102,61,41
22,Huesca,88,Castillazuelo,181,84,97
22,Huesca,89,Castillonroy,342,173,169
22,Huesca,94,Chalamera,113,58,55
22,Huesca,95,Chía,100,63,37
22,Huesca,96,Chimillas,374,189,185
22,Huesca,90,Colungo,115,70,45
22,Huesca,99,Esplús,672,342,330
22,Huesca,102,Estada,221,123,98
22,Huesca,103,Estadilla,847,405,442
22,Huesca,105,Estopiñán del Castillo,144,75,69
22,Huesca,106,Fago,27,13,14
22,Huesca,107,Fanlo,118,75,43
22,Huesca,109,Fiscal,374,208,166
22,Huesca,110,Fonz,987,511,476
22,Huesca,111,Foradada del Toscar,197,107,90
22,Huesca,112,Fraga,14834,7584,7250
22,Huesca,113,"Fueva, La",618,321,297
22,Huesca,114,Gistaín,144,79,65
22,Huesca,115,"Grado, El",448,237,211
22,Huesca,116,Grañén,1961,1022,939
22,Huesca,117,Graus,3513,1805,1708
22,Huesca,119,Gurrea de Gállego,1627,845,782
22,Huesca,122,Hoz de Jaca,74,39,35
22,Huesca,908,Hoz y Costean,190,110,80
22,Huesca,124,Huerto,255,139,116
22,Huesca,125,Huesca,52418,25230,27188
22,Huesca,126,Ibieca,121,67,54
22,Huesca,127,Igriés,675,348,327
22,Huesca,128,Ilche,211,107,104
22,Huesca,129,Isábena,297,155,142
22,Huesca,130,Jaca,13221,6554,6667
22,Huesca,131,Jasa,102,61,41
22,Huesca,133,Labuerda,156,80,76
22,Huesca,135,Laluenga,225,122,103
22,Huesca,136,Lalueza,1021,538,483
22,Huesca,137,Lanaja,1340,711,629
22,Huesca,139,Laperdiguera,95,49,46
22,Huesca,141,Lascellas-Ponzano,148,85,63
22,Huesca,142,Lascuarre,143,74,69
22,Huesca,143,Laspaúles,316,186,130
22,Huesca,144,Laspuña,293,158,135
22,Huesca,149,Loarre,361,200,161
22,Huesca,150,Loporzano,547,308,239
22,Huesca,151,Loscorrales,106,53,53
22,Huesca,905,Lupiñén-Ortilla,374,189,185
22,Huesca,155,Monesma y Cajigar,93,49,44
22,Huesca,156,Monflorite-Lascasas,304,165,139
22,Huesca,157,Montanuy,253,148,105
22,Huesca,158,Monzón,17290,8816,8474
22,Huesca,160,Naval,250,128,122
22,Huesca,162,Novales,183,89,94
22,Huesca,163,Nueno,558,311,247
22,Huesca,164,Olvena,62,27,35
22,Huesca,165,Ontiñena,585,294,291
22,Huesca,167,Osso de Cinca,805,414,391
22,Huesca,168,Palo,23,11,12
22,Huesca,170,Panticosa,765,395,370
22,Huesca,172,Peñalba,720,377,343
22,Huesca,173,"Peñas de Riglos, Las",268,165,103
22,Huesca,174,Peralta de Alcofea,553,287,266
22,Huesca,175,Peralta de Calasanz,240,136,104
22,Huesca,176,Peraltilla,201,102,99
22,Huesca,177,Perarrúa,107,59,48
22,Huesca,178,Pertusa,124,71,53
22,Huesca,181,Piracés,102,58,44
22,Huesca,182,Plan,312,163,149
22,Huesca,184,Poleñino,215,113,102
22,Huesca,186,Pozán de Vero,230,116,114
22,Huesca,187,"Puebla de Castro, La",415,213,202
22,Huesca,188,Puente de Montañana,129,55,74
22,Huesca,902,Puente la Reina de Jaca,284,149,135
22,Huesca,189,Puértolas,214,122,92
22,Huesca,190,"Pueyo de Araguás, El",153,90,63
22,Huesca,193,Pueyo de Santa Cruz,358,183,175
22,Huesca,195,Quicena,298,153,145
22,Huesca,197,Robres,582,291,291
22,Huesca,199,Sabiñánigo,10129,5138,4991
22,Huesca,200,Sahún,326,175,151
22,Huesca,201,Salas Altas,302,156,146
22,Huesca,202,Salas Bajas,136,63,73
22,Huesca,203,Salillas,102,53,49
22,Huesca,204,Sallent de Gállego,1490,750,740
22,Huesca,205,San Esteban de Litera,501,263,238
22,Huesca,207,San Juan de Plan,158,84,74
22,Huesca,903,San Miguel del Cinca,854,431,423
22,Huesca,206,Sangarrén,214,109,105
22,Huesca,208,Santa Cilia,206,111,95
22,Huesca,209,Santa Cruz de la Serós,191,110,81
22,Huesca,906,Santa María de Dulcis,219,115,104
22,Huesca,212,Santaliestra y San Quílez,91,45,46
22,Huesca,213,Sariñena,4323,2240,2083
22,Huesca,214,Secastilla,158,71,87
22,Huesca,215,Seira,142,78,64
22,Huesca,217,Sena,530,290,240
22,Huesca,218,Senés de Alcubierre,51,23,28
22,Huesca,220,Sesa,208,116,92
22,Huesca,221,Sesué,121,67,54
22,Huesca,222,Siétamo,663,365,298
22,Huesca,223,Sopeira,110,58,52
22,Huesca,904,"Sotonera, La",1018,528,490
22,Huesca,225,Tamarite de Litera,3626,1849,1777
22,Huesca,226,Tardienta,994,502,492
22,Huesca,227,Tella-Sin,254,144,110
22,Huesca,228,Tierz,726,367,359
22,Huesca,229,Tolva,147,86,61
22,Huesca,230,Torla,292,151,141
22,Huesca,232,Torralba de Aragón,107,55,52
22,Huesca,233,Torre la Ribera,113,55,58
22,Huesca,234,Torrente de Cinca,1241,637,604
22,Huesca,235,Torres de Alcanadre,106,60,46
22,Huesca,236,Torres de Barbués,303,154,149
22,Huesca,239,Tramaced,95,56,39
22,Huesca,242,Valfarta,78,46,32
22,Huesca,243,Valle de Bardají,39,23,16
22,Huesca,901,Valle de Hecho,924,489,435
22,Huesca,244,Valle de Lierp,59,33,26
22,Huesca,245,Velilla de Cinca,447,228,219
22,Huesca,909,Vencillón,442,233,209
22,Huesca,247,Viacamp y Litera,43,25,18
22,Huesca,248,Vicién,124,71,53
22,Huesca,249,Villanova,150,78,72
22,Huesca,250,Villanúa,487,268,219
22,Huesca,251,Villanueva de Sigena,443,221,222
22,Huesca,252,Yebra de Basa,146,81,65
22,Huesca,253,Yésero,63,39,24
22,Huesca,254,Zaidín,1797,918,879
23,Jaén,1,Albanchez de Mágina,1179,614,565
23,Jaén,2,Alcalá la Real,22682,11244,11438
23,Jaén,3,Alcaudete,11008,5479,5529
23,Jaén,4,Aldeaquemada,540,284,256
23,Jaén,5,Andújar,38885,19231,19654
23,Jaén,6,Arjona,5764,2879,2885
23,Jaén,7,Arjonilla,3793,1894,1899
23,Jaén,8,Arquillos,1948,983,965
23,Jaén,905,Arroyo del Ojanco,2505,1311,1194
23,Jaén,9,Baeza,16302,8101,8201
23,Jaén,10,Bailén,18616,9346,9270
23,Jaén,11,Baños de la Encina,2679,1369,1310
23,Jaén,12,Beas de Segura,5642,2962,2680
23,Jaén,902,Bedmar y Garcíez,2969,1483,1486
23,Jaén,14,Begíjar,3135,1575,1560
23,Jaén,15,Bélmez de la Moraleda,1726,855,871
23,Jaén,16,Benatae,531,283,248
23,Jaén,17,Cabra del Santo Cristo,1996,1049,947
23,Jaén,18,Cambil,2861,1478,1383
23,Jaén,19,Campillo de Arenas,2014,1060,954
23,Jaén,20,Canena,2018,1023,995
23,Jaén,21,Carboneros,647,334,313
23,Jaén,901,Cárcheles,1466,760,706
23,Jaén,24,"Carolina, La",15899,7902,7997
23,Jaén,25,Castellar,3504,1766,1738
23,Jaén,26,Castillo de Locubín,4526,2231,2295
23,Jaén,27,Cazalilla,902,434,468
23,Jaén,28,Cazorla,7929,3852,4077
23,Jaén,29,Chiclana de Segura,1084,549,535
23,Jaén,30,Chilluévar,1578,785,793
23,Jaén,31,Escañuela,960,486,474
23,Jaén,32,Espelúy,715,360,355
23,Jaén,33,Frailes,1681,837,844
23,Jaén,34,Fuensanta de Martos,3226,1601,1625
23,Jaén,35,Fuerte del Rey,1410,724,686
23,Jaén,37,Génave,613,329,284
23,Jaén,38,"Guardia de Jaén, La",4654,2366,2288
23,Jaén,39,Guarromán,2925,1485,1440
23,Jaén,41,Higuera de Calatrava,645,340,305
23,Jaén,42,Hinojares,395,204,191
23,Jaén,43,Hornos,677,329,348
23,Jaén,44,Huelma,6141,3048,3093
23,Jaén,45,Huesa,2622,1325,1297
23,Jaén,46,Ibros,3038,1511,1527
23,Jaén,47,"Iruela, La",2090,1074,1016
23,Jaén,48,Iznatoraf,1054,564,490
23,Jaén,49,Jabalquinto,2300,1161,1139
23,Jaén,50,Jaén,116176,56115,60061
23,Jaén,51,Jamilena,3507,1796,1711
23,Jaén,52,Jimena,1378,670,708
23,Jaén,53,Jódar,12155,6001,6154
23,Jaén,40,Lahiguera,1833,903,930
23,Jaén,54,Larva,487,247,240
23,Jaén,55,Linares,60740,29750,30990
23,Jaén,56,Lopera,3882,1950,1932
23,Jaén,57,Lupión,938,466,472
23,Jaén,58,Mancha Real,11353,5727,5626
23,Jaén,59,Marmolejo,7252,3624,3628
23,Jaén,60,Martos,24585,12199,12386
23,Jaén,61,Mengíbar,9973,5009,4964
23,Jaén,62,Montizón,1845,966,879
23,Jaén,63,Navas de San Juan,4895,2465,2430
23,Jaén,64,Noalejo,2012,1029,983
23,Jaén,65,Orcera,1983,998,985
23,Jaén,66,Peal de Becerro,5468,2728,2740
23,Jaén,67,Pegalajar,3073,1545,1528
23,Jaén,69,Porcuna,6727,3400,3327
23,Jaén,70,Pozo Alcón,5165,2642,2523
23,Jaén,71,Puente de Génave,2260,1138,1122
23,Jaén,72,"Puerta de Segura, La",2591,1299,1292
23,Jaén,73,Quesada,5705,2893,2812
23,Jaén,74,Rus,3740,1921,1819
23,Jaén,75,Sabiote,4143,2051,2092
23,Jaén,76,Santa Elena,970,520,450
23,Jaén,77,Santiago de Calatrava,795,412,383
23,Jaén,904,Santiago-Pontones,3491,1789,1702
23,Jaén,79,Santisteban del Puerto,4758,2453,2305
23,Jaén,80,Santo Tomé,2430,1285,1145
23,Jaén,81,Segura de la Sierra,1949,965,984
23,Jaén,82,Siles,2387,1223,1164
23,Jaén,84,Sorihuela del Guadalimar,1317,688,629
23,Jaén,86,Torre del Campo,14729,7389,7340
23,Jaén,85,Torreblascopedro,2789,1405,1384
23,Jaén,87,Torredonjimeno,14116,6943,7173
23,Jaén,88,Torreperogil,7649,3790,3859
23,Jaén,90,Torres,1592,813,779
23,Jaén,91,Torres de Albánchez,915,477,438
23,Jaén,92,Úbeda,35514,17465,18049
23,Jaén,93,Valdepeñas de Jaén,4045,2011,2034
23,Jaén,94,Vilches,4768,2429,2339
23,Jaén,95,Villacarrillo,11263,5718,5545
23,Jaén,96,Villanueva de la Reina,3301,1669,1632
23,Jaén,97,Villanueva del Arzobispo,8768,4588,4180
23,Jaén,98,Villardompardo,1081,540,541
23,Jaén,99,"Villares, Los",6013,3025,2988
23,Jaén,101,Villarrodrigo,464,243,221
23,Jaén,903,Villatorres,4472,2273,2199
24,León,1,Acebedo,230,134,96
24,León,2,Algadefe,307,157,150
24,León,3,Alija del Infantado,760,383,377
24,León,4,Almanza,601,342,259
24,León,5,"Antigua, La",447,253,194
24,León,6,Ardón,617,323,294
24,León,7,Arganza,860,431,429
24,León,8,Astorga,11690,5546,6144
24,León,9,Balboa,339,181,158
24,León,10,"Bañeza, La",10711,5176,5535
24,León,11,Barjas,214,113,101
24,León,12,"Barrios de Luna, Los",317,180,137
24,León,14,Bembibre,9774,4834,4940
24,León,15,Benavides,2719,1353,1366
24,León,16,Benuza,530,294,236
24,León,17,Bercianos del Páramo,645,321,324
24,León,18,Bercianos del Real Camino,194,101,93
24,León,19,Berlanga del Bierzo,389,181,208
24,León,20,Boca de Huérgano,515,302,213
24,León,21,Boñar,2031,1014,1017
24,León,22,Borrenes,368,188,180
24,León,23,Brazuelo,318,171,147
24,León,24,"Burgo Ranero, El",776,423,353
24,León,25,Burón,322,188,134
24,León,26,Bustillo del Páramo,1369,713,656
24,León,27,Cabañas Raras,1328,682,646
24,León,28,Cabreros del Río,462,246,216
24,León,29,Cabrillanes,866,446,420
24,León,30,Cacabelos,5459,2743,2716
24,León,31,Calzada del Coto,260,147,113
24,León,32,Campazas,139,70,69
24,León,33,Campo de Villavidel,209,113,96
24,León,34,Camponaraya,4194,2110,2084
24,León,36,Candín,320,164,156
24,León,37,Cármenes,407,218,189
24,León,38,Carracedelo,3636,1786,1850
24,León,39,Carrizo,2481,1265,1216
24,León,40,Carrocera,545,276,269
24,León,41,Carucedo,618,311,307
24,León,42,Castilfalé,77,42,35
24,León,43,Castrillo de Cabrera,134,71,63
24,León,44,Castrillo de la Valduerna,187,82,105
24,León,46,Castrocalbón,1075,567,508
24,León,47,Castrocontrigo,852,441,411
24,León,49,Castropodame,1768,909,859
24,León,50,Castrotierra de Valmadrigal,114,59,55
24,León,51,Cea,496,259,237
24,León,52,Cebanico,186,103,83
24,León,53,Cebrones del Río,540,288,252
24,León,65,Chozas de Abajo,2474,1285,1189
24,León,54,Cimanes de la Vega,519,267,252
24,León,55,Cimanes del Tejar,783,420,363
24,León,56,Cistierna,3568,1761,1807
24,León,57,Congosto,1664,817,847
24,León,58,Corbillos de los Oteros,215,123,92
24,León,59,Corullón,1068,553,515
24,León,60,Crémenes,601,325,276
24,León,61,Cuadros,2018,1022,996
24,León,62,Cubillas de los Oteros,154,84,70
24,León,63,Cubillas de Rueda,497,254,243
24,León,64,Cubillos del Sil,1865,978,887
24,León,66,Destriana,579,276,303
24,León,67,Encinedo,834,433,401
24,León,68,"Ercina, La",518,266,252
24,León,69,Escobar de Campos,51,32,19
24,León,70,Fabero,5006,2437,2569
24,León,71,Folgoso de la Ribera,1207,585,622
24,León,73,Fresno de la Vega,643,312,331
24,León,74,Fuentes de Carbajal,106,58,48
24,León,76,Garrafe de Torío,1366,728,638
24,León,77,Gordaliza del Pino,269,132,137
24,León,78,Gordoncillo,478,237,241
24,León,79,Gradefes,1028,544,484
24,León,80,Grajal de Campos,249,123,126
24,León,81,Gusendos de los Oteros,137,77,60
24,León,82,Hospital de Órbigo,1003,493,510
24,León,83,Igüeña,1347,707,640
24,León,84,Izagre,201,106,95
24,León,86,Joarilla de las Matas,333,173,160
24,León,87,Laguna Dalga,712,378,334
24,León,88,Laguna de Negrillos,1149,591,558
24,León,89,León,130601,59712,70889
24,León,92,Llamas de la Ribera,938,486,452
24,León,90,Lucillo,408,215,193
24,León,91,Luyego,748,375,373
24,León,93,Magaz de Cepeda,386,198,188
24,León,94,Mansilla de las Mulas,1908,977,931
24,León,95,Mansilla Mayor,326,171,155
24,León,96,Maraña,151,86,65
24,León,97,Matadeón de los Oteros,274,142,132
24,León,98,Matallana de Torío,1374,721,653
24,León,99,Matanza,213,118,95
24,León,100,Molinaseca,895,481,414
24,León,101,Murias de Paredes,465,230,235
24,León,102,Noceda del Bierzo,736,373,363
24,León,103,Oencia,333,195,138
24,León,104,"Omañas, Las",316,168,148
24,León,105,Onzonilla,1775,931,844
24,León,106,Oseja de Sajambre,282,163,119
24,León,107,Pajares de los Oteros,330,210,120
24,León,108,Palacios de la Valduerna,435,211,224
24,León,109,Palacios del Sil,1139,625,514
24,León,110,Páramo del Sil,1414,709,705
24,León,112,Peranzanes,324,185,139
24,León,113,Pobladura de Pelayo García,422,215,207
24,León,114,"Pola de Gordón, La",3823,1904,1919
24,León,115,Ponferrada,68121,32660,35461
24,León,116,Posada de Valdeón,481,293,188
24,León,117,Pozuelo del Páramo,510,267,243
24,León,118,Prado de la Guzpeña,136,77,59
24,León,119,Priaranza del Bierzo,828,422,406
24,León,120,Prioro,396,224,172
24,León,121,Puebla de Lillo,688,380,308
24,León,122,Puente de Domingo Flórez,1565,808,757
24,León,123,Quintana del Castillo,796,438,358
24,León,124,Quintana del Marco,439,235,204
24,León,125,Quintana y Congosto,410,205,205
24,León,127,Regueras de Arriba,330,180,150
24,León,129,Reyero,121,63,58
24,León,130,Riaño,498,296,202
24,León,131,Riego de la Vega,879,450,429
24,León,132,Riello,693,383,310
24,León,133,Rioseco de Tapia,389,207,182
24,León,134,"Robla, La",4482,2275,2207
24,León,136,Roperuelos del Páramo,614,314,300
24,León,137,Sabero,1313,643,670
24,León,139,Sahagún,2791,1386,1405
24,León,141,San Adrián del Valle,114,59,55
24,León,142,San Andrés del Rabanedo,31862,15412,16450
24,León,144,San Cristóbal de la Polantera,826,413,413
24,León,145,San Emiliano,703,377,326
24,León,146,San Esteban de Nogales,284,146,138
24,León,148,San Justo de la Vega,1991,1009,982
24,León,149,San Millán de los Caballeros,190,100,90
24,León,150,San Pedro Bercianos,265,140,125
24,León,143,Sancedo,571,284,287
24,León,151,Santa Colomba de Curueño,540,281,259
24,León,152,Santa Colomba de Somoza,501,272,229
24,León,153,Santa Cristina de Valmadrigal,300,158,142
24,León,154,Santa Elena de Jamuz,1173,609,564
24,León,155,Santa María de la Isla,558,294,264
24,León,158,Santa María de Ordás,346,174,172
24,León,156,Santa María del Monte de Cea,263,135,128
24,León,157,Santa María del Páramo,3175,1559,1616
24,León,159,Santa Marina del Rey,2077,1031,1046
24,León,160,Santas Martas,852,451,401
24,León,161,Santiago Millas,322,175,147
24,León,162,Santovenia de la Valdoncina,1978,1025,953
24,León,163,Sariegos,4778,2419,2359
24,León,164,Sena de Luna,398,198,200
24,León,165,Sobrado,368,185,183
24,León,166,Soto de la Vega,1682,869,813
24,León,167,Soto y Amío,897,448,449
24,León,168,Toral de los Guzmanes,567,304,263
24,León,206,Toral de los Vados,2108,1042,1066
24,León,169,Toreno,3525,1745,1780
24,León,170,Torre del Bierzo,2440,1242,1198
24,León,171,Trabadelo,426,240,186
24,León,172,Truchas,492,243,249
24,León,173,Turcia,1092,551,541
24,León,174,Urdiales del Páramo,533,273,260
24,León,185,Val de San Lorenzo,549,275,274
24,León,175,Valdefresno,2088,1086,1002
24,León,176,Valdefuentes del Páramo,337,173,164
24,León,177,Valdelugueros,538,305,233
24,León,178,Valdemora,82,34,48
24,León,179,Valdepiélago,351,186,165
24,León,180,Valdepolo,1303,682,621
24,León,181,Valderas,1876,951,925
24,León,182,Valderrey,476,224,252
24,León,183,Valderrueda,944,478,466
24,León,184,Valdesamario,219,124,95
24,León,187,Valdevimbre,1017,524,493
24,León,188,Valencia de Don Juan,5199,2554,2645
24,León,191,Vallecillo,135,72,63
24,León,189,Valverde de la Virgen,7165,3705,3460
24,León,190,Valverde-Enrique,182,96,86
24,León,193,"Vecilla, La",419,221,198
24,León,196,Vega de Espinareda,2380,1203,1177
24,León,197,Vega de Infanzones,932,475,457
24,León,198,Vega de Valcarce,676,347,329
24,León,194,Vegacervera,329,174,155
24,León,199,Vegaquemada,456,236,220
24,León,201,Vegas del Condado,1157,643,514
24,León,202,Villablino,10003,4918,5085
24,León,203,Villabraz,114,66,48
24,León,205,Villadangos del Páramo,1117,592,525
24,León,207,Villademor de la Vega,390,205,185
24,León,209,Villafranca del Bierzo,3316,1602,1714
24,León,210,Villagatón,635,328,307
24,León,211,Villamandos,318,173,145
24,León,901,Villamanín,1087,543,544
24,León,212,Villamañán,1226,595,631
24,León,213,Villamartín de Don Sancho,148,80,68
24,León,214,Villamejil,771,403,368
24,León,215,Villamol,185,91,94
24,León,216,Villamontán de la Valduerna,830,434,396
24,León,217,Villamoratiel de las Matas,155,86,69
24,León,218,Villanueva de las Manzanas,512,259,253
24,León,219,Villaobispo de Otero,629,336,293
24,León,902,Villaornate y Castro,406,207,199
24,León,221,Villaquejida,967,485,482
24,León,222,Villaquilambre,18343,9163,9180
24,León,223,Villarejo de Órbigo,3199,1565,1634
24,León,224,Villares de Órbigo,701,373,328
24,León,225,Villasabariego,1223,638,585
24,León,226,Villaselán,212,118,94
24,León,227,Villaturiel,1970,1038,932
24,León,228,Villazala,764,404,360
24,León,229,Villazanzo de Valderaduey,508,288,220
24,León,230,Zotes del Páramo,482,274,208
25,Lleida,1,Abella de la Conca,165,90,75
25,Lleida,2,Àger,604,327,277
25,Lleida,3,Agramunt,5599,2852,2747
25,Lleida,38,Aitona,2402,1234,1168
25,Lleida,4,"Alamús, Els",752,395,357
25,Lleida,5,Alàs i Cerc,359,183,176
25,Lleida,6,"Albagés, L'",427,224,203
25,Lleida,7,Albatàrrec,2090,1096,994
25,Lleida,8,Albesa,1636,885,751
25,Lleida,9,"Albi, L'",863,448,415
25,Lleida,10,Alcanó,244,119,125
25,Lleida,11,Alcarràs,9026,4691,4335
25,Lleida,12,Alcoletge,3224,1697,1527
25,Lleida,13,Alfarràs,3001,1541,1460
25,Lleida,14,Alfés,319,164,155
25,Lleida,15,Algerri,431,228,203
25,Lleida,16,Alguaire,3113,1636,1477
25,Lleida,17,Alins,301,157,144
25,Lleida,19,Almacelles,6724,3497,3227
25,Lleida,20,Almatret,348,183,165
25,Lleida,21,Almenar,3612,1925,1687
25,Lleida,22,Alòs de Balaguer,133,75,58
25,Lleida,23,Alpicat,6267,3120,3147
25,Lleida,24,Alt Àneu,416,233,183
25,Lleida,27,Anglesola,1384,683,701
25,Lleida,29,Arbeca,2470,1270,1200
25,Lleida,31,Arres,61,40,21
25,Lleida,32,Arsèguel,84,45,39
25,Lleida,33,Artesa de Lleida,1519,797,722
25,Lleida,34,Artesa de Segre,3708,1887,1821
25,Lleida,36,Aspa,212,107,105
25,Lleida,37,"Avellanes i Santa Linya, Les",474,270,204
25,Lleida,39,Baix Pallars,376,195,181
25,Lleida,40,Balaguer,16665,8494,8171
25,Lleida,41,Barbens,870,455,415
25,Lleida,42,"Baronia de Rialb, La",257,137,120
25,Lleida,44,Bassella,249,127,122
25,Lleida,45,Bausen,52,31,21
25,Lleida,46,Belianes,556,286,270
25,Lleida,170,Bellaguarda,317,166,151
25,Lleida,47,Bellcaire d'Urgell,1315,673,642
25,Lleida,48,Bell-lloc d'Urgell,2337,1148,1189
25,Lleida,49,Bellmunt d'Urgell,198,97,101
25,Lleida,50,Bellpuig,5001,2589,2412
25,Lleida,51,Bellver de Cerdanya,2185,1150,1035
25,Lleida,52,Bellvís,2371,1188,1183
25,Lleida,53,Benavent de Segrià,1527,795,732
25,Lleida,55,Biosca,202,110,92
25,Lleida,57,"Bòrdes, Es",236,133,103
25,Lleida,58,"Borges Blanques, Les",6103,3122,2981
25,Lleida,59,Bossòst,1187,596,591
25,Lleida,56,Bovera,291,157,134
25,Lleida,60,Cabanabona,97,44,53
25,Lleida,61,Cabó,94,47,47
25,Lleida,62,Camarasa,941,479,462
25,Lleida,63,Canejan,102,54,48
25,Lleida,904,Castell de Mur,168,89,79
25,Lleida,64,Castellar de la Ribera,157,84,73
25,Lleida,67,Castelldans,1000,530,470
25,Lleida,68,Castellnou de Seana,776,407,369
25,Lleida,69,Castelló de Farfanya,555,298,257
25,Lleida,70,Castellserà,1078,544,534
25,Lleida,71,Cava,60,34,26
25,Lleida,72,Cervera,9212,4652,4560
25,Lleida,73,Cervià de les Garrigues,726,380,346
25,Lleida,74,Ciutadilla,209,114,95
25,Lleida,75,Clariana de Cardener,141,73,68
25,Lleida,76,"Cogul, El",193,108,85
25,Lleida,77,Coll de Nargó,583,292,291
25,Lleida,163,"Coma i la Pedra, La",273,163,110
25,Lleida,161,Conca de Dalt,446,233,213
25,Lleida,78,Corbins,1401,743,658
25,Lleida,79,Cubells,419,223,196
25,Lleida,81,"Espluga Calba, L'",401,205,196
25,Lleida,82,Espot,358,196,162
25,Lleida,88,Estamariu,126,74,52
25,Lleida,85,Estaràs,158,85,73
25,Lleida,86,Esterri d'Àneu,888,457,431
25,Lleida,87,Esterri de Cardós,70,36,34
25,Lleida,89,Farrera,124,72,52
25,Lleida,908,Fígols i Alinyà,267,149,118
25,Lleida,92,"Floresta, La",164,89,75
25,Lleida,93,Fondarella,818,412,406
25,Lleida,94,Foradada,185,106,79
25,Lleida,96,"Fuliola, La",1300,663,637
25,Lleida,97,Fulleda,105,53,52
25,Lleida,98,Gavet de la Conca,300,150,150
25,Lleida,912,Gimenells i el Pla de la Font,1141,584,557
25,Lleida,99,Golmés,1752,874,878
25,Lleida,100,Gósol,217,127,90
25,Lleida,101,"Granadella, La",750,398,352
25,Lleida,102,"Granja d'Escarp, La",988,521,467
25,Lleida,103,Granyanella,142,76,66
25,Lleida,105,Granyena de les Garrigues,173,103,70
25,Lleida,104,Granyena de Segarra,127,60,67
25,Lleida,109,Guimerà,296,161,135
25,Lleida,903,"Guingueta d'Àneu, La",326,168,158
25,Lleida,110,Guissona,6796,3622,3174
25,Lleida,111,Guixers,130,78,52
25,Lleida,115,Isona i Conca Dellà,1053,560,493
25,Lleida,112,Ivars de Noguera,365,190,175
25,Lleida,113,Ivars d'Urgell,1619,853,766
25,Lleida,114,Ivorra,119,63,56
25,Lleida,910,Josa i Tuixén,141,80,61
25,Lleida,118,Juncosa,443,239,204
25,Lleida,119,Juneda,3481,1820,1661
25,Lleida,121,Les,986,493,493
25,Lleida,122,Linyola,2654,1350,1304
25,Lleida,123,Lladorre,238,116,122
25,Lleida,124,Lladurs,187,103,84
25,Lleida,125,Llardecans,497,255,242
25,Lleida,126,Llavorsí,361,186,175
25,Lleida,120,Lleida,139809,69294,70515
25,Lleida,127,Lles de Cerdanya,266,159,107
25,Lleida,128,Llimiana,162,94,68
25,Lleida,129,Llobera,210,112,98
25,Lleida,133,Maials,958,498,460
25,Lleida,130,Maldà,233,119,114
25,Lleida,131,Massalcoreig,565,299,266
25,Lleida,132,Massoteres,204,113,91
25,Lleida,134,Menàrguens,885,481,404
25,Lleida,135,Miralcamp,1408,711,697
25,Lleida,137,Mollerussa,14959,7632,7327
25,Lleida,136,"Molsosa, La",104,52,52
25,Lleida,139,Montellà i Martinet,647,350,297
25,Lleida,140,Montferrer i Castellbò,1022,554,468
25,Lleida,138,Montgai,688,354,334
25,Lleida,142,Montoliu de Lleida,504,256,248
25,Lleida,141,Montoliu de Segarra,196,116,80
25,Lleida,143,Montornès de Segarra,102,51,51
25,Lleida,145,Nalec,105,55,50
25,Lleida,25,Naut Aran,1780,899,881
25,Lleida,146,Navès,267,133,134
25,Lleida,148,Odèn,269,161,108
25,Lleida,149,Oliana,1903,932,971
25,Lleida,150,Oliola,230,127,103
25,Lleida,151,Olius,903,460,443
25,Lleida,152,"Oluges, Les",162,86,76
25,Lleida,153,"Omellons, Els",234,125,109
25,Lleida,154,"Omells de na Gaia, Els",143,76,67
25,Lleida,155,Organyà,875,439,436
25,Lleida,156,Os de Balaguer,1015,517,498
25,Lleida,157,Ossó de Sió,210,104,106
25,Lleida,158,"Palau d'Anglesola, El",2185,1088,1097
25,Lleida,164,Penelles,511,302,209
25,Lleida,165,Peramola,361,181,180
25,Lleida,166,Pinell de Solsonès,211,117,94
25,Lleida,167,Pinós,296,162,134
25,Lleida,911,"Plans de Sió, Els",545,290,255
25,Lleida,168,"Poal, El",648,339,309
25,Lleida,169,"Pobla de Cérvoles, La",234,129,105
25,Lleida,171,"Pobla de Segur, La",3073,1520,1553
25,Lleida,30,"Pont de Bar, El",176,102,74
25,Lleida,173,"Pont de Suert, El",2441,1241,1200
25,Lleida,172,Ponts,2690,1339,1351
25,Lleida,174,"Portella, La",767,420,347
25,Lleida,175,Prats i Sansor,281,145,136
25,Lleida,176,Preixana,410,207,203
25,Lleida,177,Preixens,464,232,232
25,Lleida,179,Prullans,219,108,111
25,Lleida,180,Puiggròs,302,163,139
25,Lleida,181,Puigverd d'Agramunt,269,153,116
25,Lleida,182,Puigverd de Lleida,1440,737,703
25,Lleida,183,Rialp,670,348,322
25,Lleida,905,Ribera d'Ondara,421,216,205
25,Lleida,185,Ribera d'Urgellet,955,493,462
25,Lleida,186,Riner,285,135,150
25,Lleida,913,Riu de Cerdanya,117,63,54
25,Lleida,189,Rosselló,3084,1578,1506
25,Lleida,190,Salàs de Pallars,369,192,177
25,Lleida,191,Sanaüja,444,230,214
25,Lleida,196,Sant Esteve de la Sarga,134,78,56
25,Lleida,192,Sant Guim de Freixenet,1112,576,536
25,Lleida,197,Sant Guim de la Plana,184,98,86
25,Lleida,193,Sant Llorenç de Morunys,1000,499,501
25,Lleida,902,Sant Martí de Riucorb,691,362,329
25,Lleida,194,Sant Ramon,525,289,236
25,Lleida,201,Sarroca de Bellera,126,75,51
25,Lleida,200,Sarroca de Lleida,401,219,182
25,Lleida,202,Senterada,140,82,58
25,Lleida,35,"Sentiu de Sió, La",475,239,236
25,Lleida,204,Seròs,1911,1045,866
25,Lleida,203,"Seu d'Urgell, La",12468,6062,6406
25,Lleida,205,Sidamon,735,375,360
25,Lleida,206,"Soleràs, El",362,184,178
25,Lleida,207,Solsona,9188,4591,4597
25,Lleida,208,Soriguera,374,200,174
25,Lleida,209,Sort,2274,1143,1131
25,Lleida,210,Soses,1753,908,845
25,Lleida,211,Sudanell,888,494,394
25,Lleida,212,Sunyer,298,157,141
25,Lleida,215,Talarn,436,236,200
25,Lleida,216,Talavera,279,156,123
25,Lleida,217,Tàrrega,16670,8347,8323
25,Lleida,218,Tarrés,107,63,44
25,Lleida,219,Tarroja de Segarra,171,89,82
25,Lleida,220,Térmens,1548,775,773
25,Lleida,221,Tírvia,160,81,79
25,Lleida,222,Tiurana,77,35,42
25,Lleida,223,Torà,1253,629,624
25,Lleida,224,"Torms, Els",153,83,70
25,Lleida,225,Tornabous,935,505,430
25,Lleida,227,"Torre de Cabdella, La",747,372,375
25,Lleida,226,Torrebesses,300,157,143
25,Lleida,228,Torrefarrera,4400,2208,2192
25,Lleida,907,Torrefeta i Florejacs,617,324,293
25,Lleida,230,Torregrossa,2234,1129,1105
25,Lleida,231,Torrelameu,735,416,319
25,Lleida,232,Torres de Segre,2246,1159,1087
25,Lleida,233,Torre-serona,369,188,181
25,Lleida,234,Tremp,6288,3112,3176
25,Lleida,43,"Vall de Boí, La",1023,545,478
25,Lleida,901,Vall de Cardós,394,212,182
25,Lleida,238,Vallbona de les Monges,259,138,121
25,Lleida,240,Vallfogona de Balaguer,1877,924,953
25,Lleida,906,"Valls d'Aguilar, Les",320,167,153
25,Lleida,239,"Valls de Valira, Les",879,449,430
25,Lleida,909,"Vansa i Fórnols, La",206,109,97
25,Lleida,242,Verdú,1002,478,524
25,Lleida,243,Vielha e Mijaran,5508,2823,2685
25,Lleida,244,Vilagrassa,513,266,247
25,Lleida,245,Vilaller,633,348,285
25,Lleida,247,Vilamòs,178,100,78
25,Lleida,248,Vilanova de Bellpuig,1164,595,569
25,Lleida,254,Vilanova de la Barca,1141,568,573
25,Lleida,249,Vilanova de l'Aguda,237,119,118
25,Lleida,250,Vilanova de Meià,413,220,193
25,Lleida,251,Vilanova de Segrià,900,473,427
25,Lleida,252,Vila-sana,719,362,357
25,Lleida,253,"Vilosell, El",192,97,95
25,Lleida,255,Vinaixa,567,291,276
27,Lugo,1,Abadín,2721,1340,1381
27,Lugo,2,Alfoz,1946,948,998
27,Lugo,3,Antas de Ulla,2171,1063,1108
27,Lugo,4,Baleira,1420,755,665
27,Lugo,901,Baralla,2798,1451,1347
27,Lugo,5,Barreiros,3061,1476,1585
27,Lugo,6,Becerreá,3048,1538,1510
27,Lugo,7,Begonte,3231,1608,1623
27,Lugo,8,Bóveda,1570,774,796
27,Lugo,902,Burela,9672,4872,4800
27,Lugo,9,Carballedo,2465,1230,1235
27,Lugo,10,Castro de Rei,5267,2585,2682
27,Lugo,11,Castroverde,2840,1455,1385
27,Lugo,12,Cervantes,1563,890,673
27,Lugo,13,Cervo,4430,2180,2250
27,Lugo,16,Chantada,8649,4209,4440
27,Lugo,14,"Corgo, O",3761,1904,1857
27,Lugo,15,Cospeito,4954,2408,2546
27,Lugo,17,Folgoso do Courel,1136,594,542
27,Lugo,18,"Fonsagrada, A",4059,2117,1942
27,Lugo,19,Foz,9966,4853,5113
27,Lugo,20,Friol,4071,2035,2036
27,Lugo,22,Guitiriz,5603,2798,2805
27,Lugo,23,Guntín,2980,1511,1469
27,Lugo,24,"Incio, O",1822,889,933
27,Lugo,26,Láncara,2839,1437,1402
27,Lugo,27,Lourenzá,2348,1127,1221
27,Lugo,28,Lugo,98761,46094,52667
27,Lugo,29,Meira,1769,887,882
27,Lugo,30,Mondoñedo,4074,1900,2174
27,Lugo,31,Monforte de Lemos,19426,9243,10183
27,Lugo,32,Monterroso,3888,1927,1961
27,Lugo,33,Muras,723,366,357
27,Lugo,34,Navia de Suarna,1299,721,578
27,Lugo,35,Negueira de Muñiz,217,116,101
27,Lugo,37,"Nogais, As",1270,651,619
27,Lugo,38,Ourol,1123,553,570
27,Lugo,39,Outeiro de Rei,5098,2614,2484
27,Lugo,40,Palas de Rei,3613,1790,1823
27,Lugo,41,Pantón,2772,1340,1432
27,Lugo,42,Paradela,2004,989,1015
27,Lugo,43,"Páramo, O",1520,756,764
27,Lugo,44,"Pastoriza, A",3362,1675,1687
27,Lugo,45,Pedrafita do Cebreiro,1175,623,552
27,Lugo,47,"Pobra do Brollón, A",1894,949,945
27,Lugo,46,Pol,1757,866,891
27,Lugo,48,"Pontenova, A",2610,1264,1346
27,Lugo,49,Portomarín,1654,837,817
27,Lugo,50,Quiroga,3552,1703,1849
27,Lugo,56,Rábade,1637,825,812
27,Lugo,51,Ribadeo,9994,4755,5239
27,Lugo,52,Ribas de Sil,1033,515,518
27,Lugo,53,Ribeira de Piquín,609,311,298
27,Lugo,54,Riotorto,1417,690,727
27,Lugo,55,Samos,1502,791,711
27,Lugo,57,Sarria,13488,6604,6884
27,Lugo,58,"Saviñao, O",4202,2097,2105
27,Lugo,59,Sober,2469,1176,1293
27,Lugo,60,Taboada,3173,1530,1643
27,Lugo,61,Trabada,1228,600,628
27,Lugo,62,Triacastela,739,370,369
27,Lugo,63,"Valadouro, O",2100,1035,1065
27,Lugo,64,"Vicedo, O",1898,941,957
27,Lugo,65,Vilalba,14980,7297,7683
27,Lugo,66,Viveiro,16016,7839,8177
27,Lugo,21,Xermade,2071,993,1078
27,Lugo,25,Xove,3497,1733,1764
28,Madrid,1,"Acebeda, La",67,37,30
28,Madrid,2,Ajalvir,4261,2235,2026
28,Madrid,3,Alameda del Valle,248,143,105
28,Madrid,4,"Álamo, El",8845,4376,4469
28,Madrid,5,Alcalá de Henares,204823,101914,102909
28,Madrid,6,Alcobendas,112196,54245,57951
28,Madrid,7,Alcorcón,169773,82838,86935
28,Madrid,8,Aldea del Fresno,2574,1356,1218
28,Madrid,9,Algete,20136,10003,10133
28,Madrid,10,Alpedrete,13996,6929,7067
28,Madrid,11,Ambite,586,305,281
28,Madrid,12,Anchuelo,1209,644,565
28,Madrid,13,Aranjuez,57728,28234,29494
28,Madrid,14,Arganda del Rey,55981,28593,27388
28,Madrid,15,Arroyomolinos,24313,12357,11956
28,Madrid,16,"Atazar, El",103,54,49
28,Madrid,17,Batres,1558,795,763
28,Madrid,18,Becerril de la Sierra,5388,2686,2702
28,Madrid,19,Belmonte de Tajo,1591,816,775
28,Madrid,21,"Berrueco, El",633,329,304
28,Madrid,20,Berzosa del Lozoya,214,118,96
28,Madrid,22,Boadilla del Monte,47587,23335,24252
28,Madrid,23,"Boalo, El",7050,3645,3405
28,Madrid,24,Braojos,210,118,92
28,Madrid,25,Brea de Tajo,563,317,246
28,Madrid,26,Brunete,10075,5014,5061
28,Madrid,27,Buitrago del Lozoya,1964,976,988
28,Madrid,28,Bustarviejo,2372,1199,1173
28,Madrid,29,Cabanillas de la Sierra,743,388,355
28,Madrid,30,"Cabrera, La",2613,1322,1291
28,Madrid,31,Cadalso de los Vidrios,2915,1517,1398
28,Madrid,32,Camarma de Esteruelas,6995,3604,3391
28,Madrid,33,Campo Real,5715,2933,2782
28,Madrid,34,Canencia,483,261,222
28,Madrid,35,Carabaña,2017,1017,1000
28,Madrid,36,Casarrubuelos,3361,1710,1651
28,Madrid,37,Cenicientos,2091,1026,1065
28,Madrid,38,Cercedilla,6890,3355,3535
28,Madrid,39,Cervera de Buitrago,180,105,75
28,Madrid,51,Chapinería,2194,1117,1077
28,Madrid,52,Chinchón,5428,2780,2648
28,Madrid,40,Ciempozuelos,23950,11993,11957
28,Madrid,41,Cobeña,6984,3468,3516
28,Madrid,46,Collado Mediano,6746,3407,3339
28,Madrid,47,Collado Villalba,62684,30704,31980
28,Madrid,43,Colmenar de Oreja,8424,4319,4105
28,Madrid,42,Colmenar del Arroyo,1581,803,778
28,Madrid,45,Colmenar Viejo,46955,23169,23786
28,Madrid,44,Colmenarejo,8919,4424,4495
28,Madrid,48,Corpa,658,352,306
28,Madrid,49,Coslada,91425,45705,45720
28,Madrid,50,Cubas de la Sagra,5525,2725,2800
28,Madrid,53,Daganzo de Arriba,9793,4933,4860
28,Madrid,54,"Escorial, El",15197,7495,7702
28,Madrid,55,Estremera,1468,766,702
28,Madrid,56,Fresnedillas de la Oliva,1577,815,762
28,Madrid,57,Fresno de Torote,2043,1093,950
28,Madrid,58,Fuenlabrada,197520,98627,98893
28,Madrid,59,Fuente el Saz de Jarama,6324,3210,3114
28,Madrid,60,Fuentidueña de Tajo,2108,1067,1041
28,Madrid,61,Galapagar,32523,16107,16416
28,Madrid,62,Garganta de los Montes,393,201,192
28,Madrid,63,Gargantilla del Lozoya y Pinilla de Buitrago,368,199,169
28,Madrid,64,Gascones,176,99,77
28,Madrid,65,Getafe,172526,84927,87599
28,Madrid,66,Griñón,9873,4924,4949
28,Madrid,67,Guadalix de la Sierra,6071,3072,2999
28,Madrid,68,Guadarrama,15712,7774,7938
28,Madrid,69,"Hiruela, La",51,33,18
28,Madrid,70,Horcajo de la Sierra-Aoslos,169,96,73
28,Madrid,71,Horcajuelo de la Sierra,86,41,45
28,Madrid,72,Hoyo de Manzanares,7872,3985,3887
28,Madrid,73,Humanes de Madrid,19248,9798,9450
28,Madrid,74,Leganés,186995,91606,95389
28,Madrid,75,Loeches,8078,4052,4026
28,Madrid,76,Lozoya,625,323,302
28,Madrid,901,Lozoyuela-Navas-Sieteiglesias,1216,636,580
28,Madrid,78,Madarcos,55,32,23
28,Madrid,79,Madrid,3207247,1494592,1712655
28,Madrid,80,Majadahonda,70386,33435,36951
28,Madrid,82,Manzanares el Real,8053,4112,3941
28,Madrid,83,Meco,12925,6555,6370
28,Madrid,84,Mejorada del Campo,23048,11500,11548
28,Madrid,85,Miraflores de la Sierra,5907,3023,2884
28,Madrid,86,"Molar, El",8365,4266,4099
28,Madrid,87,"Molinos, Los",4485,2225,2260
28,Madrid,88,Montejo de la Sierra,359,180,179
28,Madrid,89,Moraleja de Enmedio,4937,2475,2462
28,Madrid,90,Moralzarzal,12168,6089,6079
28,Madrid,91,Morata de Tajuña,7553,3790,3763
28,Madrid,92,Móstoles,206451,101585,104866
28,Madrid,93,Navacerrada,2863,1408,1455
28,Madrid,94,Navalafuente,1223,645,578
28,Madrid,95,Navalagamella,2436,1277,1159
28,Madrid,96,Navalcarnero,26085,13092,12993
28,Madrid,97,Navarredonda y San Mamés,128,76,52
28,Madrid,99,Navas del Rey,2684,1430,1254
28,Madrid,100,Nuevo Baztán,6299,3203,3096
28,Madrid,101,Olmeda de las Fuentes,340,181,159
28,Madrid,102,Orusco de Tajuña,1308,670,638
28,Madrid,104,Paracuellos de Jarama,21128,10755,10373
28,Madrid,106,Parla,125634,63413,62221
28,Madrid,107,Patones,502,243,259
28,Madrid,108,Pedrezuela,5082,2573,2509
28,Madrid,109,Pelayos de la Presa,2537,1299,1238
28,Madrid,110,Perales de Tajuña,2990,1515,1475
28,Madrid,111,Pezuela de las Torres,798,422,376
28,Madrid,112,Pinilla del Valle,210,121,89
28,Madrid,113,Pinto,46870,23356,23514
28,Madrid,114,Piñuécar-Gandullas,176,87,89
28,Madrid,115,Pozuelo de Alarcón,84474,40505,43969
28,Madrid,116,Pozuelo del Rey,1052,554,498
28,Madrid,117,Prádena del Rincón,126,69,57
28,Madrid,118,Puebla de la Sierra,96,55,41
28,Madrid,902,Puentes Viejas,648,373,275
28,Madrid,119,Quijorna,3190,1641,1549
28,Madrid,120,Rascafría,1893,1034,859
28,Madrid,121,Redueña,284,154,130
28,Madrid,122,Ribatejada,696,350,346
28,Madrid,123,Rivas-Vaciamadrid,78133,39100,39033
28,Madrid,124,Robledillo de la Jara,102,53,49
28,Madrid,125,Robledo de Chavela,4137,2148,1989
28,Madrid,126,Robregordo,60,35,25
28,Madrid,127,"Rozas de Madrid, Las",91806,44508,47298
28,Madrid,128,Rozas de Puerto Real,484,279,205
28,Madrid,129,San Agustín del Guadalix,12955,6439,6516
28,Madrid,130,San Fernando de Henares,41226,20418,20808
28,Madrid,131,San Lorenzo de El Escorial,18495,8863,9632
28,Madrid,132,San Martín de la Vega,19672,10210,9462
28,Madrid,133,San Martín de Valdeiglesias,8524,4237,4287
28,Madrid,134,San Sebastián de los Reyes,82090,40125,41965
28,Madrid,135,Santa María de la Alameda,1214,651,563
28,Madrid,136,Santorcaz,845,436,409
28,Madrid,137,"Santos de la Humosa, Los",2421,1246,1175
28,Madrid,138,"Serna del Monte, La",93,51,42
28,Madrid,140,Serranillos del Valle,3816,1881,1935
28,Madrid,141,Sevilla la Nueva,8925,4430,4495
28,Madrid,143,Somosierra,82,46,36
28,Madrid,144,Soto del Real,8519,4182,4337
28,Madrid,145,Talamanca de Jarama,3211,1610,1601
28,Madrid,146,Tielmes,2658,1368,1290
28,Madrid,147,Titulcia,1237,647,590
28,Madrid,148,Torrejón de Ardoz,123761,61611,62150
28,Madrid,149,Torrejón de la Calzada,7743,3854,3889
28,Madrid,150,Torrejón de Velasco,4177,2121,2056
28,Madrid,151,Torrelaguna,4861,2498,2363
28,Madrid,152,Torrelodones,22782,10995,11787
28,Madrid,153,Torremocha de Jarama,892,433,459
28,Madrid,154,Torres de la Alameda,7899,4049,3850
28,Madrid,903,Tres Cantos,41896,20289,21607
28,Madrid,155,Valdaracete,669,341,328
28,Madrid,156,Valdeavero,1494,785,709
28,Madrid,157,Valdelaguna,871,443,428
28,Madrid,158,Valdemanco,958,511,447
28,Madrid,159,Valdemaqueda,882,432,450
28,Madrid,160,Valdemorillo,11988,6155,5833
28,Madrid,161,Valdemoro,71578,35762,35816
28,Madrid,162,Valdeolmos-Alalpardo,3633,1848,1785
28,Madrid,163,Valdepiélagos,574,296,278
28,Madrid,164,Valdetorres de Jarama,4176,2127,2049
28,Madrid,165,Valdilecha,2910,1496,1414
28,Madrid,166,Valverde de Alcalá,453,245,208
28,Madrid,167,Velilla de San Antonio,12246,6186,6060
28,Madrid,168,"Vellón, El",1824,943,881
28,Madrid,169,Venturada,1968,1025,943
28,Madrid,171,Villa del Prado,6502,3365,3137
28,Madrid,170,Villaconejos,3495,1777,1718
28,Madrid,172,Villalbilla,11643,5934,5709
28,Madrid,173,Villamanrique de Tajo,798,409,389
28,Madrid,174,Villamanta,2514,1253,1261
28,Madrid,175,Villamantilla,1238,606,632
28,Madrid,176,Villanueva de la Cañada,18734,9096,9638
28,Madrid,178,Villanueva de Perales,1458,755,703
28,Madrid,177,Villanueva del Pardillo,16690,8144,8546
28,Madrid,179,Villar del Olmo,2115,1091,1024
28,Madrid,180,Villarejo de Salvanés,7389,3736,3653
28,Madrid,181,Villaviciosa de Odón,26982,13131,13851
28,Madrid,182,Villavieja del Lozoya,277,147,130
28,Madrid,183,Zarzalejo,1553,818,735
29,Málaga,1,Alameda,5455,2744,2711
29,Málaga,2,Alcaucín,2832,1438,1394
29,Málaga,3,Alfarnate,1240,633,607
29,Málaga,4,Alfarnatejo,515,267,248
29,Málaga,5,Algarrobo,6601,3314,3287
29,Málaga,6,Algatocín,866,442,424
29,Málaga,7,Alhaurín de la Torre,38067,19005,19062
29,Málaga,8,Alhaurín el Grande,24249,12144,12105
29,Málaga,9,Almáchar,1915,984,931
29,Málaga,10,Almargen,2045,1046,999
29,Málaga,11,Almogía,4168,2138,2030
29,Málaga,12,Álora,13342,6708,6634
29,Málaga,13,Alozaina,2206,1120,1086
29,Málaga,14,Alpandeire,271,141,130
29,Málaga,15,Antequera,41620,20441,21179
29,Málaga,16,Árchez,487,256,231
29,Málaga,17,Archidona,8705,4371,4334
29,Málaga,18,Ardales,2588,1304,1284
29,Málaga,19,Arenas,1397,735,662
29,Málaga,20,Arriate,4075,2010,2065
29,Málaga,21,Atajate,142,74,68
29,Málaga,22,Benadalid,258,125,133
29,Málaga,23,Benahavís,6380,3220,3160
29,Málaga,24,Benalauría,492,262,230
29,Málaga,25,Benalmádena,69002,34141,34861
29,Málaga,26,Benamargosa,1613,825,788
29,Málaga,27,Benamocarra,3084,1560,1524
29,Málaga,28,Benaoján,1531,795,736
29,Málaga,29,Benarrabá,544,272,272
29,Málaga,30,"Borge, El",984,503,481
29,Málaga,31,"Burgo, El",1947,977,970
29,Málaga,32,Campillos,8677,4347,4330
29,Málaga,33,Canillas de Aceituno,1851,976,875
29,Málaga,34,Canillas de Albaida,979,499,480
29,Málaga,35,Cañete la Real,1812,913,899
29,Málaga,36,Carratraca,816,412,404
29,Málaga,37,Cartajima,250,130,120
29,Málaga,38,Cártama,24242,12355,11887
29,Málaga,39,Casabermeja,3651,1951,1700
29,Málaga,40,Casarabonela,2690,1422,1268
29,Málaga,41,Casares,5754,2988,2766
29,Málaga,42,Coín,22536,11465,11071
29,Málaga,43,Colmenar,3583,1834,1749
29,Málaga,44,Comares,1583,831,752
29,Málaga,45,Cómpeta,3885,1972,1913
29,Málaga,46,Cortes de la Frontera,3461,1767,1694
29,Málaga,47,Cuevas Bajas,1451,717,734
29,Málaga,49,Cuevas de San Marcos,4029,2018,2011
29,Málaga,48,Cuevas del Becerro,1704,844,860
29,Málaga,50,Cútar,661,336,325
29,Málaga,51,Estepona,67986,33849,34137
29,Málaga,52,Faraján,246,120,126
29,Málaga,53,Frigiliana,3395,1690,1705
29,Málaga,54,Fuengirola,77397,37951,39446
29,Málaga,55,Fuente de Piedra,2733,1379,1354
29,Málaga,56,Gaucín,1647,862,785
29,Málaga,57,Genalguacil,499,259,240
29,Málaga,58,Guaro,2284,1149,1135
29,Málaga,59,Humilladero,3430,1724,1706
29,Málaga,60,Igualeja,823,419,404
29,Málaga,61,Istán,1398,715,683
29,Málaga,62,Iznate,943,494,449
29,Málaga,63,Jimera de Líbar,461,241,220
29,Málaga,64,Jubrique,712,356,356
29,Málaga,65,Júzcar,239,136,103
29,Málaga,66,Macharaviaya,500,268,232
29,Málaga,67,Málaga,568479,273475,295004
29,Málaga,68,Manilva,14600,7561,7039
29,Málaga,69,Marbella,142018,69213,72805
29,Málaga,70,Mijas,85600,42917,42683
29,Málaga,71,Moclinejo,1283,666,617
29,Málaga,72,Mollina,5185,2616,2569
29,Málaga,73,Monda,2383,1209,1174
29,Málaga,74,Montejaque,1010,492,518
29,Málaga,75,Nerja,22918,11341,11577
29,Málaga,76,Ojén,3293,1684,1609
29,Málaga,77,Parauta,241,118,123
29,Málaga,79,Periana,3542,1847,1695
29,Málaga,80,Pizarra,9298,4745,4553
29,Málaga,81,Pujerra,314,167,147
29,Málaga,82,Rincón de la Victoria,41827,20653,21174
29,Málaga,83,Riogordo,3083,1604,1479
29,Málaga,84,Ronda,36665,17915,18750
29,Málaga,85,Salares,229,120,109
29,Málaga,86,Sayalonga,1568,795,773
29,Málaga,87,Sedella,715,398,317
29,Málaga,88,Sierra de Yeguas,3488,1753,1735
29,Málaga,89,Teba,4044,2024,2020
29,Málaga,90,Tolox,2295,1166,1129
29,Málaga,901,Torremolinos,69389,34786,34603
29,Málaga,91,Torrox,18514,9360,9154
29,Málaga,92,Totalán,736,380,356
29,Málaga,93,Valle de Abdalajís,2712,1366,1346
29,Málaga,94,Vélez-Málaga,76911,38212,38699
29,Málaga,95,Villanueva de Algaidas,4471,2280,2191
29,Málaga,902,Villanueva de la Concepción,3460,1702,1758
29,Málaga,98,Villanueva de Tapia,1603,817,786
29,Málaga,96,Villanueva del Rosario,3588,1762,1826
29,Málaga,97,Villanueva del Trabuco,5444,2710,2734
29,Málaga,99,Viñuela,2073,1074,999
29,Málaga,100,Yunquera,3091,1566,1525
30,Murcia,1,Abanilla,6560,3318,3242
30,Murcia,2,Abarán,13157,6635,6522
30,Murcia,3,Águilas,34930,17536,17394
30,Murcia,4,Albudeite,1371,694,677
30,Murcia,5,Alcantarilla,40695,20115,20580
30,Murcia,902,"Alcázares, Los",16568,8485,8083
30,Murcia,6,Aledo,1004,499,505
30,Murcia,7,Alguazas,9544,4971,4573
30,Murcia,8,Alhama de Murcia,21182,10784,10398
30,Murcia,9,Archena,18369,9576,8793
30,Murcia,10,Beniel,11160,5755,5405
30,Murcia,11,Blanca,6460,3282,3178
30,Murcia,12,Bullas,12288,6216,6072
30,Murcia,13,Calasparra,10558,5329,5229
30,Murcia,14,Campos del Río,2176,1039,1137
30,Murcia,15,Caravaca de la Cruz,26024,13021,13003
30,Murcia,16,Cartagena,217641,109266,108375
30,Murcia,17,Cehegín,16267,8239,8028
30,Murcia,18,Ceutí,10967,5520,5447
30,Murcia,19,Cieza,35240,17676,17564
30,Murcia,20,Fortuna,9623,5115,4508
30,Murcia,21,Fuente Álamo de Murcia,16679,8761,7918
30,Murcia,22,Jumilla,25710,13338,12372
30,Murcia,23,Librilla,4839,2461,2378
30,Murcia,24,Lorca,92718,47909,44809
30,Murcia,25,Lorquí,6954,3547,3407
30,Murcia,26,Mazarrón,35661,18535,17126
30,Murcia,27,Molina de Segura,68450,34292,34158
30,Murcia,28,Moratalla,8229,4182,4047
30,Murcia,29,Mula,17057,8782,8275
30,Murcia,30,Murcia,438246,214904,223342
30,Murcia,31,Ojós,531,295,236
30,Murcia,32,Pliego,3901,2009,1892
30,Murcia,33,Puerto Lumbreras,14564,7288,7276
30,Murcia,34,Ricote,1417,727,690
30,Murcia,35,San Javier,32786,16734,16052
30,Murcia,36,San Pedro del Pinatar,24102,12186,11916
30,Murcia,901,Santomera,15793,8024,7769
30,Murcia,37,Torre-Pacheco,33575,17521,16054
30,Murcia,38,"Torres de Cotillas, Las",21565,10992,10573
30,Murcia,39,Totana,30448,15658,14790
30,Murcia,40,Ulea,935,480,455
30,Murcia,41,"Unión, La",19263,9704,9559
30,Murcia,42,Villanueva del Río Segura,2449,1210,1239
30,Murcia,43,Yecla,34393,17232,17161
31,Navarra,1,Abáigar,98,52,46
31,Navarra,2,Abárzuza/Abartzuza,556,280,276
31,Navarra,3,Abaurregaina/Abaurrea Alta,136,84,52
31,Navarra,4,Abaurrepea/Abaurrea Baja,38,26,12
31,Navarra,5,Aberin,390,210,180
31,Navarra,6,Ablitas,2632,1337,1295
31,Navarra,7,Adiós,183,97,86
31,Navarra,8,Aguilar de Codés,100,53,47
31,Navarra,9,Aibar/Oibar,873,477,396
31,Navarra,11,Allín/Allin,851,451,400
31,Navarra,12,Allo,1029,523,506
31,Navarra,10,Altsasu/Alsasua,7711,3898,3813
31,Navarra,13,Améscoa Baja,785,422,363
31,Navarra,14,Ancín/Antzin,376,208,168
31,Navarra,15,Andosilla,2883,1482,1401
31,Navarra,16,Ansoáin/Antsoain,10976,5484,5492
31,Navarra,17,Anue,460,251,209
31,Navarra,18,Añorbe,556,306,250
31,Navarra,19,Aoiz/Agoitz,2684,1353,1331
31,Navarra,20,Araitz,552,315,237
31,Navarra,25,Arakil,959,502,457
31,Navarra,21,Aranarache/Aranaratxe,82,46,36
31,Navarra,23,Aranguren,8579,4346,4233
31,Navarra,24,Arano,120,62,58
31,Navarra,22,Arantza,634,342,292
31,Navarra,26,Aras,183,101,82
31,Navarra,27,Arbizu,1099,561,538
31,Navarra,28,Arce/Artzi,276,150,126
31,Navarra,29,"Arcos, Los",1182,588,594
31,Navarra,30,Arellano,205,117,88
31,Navarra,31,Areso,271,147,124
31,Navarra,32,Arguedas,2335,1195,1140
31,Navarra,33,Aria,56,32,24
31,Navarra,34,Aribe,47,24,23
31,Navarra,35,Armañanzas,59,31,28
31,Navarra,36,Arróniz,1084,587,497
31,Navarra,37,Arruazu,120,63,57
31,Navarra,38,Artajona,1721,892,829
31,Navarra,39,Artazu,116,57,59
31,Navarra,40,Atez,238,139,99
31,Navarra,58,Auritz/Burguete,260,126,134
31,Navarra,41,Ayegui/Aiegi,2133,1135,998
31,Navarra,42,Azagra,3840,1970,1870
31,Navarra,43,Azuelo,38,15,23
31,Navarra,44,Bakaiku,331,182,149
31,Navarra,901,Barañain,21120,10253,10867
31,Navarra,45,Barásoain,681,356,325
31,Navarra,46,Barbarin,62,29,33
31,Navarra,47,Bargota,305,150,155
31,Navarra,48,Barillas,202,109,93
31,Navarra,49,Basaburua,874,495,379
31,Navarra,50,Baztan,7974,4019,3955
31,Navarra,137,Beintza-Labaien,240,138,102
31,Navarra,51,Beire,312,164,148
31,Navarra,52,Belascoáin,126,66,60
31,Navarra,250,Bera,3829,1921,1908
31,Navarra,53,Berbinzana,707,356,351
31,Navarra,905,Beriáin,3864,1898,1966
31,Navarra,902,Berrioplano/Berriobeiti,6325,3197,3128
31,Navarra,903,Berriozar,9605,4890,4715
31,Navarra,54,Bertizarana,614,307,307
31,Navarra,55,Betelu,339,185,154
31,Navarra,253,Bidaurreta,166,92,74
31,Navarra,56,Biurrun-Olcoz,229,132,97
31,Navarra,57,Buñuel,2330,1153,1177
31,Navarra,59,Burgui/Burgi,231,133,98
31,Navarra,60,Burlada/Burlata,18248,8888,9360
31,Navarra,61,"Busto, El",72,39,33
31,Navarra,62,Cabanillas,1483,768,715
31,Navarra,63,Cabredo,100,53,47
31,Navarra,64,Cadreita,2075,1087,988
31,Navarra,65,Caparroso,2834,1462,1372
31,Navarra,66,Cárcar,1097,554,543
31,Navarra,67,Carcastillo,2541,1309,1232
31,Navarra,68,Cascante,3970,1972,1998
31,Navarra,69,Cáseda,1013,493,520
31,Navarra,70,Castejón,4183,2083,2100
31,Navarra,71,Castillonuevo,16,12,4
31,Navarra,193,Cendea de Olza/Oltza Zendea,1802,910,892
31,Navarra,72,Cintruénigo,7776,3964,3812
31,Navarra,74,Cirauqui/Zirauki,503,278,225
31,Navarra,75,Ciriza/Ziritza,124,55,69
31,Navarra,76,Cizur,3782,1919,1863
31,Navarra,77,Corella,7878,4088,3790
31,Navarra,78,Cortes,3240,1648,1592
31,Navarra,79,Desojo,87,46,41
31,Navarra,80,Dicastillo,659,348,311
31,Navarra,81,Donamaria,437,218,219
31,Navarra,221,Doneztebe/Santesteban,1681,862,819
31,Navarra,83,Echarri,74,39,35
31,Navarra,86,Egüés,18414,9308,9106
31,Navarra,87,Elgorriaga,225,106,119
31,Navarra,89,Enériz/Eneritz,365,189,176
31,Navarra,90,Eratsun,159,101,58
31,Navarra,91,Ergoiena,406,222,184
31,Navarra,92,Erro,814,464,350
31,Navarra,94,Eslava,128,67,61
31,Navarra,95,Esparza de Salazar/Espartza Zaraitzu,88,46,42
31,Navarra,96,Espronceda,123,69,54
31,Navarra,97,Estella-Lizarra,13947,6763,7184
31,Navarra,98,Esteribar,2428,1269,1159
31,Navarra,99,Etayo,76,38,38
31,Navarra,82,Etxalar,829,444,385
31,Navarra,84,Etxarri-Aranatz,2496,1289,1207
31,Navarra,85,Etxauri,582,306,276
31,Navarra,100,Eulate,319,172,147
31,Navarra,101,Ezcabarte,1781,948,833
31,Navarra,93,Ezcároz/Ezkaroze,338,177,161
31,Navarra,102,Ezkurra,151,101,50
31,Navarra,103,Ezprogui,44,23,21
31,Navarra,104,Falces,2501,1265,1236
31,Navarra,105,Fitero,2123,1079,1044
31,Navarra,106,Fontellas,983,505,478
31,Navarra,107,Funes,2494,1341,1153
31,Navarra,108,Fustiñana,2574,1302,1272
31,Navarra,109,Galar,1978,1044,934
31,Navarra,110,Gallipienzo/Galipentzu,116,64,52
31,Navarra,111,Gallués/Galoze,104,68,36
31,Navarra,112,Garaioa,99,54,45
31,Navarra,113,Garde,166,100,66
31,Navarra,114,Garínoain,514,285,229
31,Navarra,115,Garralda,187,96,91
31,Navarra,116,Genevilla,76,48,28
31,Navarra,117,Goizueta,763,418,345
31,Navarra,118,Goñi,181,116,65
31,Navarra,119,Güesa/Gorza,50,30,20
31,Navarra,120,Guesálaz/Gesalatz,461,271,190
31,Navarra,121,Guirguillano,93,50,43
31,Navarra,256,Hiriberri/Villanueva de Aezkoa,119,67,52
31,Navarra,122,Huarte/Uharte,6781,3403,3378
31,Navarra,124,Ibargoiti,243,145,98
31,Navarra,259,Igantzi,627,329,298
31,Navarra,125,Igúzquiza,329,170,159
31,Navarra,126,Imotz,434,231,203
31,Navarra,127,Irañeta,172,95,77
31,Navarra,904,Irurtzun,2300,1197,1103
31,Navarra,128,Isaba/Izaba,488,236,252
31,Navarra,129,Ituren,513,265,248
31,Navarra,130,Iturmendi,390,198,192
31,Navarra,131,Iza/Itza,1131,602,529
31,Navarra,132,Izagaondoa,183,118,65
31,Navarra,133,Izalzu/Itzaltzu,52,30,22
31,Navarra,134,Jaurrieta,214,119,95
31,Navarra,135,Javier,115,41,74
31,Navarra,136,Juslapeña,559,306,253
31,Navarra,138,Lakuntza,1277,655,622
31,Navarra,139,Lana,187,107,80
31,Navarra,140,Lantz,139,84,55
31,Navarra,141,Lapoblación,147,81,66
31,Navarra,142,Larraga,2129,1156,973
31,Navarra,143,Larraona,111,53,58
31,Navarra,144,Larraun,997,547,450
31,Navarra,145,Lazagurría,202,103,99
31,Navarra,146,Leache,53,32,21
31,Navarra,147,Legarda,118,68,50
31,Navarra,148,Legaria,111,52,59
31,Navarra,149,Leitza,2889,1542,1347
31,Navarra,908,Lekunberri,1486,737,749
31,Navarra,150,Leoz/Leotz,258,168,90
31,Navarra,151,Lerga,72,44,28
31,Navarra,152,Lerín,1756,896,860
31,Navarra,153,Lesaka,2784,1442,1342
31,Navarra,154,Lezáun,261,154,107
31,Navarra,155,Liédena,328,168,160
31,Navarra,156,Lizoáin-Arriasgoiti,323,200,123
31,Navarra,157,Lodosa,4836,2431,2405
31,Navarra,158,Lónguida/Longida,321,169,152
31,Navarra,159,Lumbier,1379,746,633
31,Navarra,160,Luquin,137,73,64
31,Navarra,248,Luzaide/Valcarlos,379,210,169
31,Navarra,161,Mañeru,431,239,192
31,Navarra,162,Marañón,53,25,28
31,Navarra,163,Marcilla,2813,1405,1408
31,Navarra,164,Mélida,723,368,355
31,Navarra,165,Mendavia,3655,1864,1791
31,Navarra,166,Mendaza,320,163,157
31,Navarra,167,Mendigorría,1095,570,525
31,Navarra,168,Metauten,290,164,126
31,Navarra,169,Milagro,3393,1763,1630
31,Navarra,170,Mirafuentes,53,24,29
31,Navarra,171,Miranda de Arga,909,457,452
31,Navarra,172,Monreal/Elo,483,255,228
31,Navarra,173,Monteagudo,1142,596,546
31,Navarra,174,Morentin,132,70,62
31,Navarra,175,Mues,90,46,44
31,Navarra,176,Murchante,3745,1872,1873
31,Navarra,177,Murieta,354,192,162
31,Navarra,178,Murillo el Cuende,680,356,324
31,Navarra,179,Murillo el Fruto,670,348,322
31,Navarra,180,Muruzábal,277,125,152
31,Navarra,181,Navascués/Nabaskoze,170,106,64
31,Navarra,182,Nazar,45,25,20
31,Navarra,88,Noáin (Valle de Elorz)/Noain (Elortzibar),7808,3950,3858
31,Navarra,183,Obanos,924,458,466
31,Navarra,185,Ochagavía/Otsagabia,604,314,290
31,Navarra,184,Oco,66,34,32
31,Navarra,186,Odieta,366,205,161
31,Navarra,187,Oitz,144,86,58
31,Navarra,188,Olaibar,280,146,134
31,Navarra,189,Olazti/Olazagutía,1627,839,788
31,Navarra,190,Olejua,56,30,26
31,Navarra,191,Olite/Erriberri,3875,1962,1913
31,Navarra,194,Ollo,404,215,189
31,Navarra,192,Olóriz/Oloritz,187,113,74
31,Navarra,195,Orbaizeta,214,108,106
31,Navarra,196,Orbara,41,20,21
31,Navarra,197,Orísoain,95,51,44
31,Navarra,906,Orkoien,3716,1879,1837
31,Navarra,198,Oronz/Orontze,49,26,23
31,Navarra,199,Oroz-Betelu/Orotz-Betelu,165,89,76
31,Navarra,211,Orreaga/Roncesvalles,26,13,13
31,Navarra,200,Oteiza,950,495,455
31,Navarra,201,Pamplona/Iruña,196955,93996,102959
31,Navarra,202,Peralta/Azkoien,5975,3012,2963
31,Navarra,203,Petilla de Aragón,32,20,12
31,Navarra,204,Piedramillera,46,30,16
31,Navarra,205,Pitillas,535,258,277
31,Navarra,206,Puente la Reina/Gares,2787,1435,1352
31,Navarra,207,Pueyo,354,192,162
31,Navarra,208,Ribaforada,3721,1897,1824
31,Navarra,209,Romanzado,181,101,80
31,Navarra,210,Roncal/Erronkari,241,129,112
31,Navarra,212,Sada,170,90,80
31,Navarra,213,Saldías,114,68,46
31,Navarra,214,Salinas de Oro/Jaitz,119,66,53
31,Navarra,215,San Adrián,6225,3080,3145
31,Navarra,217,San Martín de Unx,431,223,208
31,Navarra,216,Sangüesa/Zangoza,5080,2593,2487
31,Navarra,219,Sansol,111,58,53
31,Navarra,220,Santacara,911,473,438
31,Navarra,222,Sarriés/Sartze,66,42,24
31,Navarra,223,Sartaguda,1345,704,641
31,Navarra,224,Sesma,1211,614,597
31,Navarra,225,Sorlada,67,39,28
31,Navarra,226,Sunbilla,627,331,296
31,Navarra,227,Tafalla,11201,5555,5646
31,Navarra,228,Tiebas-Muruarte de Reta,647,339,308
31,Navarra,229,Tirapu,58,33,25
31,Navarra,230,Torralba del Río,125,67,58
31,Navarra,231,Torres del Río,147,72,75
31,Navarra,232,Tudela,35369,17511,17858
31,Navarra,233,Tulebras,128,53,75
31,Navarra,234,Ucar,185,106,79
31,Navarra,123,Uharte-Arakil,851,454,397
31,Navarra,235,Ujué,200,112,88
31,Navarra,236,Ultzama,1692,871,821
31,Navarra,237,Unciti,221,137,84
31,Navarra,238,Unzué/Untzue,142,81,61
31,Navarra,239,Urdazubi/Urdax,380,186,194
31,Navarra,240,Urdiain,698,368,330
31,Navarra,241,Urraul Alto,159,93,66
31,Navarra,242,Urraul Bajo,292,127,165
31,Navarra,244,Urrotz,181,102,79
31,Navarra,243,Urroz-Villa,393,203,190
31,Navarra,245,Urzainqui/Urzainki,101,57,44
31,Navarra,246,Uterga,174,97,77
31,Navarra,247,Uztárroz/Uztarroze,160,80,80
31,Navarra,260,Valle de Yerri/Deierri,1529,787,742
31,Navarra,249,Valtierra,2530,1242,1288
31,Navarra,251,Viana,4062,2086,1976
31,Navarra,252,Vidángoz/Bidankoze,94,50,44
31,Navarra,254,Villafranca,2910,1459,1451
31,Navarra,255,Villamayor de Monjardín,135,70,65
31,Navarra,257,Villatuerta,1145,571,574
31,Navarra,258,Villava/Atarrabia,10308,5100,5208
31,Navarra,261,Yesa,239,123,116
31,Navarra,262,Zabalza/Zabaltza,284,146,138
31,Navarra,73,Ziordia,372,178,194
31,Navarra,907,Zizur Mayor/Zizur Nagusia,14120,6970,7150
31,Navarra,263,Zubieta,316,170,146
31,Navarra,264,Zugarramurdi,220,111,109
31,Navarra,265,Zúñiga,132,84,48
32,Ourense,1,Allariz,6056,3030,3026
32,Ourense,2,Amoeiro,2257,1114,1143
32,Ourense,3,"Arnoia, A",1048,513,535
32,Ourense,4,Avión,2323,1092,1231
32,Ourense,5,Baltar,1028,533,495
32,Ourense,6,Bande,1890,899,991
32,Ourense,7,Baños de Molgas,1727,857,870
32,Ourense,8,Barbadás,10228,4963,5265
32,Ourense,9,"Barco de Valdeorras, O",14010,6840,7170
32,Ourense,10,Beade,465,240,225
32,Ourense,11,Beariz,1136,519,617
32,Ourense,12,"Blancos, Os",908,483,425
32,Ourense,13,Boborás,2737,1292,1445
32,Ourense,14,"Bola, A",1361,650,711
32,Ourense,15,"Bolo, O",1060,535,525
32,Ourense,16,Calvos de Randín,1028,514,514
32,Ourense,18,Carballeda de Avia,1438,698,740
32,Ourense,17,Carballeda de Valdeorras,1727,871,856
32,Ourense,19,"Carballiño, O",14355,6788,7567
32,Ourense,20,Cartelle,3037,1491,1546
32,Ourense,22,Castrelo de Miño,1675,826,849
32,Ourense,21,Castrelo do Val,1138,586,552
32,Ourense,23,Castro Caldelas,1412,702,710
32,Ourense,24,Celanova,5638,2670,2968
32,Ourense,25,Cenlle,1278,603,675
32,Ourense,29,Chandrexa de Queixa,560,316,244
32,Ourense,26,Coles,3171,1592,1579
32,Ourense,27,Cortegada,1231,612,619
32,Ourense,28,Cualedro,1876,948,928
32,Ourense,30,Entrimo,1311,612,699
32,Ourense,31,Esgos,1208,625,583
32,Ourense,33,Gomesende,895,427,468
32,Ourense,34,"Gudiña, A",1508,802,706
32,Ourense,35,"Irixo, O",1685,797,888
32,Ourense,38,Larouco,557,263,294
32,Ourense,39,Laza,1487,765,722
32,Ourense,40,Leiro,1724,865,859
32,Ourense,41,Lobeira,855,415,440
32,Ourense,42,Lobios,2130,1092,1038
32,Ourense,43,Maceda,3025,1468,1557
32,Ourense,44,Manzaneda,971,476,495
32,Ourense,45,Maside,2920,1408,1512
32,Ourense,46,Melón,1396,663,733
32,Ourense,47,"Merca, A",2119,1039,1080
32,Ourense,48,"Mezquita, A",1169,607,562
32,Ourense,49,Montederramo,854,433,421
32,Ourense,50,Monterrei,2875,1451,1424
32,Ourense,51,Muíños,1744,878,866
32,Ourense,52,Nogueira de Ramuín,2271,1126,1145
32,Ourense,53,Oímbra,2019,1092,927
32,Ourense,54,Ourense,107542,49364,58178
32,Ourense,55,Paderne de Allariz,1545,755,790
32,Ourense,56,Padrenda,2135,1037,1098
32,Ourense,57,Parada de Sil,642,338,304
32,Ourense,58,"Pereiro de Aguiar, O",6326,3237,3089
32,Ourense,59,"Peroxa, A",2030,997,1033
32,Ourense,60,Petín,986,475,511
32,Ourense,61,Piñor,1280,643,637
32,Ourense,63,"Pobra de Trives, A",2319,1168,1151
32,Ourense,64,Pontedeva,644,309,335
32,Ourense,62,Porqueira,961,461,500
32,Ourense,65,Punxín,776,366,410
32,Ourense,66,Quintela de Leirado,671,290,381
32,Ourense,67,Rairiz de Veiga,1527,778,749
32,Ourense,68,Ramirás,1712,790,922
32,Ourense,69,Ribadavia,5230,2524,2706
32,Ourense,71,Riós,1751,889,862
32,Ourense,72,"Rúa, A",4685,2340,2345
32,Ourense,73,Rubiá,1518,758,760
32,Ourense,74,San Amaro,1202,586,616
32,Ourense,75,San Cibrao das Viñas,4906,2500,2406
32,Ourense,76,San Cristovo de Cea,2497,1246,1251
32,Ourense,70,San Xoán de Río,657,322,335
32,Ourense,77,Sandiás,1316,599,717
32,Ourense,78,Sarreaus,1365,693,672
32,Ourense,79,Taboadela,1603,815,788
32,Ourense,80,"Teixeira, A",406,205,201
32,Ourense,81,Toén,2527,1312,1215
32,Ourense,82,Trasmiras,1500,741,759
32,Ourense,83,"Veiga, A",1000,512,488
32,Ourense,84,Verea,1112,524,588
32,Ourense,85,Verín,14760,7249,7511
32,Ourense,86,Viana do Bolo,3163,1580,1583
32,Ourense,87,Vilamarín,2121,1061,1060
32,Ourense,88,Vilamartín de Valdeorras,1826,924,902
32,Ourense,89,Vilar de Barrio,1528,766,762
32,Ourense,90,Vilar de Santos,923,453,470
32,Ourense,91,Vilardevós,2062,1046,1016
32,Ourense,92,Vilariño de Conso,660,374,286
32,Ourense,32,Xinzo de Limia,10307,5083,5224
32,Ourense,36,Xunqueira de Ambía,1620,810,810
32,Ourense,37,Xunqueira de Espadanedo,862,424,438
34,Palencia,1,Abarca de Campos,38,22,16
34,Palencia,3,Abia de las Torres,177,100,77
34,Palencia,4,Aguilar de Campoo,7160,3489,3671
34,Palencia,5,Alar del Rey,1005,493,512
34,Palencia,6,Alba de Cerrato,87,48,39
34,Palencia,9,Amayuelas de Arriba,39,23,16
34,Palencia,10,Ampudia,622,334,288
34,Palencia,11,Amusco,448,247,201
34,Palencia,12,Antigüedad,396,212,184
34,Palencia,15,Arconada,46,27,19
34,Palencia,17,Astudillo,1045,528,517
34,Palencia,18,Autilla del Pino,251,138,113
34,Palencia,19,Autillo de Campos,152,75,77
34,Palencia,20,Ayuela,58,33,25
34,Palencia,22,Baltanás,1309,688,621
34,Palencia,24,Baquerín de Campos,37,24,13
34,Palencia,25,Bárcena de Campos,56,27,29
34,Palencia,27,Barruelo de Santullán,1373,666,707
34,Palencia,28,Báscones de Ojeda,158,90,68
34,Palencia,29,Becerril de Campos,902,448,454
34,Palencia,31,Belmonte de Campos,29,15,14
34,Palencia,32,Berzosilla,46,23,23
34,Palencia,33,Boada de Campos,21,13,8
34,Palencia,35,Boadilla de Rioseco,127,75,52
34,Palencia,34,Boadilla del Camino,101,56,45
34,Palencia,36,Brañosera,230,133,97
34,Palencia,37,Buenavista de Valdavia,354,188,166
34,Palencia,38,Bustillo de la Vega,319,171,148
34,Palencia,39,Bustillo del Páramo de Carrión,63,38,25
34,Palencia,41,Calahorra de Boedo,98,53,45
34,Palencia,42,Calzada de los Molinos,331,179,152
34,Palencia,45,Capillas,86,42,44
34,Palencia,46,Cardeñosa de Volpejera,49,27,22
34,Palencia,47,Carrión de los Condes,2204,1066,1138
34,Palencia,48,Castil de Vela,62,31,31
34,Palencia,49,Castrejón de la Peña,428,235,193
34,Palencia,50,Castrillo de Don Juan,231,121,110
34,Palencia,51,Castrillo de Onielo,120,59,61
34,Palencia,52,Castrillo de Villavega,202,107,95
34,Palencia,53,Castromocho,243,126,117
34,Palencia,55,Cervatos de la Cueza,306,174,132
34,Palencia,56,Cervera de Pisuerga,2521,1260,1261
34,Palencia,57,Cevico de la Torre,519,259,260
34,Palencia,58,Cevico Navero,205,112,93
34,Palencia,59,Cisneros,491,240,251
34,Palencia,60,Cobos de Cerrato,157,85,72
34,Palencia,61,Collazos de Boedo,129,71,58
34,Palencia,62,Congosto de Valdavia,191,113,78
34,Palencia,63,Cordovilla la Real,111,61,50
34,Palencia,66,Cubillas de Cerrato,72,38,34
34,Palencia,67,Dehesa de Montejo,135,76,59
34,Palencia,68,Dehesa de Romanos,35,22,13
34,Palencia,69,Dueñas,2769,1427,1342
34,Palencia,70,Espinosa de Cerrato,187,94,93
34,Palencia,71,Espinosa de Villagonzalo,224,119,105
34,Palencia,72,Frechilla,190,96,94
34,Palencia,73,Fresno del Río,195,99,96
34,Palencia,74,Frómista,832,425,407
34,Palencia,76,Fuentes de Nava,711,363,348
34,Palencia,77,Fuentes de Valdepero,347,177,170
34,Palencia,79,Grijota,1998,1043,955
34,Palencia,80,Guardo,6915,3459,3456
34,Palencia,81,Guaza de Campos,65,36,29
34,Palencia,82,Hérmedes de Cerrato,88,46,42
34,Palencia,83,Herrera de Pisuerga,2258,1106,1152
34,Palencia,84,Herrera de Valdecañas,145,80,65
34,Palencia,86,Hontoria de Cerrato,105,56,49
34,Palencia,87,Hornillos de Cerrato,117,58,59
34,Palencia,88,Husillos,278,153,125
34,Palencia,89,Itero de la Vega,189,100,89
34,Palencia,91,Lagartos,140,75,65
34,Palencia,92,Lantadilla,355,183,172
34,Palencia,94,Ledigos,68,37,31
34,Palencia,903,Loma de Ucieza,241,143,98
34,Palencia,96,Lomas,53,33,20
34,Palencia,98,Magaz de Pisuerga,1070,586,484
34,Palencia,99,Manquillos,63,32,31
34,Palencia,100,Mantinos,158,89,69
34,Palencia,101,Marcilla de Campos,40,18,22
34,Palencia,102,Mazariegos,241,142,99
34,Palencia,103,Mazuecos de Valdeginate,104,56,48
34,Palencia,104,Melgar de Yuso,273,157,116
34,Palencia,106,Meneses de Campos,125,63,62
34,Palencia,107,Micieces de Ojeda,89,49,40
34,Palencia,108,Monzón de Campos,659,338,321
34,Palencia,109,Moratinos,65,37,28
34,Palencia,110,Mudá,99,50,49
34,Palencia,112,Nogal de las Huertas,15,7,8
34,Palencia,113,Olea de Boedo,36,14,22
34,Palencia,114,Olmos de Ojeda,224,136,88
34,Palencia,116,Osornillo,65,33,32
34,Palencia,901,Osorno la Mayor,1391,735,656
34,Palencia,120,Palencia,80649,38085,42564
34,Palencia,121,Palenzuela,215,114,101
34,Palencia,122,Páramo de Boedo,78,42,36
34,Palencia,123,Paredes de Nava,2007,1016,991
34,Palencia,124,Payo de Ojeda,64,38,26
34,Palencia,125,Pedraza de Campos,98,52,46
34,Palencia,126,Pedrosa de la Vega,349,196,153
34,Palencia,127,Perales,133,69,64
34,Palencia,904,"Pernía, La",360,209,151
34,Palencia,129,Pino del Río,204,123,81
34,Palencia,130,Piña de Campos,249,131,118
34,Palencia,131,Población de Arroyo,67,35,32
34,Palencia,132,Población de Campos,138,75,63
34,Palencia,133,Población de Cerrato,113,63,50
34,Palencia,134,Polentinos,60,33,27
34,Palencia,135,Pomar de Valdivia,479,263,216
34,Palencia,136,Poza de la Vega,237,134,103
34,Palencia,137,Pozo de Urama,30,19,11
34,Palencia,139,Prádanos de Ojeda,205,113,92
34,Palencia,140,"Puebla de Valdavia, La",103,54,49
34,Palencia,141,Quintana del Puente,270,156,114
34,Palencia,143,Quintanilla de Onsoña,201,113,88
34,Palencia,146,Reinoso de Cerrato,57,35,22
34,Palencia,147,Renedo de la Vega,210,116,94
34,Palencia,149,Requena de Campos,19,9,10
34,Palencia,151,Respenda de la Peña,195,110,85
34,Palencia,152,Revenga de Campos,166,82,84
34,Palencia,154,Revilla de Collazos,83,45,38
34,Palencia,155,Ribas de Campos,165,82,83
34,Palencia,156,Riberos de la Cueza,59,39,20
34,Palencia,157,Saldaña,3132,1562,1570
34,Palencia,158,Salinas de Pisuerga,363,183,180
34,Palencia,159,San Cebrián de Campos,461,253,208
34,Palencia,160,San Cebrián de Mudá,163,87,76
34,Palencia,161,San Cristóbal de Boedo,21,12,9
34,Palencia,163,San Mamés de Campos,60,29,31
34,Palencia,165,San Román de la Cuba,79,42,37
34,Palencia,167,Santa Cecilia del Alcor,127,78,49
34,Palencia,168,Santa Cruz de Boedo,54,30,24
34,Palencia,169,Santervás de la Vega,489,270,219
34,Palencia,170,Santibáñez de Ecla,71,33,38
34,Palencia,171,Santibáñez de la Peña,1170,579,591
34,Palencia,174,Santoyo,235,126,109
34,Palencia,175,"Serna, La",101,63,38
34,Palencia,177,Soto de Cerrato,187,107,80
34,Palencia,176,Sotobañado y Priorato,161,92,69
34,Palencia,178,Tabanera de Cerrato,121,70,51
34,Palencia,179,Tabanera de Valdavia,34,16,18
34,Palencia,180,Támara de Campos,79,42,37
34,Palencia,181,Tariego de Cerrato,522,279,243
34,Palencia,182,Torquemada,1055,574,481
34,Palencia,184,Torremormojón,55,32,23
34,Palencia,185,Triollo,66,40,26
34,Palencia,186,Valbuena de Pisuerga,56,32,24
34,Palencia,189,Valdeolmillos,62,33,29
34,Palencia,190,Valderrábano,53,28,25
34,Palencia,192,Valde-Ucieza,108,64,44
34,Palencia,196,Valle de Cerrato,90,52,38
34,Palencia,902,Valle del Retortillo,180,104,76
34,Palencia,199,Velilla del Río Carrión,1462,754,708
34,Palencia,23,Venta de Baños,6493,3246,3247
34,Palencia,201,Vertavillo,205,110,95
34,Palencia,93,"Vid de Ojeda, La",112,66,46
34,Palencia,202,Villabasta de Valdavia,31,16,15
34,Palencia,204,Villacidaler,49,29,20
34,Palencia,205,Villaconancio,67,41,26
34,Palencia,206,Villada,1048,531,517
34,Palencia,208,Villaeles de Valdavia,65,35,30
34,Palencia,210,Villahán,105,55,50
34,Palencia,211,Villaherreros,213,104,109
34,Palencia,213,Villalaco,67,33,34
34,Palencia,214,Villalba de Guardo,193,103,90
34,Palencia,215,Villalcázar de Sirga,155,76,79
34,Palencia,216,Villalcón,71,38,33
34,Palencia,217,Villalobón,1501,761,740
34,Palencia,218,Villaluenga de la Vega,591,337,254
34,Palencia,220,Villamartín de Campos,185,103,82
34,Palencia,221,Villamediana,186,103,83
34,Palencia,222,Villameriel,125,72,53
34,Palencia,223,Villamoronta,270,153,117
34,Palencia,224,Villamuera de la Cueza,48,29,19
34,Palencia,225,Villamuriel de Cerrato,6411,3302,3109
34,Palencia,227,Villanueva del Rebollar,82,41,41
34,Palencia,228,Villanuño de Valdavia,97,51,46
34,Palencia,229,Villaprovedo,65,41,24
34,Palencia,230,Villarmentero de Campos,14,9,5
34,Palencia,231,Villarrabé,237,123,114
34,Palencia,232,Villarramiel,898,483,415
34,Palencia,233,Villasarracino,144,81,63
34,Palencia,234,Villasila de Valdavia,72,51,21
34,Palencia,236,Villaturde,183,94,89
34,Palencia,237,Villaumbrales,722,375,347
34,Palencia,238,Villaviudas,379,179,200
34,Palencia,240,Villerías de Campos,101,57,44
34,Palencia,241,Villodre,19,11,8
34,Palencia,242,Villodrigo,122,67,55
34,Palencia,243,Villoldo,369,203,166
34,Palencia,245,Villota del Páramo,345,198,147
34,Palencia,246,Villovieco,73,41,32
35,"Palmas, Las",1,Agaete,5796,2908,2888
35,"Palmas, Las",2,Agüimes,30214,15278,14936
35,"Palmas, Las",20,"Aldea de San Nicolás, La",8228,4159,4069
35,"Palmas, Las",3,Antigua,11629,6250,5379
35,"Palmas, Las",4,Arrecife,55673,28078,27595
35,"Palmas, Las",5,Artenara,1198,649,549
35,"Palmas, Las",6,Arucas,36852,18382,18470
35,"Palmas, Las",7,Betancuria,811,419,392
35,"Palmas, Las",8,Firgas,7628,3877,3751
35,"Palmas, Las",9,Gáldar,24227,12149,12078
35,"Palmas, Las",10,Haría,4782,2459,2323
35,"Palmas, Las",11,Ingenio,29978,15187,14791
35,"Palmas, Las",12,Mogán,21782,11354,10428
35,"Palmas, Las",13,Moya,7977,4077,3900
35,"Palmas, Las",14,"Oliva, La",25083,13328,11755
35,"Palmas, Las",15,Pájara,20931,11049,9882
35,"Palmas, Las",16,"Palmas de Gran Canaria, Las",383050,186335,196715
35,"Palmas, Las",17,Puerto del Rosario,36774,18856,17918
35,"Palmas, Las",18,San Bartolomé,18541,9389,9152
35,"Palmas, Las",19,San Bartolomé de Tirajana,56698,29639,27059
35,"Palmas, Las",21,Santa Brígida,18971,9422,9549
35,"Palmas, Las",22,Santa Lucía de Tirajana,68506,34433,34073
35,"Palmas, Las",23,Santa María de Guía de Gran Canaria,13811,6884,6927
35,"Palmas, Las",24,Teguise,21152,10698,10454
35,"Palmas, Las",25,Tejeda,2028,1072,956
35,"Palmas, Las",26,Telde,102170,50686,51484
35,"Palmas, Las",27,Teror,12761,6543,6218
35,"Palmas, Las",28,Tías,20451,10441,10010
35,"Palmas, Las",29,Tinajo,5783,3003,2780
35,"Palmas, Las",30,Tuineje,13946,7198,6748
35,"Palmas, Las",32,Valleseco,3904,2051,1853
35,"Palmas, Las",31,Valsequillo de Gran Canaria,9170,4616,4554
35,"Palmas, Las",33,Vega de San Mateo,7774,3963,3811
35,"Palmas, Las",34,Yaiza,15571,8178,7393
36,Pontevedra,20,Agolada,2745,1355,1390
36,Pontevedra,1,Arbo,2967,1488,1479
36,Pontevedra,3,Baiona,12035,5964,6071
36,Pontevedra,2,Barro,3712,1836,1876
36,Pontevedra,4,Bueu,12375,6094,6281
36,Pontevedra,5,Caldas de Reis,10019,4846,5173
36,Pontevedra,6,Cambados,13544,6556,6988
36,Pontevedra,7,Campo Lameiro,1982,955,1027
36,Pontevedra,8,Cangas,26173,12935,13238
36,Pontevedra,9,"Cañiza, A",5416,2647,2769
36,Pontevedra,10,Catoira,3421,1683,1738
36,Pontevedra,11,Cerdedo,1865,870,995
36,Pontevedra,12,Cotobade,4359,2093,2266
36,Pontevedra,13,Covelo,2800,1381,1419
36,Pontevedra,14,Crecente,2314,1113,1201
36,Pontevedra,15,Cuntis,4913,2311,2602
36,Pontevedra,16,Dozón,1241,633,608
36,Pontevedra,17,"Estrada, A",21464,10283,11181
36,Pontevedra,18,Forcarei,3820,1807,2013
36,Pontevedra,19,Fornelos de Montes,1864,883,981
36,Pontevedra,21,Gondomar,14005,6906,7099
36,Pontevedra,22,"Grove, O",11096,5463,5633
36,Pontevedra,23,"Guarda, A",10438,5101,5337
36,Pontevedra,901,"Illa de Arousa, A",5028,2490,2538
36,Pontevedra,24,Lalín,20048,9721,10327
36,Pontevedra,25,"Lama, A",2862,1382,1480
36,Pontevedra,26,Marín,25483,12807,12676
36,Pontevedra,27,Meaño,5421,2641,2780
36,Pontevedra,28,Meis,5007,2375,2632
36,Pontevedra,29,Moaña,19309,9475,9834
36,Pontevedra,30,Mondariz,4800,2304,2496
36,Pontevedra,31,Mondariz-Balneario,656,331,325
36,Pontevedra,32,Moraña,4400,2122,2278
36,Pontevedra,33,Mos,15367,7560,7807
36,Pontevedra,34,"Neves, As",4192,2038,2154
36,Pontevedra,35,Nigrán,17738,8706,9032
36,Pontevedra,36,Oia,3094,1547,1547
36,Pontevedra,37,Pazos de Borbén,3113,1495,1618
36,Pontevedra,41,Poio,16767,8302,8465
36,Pontevedra,43,Ponte Caldelas,5668,2755,2913
36,Pontevedra,42,Ponteareas,23326,11403,11923
36,Pontevedra,44,Pontecesures,3113,1577,1536
36,Pontevedra,38,Pontevedra,82934,39345,43589
36,Pontevedra,39,"Porriño, O",18908,9339,9569
36,Pontevedra,40,Portas,3033,1451,1582
36,Pontevedra,45,Redondela,29918,14645,15273
36,Pontevedra,46,Ribadumia,5168,2492,2676
36,Pontevedra,47,Rodeiro,2844,1438,1406
36,Pontevedra,48,"Rosal, O",6531,3220,3311
36,Pontevedra,49,Salceda de Caselas,8887,4470,4417
36,Pontevedra,50,Salvaterra de Miño,9816,4930,4886
36,Pontevedra,51,Sanxenxo,17582,8699,8883
36,Pontevedra,52,Silleda,9037,4422,4615
36,Pontevedra,53,Soutomaior,7302,3640,3662
36,Pontevedra,54,Tomiño,13740,6904,6836
36,Pontevedra,55,Tui,16827,8036,8791
36,Pontevedra,56,Valga,6059,2950,3109
36,Pontevedra,57,Vigo,296479,141359,155120
36,Pontevedra,59,Vila de Cruces,5934,2918,3016
36,Pontevedra,58,Vilaboa,5848,2813,3035
36,Pontevedra,60,Vilagarcía de Arousa,37741,18151,19590
36,Pontevedra,61,Vilanova de Arousa,10502,5149,5353
26,"Rioja, La",1,Ábalos,348,227,121
26,"Rioja, La",2,Agoncillo,1161,657,504
26,"Rioja, La",3,Aguilar del Río Alhama,533,259,274
26,"Rioja, La",4,Ajamil de Cameros,76,50,26
26,"Rioja, La",5,Albelda de Iregua,3336,1725,1611
26,"Rioja, La",6,Alberite,2598,1310,1288
26,"Rioja, La",7,Alcanadre,727,385,342
26,"Rioja, La",8,Aldeanueva de Ebro,2817,1470,1347
26,"Rioja, La",9,Alesanco,537,286,251
26,"Rioja, La",10,Alesón,115,66,49
26,"Rioja, La",11,Alfaro,9811,4951,4860
26,"Rioja, La",12,Almarza de Cameros,18,12,6
26,"Rioja, La",13,Anguciana,453,247,206
26,"Rioja, La",14,Anguiano,545,310,235
26,"Rioja, La",15,Arenzana de Abajo,255,135,120
26,"Rioja, La",16,Arenzana de Arriba,32,21,11
26,"Rioja, La",17,Arnedillo,483,235,248
26,"Rioja, La",18,Arnedo,14559,7218,7341
26,"Rioja, La",19,Arrúbal,498,261,237
26,"Rioja, La",20,Ausejo,1104,655,449
26,"Rioja, La",21,Autol,4450,2262,2188
26,"Rioja, La",22,Azofra,225,124,101
26,"Rioja, La",23,Badarán,572,294,278
26,"Rioja, La",24,Bañares,293,149,144
26,"Rioja, La",26,Baños de Río Tobía,1655,821,834
26,"Rioja, La",25,Baños de Rioja,95,51,44
26,"Rioja, La",27,Berceo,171,108,63
26,"Rioja, La",28,Bergasa,152,83,69
26,"Rioja, La",29,Bergasillas Bajera,37,20,17
26,"Rioja, La",30,Bezares,19,10,9
26,"Rioja, La",31,Bobadilla,130,71,59
26,"Rioja, La",32,Brieva de Cameros,56,37,19
26,"Rioja, La",33,Briñas,225,106,119
26,"Rioja, La",34,Briones,853,459,394
26,"Rioja, La",35,Cabezón de Cameros,18,14,4
26,"Rioja, La",36,Calahorra,24509,12117,12392
26,"Rioja, La",37,Camprovín,170,95,75
26,"Rioja, La",38,Canales de la Sierra,82,51,31
26,"Rioja, La",39,Canillas de Río Tuerto,41,20,21
26,"Rioja, La",40,Cañas,98,45,53
26,"Rioja, La",41,Cárdenas,174,87,87
26,"Rioja, La",42,Casalarreina,1208,631,577
26,"Rioja, La",43,Castañares de Rioja,462,224,238
26,"Rioja, La",44,Castroviejo,58,33,25
26,"Rioja, La",45,Cellorigo,13,6,7
26,"Rioja, La",46,Cenicero,2050,1048,1002
26,"Rioja, La",47,Cervera del Río Alhama,2590,1330,1260
26,"Rioja, La",48,Cidamón,32,18,14
26,"Rioja, La",49,Cihuri,233,119,114
26,"Rioja, La",50,Cirueña,128,80,48
26,"Rioja, La",51,Clavijo,288,163,125
26,"Rioja, La",52,Cordovín,177,88,89
26,"Rioja, La",53,Corera,279,153,126
26,"Rioja, La",54,Cornago,382,217,165
26,"Rioja, La",55,Corporales,43,23,20
26,"Rioja, La",56,Cuzcurrita de Río Tirón,503,271,232
26,"Rioja, La",57,Daroca de Rioja,58,38,20
26,"Rioja, La",58,Enciso,172,103,69
26,"Rioja, La",59,Entrena,1545,796,749
26,"Rioja, La",60,Estollo,96,64,32
26,"Rioja, La",61,Ezcaray,2031,1057,974
26,"Rioja, La",62,Foncea,97,50,47
26,"Rioja, La",63,Fonzaleche,157,106,51
26,"Rioja, La",64,Fuenmayor,3169,1593,1576
26,"Rioja, La",65,Galbárruli,52,33,19
26,"Rioja, La",66,Galilea,381,187,194
26,"Rioja, La",67,Gallinero de Cameros,25,17,8
26,"Rioja, La",68,Gimileo,119,64,55
26,"Rioja, La",69,Grañón,283,158,125
26,"Rioja, La",70,Grávalos,221,113,108
26,"Rioja, La",71,Haro,11713,5868,5845
26,"Rioja, La",72,Herce,359,188,171
26,"Rioja, La",73,Herramélluri,111,58,53
26,"Rioja, La",74,Hervías,127,64,63
26,"Rioja, La",75,Hormilla,447,242,205
26,"Rioja, La",76,Hormilleja,155,80,75
26,"Rioja, La",77,Hornillos de Cameros,15,7,8
26,"Rioja, La",78,Hornos de Moncalvillo,95,52,43
26,"Rioja, La",79,Huércanos,878,468,410
26,"Rioja, La",80,Igea,689,396,293
26,"Rioja, La",81,Jalón de Cameros,21,11,10
26,"Rioja, La",82,Laguna de Cameros,121,73,48
26,"Rioja, La",83,Lagunilla del Jubera,324,181,143
26,"Rioja, La",84,Lardero,9121,4655,4466
26,"Rioja, La",86,Ledesma de la Cogolla,19,14,5
26,"Rioja, La",87,Leiva,282,147,135
26,"Rioja, La",88,Leza de Río Leza,44,26,18
26,"Rioja, La",89,Logroño,153066,73383,79683
26,"Rioja, La",91,Lumbreras,159,104,55
26,"Rioja, La",92,Manjarrés,118,66,52
26,"Rioja, La",93,Mansilla de la Sierra,68,47,21
26,"Rioja, La",94,Manzanares de Rioja,94,56,38
26,"Rioja, La",95,Matute,119,58,61
26,"Rioja, La",96,Medrano,312,163,149
26,"Rioja, La",98,Munilla,118,60,58
26,"Rioja, La",99,Murillo de Río Leza,1752,907,845
26,"Rioja, La",100,Muro de Aguas,61,37,24
26,"Rioja, La",101,Muro en Cameros,46,29,17
26,"Rioja, La",102,Nájera,8377,4163,4214
26,"Rioja, La",103,Nalda,955,521,434
26,"Rioja, La",104,Navajún,18,13,5
26,"Rioja, La",105,Navarrete,2944,1490,1454
26,"Rioja, La",106,Nestares,79,48,31
26,"Rioja, La",107,Nieva de Cameros,97,61,36
26,"Rioja, La",109,Ochánduri,103,61,42
26,"Rioja, La",108,Ocón,293,184,109
26,"Rioja, La",110,Ojacastro,187,108,79
26,"Rioja, La",111,Ollauri,307,167,140
26,"Rioja, La",112,Ortigosa de Cameros,269,156,113
26,"Rioja, La",113,Pazuengos,34,24,10
26,"Rioja, La",114,Pedroso,78,50,28
26,"Rioja, La",115,Pinillos,16,9,7
26,"Rioja, La",117,Pradejón,4204,2193,2011
26,"Rioja, La",118,Pradillo,60,31,29
26,"Rioja, La",119,Préjano,256,145,111
26,"Rioja, La",120,Quel,2045,1059,986
26,"Rioja, La",121,Rabanera,35,28,7
26,"Rioja, La",122,"Rasillo de Cameros, El",143,74,69
26,"Rioja, La",123,"Redal, El",157,87,70
26,"Rioja, La",124,Ribafrecha,1030,544,486
26,"Rioja, La",125,Rincón de Soto,3799,1916,1883
26,"Rioja, La",126,Robres del Castillo,31,20,11
26,"Rioja, La",127,Rodezno,274,153,121
26,"Rioja, La",128,Sajazarra,135,69,66
26,"Rioja, La",129,San Asensio,1222,648,574
26,"Rioja, La",130,San Millán de la Cogolla,255,166,89
26,"Rioja, La",131,San Millán de Yécora,40,25,15
26,"Rioja, La",132,San Román de Cameros,155,84,71
26,"Rioja, La",139,San Torcuato,77,43,34
26,"Rioja, La",142,San Vicente de la Sonsierra,1119,601,518
26,"Rioja, La",134,Santa Coloma,119,70,49
26,"Rioja, La",135,Santa Engracia del Jubera,159,102,57
26,"Rioja, La",136,Santa Eulalia Bajera,117,61,56
26,"Rioja, La",138,Santo Domingo de la Calzada,6614,3364,3250
26,"Rioja, La",140,Santurde de Rioja,300,155,145
26,"Rioja, La",141,Santurdejo,134,82,52
26,"Rioja, La",143,Sojuela,266,160,106
26,"Rioja, La",144,Sorzano,256,141,115
26,"Rioja, La",145,Sotés,300,172,128
26,"Rioja, La",146,Soto en Cameros,126,68,58
26,"Rioja, La",147,Terroba,40,20,20
26,"Rioja, La",148,Tirgo,224,117,107
26,"Rioja, La",149,Tobía,68,39,29
26,"Rioja, La",150,Tormantos,148,88,60
26,"Rioja, La",153,Torre en Cameros,12,10,2
26,"Rioja, La",151,Torrecilla en Cameros,497,268,229
26,"Rioja, La",152,Torrecilla sobre Alesanco,38,20,18
26,"Rioja, La",154,Torremontalbo,15,8,7
26,"Rioja, La",155,Treviana,182,97,85
26,"Rioja, La",157,Tricio,398,193,205
26,"Rioja, La",158,Tudelilla,382,211,171
26,"Rioja, La",160,Uruñuela,977,493,484
26,"Rioja, La",161,Valdemadera,9,6,3
26,"Rioja, La",162,Valgañón,130,81,49
26,"Rioja, La",163,Ventosa,163,96,67
26,"Rioja, La",164,Ventrosa,65,39,26
26,"Rioja, La",165,Viguera,433,241,192
26,"Rioja, La",166,Villalba de Rioja,132,81,51
26,"Rioja, La",167,Villalobar de Rioja,68,49,19
26,"Rioja, La",168,Villamediana de Iregua,7383,3753,3630
26,"Rioja, La",169,Villanueva de Cameros,83,49,34
26,"Rioja, La",170,"Villar de Arnedo, El",643,327,316
26,"Rioja, La",171,Villar de Torre,228,130,98
26,"Rioja, La",172,Villarejo,36,25,11
26,"Rioja, La",173,Villarroya,8,4,4
26,"Rioja, La",174,Villarta-Quintana,163,92,71
26,"Rioja, La",175,Villavelayo,51,32,19
26,"Rioja, La",176,Villaverde de Rioja,67,34,33
26,"Rioja, La",177,Villoslada de Cameros,354,214,140
26,"Rioja, La",178,Viniegra de Abajo,89,53,36
26,"Rioja, La",179,Viniegra de Arriba,51,33,18
26,"Rioja, La",180,Zarratón,277,153,124
26,"Rioja, La",181,Zarzosa,16,12,4
26,"Rioja, La",183,Zorraquín,95,48,47
37,Salamanca,1,Abusejo,225,119,106
37,Salamanca,2,Agallas,151,81,70
37,Salamanca,3,Ahigal de los Aceiteros,132,68,64
37,Salamanca,4,Ahigal de Villarino,35,18,17
37,Salamanca,5,"Alameda de Gardón, La",97,49,48
37,Salamanca,6,"Alamedilla, La",153,78,75
37,Salamanca,7,Alaraz,516,259,257
37,Salamanca,8,Alba de Tormes,5365,2661,2704
37,Salamanca,9,Alba de Yeltes,238,127,111
37,Salamanca,10,"Alberca, La",1150,579,571
37,Salamanca,11,"Alberguería de Argañán, La",139,71,68
37,Salamanca,12,Alconada,165,88,77
37,Salamanca,15,Aldea del Obispo,332,183,149
37,Salamanca,13,Aldeacipreste,133,71,62
37,Salamanca,14,Aldeadávila de la Ribera,1324,677,647
37,Salamanca,16,Aldealengua,668,344,324
37,Salamanca,17,Aldeanueva de Figueroa,286,149,137
37,Salamanca,18,Aldeanueva de la Sierra,121,70,51
37,Salamanca,19,Aldearrodrigo,160,82,78
37,Salamanca,20,Aldearrubia,512,280,232
37,Salamanca,21,Aldeaseca de Alba,88,40,48
37,Salamanca,22,Aldeaseca de la Frontera,294,151,143
37,Salamanca,23,Aldeatejada,1579,807,772
37,Salamanca,24,Aldeavieja de Tormes,104,55,49
37,Salamanca,25,Aldehuela de la Bóveda,308,160,148
37,Salamanca,26,Aldehuela de Yeltes,217,121,96
37,Salamanca,27,Almenara de Tormes,266,148,118
37,Salamanca,28,Almendra,176,97,79
37,Salamanca,29,Anaya de Alba,216,123,93
37,Salamanca,30,Añover de Tormes,96,53,43
37,Salamanca,31,Arabayona de Mógica,415,228,187
37,Salamanca,32,Arapiles,620,324,296
37,Salamanca,33,Arcediano,109,59,50
37,Salamanca,34,"Arco, El",94,49,45
37,Salamanca,35,Armenteros,315,178,137
37,Salamanca,37,"Atalaya, La",125,69,56
37,Salamanca,38,Babilafuente,888,461,427
37,Salamanca,39,Bañobárez,324,166,158
37,Salamanca,40,Barbadillo,414,212,202
37,Salamanca,41,Barbalos,77,43,34
37,Salamanca,42,Barceo,47,27,20
37,Salamanca,44,Barruecopardo,519,283,236
37,Salamanca,45,"Bastida, La",28,16,12
37,Salamanca,46,Béjar,14280,6838,7442
37,Salamanca,47,Beleña,209,99,110
37,Salamanca,49,Bermellar,149,78,71
37,Salamanca,50,Berrocal de Huebra,75,41,34
37,Salamanca,51,Berrocal de Salvatierra,93,48,45
37,Salamanca,52,Boada,300,155,145
37,Salamanca,54,"Bodón, El",301,155,146
37,Salamanca,55,Bogajo,152,83,69
37,Salamanca,56,"Bouza, La",75,36,39
37,Salamanca,57,Bóveda del Río Almar,245,131,114
37,Salamanca,58,Brincones,66,34,32
37,Salamanca,59,Buenamadre,134,73,61
37,Salamanca,60,Buenavista,237,128,109
37,Salamanca,61,"Cabaco, El",275,137,138
37,Salamanca,63,"Cabeza de Béjar, La",93,54,39
37,Salamanca,65,Cabeza del Caballo,357,192,165
37,Salamanca,62,Cabezabellosa de la Calzada,96,52,44
37,Salamanca,67,Cabrerizos,4106,2071,2035
37,Salamanca,68,Cabrillas,420,207,213
37,Salamanca,69,Calvarrasa de Abajo,1132,590,542
37,Salamanca,70,Calvarrasa de Arriba,613,320,293
37,Salamanca,71,"Calzada de Béjar, La",91,48,43
37,Salamanca,72,Calzada de Don Diego,186,100,86
37,Salamanca,73,Calzada de Valdunciel,662,344,318
37,Salamanca,74,Campillo de Azaba,178,99,79
37,Salamanca,77,"Campo de Peñaranda, El",267,148,119
37,Salamanca,78,Candelario,989,493,496
37,Salamanca,79,Canillas de Abajo,79,54,25
37,Salamanca,80,Cantagallo,278,149,129
37,Salamanca,81,Cantalapiedra,982,498,484
37,Salamanca,82,Cantalpino,964,530,434
37,Salamanca,83,Cantaracillo,207,110,97
37,Salamanca,85,Carbajosa de la Sagrada,6639,3395,3244
37,Salamanca,86,Carpio de Azaba,107,61,46
37,Salamanca,87,Carrascal de Barregas,1043,555,488
37,Salamanca,88,Carrascal del Obispo,235,126,109
37,Salamanca,89,Casafranca,76,43,33
37,Salamanca,90,"Casas del Conde, Las",55,30,25
37,Salamanca,91,Casillas de Flores,185,93,92
37,Salamanca,92,Castellanos de Moriscos,2109,1102,1007
37,Salamanca,185,Castellanos de Villiquera,688,366,322
37,Salamanca,96,Castillejo de Martín Viejo,242,133,109
37,Salamanca,97,Castraz,46,28,18
37,Salamanca,98,Cepeda,365,179,186
37,Salamanca,99,Cereceda de la Sierra,92,48,44
37,Salamanca,100,Cerezal de Peñahorcada,87,49,38
37,Salamanca,101,Cerralbo,184,102,82
37,Salamanca,102,"Cerro, El",458,229,229
37,Salamanca,103,Cespedosa de Tormes,564,300,264
37,Salamanca,114,Chagarcía Medianero,89,45,44
37,Salamanca,104,Cilleros de la Bastida,30,16,14
37,Salamanca,106,Cipérez,296,148,148
37,Salamanca,107,Ciudad Rodrigo,13503,6561,6942
37,Salamanca,108,Coca de Alba,105,51,54
37,Salamanca,109,Colmenar de Montemayor,193,104,89
37,Salamanca,110,Cordovilla,125,71,54
37,Salamanca,112,Cristóbal,174,99,75
37,Salamanca,113,"Cubo de Don Sancho, El",464,249,215
37,Salamanca,115,Dios le Guarde,149,78,71
37,Salamanca,116,Doñinos de Ledesma,75,38,37
37,Salamanca,117,Doñinos de Salamanca,1853,982,871
37,Salamanca,118,Ejeme,137,79,58
37,Salamanca,120,Encina de San Silvestre,112,57,55
37,Salamanca,119,"Encina, La",120,76,44
37,Salamanca,121,Encinas de Abajo,620,325,295
37,Salamanca,122,Encinas de Arriba,252,130,122
37,Salamanca,123,Encinasola de los Comendadores,211,113,98
37,Salamanca,124,Endrinal,257,141,116
37,Salamanca,125,Escurial de la Sierra,254,137,117
37,Salamanca,126,Espadaña,32,19,13
37,Salamanca,127,Espeja,261,133,128
37,Salamanca,128,Espino de la Orbada,281,150,131
37,Salamanca,129,Florida de Liébana,286,154,132
37,Salamanca,130,Forfoleda,187,105,82
37,Salamanca,131,Frades de la Sierra,215,115,100
37,Salamanca,132,"Fregeneda, La",404,199,205
37,Salamanca,133,Fresnedoso,109,63,46
37,Salamanca,134,Fresno Alhándiga,255,145,110
37,Salamanca,135,"Fuente de San Esteban, La",1413,713,700
37,Salamanca,136,Fuenteguinaldo,714,363,351
37,Salamanca,137,Fuenteliante,114,58,56
37,Salamanca,138,Fuenterroble de Salvatierra,260,135,125
37,Salamanca,139,Fuentes de Béjar,239,118,121
37,Salamanca,140,Fuentes de Oñoro,1353,674,679
37,Salamanca,141,Gajates,169,76,93
37,Salamanca,142,Galindo y Perahuy,716,410,306
37,Salamanca,143,Galinduste,469,229,240
37,Salamanca,144,Galisancho,415,233,182
37,Salamanca,145,Gallegos de Argañán,308,160,148
37,Salamanca,146,Gallegos de Solmirón,141,73,68
37,Salamanca,147,Garcibuey,173,97,76
37,Salamanca,148,Garcihernández,507,264,243
37,Salamanca,149,Garcirrey,74,43,31
37,Salamanca,150,Gejuelo del Barro,42,25,17
37,Salamanca,151,Golpejas,154,81,73
37,Salamanca,152,Gomecello,491,258,233
37,Salamanca,154,Guadramiro,165,94,71
37,Salamanca,155,Guijo de Ávila,93,56,37
37,Salamanca,156,Guijuelo,5939,3020,2919
37,Salamanca,157,Herguijuela de Ciudad Rodrigo,87,47,40
37,Salamanca,158,Herguijuela de la Sierra,298,159,139
37,Salamanca,159,Herguijuela del Campo,97,43,54
37,Salamanca,160,Hinojosa de Duero,730,360,370
37,Salamanca,161,Horcajo de Montemayor,159,86,73
37,Salamanca,162,Horcajo Medianero,226,119,107
37,Salamanca,163,"Hoya, La",45,25,20
37,Salamanca,164,Huerta,312,171,141
37,Salamanca,165,Iruelos,36,18,18
37,Salamanca,166,Ituero de Azaba,223,113,110
37,Salamanca,167,Juzbado,169,89,80
37,Salamanca,168,Lagunilla,536,295,241
37,Salamanca,169,Larrodrigo,203,115,88
37,Salamanca,170,Ledesma,1804,884,920
37,Salamanca,171,Ledrada,517,262,255
37,Salamanca,172,Linares de Riofrío,952,516,436
37,Salamanca,173,Lumbrales,1771,886,885
37,Salamanca,175,Machacón,464,242,222
37,Salamanca,174,Macotera,1246,659,587
37,Salamanca,176,Madroñal,159,93,66
37,Salamanca,177,"Maíllo, El",302,164,138
37,Salamanca,178,Malpartida,104,60,44
37,Salamanca,179,Mancera de Abajo,231,116,115
37,Salamanca,180,"Manzano, El",73,38,35
37,Salamanca,181,Martiago,287,148,139
37,Salamanca,183,Martín de Yeltes,449,232,217
37,Salamanca,182,Martinamor,100,61,39
37,Salamanca,184,Masueco,353,182,171
37,Salamanca,186,"Mata de Ledesma, La",113,59,54
37,Salamanca,187,Matilla de los Caños del Río,637,321,316
37,Salamanca,188,"Maya, La",201,116,85
37,Salamanca,189,Membribe de la Sierra,148,87,61
37,Salamanca,190,Mieza,240,118,122
37,Salamanca,191,"Milano, El",130,75,55
37,Salamanca,192,Miranda de Azán,410,215,195
37,Salamanca,193,Miranda del Castañar,486,259,227
37,Salamanca,194,Mogarraz,303,153,150
37,Salamanca,195,Molinillo,59,35,24
37,Salamanca,196,Monforte de la Sierra,89,46,43
37,Salamanca,197,Monleón,105,61,44
37,Salamanca,198,Monleras,257,123,134
37,Salamanca,199,Monsagro,151,79,72
37,Salamanca,200,Montejo,217,115,102
37,Salamanca,201,Montemayor del Río,296,154,142
37,Salamanca,202,Monterrubio de Armuña,1299,689,610
37,Salamanca,203,Monterrubio de la Sierra,179,100,79
37,Salamanca,204,Morasverdes,287,148,139
37,Salamanca,205,Morille,260,131,129
37,Salamanca,206,Moríñigo,107,57,50
37,Salamanca,207,Moriscos,304,170,134
37,Salamanca,208,Moronta,90,51,39
37,Salamanca,209,Mozárbez,500,267,233
37,Salamanca,211,Narros de Matalayegua,231,129,102
37,Salamanca,213,Nava de Béjar,106,59,47
37,Salamanca,214,Nava de Francia,140,76,64
37,Salamanca,215,Nava de Sotrobal,173,101,72
37,Salamanca,212,Navacarros,126,68,58
37,Salamanca,216,Navales,324,175,149
37,Salamanca,217,Navalmoral de Béjar,58,25,33
37,Salamanca,218,Navamorales,78,49,29
37,Salamanca,219,Navarredonda de la Rinconada,192,98,94
37,Salamanca,221,Navasfrías,485,247,238
37,Salamanca,222,Negrilla de Palencia,122,65,57
37,Salamanca,223,Olmedo de Camaces,130,72,58
37,Salamanca,224,"Orbada, La",215,110,105
37,Salamanca,225,Pajares de la Laguna,125,66,59
37,Salamanca,226,Palacios del Arzobispo,171,86,85
37,Salamanca,228,Palaciosrubios,413,219,194
37,Salamanca,229,Palencia de Negrilla,172,95,77
37,Salamanca,230,Parada de Arriba,272,140,132
37,Salamanca,231,Parada de Rubiales,297,154,143
37,Salamanca,232,Paradinas de San Juan,448,251,197
37,Salamanca,233,Pastores,57,32,25
37,Salamanca,234,"Payo, El",376,187,189
37,Salamanca,235,Pedraza de Alba,248,128,120
37,Salamanca,236,Pedrosillo de Alba,157,86,71
37,Salamanca,237,Pedrosillo de los Aires,393,216,177
37,Salamanca,238,Pedrosillo el Ralo,136,70,66
37,Salamanca,239,"Pedroso de la Armuña, El",250,123,127
37,Salamanca,240,Pelabravo,1097,570,527
37,Salamanca,241,Pelarrodríguez,171,103,68
37,Salamanca,242,Pelayos,116,67,49
37,Salamanca,243,"Peña, La",118,57,61
37,Salamanca,244,Peñacaballera,157,75,82
37,Salamanca,245,Peñaparda,391,202,189
37,Salamanca,246,Peñaranda de Bracamonte,6776,3332,3444
37,Salamanca,247,Peñarandilla,227,121,106
37,Salamanca,248,Peralejos de Abajo,159,82,77
37,Salamanca,249,Peralejos de Arriba,47,28,19
37,Salamanca,250,Pereña de la Ribera,413,210,203
37,Salamanca,251,Peromingo,140,66,74
37,Salamanca,252,Pinedas,112,63,49
37,Salamanca,253,"Pino de Tormes, El",163,85,78
37,Salamanca,254,Pitiegua,208,121,87
37,Salamanca,255,Pizarral,63,32,31
37,Salamanca,256,Poveda de las Cintas,258,145,113
37,Salamanca,257,Pozos de Hinojo,55,30,25
37,Salamanca,258,Puebla de Azaba,227,122,105
37,Salamanca,259,Puebla de San Medel,45,25,20
37,Salamanca,260,Puebla de Yeltes,149,83,66
37,Salamanca,261,Puente del Congosto,245,140,105
37,Salamanca,262,Puertas,82,43,39
37,Salamanca,263,Puerto de Béjar,398,204,194
37,Salamanca,264,Puerto Seguro,75,40,35
37,Salamanca,265,Rágama,251,125,126
37,Salamanca,266,"Redonda, La",92,53,39
37,Salamanca,267,Retortillo,256,137,119
37,Salamanca,268,"Rinconada de la Sierra, La",123,66,57
37,Salamanca,269,Robleda,488,259,229
37,Salamanca,270,Robliza de Cojos,240,123,117
37,Salamanca,271,Rollán,403,215,188
37,Salamanca,272,Saelices el Chico,166,86,80
37,Salamanca,273,"Sagrada, La",121,63,58
37,Salamanca,303,"Sahugo, El",199,103,96
37,Salamanca,274,Salamanca,149528,68687,80841
37,Salamanca,275,Saldeana,130,70,60
37,Salamanca,276,Salmoral,170,98,72
37,Salamanca,277,Salvatierra de Tormes,66,31,35
37,Salamanca,278,San Cristóbal de la Cuesta,968,516,452
37,Salamanca,284,San Esteban de la Sierra,349,185,164
37,Salamanca,285,San Felices de los Gallegos,474,245,229
37,Salamanca,286,San Martín del Castañar,262,136,126
37,Salamanca,287,San Miguel de Valero,365,179,186
37,Salamanca,36,San Miguel del Robledo,72,34,38
37,Salamanca,288,San Morales,301,168,133
37,Salamanca,289,San Muñoz,275,141,134
37,Salamanca,291,San Pedro de Rozados,309,165,144
37,Salamanca,290,San Pedro del Valle,143,76,67
37,Salamanca,292,San Pelayo de Guareña,92,47,45
37,Salamanca,280,Sanchón de la Ribera,80,48,32
37,Salamanca,281,Sanchón de la Sagrada,38,22,16
37,Salamanca,282,Sanchotello,229,123,106
37,Salamanca,279,Sancti-Spíritus,862,455,407
37,Salamanca,283,Sando,145,83,62
37,Salamanca,293,Santa María de Sando,129,66,63
37,Salamanca,294,Santa Marta de Tormes,15032,7467,7565
37,Salamanca,296,Santiago de la Puebla,393,203,190
37,Salamanca,297,Santibáñez de Béjar,505,263,242
37,Salamanca,298,Santibáñez de la Sierra,204,110,94
37,Salamanca,299,Santiz,254,131,123
37,Salamanca,300,"Santos, Los",662,347,315
37,Salamanca,301,Sardón de los Frailes,81,44,37
37,Salamanca,302,Saucelle,350,181,169
37,Salamanca,304,Sepulcro-Hilario,188,105,83
37,Salamanca,305,Sequeros,229,110,119
37,Salamanca,306,Serradilla del Arroyo,313,169,144
37,Salamanca,307,Serradilla del Llano,173,84,89
37,Salamanca,309,"Sierpe, La",45,26,19
37,Salamanca,310,Sieteiglesias de Tormes,178,93,85
37,Salamanca,311,Sobradillo,255,132,123
37,Salamanca,312,Sorihuela,293,150,143
37,Salamanca,313,Sotoserrano,645,340,305
37,Salamanca,314,Tabera de Abajo,98,59,39
37,Salamanca,315,"Tala, La",99,53,46
37,Salamanca,316,Tamames,885,461,424
37,Salamanca,317,Tarazona de Guareña,349,188,161
37,Salamanca,318,Tardáguila,239,135,104
37,Salamanca,319,"Tejado, El",133,67,66
37,Salamanca,320,Tejeda y Segoyuela,106,58,48
37,Salamanca,321,Tenebrón,170,83,87
37,Salamanca,322,Terradillos,3314,1725,1589
37,Salamanca,323,Topas,597,316,281
37,Salamanca,324,Tordillos,419,222,197
37,Salamanca,325,"Tornadizo, El",99,54,45
37,Salamanca,327,Torresmenudas,212,106,106
37,Salamanca,328,Trabanca,227,112,115
37,Salamanca,329,Tremedal de Tormes,41,20,21
37,Salamanca,330,Valdecarros,371,192,179
37,Salamanca,331,Valdefuentes de Sangusín,241,128,113
37,Salamanca,332,Valdehijaderos,79,41,38
37,Salamanca,333,Valdelacasa,240,137,103
37,Salamanca,334,Valdelageve,92,46,46
37,Salamanca,335,Valdelosa,467,234,233
37,Salamanca,336,Valdemierque,58,36,22
37,Salamanca,337,Valderrodrigo,155,75,80
37,Salamanca,338,Valdunciel,96,48,48
37,Salamanca,339,Valero,298,161,137
37,Salamanca,343,Vallejera de Riofrío,61,30,31
37,Salamanca,340,Valsalabroso,147,88,59
37,Salamanca,341,Valverde de Valdelacasa,69,39,30
37,Salamanca,342,Valverdón,292,149,143
37,Salamanca,344,Vecinos,279,141,138
37,Salamanca,345,Vega de Tirados,191,98,93
37,Salamanca,346,"Veguillas, Las",280,128,152
37,Salamanca,347,"Vellés, La",563,307,256
37,Salamanca,348,Ventosa del Río Almar,122,68,54
37,Salamanca,349,"Vídola, La",137,67,70
37,Salamanca,351,Villaflores,294,148,146
37,Salamanca,352,Villagonzalo de Tormes,218,127,91
37,Salamanca,353,Villalba de los Llanos,146,83,63
37,Salamanca,354,Villamayor,6826,3436,3390
37,Salamanca,355,Villanueva del Conde,159,86,73
37,Salamanca,356,Villar de Argañán,97,53,44
37,Salamanca,357,Villar de Ciervo,291,156,135
37,Salamanca,358,Villar de Gallimazo,169,93,76
37,Salamanca,359,Villar de la Yegua,196,103,93
37,Salamanca,360,Villar de Peralonso,268,130,138
37,Salamanca,361,Villar de Samaniego,94,53,41
37,Salamanca,362,Villares de la Reina,6135,3085,3050
37,Salamanca,363,Villares de Yeltes,133,62,71
37,Salamanca,364,Villarino de los Aires,879,456,423
37,Salamanca,365,Villarmayor,222,122,100
37,Salamanca,366,Villarmuerto,43,26,17
37,Salamanca,367,Villasbuenas,215,115,100
37,Salamanca,368,Villasdardo,19,9,10
37,Salamanca,369,Villaseco de los Gamitos,155,87,68
37,Salamanca,370,Villaseco de los Reyes,394,222,172
37,Salamanca,371,Villasrubias,305,161,144
37,Salamanca,372,Villaverde de Guareña,148,82,66
37,Salamanca,373,Villavieja de Yeltes,912,476,436
37,Salamanca,374,Villoria,1465,745,720
37,Salamanca,375,Villoruela,862,436,426
37,Salamanca,350,Vilvestre,468,230,238
37,Salamanca,376,Vitigudino,2819,1398,1421
37,Salamanca,377,Yecla de Yeltes,285,146,139
37,Salamanca,378,Zamarra,113,63,50
37,Salamanca,379,Zamayón,191,107,84
37,Salamanca,380,Zarapicos,51,26,25
37,Salamanca,381,"Zarza de Pumareda, La",148,83,65
37,Salamanca,382,Zorita de la Frontera,203,107,96
38,Santa Cruz de Tenerife,1,Adeje,49387,25276,24111
38,Santa Cruz de Tenerife,2,Agulo,1100,554,546
38,Santa Cruz de Tenerife,3,Alajeró,2066,1105,961
38,Santa Cruz de Tenerife,4,Arafo,5497,2716,2781
38,Santa Cruz de Tenerife,5,Arico,7392,3825,3567
38,Santa Cruz de Tenerife,6,Arona,80987,41695,39292
38,Santa Cruz de Tenerife,7,Barlovento,2085,1051,1034
38,Santa Cruz de Tenerife,8,Breña Alta,7455,3676,3779
38,Santa Cruz de Tenerife,9,Breña Baja,5523,2805,2718
38,Santa Cruz de Tenerife,10,Buenavista del Norte,4961,2529,2432
38,Santa Cruz de Tenerife,11,Candelaria,26134,12772,13362
38,Santa Cruz de Tenerife,12,Fasnia,2873,1489,1384
38,Santa Cruz de Tenerife,13,Frontera,4058,2062,1996
38,Santa Cruz de Tenerife,14,Fuencaliente de la Palma,1798,910,888
38,Santa Cruz de Tenerife,15,Garachico,5086,2526,2560
38,Santa Cruz de Tenerife,16,Garafía,1645,835,810
38,Santa Cruz de Tenerife,17,Granadilla de Abona,43608,22107,21501
38,Santa Cruz de Tenerife,18,"Guancha, La",5448,2681,2767
38,Santa Cruz de Tenerife,19,Guía de Isora,20537,10284,10253
38,Santa Cruz de Tenerife,20,Güímar,18589,9217,9372
38,Santa Cruz de Tenerife,21,Hermigua,2103,1076,1027
38,Santa Cruz de Tenerife,22,Icod de los Vinos,23092,11408,11684
38,Santa Cruz de Tenerife,24,"Llanos de Aridane, Los",20930,10217,10713
38,Santa Cruz de Tenerife,25,"Matanza de Acentejo, La",8944,4538,4406
38,Santa Cruz de Tenerife,26,"Orotava, La",41255,20335,20920
38,Santa Cruz de Tenerife,27,"Paso, El",7928,3963,3965
38,Santa Cruz de Tenerife,901,"Pinar de El Hierro, El",1873,966,907
38,Santa Cruz de Tenerife,28,Puerto de la Cruz,28929,14128,14801
38,Santa Cruz de Tenerife,29,Puntagorda,2057,1040,1017
38,Santa Cruz de Tenerife,30,Puntallana,2346,1184,1162
38,Santa Cruz de Tenerife,31,"Realejos, Los",37970,18724,19246
38,Santa Cruz de Tenerife,32,"Rosario, El",17465,8900,8565
38,Santa Cruz de Tenerife,33,San Andrés y Sauces,4473,2250,2223
38,Santa Cruz de Tenerife,23,San Cristóbal de La Laguna,151718,73977,77741
38,Santa Cruz de Tenerife,34,San Juan de la Rambla,5110,2549,2561
38,Santa Cruz de Tenerife,35,San Miguel de Abona,16099,8121,7978
38,Santa Cruz de Tenerife,36,San Sebastián de la Gomera,8699,4391,4308
38,Santa Cruz de Tenerife,37,Santa Cruz de la Palma,16330,7962,8368
38,Santa Cruz de Tenerife,38,Santa Cruz de Tenerife,206593,98920,107673
38,Santa Cruz de Tenerife,39,Santa Úrsula,14545,7278,7267
38,Santa Cruz de Tenerife,40,Santiago del Teide,12634,6332,6302
38,Santa Cruz de Tenerife,41,"Sauzal, El",9076,4490,4586
38,Santa Cruz de Tenerife,42,"Silos, Los",5082,2556,2526
38,Santa Cruz de Tenerife,43,Tacoronte,23805,11922,11883
38,Santa Cruz de Tenerife,44,"Tanque, El",2815,1377,1438
38,Santa Cruz de Tenerife,45,Tazacorte,4911,2501,2410
38,Santa Cruz de Tenerife,46,Tegueste,11078,5478,5600
38,Santa Cruz de Tenerife,47,Tijarafe,2776,1412,1364
38,Santa Cruz de Tenerife,49,Valle Gran Rey,4240,2156,2084
38,Santa Cruz de Tenerife,50,Vallehermoso,2945,1514,1431
38,Santa Cruz de Tenerife,48,Valverde,5048,2580,2468
38,Santa Cruz de Tenerife,51,"Victoria de Acentejo, La",9069,4553,4516
38,Santa Cruz de Tenerife,52,Vilaflor,1804,929,875
38,Santa Cruz de Tenerife,53,Villa de Mazo,4858,2450,2408
40,Segovia,1,Abades,890,449,441
40,Segovia,2,Adrada de Pirón,35,17,18
40,Segovia,3,Adrados,157,89,68
40,Segovia,4,Aguilafuente,657,317,340
40,Segovia,5,Alconada de Maderuelo,32,20,12
40,Segovia,12,Aldea Real,329,175,154
40,Segovia,6,Aldealcorvo,21,13,8
40,Segovia,7,Aldealengua de Pedraza,95,56,39
40,Segovia,8,Aldealengua de Santa María,64,30,34
40,Segovia,9,Aldeanueva de la Serrezuela,57,38,19
40,Segovia,10,Aldeanueva del Codonal,141,76,65
40,Segovia,13,Aldeasoña,67,40,27
40,Segovia,14,Aldehorno,55,30,25
40,Segovia,15,Aldehuela del Codonal,31,16,15
40,Segovia,16,Aldeonte,67,31,36
40,Segovia,17,Anaya,126,61,65
40,Segovia,18,Añe,106,59,47
40,Segovia,19,Arahuetes,41,26,15
40,Segovia,20,Arcones,258,124,134
40,Segovia,21,Arevalillo de Cega,35,19,16
40,Segovia,22,Armuña,232,133,99
40,Segovia,24,Ayllón,1371,725,646
40,Segovia,25,Barbolla,206,115,91
40,Segovia,26,Basardilla,180,85,95
40,Segovia,28,Bercial,113,60,53
40,Segovia,29,Bercimuel,37,19,18
40,Segovia,30,Bernardos,570,309,261
40,Segovia,31,Bernuy de Porreros,696,378,318
40,Segovia,32,Boceguillas,810,411,399
40,Segovia,33,Brieva,88,53,35
40,Segovia,34,Caballar,99,51,48
40,Segovia,35,Cabañas de Polendos,177,97,80
40,Segovia,36,Cabezuela,684,353,331
40,Segovia,37,Calabazas de Fuentidueña,36,20,16
40,Segovia,39,Campo de San Pedro,321,181,140
40,Segovia,40,Cantalejo,3937,2011,1926
40,Segovia,41,Cantimpalos,1423,738,685
40,Segovia,43,Carbonero el Mayor,2541,1290,1251
40,Segovia,44,Carrascal del Río,167,91,76
40,Segovia,45,Casla,173,86,87
40,Segovia,46,Castillejo de Mesleón,135,80,55
40,Segovia,47,Castro de Fuentidueña,43,27,16
40,Segovia,48,Castrojimeno,33,18,15
40,Segovia,49,Castroserna de Abajo,55,26,29
40,Segovia,51,Castroserracín,44,24,20
40,Segovia,52,Cedillo de la Torre,117,53,64
40,Segovia,53,Cerezo de Abajo,148,79,69
40,Segovia,54,Cerezo de Arriba,180,100,80
40,Segovia,65,Chañe,876,415,461
40,Segovia,55,Cilleruelo de San Mamés,44,26,18
40,Segovia,56,Cobos de Fuentidueña,34,17,17
40,Segovia,57,Coca,2034,1001,1033
40,Segovia,58,Codorniz,372,189,183
40,Segovia,59,Collado Hermoso,154,74,80
40,Segovia,60,Condado de Castilnovo,86,49,37
40,Segovia,61,Corral de Ayllón,88,55,33
40,Segovia,902,Cozuelos de Fuentidueña,141,81,60
40,Segovia,62,Cubillo,68,40,28
40,Segovia,63,Cuéllar,9671,4884,4787
40,Segovia,905,Cuevas de Provanco,143,76,67
40,Segovia,68,Domingo García,37,22,15
40,Segovia,69,Donhierro,107,58,49
40,Segovia,70,Duruelo,174,103,71
40,Segovia,71,Encinas,53,30,23
40,Segovia,72,Encinillas,214,117,97
40,Segovia,73,Escalona del Prado,562,296,266
40,Segovia,74,Escarabajosa de Cabezas,337,183,154
40,Segovia,75,Escobar de Polendos,189,98,91
40,Segovia,76,"Espinar, El",9707,4983,4724
40,Segovia,77,Espirdo,1046,558,488
40,Segovia,78,Fresneda de Cuéllar,181,99,82
40,Segovia,79,Fresno de Cantespino,252,138,114
40,Segovia,80,Fresno de la Fuente,103,54,49
40,Segovia,81,Frumales,144,72,72
40,Segovia,82,Fuente de Santa Cruz,132,66,66
40,Segovia,83,Fuente el Olmo de Fuentidueña,170,65,105
40,Segovia,84,Fuente el Olmo de Íscar,77,44,33
40,Segovia,86,Fuentepelayo,959,498,461
40,Segovia,87,Fuentepiñel,106,56,50
40,Segovia,88,Fuenterrebollo,365,190,175
40,Segovia,89,Fuentesaúco de Fuentidueña,267,147,120
40,Segovia,91,Fuentesoto,132,68,64
40,Segovia,92,Fuentidueña,147,79,68
40,Segovia,93,Gallegos,90,49,41
40,Segovia,94,Garcillán,477,256,221
40,Segovia,95,Gomezserracín,697,361,336
40,Segovia,97,Grajera,236,127,109
40,Segovia,99,Honrubia de la Cuesta,70,40,30
40,Segovia,100,Hontalbilla,327,176,151
40,Segovia,101,Hontanares de Eresma,1214,641,573
40,Segovia,103,"Huertos, Los",174,102,72
40,Segovia,104,Ituero y Lama,370,191,179
40,Segovia,105,Juarros de Riomoros,71,41,30
40,Segovia,106,Juarros de Voltoya,250,122,128
40,Segovia,107,Labajos,146,80,66
40,Segovia,108,Laguna de Contreras,122,70,52
40,Segovia,109,Languilla,86,47,39
40,Segovia,110,Lastras de Cuéllar,420,210,210
40,Segovia,111,Lastras del Pozo,84,40,44
40,Segovia,112,"Lastrilla, La",3562,1832,1730
40,Segovia,113,"Losa, La",529,288,241
40,Segovia,115,Maderuelo,115,64,51
40,Segovia,903,Marazoleja,120,74,46
40,Segovia,118,Marazuela,56,33,23
40,Segovia,119,Martín Miguel,223,127,96
40,Segovia,120,Martín Muñoz de la Dehesa,212,112,100
40,Segovia,121,Martín Muñoz de las Posadas,367,188,179
40,Segovia,122,Marugán,654,355,299
40,Segovia,124,Mata de Cuéllar,283,149,134
40,Segovia,123,Matabuena,218,120,98
40,Segovia,125,"Matilla, La",97,54,43
40,Segovia,126,Melque de Cercos,94,48,46
40,Segovia,127,Membibre de la Hoz,38,21,17
40,Segovia,128,Migueláñez,175,91,84
40,Segovia,129,Montejo de Arévalo,211,114,97
40,Segovia,130,Montejo de la Vega de la Serrezuela,154,93,61
40,Segovia,131,Monterrubio,63,36,27
40,Segovia,132,Moral de Hornuez,76,43,33
40,Segovia,134,Mozoncillo,1039,564,475
40,Segovia,135,Muñopedro,335,174,161
40,Segovia,136,Muñoveros,177,85,92
40,Segovia,138,Nava de la Asunción,3029,1525,1504
40,Segovia,139,Navafría,324,176,148
40,Segovia,140,Navalilla,121,60,61
40,Segovia,141,Navalmanzano,1169,612,557
40,Segovia,142,Navares de Ayuso,62,30,32
40,Segovia,143,Navares de Enmedio,103,60,43
40,Segovia,144,Navares de las Cuevas,25,16,9
40,Segovia,145,Navas de Oro,1439,747,692
40,Segovia,904,Navas de Riofrío,426,202,224
40,Segovia,146,Navas de San Antonio,416,217,199
40,Segovia,148,Nieva,335,179,156
40,Segovia,149,Olombrada,663,359,304
40,Segovia,150,Orejana,74,42,32
40,Segovia,151,Ortigosa de Pestaño,94,49,45
40,Segovia,901,Ortigosa del Monte,574,305,269
40,Segovia,152,Otero de Herreros,1010,517,493
40,Segovia,154,Pajarejos,21,13,8
40,Segovia,155,Palazuelos de Eresma,4707,2443,2264
40,Segovia,156,Pedraza,438,244,194
40,Segovia,157,Pelayos del Arroyo,63,36,27
40,Segovia,158,Perosillo,18,13,5
40,Segovia,159,Pinarejos,168,98,70
40,Segovia,160,Pinarnegrillo,122,68,54
40,Segovia,161,Pradales,43,21,22
40,Segovia,162,Prádena,570,310,260
40,Segovia,163,Puebla de Pedraza,56,30,26
40,Segovia,164,Rapariegos,221,116,105
40,Segovia,181,Real Sitio de San Ildefonso,5569,2750,2819
40,Segovia,165,Rebollo,98,54,44
40,Segovia,166,Remondo,326,162,164
40,Segovia,168,Riaguas de San Bartolomé,39,21,18
40,Segovia,170,Riaza,2473,1348,1125
40,Segovia,171,Ribota,46,35,11
40,Segovia,172,Riofrío de Riaza,30,18,12
40,Segovia,173,Roda de Eresma,198,109,89
40,Segovia,174,Sacramenia,427,225,202
40,Segovia,176,Samboal,495,266,229
40,Segovia,177,San Cristóbal de Cuéllar,181,100,81
40,Segovia,178,San Cristóbal de la Vega,128,62,66
40,Segovia,906,San Cristóbal de Segovia,2916,1501,1415
40,Segovia,182,San Martín y Mudrián,289,141,148
40,Segovia,183,San Miguel de Bernuy,161,83,78
40,Segovia,184,San Pedro de Gaíllos,288,149,139
40,Segovia,179,Sanchonuño,980,474,506
40,Segovia,180,Sangarcía,366,193,173
40,Segovia,185,Santa María la Real de Nieva,993,531,462
40,Segovia,186,Santa Marta del Cerro,40,18,22
40,Segovia,188,Santiuste de Pedraza,121,71,50
40,Segovia,189,Santiuste de San Juan Bautista,628,340,288
40,Segovia,190,Santo Domingo de Pirón,66,33,33
40,Segovia,191,Santo Tomé del Puerto,307,165,142
40,Segovia,192,Sauquillo de Cabezas,208,111,97
40,Segovia,193,Sebúlcor,280,146,134
40,Segovia,194,Segovia,54309,25966,28343
40,Segovia,195,Sepúlveda,1219,628,591
40,Segovia,196,Sequera de Fresno,41,23,18
40,Segovia,198,Sotillo,32,19,13
40,Segovia,199,Sotosalbos,126,65,61
40,Segovia,200,Tabanera la Luenga,73,32,41
40,Segovia,201,Tolocirio,54,24,30
40,Segovia,206,Torre Val de San Pedro,190,93,97
40,Segovia,202,Torreadrada,80,36,44
40,Segovia,203,Torrecaballeros,1285,649,636
40,Segovia,204,Torrecilla del Pinar,221,115,106
40,Segovia,205,Torreiglesias,342,172,170
40,Segovia,207,Trescasas,978,499,479
40,Segovia,208,Turégano,1082,534,548
40,Segovia,210,Urueñas,94,55,39
40,Segovia,211,Valdeprados,86,47,39
40,Segovia,212,Valdevacas de Montejo,35,19,16
40,Segovia,213,Valdevacas y Guijar,108,54,54
40,Segovia,218,Valle de Tabladillo,105,61,44
40,Segovia,219,Vallelado,766,412,354
40,Segovia,220,Valleruela de Pedraza,82,42,40
40,Segovia,221,Valleruela de Sepúlveda,56,27,29
40,Segovia,214,Valseca,278,151,127
40,Segovia,215,Valtiendas,109,67,42
40,Segovia,216,Valverde del Majano,1074,530,544
40,Segovia,222,Veganzones,267,147,120
40,Segovia,223,Vegas de Matute,294,176,118
40,Segovia,224,Ventosilla y Tejadilla,29,20,9
40,Segovia,225,Villacastín,1585,811,774
40,Segovia,228,Villaverde de Íscar,674,353,321
40,Segovia,229,Villaverde de Montejo,42,23,19
40,Segovia,230,Villeguillo,134,81,53
40,Segovia,231,Yanguas de Eresma,156,79,77
40,Segovia,233,Zarzuela del Monte,577,291,286
40,Segovia,234,Zarzuela del Pinar,491,255,236
41,Sevilla,1,Aguadulce,2166,1066,1100
41,Sevilla,2,Alanís,1843,918,925
41,Sevilla,3,Albaida del Aljarafe,3084,1552,1532
41,Sevilla,4,Alcalá de Guadaíra,73876,36762,37114
41,Sevilla,5,Alcalá del Río,11620,5882,5738
41,Sevilla,6,Alcolea del Río,3404,1697,1707
41,Sevilla,7,"Algaba, La",16029,7948,8081
41,Sevilla,8,Algámitas,1310,683,627
41,Sevilla,9,Almadén de la Plata,1531,775,756
41,Sevilla,10,Almensilla,5814,2931,2883
41,Sevilla,11,Arahal,19536,9659,9877
41,Sevilla,12,Aznalcázar,4257,2163,2094
41,Sevilla,13,Aznalcóllar,6200,3163,3037
41,Sevilla,14,Badolatosa,3184,1642,1542
41,Sevilla,15,Benacazón,7144,3624,3520
41,Sevilla,16,Bollullos de la Mitación,9882,4964,4918
41,Sevilla,17,Bormujos,20681,10301,10380
41,Sevilla,18,Brenes,12897,6472,6425
41,Sevilla,19,Burguillos,6556,3304,3252
41,Sevilla,20,"Cabezas de San Juan, Las",16589,8401,8188
41,Sevilla,21,Camas,26535,12943,13592
41,Sevilla,22,"Campana, La",5497,2759,2738
41,Sevilla,23,Cantillana,10842,5587,5255
41,Sevilla,901,Cañada Rosal,3277,1628,1649
41,Sevilla,24,Carmona,28793,14475,14318
41,Sevilla,25,Carrión de los Céspedes,2524,1221,1303
41,Sevilla,26,Casariche,5619,2876,2743
41,Sevilla,27,Castilblanco de los Arroyos,5075,2555,2520
41,Sevilla,28,Castilleja de Guzmán,2858,1443,1415
41,Sevilla,29,Castilleja de la Cuesta,17474,8462,9012
41,Sevilla,30,Castilleja del Campo,650,319,331
41,Sevilla,31,"Castillo de las Guardas, El",1545,791,754
41,Sevilla,32,Cazalla de la Sierra,5054,2485,2569
41,Sevilla,33,Constantina,6337,3146,3191
41,Sevilla,34,Coria del Río,30115,15055,15060
41,Sevilla,35,Coripe,1359,682,677
41,Sevilla,36,"Coronil, El",5001,2508,2493
41,Sevilla,37,"Corrales, Los",4047,2075,1972
41,Sevilla,903,"Cuervo de Sevilla, El",8737,4463,4274
41,Sevilla,38,Dos Hermanas,129719,64074,65645
41,Sevilla,39,Écija,40880,20169,20711
41,Sevilla,40,Espartinas,14485,7288,7197
41,Sevilla,41,Estepa,12631,6285,6346
41,Sevilla,42,Fuentes de Andalucía,7257,3616,3641
41,Sevilla,43,"Garrobo, El",769,395,374
41,Sevilla,44,Gelves,9591,4738,4853
41,Sevilla,45,Gerena,7207,3638,3569
41,Sevilla,46,Gilena,3897,1967,1930
41,Sevilla,47,Gines,13299,6566,6733
41,Sevilla,48,Guadalcanal,2861,1433,1428
41,Sevilla,49,Guillena,12328,6231,6097
41,Sevilla,50,Herrera,6510,3220,3290
41,Sevilla,51,Huévar del Aljarafe,2742,1415,1327
41,Sevilla,902,Isla Mayor,5948,3000,2948
41,Sevilla,52,"Lantejuela, La",3938,2019,1919
41,Sevilla,53,Lebrija,27395,13726,13669
41,Sevilla,54,Lora de Estepa,870,441,429
41,Sevilla,55,Lora del Río,19403,9654,9749
41,Sevilla,56,"Luisiana, La",4694,2373,2321
41,Sevilla,57,"Madroño, El",314,156,158
41,Sevilla,58,Mairena del Alcor,22328,11168,11160
41,Sevilla,59,Mairena del Aljarafe,43305,21204,22101
41,Sevilla,60,Marchena,19959,9969,9990
41,Sevilla,61,Marinaleda,2771,1405,1366
41,Sevilla,62,Martín de la Jara,2816,1448,1368
41,Sevilla,63,"Molares, Los",3522,1814,1708
41,Sevilla,64,Montellano,7154,3586,3568
41,Sevilla,65,Morón de la Frontera,28334,14000,14334
41,Sevilla,66,"Navas de la Concepción, Las",1704,835,869
41,Sevilla,67,Olivares,9568,4806,4762
41,Sevilla,68,Osuna,17820,8793,9027
41,Sevilla,69,"Palacios y Villafranca, Los",37936,19106,18830
41,Sevilla,70,Palomares del Río,7839,3952,3887
41,Sevilla,71,Paradas,7094,3561,3533
41,Sevilla,72,Pedrera,5352,2639,2713
41,Sevilla,73,"Pedroso, El",2194,1089,1105
41,Sevilla,74,Peñaflor,3738,1888,1850
41,Sevilla,75,Pilas,14058,7110,6948
41,Sevilla,76,Pruna,2788,1446,1342
41,Sevilla,77,"Puebla de Cazalla, La",11448,5714,5734
41,Sevilla,78,"Puebla de los Infantes, La",3134,1550,1584
41,Sevilla,79,"Puebla del Río, La",12207,6082,6125
41,Sevilla,80,"Real de la Jara, El",1617,796,821
41,Sevilla,81,"Rinconada, La",37755,18819,18936
41,Sevilla,82,"Roda de Andalucía, La",4351,2162,2189
41,Sevilla,83,"Ronquillo, El",1429,738,691
41,Sevilla,84,"Rubio, El",3580,1776,1804
41,Sevilla,85,Salteras,5449,2659,2790
41,Sevilla,86,San Juan de Aznalfarache,21801,10563,11238
41,Sevilla,88,San Nicolás del Puerto,621,317,304
41,Sevilla,87,Sanlúcar la Mayor,13498,6691,6807
41,Sevilla,89,Santiponce,8382,4191,4191
41,Sevilla,90,"Saucejo, El",4462,2232,2230
41,Sevilla,91,Sevilla,700169,332743,367426
41,Sevilla,92,Tocina,9640,4769,4871
41,Sevilla,93,Tomares,24346,12068,12278
41,Sevilla,94,Umbrete,8512,4292,4220
41,Sevilla,95,Utrera,52013,25980,26033
41,Sevilla,96,Valencina de la Concepción,7986,3972,4014
41,Sevilla,97,Villamanrique de la Condesa,4359,2158,2201
41,Sevilla,100,Villanueva de San Juan,1300,626,674
41,Sevilla,98,Villanueva del Ariscal,6244,3056,3188
41,Sevilla,99,Villanueva del Río y Minas,5096,2547,2549
41,Sevilla,101,Villaverde del Río,7697,3926,3771
41,Sevilla,102,"Viso del Alcor, El",19099,9567,9532
42,Soria,1,Abejar,348,195,153
42,Soria,3,Adradas,58,31,27
42,Soria,4,Ágreda,3134,1593,1541
42,Soria,6,Alconaba,193,116,77
42,Soria,7,Alcubilla de Avellaneda,153,78,75
42,Soria,8,Alcubilla de las Peñas,67,41,26
42,Soria,9,Aldealafuente,99,56,43
42,Soria,10,Aldealices,25,15,10
42,Soria,11,Aldealpozo,27,14,13
42,Soria,12,Aldealseñor,44,26,18
42,Soria,13,Aldehuela de Periáñez,47,22,25
42,Soria,14,"Aldehuelas, Las",75,39,36
42,Soria,15,Alentisque,34,20,14
42,Soria,16,Aliud,24,13,11
42,Soria,17,Almajano,209,109,100
42,Soria,18,Almaluez,171,99,72
42,Soria,19,Almarza,626,359,267
42,Soria,20,Almazán,5843,2985,2858
42,Soria,21,Almazul,93,54,39
42,Soria,22,Almenar de Soria,261,154,107
42,Soria,23,Alpanseque,77,43,34
42,Soria,24,Arancón,91,60,31
42,Soria,25,Arcos de Jalón,1774,948,826
42,Soria,26,Arenillas,35,17,18
42,Soria,27,Arévalo de la Sierra,79,52,27
42,Soria,28,Ausejo de la Sierra,72,40,32
42,Soria,29,Baraona,174,99,75
42,Soria,30,Barca,117,68,49
42,Soria,31,Barcones,27,16,11
42,Soria,32,Bayubas de Abajo,177,91,86
42,Soria,33,Bayubas de Arriba,53,32,21
42,Soria,34,Beratón,39,22,17
42,Soria,35,Berlanga de Duero,994,493,501
42,Soria,36,Blacos,50,28,22
42,Soria,37,Bliecos,38,23,15
42,Soria,38,Borjabad,38,22,16
42,Soria,39,Borobia,282,149,133
42,Soria,41,Buberos,35,18,17
42,Soria,42,Buitrago,61,33,28
42,Soria,43,Burgo de Osma-Ciudad de Osma,5163,2597,2566
42,Soria,44,Cabrejas del Campo,64,37,27
42,Soria,45,Cabrejas del Pinar,405,228,177
42,Soria,46,Calatañazor,57,31,26
42,Soria,48,Caltojar,70,42,28
42,Soria,49,Candilichera,135,79,56
42,Soria,50,Cañamaque,34,24,10
42,Soria,51,Carabantes,22,11,11
42,Soria,52,Caracena,17,12,5
42,Soria,53,Carrascosa de Abajo,27,17,10
42,Soria,54,Carrascosa de la Sierra,22,15,7
42,Soria,55,Casarejos,198,99,99
42,Soria,56,Castilfrío de la Sierra,26,17,9
42,Soria,58,Castillejo de Robledo,129,69,60
42,Soria,57,Castilruiz,203,111,92
42,Soria,59,Centenera de Andaluz,24,9,15
42,Soria,60,Cerbón,35,24,11
42,Soria,61,Cidones,347,196,151
42,Soria,62,Cigudosa,32,20,12
42,Soria,63,Cihuela,64,35,29
42,Soria,64,Ciria,97,52,45
42,Soria,65,Cirujales del Río,25,15,10
42,Soria,68,Coscurita,98,59,39
42,Soria,69,Covaleda,1815,938,877
42,Soria,70,Cubilla,42,26,16
42,Soria,71,Cubo de la Solana,181,98,83
42,Soria,73,Cueva de Ágreda,82,49,33
42,Soria,75,Dévanos,97,54,43
42,Soria,76,Deza,251,130,121
42,Soria,78,Duruelo de la Sierra,1246,635,611
42,Soria,79,Escobosa de Almazán,28,19,9
42,Soria,80,Espeja de San Marcelino,177,105,72
42,Soria,81,Espejón,199,105,94
42,Soria,82,Estepa de San Juan,7,5,2
42,Soria,83,Frechilla de Almazán,27,14,13
42,Soria,84,Fresno de Caracena,28,16,12
42,Soria,85,Fuentearmegil,218,124,94
42,Soria,86,Fuentecambrón,41,26,15
42,Soria,87,Fuentecantos,58,28,30
42,Soria,88,Fuentelmonge,84,48,36
42,Soria,89,Fuentelsaz de Soria,59,31,28
42,Soria,90,Fuentepinilla,101,63,38
42,Soria,92,Fuentes de Magaña,87,47,40
42,Soria,93,Fuentestrún,55,32,23
42,Soria,94,Garray,634,345,289
42,Soria,95,Golmayo,2314,1209,1105
42,Soria,96,Gómara,362,206,156
42,Soria,97,Gormaz,24,15,9
42,Soria,98,Herrera de Soria,13,9,4
42,Soria,100,Hinojosa del Campo,34,22,12
42,Soria,103,Langa de Duero,801,432,369
42,Soria,105,Liceras,63,32,31
42,Soria,106,"Losilla, La",17,10,7
42,Soria,107,Magaña,89,53,36
42,Soria,108,Maján,13,7,6
42,Soria,110,Matalebreras,77,43,34
42,Soria,111,Matamala de Almazán,324,177,147
42,Soria,113,Medinaceli,780,379,401
42,Soria,115,Miño de Medinaceli,76,42,34
42,Soria,116,Miño de San Esteban,59,37,22
42,Soria,117,Molinos de Duero,176,95,81
42,Soria,118,Momblona,26,17,9
42,Soria,119,Monteagudo de las Vicarías,235,114,121
42,Soria,120,Montejo de Tiermes,190,126,64
42,Soria,121,Montenegro de Cameros,79,48,31
42,Soria,123,Morón de Almazán,229,118,111
42,Soria,124,Muriel de la Fuente,68,38,30
42,Soria,125,Muriel Viejo,81,46,35
42,Soria,127,Nafría de Ucero,44,26,18
42,Soria,128,Narros,48,25,23
42,Soria,129,Navaleno,865,450,415
42,Soria,130,Nepas,66,41,25
42,Soria,131,Nolay,59,31,28
42,Soria,132,Noviercas,179,95,84
42,Soria,134,Ólvega,3821,1978,1843
42,Soria,135,Oncala,94,57,37
42,Soria,139,Pinilla del Campo,22,13,9
42,Soria,140,Portillo de Soria,17,12,5
42,Soria,141,"Póveda de Soria, La",120,67,53
42,Soria,142,Pozalmuro,74,36,38
42,Soria,144,Quintana Redonda,523,289,234
42,Soria,145,Quintanas de Gormaz,147,85,62
42,Soria,148,Quiñonería,15,8,7
42,Soria,149,"Rábanos, Los",515,303,212
42,Soria,151,Rebollar,42,21,21
42,Soria,152,Recuerda,105,59,46
42,Soria,153,Rello,20,12,8
42,Soria,154,Renieblas,96,60,36
42,Soria,155,Retortillo de Soria,200,107,93
42,Soria,156,Reznos,33,22,11
42,Soria,157,"Riba de Escalote, La",18,12,6
42,Soria,158,Rioseco de Soria,138,78,60
42,Soria,159,Rollamienta,39,24,15
42,Soria,160,"Royo, El",310,170,140
42,Soria,161,Salduero,167,90,77
42,Soria,162,San Esteban de Gormaz,3160,1674,1486
42,Soria,163,San Felices,61,36,25
42,Soria,164,San Leonardo de Yagüe,2273,1171,1102
42,Soria,165,San Pedro Manrique,618,350,268
42,Soria,166,Santa Cruz de Yanguas,73,46,27
42,Soria,167,Santa María de Huerta,328,178,150
42,Soria,168,Santa María de las Hoyas,135,78,57
42,Soria,171,Serón de Nágima,152,83,69
42,Soria,172,Soliedra,36,19,17
42,Soria,173,Soria,39753,18869,20884
42,Soria,174,Sotillo del Rincón,192,99,93
42,Soria,175,Suellacabras,28,16,12
42,Soria,176,Tajahuerce,30,17,13
42,Soria,177,Tajueco,81,45,36
42,Soria,178,Talveila,149,80,69
42,Soria,181,Tardelcuende,471,245,226
42,Soria,182,Taroda,55,29,26
42,Soria,183,Tejado,131,74,57
42,Soria,184,Torlengua,74,39,35
42,Soria,185,Torreblacos,28,15,13
42,Soria,187,Torrubia de Soria,71,48,23
42,Soria,188,Trévago,54,25,29
42,Soria,189,Ucero,71,36,35
42,Soria,190,Vadillo,130,74,56
42,Soria,191,Valdeavellano de Tera,201,113,88
42,Soria,192,Valdegeña,43,29,14
42,Soria,193,Valdelagua del Cerro,20,13,7
42,Soria,194,Valdemaluque,196,94,102
42,Soria,195,Valdenebro,128,73,55
42,Soria,196,Valdeprado,15,11,4
42,Soria,197,Valderrodilla,88,50,38
42,Soria,198,Valtajeros,24,13,11
42,Soria,200,Velamazán,92,58,34
42,Soria,201,Velilla de la Sierra,28,18,10
42,Soria,202,Velilla de los Ajos,29,19,10
42,Soria,204,Viana de Duero,61,43,18
42,Soria,205,Villaciervos,93,59,34
42,Soria,206,Villanueva de Gormaz,9,6,3
42,Soria,207,Villar del Ala,54,24,30
42,Soria,208,Villar del Campo,25,16,9
42,Soria,209,Villar del Río,159,100,59
42,Soria,211,"Villares de Soria, Los",94,53,41
42,Soria,212,Villasayas,75,49,26
42,Soria,213,Villaseca de Arciel,36,20,16
42,Soria,215,Vinuesa,968,526,442
42,Soria,216,Vizmanos,27,17,10
42,Soria,217,Vozmediano,40,25,15
42,Soria,218,Yanguas,123,80,43
42,Soria,219,Yelo,47,25,22
43,Tarragona,1,Aiguamúrcia,918,486,432
43,Tarragona,2,Albinyana,2354,1178,1176
43,Tarragona,3,"Albiol, L'",469,238,231
43,Tarragona,4,Alcanar,10389,5364,5025
43,Tarragona,5,Alcover,5142,2585,2557
43,Tarragona,904,"Aldea, L'",4414,2339,2075
43,Tarragona,6,Aldover,973,494,479
43,Tarragona,7,"Aleixar, L'",884,443,441
43,Tarragona,8,Alfara de Carles,394,215,179
43,Tarragona,9,Alforja,1857,949,908
43,Tarragona,10,Alió,421,212,209
43,Tarragona,11,Almoster,1396,691,705
43,Tarragona,12,Altafulla,4928,2422,2506
43,Tarragona,13,"Ametlla de Mar, L'",7704,3924,3780
43,Tarragona,906,"Ampolla, L'",3636,1854,1782
43,Tarragona,14,Amposta,21511,10921,10590
43,Tarragona,16,"Arboç, L'",5517,2872,2645
43,Tarragona,15,Arbolí,110,62,48
43,Tarragona,17,"Argentera, L'",152,88,64
43,Tarragona,18,Arnes,479,247,232
43,Tarragona,19,Ascó,1650,859,791
43,Tarragona,20,Banyeres del Penedès,3044,1552,1492
43,Tarragona,21,Barberà de la Conca,523,282,241
43,Tarragona,22,Batea,1967,985,982
43,Tarragona,23,Bellmunt del Priorat,313,163,150
43,Tarragona,24,Bellvei,2129,1091,1038
43,Tarragona,25,Benifallet,725,365,360
43,Tarragona,26,Benissanet,1280,693,587
43,Tarragona,27,"Bisbal de Falset, La",219,121,98
43,Tarragona,28,"Bisbal del Penedès, La",3497,1830,1667
43,Tarragona,29,Blancafort,414,212,202
43,Tarragona,30,Bonastre,654,340,314
43,Tarragona,31,"Borges del Camp, Les",2114,1056,1058
43,Tarragona,32,Bot,668,348,320
43,Tarragona,33,Botarell,1113,595,518
43,Tarragona,34,Bràfim,669,342,327
43,Tarragona,35,Cabacés,333,170,163
43,Tarragona,36,Cabra del Camp,1170,615,555
43,Tarragona,37,Calafell,24563,12321,12242
43,Tarragona,903,Camarles,3628,1855,1773
43,Tarragona,38,Cambrils,33775,16758,17017
43,Tarragona,907,"Canonja, La",5741,2879,2862
43,Tarragona,39,Capafonts,113,58,55
43,Tarragona,40,Capçanes,415,207,208
43,Tarragona,41,Caseres,273,137,136
43,Tarragona,42,Castellvell del Camp,2840,1417,1423
43,Tarragona,43,"Catllar, El",4164,2145,2019
43,Tarragona,45,Colldejou,173,92,81
43,Tarragona,46,Conesa,124,63,61
43,Tarragona,47,Constantí,6748,3538,3210
43,Tarragona,48,Corbera d'Ebre,1130,608,522
43,Tarragona,49,Cornudella de Montsant,983,520,463
43,Tarragona,50,Creixell,3455,1767,1688
43,Tarragona,51,Cunit,12416,6248,6168
43,Tarragona,901,Deltebre,12158,6140,6018
43,Tarragona,53,Duesaigües,246,140,106
43,Tarragona,54,"Espluga de Francolí, L'",3897,1908,1989
43,Tarragona,55,Falset,2883,1460,1423
43,Tarragona,56,"Fatarella, La",1056,528,528
43,Tarragona,57,"Febró, La",48,35,13
43,Tarragona,58,"Figuera, La",108,59,49
43,Tarragona,59,Figuerola del Camp,352,175,177
43,Tarragona,60,Flix,3929,1961,1968
43,Tarragona,61,Forès,49,27,22
43,Tarragona,62,Freginals,468,253,215
43,Tarragona,63,"Galera, La",808,414,394
43,Tarragona,64,Gandesa,3117,1604,1513
43,Tarragona,65,Garcia,568,288,280
43,Tarragona,66,"Garidells, Els",187,95,92
43,Tarragona,67,Ginestar,902,465,437
43,Tarragona,68,Godall,713,368,345
43,Tarragona,69,Gratallops,250,134,116
43,Tarragona,70,"Guiamets, Els",297,140,157
43,Tarragona,71,Horta de Sant Joan,1259,667,592
43,Tarragona,72,"Lloar, El",113,61,52
43,Tarragona,73,Llorac,113,60,53
43,Tarragona,74,Llorenç del Penedès,2304,1126,1178
43,Tarragona,76,Marçà,616,320,296
43,Tarragona,75,Margalef,110,63,47
43,Tarragona,77,Mas de Barberans,637,311,326
43,Tarragona,78,Masdenverge,1140,596,544
43,Tarragona,79,Masllorenç,534,288,246
43,Tarragona,80,"Masó, La",291,154,137
43,Tarragona,81,Maspujols,772,404,368
43,Tarragona,82,"Masroig, El",564,300,264
43,Tarragona,83,"Milà, El",169,84,85
43,Tarragona,84,Miravet,778,416,362
43,Tarragona,85,"Molar, El",298,161,137
43,Tarragona,86,Montblanc,7409,3732,3677
43,Tarragona,88,Montbrió del Camp,2633,1337,1296
43,Tarragona,89,Montferri,372,203,169
43,Tarragona,90,"Montmell, El",1474,801,673
43,Tarragona,91,Mont-ral,170,96,74
43,Tarragona,92,Mont-roig del Camp,12906,6760,6146
43,Tarragona,93,Móra d'Ebre,5608,2764,2844
43,Tarragona,94,Móra la Nova,3277,1672,1605
43,Tarragona,95,"Morell, El",3485,1807,1678
43,Tarragona,96,"Morera de Montsant, La",158,95,63
43,Tarragona,97,"Nou de Gaià, La",559,280,279
43,Tarragona,98,Nulles,457,233,224
43,Tarragona,100,"Pallaresos, Els",4450,2252,2198
43,Tarragona,99,"Palma d'Ebre, La",379,176,203
43,Tarragona,101,Passanant i Belltall,149,80,69
43,Tarragona,102,Paüls,594,292,302
43,Tarragona,103,Perafort,1278,670,608
43,Tarragona,104,"Perelló, El",2862,1484,1378
43,Tarragona,105,"Piles, Les",211,111,100
43,Tarragona,106,"Pinell de Brai, El",1113,570,543
43,Tarragona,107,Pira,491,256,235
43,Tarragona,108,"Pla de Santa Maria, El",2341,1234,1107
43,Tarragona,109,"Pobla de Mafumet, La",3210,1656,1554
43,Tarragona,110,"Pobla de Massaluca, La",372,196,176
43,Tarragona,111,"Pobla de Montornès, La",2904,1515,1389
43,Tarragona,112,Poboleda,362,197,165
43,Tarragona,113,"Pont d'Armentera, El",588,308,280
43,Tarragona,141,Pontils,123,67,56
43,Tarragona,114,Porrera,469,260,209
43,Tarragona,115,Pradell de la Teixeta,191,83,108
43,Tarragona,116,Prades,660,338,322
43,Tarragona,117,Prat de Comte,170,92,78
43,Tarragona,118,Pratdip,700,374,326
43,Tarragona,119,Puigpelat,1081,559,522
43,Tarragona,120,Querol,543,301,242
43,Tarragona,121,Rasquera,827,417,410
43,Tarragona,122,Renau,137,69,68
43,Tarragona,123,Reus,106790,52211,54579
43,Tarragona,124,"Riba, La",621,327,294
43,Tarragona,125,Riba-roja d'Ebre,1301,696,605
43,Tarragona,126,"Riera de Gaià, La",1635,825,810
43,Tarragona,127,Riudecanyes,1170,607,563
43,Tarragona,128,Riudecols,1293,667,626
43,Tarragona,129,Riudoms,6472,3320,3152
43,Tarragona,130,Rocafort de Queralt,267,139,128
43,Tarragona,131,Roda de Barà,6394,3305,3089
43,Tarragona,132,Rodonyà,488,253,235
43,Tarragona,133,Roquetes,8297,4319,3978
43,Tarragona,134,"Rourell, El",400,206,194
43,Tarragona,135,Salomó,515,277,238
43,Tarragona,905,Salou,26752,14150,12602
43,Tarragona,136,Sant Carles de la Ràpita,15245,7586,7659
43,Tarragona,137,Sant Jaume dels Domenys,2556,1307,1249
43,Tarragona,902,Sant Jaume d'Enveja,3566,1815,1751
43,Tarragona,138,Santa Bàrbara,3873,1975,1898
43,Tarragona,139,Santa Coloma de Queralt,2966,1468,1498
43,Tarragona,140,Santa Oliva,3311,1680,1631
43,Tarragona,142,Sarral,1640,846,794
43,Tarragona,143,Savallà del Comtat,64,32,32
43,Tarragona,144,"Secuita, La",1635,838,797
43,Tarragona,145,"Selva del Camp, La",5614,2831,2783
43,Tarragona,146,Senan,56,36,20
43,Tarragona,44,"Sénia, La",5987,3045,2942
43,Tarragona,147,Solivella,653,331,322
43,Tarragona,148,Tarragona,133545,65414,68131
43,Tarragona,149,Tivenys,877,445,432
43,Tarragona,150,Tivissa,1814,907,907
43,Tarragona,151,"Torre de Fontaubella, La",127,68,59
43,Tarragona,152,"Torre de l'Espanyol, La",686,357,329
43,Tarragona,153,Torredembarra,15354,7565,7789
43,Tarragona,154,Torroja del Priorat,166,91,75
43,Tarragona,155,Tortosa,33992,17022,16970
43,Tarragona,156,Ulldecona,7240,3743,3497
43,Tarragona,157,Ulldemolins,435,248,187
43,Tarragona,158,Vallclara,115,65,50
43,Tarragona,159,Vallfogona de Riucorb,116,64,52
43,Tarragona,160,Vallmoll,1674,866,808
43,Tarragona,161,Valls,24649,12361,12288
43,Tarragona,162,Vandellòs i l'Hospitalet de l'Infant,5992,2972,3020
43,Tarragona,163,"Vendrell, El",36747,18389,18358
43,Tarragona,164,Vespella de Gaià,411,221,190
43,Tarragona,165,Vilabella,807,415,392
43,Tarragona,175,Vilalba dels Arcs,706,367,339
43,Tarragona,166,Vilallonga del Camp,2237,1147,1090
43,Tarragona,168,Vilanova de Prades,132,66,66
43,Tarragona,167,Vilanova d'Escornalbou,563,308,255
43,Tarragona,169,Vilaplana,631,319,312
43,Tarragona,170,Vila-rodona,1261,646,615
43,Tarragona,171,Vila-seca,21689,11065,10624
43,Tarragona,172,Vilaverd,506,262,244
43,Tarragona,173,"Vilella Alta, La",131,72,59
43,Tarragona,174,"Vilella Baixa, La",215,115,100
43,Tarragona,176,Vimbodí i Poblet,974,546,428
43,Tarragona,177,Vinebre,478,242,236
43,Tarragona,178,Vinyols i els Arcs,1969,1012,957
43,Tarragona,52,Xerta,1260,621,639
44,Teruel,1,Ababuj,65,41,24
44,Teruel,2,Abejuela,39,28,11
44,Teruel,3,Aguatón,19,8,11
44,Teruel,4,Aguaviva,654,333,321
44,Teruel,5,Aguilar del Alfambra,75,45,30
44,Teruel,6,Alacón,306,149,157
44,Teruel,7,Alba,215,113,102
44,Teruel,8,Albalate del Arzobispo,2049,1048,1001
44,Teruel,9,Albarracín,1093,565,528
44,Teruel,10,Albentosa,296,151,145
44,Teruel,11,Alcaine,69,40,29
44,Teruel,12,Alcalá de la Selva,457,241,216
44,Teruel,13,Alcañiz,16384,8200,8184
44,Teruel,14,Alcorisa,3501,1789,1712
44,Teruel,16,Alfambra,584,303,281
44,Teruel,17,Aliaga,361,201,160
44,Teruel,21,Allepuz,119,57,62
44,Teruel,22,Alloza,667,340,327
44,Teruel,23,Allueva,15,10,5
44,Teruel,18,Almohaja,21,16,5
44,Teruel,19,Alobras,79,44,35
44,Teruel,20,Alpeñés,19,11,8
44,Teruel,24,Anadón,23,13,10
44,Teruel,25,Andorra,8278,4250,4028
44,Teruel,26,Arcos de las Salinas,96,53,43
44,Teruel,27,Arens de Lledó,215,100,115
44,Teruel,28,Argente,225,108,117
44,Teruel,29,Ariño,769,386,383
44,Teruel,31,Azaila,124,63,61
44,Teruel,32,Bádenas,20,11,9
44,Teruel,33,Báguena,353,192,161
44,Teruel,34,Bañón,163,90,73
44,Teruel,35,Barrachina,148,78,70
44,Teruel,36,Bea,30,19,11
44,Teruel,37,Beceite,599,310,289
44,Teruel,39,Bello,250,120,130
44,Teruel,38,Belmonte de San José,117,57,60
44,Teruel,40,Berge,251,126,125
44,Teruel,41,Bezas,75,41,34
44,Teruel,42,Blancas,157,89,68
44,Teruel,43,Blesa,118,75,43
44,Teruel,44,Bordón,120,67,53
44,Teruel,45,Bronchales,461,271,190
44,Teruel,46,Bueña,62,31,31
44,Teruel,47,Burbáguena,294,146,148
44,Teruel,48,Cabra de Mora,66,40,26
44,Teruel,49,Calaceite,1106,570,536
44,Teruel,50,Calamocha,4515,2242,2273
44,Teruel,51,Calanda,3949,1958,1991
44,Teruel,52,Calomarde,84,49,35
44,Teruel,53,Camañas,127,71,56
44,Teruel,54,Camarena de la Sierra,138,80,58
44,Teruel,55,Camarillas,110,66,44
44,Teruel,56,Caminreal,724,367,357
44,Teruel,59,Cantavieja,724,375,349
44,Teruel,60,Cañada de Benatanduz,38,26,12
44,Teruel,61,"Cañada de Verich, La",94,54,40
44,Teruel,62,Cañada Vellida,38,27,11
44,Teruel,63,Cañizar del Olivar,98,53,45
44,Teruel,64,Cascante del Río,80,48,32
44,Teruel,65,Castejón de Tornos,66,40,26
44,Teruel,66,Castel de Cabra,131,68,63
44,Teruel,70,"Castellar, El",62,40,22
44,Teruel,71,Castellote,782,406,376
44,Teruel,67,Castelnou,152,81,71
44,Teruel,68,Castelserás,833,437,396
44,Teruel,74,Cedrillas,630,325,305
44,Teruel,75,Celadas,404,222,182
44,Teruel,76,Cella,2886,1516,1370
44,Teruel,77,"Cerollera, La",104,62,42
44,Teruel,80,"Codoñera, La",368,194,174
44,Teruel,82,Corbalán,109,56,53
44,Teruel,84,Cortes de Aragón,57,26,31
44,Teruel,85,Cosa,60,36,24
44,Teruel,86,Cretas,597,300,297
44,Teruel,87,Crivillén,76,39,37
44,Teruel,88,"Cuba, La",47,27,20
44,Teruel,89,Cubla,61,39,22
44,Teruel,90,Cucalón,110,65,45
44,Teruel,92,"Cuervo, El",98,52,46
44,Teruel,93,Cuevas de Almudén,141,82,59
44,Teruel,94,Cuevas Labradas,135,71,64
44,Teruel,96,Ejulve,204,103,101
44,Teruel,97,Escorihuela,162,79,83
44,Teruel,99,Escucha,1003,556,447
44,Teruel,100,Estercuel,261,153,108
44,Teruel,101,Ferreruela de Huerva,67,36,31
44,Teruel,102,Fonfría,30,17,13
44,Teruel,103,Formiche Alto,170,92,78
44,Teruel,105,Fórnoles,93,44,49
44,Teruel,106,Fortanete,208,125,83
44,Teruel,107,Foz-Calanda,269,147,122
44,Teruel,108,"Fresneda, La",495,279,216
44,Teruel,109,Frías de Albarracín,143,82,61
44,Teruel,110,Fuenferrada,61,36,25
44,Teruel,111,Fuentes Calientes,113,63,50
44,Teruel,112,Fuentes Claras,553,304,249
44,Teruel,113,Fuentes de Rubielos,128,69,59
44,Teruel,114,Fuentespalda,308,152,156
44,Teruel,115,Galve,168,88,80
44,Teruel,116,Gargallo,122,65,57
44,Teruel,117,Gea de Albarracín,410,211,199
44,Teruel,118,"Ginebrosa, La",216,119,97
44,Teruel,119,Griegos,139,84,55
44,Teruel,120,Guadalaviar,245,142,103
44,Teruel,121,Gúdar,84,46,38
44,Teruel,122,Híjar,1774,897,877
44,Teruel,123,Hinojosa de Jarque,146,84,62
44,Teruel,124,"Hoz de la Vieja, La",83,43,40
44,Teruel,125,Huesa del Común,82,52,30
44,Teruel,126,"Iglesuela del Cid, La",469,246,223
44,Teruel,127,Jabaloyas,78,45,33
44,Teruel,128,Jarque de la Val,87,47,40
44,Teruel,129,Jatiel,50,29,21
44,Teruel,130,Jorcas,38,22,16
44,Teruel,131,Josa,36,21,15
44,Teruel,132,Lagueruela,72,38,34
44,Teruel,133,Lanzuela,27,20,7
44,Teruel,135,Libros,137,80,57
44,Teruel,136,Lidón,54,28,26
44,Teruel,137,Linares de Mora,276,158,118
44,Teruel,141,Lledó,172,95,77
44,Teruel,138,Loscos,156,96,60
44,Teruel,142,Maicas,36,19,17
44,Teruel,143,Manzanera,539,284,255
44,Teruel,144,Martín del Río,437,224,213
44,Teruel,145,Mas de las Matas,1349,701,648
44,Teruel,146,"Mata de los Olmos, La",280,135,145
44,Teruel,147,Mazaleón,558,304,254
44,Teruel,148,Mezquita de Jarque,121,69,52
44,Teruel,149,Mirambel,113,59,54
44,Teruel,150,Miravete de la Sierra,29,20,9
44,Teruel,151,Molinos,276,150,126
44,Teruel,152,Monforte de Moyuela,66,45,21
44,Teruel,153,Monreal del Campo,2680,1336,1344
44,Teruel,154,Monroyo,367,222,145
44,Teruel,155,Montalbán,1341,686,655
44,Teruel,156,Monteagudo del Castillo,59,33,26
44,Teruel,157,Monterde de Albarracín,62,35,27
44,Teruel,158,Mora de Rubielos,1632,827,805
44,Teruel,159,Moscardón,62,31,31
44,Teruel,160,Mosqueruela,607,327,280
44,Teruel,161,Muniesa,640,331,309
44,Teruel,163,Noguera de Albarracín,146,78,68
44,Teruel,164,Nogueras,30,22,8
44,Teruel,165,Nogueruelas,210,117,93
44,Teruel,167,Obón,38,23,15
44,Teruel,168,Odón,228,117,111
44,Teruel,169,Ojos Negros,435,240,195
44,Teruel,171,Olba,250,143,107
44,Teruel,172,Oliete,430,226,204
44,Teruel,173,"Olmos, Los",131,72,59
44,Teruel,174,Orihuela del Tremedal,552,295,257
44,Teruel,175,Orrios,145,73,72
44,Teruel,176,Palomar de Arroyos,186,108,78
44,Teruel,177,Pancrudo,123,71,52
44,Teruel,178,"Parras de Castellote, Las",63,35,28
44,Teruel,179,Peñarroya de Tastavins,480,260,220
44,Teruel,180,Peracense,73,40,33
44,Teruel,181,Peralejos,90,43,47
44,Teruel,182,Perales del Alfambra,265,139,126
44,Teruel,183,Pitarque,89,42,47
44,Teruel,184,Plou,45,28,17
44,Teruel,185,"Pobo, El",145,91,54
44,Teruel,187,"Portellada, La",245,122,123
44,Teruel,189,Pozondón,66,36,30
44,Teruel,190,Pozuel del Campo,80,41,39
44,Teruel,191,"Puebla de Híjar, La",974,497,477
44,Teruel,192,"Puebla de Valverde, La",547,307,240
44,Teruel,193,Puertomingalvo,135,78,57
44,Teruel,194,Ráfales,138,69,69
44,Teruel,195,Rillo,109,60,49
44,Teruel,196,Riodeva,165,83,82
44,Teruel,197,Ródenas,78,48,30
44,Teruel,198,Royuela,230,126,104
44,Teruel,199,Rubiales,55,31,24
44,Teruel,200,Rubielos de la Cérida,43,23,20
44,Teruel,201,Rubielos de Mora,722,367,355
44,Teruel,203,Salcedillo,10,8,2
44,Teruel,204,Saldón,29,19,10
44,Teruel,205,Samper de Calanda,867,427,440
44,Teruel,206,San Agustín,151,96,55
44,Teruel,207,San Martín del Río,182,89,93
44,Teruel,208,Santa Cruz de Nogueras,38,20,18
44,Teruel,209,Santa Eulalia,1118,558,560
44,Teruel,210,Sarrión,1149,623,526
44,Teruel,211,Segura de los Baños,40,25,15
44,Teruel,212,Seno,43,22,21
44,Teruel,213,Singra,73,42,31
44,Teruel,215,Terriente,179,102,77
44,Teruel,216,Teruel,35961,17359,18602
44,Teruel,217,Toril y Masegoso,35,26,9
44,Teruel,218,Tormón,31,17,14
44,Teruel,219,Tornos,234,124,110
44,Teruel,220,Torralba de los Sisones,174,96,78
44,Teruel,223,Torre de Arcas,95,48,47
44,Teruel,224,Torre de las Arcas,31,15,16
44,Teruel,225,Torre del Compte,147,74,73
44,Teruel,227,Torre los Negros,91,50,41
44,Teruel,221,Torrecilla de Alcañiz,437,232,205
44,Teruel,222,Torrecilla del Rebollar,142,83,59
44,Teruel,226,Torrelacárcel,193,102,91
44,Teruel,228,Torremocha de Jiloca,125,71,54
44,Teruel,229,Torres de Albarracín,159,88,71
44,Teruel,230,Torrevelilla,211,108,103
44,Teruel,231,Torrijas,44,20,24
44,Teruel,232,Torrijo del Campo,496,263,233
44,Teruel,234,Tramacastiel,76,44,32
44,Teruel,235,Tramacastilla,114,52,62
44,Teruel,236,Tronchón,91,51,40
44,Teruel,237,Urrea de Gaén,491,240,251
44,Teruel,238,Utrillas,3268,1698,1570
44,Teruel,239,Valacloche,23,16,7
44,Teruel,240,Valbona,197,109,88
44,Teruel,241,Valdealgorfa,621,302,319
44,Teruel,243,Valdecuenca,44,30,14
44,Teruel,244,Valdelinares,100,61,39
44,Teruel,245,Valdeltormo,322,165,157
44,Teruel,246,Valderrobres,2310,1190,1120
44,Teruel,247,Valjunquera,383,197,186
44,Teruel,249,"Vallecillo, El",52,32,20
44,Teruel,250,Veguillas de la Sierra,22,15,7
44,Teruel,251,Villafranca del Campo,323,165,158
44,Teruel,252,Villahermosa del Campo,102,64,38
44,Teruel,256,Villanueva del Rebollar de la Sierra,46,27,19
44,Teruel,257,Villar del Cobo,192,107,85
44,Teruel,258,Villar del Salz,73,42,31
44,Teruel,260,Villarluengo,195,113,82
44,Teruel,261,Villarquemado,889,467,422
44,Teruel,262,Villarroya de los Pinares,164,85,79
44,Teruel,263,Villastar,498,252,246
44,Teruel,264,Villel,355,204,151
44,Teruel,265,Vinaceite,287,157,130
44,Teruel,266,Visiedo,141,65,76
44,Teruel,267,Vivel del Río Martín,81,44,37
44,Teruel,268,"Zoma, La",19,7,12
45,Toledo,1,Ajofrín,2359,1180,1179
45,Toledo,2,Alameda de la Sagra,3518,1825,1693
45,Toledo,3,Albarreal de Tajo,722,384,338
45,Toledo,4,Alcabón,732,386,346
45,Toledo,5,Alcañizo,309,162,147
45,Toledo,6,Alcaudete de la Jara,2005,1007,998
45,Toledo,7,Alcolea de Tajo,900,458,442
45,Toledo,8,Aldea en Cabo,192,103,89
45,Toledo,9,Aldeanueva de Barbarroya,631,312,319
45,Toledo,10,Aldeanueva de San Bartolomé,497,244,253
45,Toledo,11,Almendral de la Cañada,349,197,152
45,Toledo,12,Almonacid de Toledo,856,436,420
45,Toledo,13,Almorox,2376,1252,1124
45,Toledo,14,Añover de Tajo,5367,2743,2624
45,Toledo,15,Arcicóllar,827,413,414
45,Toledo,16,Argés,5894,2948,2946
45,Toledo,17,Azután,292,142,150
45,Toledo,18,Barcience,702,374,328
45,Toledo,19,Bargas,9898,4949,4949
45,Toledo,20,Belvís de la Jara,1759,877,882
45,Toledo,21,Borox,3552,1854,1698
45,Toledo,22,Buenaventura,482,258,224
45,Toledo,23,Burguillos de Toledo,2936,1484,1452
45,Toledo,24,Burujón,1422,757,665
45,Toledo,25,Cabañas de la Sagra,1901,1005,896
45,Toledo,26,Cabañas de Yepes,295,154,141
45,Toledo,27,Cabezamesada,454,255,199
45,Toledo,28,Calera y Chozas,4731,2415,2316
45,Toledo,29,Caleruela,252,136,116
45,Toledo,30,Calzada de Oropesa,561,297,264
45,Toledo,31,Camarena,3878,2047,1831
45,Toledo,32,Camarenilla,601,313,288
45,Toledo,33,"Campillo de la Jara, El",431,222,209
45,Toledo,34,Camuñas,1864,954,910
45,Toledo,35,Cardiel de los Montes,379,209,170
45,Toledo,36,Carmena,798,422,376
45,Toledo,37,"Carpio de Tajo, El",2117,1052,1065
45,Toledo,38,Carranque,4551,2345,2206
45,Toledo,39,Carriches,302,154,148
45,Toledo,40,"Casar de Escalona, El",2063,1117,946
45,Toledo,41,Casarrubios del Monte,5457,2905,2552
45,Toledo,42,Casasbuenas,203,97,106
45,Toledo,43,Castillo de Bayuela,964,494,470
45,Toledo,45,Cazalegas,1889,971,918
45,Toledo,46,Cebolla,3813,1952,1861
45,Toledo,47,Cedillo del Condado,3568,1870,1698
45,Toledo,48,"Cerralbos, Los",420,229,191
45,Toledo,49,Cervera de los Montes,464,232,232
45,Toledo,56,Chozas de Canales,4018,2140,1878
45,Toledo,57,Chueca,268,150,118
45,Toledo,50,Ciruelos,660,342,318
45,Toledo,51,Cobeja,2297,1197,1100
45,Toledo,52,Cobisa,4147,2111,2036
45,Toledo,53,Consuegra,10668,5400,5268
45,Toledo,54,Corral de Almaguer,6115,3150,2965
45,Toledo,55,Cuerva,1435,735,700
45,Toledo,58,Domingo Pérez,483,238,245
45,Toledo,59,Dosbarrios,2327,1180,1147
45,Toledo,60,Erustes,233,121,112
45,Toledo,61,Escalona,3368,1755,1613
45,Toledo,62,Escalonilla,1496,747,749
45,Toledo,63,Espinoso del Rey,573,308,265
45,Toledo,64,Esquivias,5451,2757,2694
45,Toledo,65,"Estrella, La",287,148,139
45,Toledo,66,Fuensalida,11221,5725,5496
45,Toledo,67,Gálvez,3267,1661,1606
45,Toledo,68,Garciotum,183,96,87
45,Toledo,69,Gerindote,2309,1192,1117
45,Toledo,70,Guadamur,1859,940,919
45,Toledo,71,"Guardia, La",2169,1089,1080
45,Toledo,72,"Herencias, Las",849,444,405
45,Toledo,73,Herreruela de Oropesa,410,207,203
45,Toledo,74,Hinojosa de San Vicente,423,235,188
45,Toledo,75,Hontanar,176,98,78
45,Toledo,76,Hormigos,798,436,362
45,Toledo,77,Huecas,660,348,312
45,Toledo,78,Huerta de Valdecarábanos,1883,935,948
45,Toledo,79,"Iglesuela, La",448,234,214
45,Toledo,80,Illán de Vacas,1,1,0
45,Toledo,81,Illescas,25382,12931,12451
45,Toledo,82,Lagartera,1522,767,755
45,Toledo,83,Layos,617,315,302
45,Toledo,84,Lillo,2972,1516,1456
45,Toledo,85,Lominchar,2364,1241,1123
45,Toledo,86,Lucillos,646,334,312
45,Toledo,87,Madridejos,11113,5584,5529
45,Toledo,88,Magán,3160,1661,1499
45,Toledo,89,Malpica de Tajo,1978,994,984
45,Toledo,90,Manzaneque,368,179,189
45,Toledo,91,Maqueda,508,254,254
45,Toledo,92,Marjaliza,301,153,148
45,Toledo,93,Marrupe,164,87,77
45,Toledo,94,Mascaraque,484,245,239
45,Toledo,95,"Mata, La",1010,515,495
45,Toledo,96,Mazarambroz,1295,667,628
45,Toledo,97,Mejorada,1305,673,632
45,Toledo,98,Menasalbas,3030,1598,1432
45,Toledo,99,Méntrida,4950,2559,2391
45,Toledo,100,Mesegar de Tajo,227,123,104
45,Toledo,101,Miguel Esteban,5320,2671,2649
45,Toledo,102,Mocejón,4958,2530,2428
45,Toledo,103,Mohedas de la Jara,483,266,217
45,Toledo,104,Montearagón,554,287,267
45,Toledo,105,Montesclaros,446,238,208
45,Toledo,106,Mora,10433,5321,5112
45,Toledo,107,Nambroca,4257,2199,2058
45,Toledo,108,"Nava de Ricomalillo, La",622,319,303
45,Toledo,109,Navahermosa,4102,2128,1974
45,Toledo,110,Navalcán,2307,1235,1072
45,Toledo,111,Navalmoralejo,72,38,34
45,Toledo,112,"Navalmorales, Los",2656,1378,1278
45,Toledo,113,"Navalucillos, Los",2476,1266,1210
45,Toledo,114,Navamorcuende,681,352,329
45,Toledo,115,Noblejas,3614,1852,1762
45,Toledo,116,Noez,953,503,450
45,Toledo,117,Nombela,1006,518,488
45,Toledo,118,Novés,2821,1454,1367
45,Toledo,119,Numancia de la Sagra,4985,2616,2369
45,Toledo,120,Nuño Gómez,157,87,70
45,Toledo,121,Ocaña,11016,5625,5391
45,Toledo,122,Olías del Rey,7175,3673,3502
45,Toledo,123,Ontígola,3937,2129,1808
45,Toledo,124,Orgaz,2758,1380,1378
45,Toledo,125,Oropesa,2852,1390,1462
45,Toledo,126,Otero,376,187,189
45,Toledo,127,Palomeque,905,498,407
45,Toledo,128,Pantoja,3524,1791,1733
45,Toledo,129,Paredes de Escalona,156,76,80
45,Toledo,130,Parrillas,404,202,202
45,Toledo,131,Pelahustán,359,196,163
45,Toledo,132,Pepino,2644,1369,1275
45,Toledo,133,Polán,3990,2010,1980
45,Toledo,134,Portillo de Toledo,2252,1134,1118
45,Toledo,135,"Puebla de Almoradiel, La",5755,2913,2842
45,Toledo,136,"Puebla de Montalbán, La",8307,4221,4086
45,Toledo,137,"Pueblanueva, La",2407,1216,1191
45,Toledo,138,"Puente del Arzobispo, El",1375,676,699
45,Toledo,139,Puerto de San Vicente,228,117,111
45,Toledo,140,Pulgar,1672,865,807
45,Toledo,141,Quero,1186,604,582
45,Toledo,142,Quintanar de la Orden,11704,5930,5774
45,Toledo,143,Quismondo,1683,859,824
45,Toledo,144,"Real de San Vicente, El",1080,578,502
45,Toledo,145,Recas,4154,2342,1812
45,Toledo,146,Retamoso de la Jara,119,60,59
45,Toledo,147,Rielves,791,388,403
45,Toledo,148,Robledo del Mazo,331,191,140
45,Toledo,149,"Romeral, El",690,345,345
45,Toledo,150,San Bartolomé de las Abiertas,548,293,255
45,Toledo,151,San Martín de Montalbán,823,408,415
45,Toledo,152,San Martín de Pusa,838,446,392
45,Toledo,153,San Pablo de los Montes,2053,1041,1012
45,Toledo,154,San Román de los Montes,1881,995,886
45,Toledo,155,Santa Ana de Pusa,474,261,213
45,Toledo,156,Santa Cruz de la Zarza,4841,2466,2375
45,Toledo,157,Santa Cruz del Retamar,3075,1600,1475
45,Toledo,158,Santa Olalla,3435,1739,1696
45,Toledo,901,Santo Domingo-Caudilla,1044,545,499
45,Toledo,159,Sartajada,104,59,45
45,Toledo,160,Segurilla,1302,669,633
45,Toledo,161,Seseña,20578,10715,9863
45,Toledo,162,Sevilleja de la Jara,803,433,370
45,Toledo,163,Sonseca,11626,5923,5703
45,Toledo,164,Sotillo de las Palomas,203,107,96
45,Toledo,165,Talavera de la Reina,88548,43103,45445
45,Toledo,166,Tembleque,2255,1155,1100
45,Toledo,167,"Toboso, El",2094,1062,1032
45,Toledo,168,Toledo,83593,40013,43580
45,Toledo,169,Torralba de Oropesa,251,133,118
45,Toledo,171,"Torre de Esteban Hambrán, La",1789,929,860
45,Toledo,170,Torrecilla de la Jara,263,133,130
45,Toledo,172,Torrico,824,430,394
45,Toledo,173,Torrijos,13359,6619,6740
45,Toledo,174,Totanés,414,220,194
45,Toledo,175,Turleque,862,434,428
45,Toledo,176,Ugena,5260,2729,2531
45,Toledo,177,Urda,3004,1500,1504
45,Toledo,179,Valdeverdeja,703,339,364
45,Toledo,180,Valmojado,4314,2212,2102
45,Toledo,181,Velada,2919,1520,1399
45,Toledo,182,"Ventas con Peña Aguilera, Las",1263,649,614
45,Toledo,183,"Ventas de Retamosa, Las",3405,1786,1619
45,Toledo,184,"Ventas de San Julián, Las",252,118,134
45,Toledo,186,"Villa de Don Fadrique, La",4006,1990,2016
45,Toledo,185,Villacañas,10162,5049,5113
45,Toledo,187,Villafranca de los Caballeros,5319,2644,2675
45,Toledo,188,Villaluenga de la Sagra,4042,2024,2018
45,Toledo,189,Villamiel de Toledo,915,484,431
45,Toledo,190,Villaminaya,566,291,275
45,Toledo,191,Villamuelas,704,368,336
45,Toledo,192,Villanueva de Alcardete,3706,1941,1765
45,Toledo,193,Villanueva de Bogas,805,412,393
45,Toledo,194,Villarejo de Montalbán,74,40,34
45,Toledo,195,Villarrubia de Santiago,2769,1383,1386
45,Toledo,196,Villaseca de la Sagra,1931,998,933
45,Toledo,197,Villasequilla,2621,1348,1273
45,Toledo,198,Villatobas,2666,1373,1293
45,Toledo,199,"Viso de San Juan, El",4088,2163,1925
45,Toledo,200,"Yébenes, Los",6317,3234,3083
45,Toledo,201,Yeles,5232,2787,2445
45,Toledo,202,Yepes,5110,2634,2476
45,Toledo,203,Yuncler,3578,1828,1750
45,Toledo,204,Yunclillos,879,471,408
45,Toledo,205,Yuncos,10773,5572,5201
46,Valencia/València,1,Ademuz,1203,640,563
46,Valencia/València,2,Ador,1416,735,681
46,Valencia/València,4,Agullent,2428,1193,1235
46,Valencia/València,42,Aielo de Malferit,4638,2308,2330
46,Valencia/València,43,Aielo de Rugat,174,91,83
46,Valencia/València,5,Alaquàs,30273,14955,15318
46,Valencia/València,6,Albaida,6078,3015,3063
46,Valencia/València,7,Albal,15893,7926,7967
46,Valencia/València,8,Albalat de la Ribera,3526,1763,1763
46,Valencia/València,9,Albalat dels Sorells,3923,1910,2013
46,Valencia/València,10,Albalat dels Tarongers,1144,605,539
46,Valencia/València,11,Alberic,10943,5523,5420
46,Valencia/València,12,Alborache,1238,640,598
46,Valencia/València,13,Alboraya,23269,11529,11740
46,Valencia/València,14,Albuixech,3908,1917,1991
46,Valencia/València,16,Alcàntera de Xúquer,1370,680,690
46,Valencia/València,15,Alcàsser,9520,4843,4677
46,Valencia/València,18,Alcublas,743,379,364
46,Valencia/València,20,"Alcúdia de Crespins, l'",5319,2658,2661
46,Valencia/València,19,"Alcúdia, l'",11563,5651,5912
46,Valencia/València,21,Aldaia,31028,15557,15471
46,Valencia/València,22,Alfafar,20973,10364,10609
46,Valencia/València,24,Alfara de la Baronia,568,299,269
46,Valencia/València,25,Alfara del Patriarca,3215,1585,1630
46,Valencia/València,26,Alfarp,1550,792,758
46,Valencia/València,27,Alfarrasí,1284,633,651
46,Valencia/València,23,Alfauir,431,222,209
46,Valencia/València,28,Algar de Palancia,528,268,260
46,Valencia/València,29,Algemesí,28000,13861,14139
46,Valencia/València,30,Algimia de Alfara,1066,532,534
46,Valencia/València,31,Alginet,13068,6650,6418
46,Valencia/València,32,Almàssera,7285,3550,3735
46,Valencia/València,33,Almiserà,309,158,151
46,Valencia/València,34,Almoines,2305,1180,1125
46,Valencia/València,35,Almussafes,8567,4315,4252
46,Valencia/València,36,Alpuente,724,396,328
46,Valencia/València,37,"Alqueria de la Comtessa, l'",1541,771,770
46,Valencia/València,17,Alzira,44788,21848,22940
46,Valencia/València,38,Andilla,380,238,142
46,Valencia/València,39,Anna,2640,1315,1325
46,Valencia/València,40,Antella,1382,685,697
46,Valencia/València,41,Aras de los Olmos,403,231,172
46,Valencia/València,3,Atzeneta d'Albaida,1192,616,576
46,Valencia/València,44,Ayora,5457,2754,2703
46,Valencia/València,46,Barx,1333,684,649
46,Valencia/València,45,Barxeta,1623,829,794
46,Valencia/València,47,Bèlgida,714,356,358
46,Valencia/València,48,Bellreguard,4765,2372,2393
46,Valencia/València,49,Bellús,343,168,175
46,Valencia/València,50,Benagéber,216,120,96
46,Valencia/València,51,Benaguasil,11354,5869,5485
46,Valencia/València,52,Benavites,636,305,331
46,Valencia/València,53,Beneixida,683,326,357
46,Valencia/València,54,Benetússer,14709,7230,7479
46,Valencia/València,55,Beniarjó,1846,909,937
46,Valencia/València,56,Beniatjar,233,117,116
46,Valencia/València,57,Benicolet,681,357,324
46,Valencia/València,904,Benicull de Xúquer,1014,522,492
46,Valencia/València,60,Benifaió,11830,5838,5992
46,Valencia/València,59,Benifairó de la Valldigna,1655,819,836
46,Valencia/València,58,Benifairó de les Valls,2245,1121,1124
46,Valencia/València,61,Beniflá,464,231,233
46,Valencia/València,62,Benigànim,6232,3158,3074
46,Valencia/València,63,Benimodo,2269,1171,1098
46,Valencia/València,64,Benimuslem,664,337,327
46,Valencia/València,65,Beniparrell,1937,991,946
46,Valencia/València,66,Benirredrà,1679,806,873
46,Valencia/València,67,Benisanó,2281,1138,1143
46,Valencia/València,68,Benissoda,428,231,197
46,Valencia/València,69,Benisuera,192,99,93
46,Valencia/València,70,Bétera,21566,10860,10706
46,Valencia/València,71,Bicorp,549,270,279
46,Valencia/València,72,Bocairent,4411,2210,2201
46,Valencia/València,73,Bolbaite,1397,692,705
46,Valencia/València,74,Bonrepòs i Mirambell,3497,1723,1774
46,Valencia/València,75,Bufali,177,91,86
46,Valencia/València,76,Bugarra,811,409,402
46,Valencia/València,77,Buñol,9941,5017,4924
46,Valencia/València,78,Burjassot,38148,18493,19655
46,Valencia/València,79,Calles,458,259,199
46,Valencia/València,80,Camporrobles,1372,685,687
46,Valencia/València,81,Canals,12104,6022,6082
46,Valencia/València,82,Canet d'En Berenguer,6009,3088,2921
46,Valencia/València,83,Carcaixent,20590,10188,10402
46,Valencia/València,84,Càrcer,2029,988,1041
46,Valencia/València,85,Carlet,15335,7645,7690
46,Valencia/València,86,Carrícola,105,53,52
46,Valencia/València,87,Casas Altas,159,83,76
46,Valencia/València,88,Casas Bajas,213,111,102
46,Valencia/València,89,Casinos,2842,1459,1383
46,Valencia/València,90,Castelló de Rugat,2328,1190,1138
46,Valencia/València,91,Castellonet de la Conquesta,152,86,66
46,Valencia/València,92,Castielfabib,262,129,133
46,Valencia/València,93,Catadau,2789,1401,1388
46,Valencia/València,94,Catarroja,27654,13731,13923
46,Valencia/València,95,Caudete de las Fuentes,692,367,325
46,Valencia/València,96,Cerdà,383,201,182
46,Valencia/València,107,Chella,2752,1363,1389
46,Valencia/València,106,Chelva,1507,777,730
46,Valencia/València,108,Chera,549,300,249
46,Valencia/València,109,Cheste,8514,4368,4146
46,Valencia/València,111,Chiva,15204,7863,7341
46,Valencia/València,112,Chulilla,699,378,321
46,Valencia/València,97,Cofrentes,1029,529,500
46,Valencia/València,98,Corbera,3267,1626,1641
46,Valencia/València,99,Cortes de Pallás,981,518,463
46,Valencia/València,100,Cotes,385,189,196
46,Valencia/València,105,Cullera,22292,11143,11149
46,Valencia/València,113,Daimús,2830,1428,1402
46,Valencia/València,114,Domeño,713,363,350
46,Valencia/València,115,Dos Aguas,437,248,189
46,Valencia/València,116,"Eliana, l'",17527,8663,8864
46,Valencia/València,117,Emperador,661,341,320
46,Valencia/València,118,Enguera,5872,3023,2849
46,Valencia/València,119,"Ènova, l'",954,486,468
46,Valencia/València,120,Estivella,1384,683,701
46,Valencia/València,121,Estubeny,129,66,63
46,Valencia/València,122,Faura,3513,1773,1740
46,Valencia/València,123,Favara,2456,1231,1225
46,Valencia/València,126,Foios,7078,3445,3633
46,Valencia/València,128,"Font de la Figuera, la",2150,1077,1073
46,Valencia/València,127,"Font d'En Carròs, la",4055,2038,2017
46,Valencia/València,124,Fontanars dels Alforins,1003,513,490
46,Valencia/València,125,Fortaleny,1026,503,523
46,Valencia/València,129,Fuenterrobles,712,382,330
46,Valencia/València,131,Gandia,78543,39339,39204
46,Valencia/València,902,Gátova,387,184,203
46,Valencia/València,130,Gavarda,1146,557,589
46,Valencia/València,132,Genovés,2847,1433,1414
46,Valencia/València,133,Gestalgar,681,350,331
46,Valencia/València,134,Gilet,3319,1707,1612
46,Valencia/València,135,Godella,13226,6394,6832
46,Valencia/València,136,Godelleta,3441,1781,1660
46,Valencia/València,137,"Granja de la Costera, la",382,200,182
46,Valencia/València,138,Guadasséquies,457,244,213
46,Valencia/València,139,Guadassuar,6013,2962,3051
46,Valencia/València,140,Guardamar de la Safor,483,258,225
46,Valencia/València,141,Higueruelas,512,270,242
46,Valencia/València,142,Jalance,947,477,470
46,Valencia/València,144,Jarafuel,819,423,396
46,Valencia/València,154,Llanera de Ranes,1098,572,526
46,Valencia/València,155,Llaurí,1318,658,660
46,Valencia/València,147,Llíria,23576,12015,11561
46,Valencia/València,152,Llocnou de la Corona,151,84,67
46,Valencia/València,153,Llocnou de Sant Jeroni,555,274,281
46,Valencia/València,151,Llocnou d'En Fenollet,928,485,443
46,Valencia/València,156,Llombai,2780,1405,1375
46,Valencia/València,157,"Llosa de Ranes, la",3721,1913,1808
46,Valencia/València,150,Llutxent,2491,1270,1221
46,Valencia/València,148,Loriguilla,1852,959,893
46,Valencia/València,149,Losa del Obispo,571,297,274
46,Valencia/València,158,Macastre,1208,627,581
46,Valencia/València,159,Manises,31057,15361,15696
46,Valencia/València,160,Manuel,2562,1248,1314
46,Valencia/València,161,Marines,1843,946,897
46,Valencia/València,162,Massalavés,1649,858,791
46,Valencia/València,163,Massalfassar,2411,1204,1207
46,Valencia/València,164,Massamagrell,15628,7742,7886
46,Valencia/València,165,Massanassa,8888,4405,4483
46,Valencia/València,166,Meliana,10661,5294,5367
46,Valencia/València,167,Millares,401,193,208
46,Valencia/València,168,Miramar,2597,1374,1223
46,Valencia/València,169,Mislata,43775,21363,22412
46,Valencia/València,170,Mogente/Moixent,4697,2386,2311
46,Valencia/València,171,Moncada,21930,10867,11063
46,Valencia/València,173,Montaverner,1800,900,900
46,Valencia/València,174,Montesa,1333,689,644
46,Valencia/València,175,Montitxelvo/Montichelvo,666,338,328
46,Valencia/València,176,Montroy,2923,1547,1376
46,Valencia/València,172,Montserrat,7301,3843,3458
46,Valencia/València,177,Museros,6292,3168,3124
46,Valencia/València,178,Náquera,6051,3157,2894
46,Valencia/València,179,Navarrés,3322,1700,1622
46,Valencia/València,180,Novelé/Novetlè,879,433,446
46,Valencia/València,181,Oliva,27787,13918,13869
46,Valencia/València,183,"Olleria, l'",8597,4353,4244
46,Valencia/València,182,Olocau,1630,867,763
46,Valencia/València,184,Ontinyent,36974,18416,18558
46,Valencia/València,185,Otos,466,235,231
46,Valencia/València,186,Paiporta,24787,12400,12387
46,Valencia/València,187,Palma de Gandía,1807,922,885
46,Valencia/València,188,Palmera,1003,522,481
46,Valencia/València,189,"Palomar, el",598,293,305
46,Valencia/València,190,Paterna,67159,33475,33684
46,Valencia/València,191,Pedralba,2957,1576,1381
46,Valencia/València,192,Petrés,1007,506,501
46,Valencia/València,193,Picanya,11223,5509,5714
46,Valencia/València,194,Picassent,20420,10321,10099
46,Valencia/València,195,Piles,2801,1421,1380
46,Valencia/València,196,Pinet,173,83,90
46,Valencia/València,199,"Pobla de Farnals, la",7483,3795,3688
46,Valencia/València,202,"Pobla de Vallbona, la",22499,11402,11097
46,Valencia/València,200,"Pobla del Duc, la",2500,1215,1285
46,Valencia/València,203,"Pobla Llarga, la",4563,2286,2277
46,Valencia/València,197,Polinyà de Xúquer,2569,1291,1278
46,Valencia/València,198,Potríes,1002,491,511
46,Valencia/València,205,Puçol,19320,9540,9780
46,Valencia/València,201,Puebla de San Miguel,75,43,32
46,Valencia/València,204,"Puig de Santa Maria, el",8943,4379,4564
46,Valencia/València,101,Quart de les Valls,1080,514,566
46,Valencia/València,102,Quart de Poblet,25174,12363,12811
46,Valencia/València,103,Quartell,1545,754,791
46,Valencia/València,104,Quatretonda,2420,1237,1183
46,Valencia/València,206,Quesa,718,363,355
46,Valencia/València,207,Rafelbunyol,8855,4373,4482
46,Valencia/València,208,Rafelcofer,1450,682,768
46,Valencia/València,209,Rafelguaraf,2476,1240,1236
46,Valencia/València,210,Ráfol de Salem,439,212,227
46,Valencia/València,212,Real,2330,1210,1120
46,Valencia/València,211,Real de Gandía,2277,1109,1168
46,Valencia/València,213,Requena,21066,10557,10509
46,Valencia/València,214,Riba-roja de Túria,21520,10950,10570
46,Valencia/València,215,Riola,1842,943,899
46,Valencia/València,216,Rocafort,6841,3351,3490
46,Valencia/València,217,Rotglà i Corberà,1135,565,570
46,Valencia/València,218,Rótova,1275,662,613
46,Valencia/València,219,Rugat,189,94,95
46,Valencia/València,220,Sagunto/Sagunt,65190,32102,33088
46,Valencia/València,221,Salem,441,217,224
46,Valencia/València,903,San Antonio de Benagéber,7332,3587,3745
46,Valencia/València,222,Sant Joanet,487,242,245
46,Valencia/València,223,Sedaví,10201,4968,5233
46,Valencia/València,224,Segart,180,91,89
46,Valencia/València,225,Sellent,371,188,183
46,Valencia/València,226,Sempere,43,22,21
46,Valencia/València,227,Senyera,1169,578,591
46,Valencia/València,228,Serra,3313,1719,1594
46,Valencia/València,229,Siete Aguas,1421,754,667
46,Valencia/València,230,Silla,18834,9390,9444
46,Valencia/València,231,Simat de la Valldigna,3672,1905,1767
46,Valencia/València,232,Sinarcas,1141,588,553
46,Valencia/València,233,Sollana,4978,2449,2529
46,Valencia/València,234,Sot de Chera,384,192,192
46,Valencia/València,235,Sueca,28961,14481,14480
46,Valencia/València,236,Sumacàrcer,1252,617,635
46,Valencia/València,237,Tavernes Blanques,9296,4520,4776
46,Valencia/València,238,Tavernes de la Valldigna,17916,9037,8879
46,Valencia/València,239,Teresa de Cofrentes,662,338,324
46,Valencia/València,240,Terrateig,310,160,150
46,Valencia/València,241,Titaguas,516,265,251
46,Valencia/València,242,Torrebaja,445,235,210
46,Valencia/València,243,Torrella,152,81,71
46,Valencia/València,244,Torrent,80759,40197,40562
46,Valencia/València,245,Torres Torres,631,342,289
46,Valencia/València,246,Tous,1314,672,642
46,Valencia/València,247,Tuéjar,1161,636,525
46,Valencia/València,248,Turís,6678,3502,3176
46,Valencia/València,249,Utiel,12311,6207,6104
46,Valencia/València,250,Valencia,792303,378707,413596
46,Valencia/València,251,Vallada,3169,1619,1550
46,Valencia/València,252,Vallanca,159,88,71
46,Valencia/València,253,Vallés,161,83,78
46,Valencia/València,254,Venta del Moro,1427,768,659
46,Valencia/València,256,Vilamarxant,9414,4869,4545
46,Valencia/València,255,Villalonga,4563,2279,2284
46,Valencia/València,257,Villanueva de Castellón,7458,3692,3766
46,Valencia/València,258,Villar del Arzobispo,3726,1883,1843
46,Valencia/València,259,Villargordo del Cabriel,654,344,310
46,Valencia/València,260,Vinalesa,3244,1598,1646
46,Valencia/València,145,Xàtiva,29400,14393,15007
46,Valencia/València,143,Xeraco,6251,3254,2997
46,Valencia/València,146,Xeresa,2268,1156,1112
46,Valencia/València,110,Xirivella,29796,14798,14998
46,Valencia/València,261,Yátova,2153,1133,1020
46,Valencia/València,262,"Yesa, La",254,139,115
46,Valencia/València,263,Zarra,529,290,239
47,Valladolid,1,Adalia,59,32,27
47,Valladolid,2,Aguasal,27,20,7
47,Valladolid,3,Aguilar de Campos,293,165,128
47,Valladolid,4,Alaejos,1467,772,695
47,Valladolid,5,Alcazarén,707,377,330
47,Valladolid,6,Aldea de San Miguel,235,124,111
47,Valladolid,7,Aldeamayor de San Martín,4730,2453,2277
47,Valladolid,8,Almenara de Adaja,27,14,13
47,Valladolid,9,Amusquillo,114,72,42
47,Valladolid,10,Arroyo de la Encomienda,16643,8515,8128
47,Valladolid,11,Ataquines,593,330,263
47,Valladolid,12,Bahabón,150,72,78
47,Valladolid,13,Barcial de la Loma,114,58,56
47,Valladolid,14,Barruelo del Valle,67,40,27
47,Valladolid,15,Becilla de Valderaduey,282,157,125
47,Valladolid,16,Benafarces,90,49,41
47,Valladolid,17,Bercero,220,118,102
47,Valladolid,18,Berceruelo,40,22,18
47,Valladolid,19,Berrueces,116,62,54
47,Valladolid,20,Bobadilla del Campo,313,171,142
47,Valladolid,21,Bocigas,91,48,43
47,Valladolid,22,Bocos de Duero,60,26,34
47,Valladolid,23,Boecillo,3921,2006,1915
47,Valladolid,24,Bolaños de Campos,359,190,169
47,Valladolid,25,Brahojos de Medina,131,71,60
47,Valladolid,26,Bustillo de Chaves,81,48,33
47,Valladolid,27,Cabezón de Pisuerga,3679,1893,1786
47,Valladolid,28,Cabezón de Valderaduey,37,19,18
47,Valladolid,29,Cabreros del Monte,68,37,31
47,Valladolid,30,Campaspero,1215,657,558
47,Valladolid,31,"Campillo, El",234,134,100
47,Valladolid,32,Camporredondo,170,95,75
47,Valladolid,33,Canalejas de Peñafiel,302,160,142
47,Valladolid,34,Canillas de Esgueva,90,51,39
47,Valladolid,35,Carpio,1084,578,506
47,Valladolid,36,Casasola de Arión,289,160,129
47,Valladolid,37,Castrejón de Trabancos,203,102,101
47,Valladolid,38,Castrillo de Duero,137,73,64
47,Valladolid,39,Castrillo-Tejeriego,193,109,84
47,Valladolid,40,Castrobol,66,32,34
47,Valladolid,41,Castrodeza,168,102,66
47,Valladolid,42,Castromembibre,67,38,29
47,Valladolid,43,Castromonte,332,187,145
47,Valladolid,44,Castronuevo de Esgueva,376,209,167
47,Valladolid,45,Castronuño,955,474,481
47,Valladolid,46,Castroponce,165,90,75
47,Valladolid,47,Castroverde de Cerrato,231,141,90
47,Valladolid,48,Ceinos de Campos,258,140,118
47,Valladolid,49,Cervillego de la Cruz,94,54,40
47,Valladolid,50,Cigales,5026,2568,2458
47,Valladolid,51,Ciguñuela,397,219,178
47,Valladolid,52,Cistérniga,8578,4405,4173
47,Valladolid,53,Cogeces de Íscar,155,85,70
47,Valladolid,54,Cogeces del Monte,768,415,353
47,Valladolid,55,Corcos,217,114,103
47,Valladolid,56,Corrales de Duero,84,51,33
47,Valladolid,57,Cubillas de Santa Marta,281,166,115
47,Valladolid,58,Cuenca de Campos,219,116,103
47,Valladolid,59,Curiel de Duero,125,83,42
47,Valladolid,60,Encinas de Esgueva,274,152,122
47,Valladolid,61,Esguevillas de Esgueva,281,151,130
47,Valladolid,62,Fombellida,189,107,82
47,Valladolid,63,Fompedraza,132,71,61
47,Valladolid,64,Fontihoyuelo,32,17,15
47,Valladolid,65,Fresno el Viejo,982,513,469
47,Valladolid,66,Fuensaldaña,1455,747,708
47,Valladolid,67,Fuente el Sol,194,102,92
47,Valladolid,68,Fuente-Olmedo,41,20,21
47,Valladolid,69,Gallegos de Hornija,146,73,73
47,Valladolid,70,Gatón de Campos,29,18,11
47,Valladolid,71,Geria,516,259,257
47,Valladolid,73,Herrín de Campos,144,70,74
47,Valladolid,74,Hornillos de Eresma,183,94,89
47,Valladolid,75,Íscar,6837,3484,3353
47,Valladolid,76,Laguna de Duero,22590,11335,11255
47,Valladolid,77,Langayo,292,182,110
47,Valladolid,79,Llano de Olmedo,71,41,30
47,Valladolid,78,Lomoviejo,192,101,91
47,Valladolid,80,Manzanillo,63,35,28
47,Valladolid,81,Marzales,56,26,30
47,Valladolid,82,Matapozuelos,1032,516,516
47,Valladolid,83,Matilla de los Caños,98,56,42
47,Valladolid,84,Mayorga,1918,946,972
47,Valladolid,86,Medina de Rioseco,4938,2417,2521
47,Valladolid,85,Medina del Campo,21556,10451,11105
47,Valladolid,87,Megeces,457,242,215
47,Valladolid,88,Melgar de Abajo,125,71,54
47,Valladolid,89,Melgar de Arriba,188,104,84
47,Valladolid,90,Mojados,3229,1680,1549
47,Valladolid,91,Monasterio de Vega,98,52,46
47,Valladolid,92,Montealegre de Campos,126,73,53
47,Valladolid,93,Montemayor de Pililla,954,508,446
47,Valladolid,94,Moral de la Reina,200,115,85
47,Valladolid,95,Moraleja de las Panaderas,42,28,14
47,Valladolid,96,Morales de Campos,161,85,76
47,Valladolid,97,Mota del Marqués,399,202,197
47,Valladolid,98,Mucientes,708,361,347
47,Valladolid,99,"Mudarra, La",170,88,82
47,Valladolid,100,Muriel,166,90,76
47,Valladolid,101,Nava del Rey,2104,1083,1021
47,Valladolid,102,Nueva Villa de las Torres,314,179,135
47,Valladolid,103,Olivares de Duero,341,186,155
47,Valladolid,104,Olmedo,3776,1864,1912
47,Valladolid,105,Olmos de Esgueva,223,117,106
47,Valladolid,106,Olmos de Peñafiel,67,35,32
47,Valladolid,109,Palazuelo de Vedija,199,107,92
47,Valladolid,110,"Parrilla, La",511,257,254
47,Valladolid,111,"Pedraja de Portillo, La",1109,572,537
47,Valladolid,112,Pedrajas de San Esteban,3605,1855,1750
47,Valladolid,113,Pedrosa del Rey,190,101,89
47,Valladolid,114,Peñafiel,5578,2809,2769
47,Valladolid,115,Peñaflor de Hornija,334,185,149
47,Valladolid,116,Pesquera de Duero,502,280,222
47,Valladolid,117,Piña de Esgueva,329,167,162
47,Valladolid,118,Piñel de Abajo,193,103,90
47,Valladolid,119,Piñel de Arriba,110,57,53
47,Valladolid,121,Pollos,646,338,308
47,Valladolid,122,Portillo,2457,1261,1196
47,Valladolid,123,Pozal de Gallinas,545,292,253
47,Valladolid,124,Pozaldez,556,295,261
47,Valladolid,125,Pozuelo de la Orden,63,38,25
47,Valladolid,126,Puras,52,29,23
47,Valladolid,127,Quintanilla de Arriba,164,90,74
47,Valladolid,129,Quintanilla de Onésimo,1123,589,534
47,Valladolid,130,Quintanilla de Trigueros,107,56,51
47,Valladolid,128,Quintanilla del Molar,68,32,36
47,Valladolid,131,Rábano,205,108,97
47,Valladolid,132,Ramiro,44,26,18
47,Valladolid,133,Renedo de Esgueva,3370,1741,1629
47,Valladolid,134,Roales de Campos,195,109,86
47,Valladolid,135,Robladillo,95,57,38
47,Valladolid,137,Roturas,33,18,15
47,Valladolid,138,Rubí de Bracamonte,257,145,112
47,Valladolid,139,Rueda,1343,691,652
47,Valladolid,140,Saelices de Mayorga,128,74,54
47,Valladolid,141,Salvador de Zapardiel,146,84,62
47,Valladolid,142,San Cebrián de Mazote,192,116,76
47,Valladolid,143,San Llorente,147,84,63
47,Valladolid,144,San Martín de Valvení,94,53,41
47,Valladolid,145,San Miguel del Arroyo,731,387,344
47,Valladolid,146,San Miguel del Pino,304,170,134
47,Valladolid,147,San Pablo de la Moraleja,131,66,65
47,Valladolid,148,San Pedro de Latarce,533,288,245
47,Valladolid,149,San Pelayo,44,19,25
47,Valladolid,150,San Román de Hornija,377,180,197
47,Valladolid,151,San Salvador,33,19,14
47,Valladolid,156,San Vicente del Palacio,196,108,88
47,Valladolid,152,Santa Eufemia del Arroyo,92,47,45
47,Valladolid,153,Santervás de Campos,138,76,62
47,Valladolid,154,Santibáñez de Valcorba,178,101,77
47,Valladolid,155,Santovenia de Pisuerga,4023,2064,1959
47,Valladolid,157,Sardón de Duero,659,341,318
47,Valladolid,158,"Seca, La",1109,565,544
47,Valladolid,159,Serrada,1205,635,570
47,Valladolid,160,Siete Iglesias de Trabancos,503,262,241
47,Valladolid,161,Simancas,5406,2740,2666
47,Valladolid,162,Tamariz de Campos,72,37,35
47,Valladolid,163,Tiedra,319,164,155
47,Valladolid,164,Tordehumos,443,221,222
47,Valladolid,165,Tordesillas,8961,4557,4404
47,Valladolid,169,Torre de Esgueva,78,36,42
47,Valladolid,170,Torre de Peñafiel,45,26,19
47,Valladolid,166,Torrecilla de la Abadesa,307,153,154
47,Valladolid,167,Torrecilla de la Orden,278,139,139
47,Valladolid,168,Torrecilla de la Torre,29,18,11
47,Valladolid,171,Torrelobatón,490,249,241
47,Valladolid,172,Torrescárcela,167,89,78
47,Valladolid,173,Traspinedo,1117,609,508
47,Valladolid,174,Trigueros del Valle,326,178,148
47,Valladolid,175,Tudela de Duero,8733,4480,4253
47,Valladolid,176,"Unión de Campos, La",254,136,118
47,Valladolid,177,Urones de Castroponce,113,64,49
47,Valladolid,178,Urueña,181,97,84
47,Valladolid,179,Valbuena de Duero,479,255,224
47,Valladolid,180,Valdearcos de la Vega,97,50,47
47,Valladolid,181,Valdenebro de los Valles,212,109,103
47,Valladolid,182,Valdestillas,1743,906,837
47,Valladolid,183,Valdunquillo,170,81,89
47,Valladolid,186,Valladolid,309714,146452,163262
47,Valladolid,184,Valoria la Buena,692,368,324
47,Valladolid,185,Valverde de Campos,108,66,42
47,Valladolid,187,Vega de Ruiponce,121,70,51
47,Valladolid,188,Vega de Valdetronco,127,70,57
47,Valladolid,189,Velascálvaro,177,101,76
47,Valladolid,190,Velilla,114,58,56
47,Valladolid,191,Velliza,109,66,43
47,Valladolid,192,Ventosa de la Cuesta,122,69,53
47,Valladolid,193,Viana de Cega,2019,1051,968
47,Valladolid,195,Villabáñez,562,309,253
47,Valladolid,196,Villabaruz de Campos,38,19,19
47,Valladolid,197,Villabrágima,1060,555,505
47,Valladolid,198,Villacarralón,81,48,33
47,Valladolid,199,Villacid de Campos,84,52,32
47,Valladolid,200,Villaco,93,58,35
47,Valladolid,203,Villafrades de Campos,85,41,44
47,Valladolid,204,Villafranca de Duero,300,156,144
47,Valladolid,205,Villafrechós,497,274,223
47,Valladolid,206,Villafuerte,111,63,48
47,Valladolid,207,Villagarcía de Campos,372,217,155
47,Valladolid,208,Villagómez la Nueva,69,38,31
47,Valladolid,209,Villalán de Campos,47,26,21
47,Valladolid,210,Villalar de los Comuneros,459,224,235
47,Valladolid,211,Villalba de la Loma,61,30,31
47,Valladolid,212,Villalba de los Alcores,404,222,182
47,Valladolid,213,Villalbarba,135,69,66
47,Valladolid,214,Villalón de Campos,1820,897,923
47,Valladolid,215,Villamuriel de Campos,62,31,31
47,Valladolid,216,Villán de Tordesillas,134,75,59
47,Valladolid,217,Villanubla,2444,1274,1170
47,Valladolid,218,Villanueva de Duero,1184,617,567
47,Valladolid,219,Villanueva de la Condesa,63,34,29
47,Valladolid,220,Villanueva de los Caballeros,206,104,102
47,Valladolid,221,Villanueva de los Infantes,119,68,51
47,Valladolid,222,Villanueva de San Mancio,105,54,51
47,Valladolid,223,Villardefrades,177,95,82
47,Valladolid,224,Villarmentero de Esgueva,107,54,53
47,Valladolid,225,Villasexmir,87,49,38
47,Valladolid,226,Villavaquerín,199,111,88
47,Valladolid,227,Villavellid,61,37,24
47,Valladolid,228,Villaverde de Medina,535,290,245
47,Valladolid,229,Villavicencio de los Caballeros,245,117,128
47,Valladolid,194,Viloria,363,192,171
47,Valladolid,230,Wamba,360,192,168
47,Valladolid,231,Zaratán,5880,3030,2850
47,Valladolid,232,"Zarza, La",124,69,55
49,Zamora,2,Abezames,75,38,37
49,Zamora,3,Alcañices,1154,584,570
49,Zamora,4,Alcubilla de Nogales,147,75,72
49,Zamora,5,Alfaraz de Sayago,162,90,72
49,Zamora,6,Algodre,169,92,77
49,Zamora,7,Almaraz de Duero,405,201,204
49,Zamora,8,Almeida de Sayago,548,282,266
49,Zamora,9,Andavías,464,239,225
49,Zamora,10,Arcenillas,413,213,200
49,Zamora,11,Arcos de la Polvorosa,255,135,120
49,Zamora,12,Argañín,77,38,39
49,Zamora,13,Argujillo,304,157,147
49,Zamora,14,Arquillinos,126,65,61
49,Zamora,15,Arrabalde,267,125,142
49,Zamora,16,Aspariegos,299,146,153
49,Zamora,17,Asturianos,271,145,126
49,Zamora,18,Ayoó de Vidriales,374,201,173
49,Zamora,19,Barcial del Barco,278,152,126
49,Zamora,20,Belver de los Montes,331,182,149
49,Zamora,21,Benavente,19137,9282,9855
49,Zamora,22,Benegiles,364,195,169
49,Zamora,23,Bermillo de Sayago,1155,603,552
49,Zamora,24,"Bóveda de Toro, La",820,418,402
49,Zamora,25,Bretó,190,108,82
49,Zamora,26,Bretocino,256,136,120
49,Zamora,27,Brime de Sog,168,81,87
49,Zamora,28,Brime de Urz,133,76,57
49,Zamora,29,Burganes de Valverde,732,387,345
49,Zamora,30,Bustillo del Oro,95,49,46
49,Zamora,31,Cabañas de Sayago,156,83,73
49,Zamora,32,Calzadilla de Tera,372,168,204
49,Zamora,33,Camarzana de Tera,905,446,459
49,Zamora,34,Cañizal,493,258,235
49,Zamora,35,Cañizo,258,131,127
49,Zamora,36,Carbajales de Alba,622,319,303
49,Zamora,37,Carbellino,215,116,99
49,Zamora,38,Casaseca de Campeán,119,67,52
49,Zamora,39,Casaseca de las Chanas,399,222,177
49,Zamora,40,Castrillo de la Guareña,133,70,63
49,Zamora,41,Castrogonzalo,502,268,234
49,Zamora,42,Castronuevo,263,128,135
49,Zamora,43,Castroverde de Campos,379,192,187
49,Zamora,44,Cazurra,90,48,42
49,Zamora,46,Cerecinos de Campos,310,169,141
49,Zamora,47,Cerecinos del Carrizal,135,78,57
49,Zamora,48,Cernadilla,153,74,79
49,Zamora,50,Cobreros,613,337,276
49,Zamora,52,Coomonte,210,107,103
49,Zamora,53,Coreses,1099,573,526
49,Zamora,54,Corrales del Vino,1102,540,562
49,Zamora,55,Cotanes del Monte,122,68,54
49,Zamora,56,Cubillos,340,167,173
49,Zamora,57,Cubo de Benavente,126,70,56
49,Zamora,58,"Cubo de Tierra del Vino, El",394,215,179
49,Zamora,59,Cuelgamures,94,56,38
49,Zamora,61,Entrala,166,87,79
49,Zamora,62,Espadañedo,135,67,68
49,Zamora,63,Faramontanos de Tábara,386,200,186
49,Zamora,64,Fariza,599,307,292
49,Zamora,65,Fermoselle,1356,706,650
49,Zamora,66,Ferreras de Abajo,594,302,292
49,Zamora,67,Ferreras de Arriba,434,233,201
49,Zamora,68,Ferreruela,535,296,239
49,Zamora,69,Figueruela de Arriba,423,209,214
49,Zamora,71,Fonfría,861,443,418
49,Zamora,75,Fresno de la Polvorosa,157,79,78
49,Zamora,76,Fresno de la Ribera,390,213,177
49,Zamora,77,Fresno de Sayago,219,114,105
49,Zamora,78,Friera de Valverde,199,100,99
49,Zamora,79,Fuente Encalada,118,68,50
49,Zamora,80,Fuentelapeña,805,426,379
49,Zamora,82,Fuentes de Ropel,455,226,229
49,Zamora,81,Fuentesaúco,1808,908,900
49,Zamora,83,Fuentesecas,69,34,35
49,Zamora,84,Fuentespreadas,323,176,147
49,Zamora,85,Galende,1230,638,592
49,Zamora,86,Gallegos del Pan,137,81,56
49,Zamora,87,Gallegos del Río,594,318,276
49,Zamora,88,Gamones,93,49,44
49,Zamora,90,Gema,232,122,110
49,Zamora,91,Granja de Moreruela,292,159,133
49,Zamora,92,Granucillo,162,84,78
49,Zamora,93,Guarrate,367,194,173
49,Zamora,94,Hermisende,283,152,131
49,Zamora,95,"Hiniesta, La",328,166,162
49,Zamora,96,Jambrina,184,96,88
49,Zamora,97,Justel,89,51,38
49,Zamora,98,Losacino,248,135,113
49,Zamora,99,Losacio,114,66,48
49,Zamora,100,Lubián,351,185,166
49,Zamora,101,Luelmo,191,97,94
49,Zamora,102,"Maderal, El",226,117,109
49,Zamora,103,Madridanos,501,256,245
49,Zamora,104,Mahide,379,205,174
49,Zamora,105,Maire de Castroponce,151,80,71
49,Zamora,107,Malva,166,81,85
49,Zamora,108,Manganeses de la Lampreana,513,251,262
49,Zamora,109,Manganeses de la Polvorosa,731,351,380
49,Zamora,110,Manzanal de Arriba,382,204,178
49,Zamora,112,Manzanal de los Infantes,137,78,59
49,Zamora,111,Manzanal del Barco,154,79,75
49,Zamora,113,Matilla de Arzón,191,110,81
49,Zamora,114,Matilla la Seca,55,28,27
49,Zamora,115,Mayalde,223,115,108
49,Zamora,116,Melgar de Tera,432,215,217
49,Zamora,117,Micereces de Tera,507,256,251
49,Zamora,118,Milles de la Polvorosa,237,128,109
49,Zamora,119,Molacillos,275,146,129
49,Zamora,120,Molezuelas de la Carballeda,84,46,38
49,Zamora,121,Mombuey,446,240,206
49,Zamora,122,Monfarracinos,920,478,442
49,Zamora,123,Montamarta,614,320,294
49,Zamora,124,Moral de Sayago,294,166,128
49,Zamora,126,Moraleja de Sayago,244,128,116
49,Zamora,125,Moraleja del Vino,1662,858,804
49,Zamora,128,Morales de Rey,637,319,318
49,Zamora,129,Morales de Toro,1018,522,496
49,Zamora,130,Morales de Valverde,213,109,104
49,Zamora,127,Morales del Vino,2888,1506,1382
49,Zamora,131,Moralina,330,167,163
49,Zamora,132,Moreruela de los Infanzones,374,189,185
49,Zamora,133,Moreruela de Tábara,357,179,178
49,Zamora,134,Muelas de los Caballeros,199,108,91
49,Zamora,135,Muelas del Pan,734,370,364
49,Zamora,136,Muga de Sayago,373,183,190
49,Zamora,137,Navianos de Valverde,205,111,94
49,Zamora,138,Olmillos de Castro,264,138,126
49,Zamora,139,Otero de Bodas,196,104,92
49,Zamora,141,Pajares de la Lampreana,406,204,202
49,Zamora,143,Palacios de Sanabria,268,134,134
49,Zamora,142,Palacios del Pan,269,138,131
49,Zamora,145,Pedralba de la Pradería,298,161,137
49,Zamora,146,"Pego, El",334,170,164
49,Zamora,147,Peleagonzalo,279,140,139
49,Zamora,148,Peleas de Abajo,209,108,101
49,Zamora,149,Peñausende,448,223,225
49,Zamora,150,Peque,178,81,97
49,Zamora,151,"Perdigón, El",774,405,369
49,Zamora,152,Pereruela,638,344,294
49,Zamora,153,Perilla de Castro,191,92,99
49,Zamora,154,Pías,150,81,69
49,Zamora,155,Piedrahita de Castro,115,62,53
49,Zamora,156,Pinilla de Toro,266,142,124
49,Zamora,157,Pino del Oro,194,103,91
49,Zamora,158,"Piñero, El",245,130,115
49,Zamora,160,Pobladura de Valderaduey,46,24,22
49,Zamora,159,Pobladura del Valle,316,164,152
49,Zamora,162,Porto,200,108,92
49,Zamora,163,Pozoantiguo,268,138,130
49,Zamora,164,Pozuelo de Tábara,157,75,82
49,Zamora,165,Prado,70,39,31
49,Zamora,166,Puebla de Sanabria,1541,739,802
49,Zamora,167,Pueblica de Valverde,236,125,111
49,Zamora,170,Quintanilla de Urz,118,60,58
49,Zamora,168,Quintanilla del Monte,105,49,56
49,Zamora,169,Quintanilla del Olmo,36,18,18
49,Zamora,171,Quiruelas de Vidriales,759,377,382
49,Zamora,172,Rabanales,629,329,300
49,Zamora,173,Rábano de Aliste,422,208,214
49,Zamora,174,Requejo,156,75,81
49,Zamora,175,Revellinos,275,150,125
49,Zamora,176,Riofrío de Aliste,765,414,351
49,Zamora,177,Rionegro del Puente,310,162,148
49,Zamora,178,Roales,843,446,397
49,Zamora,179,Robleda-Cervantes,434,224,210
49,Zamora,180,Roelos de Sayago,184,86,98
49,Zamora,181,Rosinos de la Requejada,407,214,193
49,Zamora,183,Salce,108,48,60
49,Zamora,184,Samir de los Caños,198,101,97
49,Zamora,185,San Agustín del Pozo,200,105,95
49,Zamora,186,San Cebrián de Castro,279,136,143
49,Zamora,187,San Cristóbal de Entreviñas,1522,791,731
49,Zamora,188,San Esteban del Molar,143,82,61
49,Zamora,189,San Justo,258,135,123
49,Zamora,190,San Martín de Valderaduey,75,40,35
49,Zamora,191,San Miguel de la Ribera,324,165,159
49,Zamora,192,San Miguel del Valle,173,84,89
49,Zamora,193,San Pedro de Ceque,526,276,250
49,Zamora,194,San Pedro de la Nave-Almendra,357,177,180
49,Zamora,208,San Vicente de la Cabeza,452,242,210
49,Zamora,209,San Vitero,600,330,270
49,Zamora,197,Santa Clara de Avedillo,185,96,89
49,Zamora,199,Santa Colomba de las Monjas,291,143,148
49,Zamora,200,Santa Cristina de la Polvorosa,1128,563,565
49,Zamora,201,Santa Croya de Tera,344,178,166
49,Zamora,202,Santa Eufemia del Barco,208,121,87
49,Zamora,203,Santa María de la Vega,355,185,170
49,Zamora,204,Santa María de Valverde,75,34,41
49,Zamora,205,Santibáñez de Tera,437,226,211
49,Zamora,206,Santibáñez de Vidriales,1093,549,544
49,Zamora,207,Santovenia,298,147,151
49,Zamora,210,Sanzoles,551,282,269
49,Zamora,214,Tábara,840,431,409
49,Zamora,216,Tapioles,177,101,76
49,Zamora,219,Toro,9421,4591,4830
49,Zamora,220,"Torre del Valle, La",160,86,74
49,Zamora,221,Torregamones,302,159,143
49,Zamora,222,Torres del Carrizal,461,236,225
49,Zamora,223,Trabazos,1008,528,480
49,Zamora,224,Trefacio,196,104,92
49,Zamora,225,Uña de Quintana,167,87,80
49,Zamora,226,Vadillo de la Guareña,298,160,138
49,Zamora,227,Valcabado,344,169,175
49,Zamora,228,Valdefinjas,55,33,22
49,Zamora,229,Valdescorriel,150,74,76
49,Zamora,230,Vallesa de la Guareña,110,59,51
49,Zamora,231,Vega de Tera,391,197,194
49,Zamora,232,Vega de Villalobos,117,55,62
49,Zamora,233,Vegalatrave,109,63,46
49,Zamora,234,Venialbo,462,249,213
49,Zamora,235,Vezdemarbán,466,239,227
49,Zamora,236,Vidayanes,98,49,49
49,Zamora,237,Videmala,163,85,78
49,Zamora,238,Villabrázaro,271,146,125
49,Zamora,239,Villabuena del Puente,823,424,399
49,Zamora,240,Villadepera,249,133,116
49,Zamora,241,Villaescusa,286,154,132
49,Zamora,242,Villafáfila,542,278,264
49,Zamora,243,Villaferrueña,116,59,57
49,Zamora,244,Villageriz,47,27,20
49,Zamora,245,Villalazán,308,148,160
49,Zamora,246,Villalba de la Lampreana,269,145,124
49,Zamora,247,Villalcampo,494,241,253
49,Zamora,248,Villalobos,283,140,143
49,Zamora,249,Villalonso,91,47,44
49,Zamora,250,Villalpando,1591,791,800
49,Zamora,251,Villalube,190,99,91
49,Zamora,252,Villamayor de Campos,383,193,190
49,Zamora,255,Villamor de los Escuderos,430,229,201
49,Zamora,256,Villanázar,319,164,155
49,Zamora,257,Villanueva de Azoague,326,164,162
49,Zamora,258,Villanueva de Campeán,132,72,60
49,Zamora,259,Villanueva de las Peras,99,54,45
49,Zamora,260,Villanueva del Campo,938,457,481
49,Zamora,263,Villar de Fallaves,57,30,27
49,Zamora,264,Villar del Buey,673,350,323
49,Zamora,261,Villaralbo,1914,969,945
49,Zamora,262,Villardeciervos,459,222,237
49,Zamora,265,Villardiegua de la Ribera,141,68,73
49,Zamora,266,Villárdiga,96,52,44
49,Zamora,267,Villardondiego,105,62,43
49,Zamora,268,Villarrín de Campos,479,256,223
49,Zamora,269,Villaseco del Pan,247,114,133
49,Zamora,270,Villavendimio,171,104,67
49,Zamora,272,Villaveza de Valverde,96,47,49
49,Zamora,271,Villaveza del Agua,217,112,105
49,Zamora,273,Viñas,216,109,107
49,Zamora,275,Zamora,64986,30550,34436
50,Zaragoza,1,Abanto,133,72,61
50,Zaragoza,2,Acered,245,150,95
50,Zaragoza,3,Agón,155,81,74
50,Zaragoza,4,Aguarón,743,382,361
50,Zaragoza,5,Aguilón,252,133,119
50,Zaragoza,6,Ainzón,1187,606,581
50,Zaragoza,7,Aladrén,54,37,17
50,Zaragoza,8,Alagón,7175,3623,3552
50,Zaragoza,9,Alarba,152,89,63
50,Zaragoza,10,Alberite de San Juan,91,54,37
50,Zaragoza,11,Albeta,144,70,74
50,Zaragoza,12,Alborge,119,60,59
50,Zaragoza,13,Alcalá de Ebro,270,127,143
50,Zaragoza,14,Alcalá de Moncayo,184,111,73
50,Zaragoza,15,Alconchel de Ariza,85,49,36
50,Zaragoza,16,Aldehuela de Liestos,48,32,16
50,Zaragoza,17,Alfajarín,2235,1154,1081
50,Zaragoza,18,Alfamén,1517,823,694
50,Zaragoza,19,Alforque,78,43,35
50,Zaragoza,20,Alhama de Aragón,1106,584,522
50,Zaragoza,21,Almochuel,38,18,20
50,Zaragoza,22,"Almolda, La",608,312,296
50,Zaragoza,23,Almonacid de la Cuba,244,128,116
50,Zaragoza,24,Almonacid de la Sierra,744,423,321
50,Zaragoza,25,"Almunia de Doña Godina, La",7766,4001,3765
50,Zaragoza,26,Alpartir,567,291,276
50,Zaragoza,27,Ambel,270,133,137
50,Zaragoza,28,Anento,108,68,40
50,Zaragoza,29,Aniñón,789,432,357
50,Zaragoza,30,Añón de Moncayo,212,125,87
50,Zaragoza,31,Aranda de Moncayo,185,115,70
50,Zaragoza,32,Arándiga,367,188,179
50,Zaragoza,33,Ardisa,81,52,29
50,Zaragoza,34,Ariza,1207,613,594
50,Zaragoza,35,Artieda,90,51,39
50,Zaragoza,36,Asín,103,50,53
50,Zaragoza,37,Atea,167,100,67
50,Zaragoza,38,Ateca,2061,1067,994
50,Zaragoza,39,Azuara,643,357,286
50,Zaragoza,40,Badules,102,54,48
50,Zaragoza,41,Bagüés,20,12,8
50,Zaragoza,42,Balconchán,14,6,8
50,Zaragoza,43,Bárboles,316,175,141
50,Zaragoza,44,Bardallur,311,153,158
50,Zaragoza,45,Belchite,1633,840,793
50,Zaragoza,46,Belmonte de Gracián,233,129,104
50,Zaragoza,47,Berdejo,61,37,24
50,Zaragoza,48,Berrueco,41,21,20
50,Zaragoza,901,Biel,167,99,68
50,Zaragoza,50,Bijuesca,108,67,41
50,Zaragoza,51,Biota,1036,529,507
50,Zaragoza,52,Bisimbre,100,53,47
50,Zaragoza,53,Boquiñeni,923,472,451
50,Zaragoza,54,Bordalba,68,41,27
50,Zaragoza,55,Borja,4915,2478,2437
50,Zaragoza,56,Botorrita,516,283,233
50,Zaragoza,57,Brea de Aragón,1754,881,873
50,Zaragoza,58,Bubierca,78,40,38
50,Zaragoza,59,Bujaraloz,1044,545,499
50,Zaragoza,60,Bulbuente,241,125,116
50,Zaragoza,61,Bureta,268,139,129
50,Zaragoza,62,"Burgo de Ebro, El",2366,1210,1156
50,Zaragoza,63,"Buste, El",76,41,35
50,Zaragoza,64,Cabañas de Ebro,540,287,253
50,Zaragoza,65,Cabolafuente,41,22,19
50,Zaragoza,66,Cadrete,3363,1746,1617
50,Zaragoza,67,Calatayud,20926,10402,10524
50,Zaragoza,68,Calatorao,2998,1576,1422
50,Zaragoza,69,Calcena,81,49,32
50,Zaragoza,70,Calmarza,80,42,38
50,Zaragoza,71,Campillo de Aragón,148,82,66
50,Zaragoza,72,Carenas,165,87,78
50,Zaragoza,73,Cariñena,3537,1827,1710
50,Zaragoza,74,Caspe,9858,5146,4712
50,Zaragoza,75,Castejón de Alarba,87,50,37
50,Zaragoza,76,Castejón de las Armas,106,57,49
50,Zaragoza,77,Castejón de Valdejasa,248,127,121
50,Zaragoza,78,Castiliscar,300,152,148
50,Zaragoza,79,Cervera de la Cañada,318,174,144
50,Zaragoza,80,Cerveruela,42,27,15
50,Zaragoza,81,Cetina,672,344,328
50,Zaragoza,92,Chiprana,487,257,230
50,Zaragoza,93,Chodes,135,73,62
50,Zaragoza,82,Cimballa,115,57,58
50,Zaragoza,83,Cinco Olivas,109,55,54
50,Zaragoza,84,Clarés de Ribota,84,49,35
50,Zaragoza,85,Codo,202,101,101
50,Zaragoza,86,Codos,227,141,86
50,Zaragoza,87,Contamina,37,21,16
50,Zaragoza,88,Cosuenda,390,199,191
50,Zaragoza,89,Cuarte de Huerva,11043,5716,5327
50,Zaragoza,90,Cubel,188,94,94
50,Zaragoza,91,"Cuerlas, Las",52,27,25
50,Zaragoza,94,Daroca,2255,1117,1138
50,Zaragoza,95,Ejea de los Caballeros,17139,8794,8345
50,Zaragoza,96,Embid de Ariza,51,26,25
50,Zaragoza,98,Encinacorba,238,120,118
50,Zaragoza,99,Épila,4734,2511,2223
50,Zaragoza,100,Erla,393,198,195
50,Zaragoza,101,Escatrón,1104,545,559
50,Zaragoza,102,Fabara,1276,694,582
50,Zaragoza,104,Farlete,411,204,207
50,Zaragoza,105,Fayón,372,193,179
50,Zaragoza,106,"Fayos, Los",151,76,75
50,Zaragoza,107,Figueruelas,1319,689,630
50,Zaragoza,108,Fombuena,52,29,23
50,Zaragoza,109,"Frago, El",105,63,42
50,Zaragoza,110,"Frasno, El",441,233,208
50,Zaragoza,111,Fréscano,204,113,91
50,Zaragoza,113,Fuendejalón,948,516,432
50,Zaragoza,114,Fuendetodos,169,90,79
50,Zaragoza,115,Fuentes de Ebro,4656,2420,2236
50,Zaragoza,116,Fuentes de Jiloca,261,144,117
50,Zaragoza,117,Gallocanta,154,85,69
50,Zaragoza,118,Gallur,2846,1429,1417
50,Zaragoza,119,Gelsa,1135,593,542
50,Zaragoza,120,Godojos,39,21,18
50,Zaragoza,121,Gotor,352,185,167
50,Zaragoza,122,Grisel,70,42,28
50,Zaragoza,123,Grisén,626,321,305
50,Zaragoza,124,Herrera de los Navarros,569,299,270
50,Zaragoza,125,Ibdes,460,244,216
50,Zaragoza,126,Illueca,3216,1587,1629
50,Zaragoza,128,Isuerre,33,22,11
50,Zaragoza,129,Jaraba,340,180,160
50,Zaragoza,130,Jarque,529,290,239
50,Zaragoza,131,Jaulín,265,141,124
50,Zaragoza,132,"Joyosa, La",983,502,481
50,Zaragoza,133,Lagata,142,77,65
50,Zaragoza,134,Langa del Castillo,134,66,68
50,Zaragoza,135,Layana,108,62,46
50,Zaragoza,136,Lécera,754,403,351
50,Zaragoza,138,Lechón,51,31,20
50,Zaragoza,137,Leciñena,1263,638,625
50,Zaragoza,139,Letux,372,210,162
50,Zaragoza,140,Litago,173,96,77
50,Zaragoza,141,Lituénigo,124,64,60
50,Zaragoza,142,Lobera de Onsella,40,25,15
50,Zaragoza,143,Longares,903,521,382
50,Zaragoza,144,Longás,35,25,10
50,Zaragoza,146,Lucena de Jalón,264,143,121
50,Zaragoza,147,Luceni,1032,518,514
50,Zaragoza,148,Luesia,325,181,144
50,Zaragoza,149,Luesma,47,28,19
50,Zaragoza,150,Lumpiaque,915,472,443
50,Zaragoza,151,Luna,794,417,377
50,Zaragoza,152,Maella,1977,1036,941
50,Zaragoza,153,Magallón,1191,620,571
50,Zaragoza,154,Mainar,158,85,73
50,Zaragoza,155,Malanquilla,117,71,46
50,Zaragoza,156,Maleján,305,155,150
50,Zaragoza,160,Mallén,3611,1918,1693
50,Zaragoza,157,Malón,378,199,179
50,Zaragoza,159,Maluenda,1116,554,562
50,Zaragoza,161,Manchones,122,72,50
50,Zaragoza,162,Mara,186,95,91
50,Zaragoza,163,María de Huerva,5315,2745,2570
50,Zaragoza,902,Marracos,101,56,45
50,Zaragoza,164,Mediana de Aragón,469,233,236
50,Zaragoza,165,Mequinenza,2436,1259,1177
50,Zaragoza,166,Mesones de Isuela,300,148,152
50,Zaragoza,167,Mezalocha,244,139,105
50,Zaragoza,168,Mianos,33,19,14
50,Zaragoza,169,Miedes de Aragón,470,258,212
50,Zaragoza,170,Monegrillo,458,252,206
50,Zaragoza,171,Moneva,116,66,50
50,Zaragoza,172,Monreal de Ariza,231,128,103
50,Zaragoza,173,Monterde,161,92,69
50,Zaragoza,174,Montón,115,66,49
50,Zaragoza,175,Morata de Jalón,1259,624,635
50,Zaragoza,176,Morata de Jiloca,232,132,100
50,Zaragoza,177,Morés,393,212,181
50,Zaragoza,178,Moros,434,231,203
50,Zaragoza,179,Moyuela,280,155,125
50,Zaragoza,180,Mozota,117,57,60
50,Zaragoza,181,Muel,1377,701,676
50,Zaragoza,182,"Muela, La",5015,2586,2429
50,Zaragoza,183,Munébrega,462,251,211
50,Zaragoza,184,Murero,135,75,60
50,Zaragoza,185,Murillo de Gállego,189,108,81
50,Zaragoza,186,Navardún,45,28,17
50,Zaragoza,187,Nigüella,75,44,31
50,Zaragoza,188,Nombrevilla,34,20,14
50,Zaragoza,189,Nonaspe,1038,560,478
50,Zaragoza,190,Novallas,947,504,443
50,Zaragoza,191,Novillas,594,296,298
50,Zaragoza,192,Nuévalos,348,195,153
50,Zaragoza,193,Nuez de Ebro,863,437,426
50,Zaragoza,194,Olvés,109,63,46
50,Zaragoza,195,Orcajo,45,25,20
50,Zaragoza,196,Orera,133,68,65
50,Zaragoza,197,Orés,104,59,45
50,Zaragoza,198,Oseja,44,26,18
50,Zaragoza,199,Osera de Ebro,447,229,218
50,Zaragoza,200,Paniza,754,406,348
50,Zaragoza,201,Paracuellos de Jiloca,567,298,269
50,Zaragoza,202,Paracuellos de la Ribera,172,85,87
50,Zaragoza,203,Pastriz,1317,634,683
50,Zaragoza,204,Pedrola,3680,1921,1759
50,Zaragoza,205,"Pedrosas, Las",111,52,59
50,Zaragoza,206,Perdiguera,616,322,294
50,Zaragoza,207,Piedratajada,126,64,62
50,Zaragoza,208,Pina de Ebro,2615,1348,1267
50,Zaragoza,209,Pinseque,3687,1919,1768
50,Zaragoza,210,"Pintanos, Los",48,29,19
50,Zaragoza,211,Plasencia de Jalón,374,205,169
50,Zaragoza,212,Pleitas,45,23,22
50,Zaragoza,213,Plenas,128,67,61
50,Zaragoza,214,Pomer,33,22,11
50,Zaragoza,215,Pozuel de Ariza,22,13,9
50,Zaragoza,216,Pozuelo de Aragón,318,174,144
50,Zaragoza,217,Pradilla de Ebro,624,330,294
50,Zaragoza,218,Puebla de Albortón,125,78,47
50,Zaragoza,219,"Puebla de Alfindén, La",5784,2985,2799
50,Zaragoza,220,Puendeluna,55,31,24
50,Zaragoza,221,Purujosa,39,26,13
50,Zaragoza,222,Quinto,2085,1064,1021
50,Zaragoza,223,Remolinos,1144,585,559
50,Zaragoza,224,Retascón,70,43,27
50,Zaragoza,225,Ricla,3225,1691,1534
50,Zaragoza,227,Romanos,114,68,46
50,Zaragoza,228,Rueda de Jalón,343,187,156
50,Zaragoza,229,Ruesca,76,40,36
50,Zaragoza,241,Sabiñán,770,405,365
50,Zaragoza,230,Sádaba,1506,771,735
50,Zaragoza,231,Salillas de Jalón,337,169,168
50,Zaragoza,232,Salvatierra de Esca,211,103,108
50,Zaragoza,233,Samper del Salz,109,62,47
50,Zaragoza,234,San Martín de la Virgen de Moncayo,292,164,128
50,Zaragoza,235,San Mateo de Gállego,3190,1657,1533
50,Zaragoza,236,Santa Cruz de Grío,136,72,64
50,Zaragoza,237,Santa Cruz de Moncayo,143,76,67
50,Zaragoza,238,Santa Eulalia de Gállego,123,68,55
50,Zaragoza,239,Santed,66,40,26
50,Zaragoza,240,Sástago,1249,643,606
50,Zaragoza,242,Sediles,108,64,44
50,Zaragoza,243,Sestrica,400,228,172
50,Zaragoza,244,Sierra de Luna,262,140,122
50,Zaragoza,245,Sigüés,113,63,50
50,Zaragoza,246,Sisamón,39,26,13
50,Zaragoza,247,Sobradiel,1054,512,542
50,Zaragoza,248,Sos del Rey Católico,635,326,309
50,Zaragoza,249,Tabuenca,369,208,161
50,Zaragoza,250,Talamantes,60,27,33
50,Zaragoza,251,Tarazona,10863,5373,5490
50,Zaragoza,252,Tauste,7190,3601,3589
50,Zaragoza,253,Terrer,586,307,279
50,Zaragoza,254,Tierga,195,108,87
50,Zaragoza,255,Tobed,236,117,119
50,Zaragoza,256,Torralba de los Frailes,88,49,39
50,Zaragoza,257,Torralba de Ribota,203,111,92
50,Zaragoza,258,Torralbilla,57,32,25
50,Zaragoza,259,Torrehermosa,70,38,32
50,Zaragoza,260,Torrelapaja,37,23,14
50,Zaragoza,261,Torrellas,287,154,133
50,Zaragoza,262,Torres de Berrellén,1501,788,713
50,Zaragoza,263,Torrijo de la Cañada,277,158,119
50,Zaragoza,264,Tosos,210,116,94
50,Zaragoza,265,Trasmoz,74,41,33
50,Zaragoza,266,Trasobares,140,85,55
50,Zaragoza,267,Uncastillo,712,347,365
50,Zaragoza,268,Undués de Lerda,60,34,26
50,Zaragoza,269,Urrea de Jalón,406,207,199
50,Zaragoza,270,Urriés,41,25,16
50,Zaragoza,271,Used,303,166,137
50,Zaragoza,272,Utebo,18336,9222,9114
50,Zaragoza,274,Val de San Martín,76,41,35
50,Zaragoza,273,Valdehorna,29,15,14
50,Zaragoza,275,Valmadrid,138,88,50
50,Zaragoza,276,Valpalmas,151,72,79
50,Zaragoza,277,Valtorres,92,44,48
50,Zaragoza,278,Velilla de Ebro,243,132,111
50,Zaragoza,279,Velilla de Jiloca,116,65,51
50,Zaragoza,280,Vera de Moncayo,406,210,196
50,Zaragoza,281,Vierlas,91,47,44
50,Zaragoza,283,Villadoz,93,55,38
50,Zaragoza,284,Villafeliche,206,107,99
50,Zaragoza,285,Villafranca de Ebro,834,409,425
50,Zaragoza,286,Villalba de Perejil,108,58,50
50,Zaragoza,287,Villalengua,376,200,176
50,Zaragoza,903,Villamayor de Gállego,2837,1427,1410
50,Zaragoza,288,Villanueva de Gállego,4606,2338,2268
50,Zaragoza,290,Villanueva de Huerva,534,280,254
50,Zaragoza,289,Villanueva de Jiloca,57,29,28
50,Zaragoza,291,Villar de los Navarros,113,61,52
50,Zaragoza,292,Villarreal de Huerva,219,117,102
50,Zaragoza,293,Villarroya de la Sierra,535,281,254
50,Zaragoza,294,Villarroya del Campo,78,44,34
50,Zaragoza,282,"Vilueña, La",109,53,56
50,Zaragoza,295,Vistabella,49,32,17
50,Zaragoza,296,"Zaida, La",486,238,248
50,Zaragoza,297,Zaragoza,682004,329700,352304
50,Zaragoza,298,Zuera,7817,4032,3785
51,Ceuta,1,Ceuta,84180,43060,41120
52,Melilla,1,Melilla,83679,43017,40662
