province_code,province_name,cmun,municipality_name,population_total,population_male,population_female
02,Albacete,1,Abengibre,888,447,441
02,Albacete,2,Alatoz,599,336,263
02,Albacete,3,Albacete,172472,84720,87752
02,Albacete,4,Albatana,782,398,384
02,Albacete,5,Alborea,849,440,409
02,Albacete,6,Alcadozo,723,377,346
02,Albacete,7,Alcalá del Júcar,1346,718,628
02,Albacete,8,Alcaraz,1597,806,791
02,Albacete,9,Almansa,25374,12620,12754
02,Albacete,10,Alpera,2417,1241,1176
02,Albacete,11,Ayna,794,423,371
02,Albacete,12,Balazote,2447,1260,1187
02,Albacete,14,"Ballestero, El",465,235,230
02,Albacete,13,Balsa de Ves,191,103,88
02,Albacete,15,Barrax,2027,1051,976
02,Albacete,16,Bienservida,712,366,346
02,Albacete,17,Bogarra,996,520,476
02,Albacete,18,Bonete,1225,621,604
02,Albacete,19,"Bonillo, El",3012,1529,1483
02,Albacete,20,Carcelén,639,338,301
02,Albacete,21,Casas de Juan Núñez,1441,748,693
02,Albacete,22,Casas de Lázaro,446,245,201
02,Albacete,23,Casas de Ves,724,379,345
02,Albacete,24,Casas-Ibáñez,4843,2510,2333
02,Albacete,25,Caudete,10551,5342,5209
02,Albacete,26,Cenizate,1306,690,616
02,Albacete,29,Chinchilla de Monte-Aragón,4116,2141,1975
02,Albacete,27,Corral-Rubio,403,212,191
02,Albacete,28,Cotillas,157,83,74
02,Albacete,30,Elche de la Sierra,3941,1977,1964
02,Albacete,31,Férez,743,367,376
02,Albacete,32,Fuensanta,368,200,168
02,Albacete,33,Fuente-Álamo,2649,1403,1246
02,Albacete,34,Fuentealbilla,2013,1023,990
02,Albacete,35,"Gineta, La",2582,1330,1252
02,Albacete,36,Golosalvo,118,62,56
02,Albacete,37,Hellín,31262,15625,15637
02,Albacete,38,"Herrera, La",349,175,174
02,Albacete,39,Higueruela,1310,672,638
02,Albacete,40,Hoya-Gonzalo,737,386,351
02,Albacete,41,Jorquera,431,232,199
02,Albacete,42,Letur,1074,532,542
02,Albacete,43,Lezuza,1582,803,779
02,Albacete,44,Liétor,1388,713,675
02,Albacete,45,Madrigueras,4836,2474,2362
02,Albacete,46,Mahora,1431,716,715
02,Albacete,47,Masegoso,122,65,57
02,Albacete,48,Minaya,1683,851,832
02,Albacete,49,Molinicos,1020,525,495
02,Albacete,50,Montalvos,124,69,55
02,Albacete,51,Montealegre del Castillo,2234,1143,1091
02,Albacete,52,Motilleja,589,299,290
02,Albacete,53,Munera,3757,1902,1855
02,Albacete,54,Navas de Jorquera,554,282,272
02,Albacete,55,Nerpio,1478,797,681
02,Albacete,56,Ontur,2246,1120,1126
02,Albacete,57,Ossa de Montiel,2645,1327,1318
02,Albacete,58,Paterna del Madera,443,236,207
02,Albacete,60,Peñas de San Pedro,1360,780,580
02,Albacete,59,Peñascosa,387,199,188
02,Albacete,61,Pétrola,826,438,388
02,Albacete,62,Povedilla,538,279,259
02,Albacete,901,Pozo Cañada,2880,1446,1434
02,Albacete,63,Pozohondo,1791,939,852
02,Albacete,64,Pozo-Lorente,448,226,222
02,Albacete,65,Pozuelo,570,305,265
02,Albacete,66,"Recueja, La",308,153,155
02,Albacete,67,Riópar,1463,746,717
02,Albacete,68,Robledo,456,238,218
02,Albacete,69,"Roda, La",16420,8343,8077
02,Albacete,70,Salobre,606,319,287
02,Albacete,71,San Pedro,1287,661,626
02,Albacete,72,Socovos,1975,1007,968
02,Albacete,73,Tarazona de la Mancha,6696,3397,3299
02,Albacete,74,Tobarra,8153,4153,4000
02,Albacete,75,Valdeganga,1980,1005,975
02,Albacete,76,Vianos,400,202,198
02,Albacete,77,Villa de Ves,53,29,24
02,Albacete,78,Villalgordo del Júcar,1240,647,593
02,Albacete,79,Villamalea,4164,2098,2066
02,Albacete,80,Villapalacios,682,357,325
02,Albacete,81,Villarrobledo,26583,13221,13362
02,Albacete,82,Villatoya,135,75,60
02,Albacete,83,Villavaliente,268,153,115
02,Albacete,84,Villaverde de Guadalimar,404,216,188
02,Albacete,85,Viveros,356,181,175
02,Albacete,86,Yeste,3157,1622,1535
03,Alicante/Alacant,1,Adsubia,749,389,360
03,Alicante/Alacant,2,Agost,4791,2424,2367
03,Alicante/Alacant,3,Agres,598,311,287
03,Alicante/Alacant,4,Aigües,1105,577,528
03,Alicante/Alacant,5,Albatera,11936,6112,5824
03,Alicante/Alacant,6,Alcalalí,1433,722,711
03,Alicante/Alacant,7,Alcocer de Planes,233,119,114
03,Alicante/Alacant,8,Alcoleja,204,104,100
03,Alicante/Alacant,9,Alcoy/Alcoi,60837,29690,31147
03,Alicante/Alacant,10,Alfafara,419,205,214
03,Alicante/Alacant,11,"Alfàs del Pi, l'",21964,10998,10966
03,Alicante/Alacant,12,Algorfa,4755,2364,2391
03,Alicante/Alacant,13,Algueña,1527,767,760
03,Alicante/Alacant,14,Alicante/Alacant,334678,162536,172142
03,Alicante/Alacant,15,Almoradí,19601,9955,9646
03,Alicante/Alacant,16,Almudaina,129,69,60
03,Alicante/Alacant,17,"Alqueria d'Asnar, l'",515,236,279
03,Alicante/Alacant,18,Altea,24298,12065,12233
03,Alicante/Alacant,19,Aspe,20309,10254,10055
03,Alicante/Alacant,20,Balones,157,81,76
03,Alicante/Alacant,21,Banyeres de Mariola,7222,3602,3620
03,Alicante/Alacant,22,Benasau,174,84,90
03,Alicante/Alacant,23,Beneixama,1792,901,891
03,Alicante/Alacant,24,Benejúzar,5425,2692,2733
03,Alicante/Alacant,25,Benferri,1934,1016,918
03,Alicante/Alacant,26,Beniarbeig,1902,954,948
03,Alicante/Alacant,27,Beniardá,248,139,109
03,Alicante/Alacant,28,Beniarrés,1271,628,643
03,Alicante/Alacant,30,Benidoleig,1315,650,665
03,Alicante/Alacant,31,Benidorm,72991,36800,36191
03,Alicante/Alacant,32,Benifallim,110,55,55
03,Alicante/Alacant,33,Benifato,202,103,99
03,Alicante/Alacant,29,Benigembla,583,300,283
03,Alicante/Alacant,34,Benijófar,4207,2076,2131
03,Alicante/Alacant,35,Benilloba,800,404,396
03,Alicante/Alacant,36,Benillup,106,47,59
03,Alicante/Alacant,37,Benimantell,518,242,276
03,Alicante/Alacant,38,Benimarfull,417,207,210
03,Alicante/Alacant,39,Benimassot,125,68,57
03,Alicante/Alacant,40,Benimeli,424,204,220
03,Alicante/Alacant,41,Benissa,13808,6935,6873
03,Alicante/Alacant,42,"Benitachell/Poble Nou de Benitatxell, el",5698,2858,2840
03,Alicante/Alacant,43,Biar,3695,1809,1886
03,Alicante/Alacant,44,Bigastro,6719,3443,3276
03,Alicante/Alacant,45,Bolulla,450,230,220
03,Alicante/Alacant,46,Busot,3412,1720,1692
03,Alicante/Alacant,49,Callosa de Segura,18034,9092,8942
03,Alicante/Alacant,48,Callosa d'En Sarrià,7815,3995,3820
03,Alicante/Alacant,47,Calp,29550,14972,14578
03,Alicante/Alacant,50,"Campello, el",27709,13705,14004
03,Alicante/Alacant,51,"Campo de Mirra/Camp de Mirra, el",444,224,220
03,Alicante/Alacant,52,Cañada,1237,607,630
03,Alicante/Alacant,53,Castalla,10573,5343,5230
03,Alicante/Alacant,54,Castell de Castells,478,237,241
03,Alicante/Alacant,75,"Castell de Guadalest, el",238,120,118
03,Alicante/Alacant,55,Catral,9083,4643,4440
03,Alicante/Alacant,56,Cocentaina,11591,5859,5732
03,Alicante/Alacant,57,Confrides,283,159,124
03,Alicante/Alacant,58,Cox,7077,3625,3452
03,Alicante/Alacant,59,Crevillent,28439,14492,13947
03,Alicante/Alacant,61,Daya Nueva,1996,1008,988
03,Alicante/Alacant,62,Daya Vieja,758,385,373
03,Alicante/Alacant,63,Dénia,44455,21897,22558
03,Alicante/Alacant,64,Dolores,7362,3666,3696
03,Alicante/Alacant,65,Elche/Elx,230587,114873,115714
03,Alicante/Alacant,66,Elda,54536,26770,27766
03,Alicante/Alacant,67,Facheca,104,55,49
03,Alicante/Alacant,68,Famorca,59,31,28
03,Alicante/Alacant,69,Finestrat,6932,3578,3354
03,Alicante/Alacant,77,"Fondó de les Neus, el/Hondón de las Nieves",3037,1542,1495
03,Alicante/Alacant,70,Formentera del Segura,4559,2342,2217
03,Alicante/Alacant,72,Gaianes,445,231,214
03,Alicante/Alacant,71,Gata de Gorgos,6327,3223,3104
03,Alicante/Alacant,73,Gorga,261,137,124
03,Alicante/Alacant,74,Granja de Rocamora,2461,1300,1161
03,Alicante/Alacant,76,Guardamar del Segura,17138,8612,8526
03,Alicante/Alacant,78,Hondón de los Frailes,1238,650,588
03,Alicante/Alacant,79,Ibi,23616,11828,11788
03,Alicante/Alacant,80,Jacarilla,2076,1050,1026
03,Alicante/Alacant,82,Jávea/Xàbia,32983,16560,16423
03,Alicante/Alacant,83,Jijona/Xixona,7423,3595,3828
03,Alicante/Alacant,85,Llíber,1071,526,545
03,Alicante/Alacant,84,"Lorcha/Orxa, l'",729,371,358
03,Alicante/Alacant,86,Millena,217,111,106
03,Alicante/Alacant,88,Monforte del Cid,7803,4110,3693
03,Alicante/Alacant,89,Monóvar/Monòver,12844,6387,6457
03,Alicante/Alacant,903,"Montesinos, Los",5203,2617,2586
03,Alicante/Alacant,91,Murla,598,287,311
03,Alicante/Alacant,92,Muro de Alcoy,9010,4474,4536
03,Alicante/Alacant,90,Mutxamel,23834,11935,11899
03,Alicante/Alacant,93,Novelda,26692,13299,13393
03,Alicante/Alacant,94,"Nucia, la",19135,9707,9428
03,Alicante/Alacant,95,Ondara,6657,3347,3310
03,Alicante/Alacant,96,Onil,7697,3869,3828
03,Alicante/Alacant,97,Orba,2604,1289,1315
03,Alicante/Alacant,99,Orihuela,90087,45289,44798
03,Alicante/Alacant,98,Orxeta,921,474,447
03,Alicante/Alacant,100,Parcent,1131,555,576
03,Alicante/Alacant,101,Pedreguer,7751,3832,3919
03,Alicante/Alacant,102,Pego,11029,5640,5389
03,Alicante/Alacant,103,Penàguila,318,173,145
03,Alicante/Alacant,104,Petrer,34697,17311,17386
03,Alicante/Alacant,902,Pilar de la Horadada,23403,12063,11340
03,Alicante/Alacant,105,"Pinós, el/Pinoso",7908,3990,3918
03,Alicante/Alacant,106,Planes,831,427,404
03,Alicante/Alacant,901,"Poblets, els",3404,1652,1752
03,Alicante/Alacant,107,Polop,4549,2316,2233
03,Alicante/Alacant,60,Quatretondeta,109,52,57
03,Alicante/Alacant,109,Rafal,4213,2127,2086
03,Alicante/Alacant,110,"Ràfol d'Almúnia, el",749,373,376
03,Alicante/Alacant,111,Redován,7554,3923,3631
03,Alicante/Alacant,112,Relleu,1342,675,667
03,Alicante/Alacant,113,Rojales,22006,11263,10743
03,Alicante/Alacant,114,"Romana, la",2509,1309,1200
03,Alicante/Alacant,115,Sagra,446,230,216
03,Alicante/Alacant,116,Salinas,1603,816,787
03,Alicante/Alacant,118,San Fulgencio,12529,6330,6199
03,Alicante/Alacant,904,San Isidro,1921,989,932
03,Alicante/Alacant,120,San Miguel de Salinas,7602,3826,3776
03,Alicante/Alacant,122,San Vicente del Raspeig/Sant Vicent del Raspeig,55100,27414,27686
03,Alicante/Alacant,117,Sanet y Negrals,700,348,352
03,Alicante/Alacant,119,Sant Joan d'Alacant,22740,11023,11717
03,Alicante/Alacant,121,Santa Pola,33965,17292,16673
03,Alicante/Alacant,123,Sax,10069,5059,5010
03,Alicante/Alacant,124,Sella,626,331,295
03,Alicante/Alacant,125,Senija,642,330,312
03,Alicante/Alacant,127,Tàrbena,809,417,392
03,Alicante/Alacant,128,Teulada,14578,7320,7258
03,Alicante/Alacant,129,Tibi,1761,913,848
03,Alicante/Alacant,130,Tollos,45,24,21
03,Alicante/Alacant,131,Tormos,386,195,191
03,Alicante/Alacant,132,"Torremanzanas/Torre de les Maçanes, la",797,423,374
03,Alicante/Alacant,133,Torrevieja,103720,52271,51449
03,Alicante/Alacant,134,"Vall d'Alcalà, la",175,91,84
03,Alicante/Alacant,136,Vall de Gallinera,676,351,325
03,Alicante/Alacant,137,"Vall de Laguar, la",959,466,493
03,Alicante/Alacant,135,"Vall d'Ebo, la",286,146,140
03,Alicante/Alacant,138,"Verger, el",4992,2525,2467
03,Alicante/Alacant,139,"Villajoyosa/Vila Joiosa, la",33293,16686,16607
03,Alicante/Alacant,140,Villena,34894,17433,17461
03,Alicante/Alacant,81,Xaló,3301,1664,1637
04,Almería,1,Abla,1465,765,700
04,Almería,2,Abrucena,1360,699,661
04,Almería,3,Adra,24626,12493,12133
04,Almería,4,Albánchez,774,395,379
04,Almería,5,Alboloduy,674,334,340
04,Almería,6,Albox,10821,5489,5332
04,Almería,7,Alcolea,895,476,419
04,Almería,8,Alcóntar,624,336,288
04,Almería,9,Alcudia de Monteagud,151,76,75
04,Almería,10,Alhabia,680,345,335
04,Almería,11,Alhama de Almería,3847,1961,1886
04,Almería,12,Alicún,267,140,127
04,Almería,13,Almería,191443,93132,98311
04,Almería,14,Almócita,188,94,94
04,Almería,15,Alsodux,149,79,70
04,Almería,16,Antas,3312,1665,1647
04,Almería,17,Arboleas,4990,2513,2477
04,Almería,18,Armuña de Almanzora,340,171,169
04,Almería,19,Bacares,292,150,142
04,Almería,20,Bayárcal,376,203,173
04,Almería,21,Bayarque,224,114,110
04,Almería,22,Bédar,1083,548,535
04,Almería,23,Beires,111,52,59
04,Almería,24,Benahadux,4201,2090,2111
04,Almería,26,Benitagla,78,45,33
04,Almería,27,Benizalón,288,152,136
04,Almería,28,Bentarique,278,150,128
04,Almería,29,Berja,15504,7868,7636
04,Almería,30,Canjáyar,1438,739,699
04,Almería,31,Cantoria,3956,2035,1921
04,Almería,32,Carboneras,8081,4192,3889
04,Almería,33,Castro de Filabres,157,79,78
04,Almería,36,Chercos,307,161,146
04,Almería,37,Chirivel,1811,927,884
04,Almería,34,Cóbdar,156,86,70
04,Almería,35,Cuevas del Almanzora,13296,6896,6400
04,Almería,38,Dalías,4019,1981,2038
04,Almería,902,"Ejido, El",83104,44147,38957
04,Almería,41,Enix,456,260,196
04,Almería,43,Felix,662,366,296
04,Almería,44,Fines,2260,1177,1083
04,Almería,45,Fiñana,2367,1191,1176
04,Almería,46,Fondón,989,510,479
04,Almería,47,Gádor,3241,1691,1550
04,Almería,48,"Gallardos, Los",3831,1952,1879
04,Almería,49,Garrucha,8748,4529,4219
04,Almería,50,Gérgal,1086,569,517
04,Almería,51,Huécija,519,252,267
04,Almería,52,Huércal de Almería,16319,8382,7937
04,Almería,53,Huércal-Overa,18686,9344,9342
04,Almería,54,Illar,416,218,198
04,Almería,55,Instinción,470,217,253
04,Almería,56,Laroya,170,92,78
04,Almería,57,Láujar de Andarax,1735,863,872
04,Almería,58,Líjar,471,244,227
04,Almería,59,Lubrín,1729,856,873
04,Almería,60,Lucainena de las Torres,656,350,306
04,Almería,61,Lúcar,886,447,439
04,Almería,62,Macael,5936,3038,2898
04,Almería,63,María,1370,705,665
04,Almería,64,Mojácar,8173,4132,4041
04,Almería,903,"Mojonera, La",8682,4771,3911
04,Almería,65,Nacimiento,512,267,245
04,Almería,66,Níjar,29465,16187,13278
04,Almería,67,Ohanes,714,353,361
04,Almería,68,Olula de Castro,191,97,94
04,Almería,69,Olula del Río,6500,3355,3145
04,Almería,70,Oria,2858,1489,1369
04,Almería,71,Padules,520,269,251
04,Almería,72,Partaloa,969,480,489
04,Almería,73,Paterna del Río,433,237,196
04,Almería,74,Pechina,3746,1895,1851
04,Almería,75,Pulpí,8848,4618,4230
04,Almería,76,Purchena,1761,903,858
04,Almería,77,Rágol,356,186,170
04,Almería,78,Rioja,1355,688,667
04,Almería,79,Roquetas de Mar,90358,47200,43158
04,Almería,80,Santa Cruz de Marchena,231,114,117
04,Almería,81,Santa Fe de Mondújar,463,232,231
04,Almería,82,Senés,307,156,151
04,Almería,83,Serón,2328,1174,1154
04,Almería,84,Sierro,439,229,210
04,Almería,85,Somontín,525,264,261
04,Almería,86,Sorbas,2742,1454,1288
04,Almería,87,Suflí,260,138,122
04,Almería,88,Tabernas,3682,1918,1764
04,Almería,89,Taberno,1174,577,597
04,Almería,90,Tahal,473,247,226
04,Almería,91,Terque,454,230,224
04,Almería,92,Tíjola,3838,1899,1939
04,Almería,901,"Tres Villas, Las",665,345,320
04,Almería,93,Turre,3929,2031,1898
04,Almería,94,Turrillas,234,133,101
04,Almería,95,Uleila del Campo,989,514,475
04,Almería,96,Urrácal,342,171,171
04,Almería,97,Velefique,297,163,134
04,Almería,98,Vélez-Blanco,2238,1185,1053
04,Almería,99,Vélez-Rubio,7071,3458,3613
04,Almería,100,Vera,15010,7672,7338
04,Almería,101,Viator,5492,2801,2691
04,Almería,102,Vícar,24042,12695,11347
04,Almería,103,Zurgena,3184,1589,1595
01,Araba/Álava,1,Alegría-Dulantzi,2869,1484,1385
01,Araba/Álava,2,Amurrio,10114,5067,5047
01,Araba/Álava,49,Añana,166,89,77
01,Araba/Álava,3,Aramaio,1513,795,718
01,Araba/Álava,6,Armiñón,231,115,116
01,Araba/Álava,37,Arraia-Maeztu,739,417,322
01,Araba/Álava,8,Arrazua-Ubarrundia,983,520,463
01,Araba/Álava,4,Artziniega,1861,937,924
01,Araba/Álava,9,Asparrena,1698,859,839
01,Araba/Álava,10,Ayala/Aiara,2918,1465,1453
01,Araba/Álava,11,Baños de Ebro/Mañueta,317,179,138
01,Araba/Álava,13,Barrundia,908,496,412
01,Araba/Álava,14,Berantevilla,480,245,235
01,Araba/Álava,16,Bernedo,568,326,242
01,Araba/Álava,17,Campezo/Kanpezu,1136,594,542
01,Araba/Álava,21,Elburgo/Burgelu,629,333,296
01,Araba/Álava,22,Elciego,1037,510,527
01,Araba/Álava,23,Elvillar/Bilar,368,186,182
01,Araba/Álava,46,Erriberagoitia/Ribera Alta,790,446,344
01,Araba/Álava,56,Harana/Valle de Arana,278,161,117
01,Araba/Álava,901,Iruña Oka/Iruña de Oca,3072,1581,1491
01,Araba/Álava,27,Iruraiz-Gauna,541,299,242
01,Araba/Álava,19,Kripan,194,106,88
01,Araba/Álava,20,Kuartango,358,207,151
01,Araba/Álava,28,Labastida/Bastida,1508,784,724
01,Araba/Álava,30,Lagrán,180,92,88
01,Araba/Álava,31,Laguardia,1548,799,749
01,Araba/Álava,32,Lanciego/Lantziego,685,359,326
01,Araba/Álava,902,Lantarón,929,508,421
01,Araba/Álava,33,Lapuebla de Labarca,848,437,411
01,Araba/Álava,36,Laudio/Llodio,18498,9148,9350
01,Araba/Álava,58,Legutio,1762,937,825
01,Araba/Álava,34,Leza,218,113,105
01,Araba/Álava,39,Moreda de Álava/Moreda Araba,246,126,120
01,Araba/Álava,41,Navaridas,220,124,96
01,Araba/Álava,42,Okondo,1157,610,547
01,Araba/Álava,43,Oyón-Oion,3305,1688,1617
01,Araba/Álava,44,Peñacerrada-Urizaharra,280,166,114
01,Araba/Álava,47,Ribera Baja/Erribera Beitia,1332,726,606
01,Araba/Álava,51,Salvatierra/Agurain,4978,2495,2483
01,Araba/Álava,52,Samaniego,331,185,146
01,Araba/Álava,53,San Millán/Donemiliaga,719,392,327
01,Araba/Álava,54,Urkabustaiz,1350,718,632
01,Araba/Álava,55,Valdegovía/Gaubea,1067,589,478
01,Araba/Álava,57,Villabuena de Álava/Eskuernaga,319,165,154
01,Araba/Álava,59,Vitoria-Gasteiz,242223,119383,122840
01,Araba/Álava,60,Yécora/Iekora,285,149,136
01,Araba/Álava,61,Zalduondo,185,104,81
01,Araba/Álava,62,Zambrana,430,230,200
01,Araba/Álava,18,Zigoitia,1747,947,800
01,Araba/Álava,63,Zuia,2439,1258,1181
33,Asturias,1,Allande,1939,986,953
33,Asturias,2,Aller,12136,5980,6156
33,Asturias,3,Amieva,803,434,369
33,Asturias,4,Avilés,83107,39691,43416
33,Asturias,5,Belmonte de Miranda,1740,901,839
33,Asturias,6,Bimenes,1880,894,986
33,Asturias,7,Boal,1814,907,907
33,Asturias,8,Cabrales,2157,1098,1059
33,Asturias,9,Cabranes,1074,554,520
33,Asturias,10,Candamo,2124,1044,1080
33,Asturias,12,Cangas de Onís,6787,3321,3466
33,Asturias,11,Cangas del Narcea,14077,7032,7045
33,Asturias,13,Caravia,520,271,249
33,Asturias,14,Carreño,10967,5331,5636
33,Asturias,15,Caso,1799,1005,794
33,Asturias,16,Castrillón,22950,11174,11776
33,Asturias,17,Castropol,3713,1786,1927
33,Asturias,18,Coaña,3462,1682,1780
33,Asturias,19,Colunga,3614,1760,1854
33,Asturias,20,Corvera de Asturias,16216,7997,8219
33,Asturias,21,Cudillero,5691,2813,2878
33,Asturias,22,Degaña,1182,615,567
33,Asturias,23,"Franco, El",3946,1945,2001
33,Asturias,24,Gijón,277733,131373,146360
33,Asturias,25,Gozón,10763,5262,5501
33,Asturias,26,Grado,10746,5220,5526
33,Asturias,27,Grandas de Salime,1001,508,493
33,Asturias,28,Ibias,1634,892,742
33,Asturias,29,Illano,439,232,207
33,Asturias,30,Illas,1038,531,507
33,Asturias,31,Langreo,43647,20779,22868
33,Asturias,32,Laviana,14044,6772,7272
33,Asturias,33,Lena,12367,5972,6395
33,Asturias,35,Llanera,14167,7023,7144
33,Asturias,36,Llanes,13893,6780,7113
33,Asturias,37,Mieres,42421,20094,22327
33,Asturias,38,Morcín,2866,1430,1436
33,Asturias,39,Muros de Nalón,1911,904,1007
33,Asturias,40,Nava,5599,2769,2830
33,Asturias,41,Navia,8982,4368,4614
33,Asturias,42,Noreña,5432,2647,2785
33,Asturias,43,Onís,786,413,373
33,Asturias,44,Oviedo,225973,105445,120528
33,Asturias,45,Parres,5699,2797,2902
33,Asturias,46,Peñamellera Alta,598,301,297
33,Asturias,47,Peñamellera Baja,1317,653,664
33,Asturias,48,Pesoz,191,92,99
33,Asturias,49,Piloña,7793,3833,3960
33,Asturias,50,Ponga,686,407,279
33,Asturias,51,Pravia,9016,4403,4613
33,Asturias,52,Proaza,813,459,354
33,Asturias,53,Quirós,1294,721,573
33,Asturias,54,"Regueras, Las",1952,987,965
33,Asturias,55,Ribadedeva,1904,927,977
33,Asturias,56,Ribadesella,6209,2966,3243
33,Asturias,57,Ribera de Arriba,1971,1001,970
33,Asturias,58,Riosa,2140,1088,1052
33,Asturias,59,Salas,5659,2810,2849
33,Asturias,61,San Martín de Oscos,484,240,244
33,Asturias,60,San Martín del Rey Aurelio,17953,8666,9287
33,Asturias,63,San Tirso de Abres,521,254,267
33,Asturias,62,Santa Eulalia de Oscos,503,261,242
33,Asturias,64,Santo Adriano,263,132,131
33,Asturias,65,Sariego,1313,627,686
33,Asturias,66,Siero,52229,25511,26718
33,Asturias,67,Sobrescobio,872,458,414
33,Asturias,68,Somiedo,1354,783,571
33,Asturias,69,Soto del Barco,4048,1995,2053
33,Asturias,70,Tapia de Casariego,4002,1924,2078
33,Asturias,71,Taramundi,736,357,379
33,Asturias,72,Teverga,1899,987,912
33,Asturias,73,Tineo,10652,5352,5300
33,Asturias,34,Valdés,13058,6403,6655
33,Asturias,74,Vegadeo,4131,2000,2131
33,Asturias,75,Villanueva de Oscos,345,174,171
33,Asturias,76,Villaviciosa,14989,7380,7609
33,Asturias,77,Villayón,1460,744,716
33,Asturias,78,Yernes y Tameza,166,92,74
05,Ávila,1,Adanero,266,138,128
05,Ávila,2,"Adrada, La",2704,1426,1278
05,Ávila,5,Albornos,218,115,103
05,Ávila,7,Aldeanueva de Santa Cruz,136,77,59
05,Ávila,8,Aldeaseca,273,131,142
05,Ávila,10,"Aldehuela, La",199,103,96
05,Ávila,12,Amavida,176,88,88
05,Ávila,13,"Arenal, El",1046,534,512
05,Ávila,14,Arenas de San Pedro,6841,3353,3488
05,Ávila,15,Arevalillo,101,51,50
05,Ávila,16,Arévalo,8118,3977,4141
05,Ávila,17,Aveinte,92,50,42
05,Ávila,18,Avellaneda,30,15,15
05,Ávila,19,Ávila,58915,28354,30561
05,Ávila,21,"Barco de Ávila, El",2715,1337,1378
05,Ávila,22,"Barraco, El",2085,1077,1008
05,Ávila,23,Barromán,199,108,91
05,Ávila,24,Becedas,261,137,124
05,Ávila,25,Becedillas,117,64,53
05,Ávila,26,Bercial de Zapardiel,245,121,124
05,Ávila,27,"Berlanas, Las",366,185,181
05,Ávila,29,Bernuy-Zapardiel,138,79,59
05,Ávila,30,Berrocalejo de Aragona,52,27,25
05,Ávila,33,Blascomillán,207,104,103
05,Ávila,34,Blasconuño de Matacabras,18,11,7
05,Ávila,35,Blascosancho,102,49,53
05,Ávila,36,"Bohodón, El",136,72,64
05,Ávila,37,Bohoyo,328,173,155
05,Ávila,38,Bonilla de la Sierra,134,80,54
05,Ávila,39,Brabos,55,31,24
05,Ávila,40,Bularros,80,51,29
05,Ávila,41,Burgohondo,1300,686,614
05,Ávila,42,Cabezas de Alambre,179,90,89
05,Ávila,43,Cabezas del Pozo,84,47,37
05,Ávila,44,Cabezas del Villar,308,174,134
05,Ávila,45,Cabizuela,111,53,58
05,Ávila,46,Canales,47,25,22
05,Ávila,47,Candeleda,5233,2680,2553
05,Ávila,48,Cantiveros,144,74,70
05,Ávila,49,Cardeñosa,492,259,233
05,Ávila,51,"Carrera, La",210,111,99
05,Ávila,52,Casas del Puerto,105,57,48
05,Ávila,53,Casasola,88,47,41
05,Ávila,54,Casavieja,1575,801,774
05,Ávila,55,Casillas,799,420,379
05,Ávila,56,Castellanos de Zapardiel,107,55,52
05,Ávila,57,Cebreros,3478,1776,1702
05,Ávila,58,Cepeda la Mora,89,46,43
05,Ávila,67,Chamartín,89,54,35
05,Ávila,59,Cillán,114,67,47
05,Ávila,60,Cisla,137,68,69
05,Ávila,61,"Colilla, La",344,175,169
05,Ávila,62,Collado de Contreras,224,120,104
05,Ávila,63,Collado del Mirón,44,25,19
05,Ávila,64,Constanzana,125,74,51
05,Ávila,65,Crespos,535,289,246
05,Ávila,66,Cuevas del Valle,540,295,245
05,Ávila,903,Diego del Carpio,175,97,78
05,Ávila,69,Donjimeno,94,58,36
05,Ávila,70,Donvidas,41,23,18
05,Ávila,72,Espinosa de los Caballeros,108,63,45
05,Ávila,73,Flores de Ávila,339,184,155
05,Ávila,74,Fontiveros,828,434,394
05,Ávila,75,Fresnedilla,112,48,64
05,Ávila,76,"Fresno, El",579,297,282
05,Ávila,77,Fuente el Saúz,192,103,89
05,Ávila,78,Fuentes de Año,135,74,61
05,Ávila,79,Gallegos de Altamiros,60,36,24
05,Ávila,80,Gallegos de Sobrinos,72,33,39
05,Ávila,81,Garganta del Villar,43,29,14
05,Ávila,82,Gavilanes,651,345,306
05,Ávila,83,Gemuño,164,82,82
05,Ávila,85,Gil García,40,20,20
05,Ávila,84,Gilbuena,88,52,36
05,Ávila,86,Gimialcón,94,56,38
05,Ávila,87,Gotarrendura,163,57,106
05,Ávila,88,Grandes y San Martín,30,17,13
05,Ávila,89,Guisando,564,283,281
05,Ávila,90,Gutierre-Muñoz,81,41,40
05,Ávila,92,Hernansancho,188,104,84
05,Ávila,93,Herradón de Pinares,532,294,238
05,Ávila,94,Herreros de Suso,164,85,79
05,Ávila,95,Higuera de las Dueñas,336,188,148
05,Ávila,96,"Hija de Dios, La",85,46,39
05,Ávila,97,"Horcajada, La",556,287,269
05,Ávila,99,Horcajo de las Torres,603,339,264
05,Ávila,100,"Hornillo, El",342,176,166
05,Ávila,102,"Hoyo de Pinares, El",2449,1291,1158
05,Ávila,101,Hoyocasero,327,182,145
05,Ávila,103,Hoyorredondo,83,45,38
05,Ávila,106,Hoyos de Miguel Muñoz,43,21,22
05,Ávila,104,Hoyos del Collado,35,20,15
05,Ávila,105,Hoyos del Espino,443,245,198
05,Ávila,107,Hurtumpascual,73,45,28
05,Ávila,108,Junciana,65,32,33
05,Ávila,109,Langa,520,262,258
05,Ávila,110,Lanzahíta,938,495,443
05,Ávila,113,"Llanos de Tormes, Los",92,43,49
05,Ávila,112,"Losar del Barco, El",133,67,66
05,Ávila,114,Madrigal de las Altas Torres,1621,824,797
05,Ávila,115,Maello,734,379,355
05,Ávila,116,Malpartida de Corneja,138,71,67
05,Ávila,117,Mamblas,229,124,105
05,Ávila,118,Mancera de Arriba,97,54,43
05,Ávila,119,Manjabálago,40,23,17
05,Ávila,120,Marlín,36,21,15
05,Ávila,121,Martiherrero,300,158,142
05,Ávila,122,Martínez,156,84,72
05,Ávila,123,Mediana de Voltoya,101,49,52
05,Ávila,124,Medinilla,133,65,68
05,Ávila,125,Mengamuñoz,67,32,35
05,Ávila,126,Mesegar de Corneja,77,41,36
05,Ávila,127,Mijares,828,437,391
05,Ávila,128,Mingorría,410,209,201
05,Ávila,129,"Mirón, El",152,90,62
05,Ávila,130,Mironcillo,104,57,47
05,Ávila,131,Mirueña de los Infanzones,122,64,58
05,Ávila,132,Mombeltrán,1165,605,560
05,Ávila,133,Monsalupe,60,31,29
05,Ávila,134,Moraleja de Matacabras,55,29,26
05,Ávila,135,Muñana,489,257,232
05,Ávila,136,Muñico,117,60,57
05,Ávila,138,Muñogalindo,401,215,186
05,Ávila,139,Muñogrande,81,47,34
05,Ávila,140,Muñomer del Peco,139,69,70
05,Ávila,141,Muñopepe,106,65,41
05,Ávila,142,Muñosancho,122,62,60
05,Ávila,143,Muñotello,76,40,36
05,Ávila,144,Narrillos del Álamo,91,49,42
05,Ávila,145,Narrillos del Rebollar,60,30,30
05,Ávila,149,Narros de Saldueña,130,72,58
05,Ávila,147,Narros del Castillo,187,104,83
05,Ávila,148,Narros del Puerto,38,19,19
05,Ávila,152,Nava de Arévalo,857,460,397
05,Ávila,153,Nava del Barco,110,57,53
05,Ávila,151,Navacepedilla de Corneja,116,63,53
05,Ávila,154,Navadijos,46,31,15
05,Ávila,155,Navaescurial,60,36,24
05,Ávila,156,Navahondilla,342,197,145
05,Ávila,157,Navalacruz,279,143,136
05,Ávila,158,Navalmoral,417,218,199
05,Ávila,159,Navalonguilla,289,155,134
05,Ávila,160,Navalosa,354,193,161
05,Ávila,161,Navalperal de Pinares,1001,527,474
05,Ávila,162,Navalperal de Tormes,107,60,47
05,Ávila,163,Navaluenga,2152,1079,1073
05,Ávila,164,Navaquesera,33,14,19
05,Ávila,165,Navarredonda de Gredos,485,246,239
05,Ávila,166,Navarredondilla,274,137,137
05,Ávila,167,Navarrevisca,312,171,141
05,Ávila,168,"Navas del Marqués, Las",5728,2918,2810
05,Ávila,169,Navatalgordo,255,131,124
05,Ávila,170,Navatejares,61,27,34
05,Ávila,171,Neila de San Miguel,84,43,41
05,Ávila,172,Niharra,170,93,77
05,Ávila,173,Ojos-Albos,60,36,24
05,Ávila,174,Orbita,87,44,43
05,Ávila,175,"Oso, El",210,124,86
05,Ávila,176,Padiernos,275,144,131
05,Ávila,177,Pajares de Adaja,194,101,93
05,Ávila,178,Palacios de Goda,447,233,214
05,Ávila,179,Papatrigo,265,136,129
05,Ávila,180,"Parral, El",106,59,47
05,Ávila,181,Pascualcobo,42,24,18
05,Ávila,182,Pedro Bernardo,968,523,445
05,Ávila,183,Pedro-Rodríguez,187,93,94
05,Ávila,184,Peguerinos,339,196,143
05,Ávila,185,Peñalba de Ávila,129,75,54
05,Ávila,186,Piedrahíta,2054,988,1066
05,Ávila,187,Piedralaves,2288,1184,1104
05,Ávila,188,Poveda,58,36,22
05,Ávila,189,Poyales del Hoyo,616,331,285
05,Ávila,190,Pozanco,61,37,24
05,Ávila,191,Pradosegar,145,77,68
05,Ávila,192,Puerto Castilla,102,59,43
05,Ávila,193,Rasueros,231,134,97
05,Ávila,194,Riocabado,171,91,80
05,Ávila,195,Riofrío,247,146,101
05,Ávila,196,Rivilla de Barajas,79,35,44
05,Ávila,197,Salobral,131,65,66
05,Ávila,198,Salvadiós,85,44,41
05,Ávila,199,San Bartolomé de Béjar,47,24,23
05,Ávila,200,San Bartolomé de Corneja,65,30,35
05,Ávila,201,San Bartolomé de Pinares,621,324,297
05,Ávila,206,San Esteban de los Patos,36,18,18
05,Ávila,208,San Esteban de Zapardiel,52,28,24
05,Ávila,207,San Esteban del Valle,833,436,397
05,Ávila,209,San García de Ingelmos,102,59,43
05,Ávila,901,San Juan de Gredos,317,183,134
05,Ávila,210,San Juan de la Encinilla,103,54,49
05,Ávila,211,San Juan de la Nava,532,274,258
05,Ávila,212,San Juan del Molinillo,289,163,126
05,Ávila,213,San Juan del Olmo,113,71,42
05,Ávila,214,San Lorenzo de Tormes,56,30,26
05,Ávila,215,San Martín de la Vega del Alberche,197,118,79
05,Ávila,216,San Martín del Pimpollar,216,123,93
05,Ávila,217,San Miguel de Corneja,75,39,36
05,Ávila,218,San Miguel de Serrezuela,159,89,70
05,Ávila,219,San Pascual,52,34,18
05,Ávila,220,San Pedro del Arroyo,471,242,229
05,Ávila,231,San Vicente de Arévalo,204,108,96
05,Ávila,204,Sanchidrián,840,429,411
05,Ávila,205,Sanchorreja,92,46,46
05,Ávila,222,Santa Cruz de Pinares,161,89,72
05,Ávila,221,Santa Cruz del Valle,426,221,205
05,Ávila,226,Santa María de los Caballeros,92,51,41
05,Ávila,224,Santa María del Arroyo,97,51,46
05,Ávila,225,Santa María del Berrocal,443,224,219
05,Ávila,902,Santa María del Cubillo,338,195,143
05,Ávila,227,Santa María del Tiétar,568,305,263
05,Ávila,228,Santiago del Collado,199,122,77
05,Ávila,904,Santiago del Tormes,156,87,69
05,Ávila,229,Santo Domingo de las Posadas,96,48,48
05,Ávila,230,Santo Tomé de Zabarcos,113,62,51
05,Ávila,232,"Serrada, La",114,59,55
05,Ávila,233,Serranillos,278,157,121
05,Ávila,234,Sigeres,58,28,30
05,Ávila,235,Sinlabajos,148,74,74
05,Ávila,236,Solana de Ávila,140,74,66
05,Ávila,237,Solana de Rioalmar,211,111,100
05,Ávila,238,Solosancho,949,504,445
05,Ávila,239,Sotalbo,239,133,106
05,Ávila,240,Sotillo de la Adrada,4845,2438,2407
05,Ávila,241,"Tiemblo, El",4461,2267,2194
05,Ávila,242,Tiñosillos,834,427,407
05,Ávila,243,Tolbaños,107,52,55
05,Ávila,244,Tormellas,65,35,30
05,Ávila,245,Tornadizos de Ávila,397,193,204
05,Ávila,247,"Torre, La",272,149,123
05,Ávila,246,Tórtoles,73,37,36
05,Ávila,249,Umbrías,127,65,62
05,Ávila,251,Vadillo de la Sierra,80,46,34
05,Ávila,252,Valdecasa,70,40,30
05,Ávila,253,Vega de Santa María,96,50,46
05,Ávila,254,Velayos,262,133,129
05,Ávila,256,Villaflor,134,66,68
05,Ávila,257,Villafranca de la Sierra,151,84,67
05,Ávila,905,Villanueva de Ávila,252,126,126
05,Ávila,258,Villanueva de Gómez,144,78,66
05,Ávila,259,Villanueva del Aceral,155,74,81
05,Ávila,260,Villanueva del Campillo,112,62,50
05,Ávila,261,Villar de Corneja,48,26,22
05,Ávila,262,Villarejo del Valle,424,216,208
05,Ávila,263,Villatoro,191,106,85
05,Ávila,264,Viñegra de Moraña,57,33,24
05,Ávila,265,Vita,92,58,34
05,Ávila,266,Zapardiel de la Cañada,114,58,56
05,Ávila,267,Zapardiel de la Ribera,119,63,56
06,Badajoz,1,Acedera,810,413,397
06,Badajoz,2,Aceuchal,5702,2851,2851
06,Badajoz,3,Ahillones,998,504,494
06,Badajoz,4,Alange,1971,1000,971
06,Badajoz,5,"Albuera, La",2078,1057,1021
06,Badajoz,6,Alburquerque,5587,2825,2762
06,Badajoz,7,Alconchel,1873,939,934
06,Badajoz,8,Alconera,744,372,372
06,Badajoz,9,Aljucén,248,134,114
06,Badajoz,10,Almendral,1286,619,667
06,Badajoz,11,Almendralejo,34694,17426,17268
06,Badajoz,12,Arroyo de San Serván,4267,2180,2087
06,Badajoz,13,Atalaya,319,162,157
06,Badajoz,14,Azuaga,8205,4065,4140
06,Badajoz,15,Badajoz,152270,74038,78232
06,Badajoz,16,Barcarrota,3692,1883,1809
06,Badajoz,17,Baterno,335,177,158
06,Badajoz,18,Benquerencia de la Serena,925,452,473
06,Badajoz,19,Berlanga,2486,1237,1249
06,Badajoz,20,Bienvenida,2275,1180,1095
06,Badajoz,21,Bodonal de la Sierra,1135,582,553
06,Badajoz,22,Burguillos del Cerro,3255,1615,1640
06,Badajoz,23,Cabeza del Buey,5338,2646,2692
06,Badajoz,24,Cabeza la Vaca,1430,728,702
06,Badajoz,25,Calamonte,6361,3165,3196
06,Badajoz,26,Calera de León,1029,509,520
06,Badajoz,27,Calzadilla de los Barros,914,466,448
06,Badajoz,28,Campanario,5256,2575,2681
06,Badajoz,29,Campillo de Llerena,1442,731,711
06,Badajoz,30,Capilla,182,93,89
06,Badajoz,31,Carmonita,574,286,288
06,Badajoz,32,"Carrascalejo, El",84,44,40
06,Badajoz,33,Casas de Don Pedro,1646,832,814
06,Badajoz,34,Casas de Reina,208,101,107
06,Badajoz,35,Castilblanco,1148,573,575
06,Badajoz,36,Castuera,6422,3184,3238
06,Badajoz,42,Cheles,1223,587,636
06,Badajoz,37,"Codosera, La",2337,1216,1121
06,Badajoz,38,Cordobilla de Lácara,979,496,483
06,Badajoz,39,"Coronada, La",2242,1103,1139
06,Badajoz,40,Corte de Peleas,1334,681,653
06,Badajoz,41,Cristina,561,295,266
06,Badajoz,43,Don Álvaro,758,391,367
06,Badajoz,44,Don Benito,37048,18365,18683
06,Badajoz,45,Entrín Bajo,608,312,296
06,Badajoz,46,Esparragalejo,1526,738,788
06,Badajoz,47,Esparragosa de la Serena,1069,552,517
06,Badajoz,48,Esparragosa de Lares,1018,499,519
06,Badajoz,49,Feria,1268,619,649
06,Badajoz,50,Fregenal de la Sierra,5148,2507,2641
06,Badajoz,51,Fuenlabrada de los Montes,1961,961,1000
06,Badajoz,52,Fuente de Cantos,4944,2431,2513
06,Badajoz,53,Fuente del Arco,745,381,364
06,Badajoz,54,Fuente del Maestre,6943,3447,3496
06,Badajoz,55,Fuentes de León,2468,1219,1249
06,Badajoz,56,Garbayuela,559,299,260
06,Badajoz,57,Garlitos,634,329,305
06,Badajoz,58,"Garrovilla, La",2513,1264,1249
06,Badajoz,59,Granja de Torrehermosa,2269,1140,1129
06,Badajoz,60,Guareña,7289,3678,3611
06,Badajoz,61,"Haba, La",1319,663,656
06,Badajoz,62,Helechosa de los Montes,727,413,314
06,Badajoz,63,Herrera del Duque,3707,1887,1820
06,Badajoz,64,Higuera de la Serena,1025,536,489
06,Badajoz,65,Higuera de Llerena,358,180,178
06,Badajoz,66,Higuera de Vargas,2083,1061,1022
06,Badajoz,67,Higuera la Real,2461,1254,1207
06,Badajoz,68,Hinojosa del Valle,529,261,268
06,Badajoz,69,Hornachos,3812,1915,1897
06,Badajoz,70,Jerez de los Caballeros,9870,4957,4913
06,Badajoz,71,"Lapa, La",294,150,144
06,Badajoz,73,Llera,917,473,444
06,Badajoz,74,Llerena,5986,2977,3009
06,Badajoz,72,Lobón,2869,1493,1376
06,Badajoz,75,Magacela,573,302,271
06,Badajoz,76,Maguilla,1025,506,519
06,Badajoz,77,Malcocinado,426,228,198
06,Badajoz,78,Malpartida de la Serena,628,319,309
06,Badajoz,79,Manchita,765,391,374
06,Badajoz,80,Medellín,2349,1176,1173
06,Badajoz,81,Medina de las Torres,1305,658,647
06,Badajoz,82,Mengabril,472,245,227
06,Badajoz,83,Mérida,58164,28392,29772
06,Badajoz,84,Mirandilla,1362,692,670
06,Badajoz,85,Monesterio,4362,2219,2143
06,Badajoz,86,Montemolín,1494,726,768
06,Badajoz,87,Monterrubio de la Serena,2650,1284,1366
06,Badajoz,88,Montijo,16205,8046,8159
06,Badajoz,89,"Morera, La",739,368,371
06,Badajoz,90,"Nava de Santiago, La",1040,521,519
06,Badajoz,91,Navalvillar de Pela,4831,2450,2381
06,Badajoz,92,Nogales,701,351,350
06,Badajoz,93,Oliva de la Frontera,5513,2788,2725
06,Badajoz,94,Oliva de Mérida,1842,948,894
06,Badajoz,95,Olivenza,12002,5987,6015
06,Badajoz,96,Orellana de la Sierra,280,151,129
06,Badajoz,97,Orellana la Vieja,2939,1529,1410
06,Badajoz,98,Palomas,717,358,359
06,Badajoz,99,"Parra, La",1389,711,678
06,Badajoz,100,Peñalsordo,1121,554,567
06,Badajoz,101,Peraleda del Zaucejo,612,315,297
06,Badajoz,102,Puebla de Alcocer,1278,633,645
06,Badajoz,103,Puebla de la Calzada,6021,2983,3038
06,Badajoz,104,Puebla de la Reina,845,424,421
06,Badajoz,107,Puebla de Obando,1944,973,971
06,Badajoz,108,Puebla de Sancho Pérez,2856,1450,1406
06,Badajoz,105,Puebla del Maestre,780,396,384
06,Badajoz,106,Puebla del Prior,531,270,261
06,Badajoz,902,Pueblonuevo del Guadiana,2056,1037,1019
06,Badajoz,109,Quintana de la Serena,4973,2504,2469
06,Badajoz,110,Reina,194,93,101
06,Badajoz,111,Rena,669,347,322
06,Badajoz,112,Retamal de Llerena,497,261,236
06,Badajoz,113,Ribera del Fresno,3512,1747,1765
06,Badajoz,114,Risco,154,77,77
06,Badajoz,115,"Roca de la Sierra, La",1524,747,777
06,Badajoz,116,Salvaleón,1991,997,994
06,Badajoz,117,Salvatierra de los Barros,1767,870,897
06,Badajoz,119,San Pedro de Mérida,872,438,434
06,Badajoz,123,San Vicente de Alcántara,5788,2918,2870
06,Badajoz,118,Sancti-Spíritus,235,129,106
06,Badajoz,120,Santa Amalia,4297,2160,2137
06,Badajoz,121,Santa Marta,4355,2211,2144
06,Badajoz,122,"Santos de Maimona, Los",8245,4194,4051
06,Badajoz,124,Segura de León,2066,1029,1037
06,Badajoz,125,Siruela,2124,1055,1069
06,Badajoz,126,Solana de los Barros,2770,1397,1373
06,Badajoz,127,Talarrubias,3650,1829,1821
06,Badajoz,128,Talavera la Real,5603,2840,2763
06,Badajoz,129,Táliga,767,383,384
06,Badajoz,130,Tamurejo,249,126,123
06,Badajoz,131,Torre de Miguel Sesmero,1274,647,627
06,Badajoz,132,Torremayor,1044,493,551
06,Badajoz,133,Torremejía,2254,1161,1093
06,Badajoz,134,Trasierra,675,361,314
06,Badajoz,135,Trujillanos,1473,791,682
06,Badajoz,136,Usagre,1926,964,962
06,Badajoz,137,Valdecaballeros,1202,607,595
06,Badajoz,901,Valdelacalzada,2871,1486,1385
06,Badajoz,138,Valdetorres,1281,643,638
06,Badajoz,139,Valencia de las Torres,673,365,308
06,Badajoz,140,Valencia del Mombuey,797,401,396
06,Badajoz,141,Valencia del Ventoso,2158,1081,1077
06,Badajoz,146,Valle de la Serena,1399,700,699
06,Badajoz,147,Valle de Matamoros,425,209,216
06,Badajoz,148,Valle de Santa Ana,1181,585,596
06,Badajoz,142,Valverde de Burguillos,309,163,146
06,Badajoz,143,Valverde de Leganés,4238,2136,2102
06,Badajoz,144,Valverde de Llerena,676,335,341
06,Badajoz,145,Valverde de Mérida,1138,580,558
06,Badajoz,149,Villafranca de los Barros,13329,6583,6746
06,Badajoz,150,Villagarcía de la Torre,994,521,473
06,Badajoz,151,Villagonzalo,1321,645,676
06,Badajoz,152,Villalba de los Barros,1614,811,803
06,Badajoz,153,Villanueva de la Serena,26071,12763,13308
06,Badajoz,154,Villanueva del Fresno,3617,1782,1835
06,Badajoz,156,Villar de Rena,1438,745,693
06,Badajoz,155,Villar del Rey,2355,1236,1119
06,Badajoz,157,Villarta de los Montes,550,270,280
06,Badajoz,158,Zafra,16753,8110,8643
06,Badajoz,159,Zahínos,2877,1430,1447
06,Badajoz,160,Zalamea de la Serena,3884,1941,1943
06,Badajoz,162,"Zarza, La",3645,1852,1793
06,Badajoz,161,Zarza-Capilla,382,186,196
07,"Balears, Illes",2,Alaior,9610,4806,4804
07,"Balears, Illes",1,Alaró,5508,2734,2774
07,"Balears, Illes",3,Alcúdia,19586,9941,9645
07,"Balears, Illes",4,Algaida,5367,2787,2580
07,"Balears, Illes",5,Andratx,12149,6139,6010
07,"Balears, Illes",901,Ariany,877,452,425
07,"Balears, Illes",6,Artà,7629,3816,3813
07,"Balears, Illes",7,Banyalbufar,560,316,244
07,"Balears, Illes",8,Binissalem,7795,3885,3910
07,"Balears, Illes",9,Búger,1015,514,501
07,"Balears, Illes",10,Bunyola,6276,3113,3163
07,"Balears, Illes",11,Calvià,51114,25660,25454
07,"Balears, Illes",12,Campanet,2590,1267,1323
07,"Balears, Illes",13,Campos,9964,5031,4933
07,"Balears, Illes",14,Capdepera,11421,5822,5599
07,"Balears, Illes",64,"Castell, Es",7962,4056,3906
07,"Balears, Illes",15,Ciutadella de Menorca,29580,14795,14785
07,"Balears, Illes",16,Consell,3861,1983,1878
07,"Balears, Illes",17,Costitx,1159,589,570
07,"Balears, Illes",18,Deyá,747,387,360
07,"Balears, Illes",26,Eivissa,49768,25523,24245
07,"Balears, Illes",19,Escorca,267,152,115
07,"Balears, Illes",20,Esporles,4915,2425,2490
07,"Balears, Illes",21,Estellencs,380,199,181
07,"Balears, Illes",22,Felanitx,18388,9347,9041
07,"Balears, Illes",23,Ferreries,4670,2374,2296
07,"Balears, Illes",24,Formentera,10757,5635,5122
07,"Balears, Illes",25,Fornalutx,692,352,340
07,"Balears, Illes",27,Inca,30066,15174,14892
07,"Balears, Illes",28,Lloret de Vistalegre,1346,681,665
07,"Balears, Illes",29,Lloseta,5674,2859,2815
07,"Balears, Illes",30,Llubí,2294,1141,1153
07,"Balears, Illes",31,Llucmajor,36994,18729,18265
07,"Balears, Illes",33,Manacor,40831,20500,20331
07,"Balears, Illes",34,Mancor de la Vall,1330,662,668
07,"Balears, Illes",32,Maó,28972,14296,14676
07,"Balears, Illes",35,Maria de la Salut,2152,1103,1049
07,"Balears, Illes",36,Marratxí,34583,17387,17196
07,"Balears, Illes",37,"Mercadal, Es",5396,2749,2647
07,"Balears, Illes",902,"Migjorn Gran, Es",1539,758,781
07,"Balears, Illes",38,Montuïri,2855,1451,1404
07,"Balears, Illes",39,Muro,6963,3527,3436
07,"Balears, Illes",40,Palma,407648,199491,208157
07,"Balears, Illes",41,Petra,2908,1439,1469
07,"Balears, Illes",44,"Pobla, Sa",12871,6614,6257
07,"Balears, Illes",42,Pollença,16191,8077,8114
07,"Balears, Illes",43,Porreres,5486,2833,2653
07,"Balears, Illes",45,Puigpunyent,1886,941,945
07,"Balears, Illes",59,"Salines, Ses",5227,2666,2561
07,"Balears, Illes",46,Sant Antoni de Portmany,22446,11728,10718
07,"Balears, Illes",49,Sant Joan,2047,1001,1046
07,"Balears, Illes",50,Sant Joan de Labritja,5506,2858,2648
07,"Balears, Illes",48,Sant Josep de sa Talaia,24691,12944,11747
07,"Balears, Illes",51,Sant Llorenç des Cardassar,8993,4504,4489
07,"Balears, Illes",52,Sant Lluís,7449,3766,3683
07,"Balears, Illes",53,Santa Eugènia,1702,868,834
07,"Balears, Illes",54,Santa Eulalia del Río,34946,17867,17079
07,"Balears, Illes",55,Santa Margalida,11922,6119,5803
07,"Balears, Illes",56,Santa María del Camí,6473,3213,3260
07,"Balears, Illes",57,Santanyí,13384,6832,6552
07,"Balears, Illes",58,Selva,3798,1917,1881
07,"Balears, Illes",47,Sencelles,3187,1622,1565
07,"Balears, Illes",60,Sineu,3763,1874,1889
07,"Balears, Illes",61,Sóller,14150,7134,7016
07,"Balears, Illes",62,Son Servera,12165,6145,6020
07,"Balears, Illes",63,Valldemossa,2027,1038,989
07,"Balears, Illes",65,Vilafranca de Bonany,2971,1483,1488
08,Barcelona,1,Abrera,11870,6072,5798
08,Barcelona,2,Aguilar de Segarra,250,132,118
08,Barcelona,14,Aiguafreda,2478,1198,1280
08,Barcelona,3,Alella,9610,4716,4894
08,Barcelona,4,Alpens,304,164,140
08,Barcelona,5,"Ametlla del Vallès, L'",8190,4119,4071
08,Barcelona,6,Arenys de Mar,15030,7400,7630
08,Barcelona,7,Arenys de Munt,8530,4305,4225
08,Barcelona,8,Argençola,245,141,104
08,Barcelona,9,Argentona,11914,5888,6026
08,Barcelona,10,Artés,5566,2802,2764
08,Barcelona,11,Avià,2259,1120,1139
08,Barcelona,12,Avinyó,2328,1162,1166
08,Barcelona,13,Avinyonet del Penedès,1716,923,793
08,Barcelona,15,Badalona,220977,110309,110668
08,Barcelona,904,Badia del Vallès,13563,6648,6915
08,Barcelona,16,Bagà,2396,1204,1192
08,Barcelona,17,Balenyà,3714,1865,1849
08,Barcelona,18,Balsareny,3492,1760,1732
08,Barcelona,252,Barberà del Vallès,32436,16117,16319
08,Barcelona,19,Barcelona,1620943,769819,851124
08,Barcelona,20,Begues,6520,3241,3279
08,Barcelona,21,Bellprat,91,53,38
08,Barcelona,22,Berga,16845,8313,8532
08,Barcelona,23,Bigues i Riells,8781,4489,4292
08,Barcelona,24,Borredà,594,321,273
08,Barcelona,25,"Bruc, El",2029,1090,939
08,Barcelona,26,"Brull, El",261,143,118
08,Barcelona,27,"Cabanyes, Les",947,483,464
08,Barcelona,28,Cabrera d'Anoia,1376,730,646
08,Barcelona,29,Cabrera de Mar,4532,2287,2245
08,Barcelona,30,Cabrils,7140,3496,3644
08,Barcelona,31,Calaf,3538,1848,1690
08,Barcelona,34,Calders,955,488,467
08,Barcelona,33,Caldes de Montbui,17271,8635,8636
08,Barcelona,32,Caldes d'Estrac,2773,1318,1455
08,Barcelona,35,Calella,18529,9153,9376
08,Barcelona,37,Calldetenes,2441,1250,1191
08,Barcelona,38,Callús,1909,942,967
08,Barcelona,36,Calonge de Segarra,201,101,100
08,Barcelona,39,Campins,496,251,245
08,Barcelona,40,Canet de Mar,14183,6967,7216
08,Barcelona,41,Canovelles,16090,8381,7709
08,Barcelona,42,Cànoves i Samalús,2865,1471,1394
08,Barcelona,43,Canyelles,4275,2175,2100
08,Barcelona,44,Capellades,5439,2701,2738
08,Barcelona,45,Capolat,90,38,52
08,Barcelona,46,Cardedeu,17427,8567,8860
08,Barcelona,47,Cardona,5064,2492,2572
08,Barcelona,48,Carme,866,457,409
08,Barcelona,49,Casserres,1578,796,782
08,Barcelona,57,Castell de l'Areny,73,43,30
08,Barcelona,52,Castellar de n'Hug,175,96,79
08,Barcelona,50,Castellar del Riu,174,95,79
08,Barcelona,51,Castellar del Vallès,23363,11539,11824
08,Barcelona,53,Castellbell i el Vilar,3641,1870,1771
08,Barcelona,54,Castellbisbal,12407,6338,6069
08,Barcelona,55,Castellcir,668,342,326
08,Barcelona,56,Castelldefels,62989,31213,31776
08,Barcelona,58,Castellet i la Gornal,2252,1132,1120
08,Barcelona,60,Castellfollit de Riubregós,184,100,84
08,Barcelona,59,Castellfollit del Boix,416,212,204
08,Barcelona,61,Castellgalí,2001,1044,957
08,Barcelona,62,Castellnou de Bages,1184,602,582
08,Barcelona,63,Castellolí,563,271,292
08,Barcelona,64,Castellterçol,2407,1185,1222
08,Barcelona,65,Castellví de la Marca,1650,831,819
08,Barcelona,66,Castellví de Rosanes,1757,868,889
08,Barcelona,67,Centelles,7282,3553,3729
08,Barcelona,268,Cercs,1306,660,646
08,Barcelona,266,Cerdanyola del Vallès,57892,28512,29380
08,Barcelona,68,Cervelló,8660,4346,4314
08,Barcelona,69,Collbató,4287,2216,2071
08,Barcelona,70,Collsuspina,347,184,163
08,Barcelona,71,Copons,324,158,166
08,Barcelona,72,Corbera de Llobregat,14231,7106,7125
08,Barcelona,73,Cornellà de Llobregat,87458,43108,44350
08,Barcelona,74,Cubelles,14375,7294,7081
08,Barcelona,75,Dosrius,5176,2637,2539
08,Barcelona,76,Esparreguera,21856,11160,10696
08,Barcelona,77,Esplugues de Llobregat,46726,22645,24081
08,Barcelona,78,"Espunyola, L'",255,131,124
08,Barcelona,79,"Estany, L'",398,198,200
08,Barcelona,134,Figaró-Montmany,1103,558,545
08,Barcelona,80,Fígols,46,25,21
08,Barcelona,82,Fogars de la Selva,1529,806,723
08,Barcelona,81,Fogars de Montclús,442,237,205
08,Barcelona,83,Folgueroles,2230,1122,1108
08,Barcelona,84,Fonollosa,1438,739,699
08,Barcelona,85,Font-rubí,1437,741,696
08,Barcelona,86,"Franqueses del Vallès, Les",19023,9773,9250
08,Barcelona,90,Gaià,167,90,77
08,Barcelona,87,Gallifa,200,104,96
08,Barcelona,88,"Garriga, La",15472,7482,7990
08,Barcelona,89,Gavà,46488,23022,23466
08,Barcelona,91,Gelida,7102,3553,3549
08,Barcelona,92,Gironella,5063,2500,2563
08,Barcelona,93,Gisclareny,31,16,15
08,Barcelona,94,"Granada, La",2047,1027,1020
08,Barcelona,95,Granera,83,53,30
08,Barcelona,96,Granollers,59954,29804,30150
08,Barcelona,97,Gualba,1359,689,670
08,Barcelona,99,Guardiola de Berguedà,998,524,474
08,Barcelona,100,Gurb,2580,1334,1246
08,Barcelona,101,"Hospitalet de Llobregat, L'",257057,125365,131692
08,Barcelona,162,"Hostalets de Pierola, Els",2897,1498,1399
08,Barcelona,102,Igualada,39198,19266,19932
08,Barcelona,103,Jorba,826,414,412
08,Barcelona,104,"Llacuna, La",928,506,422
08,Barcelona,105,"Llagosta, La",13612,6765,6847
08,Barcelona,107,Lliçà d'Amunt,14584,7418,7166
08,Barcelona,108,Lliçà de Vall,6394,3257,3137
08,Barcelona,106,Llinars del Vallès,9477,4688,4789
08,Barcelona,109,Lluçà,259,133,126
08,Barcelona,110,Malgrat de Mar,18504,9257,9247
08,Barcelona,111,Malla,269,135,134
08,Barcelona,112,Manlleu,20416,10180,10236
08,Barcelona,113,Manresa,76570,37560,39010
08,Barcelona,242,Marganell,308,145,163
08,Barcelona,114,Martorell,28070,14543,13527
08,Barcelona,115,Martorelles,4927,2466,2461
08,Barcelona,116,"Masies de Roda, Les",760,369,391
08,Barcelona,117,"Masies de Voltregà, Les",3144,1558,1586
08,Barcelona,118,"Masnou, El",22550,10836,11714
08,Barcelona,119,Masquefa,8373,4238,4135
08,Barcelona,120,Matadepera,8669,4342,4327
08,Barcelona,121,Mataró,124084,61859,62225
08,Barcelona,122,Mediona,2348,1180,1168
08,Barcelona,138,Moià,5793,2931,2862
08,Barcelona,123,Molins de Rei,24805,12067,12738
08,Barcelona,124,Mollet del Vallès,52242,26069,26173
08,Barcelona,128,Monistrol de Calders,700,357,343
08,Barcelona,127,Monistrol de Montserrat,2993,1533,1460
08,Barcelona,125,Montcada i Reixac,34689,17270,17419
08,Barcelona,130,Montclar,115,55,60
08,Barcelona,131,Montesquiu,921,463,458
08,Barcelona,126,Montgat,10859,5354,5505
08,Barcelona,132,Montmajor,473,243,230
08,Barcelona,133,Montmaneu,187,103,84
08,Barcelona,135,Montmeló,8830,4364,4466
08,Barcelona,136,Montornès del Vallès,16192,8259,7933
08,Barcelona,137,Montseny,303,153,150
08,Barcelona,129,Muntanyola,600,307,293
08,Barcelona,139,Mura,227,120,107
08,Barcelona,140,Navarcles,5973,2926,3047
08,Barcelona,141,Navàs,6145,3050,3095
08,Barcelona,142,"Nou de Berguedà, La",153,79,74
08,Barcelona,143,Òdena,3580,1844,1736
08,Barcelona,145,Olèrdola,3621,1877,1744
08,Barcelona,146,Olesa de Bonesvalls,1755,911,844
08,Barcelona,147,Olesa de Montserrat,23980,12069,11911
08,Barcelona,148,Olivella,3678,1941,1737
08,Barcelona,149,Olost,1188,588,600
08,Barcelona,144,Olvan,892,449,443
08,Barcelona,150,Orís,294,147,147
08,Barcelona,151,Oristà,566,279,287
08,Barcelona,152,Orpí,160,88,72
08,Barcelona,153,Òrrius,651,330,321
08,Barcelona,154,Pacs del Penedès,879,444,435
08,Barcelona,155,Palafolls,9027,4516,4511
08,Barcelona,156,Palau-solità i Plegamans,14484,7208,7276
08,Barcelona,157,Pallejà,11255,5683,5572
08,Barcelona,905,"Palma de Cervelló, La",3023,1525,1498
08,Barcelona,158,"Papiol, El",4014,1979,2035
08,Barcelona,159,Parets del Vallès,18492,9348,9144
08,Barcelona,160,Perafita,407,207,200
08,Barcelona,161,Piera,15009,7652,7357
08,Barcelona,163,Pineda de Mar,26066,13087,12979
08,Barcelona,164,"Pla del Penedès, El",1198,608,590
08,Barcelona,165,"Pobla de Claramunt, La",2258,1137,1121
08,Barcelona,166,"Pobla de Lillet, La",1249,619,630
08,Barcelona,167,Polinyà,8106,4128,3978
08,Barcelona,182,"Pont de Vilomara i Rocafort, El",3775,1961,1814
08,Barcelona,168,Pontons,531,289,242
08,Barcelona,169,"Prat de Llobregat, El",63162,31233,31929
08,Barcelona,171,Prats de Lluçanès,2659,1319,1340
08,Barcelona,170,"Prats de Rei, Els",534,286,248
08,Barcelona,230,Premià de Dalt,10289,5151,5138
08,Barcelona,172,Premià de Mar,28145,13819,14326
08,Barcelona,174,Puigdàlber,535,266,269
08,Barcelona,175,Puig-reig,4301,2107,2194
08,Barcelona,176,Pujalt,205,110,95
08,Barcelona,177,"Quar, La",62,39,23
08,Barcelona,178,Rajadell,543,281,262
08,Barcelona,179,Rellinars,735,383,352
08,Barcelona,180,Ripollet,37422,18671,18751
08,Barcelona,181,"Roca del Vallès, La",10393,5229,5164
08,Barcelona,183,Roda de Ter,6172,3038,3134
08,Barcelona,184,Rubí,74484,37120,37364
08,Barcelona,185,Rubió,227,120,107
08,Barcelona,901,Rupit i Pruit,307,159,148
08,Barcelona,187,Sabadell,207938,101530,106408
08,Barcelona,188,Sagàs,144,77,67
08,Barcelona,190,Saldes,313,180,133
08,Barcelona,191,Sallent,6875,3298,3577
08,Barcelona,194,Sant Adrià de Besòs,34482,16956,17526
08,Barcelona,195,Sant Agustí de Lluçanès,97,49,48
08,Barcelona,196,Sant Andreu de la Barca,27306,13779,13527
08,Barcelona,197,Sant Andreu de Llavaneres,10541,5225,5316
08,Barcelona,198,Sant Antoni de Vilamajor,5699,2849,2850
08,Barcelona,199,Sant Bartomeu del Grau,908,471,437
08,Barcelona,200,Sant Boi de Llobregat,83070,41092,41978
08,Barcelona,201,Sant Boi de Lluçanès,545,274,271
08,Barcelona,203,Sant Cebrià de Vallalta,3337,1741,1596
08,Barcelona,202,Sant Celoni,17076,8497,8579
08,Barcelona,204,Sant Climent de Llobregat,3900,1965,1935
08,Barcelona,205,Sant Cugat del Vallès,84946,41476,43470
08,Barcelona,206,Sant Cugat Sesgarrigues,986,499,487
08,Barcelona,207,Sant Esteve de Palautordera,2555,1247,1308
08,Barcelona,208,Sant Esteve Sesrovires,7510,3765,3745
08,Barcelona,210,Sant Feliu de Codines,6105,3094,3011
08,Barcelona,211,Sant Feliu de Llobregat,43671,21329,22342
08,Barcelona,212,Sant Feliu Sasserra,660,340,320
08,Barcelona,209,Sant Fost de Campsentelles,8441,4221,4220
08,Barcelona,213,Sant Fruitós de Bages,8227,4129,4098
08,Barcelona,215,Sant Hipòlit de Voltregà,3585,1799,1786
08,Barcelona,193,Sant Iscle de Vallalta,1322,686,636
08,Barcelona,216,Sant Jaume de Frontanyà,28,17,11
08,Barcelona,218,Sant Joan de Vilatorrada,10780,5430,5350
08,Barcelona,217,Sant Joan Despí,32792,16062,16730
08,Barcelona,903,Sant Julià de Cerdanyola,257,142,115
08,Barcelona,220,Sant Julià de Vilatorta,3024,1486,1538
08,Barcelona,221,Sant Just Desvern,15874,7547,8327
08,Barcelona,222,Sant Llorenç d'Hortons,2528,1276,1252
08,Barcelona,223,Sant Llorenç Savall,2417,1229,1188
08,Barcelona,225,Sant Martí d'Albars,106,54,52
08,Barcelona,224,Sant Martí de Centelles,1098,562,536
08,Barcelona,226,Sant Martí de Tous,1173,595,578
08,Barcelona,227,Sant Martí Sarroca,3200,1590,1610
08,Barcelona,228,Sant Martí Sesgueioles,373,188,185
08,Barcelona,229,Sant Mateu de Bages,643,332,311
08,Barcelona,231,Sant Pere de Ribes,29149,14690,14459
08,Barcelona,232,Sant Pere de Riudebitlles,2372,1191,1181
08,Barcelona,233,Sant Pere de Torelló,2469,1261,1208
08,Barcelona,234,Sant Pere de Vilamajor,4276,2156,2120
08,Barcelona,189,Sant Pere Sallavinera,163,91,72
08,Barcelona,235,Sant Pol de Mar,5073,2551,2522
08,Barcelona,236,Sant Quintí de Mediona,2146,1098,1048
08,Barcelona,237,Sant Quirze de Besora,2187,1074,1113
08,Barcelona,238,Sant Quirze del Vallès,18994,9322,9672
08,Barcelona,239,Sant Quirze Safaja,648,338,310
08,Barcelona,240,Sant Sadurní d'Anoia,12482,6126,6356
08,Barcelona,241,Sant Sadurní d'Osormort,93,51,42
08,Barcelona,98,Sant Salvador de Guardiola,3139,1610,1529
08,Barcelona,262,Sant Vicenç de Castellet,9314,4622,4692
08,Barcelona,264,Sant Vicenç de Montalt,5878,2974,2904
08,Barcelona,265,Sant Vicenç de Torelló,2029,995,1034
08,Barcelona,263,Sant Vicenç dels Horts,28084,14043,14041
08,Barcelona,243,Santa Cecília de Voltregà,178,95,83
08,Barcelona,244,Santa Coloma de Cervelló,7964,3917,4047
08,Barcelona,245,Santa Coloma de Gramenet,120593,60734,59859
08,Barcelona,246,Santa Eugènia de Berga,2269,1163,1106
08,Barcelona,247,Santa Eulàlia de Riuprimer,1199,610,589
08,Barcelona,248,Santa Eulàlia de Ronçana,7009,3501,3508
08,Barcelona,249,Santa Fe del Penedès,384,197,187
08,Barcelona,250,Santa Margarida de Montbui,9689,4849,4840
08,Barcelona,251,Santa Margarida i els Monjos,7121,3613,3508
08,Barcelona,253,Santa Maria de Besora,157,78,79
08,Barcelona,254,Santa Maria de Corcó,2193,1107,1086
08,Barcelona,256,Santa Maria de Martorelles,865,434,431
08,Barcelona,255,Santa Maria de Merlès,173,84,89
08,Barcelona,257,Santa Maria de Miralles,132,66,66
08,Barcelona,259,Santa Maria de Palautordera,9196,4714,4482
08,Barcelona,258,Santa Maria d'Oló,1048,532,516
08,Barcelona,260,Santa Perpètua de Mogoda,25606,13127,12479
08,Barcelona,261,Santa Susanna,3338,1700,1638
08,Barcelona,192,Santpedor,7187,3592,3595
08,Barcelona,267,Sentmenat,8521,4316,4205
08,Barcelona,269,Seva,3436,1760,1676
08,Barcelona,270,Sitges,29039,14479,14560
08,Barcelona,271,Sobremunt,92,45,47
08,Barcelona,272,Sora,180,99,81
08,Barcelona,273,Subirats,3076,1553,1523
08,Barcelona,274,Súria,6218,3009,3209
08,Barcelona,276,Tagamanent,322,172,150
08,Barcelona,277,Talamanca,157,89,68
08,Barcelona,278,Taradell,6212,3119,3093
08,Barcelona,275,Tavèrnoles,312,156,156
08,Barcelona,280,Tavertet,137,75,62
08,Barcelona,281,Teià,6154,3055,3099
08,Barcelona,279,Terrassa,215678,106776,108902
08,Barcelona,282,Tiana,8151,3915,4236
08,Barcelona,283,Tona,8108,4047,4061
08,Barcelona,284,Tordera,16318,8344,7974
08,Barcelona,285,Torelló,13883,6854,7029
08,Barcelona,286,"Torre de Claramunt, La",3863,2003,1860
08,Barcelona,287,Torrelavit,1392,750,642
08,Barcelona,288,Torrelles de Foix,2406,1252,1154
08,Barcelona,289,Torrelles de Llobregat,5740,2854,2886
08,Barcelona,290,Ullastrell,1981,1004,977
08,Barcelona,291,Vacarisses,6231,3239,2992
08,Barcelona,292,Vallbona d'Anoia,1432,742,690
08,Barcelona,293,Vallcebre,274,159,115
08,Barcelona,294,Vallgorguina,2640,1363,1277
08,Barcelona,295,Vallirana,14549,7257,7292
08,Barcelona,296,Vallromanes,2480,1264,1216
08,Barcelona,297,Veciana,169,96,73
08,Barcelona,298,Vic,41191,20412,20779
08,Barcelona,299,Vilada,486,253,233
08,Barcelona,301,Viladecans,65188,32420,32768
08,Barcelona,300,Viladecavalls,7411,3713,3698
08,Barcelona,305,Vilafranca del Penedès,39035,19399,19636
08,Barcelona,306,Vilalba Sasserra,703,350,353
08,Barcelona,303,Vilanova de Sau,328,163,165
08,Barcelona,302,Vilanova del Camí,12585,6367,6218
08,Barcelona,902,Vilanova del Vallès,5062,2566,2496
08,Barcelona,307,Vilanova i la Geltrú,66591,32522,34069
08,Barcelona,214,Vilassar de Dalt,8865,4377,4488
08,Barcelona,219,Vilassar de Mar,19918,9611,10307
08,Barcelona,304,Vilobí del Penedès,1106,563,543
08,Barcelona,308,Viver i Serrateix,178,93,85
48,Bizkaia,1,Abadiño,7385,3664,3721
48,Bizkaia,2,Abanto y Ciérvana-Abanto Zierbena,9708,4815,4893
48,Bizkaia,911,Ajangiz,457,235,222
48,Bizkaia,912,Alonsotegi,2845,1396,1449
48,Bizkaia,3,Amorebieta-Etxano,18513,9215,9298
48,Bizkaia,4,Amoroto,405,211,194
48,Bizkaia,5,Arakaldo,126,68,58
48,Bizkaia,6,Arantzazu,360,177,183
48,Bizkaia,93,Areatza,1226,582,644
48,Bizkaia,9,Arrankudiaga,961,473,488
48,Bizkaia,914,Arratzu,388,195,193
48,Bizkaia,10,Arrieta,551,283,268
48,Bizkaia,11,Arrigorriaga,12525,6133,6392
48,Bizkaia,23,Artea,783,390,393
48,Bizkaia,8,Artzentales,760,410,350
48,Bizkaia,91,Atxondo,1415,730,685
48,Bizkaia,70,Aulesti,669,337,332
48,Bizkaia,12,Bakio,2604,1313,1291
48,Bizkaia,90,Balmaseda,7737,3776,3961
48,Bizkaia,13,Barakaldo,100369,48739,51630
48,Bizkaia,14,Barrika,1510,743,767
48,Bizkaia,15,Basauri,41971,20452,21519
48,Bizkaia,92,Bedia,987,469,518
48,Bizkaia,16,Berango,6883,3360,3523
48,Bizkaia,17,Bermeo,17144,8474,8670
48,Bizkaia,18,Berriatua,1254,689,565
48,Bizkaia,19,Berriz,4855,2455,2400
48,Bizkaia,20,Bilbao,351629,166246,185383
48,Bizkaia,21,Busturia,1745,867,878
48,Bizkaia,901,Derio,5627,2755,2872
48,Bizkaia,26,Dima,1365,699,666
48,Bizkaia,27,Durango,28618,14095,14523
48,Bizkaia,28,Ea,886,452,434
48,Bizkaia,31,Elantxobe,402,188,214
48,Bizkaia,32,Elorrio,7283,3598,3685
48,Bizkaia,902,Erandio,24326,11910,12416
48,Bizkaia,33,Ereño,260,134,126
48,Bizkaia,34,Ermua,16278,8176,8102
48,Bizkaia,79,Errigoiti,537,296,241
48,Bizkaia,29,Etxebarri,10337,5201,5136
48,Bizkaia,30,Etxebarria,805,414,391
48,Bizkaia,906,Forua,969,492,477
48,Bizkaia,35,Fruiz,537,273,264
48,Bizkaia,36,Galdakao,29130,14367,14763
48,Bizkaia,37,Galdames,843,441,402
48,Bizkaia,38,Gamiz-Fika,1349,690,659
48,Bizkaia,39,Garai,342,171,171
48,Bizkaia,40,Gatika,1623,829,794
48,Bizkaia,41,Gautegiz Arteaga,910,470,440
48,Bizkaia,46,Gernika-Lumo,16812,8113,8699
48,Bizkaia,44,Getxo,80026,37676,42350
48,Bizkaia,47,Gizaburuaga,204,99,105
48,Bizkaia,42,Gordexola,1733,874,859
48,Bizkaia,43,Gorliz,5532,2732,2800
48,Bizkaia,45,Güeñes,6483,3189,3294
48,Bizkaia,48,Ibarrangelu,641,317,324
48,Bizkaia,94,Igorre,4235,2061,2174
48,Bizkaia,49,Ispaster,704,360,344
48,Bizkaia,910,Iurreta,3884,1931,1953
48,Bizkaia,50,Izurtza,276,168,108
48,Bizkaia,22,Karrantza Harana/Valle de Carranza,2806,1454,1352
48,Bizkaia,907,Kortezubi,423,210,213
48,Bizkaia,51,Lanestosa,264,136,128
48,Bizkaia,52,Larrabetzu,1974,968,1006
48,Bizkaia,53,Laukiz,1149,587,562
48,Bizkaia,54,Leioa,30626,14947,15679
48,Bizkaia,57,Lekeitio,7419,3643,3776
48,Bizkaia,55,Lemoa,3451,1732,1719
48,Bizkaia,56,Lemoiz,1083,572,511
48,Bizkaia,81,Lezama,2476,1212,1264
48,Bizkaia,903,Loiu,2498,1248,1250
48,Bizkaia,58,Mallabia,1198,605,593
48,Bizkaia,59,Mañaria,507,272,235
48,Bizkaia,60,Markina-Xemein,4969,2566,2403
48,Bizkaia,61,Maruri-Jatabe,961,488,473
48,Bizkaia,62,Mendata,378,201,177
48,Bizkaia,63,Mendexa,439,223,216
48,Bizkaia,64,Meñaka,754,377,377
48,Bizkaia,66,Morga,406,212,194
48,Bizkaia,68,Mundaka,1940,939,1001
48,Bizkaia,69,Mungia,16912,8287,8625
48,Bizkaia,7,Munitibar-Arbatzegi Gerrikaitz,438,236,202
48,Bizkaia,908,Murueta,302,160,142
48,Bizkaia,71,Muskiz,7541,3755,3786
48,Bizkaia,67,Muxika,1468,754,714
48,Bizkaia,909,Nabarniz,227,118,109
48,Bizkaia,73,Ondarroa,8838,4466,4372
48,Bizkaia,75,Orozko,2549,1255,1294
48,Bizkaia,83,Ortuella,8416,4081,4335
48,Bizkaia,72,Otxandio,1302,685,617
48,Bizkaia,77,Plentzia,4314,2077,2237
48,Bizkaia,78,Portugalete,47756,22956,24800
48,Bizkaia,82,Santurtzi,47129,22862,24267
48,Bizkaia,84,Sestao,28831,14002,14829
48,Bizkaia,904,Sondika,4548,2192,2356
48,Bizkaia,85,Sopelana,12912,6374,6538
48,Bizkaia,86,Sopuerta,2604,1332,1272
48,Bizkaia,76,Sukarrieta,357,186,171
48,Bizkaia,87,Trucios-Turtzioz,538,284,254
48,Bizkaia,88,Ubide,184,91,93
48,Bizkaia,65,Ugao-Miraballes,4059,2036,2023
48,Bizkaia,89,Urduliz,3631,1797,1834
48,Bizkaia,74,Urduña/Orduña,4237,2165,2072
48,Bizkaia,80,Valle de Trápaga-Trapagaran,12189,5976,6213
48,Bizkaia,95,Zaldibar,3062,1533,1529
48,Bizkaia,96,Zalla,8442,4144,4298
48,Bizkaia,905,Zamudio,3281,1644,1637
48,Bizkaia,97,Zaratamo,1663,831,832
48,Bizkaia,24,Zeanuri,1312,671,641
48,Bizkaia,25,Zeberio,1075,530,545
48,Bizkaia,913,Zierbena,1461,773,688
48,Bizkaia,915,Ziortza-Bolibar,418,221,197
09,Burgos,1,Abajas,29,18,11
09,Burgos,3,Adrada de Haza,243,127,116
09,Burgos,6,Aguas Cándidas,65,41,24
09,Burgos,7,Aguilar de Bureba,66,39,27
09,Burgos,9,Albillos,218,116,102
09,Burgos,10,Alcocero de Mola,32,23,9
09,Burgos,11,Alfoz de Bricia,87,49,38
09,Burgos,907,Alfoz de Quintanadueñas,1994,1076,918
09,Burgos,12,Alfoz de Santa Gadea,114,66,48
09,Burgos,13,Altable,48,25,23
09,Burgos,14,"Altos, Los",199,118,81
09,Burgos,16,Ameyugo,100,55,45
09,Burgos,17,Anguix,133,79,54
09,Burgos,18,Aranda de Duero,33459,16519,16940
09,Burgos,19,Arandilla,177,109,68
09,Burgos,20,Arauzo de Miel,368,205,163
09,Burgos,21,Arauzo de Salce,70,40,30
09,Burgos,22,Arauzo de Torre,90,49,41
09,Burgos,23,Arcos,1410,768,642
09,Burgos,24,Arenillas de Riopisuerga,189,109,80
09,Burgos,25,Arija,156,83,73
09,Burgos,26,Arlanzón,439,258,181
09,Burgos,27,Arraya de Oca,53,31,22
09,Burgos,29,Atapuerca,202,118,84
09,Burgos,30,"Ausines, Los",151,85,66
09,Burgos,32,Avellanosa de Muñó,119,65,54
09,Burgos,33,Bahabón de Esgueva,111,67,44
09,Burgos,34,"Balbases, Los",338,189,149
09,Burgos,35,Baños de Valdearados,378,223,155
09,Burgos,36,Bañuelos de Bureba,33,22,11
09,Burgos,37,Barbadillo de Herreros,121,71,50
09,Burgos,38,Barbadillo del Mercado,155,86,69
09,Burgos,39,Barbadillo del Pez,91,57,34
09,Burgos,41,Barrio de Muñó,34,18,16
09,Burgos,43,"Barrios de Bureba, Los",215,132,83
09,Burgos,44,Barrios de Colina,57,28,29
09,Burgos,45,Basconcillos del Tozo,317,184,133
09,Burgos,46,Bascuñana,45,29,16
09,Burgos,47,Belbimbre,76,40,36
09,Burgos,48,Belorado,2082,1087,995
09,Burgos,50,Berberana,70,37,33
09,Burgos,51,Berlangas de Roa,192,103,89
09,Burgos,52,Berzosa de Bureba,33,24,9
09,Burgos,54,Bozoó,113,62,51
09,Burgos,55,Brazacorta,75,40,35
09,Burgos,56,Briviesca,7627,3919,3708
09,Burgos,57,Bugedo,193,126,67
09,Burgos,58,Buniel,508,283,225
09,Burgos,59,Burgos,179906,86364,93542
09,Burgos,60,Busto de Bureba,189,107,82
09,Burgos,61,Cabañes de Esgueva,202,103,99
09,Burgos,62,Cabezón de la Sierra,52,21,31
09,Burgos,64,Caleruega,506,253,253
09,Burgos,65,Campillo de Aranda,181,107,74
09,Burgos,66,Campolara,59,41,18
09,Burgos,67,Canicosa de la Sierra,554,296,258
09,Burgos,68,Cantabrana,31,18,13
09,Burgos,70,Carazo,41,27,14
09,Burgos,71,Carcedo de Bureba,50,28,22
09,Burgos,72,Carcedo de Burgos,367,210,157
09,Burgos,73,Cardeñadijo,1220,664,556
09,Burgos,74,Cardeñajimeno,994,539,455
09,Burgos,75,Cardeñuela Riopico,148,86,62
09,Burgos,76,Carrias,27,23,4
09,Burgos,77,Cascajares de Bureba,35,21,14
09,Burgos,78,Cascajares de la Sierra,41,21,20
09,Burgos,79,Castellanos de Castro,53,32,21
09,Burgos,83,Castil de Peones,33,19,14
09,Burgos,82,Castildelgado,49,27,22
09,Burgos,84,Castrillo de la Reina,217,141,76
09,Burgos,85,Castrillo de la Vega,644,344,300
09,Burgos,88,Castrillo de Riopisuerga,71,45,26
09,Burgos,86,Castrillo del Val,805,473,332
09,Burgos,90,Castrillo Matajudíos,64,35,29
09,Burgos,91,Castrojeriz,849,435,414
09,Burgos,63,Cavia,283,166,117
09,Burgos,93,Cayuela,188,105,83
09,Burgos,94,Cebrecos,51,32,19
09,Burgos,95,Celada del Camino,98,53,45
09,Burgos,98,Cerezo de Río Tirón,624,341,283
09,Burgos,100,Cerratón de Juarros,55,36,19
09,Burgos,101,Ciadoncha,69,45,24
09,Burgos,102,Cillaperlata,46,30,16
09,Burgos,103,Cilleruelo de Abajo,268,142,126
09,Burgos,104,Cilleruelo de Arriba,63,34,29
09,Burgos,105,Ciruelos de Cervera,117,63,54
09,Burgos,108,Cogollos,498,281,217
09,Burgos,109,Condado de Treviño,1465,838,627
09,Burgos,110,Contreras,98,61,37
09,Burgos,112,Coruña del Conde,125,78,47
09,Burgos,113,Covarrubias,626,334,292
09,Burgos,114,Cubillo del Campo,103,58,45
09,Burgos,115,Cubo de Bureba,110,61,49
09,Burgos,117,"Cueva de Roa, La",112,58,54
09,Burgos,119,Cuevas de San Clemente,56,22,34
09,Burgos,120,Encío,51,29,22
09,Burgos,122,Espinosa de Cervera,98,61,37
09,Burgos,124,Espinosa de los Monteros,2007,1095,912
09,Burgos,123,Espinosa del Camino,39,21,18
09,Burgos,125,Estépar,705,415,290
09,Burgos,127,Fontioso,56,29,27
09,Burgos,128,Frandovínez,107,59,48
09,Burgos,129,Fresneda de la Sierra Tirón,136,93,43
09,Burgos,130,Fresneña,94,54,40
09,Burgos,131,Fresnillo de las Dueñas,560,298,262
09,Burgos,132,Fresno de Río Tirón,185,104,81
09,Burgos,133,Fresno de Rodilla,46,28,18
09,Burgos,134,Frías,277,151,126
09,Burgos,135,Fuentebureba,43,19,24
09,Burgos,136,Fuentecén,237,137,100
09,Burgos,137,Fuentelcésped,225,112,113
09,Burgos,138,Fuentelisendo,107,59,48
09,Burgos,139,Fuentemolinos,106,69,37
09,Burgos,140,Fuentenebro,152,93,59
09,Burgos,141,Fuentespina,757,402,355
09,Burgos,143,Galbarros,30,21,9
09,Burgos,144,"Gallega, La",65,39,26
09,Burgos,148,Grijalba,120,59,61
09,Burgos,149,Grisaleña,39,27,12
09,Burgos,151,Gumiel de Izán,618,348,270
09,Burgos,152,Gumiel de Mercado,363,201,162
09,Burgos,154,Hacinas,177,97,80
09,Burgos,155,Haza,26,15,11
09,Burgos,159,Hontanas,73,44,29
09,Burgos,160,Hontangas,115,70,45
09,Burgos,162,Hontoria de la Cantera,135,76,59
09,Burgos,164,Hontoria de Valdearados,219,137,82
09,Burgos,163,Hontoria del Pinar,773,425,348
09,Burgos,166,"Hormazas, Las",109,60,49
09,Burgos,167,Hornillos del Camino,57,32,25
09,Burgos,168,"Horra, La",386,199,187
09,Burgos,169,Hortigüela,101,63,38
09,Burgos,170,Hoyales de Roa,237,120,117
09,Burgos,172,Huérmeces,128,65,63
09,Burgos,173,Huerta de Arriba,135,75,60
09,Burgos,174,Huerta de Rey,1064,575,489
09,Burgos,175,Humada,142,88,54
09,Burgos,176,Hurones,75,46,29
09,Burgos,177,Ibeas de Juarros,1456,798,658
09,Burgos,178,Ibrillos,61,34,27
09,Burgos,179,Iglesiarrubia,49,29,20
09,Burgos,180,Iglesias,143,80,63
09,Burgos,181,Isar,364,183,181
09,Burgos,182,Itero del Castillo,104,55,49
09,Burgos,183,Jaramillo de la Fuente,57,34,23
09,Burgos,184,Jaramillo Quemado,4,2,2
09,Burgos,189,Junta de Traslaloma,152,77,75
09,Burgos,190,Junta de Villalba de Losa,104,56,48
09,Burgos,191,Jurisdicción de Lara,44,25,19
09,Burgos,192,Jurisdicción de San Zadornil,68,36,32
09,Burgos,194,Lerma,2886,1456,1430
09,Burgos,195,Llano de Bureba,65,34,31
09,Burgos,196,Madrigal del Monte,171,103,68
09,Burgos,197,Madrigalejo del Monte,182,115,67
09,Burgos,198,Mahamud,141,80,61
09,Burgos,199,Mambrilla de Castrejón,107,58,49
09,Burgos,200,Mambrillas de Lara,57,33,24
09,Burgos,201,Mamolar,35,23,12
09,Burgos,202,Manciles,25,17,8
09,Burgos,206,Mazuela,68,36,32
09,Burgos,208,Mecerreyes,298,158,140
09,Burgos,209,Medina de Pomar,6238,3240,2998
09,Burgos,211,Melgar de Fernamental,1826,977,849
09,Burgos,213,Merindad de Cuesta-Urria,409,210,199
09,Burgos,214,Merindad de Montija,848,495,353
09,Burgos,906,Merindad de Río Ubierna,1411,778,633
09,Burgos,215,Merindad de Sotoscueva,464,259,205
09,Burgos,216,Merindad de Valdeporres,461,241,220
09,Burgos,217,Merindad de Valdivielso,432,250,182
09,Burgos,218,Milagros,505,271,234
09,Burgos,219,Miranda de Ebro,38400,19194,19206
09,Burgos,220,Miraveche,86,54,32
09,Burgos,221,Modúbar de la Emparedada,604,339,265
09,Burgos,223,Monasterio de la Sierra,48,30,18
09,Burgos,224,Monasterio de Rodilla,200,115,85
09,Burgos,225,Moncalvillo,102,59,43
09,Burgos,226,Monterrubio de la Demanda,68,40,28
09,Burgos,227,Montorio,184,105,79
09,Burgos,228,Moradillo de Roa,199,106,93
09,Burgos,229,Nava de Roa,238,121,117
09,Burgos,230,Navas de Bureba,41,18,23
09,Burgos,231,Nebreda,73,49,24
09,Burgos,232,Neila,206,113,93
09,Burgos,235,Olmedillo de Roa,187,107,80
09,Burgos,236,Olmillos de Muñó,41,23,18
09,Burgos,238,Oña,1168,608,560
09,Burgos,239,Oquillas,62,34,28
09,Burgos,241,Orbaneja Riopico,233,124,109
09,Burgos,242,Padilla de Abajo,93,51,42
09,Burgos,243,Padilla de Arriba,89,57,32
09,Burgos,244,Padrones de Bureba,49,26,23
09,Burgos,246,Palacios de la Sierra,791,395,396
09,Burgos,247,Palacios de Riopisuerga,33,14,19
09,Burgos,248,Palazuelos de la Sierra,66,41,25
09,Burgos,249,Palazuelos de Muñó,60,31,29
09,Burgos,250,Pampliega,363,190,173
09,Burgos,251,Pancorbo,501,273,228
09,Burgos,253,Pardilla,124,72,52
09,Burgos,255,Partido de la Sierra en Tobalina,92,56,36
09,Burgos,256,Pedrosa de Duero,472,275,197
09,Burgos,259,Pedrosa de Río Úrbel,263,160,103
09,Burgos,257,Pedrosa del Páramo,101,59,42
09,Burgos,258,Pedrosa del Príncipe,173,93,80
09,Burgos,261,Peñaranda de Duero,578,291,287
09,Burgos,262,Peral de Arlanza,160,83,77
09,Burgos,265,Piérnigas,44,31,13
09,Burgos,266,Pineda de la Sierra,99,58,41
09,Burgos,267,Pineda Trasmonte,138,82,56
09,Burgos,268,Pinilla de los Barruecos,126,77,49
09,Burgos,269,Pinilla de los Moros,41,25,16
09,Burgos,270,Pinilla Trasmonte,192,107,85
09,Burgos,272,Poza de la Sal,357,179,178
09,Burgos,273,Prádanos de Bureba,61,37,24
09,Burgos,274,Pradoluengo,1384,686,698
09,Burgos,275,Presencio,184,102,82
09,Burgos,276,"Puebla de Arganzón, La",534,301,233
09,Burgos,277,Puentedura,133,84,49
09,Burgos,279,Quemada,264,154,110
09,Burgos,281,Quintana del Pidio,181,94,87
09,Burgos,280,Quintanabureba,35,21,14
09,Burgos,283,Quintanaélez,62,34,28
09,Burgos,287,Quintanaortuño,261,140,121
09,Burgos,288,Quintanapalla,114,67,47
09,Burgos,289,Quintanar de la Sierra,1998,1057,941
09,Burgos,292,Quintanavides,97,54,43
09,Burgos,294,Quintanilla de la Mata,147,83,64
09,Burgos,901,Quintanilla del Agua y Tordueles,504,263,241
09,Burgos,295,Quintanilla del Coco,70,35,35
09,Burgos,298,Quintanilla San García,107,58,49
09,Burgos,301,Quintanilla Vivar,770,408,362
09,Burgos,297,"Quintanillas, Las",394,223,171
09,Burgos,302,Rabanera del Pinar,117,67,50
09,Burgos,303,Rábanos,93,53,40
09,Burgos,304,Rabé de las Calzadas,227,114,113
09,Burgos,306,Rebolledo de la Torre,131,68,63
09,Burgos,307,Redecilla del Camino,127,69,58
09,Burgos,308,Redecilla del Campo,78,44,34
09,Burgos,309,Regumiel de la Sierra,392,197,195
09,Burgos,310,Reinoso,13,10,3
09,Burgos,311,Retuerta,74,45,29
09,Burgos,314,Revilla del Campo,112,71,41
09,Burgos,316,Revilla Vallejera,97,58,39
09,Burgos,312,"Revilla y Ahedo, La",122,68,54
09,Burgos,315,Revillarruz,485,248,237
09,Burgos,317,Rezmondo,16,7,9
09,Burgos,318,Riocavado de la Sierra,59,36,23
09,Burgos,321,Roa,2450,1259,1191
09,Burgos,323,Rojas,74,49,25
09,Burgos,325,Royuela de Río Franco,228,134,94
09,Burgos,326,Rubena,181,107,74
09,Burgos,327,Rublacedo de Abajo,33,17,16
09,Burgos,328,Rucandio,78,41,37
09,Burgos,329,Salas de Bureba,135,81,54
09,Burgos,330,Salas de los Infantes,2146,1117,1029
09,Burgos,332,Saldaña de Burgos,189,101,88
09,Burgos,334,Salinillas de Bureba,51,36,15
09,Burgos,335,San Adrián de Juarros,71,47,24
09,Burgos,337,San Juan del Monte,156,88,68
09,Burgos,338,San Mamés de Burgos,307,175,132
09,Burgos,339,San Martín de Rubiales,169,104,65
09,Burgos,340,San Millán de Lara,73,54,19
09,Burgos,360,San Vicente del Valle,36,23,13
09,Burgos,343,Santa Cecilia,105,63,42
09,Burgos,345,Santa Cruz de la Salceda,169,99,70
09,Burgos,346,Santa Cruz del Valle Urbión,101,62,39
09,Burgos,347,Santa Gadea del Cid,169,94,75
09,Burgos,348,Santa Inés,162,88,74
09,Burgos,350,Santa María del Campo,633,340,293
09,Burgos,351,Santa María del Invierno,62,44,18
09,Burgos,352,Santa María del Mercadillo,136,77,59
09,Burgos,353,Santa María Rivarredonda,95,59,36
09,Burgos,354,Santa Olalla de Bureba,33,24,9
09,Burgos,355,Santibáñez de Esgueva,118,61,57
09,Burgos,356,Santibáñez del Val,62,40,22
09,Burgos,358,Santo Domingo de Silos,310,188,122
09,Burgos,361,Sargentes de la Lora,138,78,60
09,Burgos,362,Sarracín,270,147,123
09,Burgos,363,Sasamón,1144,635,509
09,Burgos,365,"Sequera de Haza, La",44,26,18
09,Burgos,366,Solarana,95,49,46
09,Burgos,368,Sordillos,25,16,9
09,Burgos,369,Sotillo de la Ribera,558,305,253
09,Burgos,372,Sotragero,286,159,127
09,Burgos,373,Sotresgudo,515,296,219
09,Burgos,374,Susinos del Páramo,117,72,45
09,Burgos,375,Tamarón,46,28,18
09,Burgos,377,Tardajos,834,426,408
09,Burgos,378,Tejada,35,24,11
09,Burgos,380,Terradillos de Esgueva,104,53,51
09,Burgos,381,Tinieblas de la Sierra,43,24,19
09,Burgos,382,Tobar,29,17,12
09,Burgos,384,Tordómar,358,194,164
09,Burgos,386,Torrecilla del Monte,82,45,37
09,Burgos,387,Torregalindo,133,78,55
09,Burgos,388,Torrelara,32,20,12
09,Burgos,389,Torrepadre,78,48,30
09,Burgos,390,Torresandino,724,395,329
09,Burgos,391,Tórtoles de Esgueva,509,277,232
09,Burgos,392,Tosantos,53,31,22
09,Burgos,394,Trespaderne,1025,560,465
09,Burgos,395,Tubilla del Agua,169,104,65
09,Burgos,396,Tubilla del Lago,172,100,72
09,Burgos,398,Úrbel del Castillo,92,60,32
09,Burgos,400,Vadocondes,388,212,176
09,Burgos,403,Valdeande,107,69,38
09,Burgos,405,Valdezate,153,80,73
09,Burgos,406,Valdorros,312,180,132
09,Burgos,408,Vallarta de Bureba,46,28,18
09,Burgos,904,Valle de las Navas,588,332,256
09,Burgos,908,Valle de Losa,565,331,234
09,Burgos,409,Valle de Manzanedo,152,83,69
09,Burgos,410,Valle de Mena,3931,2025,1906
09,Burgos,411,Valle de Oca,177,103,74
09,Burgos,902,Valle de Santibáñez,544,302,242
09,Burgos,905,Valle de Sedano,487,278,209
09,Burgos,412,Valle de Tobalina,1017,548,469
09,Burgos,413,Valle de Valdebezana,550,295,255
09,Burgos,414,Valle de Valdelaguna,199,115,84
09,Burgos,415,Valle de Valdelucio,347,184,163
09,Burgos,416,Valle de Zamanzas,76,43,33
09,Burgos,417,Vallejera,40,23,17
09,Burgos,418,Valles de Palenzuela,80,43,37
09,Burgos,419,Valluércanes,79,50,29
09,Burgos,407,Valmala,31,15,16
09,Burgos,422,"Vid de Bureba, La",23,12,11
09,Burgos,421,"Vid y Barrios, La",280,165,115
09,Burgos,423,Vileña,34,20,14
09,Burgos,427,Villadiego,1694,928,766
09,Burgos,428,Villaescusa de Roa,129,72,57
09,Burgos,429,Villaescusa la Sombría,70,52,18
09,Burgos,430,Villaespasa,17,10,7
09,Burgos,431,Villafranca Montes de Oca,132,76,56
09,Burgos,432,Villafruela,224,128,96
09,Burgos,433,Villagalijo,68,44,24
09,Burgos,434,Villagonzalo Pedernales,1676,887,789
09,Burgos,437,Villahoz,351,189,162
09,Burgos,438,Villalba de Duero,678,359,319
09,Burgos,439,Villalbilla de Burgos,1190,640,550
09,Burgos,440,Villalbilla de Gumiel,105,65,40
09,Burgos,441,Villaldemiro,76,41,35
09,Burgos,442,Villalmanzo,443,238,205
09,Burgos,443,Villamayor de los Montes,226,114,112
09,Burgos,444,Villamayor de Treviño,84,45,39
09,Burgos,445,Villambistia,46,30,16
09,Burgos,446,Villamedianilla,10,7,3
09,Burgos,447,Villamiel de la Sierra,37,22,15
09,Burgos,448,Villangómez,255,157,98
09,Burgos,449,Villanueva de Argaño,111,68,43
09,Burgos,450,Villanueva de Carazo,32,20,12
09,Burgos,451,Villanueva de Gumiel,298,153,145
09,Burgos,454,Villanueva de Teba,46,31,15
09,Burgos,455,Villaquirán de la Puebla,49,31,18
09,Burgos,456,Villaquirán de los Infantes,151,79,72
09,Burgos,903,Villarcayo de Merindad de Castilla la Vieja,4791,2556,2235
09,Burgos,458,Villariezo,569,330,239
09,Burgos,460,Villasandino,213,123,90
09,Burgos,463,Villasur de Herreros,285,166,119
09,Burgos,464,Villatuelda,50,28,22
09,Burgos,466,Villaverde del Monte,148,84,64
09,Burgos,467,Villaverde-Mogina,78,53,25
09,Burgos,471,Villayerno Morquillas,218,120,98
09,Burgos,472,Villazopeque,60,38,22
09,Burgos,473,Villegas,101,60,41
09,Burgos,476,Villoruebo,71,46,25
09,Burgos,424,Viloria de Rioja,49,27,22
09,Burgos,425,Vilviestre del Pinar,656,353,303
09,Burgos,478,Vizcaínos,53,32,21
09,Burgos,480,Zael,115,62,53
09,Burgos,482,Zarzosa de Río Pisuerga,34,21,13
09,Burgos,483,Zazuar,256,137,119
09,Burgos,485,Zuñeda,61,37,24
10,Cáceres,1,Abadía,330,182,148
10,Cáceres,2,Abertura,432,218,214
10,Cáceres,3,Acebo,648,335,313
10,Cáceres,4,Acehúche,846,413,433
10,Cáceres,5,Aceituna,626,323,303
10,Cáceres,6,Ahigal,1462,761,701
10,Cáceres,903,Alagón del Río,841,420,421
10,Cáceres,7,Albalá,773,393,380
10,Cáceres,8,Alcántara,1619,814,805
10,Cáceres,9,Alcollarín,249,115,134
10,Cáceres,10,Alcuéscar,2904,1507,1397
10,Cáceres,12,Aldea del Cano,701,341,360
10,Cáceres,13,"Aldea del Obispo, La",337,178,159
10,Cáceres,11,Aldeacentenera,710,378,332
10,Cáceres,14,Aldeanueva de la Vera,2190,1075,1115
10,Cáceres,15,Aldeanueva del Camino,799,399,400
10,Cáceres,16,Aldehuela de Jerte,380,203,177
10,Cáceres,17,Alía,964,493,471
10,Cáceres,18,Aliseda,2013,1017,996
10,Cáceres,19,Almaraz,1558,795,763
10,Cáceres,20,Almoharín,1966,958,1008
10,Cáceres,21,Arroyo de la Luz,6292,3120,3172
10,Cáceres,23,Arroyomolinos,948,489,459
10,Cáceres,22,Arroyomolinos de la Vera,490,244,246
10,Cáceres,24,Baños de Montemayor,766,375,391
10,Cáceres,25,Barrado,451,237,214
10,Cáceres,26,Belvís de Monroy,641,326,315
10,Cáceres,27,Benquerencia,86,48,38
10,Cáceres,28,Berrocalejo,140,72,68
10,Cáceres,29,Berzocana,493,251,242
10,Cáceres,30,Bohonal de Ibor,559,288,271
10,Cáceres,31,Botija,212,108,104
10,Cáceres,32,Brozas,2046,1037,1009
10,Cáceres,33,Cabañas del Castillo,474,251,223
10,Cáceres,34,Cabezabellosa,397,204,193
10,Cáceres,35,Cabezuela del Valle,2443,1266,1177
10,Cáceres,36,Cabrero,371,198,173
10,Cáceres,37,Cáceres,95668,45926,49742
10,Cáceres,38,Cachorrilla,102,54,48
10,Cáceres,39,Cadalso,484,237,247
10,Cáceres,40,Calzadilla,493,246,247
10,Cáceres,41,Caminomorisco,1211,635,576
10,Cáceres,42,Campillo de Deleitosa,68,27,41
10,Cáceres,43,Campo Lugar,982,498,484
10,Cáceres,44,Cañamero,1716,886,830
10,Cáceres,45,Cañaveral,1189,580,609
10,Cáceres,46,Carbajo,226,113,113
10,Cáceres,47,Carcaboso,1137,578,559
10,Cáceres,48,Carrascalejo,311,157,154
10,Cáceres,49,Casar de Cáceres,4796,2364,2432
10,Cáceres,50,Casar de Palomero,1419,718,701
10,Cáceres,51,Casares de las Hurdes,489,246,243
10,Cáceres,52,Casas de Don Antonio,205,98,107
10,Cáceres,53,Casas de Don Gómez,332,175,157
10,Cáceres,56,Casas de Millán,674,342,332
10,Cáceres,57,Casas de Miravete,172,102,70
10,Cáceres,54,Casas del Castañar,620,300,320
10,Cáceres,55,Casas del Monte,817,412,405
10,Cáceres,58,Casatejada,1453,753,700
10,Cáceres,59,Casillas de Coria,441,209,232
10,Cáceres,60,Castañar de Ibor,1175,621,554
10,Cáceres,61,Ceclavín,2026,1019,1007
10,Cáceres,62,Cedillo,497,258,239
10,Cáceres,63,Cerezo,185,88,97
10,Cáceres,64,Cilleros,1793,901,892
10,Cáceres,65,Collado,164,87,77
10,Cáceres,66,Conquista de la Sierra,207,115,92
10,Cáceres,67,Coria,13101,6438,6663
10,Cáceres,68,Cuacos de Yuste,894,456,438
10,Cáceres,69,"Cumbre, La",933,457,476
10,Cáceres,70,Deleitosa,799,403,396
10,Cáceres,71,Descargamaría,175,93,82
10,Cáceres,72,Eljas,980,504,476
10,Cáceres,73,Escurial,876,463,413
10,Cáceres,75,Fresnedoso de Ibor,318,165,153
10,Cáceres,76,Galisteo,1046,522,524
10,Cáceres,77,Garciaz,817,418,399
10,Cáceres,79,Garganta la Olla,1009,536,473
10,Cáceres,78,"Garganta, La",477,261,216
10,Cáceres,80,Gargantilla,426,217,209
10,Cáceres,81,Gargüera,119,64,55
10,Cáceres,82,Garrovillas de Alconétar,2246,1109,1137
10,Cáceres,83,Garvín,110,63,47
10,Cáceres,84,Gata,1639,837,802
10,Cáceres,85,"Gordo, El",395,206,189
10,Cáceres,86,"Granja, La",361,192,169
10,Cáceres,87,Guadalupe,1999,985,1014
10,Cáceres,88,Guijo de Coria,252,136,116
10,Cáceres,89,Guijo de Galisteo,1631,827,804
10,Cáceres,90,Guijo de Granadilla,607,308,299
10,Cáceres,91,Guijo de Santa Bárbara,433,225,208
10,Cáceres,92,Herguijuela,362,183,179
10,Cáceres,93,Hernán-Pérez,496,255,241
10,Cáceres,94,Herrera de Alcántara,292,146,146
10,Cáceres,95,Herreruela,365,177,188
10,Cáceres,96,Hervás,4190,2063,2127
10,Cáceres,97,Higuera,110,68,42
10,Cáceres,98,Hinojal,443,220,223
10,Cáceres,99,Holguera,742,373,369
10,Cáceres,100,Hoyos,930,467,463
10,Cáceres,101,Huélaga,211,109,102
10,Cáceres,102,Ibahernando,524,250,274
10,Cáceres,103,Jaraicejo,551,256,295
10,Cáceres,104,Jaraíz de la Vera,6727,3372,3355
10,Cáceres,105,Jarandilla de la Vera,3070,1528,1542
10,Cáceres,106,Jarilla,155,77,78
10,Cáceres,107,Jerte,1329,676,653
10,Cáceres,108,Ladrillar,204,109,95
10,Cáceres,109,Logrosán,2089,1067,1022
10,Cáceres,110,Losar de la Vera,2841,1451,1390
10,Cáceres,111,Madrigal de la Vera,1801,946,855
10,Cáceres,112,Madrigalejo,1870,929,941
10,Cáceres,113,Madroñera,2901,1440,1461
10,Cáceres,114,Majadas,1352,682,670
10,Cáceres,115,Malpartida de Cáceres,4456,2223,2233
10,Cáceres,116,Malpartida de Plasencia,4782,2397,2385
10,Cáceres,117,Marchagaz,238,125,113
10,Cáceres,118,Mata de Alcántara,328,170,158
10,Cáceres,119,Membrío,738,353,385
10,Cáceres,120,Mesas de Ibor,177,92,85
10,Cáceres,121,Miajadas,10150,5037,5113
10,Cáceres,122,Millanes,271,141,130
10,Cáceres,123,Mirabel,702,356,346
10,Cáceres,124,Mohedas de Granadilla,953,483,470
10,Cáceres,125,Monroy,1094,553,541
10,Cáceres,126,Montánchez,1936,972,964
10,Cáceres,127,Montehermoso,5884,3020,2864
10,Cáceres,128,Moraleja,7130,3554,3576
10,Cáceres,129,Morcillo,415,199,216
10,Cáceres,130,Navaconcejo,1975,997,978
10,Cáceres,131,Navalmoral de la Mata,17401,8477,8924
10,Cáceres,132,Navalvillar de Ibor,469,240,229
10,Cáceres,133,Navas del Madroño,1412,707,705
10,Cáceres,134,Navezuelas,668,348,320
10,Cáceres,135,Nuñomoral,1411,750,661
10,Cáceres,136,Oliva de Plasencia,304,169,135
10,Cáceres,137,Palomero,412,216,196
10,Cáceres,138,Pasarón de la Vera,663,318,345
10,Cáceres,139,Pedroso de Acim,110,61,49
10,Cáceres,140,Peraleda de la Mata,1434,730,704
10,Cáceres,141,Peraleda de San Román,322,159,163
10,Cáceres,142,Perales del Puerto,966,489,477
10,Cáceres,143,Pescueza,173,81,92
10,Cáceres,144,"Pesga, La",1121,586,535
10,Cáceres,145,Piedras Albas,177,93,84
10,Cáceres,146,Pinofranqueado,1670,890,780
10,Cáceres,147,Piornal,1550,780,770
10,Cáceres,148,Plasencia,41002,19975,21027
10,Cáceres,149,Plasenzuela,500,255,245
10,Cáceres,150,Portaje,401,201,200
10,Cáceres,151,Portezuelo,264,137,127
10,Cáceres,152,Pozuelo de Zarzón,552,273,279
10,Cáceres,153,Puerto de Santa Cruz,385,195,190
10,Cáceres,154,Rebollar,224,110,114
10,Cáceres,155,Riolobos,1349,710,639
10,Cáceres,156,Robledillo de Gata,116,63,53
10,Cáceres,157,Robledillo de la Vera,318,167,151
10,Cáceres,158,Robledillo de Trujillo,414,221,193
10,Cáceres,159,Robledollano,361,202,159
10,Cáceres,160,Romangordo,261,119,142
10,Cáceres,901,Rosalejo,1283,673,610
10,Cáceres,161,Ruanes,71,43,28
10,Cáceres,162,Salorino,661,341,320
10,Cáceres,163,Salvatierra de Santiago,304,150,154
10,Cáceres,164,San Martín de Trevejo,895,446,449
10,Cáceres,165,Santa Ana,282,146,136
10,Cáceres,166,Santa Cruz de la Sierra,313,156,157
10,Cáceres,167,Santa Cruz de Paniagua,291,160,131
10,Cáceres,168,Santa Marta de Magasca,306,148,158
10,Cáceres,169,Santiago de Alcántara,615,301,314
10,Cáceres,170,Santiago del Campo,288,144,144
10,Cáceres,171,Santibáñez el Alto,405,212,193
10,Cáceres,172,Santibáñez el Bajo,797,410,387
10,Cáceres,173,Saucedilla,857,464,393
10,Cáceres,174,Segura de Toro,191,90,101
10,Cáceres,175,Serradilla,1684,864,820
10,Cáceres,176,Serrejón,449,222,227
10,Cáceres,177,Sierra de Fuentes,2056,1052,1004
10,Cáceres,178,Talaván,906,454,452
10,Cáceres,179,Talaveruela de la Vera,395,200,195
10,Cáceres,180,Talayuela,9269,4988,4281
10,Cáceres,181,Tejeda de Tiétar,873,471,402
10,Cáceres,182,Toril,183,113,70
10,Cáceres,183,Tornavacas,1181,618,563
10,Cáceres,184,"Torno, El",953,504,449
10,Cáceres,187,Torre de Don Miguel,539,288,251
10,Cáceres,188,Torre de Santa María,622,315,307
10,Cáceres,185,Torrecilla de los Ángeles,682,359,323
10,Cáceres,186,Torrecillas de la Tiesa,1187,598,589
10,Cáceres,190,Torrejón el Rubio,577,297,280
10,Cáceres,189,Torrejoncillo,3195,1571,1624
10,Cáceres,191,Torremenga,652,351,301
10,Cáceres,192,Torremocha,950,469,481
10,Cáceres,193,Torreorgaz,1742,859,883
10,Cáceres,194,Torrequemada,614,292,322
10,Cáceres,195,Trujillo,9646,4727,4919
10,Cáceres,196,Valdastillas,361,192,169
10,Cáceres,197,Valdecañas de Tajo,136,71,65
10,Cáceres,198,Valdefuentes,1362,675,687
10,Cáceres,199,Valdehúncar,200,104,96
10,Cáceres,200,Valdelacasa de Tajo,468,238,230
10,Cáceres,201,Valdemorales,227,115,112
10,Cáceres,202,Valdeobispo,743,370,373
10,Cáceres,203,Valencia de Alcántara,6032,3013,3019
10,Cáceres,204,Valverde de la Vera,554,285,269
10,Cáceres,205,Valverde del Fresno,2454,1247,1207
10,Cáceres,902,Vegaviana,854,447,407
10,Cáceres,206,Viandar de la Vera,268,133,135
10,Cáceres,207,Villa del Campo,538,263,275
10,Cáceres,208,Villa del Rey,141,73,68
10,Cáceres,209,Villamesías,278,137,141
10,Cáceres,210,Villamiel,640,320,320
10,Cáceres,211,Villanueva de la Sierra,466,231,235
10,Cáceres,212,Villanueva de la Vera,2147,1081,1066
10,Cáceres,214,Villar de Plasencia,236,117,119
10,Cáceres,213,Villar del Pedroso,655,342,313
10,Cáceres,215,Villasbuenas de Gata,436,228,208
10,Cáceres,216,Zarza de Granadilla,1850,963,887
10,Cáceres,217,Zarza de Montánchez,596,293,303
10,Cáceres,218,Zarza la Mayor,1409,711,698
10,Cáceres,219,Zorita,1586,789,797
11,Cádiz,1,Alcalá de los Gazules,5500,2818,2682
11,Cádiz,2,Alcalá del Valle,5262,2662,2600
11,Cádiz,3,Algar,1467,753,714
11,Cádiz,4,Algeciras,116917,57858,59059
11,Cádiz,5,Algodonales,5768,2925,2843
11,Cádiz,6,Arcos de la Frontera,31417,15727,15690
11,Cádiz,7,Barbate,22885,11493,11392
11,Cádiz,8,"Barrios, Los",23141,11656,11485
11,Cádiz,901,Benalup-Casas Viejas,7205,3678,3527
11,Cádiz,9,Benaocaz,740,387,353
11,Cádiz,10,Bornos,8096,4025,4071
11,Cádiz,11,"Bosque, El",2070,1053,1017
11,Cádiz,12,Cádiz,123948,58755,65193
11,Cádiz,13,Castellar de la Frontera,3202,1627,1575
11,Cádiz,15,Chiclana de la Frontera,81113,40891,40222
11,Cádiz,16,Chipiona,18849,9454,9395
11,Cádiz,14,Conil de la Frontera,21927,11100,10827
11,Cádiz,17,Espera,3951,1968,1983
11,Cádiz,18,"Gastor, El",1858,967,891
11,Cádiz,19,Grazalema,2181,1102,1079
11,Cádiz,20,Jerez de la Frontera,211900,103816,108084
11,Cádiz,21,Jimena de la Frontera,10480,5416,5064
11,Cádiz,22,"Línea de la Concepción, La",64704,31979,32725
11,Cádiz,23,Medina-Sidonia,11863,6065,5798
11,Cádiz,24,Olvera,8494,4199,4295
11,Cádiz,25,Paterna de Rivera,5662,2910,2752
11,Cádiz,26,Prado del Rey,5918,2941,2977
11,Cádiz,27,"Puerto de Santa María, El",89068,43872,45196
11,Cádiz,28,Puerto Real,41364,20859,20505
11,Cádiz,29,Puerto Serrano,7196,3644,3552
11,Cádiz,30,Rota,29094,14577,14517
11,Cádiz,31,San Fernando,96772,47658,49114
11,Cádiz,902,San José del Valle,4447,2283,2164
11,Cádiz,33,San Roque,30516,15354,15162
11,Cádiz,32,Sanlúcar de Barrameda,67308,33579,33729
11,Cádiz,34,Setenil de las Bodegas,2927,1499,1428
11,Cádiz,35,Tarifa,17962,9152,8810
11,Cádiz,36,Torre Alháquime,809,416,393
11,Cádiz,37,Trebujena,7091,3582,3509
11,Cádiz,38,Ubrique,16859,8295,8564
11,Cádiz,39,Vejer de la Frontera,12857,6479,6378
11,Cádiz,40,Villaluenga del Rosario,471,251,220
11,Cádiz,41,Villamartín,12394,6191,6203
11,Cádiz,42,Zahara,1511,770,741
39,Cantabria,1,Alfoz de Lloredo,2514,1277,1237
39,Cantabria,2,Ampuero,4281,2196,2085
39,Cantabria,3,Anievas,351,175,176
39,Cantabria,4,Arenas de Iguña,1792,913,879
39,Cantabria,5,Argoños,1696,867,829
39,Cantabria,6,Arnuero,2115,1073,1042
39,Cantabria,7,Arredondo,522,294,228
39,Cantabria,8,"Astillero, El",17938,8813,9125
39,Cantabria,9,Bárcena de Cicero,4118,2145,1973
39,Cantabria,10,Bárcena de Pie de Concha,758,371,387
39,Cantabria,11,Bareyo,2060,1038,1022
39,Cantabria,12,Cabezón de la Sal,8234,4024,4210
39,Cantabria,13,Cabezón de Liébana,707,418,289
39,Cantabria,14,Cabuérniga,1066,561,505
39,Cantabria,15,Camaleño,1029,554,475
39,Cantabria,16,Camargo,31594,15594,16000
39,Cantabria,27,Campoo de Enmedio,3798,1949,1849
39,Cantabria,17,Campoo de Yuso,703,383,320
39,Cantabria,18,Cartes,5558,2834,2724
39,Cantabria,19,Castañeda,2525,1297,1228
39,Cantabria,20,Castro-Urdiales,32522,16435,16087
39,Cantabria,21,Cieza,603,306,297
39,Cantabria,22,Cillorigo de Liébana,1338,732,606
39,Cantabria,23,Colindres,8140,4029,4111
39,Cantabria,24,Comillas,2439,1154,1285
39,Cantabria,25,"Corrales de Buelna, Los",11519,5689,5830
39,Cantabria,26,Corvera de Toranzo,2159,1103,1056
39,Cantabria,28,Entrambasaguas,4655,2402,2253
39,Cantabria,29,Escalante,766,401,365
39,Cantabria,30,Guriezo,2419,1238,1181
39,Cantabria,31,Hazas de Cesto,1526,789,737
39,Cantabria,32,Hermandad de Campoo de Suso,1756,954,802
39,Cantabria,33,Herrerías,639,360,279
39,Cantabria,34,Lamasón,303,193,110
39,Cantabria,35,Laredo,12094,5826,6268
39,Cantabria,36,Liendo,1290,673,617
39,Cantabria,37,Liérganes,2441,1216,1225
39,Cantabria,38,Limpias,1897,948,949
39,Cantabria,39,Luena,694,384,310
39,Cantabria,40,Marina de Cudeyo,5278,2665,2613
39,Cantabria,41,Mazcuerras,2127,1096,1031
39,Cantabria,42,Medio Cudeyo,7571,3714,3857
39,Cantabria,43,Meruelo,1798,912,886
39,Cantabria,44,Miengo,4677,2375,2302
39,Cantabria,45,Miera,424,220,204
39,Cantabria,46,Molledo,1610,795,815
39,Cantabria,47,Noja,2653,1319,1334
39,Cantabria,48,Penagos,1929,983,946
39,Cantabria,49,Peñarrubia,367,190,177
39,Cantabria,50,Pesaguero,340,194,146
39,Cantabria,51,Pesquera,71,38,33
39,Cantabria,52,Piélagos,23211,11666,11545
39,Cantabria,53,Polaciones,252,156,96
39,Cantabria,54,Polanco,5486,2719,2767
39,Cantabria,55,Potes,1474,714,760
39,Cantabria,56,Puente Viesgo,2861,1465,1396
39,Cantabria,57,Ramales de la Victoria,2788,1429,1359
39,Cantabria,58,Rasines,1023,553,470
39,Cantabria,59,Reinosa,10071,4751,5320
39,Cantabria,60,Reocín,8318,4099,4219
39,Cantabria,61,Ribamontán al Mar,4496,2284,2212
39,Cantabria,62,Ribamontán al Monte,2186,1145,1041
39,Cantabria,63,Rionansa,1091,620,471
39,Cantabria,64,Riotuerto,1634,799,835
39,Cantabria,65,"Rozas de Valdearroyo, Las",288,159,129
39,Cantabria,66,Ruente,1041,556,485
39,Cantabria,67,Ruesga,981,524,457
39,Cantabria,68,Ruiloba,805,410,395
39,Cantabria,69,San Felices de Buelna,2355,1167,1188
39,Cantabria,70,San Miguel de Aguayo,174,89,85
39,Cantabria,71,San Pedro del Romeral,503,274,229
39,Cantabria,72,San Roque de Riomiera,412,239,173
39,Cantabria,80,San Vicente de la Barquera,4407,2210,2197
39,Cantabria,73,Santa Cruz de Bezana,12154,5970,6184
39,Cantabria,74,Santa María de Cayón,9123,4694,4429
39,Cantabria,75,Santander,178465,82544,95921
39,Cantabria,76,Santillana del Mar,4210,2061,2149
39,Cantabria,77,Santiurde de Reinosa,299,168,131
39,Cantabria,78,Santiurde de Toranzo,1604,818,786
39,Cantabria,79,Santoña,11451,5685,5766
39,Cantabria,81,Saro,510,262,248
39,Cantabria,82,Selaya,2009,1006,1003
39,Cantabria,83,Soba,1319,705,614
39,Cantabria,84,Solórzano,1025,552,473
39,Cantabria,85,Suances,8451,4217,4234
39,Cantabria,86,"Tojos, Los",428,250,178
39,Cantabria,87,Torrelavega,55297,26349,28948
39,Cantabria,88,Tresviso,74,51,23
39,Cantabria,89,Tudanca,163,113,50
39,Cantabria,90,Udías,852,431,421
39,Cantabria,95,Val de San Vicente,2844,1465,1379
39,Cantabria,91,Valdáliga,2317,1208,1109
39,Cantabria,92,Valdeolea,1133,586,547
39,Cantabria,93,Valdeprado del Río,357,198,159
39,Cantabria,94,Valderredible,1086,624,462
39,Cantabria,101,Valle de Villaverde,355,179,176
39,Cantabria,96,Vega de Liébana,842,451,391
39,Cantabria,97,Vega de Pas,824,417,407
39,Cantabria,98,Villacarriedo,1752,910,842
39,Cantabria,99,Villaescusa,3755,1884,1871
39,Cantabria,100,Villafufre,1103,578,525
39,Cantabria,102,Voto,2798,1486,1312
12,Castellón/Castelló,2,Aín,140,69,71
12,Castellón/Castelló,3,Albocàsser,1422,705,717
12,Castellón/Castelló,4,Alcalà de Xivert,8218,4237,3981
12,Castellón/Castelló,5,"Alcora, l'",10821,5455,5366
12,Castellón/Castelló,6,Alcudia de Veo,221,113,108
12,Castellón/Castelló,7,Alfondeguilla,872,441,431
12,Castellón/Castelló,8,Algimia de Almonacid,312,176,136
12,Castellón/Castelló,9,Almazora/Almassora,26137,13215,12922
12,Castellón/Castelló,10,Almedíjar,297,149,148
12,Castellón/Castelló,11,Almenara,6112,3045,3067
12,Castellón/Castelló,901,Alquerías del Niño Perdido,4509,2233,2276
12,Castellón/Castelló,12,Altura,3866,1991,1875
12,Castellón/Castelló,13,Arañuel,196,95,101
12,Castellón/Castelló,14,Ares del Maestrat,215,116,99
12,Castellón/Castelló,15,Argelita,100,54,46
12,Castellón/Castelló,16,Artana,1974,1015,959
12,Castellón/Castelló,1,Atzeneta del Maestrat,1342,699,643
12,Castellón/Castelló,17,Ayódar,206,106,100
12,Castellón/Castelló,18,Azuébar,359,184,175
12,Castellón/Castelló,20,Barracas,201,109,92
12,Castellón/Castelló,22,Bejís,415,238,177
12,Castellón/Castelló,24,Benafer,173,94,79
12,Castellón/Castelló,25,Benafigos,165,89,76
12,Castellón/Castelló,26,Benasal,1226,630,596
12,Castellón/Castelló,27,Benicarló,26677,13398,13279
12,Castellón/Castelló,28,Benicasim/Benicàssim,18753,9485,9268
12,Castellón/Castelló,29,Benlloch,1185,617,568
12,Castellón/Castelló,21,Betxí,5815,2912,2903
12,Castellón/Castelló,32,Borriana/Burriana,35598,17801,17797
12,Castellón/Castelló,31,Borriol,5231,2667,2564
12,Castellón/Castelló,33,Cabanes,2971,1524,1447
12,Castellón/Castelló,34,Càlig,2231,1138,1093
12,Castellón/Castelló,36,Canet lo Roig,836,416,420
12,Castellón/Castelló,37,Castell de Cabres,17,12,5
12,Castellón/Castelló,38,Castellfort,238,124,114
12,Castellón/Castelló,39,Castellnovo,1050,535,515
12,Castellón/Castelló,40,Castellón de la Plana/Castelló de la Plana,180204,88550,91654
12,Castellón/Castelló,41,Castillo de Villamalefa,112,70,42
12,Castellón/Castelló,42,Catí,841,425,416
12,Castellón/Castelló,43,Caudiel,739,384,355
12,Castellón/Castelló,44,Cervera del Maestre,716,347,369
12,Castellón/Castelló,52,Chert/Xert,873,438,435
12,Castellón/Castelló,53,Chilches/Xilxes,2875,1504,1371
12,Castellón/Castelló,55,Chodos/Xodos,127,70,57
12,Castellón/Castelló,56,Chóvar,355,183,172
12,Castellón/Castelló,45,Cinctorres,484,246,238
12,Castellón/Castelló,46,Cirat,247,135,112
12,Castellón/Castelló,48,Cortes de Arenoso,352,189,163
12,Castellón/Castelló,49,Costur,587,303,284
12,Castellón/Castelló,50,"Coves de Vinromà, les",2009,1002,1007
12,Castellón/Castelló,51,Culla,601,306,295
12,Castellón/Castelló,57,Eslida,928,454,474
12,Castellón/Castelló,58,Espadilla,116,58,58
12,Castellón/Castelló,59,Fanzara,351,176,175
12,Castellón/Castelló,60,Figueroles,574,291,283
12,Castellón/Castelló,61,Forcall,522,255,267
12,Castellón/Castelló,63,Fuente la Reina,57,31,26
12,Castellón/Castelló,64,Fuentes de Ayódar,149,78,71
12,Castellón/Castelló,65,Gaibiel,195,107,88
12,Castellón/Castelló,67,Geldo,687,354,333
12,Castellón/Castelló,68,Herbés,56,30,26
12,Castellón/Castelló,69,Higueras,57,29,28
12,Castellón/Castelló,70,"Jana, la",757,389,368
12,Castellón/Castelló,71,Jérica,1656,826,830
12,Castellón/Castelló,74,"Llosa, la",955,484,471
12,Castellón/Castelló,72,Lucena del Cid,1484,747,737
12,Castellón/Castelló,73,Ludiente,192,102,90
12,Castellón/Castelló,75,"Mata de Morella, la",211,107,104
12,Castellón/Castelló,76,Matet,107,53,54
12,Castellón/Castelló,77,Moncofa,6475,3347,3128
12,Castellón/Castelló,78,Montán,415,201,214
12,Castellón/Castelló,79,Montanejos,620,311,309
12,Castellón/Castelló,80,Morella,2739,1370,1369
12,Castellón/Castelló,81,Navajas,833,438,395
12,Castellón/Castelló,82,Nules,13636,6808,6828
12,Castellón/Castelló,83,Olocau del Rey,135,75,60
12,Castellón/Castelló,84,Onda,25571,12987,12584
12,Castellón/Castelló,85,Oropesa del Mar/Orpesa,9898,5254,4644
12,Castellón/Castelló,87,Palanques,31,18,13
12,Castellón/Castelló,88,Pavías,59,34,25
12,Castellón/Castelló,89,Peníscola/Peñíscola,8214,4223,3991
12,Castellón/Castelló,90,Pina de Montalgrao,149,73,76
12,Castellón/Castelló,93,"Pobla de Benifassà, la",290,156,134
12,Castellón/Castelló,94,"Pobla Tornesa, la",1166,611,555
12,Castellón/Castelló,91,Portell de Morella,234,119,115
12,Castellón/Castelló,92,Puebla de Arenoso,174,95,79
12,Castellón/Castelló,95,Ribesalbes,1317,663,654
12,Castellón/Castelló,96,Rossell,1160,612,548
12,Castellón/Castelló,97,Sacañet,77,45,32
12,Castellón/Castelló,98,"Salzadella, la",850,425,425
12,Castellón/Castelló,101,San Rafael del Río,556,284,272
12,Castellón/Castelló,902,Sant Joan de Moró,2999,1571,1428
12,Castellón/Castelló,99,Sant Jordi/San Jorge,1126,592,534
12,Castellón/Castelló,100,Sant Mateu,2112,1084,1028
12,Castellón/Castelló,102,Santa Magdalena de Pulpis,876,466,410
12,Castellón/Castelló,103,Sarratella,101,53,48
12,Castellón/Castelló,104,Segorbe,9291,4571,4720
12,Castellón/Castelló,105,Sierra Engarcerán,1066,572,494
12,Castellón/Castelló,106,Soneja,1525,757,768
12,Castellón/Castelló,107,Sot de Ferrer,447,231,216
12,Castellón/Castelló,108,Sueras/Suera,650,331,319
12,Castellón/Castelló,109,Tales,902,454,448
12,Castellón/Castelló,110,Teresa,275,138,137
12,Castellón/Castelló,111,Tírig,550,292,258
12,Castellón/Castelló,112,Todolella,148,84,64
12,Castellón/Castelló,113,Toga,140,64,76
12,Castellón/Castelló,114,Torás,258,135,123
12,Castellón/Castelló,115,"Toro, El",280,156,124
12,Castellón/Castelló,116,Torralba del Pinar,56,29,27
12,Castellón/Castelló,119,"Torre d'En Besora, la",179,100,79
12,Castellón/Castelló,120,"Torre d'en Doménec, la",241,121,120
12,Castellón/Castelló,117,Torreblanca,5737,2951,2786
12,Castellón/Castelló,118,Torrechiva,96,60,36
12,Castellón/Castelló,121,Traiguera,1654,845,809
12,Castellón/Castelló,122,"Useras/Useres, les",1017,522,495
12,Castellón/Castelló,124,Vall d'Alba,3036,1574,1462
12,Castellón/Castelló,125,Vall de Almonacid,273,144,129
12,Castellón/Castelló,126,"Vall d'Uixó, la",32782,16279,16503
12,Castellón/Castelló,123,Vallat,73,36,37
12,Castellón/Castelló,127,Vallibona,100,54,46
12,Castellón/Castelló,128,Vilafamés,1935,1015,920
12,Castellón/Castelló,132,Vilanova d'Alcolea,688,365,323
12,Castellón/Castelló,134,Vilar de Canes,187,99,88
12,Castellón/Castelló,135,Vila-real,51357,25689,25668
12,Castellón/Castelló,136,"Vilavella, la",3281,1635,1646
12,Castellón/Castelló,129,Villafranca del Cid/Vilafranca,2494,1227,1267
12,Castellón/Castelló,130,Villahermosa del Río,506,266,240
12,Castellón/Castelló,131,Villamalur,92,49,43
12,Castellón/Castelló,133,Villanueva de Viver,77,43,34
12,Castellón/Castelló,137,Villores,48,27,21
12,Castellón/Castelló,138,Vinaròs,28615,14224,14391
12,Castellón/Castelló,139,Vistabella del Maestrazgo,419,218,201
12,Castellón/Castelló,140,Viver,1666,870,796
12,Castellón/Castelló,141,Zorita del Maestrazgo,146,75,71
12,Castellón/Castelló,142,Zucaina,187,100,87
13,Ciudad Real,1,Abenójar,1579,807,772
13,Ciudad Real,2,Agudo,1854,946,908
13,Ciudad Real,3,Alamillo,517,259,258
13,Ciudad Real,4,Albaladejo,1483,775,708
13,Ciudad Real,5,Alcázar de San Juan,31992,15727,16265
13,Ciudad Real,6,Alcoba,727,369,358
13,Ciudad Real,7,Alcolea de Calatrava,1593,808,785
13,Ciudad Real,8,Alcubillas,562,287,275
13,Ciudad Real,9,Aldea del Rey,1944,1001,943
13,Ciudad Real,10,Alhambra,1097,551,546
13,Ciudad Real,11,Almadén,6034,2898,3136
13,Ciudad Real,12,Almadenejos,500,261,239
13,Ciudad Real,13,Almagro,9132,4526,4606
13,Ciudad Real,14,Almedina,652,327,325
13,Ciudad Real,15,Almodóvar del Campo,6685,3364,3321
13,Ciudad Real,16,Almuradiel,892,443,449
13,Ciudad Real,17,Anchuras,349,191,158
13,Ciudad Real,903,Arenales de San Gregorio,700,363,337
13,Ciudad Real,18,Arenas de San Juan,1091,566,525
13,Ciudad Real,19,Argamasilla de Alba,7376,3757,3619
13,Ciudad Real,20,Argamasilla de Calatrava,6018,3038,2980
13,Ciudad Real,21,Arroba de los Montes,505,273,232
13,Ciudad Real,22,Ballesteros de Calatrava,455,228,227
13,Ciudad Real,23,Bolaños de Calatrava,12233,6246,5987
13,Ciudad Real,24,Brazatortas,1106,577,529
13,Ciudad Real,25,Cabezarados,352,180,172
13,Ciudad Real,26,Cabezarrubias del Puerto,559,290,269
13,Ciudad Real,27,Calzada de Calatrava,4392,2198,2194
13,Ciudad Real,28,Campo de Criptana,14820,7520,7300
13,Ciudad Real,29,Cañada de Calatrava,118,66,52
13,Ciudad Real,30,Caracuel de Calatrava,167,92,75
13,Ciudad Real,31,Carrión de Calatrava,3021,1506,1515
13,Ciudad Real,32,Carrizosa,1430,706,724
13,Ciudad Real,33,Castellar de Santiago,2191,1094,1097
13,Ciudad Real,38,Chillón,2042,989,1053
13,Ciudad Real,34,Ciudad Real,74921,35572,39349
13,Ciudad Real,35,Corral de Calatrava,1150,578,572
13,Ciudad Real,36,"Cortijos, Los",981,510,471
13,Ciudad Real,37,Cózar,1183,598,585
13,Ciudad Real,39,Daimiel,18698,9320,9378
13,Ciudad Real,40,Fernán Caballero,1121,556,565
13,Ciudad Real,41,Fontanarejo,309,166,143
13,Ciudad Real,42,Fuencaliente,1111,584,527
13,Ciudad Real,43,Fuenllana,279,136,143
13,Ciudad Real,44,Fuente el Fresno,3627,1882,1745
13,Ciudad Real,45,Granátula de Calatrava,865,419,446
13,Ciudad Real,46,Guadalmez,906,454,452
13,Ciudad Real,47,Herencia,9067,4637,4430
13,Ciudad Real,48,Hinojosas de Calatrava,527,270,257
13,Ciudad Real,49,Horcajo de los Montes,1006,503,503
13,Ciudad Real,50,"Labores, Las",651,321,330
13,Ciudad Real,904,Llanos del Caudillo,704,360,344
13,Ciudad Real,51,Luciana,410,216,194
13,Ciudad Real,52,Malagón,8734,4358,4376
13,Ciudad Real,53,Manzanares,19237,9572,9665
13,Ciudad Real,54,Membrilla,6335,3199,3136
13,Ciudad Real,55,Mestanza,812,395,417
13,Ciudad Real,56,Miguelturra,14727,7462,7265
13,Ciudad Real,57,Montiel,1540,807,733
13,Ciudad Real,58,Moral de Calatrava,5665,2843,2822
13,Ciudad Real,59,Navalpino,260,132,128
13,Ciudad Real,60,Navas de Estena,328,186,142
13,Ciudad Real,61,Pedro Muñoz,8659,4537,4122
13,Ciudad Real,62,Picón,702,363,339
13,Ciudad Real,63,Piedrabuena,4770,2441,2329
13,Ciudad Real,64,Poblete,2056,1066,990
13,Ciudad Real,65,Porzuna,4091,2106,1985
13,Ciudad Real,66,Pozuelo de Calatrava,3363,1717,1646
13,Ciudad Real,67,"Pozuelos de Calatrava, Los",452,234,218
13,Ciudad Real,68,Puebla de Don Rodrigo,1237,658,579
13,Ciudad Real,69,Puebla del Príncipe,790,393,397
13,Ciudad Real,70,Puerto Lápice,1019,514,505
13,Ciudad Real,71,Puertollano,51997,25372,26625
13,Ciudad Real,72,Retuerta del Bullaque,1096,602,494
13,Ciudad Real,901,"Robledo, El",1281,679,602
13,Ciudad Real,902,Ruidera,587,300,287
13,Ciudad Real,73,Saceruela,620,326,294
13,Ciudad Real,74,San Carlos del Valle,1208,623,585
13,Ciudad Real,75,San Lorenzo de Calatrava,235,120,115
13,Ciudad Real,76,Santa Cruz de los Cáñamos,593,298,295
13,Ciudad Real,77,Santa Cruz de Mudela,4568,2280,2288
13,Ciudad Real,78,Socuéllamos,13792,7114,6678
13,Ciudad Real,80,Solana del Pino,405,210,195
13,Ciudad Real,79,"Solana, La",16201,8220,7981
13,Ciudad Real,81,Terrinches,883,489,394
13,Ciudad Real,82,Tomelloso,39093,19736,19357
13,Ciudad Real,83,Torralba de Calatrava,3179,1566,1613
13,Ciudad Real,84,Torre de Juan Abad,1196,578,618
13,Ciudad Real,85,Torrenueva,2972,1491,1481
13,Ciudad Real,86,Valdemanco del Esteras,223,117,106
13,Ciudad Real,87,Valdepeñas,31212,15393,15819
13,Ciudad Real,88,Valenzuela de Calatrava,752,349,403
13,Ciudad Real,89,Villahermosa,2180,1041,1139
13,Ciudad Real,90,Villamanrique,1370,690,680
13,Ciudad Real,91,Villamayor de Calatrava,636,316,320
13,Ciudad Real,92,Villanueva de la Fuente,2430,1250,1180
13,Ciudad Real,93,Villanueva de los Infantes,5727,2842,2885
13,Ciudad Real,94,Villanueva de San Carlos,356,190,166
13,Ciudad Real,95,Villar del Pozo,94,51,43
13,Ciudad Real,96,Villarrubia de los Ojos,11116,5615,5501
13,Ciudad Real,97,Villarta de San Juan,3066,1558,1508
13,Ciudad Real,98,Viso del Marqués,2721,1357,1364
14,Córdoba,1,Adamuz,4446,2289,2157
14,Córdoba,2,Aguilar de la Frontera,13701,6920,6781
14,Córdoba,3,Alcaracejos,1545,760,785
14,Córdoba,4,Almedinilla,2523,1279,1244
14,Córdoba,5,Almodóvar del Río,8000,4032,3968
14,Córdoba,6,Añora,1556,775,781
14,Córdoba,7,Baena,20266,10329,9937
14,Córdoba,8,Belalcázar,3486,1679,1807
14,Córdoba,9,Belmez,3162,1548,1614
14,Córdoba,10,Benamejí,5158,2562,2596
14,Córdoba,11,"Blázquez, Los",727,377,350
14,Córdoba,12,Bujalance,7896,3926,3970
14,Córdoba,13,Cabra,21136,10436,10700
14,Córdoba,14,Cañete de las Torres,3124,1605,1519
14,Córdoba,15,Carcabuey,2659,1352,1307
14,Córdoba,16,Cardeña,1669,845,824
14,Córdoba,17,"Carlota, La",13743,6918,6825
14,Córdoba,18,"Carpio, El",4555,2254,2301
14,Córdoba,19,Castro del Río,8087,4010,4077
14,Córdoba,20,Conquista,461,227,234
14,Córdoba,21,Córdoba,328841,158109,170732
14,Córdoba,22,Doña Mencía,4994,2449,2545
14,Córdoba,23,Dos Torres,2524,1245,1279
14,Córdoba,24,Encinas Reales,2391,1192,1199
14,Córdoba,25,Espejo,3563,1801,1762
14,Córdoba,26,Espiel,2464,1240,1224
14,Córdoba,27,Fernán-Núñez,9826,4939,4887
14,Córdoba,28,Fuente la Lancha,369,191,178
14,Córdoba,29,Fuente Obejuna,5129,2620,2509
14,Córdoba,30,Fuente Palmera,11076,5599,5477
14,Córdoba,31,Fuente-Tójar,746,355,391
14,Córdoba,32,"Granjuela, La",510,257,253
14,Córdoba,33,Guadalcázar,1617,810,807
14,Córdoba,34,"Guijo, El",411,212,199
14,Córdoba,35,Hinojosa del Duque,7250,3528,3722
14,Córdoba,36,Hornachuelos,4694,2367,2327
14,Córdoba,37,Iznájar,4712,2373,2339
14,Córdoba,38,Lucena,42592,21203,21389
14,Córdoba,39,Luque,3309,1665,1644
14,Córdoba,40,Montalbán de Córdoba,4635,2338,2297
14,Córdoba,41,Montemayor,4123,2067,2056
14,Córdoba,42,Montilla,23836,11788,12048
14,Córdoba,43,Montoro,9834,4849,4985
14,Córdoba,44,Monturque,2004,988,1016
14,Córdoba,45,Moriles,3907,1936,1971
14,Córdoba,46,Nueva Carteya,5650,2853,2797
14,Córdoba,47,Obejo,2025,1049,976
14,Córdoba,48,Palenciana,1623,815,808
14,Córdoba,49,Palma del Río,21547,10735,10812
14,Córdoba,50,Pedro Abad,2971,1503,1468
14,Córdoba,51,Pedroche,1633,810,823
14,Córdoba,52,Peñarroya-Pueblonuevo,11651,5628,6023
14,Córdoba,53,Posadas,7594,3795,3799
14,Córdoba,54,Pozoblanco,17683,8653,9030
14,Córdoba,55,Priego de Córdoba,23456,11535,11921
14,Córdoba,56,Puente Genil,30385,15121,15264
14,Córdoba,57,"Rambla, La",7621,3816,3805
14,Córdoba,58,Rute,10601,5273,5328
14,Córdoba,59,San Sebastián de los Ballesteros,833,419,414
14,Córdoba,61,Santa Eufemia,921,468,453
14,Córdoba,60,Santaella,6136,3101,3035
14,Córdoba,62,Torrecampo,1249,610,639
14,Córdoba,63,Valenzuela,1317,646,671
14,Córdoba,64,Valsequillo,399,197,202
14,Córdoba,65,"Victoria, La",2379,1182,1197
14,Córdoba,66,Villa del Río,7463,3745,3718
14,Córdoba,67,Villafranca de Córdoba,4832,2483,2349
14,Córdoba,68,Villaharta,754,378,376
14,Córdoba,69,Villanueva de Córdoba,9440,4699,4741
14,Córdoba,70,Villanueva del Duque,1611,798,813
14,Córdoba,71,Villanueva del Rey,1167,589,578
14,Córdoba,72,Villaralto,1282,624,658
14,Córdoba,73,Villaviciosa de Córdoba,3514,1784,1730
14,Córdoba,74,"Viso, El",2763,1371,1392
14,Córdoba,75,Zuheros,741,376,365
15,"Coruña, A",1,Abegondo,5709,2827,2882
15,"Coruña, A",2,Ames,29331,14170,15161
15,"Coruña, A",3,Aranga,2072,1038,1034
15,"Coruña, A",4,Ares,5839,2872,2967
15,"Coruña, A",5,Arteixo,30725,15348,15377
15,"Coruña, A",6,Arzúa,6315,3133,3182
15,"Coruña, A",7,"Baña, A",3967,1900,2067
15,"Coruña, A",8,Bergondo,6712,3226,3486
15,"Coruña, A",9,Betanzos,13565,6424,7141
15,"Coruña, A",10,Boimorto,2200,1117,1083
15,"Coruña, A",11,Boiro,19165,9350,9815
15,"Coruña, A",12,Boqueixón,4417,2177,2240
15,"Coruña, A",13,Brión,7369,3581,3788
15,"Coruña, A",14,Cabana de Bergantiños,4759,2333,2426
15,"Coruña, A",15,Cabanas,3299,1629,1670
15,"Coruña, A",16,Camariñas,6082,3008,3074
15,"Coruña, A",17,Cambre,23879,11741,12138
15,"Coruña, A",18,"Capela, A",1376,682,694
15,"Coruña, A",19,Carballo,31358,15322,16036
15,"Coruña, A",901,Cariño,4373,2169,2204
15,"Coruña, A",20,Carnota,4605,2198,2407
15,"Coruña, A",21,Carral,6130,3025,3105
15,"Coruña, A",22,Cedeira,7254,3628,3626
15,"Coruña, A",23,Cee,7855,3782,4073
15,"Coruña, A",24,Cerceda,5318,2594,2724
15,"Coruña, A",25,Cerdido,1312,629,683
15,"Coruña, A",26,Cesuras,2174,1069,1105
15,"Coruña, A",27,Coirós,1765,864,901
15,"Coruña, A",28,Corcubión,1731,853,878
15,"Coruña, A",29,Coristanco,6974,3355,3619
15,"Coruña, A",30,"Coruña, A",246146,114421,131725
15,"Coruña, A",31,Culleredo,29416,14324,15092
15,"Coruña, A",32,Curtis,4159,2083,2076
15,"Coruña, A",33,Dodro,2977,1449,1528
15,"Coruña, A",34,Dumbría,3291,1579,1712
15,"Coruña, A",35,Fene,13780,6617,7163
15,"Coruña, A",36,Ferrol,71997,33927,38070
15,"Coruña, A",37,Fisterra,4990,2528,2462
15,"Coruña, A",38,Frades,2566,1287,1279
15,"Coruña, A",39,Irixoa,1492,750,742
15,"Coruña, A",41,"Laracha, A",11367,5576,5791
15,"Coruña, A",40,Laxe,3313,1656,1657
15,"Coruña, A",42,Lousame,3621,1752,1869
15,"Coruña, A",43,Malpica de Bergantiños,5998,2906,3092
15,"Coruña, A",44,Mañón,1537,744,793
15,"Coruña, A",45,Mazaricos,4533,2179,2354
15,"Coruña, A",46,Melide,7502,3707,3795
15,"Coruña, A",47,Mesía,2879,1445,1434
15,"Coruña, A",48,Miño,5739,2855,2884
15,"Coruña, A",49,Moeche,1358,642,716
15,"Coruña, A",50,Monfero,2129,1081,1048
15,"Coruña, A",51,Mugardos,5456,2658,2798
15,"Coruña, A",53,Muros,9437,4566,4871
15,"Coruña, A",52,Muxía,5269,2563,2706
15,"Coruña, A",54,Narón,39238,19123,20115
15,"Coruña, A",55,Neda,5422,2633,2789
15,"Coruña, A",56,Negreira,7079,3404,3675
15,"Coruña, A",57,Noia,14757,7092,7665
15,"Coruña, A",58,Oleiros,34386,16751,17635
15,"Coruña, A",59,Ordes,12963,6327,6636
15,"Coruña, A",60,Oroso,7328,3634,3694
15,"Coruña, A",61,Ortigueira,6550,3163,3387
15,"Coruña, A",62,Outes,7192,3434,3758
15,"Coruña, A",63,Oza dos Ríos,3227,1629,1598
15,"Coruña, A",64,Paderne,2597,1283,1314
15,"Coruña, A",65,Padrón,8882,4249,4633
15,"Coruña, A",66,"Pino, O",4732,2357,2375
15,"Coruña, A",67,"Pobra do Caramiñal, A",9664,4680,4984
15,"Coruña, A",68,Ponteceso,6065,3046,3019
15,"Coruña, A",69,Pontedeume,8324,4003,4321
15,"Coruña, A",70,"Pontes de García Rodríguez, As",10996,5472,5524
15,"Coruña, A",71,Porto do Son,9699,4858,4841
15,"Coruña, A",72,Rianxo,11729,5745,5984
15,"Coruña, A",73,Ribeira,27778,13746,14032
15,"Coruña, A",74,Rois,4871,2313,2558
15,"Coruña, A",75,Sada,14922,7348,7574
15,"Coruña, A",76,San Sadurniño,3061,1507,1554
15,"Coruña, A",77,Santa Comba,10101,4860,5241
15,"Coruña, A",78,Santiago de Compostela,95671,44497,51174
15,"Coruña, A",79,Santiso,1838,965,873
15,"Coruña, A",80,Sobrado,2037,1032,1005
15,"Coruña, A",81,"Somozas, As",1279,650,629
15,"Coruña, A",82,Teo,18454,9084,9370
15,"Coruña, A",83,Toques,1302,673,629
15,"Coruña, A",84,Tordoia,3924,1861,2063
15,"Coruña, A",85,Touro,3979,1974,2005
15,"Coruña, A",86,Trazo,3433,1687,1746
15,"Coruña, A",88,Val do Dubra,4234,2064,2170
15,"Coruña, A",87,Valdoviño,6857,3353,3504
15,"Coruña, A",89,Vedra,5043,2450,2593
15,"Coruña, A",91,Vilarmaior,1261,661,600
15,"Coruña, A",90,Vilasantar,1368,706,662
15,"Coruña, A",92,Vimianzo,7977,3859,4118
15,"Coruña, A",93,Zas,5109,2497,2612
16,Cuenca,1,Abia de la Obispalía,81,51,30
16,Cuenca,2,"Acebrón, El",266,136,130
16,Cuenca,3,Alarcón,186,88,98
16,Cuenca,4,Albaladejo del Cuende,322,169,153
16,Cuenca,5,Albalate de las Nogueras,312,169,143
16,Cuenca,6,Albendea,161,77,84
16,Cuenca,7,"Alberca de Záncara, La",1962,1017,945
16,Cuenca,8,Alcalá de la Vega,128,69,59
16,Cuenca,9,Alcantud,82,43,39
16,Cuenca,10,Alcázar del Rey,193,94,99
16,Cuenca,11,Alcohujate,45,25,20
16,Cuenca,12,Alconchel de la Estrella,128,73,55
16,Cuenca,13,Algarra,20,14,6
16,Cuenca,14,Aliaguilla,751,398,353
16,Cuenca,15,"Almarcha, La",516,284,232
16,Cuenca,16,Almendros,295,160,135
16,Cuenca,17,Almodóvar del Pinar,452,243,209
16,Cuenca,18,Almonacid del Marquesado,469,241,228
16,Cuenca,19,Altarejos,231,116,115
16,Cuenca,20,Arandilla del Arroyo,20,13,7
16,Cuenca,905,Arcas del Villar,1414,714,700
16,Cuenca,22,Arcos de la Sierra,106,57,49
16,Cuenca,24,Arguisuelas,143,76,67
16,Cuenca,25,Arrancacepas,31,17,14
16,Cuenca,26,Atalaya del Cañavate,133,64,69
16,Cuenca,27,Barajas de Melo,1070,569,501
16,Cuenca,29,Barchín del Hoyo,91,49,42
16,Cuenca,30,Bascuñana de San Pedro,25,15,10
16,Cuenca,31,Beamud,62,30,32
16,Cuenca,32,Belinchón,376,196,180
16,Cuenca,33,Belmonte,2147,1064,1083
16,Cuenca,34,Belmontejo,221,117,104
16,Cuenca,35,Beteta,338,164,174
16,Cuenca,36,Boniches,137,62,75
16,Cuenca,38,Buciegas,49,25,24
16,Cuenca,39,Buenache de Alarcón,612,328,284
16,Cuenca,40,Buenache de la Sierra,115,71,44
16,Cuenca,41,Buendía,484,258,226
16,Cuenca,42,Campillo de Altobuey,1600,778,822
16,Cuenca,43,Campillos-Paravientos,126,65,61
16,Cuenca,44,Campillos-Sierra,56,26,30
16,Cuenca,901,Campos del Paraíso,932,463,469
16,Cuenca,45,Canalejas del Arroyo,313,167,146
16,Cuenca,46,Cañada del Hoyo,284,139,145
16,Cuenca,47,Cañada Juncosa,294,159,135
16,Cuenca,48,Cañamares,536,292,244
16,Cuenca,49,"Cañavate, El",163,81,82
16,Cuenca,50,Cañaveras,381,198,183
16,Cuenca,51,Cañaveruelas,176,94,82
16,Cuenca,52,Cañete,933,484,449
16,Cuenca,53,Cañizares,535,284,251
16,Cuenca,55,Carboneras de Guadazaón,826,426,400
16,Cuenca,56,Cardenete,572,295,277
16,Cuenca,57,Carrascosa,107,67,40
16,Cuenca,58,Carrascosa de Haro,128,66,62
16,Cuenca,60,Casas de Benítez,1018,504,514
16,Cuenca,61,Casas de Fernando Alonso,1446,769,677
16,Cuenca,62,Casas de Garcimolina,30,20,10
16,Cuenca,63,Casas de Guijarro,140,75,65
16,Cuenca,64,Casas de Haro,898,485,413
16,Cuenca,65,Casas de los Pinos,561,260,301
16,Cuenca,66,Casasimarro,3311,1716,1595
16,Cuenca,67,Castejón,188,93,95
16,Cuenca,68,Castillejo de Iniesta,192,113,79
16,Cuenca,70,Castillejo-Sierra,33,19,14
16,Cuenca,72,Castillo de Garcimuñoz,174,97,77
16,Cuenca,71,Castillo-Albaráñez,24,11,13
16,Cuenca,73,Cervera del Llano,257,133,124
16,Cuenca,23,Chillarón de Cuenca,604,321,283
16,Cuenca,81,Chumillas,68,40,28
16,Cuenca,74,"Cierva, La",56,33,23
16,Cuenca,78,Cuenca,57032,27500,29532
16,Cuenca,79,Cueva del Hierro,37,25,12
16,Cuenca,82,Enguídanos,375,205,170
16,Cuenca,83,Fresneda de Altarejos,62,33,29
16,Cuenca,84,Fresneda de la Sierra,55,29,26
16,Cuenca,85,"Frontera, La",197,106,91
16,Cuenca,86,Fuente de Pedro Naharro,1349,702,647
16,Cuenca,87,Fuentelespino de Haro,272,141,131
16,Cuenca,88,Fuentelespino de Moya,137,73,64
16,Cuenca,904,Fuentenava de Jábaga,581,300,281
16,Cuenca,89,Fuentes,492,262,230
16,Cuenca,91,Fuertescusa,82,44,38
16,Cuenca,92,Gabaldón,207,123,84
16,Cuenca,93,Garaballa,96,53,43
16,Cuenca,94,Gascueña,214,112,102
16,Cuenca,95,Graja de Campalbo,107,55,52
16,Cuenca,96,Graja de Iniesta,420,219,201
16,Cuenca,97,Henarejos,189,85,104
16,Cuenca,98,"Herrumblar, El",777,398,379
16,Cuenca,99,"Hinojosa, La",242,121,121
16,Cuenca,100,"Hinojosos, Los",963,479,484
16,Cuenca,101,"Hito, El",179,97,82
16,Cuenca,102,Honrubia,1743,879,864
16,Cuenca,103,Hontanaya,365,194,171
16,Cuenca,104,Hontecillas,74,35,39
16,Cuenca,106,Horcajo de Santiago,4306,2250,2056
16,Cuenca,107,Huélamo,141,83,58
16,Cuenca,108,Huelves,76,38,38
16,Cuenca,109,Huérguina,51,26,25
16,Cuenca,110,Huerta de la Obispalía,138,81,57
16,Cuenca,111,Huerta del Marquesado,228,135,93
16,Cuenca,112,Huete,1974,1007,967
16,Cuenca,113,Iniesta,4619,2294,2325
16,Cuenca,115,Laguna del Marquesado,59,31,28
16,Cuenca,116,Lagunaseca,91,49,42
16,Cuenca,117,Landete,1349,696,653
16,Cuenca,118,Ledaña,1893,945,948
16,Cuenca,119,Leganiel,214,110,104
16,Cuenca,121,"Majadas, Las",307,155,152
16,Cuenca,122,Mariana,279,141,138
16,Cuenca,123,Masegosa,104,59,45
16,Cuenca,124,"Mesas, Las",2548,1327,1221
16,Cuenca,125,Minglanilla,2696,1431,1265
16,Cuenca,126,Mira,1051,526,525
16,Cuenca,128,Monreal del Llano,79,41,38
16,Cuenca,129,Montalbanejo,126,61,65
16,Cuenca,130,Montalbo,759,399,360
16,Cuenca,131,Monteagudo de las Salinas,155,92,63
16,Cuenca,132,Mota de Altarejos,39,26,13
16,Cuenca,133,Mota del Cuervo,6370,3223,3147
16,Cuenca,134,Motilla del Palancar,6276,3172,3104
16,Cuenca,135,Moya,199,105,94
16,Cuenca,137,Narboneta,55,29,26
16,Cuenca,139,Olivares de Júcar,391,209,182
16,Cuenca,140,Olmeda de la Cuesta,39,16,23
16,Cuenca,141,Olmeda del Rey,150,73,77
16,Cuenca,142,Olmedilla de Alarcón,160,91,69
16,Cuenca,143,Olmedilla de Eliz,22,13,9
16,Cuenca,145,Osa de la Vega,601,311,290
16,Cuenca,146,Pajarón,95,47,48
16,Cuenca,147,Pajaroncillo,80,45,35
16,Cuenca,148,Palomares del Campo,745,383,362
16,Cuenca,149,Palomera,196,103,93
16,Cuenca,150,Paracuellos,131,63,68
16,Cuenca,151,Paredes,79,46,33
16,Cuenca,152,"Parra de las Vegas, La",43,23,20
16,Cuenca,153,"Pedernoso, El",1278,652,626
16,Cuenca,154,"Pedroñeras, Las",7180,3811,3369
16,Cuenca,155,"Peral, El",823,462,361
16,Cuenca,156,"Peraleja, La",138,72,66
16,Cuenca,157,"Pesquera, La",249,134,115
16,Cuenca,158,"Picazo, El",745,381,364
16,Cuenca,159,Pinarejo,287,140,147
16,Cuenca,160,Pineda de Gigüela,75,36,39
16,Cuenca,161,Piqueras del Castillo,67,33,34
16,Cuenca,162,Portalrubio de Guadamejud,48,24,24
16,Cuenca,163,Portilla,78,40,38
16,Cuenca,165,Poyatos,85,49,36
16,Cuenca,166,Pozoamargo,377,192,185
16,Cuenca,908,Pozorrubielos de la Mancha,288,148,140
16,Cuenca,167,Pozorrubio,370,175,195
16,Cuenca,169,"Pozuelo, El",74,46,28
16,Cuenca,170,Priego,1141,576,565
16,Cuenca,171,"Provencio, El",2683,1319,1364
16,Cuenca,172,Puebla de Almenara,461,235,226
16,Cuenca,174,Puebla del Salvador,237,132,105
16,Cuenca,175,Quintanar del Rey,7899,4130,3769
16,Cuenca,176,Rada de Haro,73,38,35
16,Cuenca,177,Reíllo,132,69,63
16,Cuenca,181,Rozalén del Monte,78,35,43
16,Cuenca,185,Saceda-Trasierra,65,40,25
16,Cuenca,186,Saelices,639,339,300
16,Cuenca,187,Salinas del Manzano,95,54,41
16,Cuenca,188,Salmeroncillos,149,87,62
16,Cuenca,189,Salvacañete,323,170,153
16,Cuenca,190,San Clemente,7518,3828,3690
16,Cuenca,191,San Lorenzo de la Parrilla,1242,623,619
16,Cuenca,192,San Martín de Boniches,48,27,21
16,Cuenca,193,San Pedro Palmiches,80,43,37
16,Cuenca,194,Santa Cruz de Moya,286,152,134
16,Cuenca,196,Santa María de los Llanos,754,393,361
16,Cuenca,195,Santa María del Campo Rus,690,346,344
16,Cuenca,197,Santa María del Val,70,36,34
16,Cuenca,198,Sisante,1910,967,943
16,Cuenca,199,Solera de Gabaldón,27,11,16
16,Cuenca,909,Sotorribas,855,434,421
16,Cuenca,202,Talayuelas,1028,531,497
16,Cuenca,203,Tarancón,16081,8094,7987
16,Cuenca,204,Tébar,372,191,181
16,Cuenca,205,Tejadillos,139,67,72
16,Cuenca,206,Tinajas,289,160,129
16,Cuenca,209,Torralba,164,93,71
16,Cuenca,211,Torrejoncillo del Rey,514,259,255
16,Cuenca,212,Torrubia del Campo,309,154,155
16,Cuenca,213,Torrubia del Castillo,42,25,17
16,Cuenca,215,Tragacete,316,177,139
16,Cuenca,216,Tresjuncos,368,191,177
16,Cuenca,217,Tribaldos,115,51,64
16,Cuenca,218,Uclés,235,120,115
16,Cuenca,219,Uña,105,53,52
16,Cuenca,906,"Valdecolmenas, Los",105,61,44
16,Cuenca,224,Valdemeca,97,54,43
16,Cuenca,225,Valdemorillo de la Sierra,88,50,38
16,Cuenca,227,Valdemoro-Sierra,142,85,57
16,Cuenca,228,Valdeolivas,250,151,99
16,Cuenca,902,Valdetórtola,173,98,75
16,Cuenca,903,"Valeras, Las",1714,907,807
16,Cuenca,231,Valhermoso de la Fuente,41,22,19
16,Cuenca,173,"Valle de Altomira, El",296,163,133
16,Cuenca,234,Valsalobre,40,22,18
16,Cuenca,236,Valverde de Júcar,1242,617,625
16,Cuenca,237,Valverdejo,113,60,53
16,Cuenca,238,Vara de Rey,611,321,290
16,Cuenca,239,Vega del Codorno,165,92,73
16,Cuenca,240,Vellisca,141,75,66
16,Cuenca,242,Villaconejos de Trabaque,457,224,233
16,Cuenca,243,Villaescusa de Haro,587,297,290
16,Cuenca,244,Villagarcía del Llano,806,413,393
16,Cuenca,245,Villalba de la Sierra,554,278,276
16,Cuenca,246,Villalba del Rey,599,329,270
16,Cuenca,247,Villalgordo del Marquesado,101,53,48
16,Cuenca,248,Villalpardo,1148,565,583
16,Cuenca,249,Villamayor de Santiago,3000,1550,1450
16,Cuenca,250,Villanueva de Guadamejud,104,61,43
16,Cuenca,251,Villanueva de la Jara,2390,1194,1196
16,Cuenca,253,Villar de Cañas,431,234,197
16,Cuenca,254,Villar de Domingo García,238,123,115
16,Cuenca,255,Villar de la Encina,173,90,83
16,Cuenca,263,Villar de Olalla,1242,657,585
16,Cuenca,258,Villar del Humo,273,150,123
16,Cuenca,259,Villar del Infantado,45,28,17
16,Cuenca,910,Villar y Velasco,104,57,47
16,Cuenca,264,Villarejo de Fuentes,648,344,304
16,Cuenca,265,Villarejo de la Peñuela,25,12,13
16,Cuenca,266,Villarejo-Periesteban,417,206,211
16,Cuenca,269,Villares del Saz,615,314,301
16,Cuenca,270,Villarrubio,241,133,108
16,Cuenca,271,Villarta,955,502,453
16,Cuenca,272,Villas de la Ventosa,298,156,142
16,Cuenca,273,Villaverde y Pasaconsol,374,191,183
16,Cuenca,274,Víllora,162,81,81
16,Cuenca,275,Vindel,15,9,6
16,Cuenca,276,Yémeda,41,24,17
16,Cuenca,277,Zafra de Záncara,147,77,70
16,Cuenca,278,Zafrilla,88,42,46
16,Cuenca,279,Zarza de Tajo,327,172,155
16,Cuenca,280,Zarzuela,222,117,105
20,Gipuzkoa,1,Abaltzisketa,324,176,148
20,Gipuzkoa,2,Aduna,452,248,204
20,Gipuzkoa,16,Aia,2026,1093,933
20,Gipuzkoa,3,Aizarnazabal,766,397,369
20,Gipuzkoa,4,Albiztur,316,165,151
20,Gipuzkoa,5,Alegia,1771,902,869
20,Gipuzkoa,6,Alkiza,371,197,174
20,Gipuzkoa,906,Altzaga,162,79,83
20,Gipuzkoa,7,Altzo,411,219,192
20,Gipuzkoa,8,Amezketa,976,507,469
20,Gipuzkoa,9,Andoain,14646,7306,7340
20,Gipuzkoa,10,Anoeta,1830,957,873
20,Gipuzkoa,11,Antzuola,2177,1101,1076
20,Gipuzkoa,12,Arama,200,103,97
20,Gipuzkoa,13,Aretxabaleta,6850,3510,3340
20,Gipuzkoa,55,Arrasate/Mondragón,22027,10931,11096
20,Gipuzkoa,14,Asteasu,1512,807,705
20,Gipuzkoa,903,Astigarraga,4999,2569,2430
20,Gipuzkoa,15,Ataun,1680,878,802
20,Gipuzkoa,17,Azkoitia,11492,5787,5705
20,Gipuzkoa,18,Azpeitia,14506,7293,7213
20,Gipuzkoa,904,Baliarrain,127,67,60
20,Gipuzkoa,19,Beasain,13850,6968,6882
20,Gipuzkoa,20,Beizama,175,106,69
20,Gipuzkoa,21,Belauntza,281,154,127
20,Gipuzkoa,22,Berastegi,1062,563,499
20,Gipuzkoa,74,Bergara,14708,7328,7380
20,Gipuzkoa,23,Berrobi,568,300,268
20,Gipuzkoa,24,Bidegoian,537,286,251
20,Gipuzkoa,29,Deba,5439,2735,2704
20,Gipuzkoa,69,Donostia-San Sebastián,186409,87432,98977
20,Gipuzkoa,30,Eibar,27507,13354,14153
20,Gipuzkoa,31,Elduain,231,120,111
20,Gipuzkoa,33,Elgeta,1120,573,547
20,Gipuzkoa,32,Elgoibar,11438,5699,5739
20,Gipuzkoa,67,Errenteria,39324,19146,20178
20,Gipuzkoa,66,Errezil,617,327,290
20,Gipuzkoa,34,Eskoriatza,4054,2085,1969
20,Gipuzkoa,35,Ezkio-Itsaso,625,330,295
20,Gipuzkoa,38,Gabiria,488,264,224
20,Gipuzkoa,37,Gaintza,121,70,51
20,Gipuzkoa,907,Gaztelu,168,97,71
20,Gipuzkoa,39,Getaria,2679,1347,1332
20,Gipuzkoa,40,Hernani,19284,9439,9845
20,Gipuzkoa,41,Hernialde,361,193,168
20,Gipuzkoa,36,Hondarribia,16518,8241,8277
20,Gipuzkoa,42,Ibarra,4269,2184,2085
20,Gipuzkoa,43,Idiazabal,2291,1161,1130
20,Gipuzkoa,44,Ikaztegieta,469,245,224
20,Gipuzkoa,45,Irun,61102,29890,31212
20,Gipuzkoa,46,Irura,1640,848,792
20,Gipuzkoa,47,Itsasondo,677,332,345
20,Gipuzkoa,48,Larraul,247,136,111
20,Gipuzkoa,902,Lasarte-Oria,17922,8820,9102
20,Gipuzkoa,49,Lazkao,5435,2760,2675
20,Gipuzkoa,50,Leaburu,384,196,188
20,Gipuzkoa,51,Legazpi,8639,4414,4225
20,Gipuzkoa,52,Legorreta,1483,760,723
20,Gipuzkoa,68,Leintz-Gatzaga,256,134,122
20,Gipuzkoa,53,Lezo,6027,2993,3034
20,Gipuzkoa,54,Lizartza,649,361,288
20,Gipuzkoa,901,Mendaro,1962,1017,945
20,Gipuzkoa,57,Mutiloa,253,138,115
20,Gipuzkoa,56,Mutriku,5101,2559,2542
20,Gipuzkoa,63,Oiartzun,10018,5000,5018
20,Gipuzkoa,58,Olaberria,941,475,466
20,Gipuzkoa,59,Oñati,11151,5526,5625
20,Gipuzkoa,76,Ordizia,9817,4852,4965
20,Gipuzkoa,905,Orendain,181,95,86
20,Gipuzkoa,60,Orexa,123,66,57
20,Gipuzkoa,61,Orio,5382,2732,2650
20,Gipuzkoa,62,Ormaiztegi,1303,667,636
20,Gipuzkoa,64,Pasaia,15885,7569,8316
20,Gipuzkoa,70,Segura,1477,751,726
20,Gipuzkoa,65,Soraluze/Placencia de las Armas,3981,2002,1979
20,Gipuzkoa,71,Tolosa,18574,8938,9636
20,Gipuzkoa,72,Urnieta,6218,3114,3104
20,Gipuzkoa,77,Urretxu,6927,3464,3463
20,Gipuzkoa,73,Usurbil,6090,3110,2980
20,Gipuzkoa,75,Villabona,5872,2970,2902
20,Gipuzkoa,78,Zaldibia,1522,798,724
20,Gipuzkoa,79,Zarautz,22650,11094,11556
20,Gipuzkoa,25,Zegama,1553,816,737
20,Gipuzkoa,26,Zerain,265,127,138
20,Gipuzkoa,27,Zestoa,3661,1924,1737
20,Gipuzkoa,28,Zizurkil,2910,1450,1460
20,Gipuzkoa,81,Zumaia,9581,4750,4831
20,Gipuzkoa,80,Zumarraga,10024,4968,5056
17,Girona,1,Agullana,858,439,419
17,Girona,2,Aiguaviva,774,383,391
17,Girona,3,Albanyà,153,85,68
17,Girona,4,Albons,714,370,344
17,Girona,6,Alp,1745,927,818
17,Girona,7,Amer,2277,1105,1172
17,Girona,8,Anglès,5719,2850,2869
17,Girona,9,Arbúcies,6741,3538,3203
17,Girona,10,Argelaguer,425,223,202
17,Girona,11,"Armentera, L'",860,426,434
17,Girona,12,Avinyonet de Puigventós,1523,764,759
17,Girona,15,Banyoles,19341,9697,9644
17,Girona,16,Bàscara,968,498,470
17,Girona,13,Begur,4221,2156,2065
17,Girona,18,Bellcaire d'Empordà,661,328,333
17,Girona,19,Besalú,2427,1163,1264
17,Girona,20,Bescanó,4705,2335,2370
17,Girona,21,Beuda,170,92,78
17,Girona,22,"Bisbal d'Empordà, La",10679,5419,5260
17,Girona,234,Biure,249,128,121
17,Girona,23,Blanes,39785,20036,19749
17,Girona,29,Boadella i les Escaules,256,123,133
17,Girona,24,Bolvir,400,214,186
17,Girona,25,Bordils,1737,877,860
17,Girona,26,Borrassà,714,364,350
17,Girona,27,Breda,3767,1900,1867
17,Girona,28,Brunyola,397,195,202
17,Girona,31,Cabanelles,244,137,107
17,Girona,30,Cabanes,931,496,435
17,Girona,32,Cadaqués,2935,1440,1495
17,Girona,33,Caldes de Malavella,7071,3515,3556
17,Girona,34,Calonge,10851,5431,5420
17,Girona,35,Camós,677,343,334
17,Girona,36,Campdevànol,3469,1710,1759
17,Girona,37,Campelles,136,66,70
17,Girona,38,Campllong,525,266,259
17,Girona,39,Camprodon,2466,1207,1259
17,Girona,40,Canet d'Adri,624,317,307
17,Girona,41,Cantallops,333,171,162
17,Girona,42,Capmany,633,341,292
17,Girona,44,Cassà de la Selva,9925,5112,4813
17,Girona,46,Castellfollit de la Roca,999,509,490
17,Girona,47,Castelló d'Empúries,11794,6037,5757
17,Girona,48,Castell-Platja d'Aro,10527,5236,5291
17,Girona,189,"Cellera de Ter, La",2066,1029,1037
17,Girona,49,Celrà,4914,2443,2471
17,Girona,50,Cervià de Ter,906,459,447
17,Girona,51,Cistella,281,143,138
17,Girona,54,Colera,574,298,276
17,Girona,55,Colomers,205,99,106
17,Girona,57,Corçà,1279,623,656
17,Girona,56,Cornellà del Terri,2257,1147,1110
17,Girona,58,Crespià,266,134,132
17,Girona,901,"Cruïlles, Monells i Sant Sadurní de l'Heura",1253,637,616
17,Girona,60,Darnius,532,267,265
17,Girona,61,Das,222,126,96
17,Girona,62,"Escala, L'",10508,5370,5138
17,Girona,63,Espinelves,201,98,103
17,Girona,64,Espolla,421,210,211
17,Girona,65,Esponellà,446,222,224
17,Girona,5,"Far d'Empordà, El",555,280,275
17,Girona,66,Figueres,45262,22529,22733
17,Girona,67,Flaçà,1065,514,551
17,Girona,68,Foixà,311,162,149
17,Girona,69,Fontanals de Cerdanya,472,236,236
17,Girona,70,Fontanilles,156,89,67
17,Girona,71,Fontcoberta,1375,660,715
17,Girona,902,Forallac,1721,834,887
17,Girona,73,Fornells de la Selva,2449,1197,1252
17,Girona,74,Fortià,679,337,342
17,Girona,75,Garrigàs,382,202,180
17,Girona,76,Garrigoles,167,93,74
17,Girona,77,Garriguella,874,432,442
17,Girona,78,Ger,481,258,223
17,Girona,79,Girona,97198,46865,50333
17,Girona,80,Gombrèn,209,101,108
17,Girona,81,Gualta,362,195,167
17,Girona,82,Guils de Cerdanya,558,295,263
17,Girona,83,Hostalric,4018,2042,1976
17,Girona,84,Isòvol,327,185,142
17,Girona,85,Jafre,425,227,198
17,Girona,86,"Jonquera, La",3203,1637,1566
17,Girona,87,Juià,347,194,153
17,Girona,88,Lladó,736,366,370
17,Girona,89,Llagostera,8157,4212,3945
17,Girona,90,Llambilles,713,369,344
17,Girona,91,Llanars,534,272,262
17,Girona,92,Llançà,5105,2545,2560
17,Girona,93,Llers,1194,606,588
17,Girona,94,Llívia,1689,923,766
17,Girona,95,Lloret de Mar,40837,21355,19482
17,Girona,96,"Llosses, Les",224,131,93
17,Girona,102,Maçanet de Cabrenys,739,378,361
17,Girona,103,Maçanet de la Selva,7175,3693,3482
17,Girona,97,Madremanya,266,130,136
17,Girona,98,Maià de Montcal,443,226,217
17,Girona,100,Masarac,293,160,133
17,Girona,101,Massanes,711,374,337
17,Girona,99,Meranges,91,51,40
17,Girona,105,Mieres,333,174,159
17,Girona,106,Mollet de Peralada,180,91,89
17,Girona,107,Molló,350,171,179
17,Girona,109,Montagut i Oix,978,516,462
17,Girona,110,Mont-ras,1818,911,907
17,Girona,111,Navata,1254,625,629
17,Girona,112,Ogassa,247,147,100
17,Girona,114,Olot,33813,16868,16945
17,Girona,115,Ordis,391,209,182
17,Girona,116,Osor,451,224,227
17,Girona,117,Palafrugell,22880,11476,11404
17,Girona,118,Palamós,17813,8755,9058
17,Girona,119,Palau de Santa Eulàlia,100,60,40
17,Girona,121,Palau-sator,294,158,136
17,Girona,120,Palau-saverdera,1481,738,743
17,Girona,123,Palol de Revardit,478,246,232
17,Girona,124,Pals,2793,1414,1379
17,Girona,125,Pardines,154,89,65
17,Girona,126,Parlavà,386,203,183
17,Girona,128,Pau,597,299,298
17,Girona,129,Pedret i Marzà,184,97,87
17,Girona,130,"Pera, La",428,208,220
17,Girona,132,Peralada,1888,949,939
17,Girona,133,"Planes d'Hostoles, Les",1701,861,840
17,Girona,134,Planoles,308,167,141
17,Girona,135,Pont de Molins,538,274,264
17,Girona,136,Pontós,232,128,104
17,Girona,137,Porqueres,4491,2230,2261
17,Girona,140,"Port de la Selva, El",1011,542,469
17,Girona,138,Portbou,1296,650,646
17,Girona,139,"Preses, Les",1752,859,893
17,Girona,141,Puigcerdà,8957,4505,4452
17,Girona,142,Quart,3255,1660,1595
17,Girona,43,Queralbs,178,99,79
17,Girona,143,Rabós,206,106,100
17,Girona,144,Regencós,295,162,133
17,Girona,145,Ribes de Freser,1914,937,977
17,Girona,146,Riells i Viabrea,3980,2056,1924
17,Girona,147,Ripoll,10904,5379,5525
17,Girona,148,Riudarenes,2180,1115,1065
17,Girona,149,Riudaura,438,213,225
17,Girona,150,Riudellots de la Selva,2037,1040,997
17,Girona,151,Riumors,252,130,122
17,Girona,152,Roses,19896,9976,9920
17,Girona,153,Rupià,248,124,124
17,Girona,154,Sales de Llierca,144,76,68
17,Girona,155,Salt,30146,16030,14116
17,Girona,157,Sant Andreu Salou,159,81,78
17,Girona,183,Sant Aniol de Finestres,351,186,165
17,Girona,158,Sant Climent Sescebes,568,322,246
17,Girona,159,Sant Feliu de Buixalleu,788,413,375
17,Girona,160,Sant Feliu de Guíxols,21961,10892,11069
17,Girona,161,Sant Feliu de Pallerols,1360,660,700
17,Girona,162,Sant Ferriol,222,133,89
17,Girona,163,Sant Gregori,3343,1692,1651
17,Girona,164,Sant Hilari Sacalm,5753,2945,2808
17,Girona,165,Sant Jaume de Llierca,757,374,383
17,Girona,167,Sant Joan de les Abadesses,3469,1723,1746
17,Girona,168,Sant Joan de Mollet,522,262,260
17,Girona,185,Sant Joan les Fonts,2879,1445,1434
17,Girona,166,Sant Jordi Desvalls,703,343,360
17,Girona,169,Sant Julià de Ramis,3467,1734,1733
17,Girona,903,Sant Julià del Llor i Bonmatí,1244,637,607
17,Girona,171,Sant Llorenç de la Muga,248,126,122
17,Girona,172,Sant Martí de Llémena,596,309,287
17,Girona,173,Sant Martí Vell,266,137,129
17,Girona,174,Sant Miquel de Campmajor,230,121,109
17,Girona,175,Sant Miquel de Fluvià,780,396,384
17,Girona,176,Sant Mori,196,101,95
17,Girona,177,Sant Pau de Segúries,675,333,342
17,Girona,178,Sant Pere Pescador,2161,1166,995
17,Girona,180,Santa Coloma de Farners,12448,6346,6102
17,Girona,181,Santa Cristina d'Aro,5106,2598,2508
17,Girona,182,Santa Llogaia d'Àlguema,348,183,165
17,Girona,184,Santa Pau,1604,803,801
17,Girona,186,Sarrià de Ter,4790,2380,2410
17,Girona,187,"Saus, Camallera i Llampaies",807,383,424
17,Girona,188,"Selva de Mar, La",203,106,97
17,Girona,190,Serinyà,1122,576,546
17,Girona,191,Serra de Daró,208,115,93
17,Girona,192,Setcases,187,103,84
17,Girona,193,Sils,5702,2898,2804
17,Girona,52,Siurana,170,88,82
17,Girona,194,Susqueda,105,61,44
17,Girona,195,"Tallada d'Empordà, La",459,238,221
17,Girona,196,Terrades,311,157,154
17,Girona,197,Torrent,193,101,92
17,Girona,198,Torroella de Fluvià,704,355,349
17,Girona,199,Torroella de Montgrí,11494,5821,5673
17,Girona,200,Tortellà,793,389,404
17,Girona,201,Toses,155,90,65
17,Girona,202,Tossa de Mar,5952,3049,2903
17,Girona,204,Ullà,1037,572,465
17,Girona,205,Ullastret,287,144,143
17,Girona,203,Ultramort,208,113,95
17,Girona,206,Urús,201,97,104
17,Girona,14,"Vajol, La",93,53,40
17,Girona,208,"Vall de Bianya, La",1335,680,655
17,Girona,207,"Vall d'en Bas, La",2931,1466,1465
17,Girona,170,Vallfogona de Ripollès,223,121,102
17,Girona,209,Vall-llobrega,904,459,445
17,Girona,210,Ventalló,816,422,394
17,Girona,211,Verges,1193,585,608
17,Girona,212,Vidrà,163,88,75
17,Girona,213,Vidreres,7732,4017,3715
17,Girona,214,Vilabertran,911,468,443
17,Girona,215,Vilablareix,2427,1203,1224
17,Girona,217,Viladamat,451,237,214
17,Girona,216,Viladasens,208,108,100
17,Girona,218,Vilademuls,780,396,384
17,Girona,220,Viladrau,1087,553,534
17,Girona,221,Vilafant,5523,2733,2790
17,Girona,223,Vilajuïga,1177,577,600
17,Girona,224,Vilallonga de Ter,466,253,213
17,Girona,225,Vilamacolum,289,153,136
17,Girona,226,Vilamalla,1101,586,515
17,Girona,227,Vilamaniscle,176,102,74
17,Girona,228,Vilanant,376,183,193
17,Girona,230,Vila-sacra,671,323,348
17,Girona,222,Vilaür,142,68,74
17,Girona,233,Vilobí d'Onyar,3053,1603,1450
17,Girona,232,Vilopriu,217,118,99
18,Granada,1,Agrón,342,185,157
18,Granada,2,Alamedilla,673,347,326
18,Granada,3,Albolote,18088,9084,9004
18,Granada,4,Albondón,889,508,381
18,Granada,5,Albuñán,430,226,204
18,Granada,6,Albuñol,6587,3449,3138
18,Granada,7,Albuñuelas,920,467,453
18,Granada,10,Aldeire,670,349,321
18,Granada,11,Alfacar,5513,2790,2723
18,Granada,12,Algarinejo,3029,1547,1482
18,Granada,13,Alhama de Granada,6214,3313,2901
18,Granada,14,Alhendín,7746,3986,3760
18,Granada,15,Alicún de Ortega,500,272,228
18,Granada,16,Almegíjar,413,222,191
18,Granada,17,Almuñécar,27703,13708,13995
18,Granada,904,Alpujarra de la Sierra,1132,600,532
18,Granada,18,Alquife,712,354,358
18,Granada,20,Arenas del Rey,2038,1080,958
18,Granada,21,Armilla,22507,11244,11263
18,Granada,22,Atarfe,16843,8430,8413
18,Granada,23,Baza,21407,10689,10718
18,Granada,24,Beas de Granada,1031,554,477
18,Granada,25,Beas de Guadix,380,194,186
18,Granada,27,Benalúa,3351,1680,1671
18,Granada,28,Benalúa de las Villas,1375,778,597
18,Granada,29,Benamaurel,2447,1246,1201
18,Granada,30,Bérchules,835,453,382
18,Granada,32,Bubión,335,174,161
18,Granada,33,Busquístar,292,159,133
18,Granada,34,Cacín,590,290,300
18,Granada,35,Cádiar,1632,874,758
18,Granada,36,Cájar,4741,2291,2450
18,Granada,114,"Calahorra, La",765,389,376
18,Granada,37,Calicasas,571,291,280
18,Granada,38,Campotéjar,1362,712,650
18,Granada,39,Caniles,4755,2402,2353
18,Granada,40,Cáñar,468,247,221
18,Granada,42,Capileira,528,267,261
18,Granada,43,Carataunas,188,97,91
18,Granada,44,Cástaras,274,157,117
18,Granada,45,Castilléjar,1564,796,768
18,Granada,46,Castril,2378,1212,1166
18,Granada,47,Cenes de la Vega,7900,4021,3879
18,Granada,59,Chauchina,4813,2385,2428
18,Granada,61,Chimeneas,1456,762,694
18,Granada,62,Churriana de la Vega,13118,6554,6564
18,Granada,48,Cijuela,3098,1587,1511
18,Granada,49,Cogollos de Guadix,718,384,334
18,Granada,50,Cogollos de la Vega,1983,1003,980
18,Granada,51,Colomera,1468,781,687
18,Granada,53,Cortes de Baza,2219,1118,1101
18,Granada,54,Cortes y Graena,1036,524,512
18,Granada,912,Cuevas del Campo,2014,1013,1001
18,Granada,56,Cúllar,4630,2337,2293
18,Granada,57,Cúllar Vega,7104,3602,3502
18,Granada,63,Darro,1460,716,744
18,Granada,64,Dehesas de Guadix,486,236,250
18,Granada,66,Deifontes,2580,1311,1269
18,Granada,67,Diezma,775,399,376
18,Granada,68,Dílar,1821,905,916
18,Granada,69,Dólar,623,326,297
18,Granada,70,Dúdar,350,190,160
18,Granada,71,Dúrcal,7286,3614,3672
18,Granada,72,Escúzar,792,408,384
18,Granada,74,Ferreira,346,183,163
18,Granada,76,Fonelas,1085,562,523
18,Granada,78,Freila,1060,536,524
18,Granada,79,Fuente Vaqueros,4229,2103,2126
18,Granada,905,"Gabias, Las",18381,9422,8959
18,Granada,82,Galera,1243,621,622
18,Granada,83,Gobernador,322,157,165
18,Granada,84,Gójar,5340,2751,2589
18,Granada,85,Gor,877,447,430
18,Granada,86,Gorafe,461,232,229
18,Granada,87,Granada,239017,111133,127884
18,Granada,88,Guadahortuna,1963,1018,945
18,Granada,89,Guadix,18920,9405,9515
18,Granada,906,"Guajares, Los",1170,640,530
18,Granada,93,Gualchos,4805,2510,2295
18,Granada,94,Güejar Sierra,3007,1587,1420
18,Granada,95,Güevéjar,2565,1338,1227
18,Granada,96,Huélago,361,189,172
18,Granada,97,Huéneja,1228,631,597
18,Granada,98,Huéscar,8015,3963,4052
18,Granada,99,Huétor de Santillán,1836,943,893
18,Granada,100,Huétor Tájar,10084,5099,4985
18,Granada,101,Huétor Vega,11853,5937,5916
18,Granada,102,Illora,10716,5359,5357
18,Granada,103,Itrabo,1070,545,525
18,Granada,105,Iznalloz,6995,3598,3397
18,Granada,107,Jayena,1151,590,561
18,Granada,108,Jerez del Marquesado,1061,544,517
18,Granada,109,Jete,909,490,419
18,Granada,111,Jun,3558,1823,1735
18,Granada,112,Juviles,163,81,82
18,Granada,115,Láchar,3205,1635,1570
18,Granada,116,Lanjarón,3826,1891,1935
18,Granada,117,Lanteira,570,293,277
18,Granada,119,Lecrín,2299,1176,1123
18,Granada,120,Lentegí,333,175,158
18,Granada,121,Lobras,159,82,77
18,Granada,122,Loja,21496,10816,10680
18,Granada,123,Lugros,340,187,153
18,Granada,124,Lújar,519,273,246
18,Granada,126,"Malahá, La",1837,955,882
18,Granada,127,Maracena,21514,10635,10879
18,Granada,128,Marchal,446,205,241
18,Granada,132,Moclín,4204,2096,2108
18,Granada,133,Molvízar,3215,1648,1567
18,Granada,134,Monachil,7402,3802,3600
18,Granada,135,Montefrío,6054,3041,3013
18,Granada,136,Montejícar,2375,1201,1174
18,Granada,137,Montillana,1386,740,646
18,Granada,138,Moraleda de Zafayona,3266,1674,1592
18,Granada,909,Morelábor,742,386,356
18,Granada,140,Motril,61171,30285,30886
18,Granada,141,Murtas,621,369,252
18,Granada,903,Nevada,1158,597,561
18,Granada,143,Nigüelas,1203,596,607
18,Granada,144,Nívar,937,486,451
18,Granada,145,Ogíjares,13403,6681,6722
18,Granada,146,Orce,1301,672,629
18,Granada,147,Órgiva,5772,2866,2906
18,Granada,148,Otívar,1203,616,587
18,Granada,149,Otura,6910,3504,3406
18,Granada,150,Padul,8480,4286,4194
18,Granada,151,Pampaneira,344,177,167
18,Granada,152,Pedro Martínez,1272,618,654
18,Granada,153,Peligros,11059,5512,5547
18,Granada,154,"Peza, La",1293,682,611
18,Granada,910,"Pinar, El",1034,517,517
18,Granada,157,Pinos Genil,1409,738,671
18,Granada,158,Pinos Puente,13115,6595,6520
18,Granada,159,Píñar,1283,709,574
18,Granada,161,Polícar,220,112,108
18,Granada,162,Polopos,1966,1070,896
18,Granada,163,Pórtugos,364,196,168
18,Granada,164,Puebla de Don Fadrique,2393,1237,1156
18,Granada,165,Pulianas,5226,2621,2605
18,Granada,167,Purullena,2403,1205,1198
18,Granada,168,Quéntar,1009,518,491
18,Granada,170,Rubite,500,275,225
18,Granada,171,Salar,2758,1393,1365
18,Granada,173,Salobreña,12622,6329,6293
18,Granada,174,Santa Cruz del Comercio,584,306,278
18,Granada,175,Santa Fe,15322,7579,7743
18,Granada,176,Soportújar,298,160,138
18,Granada,177,Sorvilán,577,300,277
18,Granada,901,"Taha, La",778,394,384
18,Granada,178,Torre-Cardela,920,462,458
18,Granada,179,Torvizcón,736,391,345
18,Granada,180,Trevélez,795,417,378
18,Granada,181,Turón,289,170,119
18,Granada,182,Ugíjar,2643,1307,1336
18,Granada,907,Valle del Zalabí,2260,1162,1098
18,Granada,902,"Valle, El",1142,562,580
18,Granada,183,Válor,693,360,333
18,Granada,911,Vegas del Genil,9701,4954,4747
18,Granada,184,Vélez de Benaudalla,2943,1488,1455
18,Granada,185,Ventas de Huelma,704,367,337
18,Granada,908,Villamena,1028,517,511
18,Granada,187,Villanueva de las Torres,700,384,316
18,Granada,188,Villanueva Mesía,2108,1075,1033
18,Granada,189,Víznar,937,485,452
18,Granada,192,Zafarraya,2113,1166,947
18,Granada,913,Zagra,937,470,467
18,Granada,193,"Zubia, La",18375,9056,9319
18,Granada,194,Zújar,2989,1585,1404
19,Guadalajara,1,Abánades,70,38,32
19,Guadalajara,2,Ablanque,100,59,41
19,Guadalajara,3,Adobes,53,27,26
19,Guadalajara,4,Alaminos,70,35,35
19,Guadalajara,5,Alarilla,123,75,48
19,Guadalajara,6,Albalate de Zorita,1089,612,477
19,Guadalajara,7,Albares,551,282,269
19,Guadalajara,8,Albendiego,42,30,12
19,Guadalajara,9,Alcocer,334,171,163
19,Guadalajara,10,Alcolea de las Peñas,15,11,4
19,Guadalajara,11,Alcolea del Pinar,397,220,177
19,Guadalajara,13,Alcoroches,162,93,69
19,Guadalajara,15,Aldeanueva de Guadalajara,104,55,49
19,Guadalajara,16,Algar de Mesa,68,36,32
19,Guadalajara,17,Algora,103,58,45
19,Guadalajara,18,Alhóndiga,205,110,95
19,Guadalajara,19,Alique,23,9,14
19,Guadalajara,20,Almadrones,90,54,36
19,Guadalajara,21,Almoguera,1471,771,700
19,Guadalajara,22,Almonacid de Zorita,789,377,412
19,Guadalajara,23,Alocén,173,91,82
19,Guadalajara,24,Alovera,12150,6251,5899
19,Guadalajara,27,Alustante,225,139,86
19,Guadalajara,31,Angón,17,12,5
19,Guadalajara,32,Anguita,215,115,100
19,Guadalajara,33,Anquela del Ducado,85,48,37
19,Guadalajara,34,Anquela del Pedregal,23,17,6
19,Guadalajara,36,Aranzueque,463,246,217
19,Guadalajara,37,Arbancón,181,110,71
19,Guadalajara,38,Arbeteta,46,26,20
19,Guadalajara,39,Argecilla,77,51,26
19,Guadalajara,40,Armallones,69,40,29
19,Guadalajara,41,Armuña de Tajuña,252,130,122
19,Guadalajara,42,Arroyo de las Fraguas,39,21,18
19,Guadalajara,43,Atanzón,102,64,38
19,Guadalajara,44,Atienza,498,271,227
19,Guadalajara,45,Auñón,206,116,90
19,Guadalajara,46,Azuqueca de Henares,35146,18099,17047
19,Guadalajara,47,Baides,91,44,47
19,Guadalajara,48,Baños de Tajo,19,14,5
19,Guadalajara,49,Bañuelos,23,16,7
19,Guadalajara,50,Barriopedro,23,13,10
19,Guadalajara,51,Berninches,76,43,33
19,Guadalajara,52,"Bodera, La",35,22,13
19,Guadalajara,53,Brihuega,2798,1448,1350
19,Guadalajara,54,Budia,220,122,98
19,Guadalajara,55,Bujalaro,64,35,29
19,Guadalajara,57,Bustares,81,48,33
19,Guadalajara,58,Cabanillas del Campo,9709,4881,4828
19,Guadalajara,59,Campillo de Dueñas,91,51,40
19,Guadalajara,60,Campillo de Ranas,189,117,72
19,Guadalajara,61,Campisábalos,79,52,27
19,Guadalajara,64,Canredondo,107,61,46
19,Guadalajara,65,Cantalojas,159,92,67
19,Guadalajara,66,Cañizar,79,42,37
19,Guadalajara,67,"Cardoso de la Sierra, El",69,46,23
19,Guadalajara,70,Casa de Uceda,128,71,57
19,Guadalajara,71,"Casar, El",11622,5963,5659
19,Guadalajara,73,Casas de San Galindo,27,15,12
19,Guadalajara,74,Caspueñas,114,68,46
19,Guadalajara,75,Castejón de Henares,88,47,41
19,Guadalajara,76,Castellar de la Muela,37,18,19
19,Guadalajara,78,Castilforte,64,40,24
19,Guadalajara,79,Castilnuevo,8,5,3
19,Guadalajara,80,Cendejas de Enmedio,98,52,46
19,Guadalajara,81,Cendejas de la Torre,38,25,13
19,Guadalajara,82,Centenera,110,55,55
19,Guadalajara,103,Checa,336,199,137
19,Guadalajara,104,Chequilla,15,9,6
19,Guadalajara,106,Chillarón del Rey,118,67,51
19,Guadalajara,105,Chiloeches,3179,1648,1531
19,Guadalajara,86,Cifuentes,2108,1080,1028
19,Guadalajara,87,Cincovillas,25,14,11
19,Guadalajara,88,Ciruelas,128,74,54
19,Guadalajara,89,Ciruelos del Pinar,36,21,15
19,Guadalajara,90,Cobeta,123,55,68
19,Guadalajara,91,Cogollor,32,17,15
19,Guadalajara,92,Cogolludo,656,374,282
19,Guadalajara,95,Condemios de Abajo,25,15,10
19,Guadalajara,96,Condemios de Arriba,146,77,69
19,Guadalajara,97,Congostrina,37,24,13
19,Guadalajara,98,Copernal,37,26,11
19,Guadalajara,99,Corduente,397,214,183
19,Guadalajara,102,"Cubillo de Uceda, El",171,90,81
19,Guadalajara,107,Driebes,433,228,205
19,Guadalajara,108,Durón,117,61,56
19,Guadalajara,109,Embid,53,30,23
19,Guadalajara,110,Escamilla,80,41,39
19,Guadalajara,111,Escariche,203,114,89
19,Guadalajara,112,Escopete,75,42,33
19,Guadalajara,113,Espinosa de Henares,800,426,374
19,Guadalajara,114,Esplegares,44,28,16
19,Guadalajara,115,Establés,45,25,20
19,Guadalajara,116,Estriégana,22,15,7
19,Guadalajara,117,Fontanar,2342,1234,1108
19,Guadalajara,118,Fuembellida,14,9,5
19,Guadalajara,119,Fuencemillán,136,82,54
19,Guadalajara,120,Fuentelahiguera de Albatages,129,73,56
19,Guadalajara,121,Fuentelencina,326,182,144
19,Guadalajara,122,Fuentelsaz,109,55,54
19,Guadalajara,123,Fuentelviejo,48,28,20
19,Guadalajara,124,Fuentenovilla,634,355,279
19,Guadalajara,125,Gajanejos,53,32,21
19,Guadalajara,126,Galápagos,2246,1197,1049
19,Guadalajara,127,Galve de Sorbe,121,68,53
19,Guadalajara,129,Gascueña de Bornova,62,41,21
19,Guadalajara,130,Guadalajara,84803,41489,43314
19,Guadalajara,132,Henche,104,56,48
19,Guadalajara,133,Heras de Ayuso,260,150,110
19,Guadalajara,134,Herrería,23,16,7
19,Guadalajara,135,Hiendelaencina,154,85,69
19,Guadalajara,136,Hijes,29,17,12
19,Guadalajara,138,Hita,403,219,184
19,Guadalajara,139,Hombrados,37,22,15
19,Guadalajara,142,Hontoba,315,167,148
19,Guadalajara,143,Horche,2510,1302,1208
19,Guadalajara,145,Hortezuela de Océn,67,39,28
19,Guadalajara,146,"Huerce, La",59,33,26
19,Guadalajara,147,Huérmeces del Cerro,54,32,22
19,Guadalajara,148,Huertahernando,62,42,20
19,Guadalajara,150,Hueva,140,77,63
19,Guadalajara,151,Humanes,1616,809,807
19,Guadalajara,152,Illana,893,521,372
19,Guadalajara,153,Iniéstola,20,15,5
19,Guadalajara,154,"Inviernas, Las",80,45,35
19,Guadalajara,155,Irueste,63,41,22
19,Guadalajara,156,Jadraque,1662,861,801
19,Guadalajara,157,Jirueque,72,46,26
19,Guadalajara,159,Ledanca,112,57,55
19,Guadalajara,160,Loranca de Tajuña,1388,758,630
19,Guadalajara,161,Lupiana,275,145,130
19,Guadalajara,162,Luzaga,91,53,38
19,Guadalajara,163,Luzón,79,39,40
19,Guadalajara,165,Majaelrayo,60,35,25
19,Guadalajara,166,Málaga del Fresno,204,116,88
19,Guadalajara,167,Malaguilla,145,80,65
19,Guadalajara,168,Mandayona,354,183,171
19,Guadalajara,169,Mantiel,58,30,28
19,Guadalajara,170,Maranchón,254,139,115
19,Guadalajara,171,Marchamalo,6468,3310,3158
19,Guadalajara,172,Masegoso de Tajuña,84,49,35
19,Guadalajara,173,Matarrubia,59,42,17
19,Guadalajara,174,Matillas,158,78,80
19,Guadalajara,175,Mazarete,54,25,29
19,Guadalajara,176,Mazuecos,328,170,158
19,Guadalajara,177,Medranda,98,52,46
19,Guadalajara,178,Megina,48,31,17
19,Guadalajara,179,Membrillera,119,60,59
19,Guadalajara,181,Miedes de Atienza,73,42,31
19,Guadalajara,182,"Mierla, La",37,25,12
19,Guadalajara,184,Millana,152,87,65
19,Guadalajara,183,Milmarcos,104,59,45
19,Guadalajara,185,"Miñosa, La",41,28,13
19,Guadalajara,186,Mirabueno,96,57,39
19,Guadalajara,187,Miralrío,91,49,42
19,Guadalajara,188,Mochales,64,34,30
19,Guadalajara,189,Mohernando,200,101,99
19,Guadalajara,190,Molina de Aragón,3706,1875,1831
19,Guadalajara,191,Monasterio,19,8,11
19,Guadalajara,192,Mondéjar,2750,1440,1310
19,Guadalajara,193,Montarrón,31,19,12
19,Guadalajara,194,Moratilla de los Meleros,137,79,58
19,Guadalajara,195,Morenilla,49,30,19
19,Guadalajara,196,Muduex,114,60,54
19,Guadalajara,197,"Navas de Jadraque, Las",32,20,12
19,Guadalajara,198,Negredo,26,14,12
19,Guadalajara,199,Ocentejo,25,14,11
19,Guadalajara,200,"Olivar, El",129,75,54
19,Guadalajara,201,Olmeda de Cobeta,82,40,42
19,Guadalajara,202,"Olmeda de Jadraque, La",14,6,8
19,Guadalajara,203,"Ordial, El",34,18,16
19,Guadalajara,204,Orea,245,152,93
19,Guadalajara,208,Pálmaces de Jadraque,63,36,27
19,Guadalajara,209,Pardos,55,29,26
19,Guadalajara,210,Paredes de Sigüenza,33,18,15
19,Guadalajara,211,Pareja,523,299,224
19,Guadalajara,212,Pastrana,1070,547,523
19,Guadalajara,213,"Pedregal, El",84,51,33
19,Guadalajara,214,Peñalén,98,54,44
19,Guadalajara,215,Peñalver,225,137,88
19,Guadalajara,216,Peralejos de las Truchas,151,85,66
19,Guadalajara,217,Peralveche,81,51,30
19,Guadalajara,218,Pinilla de Jadraque,63,35,28
19,Guadalajara,219,Pinilla de Molina,22,12,10
19,Guadalajara,220,Pioz,3563,1923,1640
19,Guadalajara,221,Piqueras,57,37,20
19,Guadalajara,222,"Pobo de Dueñas, El",144,76,68
19,Guadalajara,223,Poveda de la Sierra,138,78,60
19,Guadalajara,224,Pozo de Almoguera,118,63,55
19,Guadalajara,225,Pozo de Guadalajara,1329,697,632
19,Guadalajara,226,Prádena de Atienza,49,33,16
19,Guadalajara,227,Prados Redondos,95,53,42
19,Guadalajara,228,Puebla de Beleña,57,32,25
19,Guadalajara,229,Puebla de Valles,83,45,38
19,Guadalajara,230,Quer,676,358,318
19,Guadalajara,231,Rebollosa de Jadraque,15,10,5
19,Guadalajara,232,"Recuenco, El",86,51,35
19,Guadalajara,233,Renera,122,72,50
19,Guadalajara,234,Retiendas,56,32,24
19,Guadalajara,235,Riba de Saelices,123,71,52
19,Guadalajara,237,Rillo de Gallo,61,35,26
19,Guadalajara,238,Riofrío del Llano,45,28,17
19,Guadalajara,239,Robledillo de Mohernando,136,68,68
19,Guadalajara,240,Robledo de Corpes,71,37,34
19,Guadalajara,241,Romanillos de Atienza,50,29,21
19,Guadalajara,242,Romanones,130,72,58
19,Guadalajara,243,Rueda de la Sierra,59,37,22
19,Guadalajara,244,Sacecorbo,109,62,47
19,Guadalajara,245,Sacedón,1851,992,859
19,Guadalajara,246,Saelices de la Sal,53,30,23
19,Guadalajara,247,Salmerón,188,103,85
19,Guadalajara,248,San Andrés del Congosto,94,58,36
19,Guadalajara,249,San Andrés del Rey,37,17,20
19,Guadalajara,250,Santiuste,23,14,9
19,Guadalajara,251,Saúca,53,29,24
19,Guadalajara,252,Sayatón,117,68,49
19,Guadalajara,254,Selas,64,30,34
19,Guadalajara,901,Semillas,39,24,15
19,Guadalajara,255,Setiles,98,59,39
19,Guadalajara,256,Sienes,62,36,26
19,Guadalajara,257,Sigüenza,4842,2444,2398
19,Guadalajara,258,Solanillos del Extremo,109,64,45
19,Guadalajara,259,Somolinos,35,17,18
19,Guadalajara,260,"Sotillo, El",50,26,24
19,Guadalajara,261,Sotodosos,47,20,27
19,Guadalajara,262,Tamajón,175,91,84
19,Guadalajara,263,Taragudo,43,21,22
19,Guadalajara,264,Taravilla,45,27,18
19,Guadalajara,265,Tartanedo,172,93,79
19,Guadalajara,266,Tendilla,400,213,187
19,Guadalajara,267,Terzaga,20,13,7
19,Guadalajara,268,Tierzo,40,26,14
19,Guadalajara,269,"Toba, La",109,63,46
19,Guadalajara,271,Tordellego,62,32,30
19,Guadalajara,270,Tordelrábano,16,9,7
19,Guadalajara,272,Tordesilos,118,74,44
19,Guadalajara,274,Torija,1660,901,759
19,Guadalajara,279,Torre del Burgo,239,119,120
19,Guadalajara,277,Torrecuadrada de Molina,24,13,11
19,Guadalajara,278,Torrecuadradilla,33,19,14
19,Guadalajara,280,Torrejón del Rey,5141,2706,2435
19,Guadalajara,281,Torremocha de Jadraque,31,20,11
19,Guadalajara,282,Torremocha del Campo,240,137,103
19,Guadalajara,283,Torremocha del Pinar,48,22,26
19,Guadalajara,284,Torremochuela,12,7,5
19,Guadalajara,285,Torrubia,24,13,11
19,Guadalajara,286,Tórtola de Henares,941,515,426
19,Guadalajara,287,Tortuera,226,125,101
19,Guadalajara,288,Tortuero,18,11,7
19,Guadalajara,289,Traíd,33,19,14
19,Guadalajara,290,Trijueque,1387,746,641
19,Guadalajara,291,Trillo,1520,787,733
19,Guadalajara,293,Uceda,2642,1386,1256
19,Guadalajara,294,Ujados,31,18,13
19,Guadalajara,296,Utande,42,29,13
19,Guadalajara,297,Valdarachas,37,17,20
19,Guadalajara,298,Valdearenas,95,60,35
19,Guadalajara,299,Valdeavellano,95,58,37
19,Guadalajara,300,Valdeaveruelo,1090,574,516
19,Guadalajara,301,Valdeconcha,43,26,17
19,Guadalajara,302,Valdegrudas,67,46,21
19,Guadalajara,303,Valdelcubo,74,46,28
19,Guadalajara,304,Valdenuño Fernández,282,158,124
19,Guadalajara,305,Valdepeñas de la Sierra,193,111,82
19,Guadalajara,306,Valderrebollo,40,18,22
19,Guadalajara,307,Valdesotos,25,13,12
19,Guadalajara,308,Valfermoso de Tajuña,64,37,27
19,Guadalajara,309,Valhermoso,39,24,15
19,Guadalajara,310,Valtablado del Río,12,9,3
19,Guadalajara,311,Valverde de los Arroyos,90,52,38
19,Guadalajara,314,Viana de Jadraque,53,35,18
19,Guadalajara,317,Villanueva de Alcorón,188,98,90
19,Guadalajara,318,Villanueva de Argecilla,43,24,19
19,Guadalajara,319,Villanueva de la Torre,6438,3267,3171
19,Guadalajara,321,Villares de Jadraque,65,41,24
19,Guadalajara,322,Villaseca de Henares,34,18,16
19,Guadalajara,323,Villaseca de Uceda,55,31,24
19,Guadalajara,324,Villel de Mesa,217,118,99
19,Guadalajara,325,Viñuelas,130,73,57
19,Guadalajara,326,Yebes,2177,1132,1045
19,Guadalajara,327,Yebra,632,328,304
19,Guadalajara,329,Yélamos de Abajo,70,34,36
19,Guadalajara,330,Yélamos de Arriba,110,60,50
19,Guadalajara,331,Yunquera de Henares,3728,1906,1822
19,Guadalajara,332,"Yunta, La",115,63,52
19,Guadalajara,333,Zaorejas,158,102,56
19,Guadalajara,334,Zarzuela de Jadraque,40,27,13
19,Guadalajara,335,Zorita de los Canes,98,50,48
21,Huelva,1,Alájar,803,411,392
21,Huelva,2,Aljaraque,19245,9622,9623
21,Huelva,3,"Almendro, El",859,454,405
21,Huelva,4,Almonaster la Real,1824,918,906
21,Huelva,5,Almonte,22609,11324,11285
21,Huelva,6,Alosno,4231,2060,2171
21,Huelva,7,Aracena,7814,3851,3963
21,Huelva,8,Aroche,3258,1624,1634
21,Huelva,9,Arroyomolinos de León,1009,521,488
21,Huelva,10,Ayamonte,20968,10571,10397
21,Huelva,11,Beas,4321,2169,2152
21,Huelva,12,Berrocal,337,159,178
21,Huelva,13,Bollullos Par del Condado,14210,7090,7120
21,Huelva,14,Bonares,6194,3088,3106
21,Huelva,15,Cabezas Rubias,811,436,375
21,Huelva,16,Cala,1289,644,645
21,Huelva,17,Calañas,4159,2068,2091
21,Huelva,18,"Campillo, El",2202,1058,1144
21,Huelva,19,Campofrío,785,396,389
21,Huelva,20,Cañaveral de León,459,227,232
21,Huelva,21,Cartaya,19185,9901,9284
21,Huelva,22,Castaño del Robledo,213,124,89
21,Huelva,23,"Cerro de Andévalo, El",2417,1185,1232
21,Huelva,30,Chucena,2176,1108,1068
21,Huelva,24,Corteconcepción,597,295,302
21,Huelva,25,Cortegana,4914,2477,2437
21,Huelva,26,Cortelazor,290,144,146
21,Huelva,27,Cumbres de Enmedio,65,41,24
21,Huelva,28,Cumbres de San Bartolomé,435,211,224
21,Huelva,29,Cumbres Mayores,1898,955,943
21,Huelva,31,Encinasola,1481,762,719
21,Huelva,32,Escacena del Campo,2009,1006,1003
21,Huelva,33,Fuenteheridos,559,286,273
21,Huelva,34,Galaroza,1587,779,808
21,Huelva,35,Gibraleón,12590,6271,6319
21,Huelva,36,"Granada de Río-Tinto, La",239,120,119
21,Huelva,37,"Granado, El",570,310,260
21,Huelva,38,Higuera de la Sierra,1390,697,693
21,Huelva,39,Hinojales,348,176,172
21,Huelva,40,Hinojos,3933,1963,1970
21,Huelva,41,Huelva,148568,71652,76916
21,Huelva,42,Isla Cristina,21958,10875,11083
21,Huelva,43,Jabugo,2327,1163,1164
21,Huelva,44,Lepe,27214,13984,13230
21,Huelva,45,Linares de la Sierra,286,146,140
21,Huelva,46,Lucena del Puerto,3124,1592,1532
21,Huelva,47,Manzanilla,2270,1153,1117
21,Huelva,48,"Marines, Los",331,166,165
21,Huelva,49,Minas de Riotinto,4112,1984,2128
21,Huelva,50,Moguer,20944,10378,10566
21,Huelva,51,"Nava, La",313,153,160
21,Huelva,52,Nerva,5766,2770,2996
21,Huelva,53,Niebla,4149,2103,2046
21,Huelva,54,"Palma del Condado, La",10606,5301,5305
21,Huelva,55,Palos de la Frontera,9809,4888,4921
21,Huelva,56,Paterna del Campo,3611,1851,1760
21,Huelva,57,Paymogo,1293,641,652
21,Huelva,58,Puebla de Guzmán,3125,1603,1522
21,Huelva,59,Puerto Moral,275,137,138
21,Huelva,60,Punta Umbría,14919,7586,7333
21,Huelva,61,Rociana del Condado,7634,3840,3794
21,Huelva,62,Rosal de la Frontera,1890,958,932
21,Huelva,63,San Bartolomé de la Torre,3560,1793,1767
21,Huelva,64,San Juan del Puerto,8479,4257,4222
21,Huelva,66,San Silvestre de Guzmán,718,387,331
21,Huelva,65,Sanlúcar de Guadiana,446,226,220
21,Huelva,67,Santa Ana la Real,542,251,291
21,Huelva,68,Santa Bárbara de Casa,1151,568,583
21,Huelva,69,Santa Olalla del Cala,2120,1082,1038
21,Huelva,70,Trigueros,7801,3885,3916
21,Huelva,71,Valdelarco,234,112,122
21,Huelva,72,Valverde del Camino,12902,6313,6589
21,Huelva,73,Villablanca,2975,1532,1443
21,Huelva,74,Villalba del Alcor,3444,1694,1750
21,Huelva,75,Villanueva de las Cruces,412,198,214
21,Huelva,76,Villanueva de los Castillejos,2785,1387,1398
21,Huelva,77,Villarrasa,2203,1113,1090
21,Huelva,78,Zalamea la Real,3365,1680,1685
21,Huelva,79,Zufre,918,466,452
22,Huesca,1,Abiego,277,146,131
22,Huesca,2,Abizanda,136,67,69
22,Huesca,3,Adahuesca,182,88,94
22,Huesca,4,Agüero,159,91,68
22,Huesca,907,Aínsa-Sobrarbe,2242,1147,1095
22,Huesca,6,Aisa,367,200,167
22,Huesca,7,Albalate de Cinca,1251,657,594
22,Huesca,8,Albalatillo,224,117,107
22,Huesca,9,Albelda,810,437,373
22,Huesca,11,Albero Alto,134,77,57
22,Huesca,12,Albero Bajo,114,62,52
22,Huesca,13,Alberuela de Tubo,348,178,170
22,Huesca,14,Alcalá de Gurrea,285,144,141
22,Huesca,15,Alcalá del Obispo,368,192,176
22,Huesca,16,Alcampell,746,377,369
22,Huesca,17,Alcolea de Cinca,1141,602,539
22,Huesca,18,Alcubierre,424,223,201
22,Huesca,19,Alerre,211,112,99
22,Huesca,20,Alfántega,135,64,71
22,Huesca,21,Almudévar,2519,1303,1216
22,Huesca,22,Almunia de San Juan,664,346,318
22,Huesca,23,Almuniente,564,289,275
22,Huesca,24,Alquézar,301,167,134
22,Huesca,25,Altorricón,1494,813,681
22,Huesca,27,Angüés,419,223,196
22,Huesca,28,Ansó,467,240,227
22,Huesca,29,Antillón,148,79,69
22,Huesca,32,Aragüés del Puerto,128,71,57
22,Huesca,35,Arén,362,192,170
22,Huesca,36,Argavieso,110,64,46
22,Huesca,37,Arguis,125,73,52
22,Huesca,39,Ayerbe,1117,560,557
22,Huesca,40,Azanuy-Alins,174,85,89
22,Huesca,41,Azara,200,103,97
22,Huesca,42,Azlor,133,65,68
22,Huesca,43,Baélls,123,70,53
22,Huesca,44,Bailo,311,181,130
22,Huesca,45,Baldellou,113,61,52
22,Huesca,46,Ballobar,940,485,455
22,Huesca,47,Banastás,286,151,135
22,Huesca,48,Barbastro,17304,8449,8855
22,Huesca,49,Barbués,98,53,45
22,Huesca,50,Barbuñales,105,52,53
22,Huesca,51,Bárcabo,117,70,47
22,Huesca,52,Belver de Cinca,1375,754,621
22,Huesca,53,Benabarre,1215,634,581
22,Huesca,54,Benasque,2217,1155,1062
22,Huesca,246,Beranuy,97,57,40
22,Huesca,55,Berbegal,420,216,204
22,Huesca,57,Bielsa,503,255,248
22,Huesca,58,Bierge,251,142,109
22,Huesca,59,Biescas,1589,861,728
22,Huesca,60,Binaced,1498,775,723
22,Huesca,61,Binéfar,9456,4940,4516
22,Huesca,62,Bisaurri,202,104,98
22,Huesca,63,Biscarrués,226,123,103
22,Huesca,64,Blecua y Torres,219,120,99
22,Huesca,66,Boltaña,1092,592,500
22,Huesca,67,Bonansa,96,51,45
22,Huesca,68,Borau,84,49,35
22,Huesca,69,Broto,542,289,253
22,Huesca,72,Caldearenas,223,130,93
22,Huesca,74,Campo,330,164,166
22,Huesca,75,Camporrélls,167,92,75
22,Huesca,76,Canal de Berdún,365,203,162
22,Huesca,77,Candasnos,381,198,183
22,Huesca,78,Canfranc,599,338,261
22,Huesca,79,Capdesaso,184,71,113
22,Huesca,80,Capella,360,189,171
22,Huesca,81,Casbas de Huesca,304,163,141
22,Huesca,83,Castejón de Monegros,623,326,297
22,Huesca,84,Castejón de Sos,767,401,366
22,Huesca,82,Castejón del Puente,360,181,179
22,Huesca,85,Castelflorite,131,69,62
22,Huesca,86,Castiello de Jaca,249,133,116
22,Huesca,87,Castigaleu,104,60,44
22,Huesca,88,Castillazuelo,189,88,101
22,Huesca,89,Castillonroy,360,178,182
22,Huesca,94,Chalamera,115,60,55
22,Huesca,95,Chía,97,61,36
22,Huesca,96,Chimillas,370,186,184
22,Huesca,90,Colungo,131,75,56
22,Huesca,99,Esplús,663,338,325
22,Huesca,102,Estada,230,131,99
22,Huesca,103,Estadilla,855,403,452
22,Huesca,105,Estopiñán del Castillo,161,84,77
22,Huesca,106,Fago,29,14,15
22,Huesca,107,Fanlo,126,78,48
22,Huesca,109,Fiscal,346,188,158
22,Huesca,110,Fonz,982,509,473
22,Huesca,111,Foradada del Toscar,208,111,97
22,Huesca,112,Fraga,14655,7516,7139
22,Huesca,113,"Fueva, La",641,334,307
22,Huesca,114,Gistaín,147,80,67
22,Huesca,115,"Grado, El",471,249,222
22,Huesca,116,Grañén,1990,1027,963
22,Huesca,117,Graus,3595,1847,1748
22,Huesca,119,Gurrea de Gállego,1644,862,782
22,Huesca,122,Hoz de Jaca,72,37,35
22,Huesca,908,Hoz y Costean,204,115,89
22,Huesca,124,Huerto,266,144,122
22,Huesca,125,Huesca,52296,25200,27096
22,Huesca,126,Ibieca,113,63,50
22,Huesca,127,Igriés,658,341,317
22,Huesca,128,Ilche,226,115,111
22,Huesca,129,Isábena,307,167,140
22,Huesca,130,Jaca,13248,6575,6673
22,Huesca,131,Jasa,112,68,44
22,Huesca,133,Labuerda,156,80,76
22,Huesca,135,Laluenga,221,121,100
22,Huesca,136,Lalueza,1066,557,509
22,Huesca,137,Lanaja,1358,721,637
22,Huesca,139,Laperdiguera,101,52,49
22,Huesca,141,Lascellas-Ponzano,143,80,63
22,Huesca,142,Lascuarre,152,77,75
22,Huesca,143,Laspaúles,322,184,138
22,Huesca,144,Laspuña,296,159,137
22,Huesca,149,Loarre,361,200,161
22,Huesca,150,Loporzano,549,308,241
22,Huesca,151,Loscorrales,107,52,55
22,Huesca,905,Lupiñén-Ortilla,378,190,188
22,Huesca,155,Monesma y Cajigar,95,52,43
22,Huesca,156,Monflorite-Lascasas,301,167,134
22,Huesca,157,Montanuy,265,158,107
22,Huesca,158,Monzón,17263,8817,8446
22,Huesca,160,Naval,250,127,123
22,Huesca,162,Novales,177,85,92
22,Huesca,163,Nueno,567,319,248
22,Huesca,164,Olvena,53,23,30
22,Huesca,165,Ontiñena,584,296,288
22,Huesca,167,Osso de Cinca,806,406,400
22,Huesca,168,Palo,30,15,15
22,Huesca,170,Panticosa,790,407,383
22,Huesca,172,Peñalba,759,396,363
22,Huesca,173,"Peñas de Riglos, Las",268,161,107
22,Huesca,174,Peralta de Alcofea,596,310,286
22,Huesca,175,Peralta de Calasanz,242,134,108
22,Huesca,176,Peraltilla,202,105,97
22,Huesca,177,Perarrúa,109,61,48
22,Huesca,178,Pertusa,121,69,52
22,Huesca,181,Piracés,100,57,43
22,Huesca,182,Plan,314,162,152
22,Huesca,184,Poleñino,217,116,101
22,Huesca,186,Pozán de Vero,243,120,123
22,Huesca,187,"Puebla de Castro, La",430,218,212
22,Huesca,188,Puente de Montañana,133,56,77
22,Huesca,902,Puente la Reina de Jaca,286,153,133
22,Huesca,189,Puértolas,225,125,100
22,Huesca,190,"Pueyo de Araguás, El",154,92,62
22,Huesca,193,Pueyo de Santa Cruz,362,185,177
22,Huesca,195,Quicena,291,150,141
22,Huesca,197,Robres,605,313,292
22,Huesca,199,Sabiñánigo,10241,5204,5037
22,Huesca,200,Sahún,340,181,159
22,Huesca,201,Salas Altas,311,159,152
22,Huesca,202,Salas Bajas,138,59,79
22,Huesca,203,Salillas,106,57,49
22,Huesca,204,Sallent de Gállego,1512,762,750
22,Huesca,205,San Esteban de Litera,502,270,232
22,Huesca,207,San Juan de Plan,162,87,75
22,Huesca,903,San Miguel del Cinca,849,433,416
22,Huesca,206,Sangarrén,227,114,113
22,Huesca,208,Santa Cilia,201,107,94
22,Huesca,209,Santa Cruz de la Serós,194,109,85
22,Huesca,906,Santa María de Dulcis,226,121,105
22,Huesca,212,Santaliestra y San Quílez,94,47,47
22,Huesca,213,Sariñena,4402,2289,2113
22,Huesca,214,Secastilla,153,67,86
22,Huesca,215,Seira,149,82,67
22,Huesca,217,Sena,542,291,251
22,Huesca,218,Senés de Alcubierre,53,23,30
22,Huesca,220,Sesa,208,113,95
22,Huesca,221,Sesué,127,72,55
22,Huesca,222,Siétamo,650,353,297
22,Huesca,223,Sopeira,114,63,51
22,Huesca,904,"Sotonera, La",1042,551,491
22,Huesca,225,Tamarite de Litera,3656,1864,1792
22,Huesca,226,Tardienta,985,499,486
22,Huesca,227,Tella-Sin,263,149,114
22,Huesca,228,Tierz,714,366,348
22,Huesca,229,Tolva,152,88,64
22,Huesca,230,Torla,320,165,155
22,Huesca,232,Torralba de Aragón,110,57,53
22,Huesca,233,Torre la Ribera,117,58,59
22,Huesca,234,Torrente de Cinca,1321,688,633
22,Huesca,235,Torres de Alcanadre,105,57,48
22,Huesca,236,Torres de Barbués,297,150,147
22,Huesca,239,Tramaced,94,58,36
22,Huesca,242,Valfarta,74,45,29
22,Huesca,243,Valle de Bardají,49,26,23
22,Huesca,901,Valle de Hecho,937,488,449
22,Huesca,244,Valle de Lierp,64,36,28
22,Huesca,245,Velilla de Cinca,452,233,219
22,Huesca,909,Vencillón,455,241,214
22,Huesca,247,Viacamp y Litera,51,33,18
22,Huesca,248,Vicién,115,66,49
22,Huesca,249,Villanova,148,73,75
22,Huesca,250,Villanúa,499,272,227
22,Huesca,251,Villanueva de Sigena,464,232,232
22,Huesca,252,Yebra de Basa,147,83,64
22,Huesca,253,Yésero,67,42,25
22,Huesca,254,Zaidín,1750,888,862
23,Jaén,1,Albanchez de Mágina,1233,643,590
23,Jaén,2,Alcalá la Real,22870,11408,11462
23,Jaén,3,Alcaudete,11139,5587,5552
23,Jaén,4,Aldeaquemada,550,290,260
23,Jaén,5,Andújar,39008,19279,19729
23,Jaén,6,Arjona,5763,2876,2887
23,Jaén,7,Arjonilla,3830,1914,1916
23,Jaén,8,Arquillos,1970,996,974
23,Jaén,905,Arroyo del Ojanco,2525,1325,1200
23,Jaén,9,Baeza,16535,8250,8285
23,Jaén,10,Bailén,18725,9402,9323
23,Jaén,11,Baños de la Encina,2694,1388,1306
23,Jaén,12,Beas de Segura,5804,3109,2695
23,Jaén,902,Bedmar y Garcíez,3051,1532,1519
23,Jaén,14,Begíjar,3151,1570,1581
23,Jaén,15,Bélmez de la Moraleda,1752,874,878
23,Jaén,16,Benatae,551,299,252
23,Jaén,17,Cabra del Santo Cristo,2034,1068,966
23,Jaén,18,Cambil,2912,1514,1398
23,Jaén,19,Campillo de Arenas,2073,1104,969
23,Jaén,20,Canena,2105,1102,1003
23,Jaén,21,Carboneros,663,344,319
23,Jaén,901,Cárcheles,1497,788,709
23,Jaén,24,"Carolina, La",15945,7917,8028
23,Jaén,25,Castellar,3543,1793,1750
23,Jaén,26,Castillo de Locubín,4659,2310,2349
23,Jaén,27,Cazalilla,928,453,475
23,Jaén,28,Cazorla,7984,3894,4090
23,Jaén,29,Chiclana de Segura,1147,602,545
23,Jaén,30,Chilluévar,1635,827,808
23,Jaén,31,Escañuela,975,495,480
23,Jaén,32,Espelúy,735,370,365
23,Jaén,33,Frailes,1723,867,856
23,Jaén,34,Fuensanta de Martos,3254,1615,1639
23,Jaén,35,Fuerte del Rey,1402,718,684
23,Jaén,37,Génave,646,350,296
23,Jaén,38,"Guardia de Jaén, La",4551,2339,2212
23,Jaén,39,Guarromán,2936,1476,1460
23,Jaén,41,Higuera de Calatrava,653,350,303
23,Jaén,42,Hinojares,436,230,206
23,Jaén,43,Hornos,685,340,345
23,Jaén,44,Huelma,6162,3053,3109
23,Jaén,45,Huesa,2648,1339,1309
23,Jaén,46,Ibros,3059,1527,1532
23,Jaén,47,"Iruela, La",2132,1110,1022
23,Jaén,48,Iznatoraf,1080,588,492
23,Jaén,49,Jabalquinto,2335,1187,1148
23,Jaén,50,Jaén,116731,56446,60285
23,Jaén,51,Jamilena,3496,1782,1714
23,Jaén,52,Jimena,1399,681,718
23,Jaén,53,Jódar,12117,6011,6106
23,Jaén,40,Lahiguera,1856,913,943
23,Jaén,54,Larva,495,257,238
23,Jaén,55,Linares,60950,29893,31057
23,Jaén,56,Lopera,3888,1944,1944
23,Jaén,57,Lupión,960,475,485
23,Jaén,58,Mancha Real,11308,5691,5617
23,Jaén,59,Marmolejo,7329,3674,3655
23,Jaén,60,Martos,24547,12139,12408
23,Jaén,61,Mengíbar,9908,4984,4924
23,Jaén,62,Montizón,1904,1007,897
23,Jaén,63,Navas de San Juan,4982,2520,2462
23,Jaén,64,Noalejo,2106,1085,1021
23,Jaén,65,Orcera,1992,1004,988
23,Jaén,66,Peal de Becerro,5614,2876,2738
23,Jaén,67,Pegalajar,3093,1551,1542
23,Jaén,69,Porcuna,6806,3442,3364
23,Jaén,70,Pozo Alcón,5260,2717,2543
23,Jaén,71,Puente de Génave,2305,1171,1134
23,Jaén,72,"Puerta de Segura, La",2638,1343,1295
23,Jaén,73,Quesada,5906,3038,2868
23,Jaén,74,Rus,3785,1955,1830
23,Jaén,75,Sabiote,4229,2104,2125
23,Jaén,76,Santa Elena,990,528,462
23,Jaén,77,Santiago de Calatrava,811,420,391
23,Jaén,904,Santiago-Pontones,3565,1836,1729
23,Jaén,79,Santisteban del Puerto,4788,2485,2303
23,Jaén,80,Santo Tomé,2635,1456,1179
23,Jaén,81,Segura de la Sierra,1982,989,993
23,Jaén,82,Siles,2451,1249,1202
23,Jaén,84,Sorihuela del Guadalimar,1342,695,647
23,Jaén,86,Torre del Campo,14690,7370,7320
23,Jaén,85,Torreblascopedro,2824,1422,1402
23,Jaén,87,Torredonjimeno,14126,6954,7172
23,Jaén,88,Torreperogil,7720,3823,3897
23,Jaén,90,Torres,1619,826,793
23,Jaén,91,Torres de Albánchez,950,493,457
23,Jaén,92,Úbeda,35784,17638,18146
23,Jaén,93,Valdepeñas de Jaén,4096,2040,2056
23,Jaén,94,Vilches,4831,2479,2352
23,Jaén,95,Villacarrillo,11442,5879,5563
23,Jaén,96,Villanueva de la Reina,3358,1714,1644
23,Jaén,97,Villanueva del Arzobispo,8942,4765,4177
23,Jaén,98,Villardompardo,1101,554,547
23,Jaén,99,"Villares, Los",5974,2979,2995
23,Jaén,101,Villarrodrigo,462,242,220
23,Jaén,903,Villatorres,4467,2275,2192
24,León,1,Acebedo,256,156,100
24,León,2,Algadefe,303,157,146
24,León,3,Alija del Infantado,798,398,400
24,León,4,Almanza,623,353,270
24,León,5,"Antigua, La",455,258,197
24,León,6,Ardón,614,326,288
24,León,7,Arganza,850,439,411
24,León,8,Astorga,11826,5612,6214
24,León,9,Balboa,357,190,167
24,León,10,"Bañeza, La",10843,5241,5602
24,León,11,Barjas,232,120,112
24,León,12,"Barrios de Luna, Los",317,181,136
24,León,14,Bembibre,9929,4914,5015
24,León,15,Benavides,2740,1371,1369
24,León,16,Benuza,549,299,250
24,León,17,Bercianos del Páramo,661,332,329
24,León,18,Bercianos del Real Camino,195,101,94
24,León,19,Berlanga del Bierzo,401,188,213
24,León,20,Boca de Huérgano,519,303,216
24,León,21,Boñar,2048,1034,1014
24,León,22,Borrenes,385,198,187
24,León,23,Brazuelo,334,178,156
24,León,24,"Burgo Ranero, El",794,428,366
24,León,25,Burón,356,216,140
24,León,26,Bustillo del Páramo,1410,734,676
24,León,27,Cabañas Raras,1316,674,642
24,León,28,Cabreros del Río,460,242,218
24,León,29,Cabrillanes,905,465,440
24,León,30,Cacabelos,5506,2762,2744
24,León,31,Calzada del Coto,261,147,114
24,León,32,Campazas,151,76,75
24,León,33,Campo de Villavidel,210,113,97
24,León,34,Camponaraya,4220,2120,2100
24,León,36,Candín,333,169,164
24,León,37,Cármenes,437,231,206
24,León,38,Carracedelo,3680,1808,1872
24,León,39,Carrizo,2499,1268,1231
24,León,40,Carrocera,565,290,275
24,León,41,Carucedo,655,329,326
24,León,42,Castilfalé,78,43,35
24,León,43,Castrillo de Cabrera,141,79,62
24,León,44,Castrillo de la Valduerna,181,81,100
24,León,46,Castrocalbón,1037,545,492
24,León,47,Castrocontrigo,895,463,432
24,León,49,Castropodame,1805,930,875
24,León,50,Castrotierra de Valmadrigal,116,60,56
24,León,51,Cea,515,273,242
24,León,52,Cebanico,186,104,82
24,León,53,Cebrones del Río,546,294,252
24,León,65,Chozas de Abajo,2415,1264,1151
24,León,54,Cimanes de la Vega,549,281,268
24,León,55,Cimanes del Tejar,804,422,382
24,León,56,Cistierna,3652,1781,1871
24,León,57,Congosto,1676,821,855
24,León,58,Corbillos de los Oteros,226,127,99
24,León,59,Corullón,1080,552,528
24,León,60,Crémenes,614,327,287
24,León,61,Cuadros,2010,1019,991
24,León,62,Cubillas de los Oteros,154,82,72
24,León,63,Cubillas de Rueda,512,265,247
24,León,64,Cubillos del Sil,1852,978,874
24,León,66,Destriana,597,285,312
24,León,67,Encinedo,828,431,397
24,León,68,"Ercina, La",537,275,262
24,León,69,Escobar de Campos,52,32,20
24,León,70,Fabero,5106,2486,2620
24,León,71,Folgoso de la Ribera,1226,595,631
24,León,73,Fresno de la Vega,654,319,335
24,León,74,Fuentes de Carbajal,115,63,52
24,León,76,Garrafe de Torío,1374,727,647
24,León,77,Gordaliza del Pino,283,138,145
24,León,78,Gordoncillo,494,248,246
24,León,79,Gradefes,1074,563,511
24,León,80,Grajal de Campos,238,114,124
24,León,81,Gusendos de los Oteros,142,80,62
24,León,82,Hospital de Órbigo,1005,493,512
24,León,83,Igüeña,1356,714,642
24,León,84,Izagre,204,108,96
24,León,86,Joarilla de las Matas,354,189,165
24,León,87,Laguna Dalga,725,380,345
24,León,88,Laguna de Negrillos,1123,571,552
24,León,89,León,131680,60354,71326
24,León,92,Llamas de la Ribera,963,493,470
24,León,90,Lucillo,414,218,196
24,León,91,Luyego,747,373,374
24,León,93,Magaz de Cepeda,397,197,200
24,León,94,Mansilla de las Mulas,1922,988,934
24,León,95,Mansilla Mayor,325,167,158
24,León,96,Maraña,162,93,69
24,León,97,Matadeón de los Oteros,277,145,132
24,León,98,Matallana de Torío,1403,730,673
24,León,99,Matanza,232,127,105
24,León,100,Molinaseca,886,477,409
24,León,101,Murias de Paredes,483,239,244
24,León,102,Noceda del Bierzo,760,380,380
24,León,103,Oencia,349,207,142
24,León,104,"Omañas, Las",315,166,149
24,León,105,Onzonilla,1764,927,837
24,León,106,Oseja de Sajambre,312,183,129
24,León,107,Pajares de los Oteros,362,227,135
24,León,108,Palacios de la Valduerna,448,218,230
24,León,109,Palacios del Sil,1159,634,525
24,León,110,Páramo del Sil,1421,725,696
24,León,112,Peranzanes,332,191,141
24,León,113,Pobladura de Pelayo García,426,215,211
24,León,114,"Pola de Gordón, La",3905,1954,1951
24,León,115,Ponferrada,68549,32956,35593
24,León,116,Posada de Valdeón,485,289,196
24,León,117,Pozuelo del Páramo,519,265,254
24,León,118,Prado de la Guzpeña,138,77,61
24,León,119,Priaranza del Bierzo,828,416,412
24,León,120,Prioro,404,219,185
24,León,121,Puebla de Lillo,704,392,312
24,León,122,Puente de Domingo Flórez,1633,848,785
24,León,123,Quintana del Castillo,869,472,397
24,León,124,Quintana del Marco,450,243,207
24,León,125,Quintana y Congosto,484,246,238
24,León,127,Regueras de Arriba,332,181,151
24,León,129,Reyero,129,65,64
24,León,130,Riaño,512,299,213
24,León,131,Riego de la Vega,892,458,434
24,León,132,Riello,700,383,317
24,León,133,Rioseco de Tapia,400,212,188
24,León,134,"Robla, La",4610,2365,2245
24,León,136,Roperuelos del Páramo,624,324,300
24,León,137,Sabero,1353,661,692
24,León,139,Sahagún,2811,1393,1418
24,León,141,San Adrián del Valle,123,63,60
24,León,142,San Andrés del Rabanedo,31742,15391,16351
24,León,144,San Cristóbal de la Polantera,825,411,414
24,León,145,San Emiliano,699,375,324
24,León,146,San Esteban de Nogales,289,151,138
24,León,148,San Justo de la Vega,1997,1024,973
24,León,149,San Millán de los Caballeros,188,97,91
24,León,150,San Pedro Bercianos,271,140,131
24,León,143,Sancedo,574,284,290
24,León,151,Santa Colomba de Curueño,555,282,273
24,León,152,Santa Colomba de Somoza,505,269,236
24,León,153,Santa Cristina de Valmadrigal,308,160,148
24,León,154,Santa Elena de Jamuz,1217,631,586
24,León,155,Santa María de la Isla,569,299,270
24,León,158,Santa María de Ordás,347,173,174
24,León,156,Santa María del Monte de Cea,269,140,129
24,León,157,Santa María del Páramo,3183,1576,1607
24,León,159,Santa Marina del Rey,2103,1044,1059
24,León,160,Santas Martas,857,455,402
24,León,161,Santiago Millas,339,179,160
24,León,162,Santovenia de la Valdoncina,1987,1020,967
24,León,163,Sariegos,4671,2368,2303
24,León,164,Sena de Luna,412,203,209
24,León,165,Sobrado,363,181,182
24,León,166,Soto de la Vega,1724,894,830
24,León,167,Soto y Amío,905,449,456
24,León,168,Toral de los Guzmanes,580,316,264
24,León,206,Toral de los Vados,2130,1050,1080
24,León,169,Toreno,3595,1770,1825
24,León,170,Torre del Bierzo,2460,1252,1208
24,León,171,Trabadelo,430,243,187
24,León,172,Truchas,508,253,255
24,León,173,Turcia,1112,548,564
24,León,174,Urdiales del Páramo,549,281,268
24,León,185,Val de San Lorenzo,578,297,281
24,León,175,Valdefresno,2046,1057,989
24,León,176,Valdefuentes del Páramo,354,190,164
24,León,177,Valdelugueros,526,297,229
24,León,178,Valdemora,85,39,46
24,León,179,Valdepiélago,361,192,169
24,León,180,Valdepolo,1328,689,639
24,León,181,Valderas,1943,984,959
24,León,182,Valderrey,487,233,254
24,León,183,Valderrueda,979,502,477
24,León,184,Valdesamario,222,119,103
24,León,187,Valdevimbre,1038,540,498
24,León,188,Valencia de Don Juan,5184,2550,2634
24,León,191,Vallecillo,133,74,59
24,León,189,Valverde de la Virgen,7118,3642,3476
24,León,190,Valverde-Enrique,189,98,91
24,León,193,"Vecilla, La",428,222,206
24,León,196,Vega de Espinareda,2419,1231,1188
24,León,197,Vega de Infanzones,925,470,455
24,León,198,Vega de Valcarce,706,372,334
24,León,194,Vegacervera,351,187,164
24,León,199,Vegaquemada,467,242,225
24,León,201,Vegas del Condado,1195,664,531
24,León,202,Villablino,10220,5055,5165
24,León,203,Villabraz,110,68,42
24,León,205,Villadangos del Páramo,1111,576,535
24,León,207,Villademor de la Vega,395,206,189
24,León,209,Villafranca del Bierzo,3463,1694,1769
24,León,210,Villagatón,638,319,319
24,León,211,Villamandos,326,173,153
24,León,901,Villamanín,1109,563,546
24,León,212,Villamañán,1282,627,655
24,León,213,Villamartín de Don Sancho,157,83,74
24,León,214,Villamejil,773,401,372
24,León,215,Villamol,182,88,94
24,León,216,Villamontán de la Valduerna,858,444,414
24,León,217,Villamoratiel de las Matas,156,87,69
24,León,218,Villanueva de las Manzanas,522,269,253
24,León,219,Villaobispo de Otero,653,350,303
24,León,902,Villaornate y Castro,401,206,195
24,León,221,Villaquejida,979,491,488
24,León,222,Villaquilambre,18124,9039,9085
24,León,223,Villarejo de Órbigo,3244,1582,1662
24,León,224,Villares de Órbigo,708,369,339
24,León,225,Villasabariego,1248,653,595
24,León,226,Villaselán,225,124,101
24,León,227,Villaturiel,1941,1020,921
24,León,228,Villazala,779,415,364
24,León,229,Villazanzo de Valderaduey,520,294,226
24,León,230,Zotes del Páramo,485,275,210
25,Lleida,1,Abella de la Conca,174,98,76
25,Lleida,2,Àger,593,322,271
25,Lleida,3,Agramunt,5633,2873,2760
25,Lleida,38,Aitona,2419,1246,1173
25,Lleida,4,"Alamús, Els",751,408,343
25,Lleida,5,Alàs i Cerc,376,200,176
25,Lleida,6,"Albagés, L'",425,224,201
25,Lleida,7,Albatàrrec,2113,1101,1012
25,Lleida,8,Albesa,1652,889,763
25,Lleida,9,"Albi, L'",860,448,412
25,Lleida,10,Alcanó,237,115,122
25,Lleida,11,Alcarràs,8755,4520,4235
25,Lleida,12,Alcoletge,3191,1677,1514
25,Lleida,13,Alfarràs,3077,1578,1499
25,Lleida,14,Alfés,342,179,163
25,Lleida,15,Algerri,438,229,209
25,Lleida,16,Alguaire,3105,1635,1470
25,Lleida,17,Alins,306,159,147
25,Lleida,19,Almacelles,6728,3534,3194
25,Lleida,20,Almatret,354,187,167
25,Lleida,21,Almenar,3653,1941,1712
25,Lleida,22,Alòs de Balaguer,134,78,56
25,Lleida,23,Alpicat,6203,3107,3096
25,Lleida,24,Alt Àneu,439,246,193
25,Lleida,27,Anglesola,1385,692,693
25,Lleida,29,Arbeca,2493,1287,1206
25,Lleida,31,Arres,65,42,23
25,Lleida,32,Arsèguel,91,51,40
25,Lleida,33,Artesa de Lleida,1507,796,711
25,Lleida,34,Artesa de Segre,3759,1908,1851
25,Lleida,36,Aspa,216,110,106
25,Lleida,37,"Avellanes i Santa Linya, Les",458,262,196
25,Lleida,39,Baix Pallars,362,187,175
25,Lleida,40,Balaguer,16952,8659,8293
25,Lleida,41,Barbens,928,492,436
25,Lleida,42,"Baronia de Rialb, La",255,136,119
25,Lleida,44,Bassella,246,129,117
25,Lleida,45,Bausen,61,36,25
25,Lleida,46,Belianes,564,291,273
25,Lleida,170,Bellaguarda,335,180,155
25,Lleida,47,Bellcaire d'Urgell,1350,684,666
25,Lleida,48,Bell-lloc d'Urgell,2420,1194,1226
25,Lleida,49,Bellmunt d'Urgell,196,93,103
25,Lleida,50,Bellpuig,4975,2582,2393
25,Lleida,51,Bellver de Cerdanya,2300,1207,1093
25,Lleida,52,Bellvís,2391,1213,1178
25,Lleida,53,Benavent de Segrià,1540,798,742
25,Lleida,55,Biosca,213,115,98
25,Lleida,57,"Bòrdes, Es",238,130,108
25,Lleida,58,"Borges Blanques, Les",6060,3095,2965
25,Lleida,59,Bossòst,1179,591,588
25,Lleida,56,Bovera,315,166,149
25,Lleida,60,Cabanabona,100,42,58
25,Lleida,61,Cabó,94,47,47
25,Lleida,62,Camarasa,945,483,462
25,Lleida,63,Canejan,109,57,52
25,Lleida,904,Castell de Mur,173,93,80
25,Lleida,64,Castellar de la Ribera,159,83,76
25,Lleida,67,Castelldans,1028,549,479
25,Lleida,68,Castellnou de Seana,766,394,372
25,Lleida,69,Castelló de Farfanya,549,297,252
25,Lleida,70,Castellserà,1089,561,528
25,Lleida,71,Cava,60,33,27
25,Lleida,72,Cervera,9440,4786,4654
25,Lleida,73,Cervià de les Garrigues,746,391,355
25,Lleida,74,Ciutadilla,207,115,92
25,Lleida,75,Clariana de Cardener,142,74,68
25,Lleida,76,"Cogul, El",197,108,89
25,Lleida,77,Coll de Nargó,595,303,292
25,Lleida,163,"Coma i la Pedra, La",274,166,108
25,Lleida,161,Conca de Dalt,433,225,208
25,Lleida,78,Corbins,1403,746,657
25,Lleida,79,Cubells,409,216,193
25,Lleida,81,"Espluga Calba, L'",399,210,189
25,Lleida,82,Espot,355,192,163
25,Lleida,88,Estamariu,122,71,51
25,Lleida,85,Estaràs,168,91,77
25,Lleida,86,Esterri d'Àneu,900,471,429
25,Lleida,87,Esterri de Cardós,75,36,39
25,Lleida,89,Farrera,140,81,59
25,Lleida,908,Fígols i Alinyà,278,156,122
25,Lleida,92,"Floresta, La",164,92,72
25,Lleida,93,Fondarella,825,418,407
25,Lleida,94,Foradada,184,103,81
25,Lleida,96,"Fuliola, La",1320,673,647
25,Lleida,97,Fulleda,103,51,52
25,Lleida,98,Gavet de la Conca,306,153,153
25,Lleida,912,Gimenells i el Pla de la Font,1170,596,574
25,Lleida,99,Golmés,1741,863,878
25,Lleida,100,Gósol,221,126,95
25,Lleida,101,"Granadella, La",750,401,349
25,Lleida,102,"Granja d'Escarp, La",986,534,452
25,Lleida,103,Granyanella,143,76,67
25,Lleida,105,Granyena de les Garrigues,175,102,73
25,Lleida,104,Granyena de Segarra,136,67,69
25,Lleida,109,Guimerà,305,168,137
25,Lleida,903,"Guingueta d'Àneu, La",341,176,165
25,Lleida,110,Guissona,6763,3602,3161
25,Lleida,111,Guixers,132,80,52
25,Lleida,115,Isona i Conca Dellà,1083,576,507
25,Lleida,112,Ivars de Noguera,361,192,169
25,Lleida,113,Ivars d'Urgell,1647,873,774
25,Lleida,114,Ivorra,118,61,57
25,Lleida,910,Josa i Tuixén,140,79,61
25,Lleida,118,Juncosa,458,243,215
25,Lleida,119,Juneda,3490,1834,1656
25,Lleida,121,Les,1012,514,498
25,Lleida,122,Linyola,2661,1372,1289
25,Lleida,123,Lladorre,239,118,121
25,Lleida,124,Lladurs,180,98,82
25,Lleida,125,Llardecans,505,261,244
25,Lleida,126,Llavorsí,366,192,174
25,Lleida,120,Lleida,139834,69302,70532
25,Lleida,127,Lles de Cerdanya,269,165,104
25,Lleida,128,Llimiana,183,105,78
25,Lleida,129,Llobera,206,109,97
25,Lleida,133,Maials,980,520,460
25,Lleida,130,Maldà,239,123,116
25,Lleida,131,Massalcoreig,575,305,270
25,Lleida,132,Massoteres,207,111,96
25,Lleida,134,Menàrguens,882,482,400
25,Lleida,135,Miralcamp,1432,735,697
25,Lleida,137,Mollerussa,14729,7533,7196
25,Lleida,136,"Molsosa, La",115,56,59
25,Lleida,139,Montellà i Martinet,683,364,319
25,Lleida,140,Montferrer i Castellbò,1036,566,470
25,Lleida,138,Montgai,701,364,337
25,Lleida,142,Montoliu de Lleida,511,258,253
25,Lleida,141,Montoliu de Segarra,197,116,81
25,Lleida,143,Montornès de Segarra,92,45,47
25,Lleida,145,Nalec,97,50,47
25,Lleida,25,Naut Aran,1758,899,859
25,Lleida,146,Navès,274,134,140
25,Lleida,148,Odèn,268,162,106
25,Lleida,149,Oliana,1920,947,973
25,Lleida,150,Oliola,219,124,95
25,Lleida,151,Olius,881,450,431
25,Lleida,152,"Oluges, Les",167,92,75
25,Lleida,153,"Omellons, Els",243,130,113
25,Lleida,154,"Omells de na Gaia, Els",151,82,69
25,Lleida,155,Organyà,895,443,452
25,Lleida,156,Os de Balaguer,991,514,477
25,Lleida,157,Ossó de Sió,218,109,109
25,Lleida,158,"Palau d'Anglesola, El",2185,1084,1101
25,Lleida,164,Penelles,524,309,215
25,Lleida,165,Peramola,369,187,182
25,Lleida,166,Pinell de Solsonès,210,115,95
25,Lleida,167,Pinós,302,165,137
25,Lleida,911,"Plans de Sió, Els",569,305,264
25,Lleida,168,"Poal, El",649,338,311
25,Lleida,169,"Pobla de Cérvoles, La",245,135,110
25,Lleida,171,"Pobla de Segur, La",3156,1572,1584
25,Lleida,30,"Pont de Bar, El",184,106,78
25,Lleida,173,"Pont de Suert, El",2516,1289,1227
25,Lleida,172,Ponts,2698,1361,1337
25,Lleida,174,"Portella, La",772,416,356
25,Lleida,175,Prats i Sansor,296,156,140
25,Lleida,176,Preixana,410,211,199
25,Lleida,177,Preixens,471,232,239
25,Lleida,179,Prullans,240,113,127
25,Lleida,180,Puiggròs,313,166,147
25,Lleida,181,Puigverd d'Agramunt,273,158,115
25,Lleida,182,Puigverd de Lleida,1442,742,700
25,Lleida,183,Rialp,680,354,326
25,Lleida,905,Ribera d'Ondara,447,229,218
25,Lleida,185,Ribera d'Urgellet,997,514,483
25,Lleida,186,Riner,294,144,150
25,Lleida,913,Riu de Cerdanya,116,62,54
25,Lleida,189,Rosselló,3103,1590,1513
25,Lleida,190,Salàs de Pallars,368,191,177
25,Lleida,191,Sanaüja,458,236,222
25,Lleida,196,Sant Esteve de la Sarga,141,83,58
25,Lleida,192,Sant Guim de Freixenet,1104,565,539
25,Lleida,197,Sant Guim de la Plana,191,103,88
25,Lleida,193,Sant Llorenç de Morunys,1038,525,513
25,Lleida,902,Sant Martí de Riucorb,695,362,333
25,Lleida,194,Sant Ramon,541,293,248
25,Lleida,201,Sarroca de Bellera,129,77,52
25,Lleida,200,Sarroca de Lleida,408,219,189
25,Lleida,202,Senterada,133,77,56
25,Lleida,35,"Sentiu de Sió, La",471,236,235
25,Lleida,204,Seròs,1907,1041,866
25,Lleida,203,"Seu d'Urgell, La",12529,6109,6420
25,Lleida,205,Sidamon,736,371,365
25,Lleida,206,"Soleràs, El",368,195,173
25,Lleida,207,Solsona,9201,4595,4606
25,Lleida,208,Soriguera,370,203,167
25,Lleida,209,Sort,2322,1174,1148
25,Lleida,210,Soses,1774,917,857
25,Lleida,211,Sudanell,887,490,397
25,Lleida,212,Sunyer,297,157,140
25,Lleida,215,Talarn,564,330,234
25,Lleida,216,Talavera,288,161,127
25,Lleida,217,Tàrrega,16731,8380,8351
25,Lleida,218,Tarrés,107,61,46
25,Lleida,219,Tarroja de Segarra,173,90,83
25,Lleida,220,Térmens,1587,800,787
25,Lleida,221,Tírvia,156,81,75
25,Lleida,222,Tiurana,80,37,43
25,Lleida,223,Torà,1333,673,660
25,Lleida,224,"Torms, Els",169,92,77
25,Lleida,225,Tornabous,925,504,421
25,Lleida,227,"Torre de Cabdella, La",755,373,382
25,Lleida,226,Torrebesses,302,159,143
25,Lleida,228,Torrefarrera,4341,2185,2156
25,Lleida,907,Torrefeta i Florejacs,617,323,294
25,Lleida,230,Torregrossa,2234,1128,1106
25,Lleida,231,Torrelameu,723,410,313
25,Lleida,232,Torres de Segre,2165,1112,1053
25,Lleida,233,Torre-serona,356,183,173
25,Lleida,234,Tremp,6515,3317,3198
25,Lleida,43,"Vall de Boí, La",1052,561,491
25,Lleida,901,Vall de Cardós,406,215,191
25,Lleida,238,Vallbona de les Monges,253,135,118
25,Lleida,240,Vallfogona de Balaguer,1853,916,937
25,Lleida,906,"Valls d'Aguilar, Les",300,162,138
25,Lleida,239,"Valls de Valira, Les",948,493,455
25,Lleida,909,"Vansa i Fórnols, La",206,112,94
25,Lleida,242,Verdú,1008,482,526
25,Lleida,243,Vielha e Mijaran,5454,2796,2658
25,Lleida,244,Vilagrassa,497,256,241
25,Lleida,245,Vilaller,667,382,285
25,Lleida,247,Vilamòs,180,104,76
25,Lleida,248,Vilanova de Bellpuig,1213,630,583
25,Lleida,254,Vilanova de la Barca,1160,583,577
25,Lleida,249,Vilanova de l'Aguda,242,120,122
25,Lleida,250,Vilanova de Meià,423,223,200
25,Lleida,251,Vilanova de Segrià,896,465,431
25,Lleida,252,Vila-sana,710,360,350
25,Lleida,253,"Vilosell, El",197,101,96
25,Lleida,255,Vinaixa,572,292,280
27,Lugo,1,Abadín,2760,1359,1401
27,Lugo,2,Alfoz,2009,984,1025
27,Lugo,3,Antas de Ulla,2219,1086,1133
27,Lugo,4,Baleira,1448,766,682
27,Lugo,901,Baralla,2834,1470,1364
27,Lugo,5,Barreiros,3124,1501,1623
27,Lugo,6,Becerreá,3072,1557,1515
27,Lugo,7,Begonte,3322,1664,1658
27,Lugo,8,Bóveda,1589,788,801
27,Lugo,902,Burela,9631,4873,4758
27,Lugo,9,Carballedo,2532,1265,1267
27,Lugo,10,Castro de Rei,5422,2682,2740
27,Lugo,11,Castroverde,2887,1481,1406
27,Lugo,12,Cervantes,1593,907,686
27,Lugo,13,Cervo,4483,2193,2290
27,Lugo,16,Chantada,8783,4266,4517
27,Lugo,14,"Corgo, O",3828,1933,1895
27,Lugo,15,Cospeito,5047,2444,2603
27,Lugo,17,Folgoso do Courel,1160,603,557
27,Lugo,18,"Fonsagrada, A",4198,2188,2010
27,Lugo,19,Foz,9978,4849,5129
27,Lugo,20,Friol,4137,2050,2087
27,Lugo,22,Guitiriz,5658,2837,2821
27,Lugo,23,Guntín,3018,1521,1497
27,Lugo,24,"Incio, O",1875,917,958
27,Lugo,26,Láncara,2866,1463,1403
27,Lugo,27,Lourenzá,2399,1153,1246
27,Lugo,28,Lugo,98457,45963,52494
27,Lugo,29,Meira,1775,885,890
27,Lugo,30,Mondoñedo,4183,1951,2232
27,Lugo,31,Monforte de Lemos,19604,9320,10284
27,Lugo,32,Monterroso,3969,1982,1987
27,Lugo,33,Muras,754,381,373
27,Lugo,34,Navia de Suarna,1337,742,595
27,Lugo,35,Negueira de Muñiz,213,114,99
27,Lugo,37,"Nogais, As",1295,670,625
27,Lugo,38,Ourol,1142,561,581
27,Lugo,39,Outeiro de Rei,5046,2586,2460
27,Lugo,40,Palas de Rei,3656,1802,1854
27,Lugo,41,Pantón,2860,1372,1488
27,Lugo,42,Paradela,2038,1010,1028
27,Lugo,43,"Páramo, O",1555,771,784
27,Lugo,44,"Pastoriza, A",3393,1688,1705
27,Lugo,45,Pedrafita do Cebreiro,1199,644,555
27,Lugo,47,"Pobra do Brollón, A",1968,977,991
27,Lugo,46,Pol,1794,884,910
27,Lugo,48,"Pontenova, A",2673,1302,1371
27,Lugo,49,Portomarín,1690,855,835
27,Lugo,50,Quiroga,3595,1736,1859
27,Lugo,56,Rábade,1674,851,823
27,Lugo,51,Ribadeo,10061,4782,5279
27,Lugo,52,Ribas de Sil,1058,528,530
27,Lugo,53,Ribeira de Piquín,630,319,311
27,Lugo,54,Riotorto,1439,698,741
27,Lugo,55,Samos,1556,807,749
27,Lugo,57,Sarria,13524,6647,6877
27,Lugo,58,"Saviñao, O",4314,2159,2155
27,Lugo,59,Sober,2478,1182,1296
27,Lugo,60,Taboada,3221,1550,1671
27,Lugo,61,Trabada,1268,619,649
27,Lugo,62,Triacastela,756,373,383
27,Lugo,63,"Valadouro, O",2123,1046,1077
27,Lugo,64,"Vicedo, O",1895,944,951
27,Lugo,65,Vilalba,15116,7379,7737
27,Lugo,66,Viveiro,16108,7890,8218
27,Lugo,21,Xermade,2101,1023,1078
27,Lugo,25,Xove,3512,1743,1769
28,Madrid,1,"Acebeda, La",65,36,29
28,Madrid,2,Ajalvir,4203,2202,2001
28,Madrid,3,Alameda del Valle,243,138,105
28,Madrid,4,"Álamo, El",8701,4312,4389
28,Madrid,5,Alcalá de Henares,203924,101572,102352
28,Madrid,6,Alcobendas,111040,53736,57304
28,Madrid,7,Alcorcón,169308,82746,86562
28,Madrid,8,Aldea del Fresno,2559,1365,1194
28,Madrid,9,Algete,20585,10290,10295
28,Madrid,10,Alpedrete,13480,6705,6775
28,Madrid,11,Ambite,591,299,292
28,Madrid,12,Anchuelo,1188,629,559
28,Madrid,13,Aranjuez,56877,27743,29134
28,Madrid,14,Arganda del Rey,55506,28367,27139
28,Madrid,15,Arroyomolinos,22476,11437,11039
28,Madrid,16,"Atazar, El",102,53,49
28,Madrid,17,Batres,1552,793,759
28,Madrid,18,Becerril de la Sierra,5355,2654,2701
28,Madrid,19,Belmonte de Tajo,1580,810,770
28,Madrid,21,"Berrueco, El",606,318,288
28,Madrid,20,Berzosa del Lozoya,227,124,103
28,Madrid,22,Boadilla del Monte,47037,23035,24002
28,Madrid,23,"Boalo, El",7037,3665,3372
28,Madrid,24,Braojos,204,116,88
28,Madrid,25,Brea de Tajo,572,325,247
28,Madrid,26,Brunete,10064,5026,5038
28,Madrid,27,Buitrago del Lozoya,2031,1003,1028
28,Madrid,28,Bustarviejo,2266,1148,1118
28,Madrid,29,Cabanillas de la Sierra,751,400,351
28,Madrid,30,"Cabrera, La",2565,1299,1266
28,Madrid,31,Cadalso de los Vidrios,2944,1538,1406
28,Madrid,32,Camarma de Esteruelas,6808,3515,3293
28,Madrid,33,Campo Real,5668,2914,2754
28,Madrid,34,Canencia,484,263,221
28,Madrid,35,Carabaña,2052,1035,1017
28,Madrid,36,Casarrubuelos,3279,1673,1606
28,Madrid,37,Cenicientos,2110,1049,1061
28,Madrid,38,Cercedilla,6986,3413,3573
28,Madrid,39,Cervera de Buitrago,183,108,75
28,Madrid,51,Chapinería,2145,1092,1053
28,Madrid,52,Chinchón,5404,2747,2657
28,Madrid,40,Ciempozuelos,23716,11915,11801
28,Madrid,41,Cobeña,6823,3383,3440
28,Madrid,46,Collado Mediano,6697,3400,3297
28,Madrid,47,Collado Villalba,61955,30383,31572
28,Madrid,43,Colmenar de Oreja,8432,4309,4123
28,Madrid,42,Colmenar del Arroyo,1565,788,777
28,Madrid,45,Colmenar Viejo,46321,22972,23349
28,Madrid,44,Colmenarejo,8753,4336,4417
28,Madrid,48,Corpa,643,346,297
28,Madrid,49,Coslada,91832,45963,45869
28,Madrid,50,Cubas de la Sagra,5332,2632,2700
28,Madrid,53,Daganzo de Arriba,9560,4792,4768
28,Madrid,54,"Escorial, El",15161,7451,7710
28,Madrid,55,Estremera,1486,753,733
28,Madrid,56,Fresnedillas de la Oliva,1592,824,768
28,Madrid,57,Fresno de Torote,2089,1098,991
28,Madrid,58,Fuenlabrada,198132,99189,98943
28,Madrid,59,Fuente el Saz de Jarama,6379,3234,3145
28,Madrid,60,Fuentidueña de Tajo,2077,1059,1018
28,Madrid,61,Galapagar,32930,16318,16612
28,Madrid,62,Garganta de los Montes,396,201,195
28,Madrid,63,Gargantilla del Lozoya y Pinilla de Buitrago,369,204,165
28,Madrid,64,Gascones,184,103,81
28,Madrid,65,Getafe,171280,84628,86652
28,Madrid,66,Griñón,9752,4875,4877
28,Madrid,67,Guadalix de la Sierra,6100,3073,3027
28,Madrid,68,Guadarrama,15534,7697,7837
28,Madrid,69,"Hiruela, La",56,35,21
28,Madrid,70,Horcajo de la Sierra-Aoslos,167,95,72
28,Madrid,71,Horcajuelo de la Sierra,95,44,51
28,Madrid,72,Hoyo de Manzanares,7812,3957,3855
28,Madrid,73,Humanes de Madrid,18870,9624,9246
28,Madrid,74,Leganés,187125,91853,95272
28,Madrid,75,Loeches,7990,4005,3985
28,Madrid,76,Lozoya,635,330,305
28,Madrid,901,Lozoyuela-Navas-Sieteiglesias,1200,637,563
28,Madrid,78,Madarcos,53,30,23
28,Madrid,79,Madrid,3233527,1509851,1723676
28,Madrid,80,Majadahonda,70198,33346,36852
28,Madrid,82,Manzanares el Real,7949,4057,3892
28,Madrid,83,Meco,12797,6508,6289
28,Madrid,84,Mejorada del Campo,22902,11443,11459
28,Madrid,85,Miraflores de la Sierra,5979,3039,2940
28,Madrid,86,"Molar, El",8226,4202,4024
28,Madrid,87,"Molinos, Los",4590,2317,2273
28,Madrid,88,Montejo de la Sierra,354,183,171
28,Madrid,89,Moraleja de Enmedio,4984,2496,2488
28,Madrid,90,Moralzarzal,12126,6067,6059
28,Madrid,91,Morata de Tajuña,7515,3789,3726
28,Madrid,92,Móstoles,206031,101653,104378
28,Madrid,93,Navacerrada,2793,1386,1407
28,Madrid,94,Navalafuente,1220,651,569
28,Madrid,95,Navalagamella,2392,1253,1139
28,Madrid,96,Navalcarnero,25453,12766,12687
28,Madrid,97,Navarredonda y San Mamés,141,82,59
28,Madrid,99,Navas del Rey,2666,1424,1242
28,Madrid,100,Nuevo Baztán,6239,3182,3057
28,Madrid,101,Olmeda de las Fuentes,338,177,161
28,Madrid,102,Orusco de Tajuña,1300,656,644
28,Madrid,104,Paracuellos de Jarama,19882,10085,9797
28,Madrid,106,Parla,124208,62848,61360
28,Madrid,107,Patones,521,251,270
28,Madrid,108,Pedrezuela,5020,2577,2443
28,Madrid,109,Pelayos de la Presa,2572,1296,1276
28,Madrid,110,Perales de Tajuña,2877,1457,1420
28,Madrid,111,Pezuela de las Torres,796,415,381
28,Madrid,112,Pinilla del Valle,215,121,94
28,Madrid,113,Pinto,46763,23363,23400
28,Madrid,114,Piñuécar-Gandullas,168,87,81
28,Madrid,115,Pozuelo de Alarcón,83844,40167,43677
28,Madrid,116,Pozuelo del Rey,1019,549,470
28,Madrid,117,Prádena del Rincón,127,72,55
28,Madrid,118,Puebla de la Sierra,99,58,41
28,Madrid,902,Puentes Viejas,667,379,288
28,Madrid,119,Quijorna,3130,1609,1521
28,Madrid,120,Rascafría,1956,1070,886
28,Madrid,121,Redueña,291,156,135
28,Madrid,122,Ribatejada,664,338,326
28,Madrid,123,Rivas-Vaciamadrid,75444,37754,37690
28,Madrid,124,Robledillo de la Jara,106,56,50
28,Madrid,125,Robledo de Chavela,4058,2101,1957
28,Madrid,126,Robregordo,65,40,25
28,Madrid,127,"Rozas de Madrid, Las",90390,43902,46488
28,Madrid,128,Rozas de Puerto Real,469,266,203
28,Madrid,129,San Agustín del Guadalix,12770,6356,6414
28,Madrid,130,San Fernando de Henares,41376,20576,20800
28,Madrid,131,San Lorenzo de El Escorial,18545,8879,9666
28,Madrid,132,San Martín de la Vega,19615,10227,9388
28,Madrid,133,San Martín de Valdeiglesias,8365,4167,4198
28,Madrid,134,San Sebastián de los Reyes,81466,39874,41592
28,Madrid,135,Santa María de la Alameda,1245,676,569
28,Madrid,136,Santorcaz,816,419,397
28,Madrid,137,"Santos de la Humosa, Los",2367,1222,1145
28,Madrid,138,"Serna del Monte, La",104,56,48
28,Madrid,140,Serranillos del Valle,3631,1813,1818
28,Madrid,141,Sevilla la Nueva,8887,4406,4481
28,Madrid,143,Somosierra,92,53,39
28,Madrid,144,Soto del Real,8480,4171,4309
28,Madrid,145,Talamanca de Jarama,3178,1619,1559
28,Madrid,146,Tielmes,2616,1349,1267
28,Madrid,147,Titulcia,1206,627,579
28,Madrid,148,Torrejón de Ardoz,125331,62815,62516
28,Madrid,149,Torrejón de la Calzada,7666,3819,3847
28,Madrid,150,Torrejón de Velasco,4161,2101,2060
28,Madrid,151,Torrelaguna,4860,2497,2363
28,Madrid,152,Torrelodones,22680,10977,11703
28,Madrid,153,Torremocha de Jarama,877,416,461
28,Madrid,154,Torres de la Alameda,7906,4049,3857
28,Madrid,903,Tres Cantos,41302,20028,21274
28,Madrid,155,Valdaracete,665,335,330
28,Madrid,156,Valdeavero,1411,749,662
28,Madrid,157,Valdelaguna,863,436,427
28,Madrid,158,Valdemanco,949,501,448
28,Madrid,159,Valdemaqueda,859,426,433
28,Madrid,160,Valdemorillo,11762,6044,5718
28,Madrid,161,Valdemoro,70315,35145,35170
28,Madrid,162,Valdeolmos-Alalpardo,3576,1828,1748
28,Madrid,163,Valdepiélagos,571,295,276
28,Madrid,164,Valdetorres de Jarama,4170,2134,2036
28,Madrid,165,Valdilecha,2816,1453,1363
28,Madrid,166,Valverde de Alcalá,464,251,213
28,Madrid,167,Velilla de San Antonio,12037,6075,5962
28,Madrid,168,"Vellón, El",1764,916,848
28,Madrid,169,Venturada,1897,984,913
28,Madrid,171,Villa del Prado,6495,3373,3122
28,Madrid,170,Villaconejos,3484,1775,1709
28,Madrid,172,Villalbilla,11010,5600,5410
28,Madrid,173,Villamanrique de Tajo,795,414,381
28,Madrid,174,Villamanta,2505,1256,1249
28,Madrid,175,Villamantilla,1183,579,604
28,Madrid,176,Villanueva de la Cañada,18425,8957,9468
28,Madrid,178,Villanueva de Perales,1486,769,717
28,Madrid,177,Villanueva del Pardillo,16509,8089,8420
28,Madrid,179,Villar del Olmo,2135,1106,1029
28,Madrid,180,Villarejo de Salvanés,7452,3776,3676
28,Madrid,181,Villaviciosa de Odón,26708,13056,13652
28,Madrid,182,Villavieja del Lozoya,273,146,127
28,Madrid,183,Zarzalejo,1517,807,710
29,Málaga,1,Alameda,5504,2756,2748
29,Málaga,2,Alcaucín,2817,1418,1399
29,Málaga,3,Alfarnate,1300,664,636
29,Málaga,4,Alfarnatejo,532,273,259
29,Málaga,5,Algarrobo,6584,3323,3261
29,Málaga,6,Algatocín,887,447,440
29,Málaga,7,Alhaurín de la Torre,37446,18714,18732
29,Málaga,8,Alhaurín el Grande,24074,12065,12009
29,Málaga,9,Almáchar,1904,975,929
29,Málaga,10,Almargen,2157,1097,1060
29,Málaga,11,Almogía,4195,2157,2038
29,Málaga,12,Álora,13399,6745,6654
29,Málaga,13,Alozaina,2230,1139,1091
29,Málaga,14,Alpandeire,274,140,134
29,Málaga,15,Antequera,41827,20536,21291
29,Málaga,16,Árchez,476,250,226
29,Málaga,17,Archidona,8814,4434,4380
29,Málaga,18,Ardales,2606,1303,1303
29,Málaga,19,Arenas,1411,736,675
29,Málaga,20,Arriate,4121,2040,2081
29,Málaga,21,Atajate,158,82,76
29,Málaga,22,Benadalid,262,130,132
29,Málaga,23,Benahavís,5980,3044,2936
29,Málaga,24,Benalauría,511,278,233
29,Málaga,25,Benalmádena,65965,32612,33353
29,Málaga,26,Benamargosa,1634,839,795
29,Málaga,27,Benamocarra,3089,1575,1514
29,Málaga,28,Benaoján,1543,795,748
29,Málaga,29,Benarrabá,559,282,277
29,Málaga,30,"Borge, El",1026,536,490
29,Málaga,31,"Burgo, El",1957,981,976
29,Málaga,32,Campillos,8663,4349,4314
29,Málaga,33,Canillas de Aceituno,1937,1027,910
29,Málaga,34,Canillas de Albaida,964,491,473
29,Málaga,35,Cañete la Real,1901,960,941
29,Málaga,36,Carratraca,860,436,424
29,Málaga,37,Cartajima,251,128,123
29,Málaga,38,Cártama,23664,12104,11560
29,Málaga,39,Casabermeja,3686,1982,1704
29,Málaga,40,Casarabonela,2726,1442,1284
29,Málaga,41,Casares,5610,2887,2723
29,Málaga,42,Coín,21791,11124,10667
29,Málaga,43,Colmenar,3624,1855,1769
29,Málaga,44,Comares,1638,865,773
29,Málaga,45,Cómpeta,3861,1954,1907
29,Málaga,46,Cortes de la Frontera,3540,1808,1732
29,Málaga,47,Cuevas Bajas,1494,757,737
29,Málaga,49,Cuevas de San Marcos,4043,2042,2001
29,Málaga,48,Cuevas del Becerro,1747,869,878
29,Málaga,50,Cútar,668,338,330
29,Málaga,51,Estepona,67101,33465,33636
29,Málaga,52,Faraján,287,136,151
29,Málaga,53,Frigiliana,3360,1672,1688
29,Málaga,54,Fuengirola,75953,37390,38563
29,Málaga,55,Fuente de Piedra,2758,1384,1374
29,Málaga,56,Gaucín,1727,894,833
29,Málaga,57,Genalguacil,522,266,256
29,Málaga,58,Guaro,2289,1142,1147
29,Málaga,59,Humilladero,3383,1696,1687
29,Málaga,60,Igualeja,871,439,432
29,Málaga,61,Istán,1533,791,742
29,Málaga,62,Iznate,951,500,451
29,Málaga,63,Jimera de Líbar,463,242,221
29,Málaga,64,Jubrique,739,362,377
29,Málaga,65,Júzcar,243,138,105
29,Málaga,66,Macharaviaya,504,271,233
29,Málaga,67,Málaga,567433,272927,294506
29,Málaga,68,Manilva,14391,7439,6952
29,Málaga,69,Marbella,140473,68415,72058
29,Málaga,70,Mijas,82124,41249,40875
29,Málaga,71,Moclinejo,1295,668,627
29,Málaga,72,Mollina,5239,2657,2582
29,Málaga,73,Monda,2523,1287,1236
29,Málaga,74,Montejaque,1017,502,515
29,Málaga,75,Nerja,22617,11209,11408
29,Málaga,76,Ojén,3451,1775,1676
29,Málaga,77,Parauta,242,116,126
29,Málaga,79,Periana,3560,1856,1704
29,Málaga,80,Pizarra,9269,4742,4527
29,Málaga,81,Pujerra,326,174,152
29,Málaga,82,Rincón de la Victoria,41216,20393,20823
29,Málaga,83,Riogordo,3107,1620,1487
29,Málaga,84,Ronda,36698,17924,18774
29,Málaga,85,Salares,236,126,110
29,Málaga,86,Sayalonga,1564,793,771
29,Málaga,87,Sedella,716,397,319
29,Málaga,88,Sierra de Yeguas,3517,1765,1752
29,Málaga,89,Teba,4128,2070,2058
29,Málaga,90,Tolox,2317,1182,1135
29,Málaga,901,Torremolinos,68961,34638,34323
29,Málaga,91,Torrox,18274,9238,9036
29,Málaga,92,Totalán,746,387,359
29,Málaga,93,Valle de Abdalajís,2716,1362,1354
29,Málaga,94,Vélez-Málaga,78467,39048,39419
29,Málaga,95,Villanueva de Algaidas,4485,2302,2183
29,Málaga,902,Villanueva de la Concepción,3465,1696,1769
29,Málaga,98,Villanueva de Tapia,1629,831,798
29,Málaga,96,Villanueva del Rosario,3641,1783,1858
29,Málaga,97,Villanueva del Trabuco,5482,2735,2747
29,Málaga,99,Viñuela,2040,1054,986
29,Málaga,100,Yunquera,3139,1595,1544
30,Murcia,1,Abanilla,6569,3313,3256
30,Murcia,2,Abarán,13110,6628,6482
30,Murcia,3,Águilas,34828,17511,17317
30,Murcia,4,Albudeite,1404,715,689
30,Murcia,5,Alcantarilla,41381,20498,20883
30,Murcia,902,"Alcázares, Los",16251,8339,7912
30,Murcia,6,Aledo,1025,515,510
30,Murcia,7,Alguazas,9460,4936,4524
30,Murcia,8,Alhama de Murcia,20915,10658,10257
30,Murcia,9,Archena,18496,9671,8825
30,Murcia,10,Beniel,11198,5794,5404
30,Murcia,11,Blanca,6493,3305,3188
30,Murcia,12,Bullas,12321,6247,6074
30,Murcia,13,Calasparra,10661,5397,5264
30,Murcia,14,Campos del Río,2220,1067,1153
30,Murcia,15,Caravaca de la Cruz,26415,13270,13145
30,Murcia,16,Cartagena,216655,108897,107758
30,Murcia,17,Cehegín,16248,8227,8021
30,Murcia,18,Ceutí,10881,5476,5405
30,Murcia,19,Cieza,35351,17720,17631
30,Murcia,20,Fortuna,10098,5356,4742
30,Murcia,21,Fuente Álamo de Murcia,16175,8472,7703
30,Murcia,22,Jumilla,25711,13383,12328
30,Murcia,23,Librilla,4842,2451,2391
30,Murcia,24,Lorca,92865,48135,44730
30,Murcia,25,Lorquí,6983,3580,3403
30,Murcia,26,Mazarrón,35408,18436,16972
30,Murcia,27,Molina de Segura,67382,33785,33597
30,Murcia,28,Moratalla,8290,4209,4081
30,Murcia,29,Mula,16968,8715,8253
30,Murcia,30,Murcia,441354,217338,224016
30,Murcia,31,Ojós,562,311,251
30,Murcia,32,Pliego,4051,2093,1958
30,Murcia,33,Puerto Lumbreras,14742,7414,7328
30,Murcia,34,Ricote,1452,750,702
30,Murcia,35,San Javier,32641,16706,15935
30,Murcia,36,San Pedro del Pinatar,24285,12297,11988
30,Murcia,901,Santomera,15709,7983,7726
30,Murcia,37,Torre-Pacheco,33911,17728,16183
30,Murcia,38,"Torres de Cotillas, Las",21608,11046,10562
30,Murcia,39,Totana,30549,15740,14809
30,Murcia,40,Ulea,926,471,455
30,Murcia,41,"Unión, La",19009,9562,9447
30,Murcia,42,Villanueva del Río Segura,2445,1209,1236
30,Murcia,43,Yecla,34601,17373,17228
31,Navarra,1,Abáigar,101,52,49
31,Navarra,2,Abárzuza/Abartzuza,548,277,271
31,Navarra,3,Abaurregaina/Abaurrea Alta,133,82,51
31,Navarra,4,Abaurrepea/Abaurrea Baja,39,26,13
31,Navarra,5,Aberin,392,209,183
31,Navarra,6,Ablitas,2663,1360,1303
31,Navarra,7,Adiós,189,101,88
31,Navarra,8,Aguilar de Codés,102,50,52
31,Navarra,9,Aibar/Oibar,875,476,399
31,Navarra,11,Allín/Allin,854,448,406
31,Navarra,12,Allo,1050,529,521
31,Navarra,10,Altsasu/Alsasua,7691,3887,3804
31,Navarra,13,Améscoa Baja,791,423,368
31,Navarra,14,Ancín/Antzin,374,205,169
31,Navarra,15,Andosilla,2950,1533,1417
31,Navarra,16,Ansoáin/Antsoain,10938,5487,5451
31,Navarra,17,Anue,455,250,205
31,Navarra,18,Añorbe,586,317,269
31,Navarra,19,Aoiz/Agoitz,2640,1325,1315
31,Navarra,20,Araitz,568,326,242
31,Navarra,25,Arakil,952,499,453
31,Navarra,21,Aranarache/Aranaratxe,87,46,41
31,Navarra,23,Aranguren,8092,4115,3977
31,Navarra,24,Arano,121,65,56
31,Navarra,22,Arantza,645,354,291
31,Navarra,26,Aras,185,105,80
31,Navarra,27,Arbizu,1093,564,529
31,Navarra,28,Arce/Artzi,260,147,113
31,Navarra,29,"Arcos, Los",1214,604,610
31,Navarra,30,Arellano,207,118,89
31,Navarra,31,Areso,276,148,128
31,Navarra,32,Arguedas,2373,1215,1158
31,Navarra,33,Aria,58,34,24
31,Navarra,34,Aribe,50,27,23
31,Navarra,35,Armañanzas,60,32,28
31,Navarra,36,Arróniz,1111,606,505
31,Navarra,37,Arruazu,114,62,52
31,Navarra,38,Artajona,1731,896,835
31,Navarra,39,Artazu,121,62,59
31,Navarra,40,Atez,243,138,105
31,Navarra,58,Auritz/Burguete,272,132,140
31,Navarra,41,Ayegui/Aiegi,2026,1065,961
31,Navarra,42,Azagra,3868,1979,1889
31,Navarra,43,Azuelo,38,16,22
31,Navarra,44,Bakaiku,333,183,150
31,Navarra,901,Barañain,21444,10468,10976
31,Navarra,45,Barásoain,674,352,322
31,Navarra,46,Barbarin,65,32,33
31,Navarra,47,Bargota,312,152,160
31,Navarra,48,Barillas,192,103,89
31,Navarra,49,Basaburua,876,500,376
31,Navarra,50,Baztan,8035,4066,3969
31,Navarra,137,Beintza-Labaien,242,142,100
31,Navarra,51,Beire,320,167,153
31,Navarra,52,Belascoáin,124,65,59
31,Navarra,250,Bera,3798,1909,1889
31,Navarra,53,Berbinzana,723,366,357
31,Navarra,905,Beriáin,3856,1892,1964
31,Navarra,902,Berrioplano/Berriobeiti,5971,3041,2930
31,Navarra,903,Berriozar,9449,4810,4639
31,Navarra,54,Bertizarana,628,319,309
31,Navarra,55,Betelu,344,188,156
31,Navarra,253,Bidaurreta,155,90,65
31,Navarra,56,Biurrun-Olcoz,235,135,100
31,Navarra,57,Buñuel,2359,1168,1191
31,Navarra,59,Burgui/Burgi,237,138,99
31,Navarra,60,Burlada/Burlata,18162,8845,9317
31,Navarra,61,"Busto, El",73,39,34
31,Navarra,62,Cabanillas,1490,764,726
31,Navarra,63,Cabredo,109,56,53
31,Navarra,64,Cadreita,2106,1108,998
31,Navarra,65,Caparroso,2821,1452,1369
31,Navarra,66,Cárcar,1121,566,555
31,Navarra,67,Carcastillo,2549,1324,1225
31,Navarra,68,Cascante,3990,1991,1999
31,Navarra,69,Cáseda,1027,497,530
31,Navarra,70,Castejón,4207,2102,2105
31,Navarra,71,Castillonuevo,16,12,4
31,Navarra,193,Cendea de Olza/Oltza Zendea,1785,906,879
31,Navarra,72,Cintruénigo,7811,4008,3803
31,Navarra,74,Cirauqui/Zirauki,505,279,226
31,Navarra,75,Ciriza/Ziritza,119,61,58
31,Navarra,76,Cizur,3663,1824,1839
31,Navarra,77,Corella,8049,4204,3845
31,Navarra,78,Cortes,3281,1695,1586
31,Navarra,79,Desojo,93,52,41
31,Navarra,80,Dicastillo,688,366,322
31,Navarra,81,Donamaria,436,218,218
31,Navarra,221,Doneztebe/Santesteban,1694,870,824
31,Navarra,83,Echarri,72,39,33
31,Navarra,86,Egüés,17450,8821,8629
31,Navarra,87,Elgorriaga,205,98,107
31,Navarra,89,Enériz/Eneritz,368,190,178
31,Navarra,90,Eratsun,160,101,59
31,Navarra,91,Ergoiena,405,218,187
31,Navarra,92,Erro,804,459,345
31,Navarra,94,Eslava,122,67,55
31,Navarra,95,Esparza de Salazar/Espartza Zaraitzu,91,48,43
31,Navarra,96,Espronceda,128,74,54
31,Navarra,97,Estella-Lizarra,14138,6870,7268
31,Navarra,98,Esteribar,2432,1267,1165
31,Navarra,99,Etayo,80,43,37
31,Navarra,82,Etxalar,818,440,378
31,Navarra,84,Etxarri-Aranatz,2487,1293,1194
31,Navarra,85,Etxauri,585,303,282
31,Navarra,100,Eulate,332,176,156
31,Navarra,101,Ezcabarte,1707,913,794
31,Navarra,93,Ezcároz/Ezkaroze,336,175,161
31,Navarra,102,Ezkurra,164,107,57
31,Navarra,103,Ezprogui,49,26,23
31,Navarra,104,Falces,2559,1302,1257
31,Navarra,105,Fitero,2212,1129,1083
31,Navarra,106,Fontellas,955,492,463
31,Navarra,107,Funes,2525,1365,1160
31,Navarra,108,Fustiñana,2578,1309,1269
31,Navarra,109,Galar,1865,982,883
31,Navarra,110,Gallipienzo/Galipentzu,115,62,53
31,Navarra,111,Gallués/Galoze,106,69,37
31,Navarra,112,Garaioa,104,58,46
31,Navarra,113,Garde,169,100,69
31,Navarra,114,Garínoain,531,296,235
31,Navarra,115,Garralda,189,96,93
31,Navarra,116,Genevilla,80,50,30
31,Navarra,117,Goizueta,758,421,337
31,Navarra,118,Goñi,189,121,68
31,Navarra,119,Güesa/Gorza,51,30,21
31,Navarra,120,Guesálaz/Gesalatz,464,274,190
31,Navarra,121,Guirguillano,92,49,43
31,Navarra,256,Hiriberri/Villanueva de Aezkoa,121,69,52
31,Navarra,122,Huarte/Uharte,6543,3316,3227
31,Navarra,124,Ibargoiti,237,141,96
31,Navarra,259,Igantzi,634,338,296
31,Navarra,125,Igúzquiza,336,168,168
31,Navarra,126,Imotz,435,237,198
31,Navarra,127,Irañeta,166,97,69
31,Navarra,904,Irurtzun,2302,1205,1097
31,Navarra,128,Isaba/Izaba,507,250,257
31,Navarra,129,Ituren,518,267,251
31,Navarra,130,Iturmendi,390,198,192
31,Navarra,131,Iza/Itza,1134,602,532
31,Navarra,132,Izagaondoa,183,116,67
31,Navarra,133,Izalzu/Itzaltzu,50,29,21
31,Navarra,134,Jaurrieta,218,119,99
31,Navarra,135,Javier,120,43,77
31,Navarra,136,Juslapeña,558,305,253
31,Navarra,138,Lakuntza,1252,654,598
31,Navarra,139,Lana,191,110,81
31,Navarra,140,Lantz,140,85,55
31,Navarra,141,Lapoblación,147,83,64
31,Navarra,142,Larraga,2152,1162,990
31,Navarra,143,Larraona,114,53,61
31,Navarra,144,Larraun,1015,560,455
31,Navarra,145,Lazagurría,206,106,100
31,Navarra,146,Leache,57,32,25
31,Navarra,147,Legarda,118,66,52
31,Navarra,148,Legaria,109,52,57
31,Navarra,149,Leitza,2916,1559,1357
31,Navarra,908,Lekunberri,1463,725,738
31,Navarra,150,Leoz/Leotz,261,167,94
31,Navarra,151,Lerga,74,45,29
31,Navarra,152,Lerín,1814,937,877
31,Navarra,153,Lesaka,2807,1452,1355
31,Navarra,154,Lezáun,264,156,108
31,Navarra,155,Liédena,327,167,160
31,Navarra,156,Lizoáin-Arriasgoiti,317,199,118
31,Navarra,157,Lodosa,4939,2495,2444
31,Navarra,158,Lónguida/Longida,324,169,155
31,Navarra,159,Lumbier,1417,763,654
31,Navarra,160,Luquin,131,68,63
31,Navarra,248,Luzaide/Valcarlos,406,213,193
31,Navarra,161,Mañeru,442,245,197
31,Navarra,162,Marañón,55,27,28
31,Navarra,163,Marcilla,2815,1409,1406
31,Navarra,164,Mélida,717,368,349
31,Navarra,165,Mendavia,3726,1910,1816
31,Navarra,166,Mendaza,350,181,169
31,Navarra,167,Mendigorría,1085,567,518
31,Navarra,168,Metauten,287,163,124
31,Navarra,169,Milagro,3378,1753,1625
31,Navarra,170,Mirafuentes,49,23,26
31,Navarra,171,Miranda de Arga,916,460,456
31,Navarra,172,Monreal/Elo,482,252,230
31,Navarra,173,Monteagudo,1145,594,551
31,Navarra,174,Morentin,133,71,62
31,Navarra,175,Mues,96,48,48
31,Navarra,176,Murchante,3758,1884,1874
31,Navarra,177,Murieta,352,192,160
31,Navarra,178,Murillo el Cuende,687,353,334
31,Navarra,179,Murillo el Fruto,683,352,331
31,Navarra,180,Muruzábal,282,130,152
31,Navarra,181,Navascués/Nabaskoze,171,106,65
31,Navarra,182,Nazar,50,29,21
31,Navarra,88,Noáin (Valle de Elorz)/Noain (Elortzibar),7566,3821,3745
31,Navarra,183,Obanos,911,449,462
31,Navarra,185,Ochagavía/Otsagabia,618,320,298
31,Navarra,184,Oco,71,38,33
31,Navarra,186,Odieta,353,195,158
31,Navarra,187,Oitz,155,94,61
31,Navarra,188,Olaibar,262,139,123
31,Navarra,189,Olazti/Olazagutía,1662,853,809
31,Navarra,190,Olejua,55,28,27
31,Navarra,191,Olite/Erriberri,3832,1949,1883
31,Navarra,194,Ollo,401,211,190
31,Navarra,192,Olóriz/Oloritz,179,107,72
31,Navarra,195,Orbaizeta,217,110,107
31,Navarra,196,Orbara,43,22,21
31,Navarra,197,Orísoain,89,50,39
31,Navarra,906,Orkoien,3696,1870,1826
31,Navarra,198,Oronz/Orontze,49,26,23
31,Navarra,199,Oroz-Betelu/Orotz-Betelu,166,89,77
31,Navarra,211,Orreaga/Roncesvalles,24,11,13
31,Navarra,200,Oteiza,959,505,454
31,Navarra,201,Pamplona/Iruña,197604,94402,103202
31,Navarra,202,Peralta/Azkoien,6009,3043,2966
31,Navarra,203,Petilla de Aragón,29,20,9
31,Navarra,204,Piedramillera,48,31,17
31,Navarra,205,Pitillas,544,257,287
31,Navarra,206,Puente la Reina/Gares,2835,1463,1372
31,Navarra,207,Pueyo,354,196,158
31,Navarra,208,Ribaforada,3698,1890,1808
31,Navarra,209,Romanzado,180,96,84
31,Navarra,210,Roncal/Erronkari,250,135,115
31,Navarra,212,Sada,184,97,87
31,Navarra,213,Saldías,118,72,46
31,Navarra,214,Salinas de Oro/Jaitz,117,66,51
31,Navarra,215,San Adrián,6247,3107,3140
31,Navarra,217,San Martín de Unx,432,215,217
31,Navarra,216,Sangüesa/Zangoza,5177,2642,2535
31,Navarra,219,Sansol,108,58,50
31,Navarra,220,Santacara,922,473,449
31,Navarra,222,Sarriés/Sartze,67,42,25
31,Navarra,223,Sartaguda,1378,726,652
31,Navarra,224,Sesma,1240,638,602
31,Navarra,225,Sorlada,63,37,26
31,Navarra,226,Sunbilla,665,349,316
31,Navarra,227,Tafalla,11256,5588,5668
31,Navarra,228,Tiebas-Muruarte de Reta,659,345,314
31,Navarra,229,Tirapu,53,33,20
31,Navarra,230,Torralba del Río,132,69,63
31,Navarra,231,Torres del Río,144,68,76
31,Navarra,232,Tudela,35358,17504,17854
31,Navarra,233,Tulebras,127,54,73
31,Navarra,234,Ucar,177,103,74
31,Navarra,123,Uharte-Arakil,827,446,381
31,Navarra,235,Ujué,202,112,90
31,Navarra,236,Ultzama,1698,870,828
31,Navarra,237,Unciti,234,141,93
31,Navarra,238,Unzué/Untzue,142,80,62
31,Navarra,239,Urdazubi/Urdax,378,188,190
31,Navarra,240,Urdiain,700,371,329
31,Navarra,241,Urraul Alto,176,107,69
31,Navarra,242,Urraul Bajo,292,127,165
31,Navarra,244,Urrotz,180,103,77
31,Navarra,243,Urroz-Villa,398,209,189
31,Navarra,245,Urzainqui/Urzainki,95,54,41
31,Navarra,246,Uterga,195,114,81
31,Navarra,247,Uztárroz/Uztarroze,166,82,84
31,Navarra,260,Valle de Yerri/Deierri,1525,783,742
31,Navarra,249,Valtierra,2523,1235,1288
31,Navarra,251,Viana,4022,2053,1969
31,Navarra,252,Vidángoz/Bidankoze,94,48,46
31,Navarra,254,Villafranca,2958,1477,1481
31,Navarra,255,Villamayor de Monjardín,137,72,65
31,Navarra,257,Villatuerta,1137,563,574
31,Navarra,258,Villava/Atarrabia,10496,5201,5295
31,Navarra,261,Yesa,252,131,121
31,Navarra,262,Zabalza/Zabaltza,282,147,135
31,Navarra,73,Ziordia,394,183,211
31,Navarra,907,Zizur Mayor/Zizur Nagusia,14084,6947,7137
31,Navarra,263,Zubieta,295,164,131
31,Navarra,264,Zugarramurdi,243,122,121
31,Navarra,265,Zúñiga,108,72,36
32,Ourense,1,Allariz,6059,3038,3021
32,Ourense,2,Amoeiro,2278,1117,1161
32,Ourense,3,"Arnoia, A",1051,515,536
32,Ourense,4,Avión,2408,1121,1287
32,Ourense,5,Baltar,1076,553,523
32,Ourense,6,Bande,1958,922,1036
32,Ourense,7,Baños de Molgas,1774,888,886
32,Ourense,8,Barbadás,10064,4888,5176
32,Ourense,9,"Barco de Valdeorras, O",14052,6876,7176
32,Ourense,10,Beade,500,254,246
32,Ourense,11,Beariz,1205,550,655
32,Ourense,12,"Blancos, Os",974,518,456
32,Ourense,13,Boborás,2862,1345,1517
32,Ourense,14,"Bola, A",1398,662,736
32,Ourense,15,"Bolo, O",1084,547,537
32,Ourense,16,Calvos de Randín,1064,537,527
32,Ourense,18,Carballeda de Avia,1487,715,772
32,Ourense,17,Carballeda de Valdeorras,1773,885,888
32,Ourense,19,"Carballiño, O",14246,6733,7513
32,Ourense,20,Cartelle,3163,1554,1609
32,Ourense,22,Castrelo de Miño,1754,870,884
32,Ourense,21,Castrelo do Val,1169,599,570
32,Ourense,23,Castro Caldelas,1486,740,746
32,Ourense,24,Celanova,5809,2745,3064
32,Ourense,25,Cenlle,1331,627,704
32,Ourense,29,Chandrexa de Queixa,586,329,257
32,Ourense,26,Coles,3216,1613,1603
32,Ourense,27,Cortegada,1277,631,646
32,Ourense,28,Cualedro,1924,979,945
32,Ourense,30,Entrimo,1391,664,727
32,Ourense,31,Esgos,1180,604,576
32,Ourense,33,Gomesende,914,438,476
32,Ourense,34,"Gudiña, A",1506,789,717
32,Ourense,35,"Irixo, O",1689,806,883
32,Ourense,38,Larouco,557,256,301
32,Ourense,39,Laza,1541,784,757
32,Ourense,40,Leiro,1763,877,886
32,Ourense,41,Lobeira,909,438,471
32,Ourense,42,Lobios,2175,1103,1072
32,Ourense,43,Maceda,3112,1510,1602
32,Ourense,44,Manzaneda,1001,497,504
32,Ourense,45,Maside,2969,1430,1539
32,Ourense,46,Melón,1479,699,780
32,Ourense,47,"Merca, A",2197,1082,1115
32,Ourense,48,"Mezquita, A",1304,677,627
32,Ourense,49,Montederramo,894,462,432
32,Ourense,50,Monterrei,2924,1459,1465
32,Ourense,51,Muíños,1779,895,884
32,Ourense,52,Nogueira de Ramuín,2336,1151,1185
32,Ourense,53,Oímbra,2062,1085,977
32,Ourense,54,Ourense,107597,49522,58075
32,Ourense,55,Paderne de Allariz,1574,765,809
32,Ourense,56,Padrenda,2244,1106,1138
32,Ourense,57,Parada de Sil,648,336,312
32,Ourense,58,"Pereiro de Aguiar, O",6306,3230,3076
32,Ourense,59,"Peroxa, A",2085,1023,1062
32,Ourense,60,Petín,982,475,507
32,Ourense,61,Piñor,1322,653,669
32,Ourense,63,"Pobra de Trives, A",2388,1196,1192
32,Ourense,64,Pontedeva,654,316,338
32,Ourense,62,Porqueira,1005,479,526
32,Ourense,65,Punxín,801,380,421
32,Ourense,66,Quintela de Leirado,716,314,402
32,Ourense,67,Rairiz de Veiga,1568,783,785
32,Ourense,68,Ramirás,1812,839,973
32,Ourense,69,Ribadavia,5319,2558,2761
32,Ourense,71,Riós,1803,902,901
32,Ourense,72,"Rúa, A",4695,2340,2355
32,Ourense,73,Rubiá,1557,781,776
32,Ourense,74,San Amaro,1237,612,625
32,Ourense,75,San Cibrao das Viñas,4745,2419,2326
32,Ourense,76,San Cristovo de Cea,2560,1270,1290
32,Ourense,70,San Xoán de Río,685,337,348
32,Ourense,77,Sandiás,1342,616,726
32,Ourense,78,Sarreaus,1408,709,699
32,Ourense,79,Taboadela,1642,831,811
32,Ourense,80,"Teixeira, A",415,208,207
32,Ourense,81,Toén,2567,1321,1246
32,Ourense,82,Trasmiras,1534,756,778
32,Ourense,83,"Veiga, A",1036,530,506
32,Ourense,84,Verea,1150,543,607
32,Ourense,85,Verín,14707,7240,7467
32,Ourense,86,Viana do Bolo,3180,1587,1593
32,Ourense,87,Vilamarín,2119,1058,1061
32,Ourense,88,Vilamartín de Valdeorras,1988,1009,979
32,Ourense,89,Vilar de Barrio,1572,780,792
32,Ourense,90,Vilar de Santos,922,447,475
32,Ourense,91,Vilardevós,2131,1088,1043
32,Ourense,92,Vilariño de Conso,632,363,269
32,Ourense,32,Xinzo de Limia,10358,5136,5222
32,Ourense,36,Xunqueira de Ambía,1649,822,827
32,Ourense,37,Xunqueira de Espadanedo,892,438,454
34,Palencia,1,Abarca de Campos,39,23,16
34,Palencia,3,Abia de las Torres,180,103,77
34,Palencia,4,Aguilar de Campoo,7203,3495,3708
34,Palencia,5,Alar del Rey,1031,505,526
34,Palencia,6,Alba de Cerrato,87,49,38
34,Palencia,9,Amayuelas de Arriba,38,23,15
34,Palencia,10,Ampudia,628,336,292
34,Palencia,11,Amusco,438,237,201
34,Palencia,12,Antigüedad,404,214,190
34,Palencia,15,Arconada,45,26,19
34,Palencia,17,Astudillo,1065,544,521
34,Palencia,18,Autilla del Pino,254,140,114
34,Palencia,19,Autillo de Campos,150,76,74
34,Palencia,20,Ayuela,61,36,25
34,Palencia,22,Baltanás,1313,693,620
34,Palencia,24,Baquerín de Campos,39,25,14
34,Palencia,25,Bárcena de Campos,55,28,27
34,Palencia,27,Barruelo de Santullán,1403,685,718
34,Palencia,28,Báscones de Ojeda,165,91,74
34,Palencia,29,Becerril de Campos,915,464,451
34,Palencia,31,Belmonte de Campos,32,16,16
34,Palencia,32,Berzosilla,51,25,26
34,Palencia,33,Boada de Campos,20,13,7
34,Palencia,35,Boadilla de Rioseco,129,75,54
34,Palencia,34,Boadilla del Camino,113,63,50
34,Palencia,36,Brañosera,233,131,102
34,Palencia,37,Buenavista de Valdavia,373,196,177
34,Palencia,38,Bustillo de la Vega,319,170,149
34,Palencia,39,Bustillo del Páramo de Carrión,64,38,26
34,Palencia,41,Calahorra de Boedo,115,62,53
34,Palencia,42,Calzada de los Molinos,347,185,162
34,Palencia,45,Capillas,90,43,47
34,Palencia,46,Cardeñosa de Volpejera,50,27,23
34,Palencia,47,Carrión de los Condes,2231,1082,1149
34,Palencia,48,Castil de Vela,68,32,36
34,Palencia,49,Castrejón de la Peña,444,244,200
34,Palencia,50,Castrillo de Don Juan,239,125,114
34,Palencia,51,Castrillo de Onielo,121,60,61
34,Palencia,52,Castrillo de Villavega,210,111,99
34,Palencia,53,Castromocho,247,131,116
34,Palencia,55,Cervatos de la Cueza,307,177,130
34,Palencia,56,Cervera de Pisuerga,2572,1290,1282
34,Palencia,57,Cevico de la Torre,520,260,260
34,Palencia,58,Cevico Navero,219,117,102
34,Palencia,59,Cisneros,498,244,254
34,Palencia,60,Cobos de Cerrato,159,84,75
34,Palencia,61,Collazos de Boedo,127,70,57
34,Palencia,62,Congosto de Valdavia,187,107,80
34,Palencia,63,Cordovilla la Real,127,70,57
34,Palencia,66,Cubillas de Cerrato,69,37,32
34,Palencia,67,Dehesa de Montejo,139,79,60
34,Palencia,68,Dehesa de Romanos,40,24,16
34,Palencia,69,Dueñas,2802,1453,1349
34,Palencia,70,Espinosa de Cerrato,194,99,95
34,Palencia,71,Espinosa de Villagonzalo,220,117,103
34,Palencia,72,Frechilla,195,100,95
34,Palencia,73,Fresno del Río,196,101,95
34,Palencia,74,Frómista,846,431,415
34,Palencia,76,Fuentes de Nava,731,374,357
34,Palencia,77,Fuentes de Valdepero,347,182,165
34,Palencia,79,Grijota,1932,1006,926
34,Palencia,80,Guardo,7027,3508,3519
34,Palencia,81,Guaza de Campos,68,35,33
34,Palencia,82,Hérmedes de Cerrato,98,54,44
34,Palencia,83,Herrera de Pisuerga,2292,1117,1175
34,Palencia,84,Herrera de Valdecañas,158,84,74
34,Palencia,86,Hontoria de Cerrato,110,58,52
34,Palencia,87,Hornillos de Cerrato,115,57,58
34,Palencia,88,Husillos,254,141,113
34,Palencia,89,Itero de la Vega,184,95,89
34,Palencia,91,Lagartos,146,79,67
34,Palencia,92,Lantadilla,369,189,180
34,Palencia,94,Ledigos,70,40,30
34,Palencia,903,Loma de Ucieza,262,154,108
34,Palencia,96,Lomas,51,32,19
34,Palencia,98,Magaz de Pisuerga,1097,627,470
34,Palencia,99,Manquillos,68,38,30
34,Palencia,100,Mantinos,158,90,68
34,Palencia,101,Marcilla de Campos,43,20,23
34,Palencia,102,Mazariegos,249,149,100
34,Palencia,103,Mazuecos de Valdeginate,107,57,50
34,Palencia,104,Melgar de Yuso,287,163,124
34,Palencia,106,Meneses de Campos,124,63,61
34,Palencia,107,Micieces de Ojeda,93,51,42
34,Palencia,108,Monzón de Campos,652,339,313
34,Palencia,109,Moratinos,67,39,28
34,Palencia,110,Mudá,100,50,50
34,Palencia,112,Nogal de las Huertas,46,27,19
34,Palencia,113,Olea de Boedo,37,14,23
34,Palencia,114,Olmos de Ojeda,240,143,97
34,Palencia,116,Osornillo,73,39,34
34,Palencia,901,Osorno la Mayor,1435,751,684
34,Palencia,120,Palencia,81198,38361,42837
34,Palencia,121,Palenzuela,222,120,102
34,Palencia,122,Páramo de Boedo,85,47,38
34,Palencia,123,Paredes de Nava,2104,1062,1042
34,Palencia,124,Payo de Ojeda,70,40,30
34,Palencia,125,Pedraza de Campos,97,52,45
34,Palencia,126,Pedrosa de la Vega,340,191,149
34,Palencia,127,Perales,139,71,68
34,Palencia,904,"Pernía, La",373,217,156
34,Palencia,129,Pino del Río,209,127,82
34,Palencia,130,Piña de Campos,257,136,121
34,Palencia,131,Población de Arroyo,73,40,33
34,Palencia,132,Población de Campos,136,75,61
34,Palencia,133,Población de Cerrato,119,67,52
34,Palencia,134,Polentinos,63,35,28
34,Palencia,135,Pomar de Valdivia,499,271,228
34,Palencia,136,Poza de la Vega,236,132,104
34,Palencia,137,Pozo de Urama,31,19,12
34,Palencia,139,Prádanos de Ojeda,215,117,98
34,Palencia,140,"Puebla de Valdavia, La",114,58,56
34,Palencia,141,Quintana del Puente,251,139,112
34,Palencia,143,Quintanilla de Onsoña,205,115,90
34,Palencia,146,Reinoso de Cerrato,57,34,23
34,Palencia,147,Renedo de la Vega,214,117,97
34,Palencia,149,Requena de Campos,24,11,13
34,Palencia,151,Respenda de la Peña,193,110,83
34,Palencia,152,Revenga de Campos,168,83,85
34,Palencia,154,Revilla de Collazos,84,45,39
34,Palencia,155,Ribas de Campos,166,82,84
34,Palencia,156,Riberos de la Cueza,62,40,22
34,Palencia,157,Saldaña,3032,1530,1502
34,Palencia,158,Salinas de Pisuerga,375,192,183
34,Palencia,159,San Cebrián de Campos,473,262,211
34,Palencia,160,San Cebrián de Mudá,170,87,83
34,Palencia,161,San Cristóbal de Boedo,25,14,11
34,Palencia,163,San Mamés de Campos,65,31,34
34,Palencia,165,San Román de la Cuba,87,47,40
34,Palencia,167,Santa Cecilia del Alcor,132,80,52
34,Palencia,168,Santa Cruz de Boedo,62,32,30
34,Palencia,169,Santervás de la Vega,497,281,216
34,Palencia,170,Santibáñez de Ecla,75,35,40
34,Palencia,171,Santibáñez de la Peña,1196,594,602
34,Palencia,174,Santoyo,241,127,114
34,Palencia,175,"Serna, La",113,70,43
34,Palencia,177,Soto de Cerrato,190,109,81
34,Palencia,176,Sotobañado y Priorato,167,93,74
34,Palencia,178,Tabanera de Cerrato,119,70,49
34,Palencia,179,Tabanera de Valdavia,33,14,19
34,Palencia,180,Támara de Campos,88,45,43
34,Palencia,181,Tariego de Cerrato,529,284,245
34,Palencia,182,Torquemada,1081,581,500
34,Palencia,184,Torremormojón,54,31,23
34,Palencia,185,Triollo,70,40,30
34,Palencia,186,Valbuena de Pisuerga,57,32,25
34,Palencia,189,Valdeolmillos,67,36,31
34,Palencia,190,Valderrábano,61,33,28
34,Palencia,192,Valde-Ucieza,114,66,48
34,Palencia,196,Valle de Cerrato,92,53,39
34,Palencia,902,Valle del Retortillo,191,109,82
34,Palencia,199,Velilla del Río Carrión,1493,773,720
34,Palencia,23,Venta de Baños,6472,3232,3240
34,Palencia,201,Vertavillo,215,114,101
34,Palencia,93,"Vid de Ojeda, La",111,66,45
34,Palencia,202,Villabasta de Valdavia,32,17,15
34,Palencia,204,Villacidaler,52,30,22
34,Palencia,205,Villaconancio,70,44,26
34,Palencia,206,Villada,1080,552,528
34,Palencia,208,Villaeles de Valdavia,67,36,31
34,Palencia,210,Villahán,111,58,53
34,Palencia,211,Villaherreros,229,111,118
34,Palencia,213,Villalaco,70,34,36
34,Palencia,214,Villalba de Guardo,199,106,93
34,Palencia,215,Villalcázar de Sirga,165,84,81
34,Palencia,216,Villalcón,67,35,32
34,Palencia,217,Villalobón,1475,763,712
34,Palencia,218,Villaluenga de la Vega,595,337,258
34,Palencia,220,Villamartín de Campos,187,102,85
34,Palencia,221,Villamediana,191,103,88
34,Palencia,222,Villameriel,122,72,50
34,Palencia,223,Villamoronta,279,155,124
34,Palencia,224,Villamuera de la Cueza,50,30,20
34,Palencia,225,Villamuriel de Cerrato,6354,3270,3084
34,Palencia,227,Villanueva del Rebollar,87,45,42
34,Palencia,228,Villanuño de Valdavia,99,53,46
34,Palencia,229,Villaprovedo,69,44,25
34,Palencia,230,Villarmentero de Campos,14,9,5
34,Palencia,231,Villarrabé,248,126,122
34,Palencia,232,Villarramiel,901,482,419
34,Palencia,233,Villasarracino,153,83,70
34,Palencia,234,Villasila de Valdavia,73,52,21
34,Palencia,236,Villaturde,183,90,93
34,Palencia,237,Villaumbrales,738,380,358
34,Palencia,238,Villaviudas,394,191,203
34,Palencia,240,Villerías de Campos,106,58,48
34,Palencia,241,Villodre,20,12,8
34,Palencia,242,Villodrigo,135,71,64
34,Palencia,243,Villoldo,398,222,176
34,Palencia,245,Villota del Páramo,353,203,150
34,Palencia,246,Villovieco,80,46,34
35,"Palmas, Las",1,Agaete,5767,2906,2861
35,"Palmas, Las",2,Agüimes,29912,15175,14737
35,"Palmas, Las",20,"Aldea de San Nicolás, La",8633,4378,4255
35,"Palmas, Las",3,Antigua,11172,6030,5142
35,"Palmas, Las",4,Arrecife,56284,28463,27821
35,"Palmas, Las",5,Artenara,1242,680,562
35,"Palmas, Las",6,Arucas,36797,18374,18423
35,"Palmas, Las",7,Betancuria,805,419,386
35,"Palmas, Las",8,Firgas,7648,3900,3748
35,"Palmas, Las",9,Gáldar,24319,12218,12101
35,"Palmas, Las",10,Haría,5190,2678,2512
35,"Palmas, Las",11,Ingenio,30048,15238,14810
35,"Palmas, Las",12,Mogán,24225,12632,11593
35,"Palmas, Las",13,Moya,8042,4083,3959
35,"Palmas, Las",14,"Oliva, La",24079,12860,11219
35,"Palmas, Las",15,Pájara,20500,10920,9580
35,"Palmas, Las",16,"Palmas de Gran Canaria, Las",382296,186030,196266
35,"Palmas, Las",17,Puerto del Rosario,36285,18632,17653
35,"Palmas, Las",18,San Bartolomé,18487,9374,9113
35,"Palmas, Las",19,San Bartolomé de Tirajana,55954,29279,26675
35,"Palmas, Las",21,Santa Brígida,18907,9375,9532
35,"Palmas, Las",22,Santa Lucía de Tirajana,67291,33811,33480
35,"Palmas, Las",23,Santa María de Guía de Gran Canaria,14070,6994,7076
35,"Palmas, Las",24,Teguise,21096,10698,10398
35,"Palmas, Las",25,Tejeda,2119,1132,987
35,"Palmas, Las",26,Telde,101300,50285,51015
35,"Palmas, Las",27,Teror,12830,6573,6257
35,"Palmas, Las",28,Tías,20228,10377,9851
35,"Palmas, Las",29,Tinajo,5716,2954,2762
35,"Palmas, Las",30,Tuineje,13615,7025,6590
35,"Palmas, Las",32,Valleseco,3903,2053,1850
35,"Palmas, Las",31,Valsequillo de Gran Canaria,9157,4628,4529
35,"Palmas, Las",33,Vega de San Mateo,7765,3974,3791
35,"Palmas, Las",34,Yaiza,15131,8037,7094
36,Pontevedra,20,Agolada,2803,1380,1423
36,Pontevedra,1,Arbo,3191,1585,1606
36,Pontevedra,3,Baiona,12063,6010,6053
36,Pontevedra,2,Barro,3724,1842,1882
36,Pontevedra,4,Bueu,12373,6127,6246
36,Pontevedra,5,Caldas de Reis,10008,4857,5151
36,Pontevedra,6,Cambados,13898,6734,7164
36,Pontevedra,7,Campo Lameiro,2009,966,1043
36,Pontevedra,8,Cangas,26087,12918,13169
36,Pontevedra,9,"Cañiza, A",5511,2698,2813
36,Pontevedra,10,Catoira,3484,1696,1788
36,Pontevedra,11,Cerdedo,1916,901,1015
36,Pontevedra,12,Cotobade,4394,2095,2299
36,Pontevedra,13,Covelo,2931,1454,1477
36,Pontevedra,14,Crecente,2367,1138,1229
36,Pontevedra,15,Cuntis,4992,2357,2635
36,Pontevedra,16,Dozón,1328,671,657
36,Pontevedra,17,"Estrada, A",21657,10382,11275
36,Pontevedra,18,Forcarei,3916,1861,2055
36,Pontevedra,19,Fornelos de Montes,1906,899,1007
36,Pontevedra,21,Gondomar,13954,6858,7096
36,Pontevedra,22,"Grove, O",11236,5526,5710
36,Pontevedra,23,"Guarda, A",10453,5097,5356
36,Pontevedra,901,"Illa de Arousa, A",4981,2467,2514
36,Pontevedra,24,Lalín,20409,9958,10451
36,Pontevedra,25,"Lama, A",2918,1407,1511
36,Pontevedra,26,Marín,25562,12829,12733
36,Pontevedra,27,Meaño,5453,2663,2790
36,Pontevedra,28,Meis,4992,2376,2616
36,Pontevedra,29,Moaña,19291,9499,9792
36,Pontevedra,30,Mondariz,4841,2332,2509
36,Pontevedra,31,Mondariz-Balneario,690,341,349
36,Pontevedra,32,Moraña,4402,2116,2286
36,Pontevedra,33,Mos,15267,7523,7744
36,Pontevedra,34,"Neves, As",4300,2112,2188
36,Pontevedra,35,Nigrán,17840,8797,9043
36,Pontevedra,36,Oia,3101,1556,1545
36,Pontevedra,37,Pazos de Borbén,3170,1523,1647
36,Pontevedra,41,Poio,16642,8223,8419
36,Pontevedra,43,Ponte Caldelas,5739,2781,2958
36,Pontevedra,42,Ponteareas,23409,11437,11972
36,Pontevedra,44,Pontecesures,3123,1581,1542
36,Pontevedra,38,Pontevedra,82684,39242,43442
36,Pontevedra,39,"Porriño, O",18543,9167,9376
36,Pontevedra,40,Portas,3073,1471,1602
36,Pontevedra,45,Redondela,30015,14692,15323
36,Pontevedra,46,Ribadumia,5166,2495,2671
36,Pontevedra,47,Rodeiro,2931,1480,1451
36,Pontevedra,48,"Rosal, O",6574,3257,3317
36,Pontevedra,49,Salceda de Caselas,8835,4477,4358
36,Pontevedra,50,Salvaterra de Miño,9677,4871,4806
36,Pontevedra,51,Sanxenxo,17604,8684,8920
36,Pontevedra,52,Silleda,9074,4456,4618
36,Pontevedra,53,Soutomaior,7265,3599,3666
36,Pontevedra,54,Tomiño,13738,6918,6820
36,Pontevedra,55,Tui,17230,8291,8939
36,Pontevedra,56,Valga,6072,2969,3103
36,Pontevedra,57,Vigo,297355,141806,155549
36,Pontevedra,59,Vila de Cruces,6085,3008,3077
36,Pontevedra,58,Vilaboa,5965,2884,3081
36,Pontevedra,60,Vilagarcía de Arousa,37621,18091,19530
36,Pontevedra,61,Vilanova de Arousa,10590,5177,5413
26,"Rioja, La",1,Ábalos,357,229,128
26,"Rioja, La",2,Agoncillo,1164,657,507
26,"Rioja, La",3,Aguilar del Río Alhama,546,262,284
26,"Rioja, La",4,Ajamil de Cameros,79,52,27
26,"Rioja, La",5,Albelda de Iregua,3394,1770,1624
26,"Rioja, La",6,Alberite,2690,1349,1341
26,"Rioja, La",7,Alcanadre,748,396,352
26,"Rioja, La",8,Aldeanueva de Ebro,2815,1469,1346
26,"Rioja, La",9,Alesanco,541,289,252
26,"Rioja, La",10,Alesón,109,64,45
26,"Rioja, La",11,Alfaro,9851,4991,4860
26,"Rioja, La",12,Almarza de Cameros,17,11,6
26,"Rioja, La",13,Anguciana,471,258,213
26,"Rioja, La",14,Anguiano,546,309,237
26,"Rioja, La",15,Arenzana de Abajo,264,138,126
26,"Rioja, La",16,Arenzana de Arriba,34,21,13
26,"Rioja, La",17,Arnedillo,484,239,245
26,"Rioja, La",18,Arnedo,14548,7242,7306
26,"Rioja, La",19,Arrúbal,498,259,239
26,"Rioja, La",20,Ausejo,1106,660,446
26,"Rioja, La",21,Autol,4442,2294,2148
26,"Rioja, La",22,Azofra,248,135,113
26,"Rioja, La",23,Badarán,583,302,281
26,"Rioja, La",24,Bañares,303,152,151
26,"Rioja, La",26,Baños de Río Tobía,1662,831,831
26,"Rioja, La",25,Baños de Rioja,96,55,41
26,"Rioja, La",27,Berceo,174,109,65
26,"Rioja, La",28,Bergasa,150,84,66
26,"Rioja, La",29,Bergasillas Bajera,35,18,17
26,"Rioja, La",30,Bezares,20,10,10
26,"Rioja, La",31,Bobadilla,140,75,65
26,"Rioja, La",32,Brieva de Cameros,58,37,21
26,"Rioja, La",33,Briñas,242,117,125
26,"Rioja, La",34,Briones,856,455,401
26,"Rioja, La",35,Cabezón de Cameros,20,16,4
26,"Rioja, La",36,Calahorra,24897,12340,12557
26,"Rioja, La",37,Camprovín,179,99,80
26,"Rioja, La",38,Canales de la Sierra,88,51,37
26,"Rioja, La",39,Canillas de Río Tuerto,42,20,22
26,"Rioja, La",40,Cañas,93,44,49
26,"Rioja, La",41,Cárdenas,178,91,87
26,"Rioja, La",42,Casalarreina,1355,726,629
26,"Rioja, La",43,Castañares de Rioja,474,224,250
26,"Rioja, La",44,Castroviejo,60,34,26
26,"Rioja, La",45,Cellorigo,13,6,7
26,"Rioja, La",46,Cenicero,2092,1073,1019
26,"Rioja, La",47,Cervera del Río Alhama,2636,1350,1286
26,"Rioja, La",48,Cidamón,32,18,14
26,"Rioja, La",49,Cihuri,229,116,113
26,"Rioja, La",50,Cirueña,128,74,54
26,"Rioja, La",51,Clavijo,298,170,128
26,"Rioja, La",52,Cordovín,182,94,88
26,"Rioja, La",53,Corera,279,151,128
26,"Rioja, La",54,Cornago,405,227,178
26,"Rioja, La",55,Corporales,41,21,20
26,"Rioja, La",56,Cuzcurrita de Río Tirón,510,277,233
26,"Rioja, La",57,Daroca de Rioja,59,37,22
26,"Rioja, La",58,Enciso,167,98,69
26,"Rioja, La",59,Entrena,1523,798,725
26,"Rioja, La",60,Estollo,98,63,35
26,"Rioja, La",61,Ezcaray,2054,1077,977
26,"Rioja, La",62,Foncea,98,52,46
26,"Rioja, La",63,Fonzaleche,159,107,52
26,"Rioja, La",64,Fuenmayor,3195,1620,1575
26,"Rioja, La",65,Galbárruli,62,39,23
26,"Rioja, La",66,Galilea,381,191,190
26,"Rioja, La",67,Gallinero de Cameros,25,17,8
26,"Rioja, La",68,Gimileo,163,103,60
26,"Rioja, La",69,Grañón,293,165,128
26,"Rioja, La",70,Grávalos,229,120,109
26,"Rioja, La",71,Haro,11806,5922,5884
26,"Rioja, La",72,Herce,362,188,174
26,"Rioja, La",73,Herramélluri,117,61,56
26,"Rioja, La",74,Hervías,142,73,69
26,"Rioja, La",75,Hormilla,445,241,204
26,"Rioja, La",76,Hormilleja,162,83,79
26,"Rioja, La",77,Hornillos de Cameros,14,5,9
26,"Rioja, La",78,Hornos de Moncalvillo,94,55,39
26,"Rioja, La",79,Huércanos,902,475,427
26,"Rioja, La",80,Igea,698,406,292
26,"Rioja, La",81,Jalón de Cameros,23,12,11
26,"Rioja, La",82,Laguna de Cameros,135,80,55
26,"Rioja, La",83,Lagunilla del Jubera,327,184,143
26,"Rioja, La",84,Lardero,8750,4438,4312
26,"Rioja, La",86,Ledesma de la Cogolla,19,14,5
26,"Rioja, La",87,Leiva,290,150,140
26,"Rioja, La",88,Leza de Río Leza,50,28,22
26,"Rioja, La",89,Logroño,153402,73829,79573
26,"Rioja, La",91,Lumbreras,164,106,58
26,"Rioja, La",92,Manjarrés,141,79,62
26,"Rioja, La",93,Mansilla de la Sierra,63,44,19
26,"Rioja, La",94,Manzanares de Rioja,98,57,41
26,"Rioja, La",95,Matute,131,64,67
26,"Rioja, La",96,Medrano,299,158,141
26,"Rioja, La",98,Munilla,123,60,63
26,"Rioja, La",99,Murillo de Río Leza,1787,948,839
26,"Rioja, La",100,Muro de Aguas,65,40,25
26,"Rioja, La",101,Muro en Cameros,48,30,18
26,"Rioja, La",102,Nájera,8427,4196,4231
26,"Rioja, La",103,Nalda,1028,569,459
26,"Rioja, La",104,Navajún,20,14,6
26,"Rioja, La",105,Navarrete,2881,1474,1407
26,"Rioja, La",106,Nestares,79,47,32
26,"Rioja, La",107,Nieva de Cameros,99,62,37
26,"Rioja, La",109,Ochánduri,109,63,46
26,"Rioja, La",108,Ocón,330,202,128
26,"Rioja, La",110,Ojacastro,186,110,76
26,"Rioja, La",111,Ollauri,314,170,144
26,"Rioja, La",112,Ortigosa de Cameros,280,162,118
26,"Rioja, La",113,Pazuengos,35,24,11
26,"Rioja, La",114,Pedroso,82,52,30
26,"Rioja, La",115,Pinillos,16,9,7
26,"Rioja, La",117,Pradejón,4184,2184,2000
26,"Rioja, La",118,Pradillo,67,36,31
26,"Rioja, La",119,Préjano,263,148,115
26,"Rioja, La",120,Quel,2060,1073,987
26,"Rioja, La",121,Rabanera,45,33,12
26,"Rioja, La",122,"Rasillo de Cameros, El",145,77,68
26,"Rioja, La",123,"Redal, El",163,87,76
26,"Rioja, La",124,Ribafrecha,1010,533,477
26,"Rioja, La",125,Rincón de Soto,3799,1920,1879
26,"Rioja, La",126,Robres del Castillo,27,18,9
26,"Rioja, La",127,Rodezno,307,180,127
26,"Rioja, La",128,Sajazarra,133,70,63
26,"Rioja, La",129,San Asensio,1220,641,579
26,"Rioja, La",130,San Millán de la Cogolla,260,169,91
26,"Rioja, La",131,San Millán de Yécora,44,27,17
26,"Rioja, La",132,San Román de Cameros,164,88,76
26,"Rioja, La",139,San Torcuato,81,48,33
26,"Rioja, La",142,San Vicente de la Sonsierra,1127,616,511
26,"Rioja, La",134,Santa Coloma,123,73,50
26,"Rioja, La",135,Santa Engracia del Jubera,184,114,70
26,"Rioja, La",136,Santa Eulalia Bajera,121,65,56
26,"Rioja, La",138,Santo Domingo de la Calzada,6671,3433,3238
26,"Rioja, La",140,Santurde de Rioja,329,175,154
26,"Rioja, La",141,Santurdejo,140,82,58
26,"Rioja, La",143,Sojuela,263,154,109
26,"Rioja, La",144,Sorzano,254,143,111
26,"Rioja, La",145,Sotés,290,164,126
26,"Rioja, La",146,Soto en Cameros,141,75,66
26,"Rioja, La",147,Terroba,37,20,17
26,"Rioja, La",148,Tirgo,229,121,108
26,"Rioja, La",149,Tobía,63,35,28
26,"Rioja, La",150,Tormantos,151,87,64
26,"Rioja, La",153,Torre en Cameros,12,10,2
26,"Rioja, La",151,Torrecilla en Cameros,529,292,237
26,"Rioja, La",152,Torrecilla sobre Alesanco,37,19,18
26,"Rioja, La",154,Torremontalbo,14,7,7
26,"Rioja, La",155,Treviana,186,101,85
26,"Rioja, La",157,Tricio,388,191,197
26,"Rioja, La",158,Tudelilla,371,206,165
26,"Rioja, La",160,Uruñuela,967,488,479
26,"Rioja, La",161,Valdemadera,9,6,3
26,"Rioja, La",162,Valgañón,125,75,50
26,"Rioja, La",163,Ventosa,164,98,66
26,"Rioja, La",164,Ventrosa,70,43,27
26,"Rioja, La",165,Viguera,435,242,193
26,"Rioja, La",166,Villalba de Rioja,148,89,59
26,"Rioja, La",167,Villalobar de Rioja,68,48,20
26,"Rioja, La",168,Villamediana de Iregua,7212,3697,3515
26,"Rioja, La",169,Villanueva de Cameros,92,52,40
26,"Rioja, La",170,"Villar de Arnedo, El",652,333,319
26,"Rioja, La",171,Villar de Torre,244,141,103
26,"Rioja, La",172,Villarejo,34,23,11
26,"Rioja, La",173,Villarroya,9,4,5
26,"Rioja, La",174,Villarta-Quintana,161,88,73
26,"Rioja, La",175,Villavelayo,51,32,19
26,"Rioja, La",176,Villaverde de Rioja,70,37,33
26,"Rioja, La",177,Villoslada de Cameros,360,213,147
26,"Rioja, La",178,Viniegra de Abajo,97,58,39
26,"Rioja, La",179,Viniegra de Arriba,54,33,21
26,"Rioja, La",180,Zarratón,299,171,128
26,"Rioja, La",181,Zarzosa,16,13,3
26,"Rioja, La",183,Zorraquín,89,43,46
37,Salamanca,1,Abusejo,233,122,111
37,Salamanca,2,Agallas,152,81,71
37,Salamanca,3,Ahigal de los Aceiteros,138,70,68
37,Salamanca,4,Ahigal de Villarino,37,18,19
37,Salamanca,5,"Alameda de Gardón, La",104,54,50
37,Salamanca,6,"Alamedilla, La",162,84,78
37,Salamanca,7,Alaraz,537,277,260
37,Salamanca,8,Alba de Tormes,5382,2671,2711
37,Salamanca,9,Alba de Yeltes,248,130,118
37,Salamanca,10,"Alberca, La",1192,605,587
37,Salamanca,11,"Alberguería de Argañán, La",141,73,68
37,Salamanca,12,Alconada,164,86,78
37,Salamanca,15,Aldea del Obispo,361,198,163
37,Salamanca,13,Aldeacipreste,135,70,65
37,Salamanca,14,Aldeadávila de la Ribera,1364,705,659
37,Salamanca,16,Aldealengua,654,331,323
37,Salamanca,17,Aldeanueva de Figueroa,288,149,139
37,Salamanca,18,Aldeanueva de la Sierra,130,72,58
37,Salamanca,19,Aldearrodrigo,165,85,80
37,Salamanca,20,Aldearrubia,525,287,238
37,Salamanca,21,Aldeaseca de Alba,89,41,48
37,Salamanca,22,Aldeaseca de la Frontera,312,161,151
37,Salamanca,23,Aldeatejada,1499,769,730
37,Salamanca,24,Aldeavieja de Tormes,105,53,52
37,Salamanca,25,Aldehuela de la Bóveda,300,152,148
37,Salamanca,26,Aldehuela de Yeltes,217,121,96
37,Salamanca,27,Almenara de Tormes,286,157,129
37,Salamanca,28,Almendra,183,99,84
37,Salamanca,29,Anaya de Alba,228,128,100
37,Salamanca,30,Añover de Tormes,96,52,44
37,Salamanca,31,Arabayona de Mógica,433,233,200
37,Salamanca,32,Arapiles,612,315,297
37,Salamanca,33,Arcediano,107,58,49
37,Salamanca,34,"Arco, El",96,52,44
37,Salamanca,35,Armenteros,342,186,156
37,Salamanca,37,"Atalaya, La",131,72,59
37,Salamanca,38,Babilafuente,918,481,437
37,Salamanca,39,Bañobárez,347,176,171
37,Salamanca,40,Barbadillo,456,236,220
37,Salamanca,41,Barbalos,83,47,36
37,Salamanca,42,Barceo,48,26,22
37,Salamanca,44,Barruecopardo,518,279,239
37,Salamanca,45,"Bastida, La",30,18,12
37,Salamanca,46,Béjar,14408,6859,7549
37,Salamanca,47,Beleña,208,99,109
37,Salamanca,49,Bermellar,159,81,78
37,Salamanca,50,Berrocal de Huebra,75,40,35
37,Salamanca,51,Berrocal de Salvatierra,95,49,46
37,Salamanca,52,Boada,307,160,147
37,Salamanca,54,"Bodón, El",311,158,153
37,Salamanca,55,Bogajo,150,81,69
37,Salamanca,56,"Bouza, La",84,44,40
37,Salamanca,57,Bóveda del Río Almar,253,132,121
37,Salamanca,58,Brincones,66,33,33
37,Salamanca,59,Buenamadre,144,78,66
37,Salamanca,60,Buenavista,249,136,113
37,Salamanca,61,"Cabaco, El",278,137,141
37,Salamanca,63,"Cabeza de Béjar, La",95,55,40
37,Salamanca,65,Cabeza del Caballo,363,193,170
37,Salamanca,62,Cabezabellosa de la Calzada,96,53,43
37,Salamanca,67,Cabrerizos,4070,2044,2026
37,Salamanca,68,Cabrillas,432,212,220
37,Salamanca,69,Calvarrasa de Abajo,1146,604,542
37,Salamanca,70,Calvarrasa de Arriba,626,323,303
37,Salamanca,71,"Calzada de Béjar, La",100,52,48
37,Salamanca,72,Calzada de Don Diego,199,109,90
37,Salamanca,73,Calzada de Valdunciel,650,332,318
37,Salamanca,74,Campillo de Azaba,187,98,89
37,Salamanca,77,"Campo de Peñaranda, El",299,164,135
37,Salamanca,78,Candelario,1005,505,500
37,Salamanca,79,Canillas de Abajo,85,57,28
37,Salamanca,80,Cantagallo,283,150,133
37,Salamanca,81,Cantalapiedra,1085,555,530
37,Salamanca,82,Cantalpino,1000,549,451
37,Salamanca,83,Cantaracillo,213,110,103
37,Salamanca,85,Carbajosa de la Sagrada,6528,3340,3188
37,Salamanca,86,Carpio de Azaba,108,61,47
37,Salamanca,87,Carrascal de Barregas,1038,552,486
37,Salamanca,88,Carrascal del Obispo,241,125,116
37,Salamanca,89,Casafranca,73,40,33
37,Salamanca,90,"Casas del Conde, Las",57,31,26
37,Salamanca,91,Casillas de Flores,203,103,100
37,Salamanca,92,Castellanos de Moriscos,1942,1012,930
37,Salamanca,185,Castellanos de Villiquera,686,365,321
37,Salamanca,96,Castillejo de Martín Viejo,250,140,110
37,Salamanca,97,Castraz,49,30,19
37,Salamanca,98,Cepeda,377,187,190
37,Salamanca,99,Cereceda de la Sierra,99,52,47
37,Salamanca,100,Cerezal de Peñahorcada,90,50,40
37,Salamanca,101,Cerralbo,195,108,87
37,Salamanca,102,"Cerro, El",460,232,228
37,Salamanca,103,Cespedosa de Tormes,573,311,262
37,Salamanca,114,Chagarcía Medianero,93,49,44
37,Salamanca,104,Cilleros de la Bastida,36,20,16
37,Salamanca,106,Cipérez,304,153,151
37,Salamanca,107,Ciudad Rodrigo,13646,6626,7020
37,Salamanca,108,Coca de Alba,109,54,55
37,Salamanca,109,Colmenar de Montemayor,200,110,90
37,Salamanca,110,Cordovilla,126,70,56
37,Salamanca,112,Cristóbal,178,98,80
37,Salamanca,113,"Cubo de Don Sancho, El",481,257,224
37,Salamanca,115,Dios le Guarde,156,81,75
37,Salamanca,116,Doñinos de Ledesma,83,44,39
37,Salamanca,117,Doñinos de Salamanca,1766,936,830
37,Salamanca,118,Ejeme,151,88,63
37,Salamanca,120,Encina de San Silvestre,117,60,57
37,Salamanca,119,"Encina, La",122,75,47
37,Salamanca,121,Encinas de Abajo,620,322,298
37,Salamanca,122,Encinas de Arriba,250,129,121
37,Salamanca,123,Encinasola de los Comendadores,215,115,100
37,Salamanca,124,Endrinal,259,141,118
37,Salamanca,125,Escurial de la Sierra,269,146,123
37,Salamanca,126,Espadaña,42,24,18
37,Salamanca,127,Espeja,265,135,130
37,Salamanca,128,Espino de la Orbada,286,154,132
37,Salamanca,129,Florida de Liébana,291,155,136
37,Salamanca,130,Forfoleda,188,106,82
37,Salamanca,131,Frades de la Sierra,221,116,105
37,Salamanca,132,"Fregeneda, La",420,207,213
37,Salamanca,133,Fresnedoso,112,63,49
37,Salamanca,134,Fresno Alhándiga,275,152,123
37,Salamanca,135,"Fuente de San Esteban, La",1425,723,702
37,Salamanca,136,Fuenteguinaldo,728,369,359
37,Salamanca,137,Fuenteliante,117,61,56
37,Salamanca,138,Fuenterroble de Salvatierra,255,128,127
37,Salamanca,139,Fuentes de Béjar,256,126,130
37,Salamanca,140,Fuentes de Oñoro,1380,696,684
37,Salamanca,141,Gajates,172,80,92
37,Salamanca,142,Galindo y Perahuy,733,424,309
37,Salamanca,143,Galinduste,470,231,239
37,Salamanca,144,Galisancho,428,235,193
37,Salamanca,145,Gallegos de Argañán,312,160,152
37,Salamanca,146,Gallegos de Solmirón,143,74,69
37,Salamanca,147,Garcibuey,192,109,83
37,Salamanca,148,Garcihernández,516,271,245
37,Salamanca,149,Garcirrey,78,44,34
37,Salamanca,150,Gejuelo del Barro,46,27,19
37,Salamanca,151,Golpejas,155,82,73
37,Salamanca,152,Gomecello,510,270,240
37,Salamanca,154,Guadramiro,165,93,72
37,Salamanca,155,Guijo de Ávila,98,58,40
37,Salamanca,156,Guijuelo,6001,3048,2953
37,Salamanca,157,Herguijuela de Ciudad Rodrigo,96,53,43
37,Salamanca,158,Herguijuela de la Sierra,299,165,134
37,Salamanca,159,Herguijuela del Campo,103,45,58
37,Salamanca,160,Hinojosa de Duero,720,359,361
37,Salamanca,161,Horcajo de Montemayor,162,83,79
37,Salamanca,162,Horcajo Medianero,250,132,118
37,Salamanca,163,"Hoya, La",48,26,22
37,Salamanca,164,Huerta,334,186,148
37,Salamanca,165,Iruelos,35,16,19
37,Salamanca,166,Ituero de Azaba,231,119,112
37,Salamanca,167,Juzbado,172,89,83
37,Salamanca,168,Lagunilla,552,299,253
37,Salamanca,169,Larrodrigo,209,117,92
37,Salamanca,170,Ledesma,1909,942,967
37,Salamanca,171,Ledrada,534,270,264
37,Salamanca,172,Linares de Riofrío,978,531,447
37,Salamanca,173,Lumbrales,1876,942,934
37,Salamanca,175,Machacón,461,241,220
37,Salamanca,174,Macotera,1268,665,603
37,Salamanca,176,Madroñal,158,92,66
37,Salamanca,177,"Maíllo, El",327,178,149
37,Salamanca,178,Malpartida,108,62,46
37,Salamanca,179,Mancera de Abajo,241,120,121
37,Salamanca,180,"Manzano, El",71,37,34
37,Salamanca,181,Martiago,316,169,147
37,Salamanca,183,Martín de Yeltes,461,240,221
37,Salamanca,182,Martinamor,115,70,45
37,Salamanca,184,Masueco,390,194,196
37,Salamanca,186,"Mata de Ledesma, La",112,57,55
37,Salamanca,187,Matilla de los Caños del Río,656,334,322
37,Salamanca,188,"Maya, La",214,124,90
37,Salamanca,189,Membribe de la Sierra,151,89,62
37,Salamanca,190,Mieza,248,124,124
37,Salamanca,191,"Milano, El",133,76,57
37,Salamanca,192,Miranda de Azán,437,230,207
37,Salamanca,193,Miranda del Castañar,495,259,236
37,Salamanca,194,Mogarraz,314,158,156
37,Salamanca,195,Molinillo,54,29,25
37,Salamanca,196,Monforte de la Sierra,97,53,44
37,Salamanca,197,Monleón,107,61,46
37,Salamanca,198,Monleras,256,123,133
37,Salamanca,199,Monsagro,162,89,73
37,Salamanca,200,Montejo,235,129,106
37,Salamanca,201,Montemayor del Río,311,160,151
37,Salamanca,202,Monterrubio de Armuña,1299,697,602
37,Salamanca,203,Monterrubio de la Sierra,185,103,82
37,Salamanca,204,Morasverdes,310,158,152
37,Salamanca,205,Morille,263,138,125
37,Salamanca,206,Moríñigo,117,60,57
37,Salamanca,207,Moriscos,306,170,136
37,Salamanca,208,Moronta,94,54,40
37,Salamanca,209,Mozárbez,502,270,232
37,Salamanca,211,Narros de Matalayegua,238,129,109
37,Salamanca,213,Nava de Béjar,110,60,50
37,Salamanca,214,Nava de Francia,142,75,67
37,Salamanca,215,Nava de Sotrobal,180,99,81
37,Salamanca,212,Navacarros,136,74,62
37,Salamanca,216,Navales,337,183,154
37,Salamanca,217,Navalmoral de Béjar,58,25,33
37,Salamanca,218,Navamorales,82,50,32
37,Salamanca,219,Navarredonda de la Rinconada,203,106,97
37,Salamanca,221,Navasfrías,508,259,249
37,Salamanca,222,Negrilla de Palencia,129,67,62
37,Salamanca,223,Olmedo de Camaces,134,73,61
37,Salamanca,224,"Orbada, La",226,114,112
37,Salamanca,225,Pajares de la Laguna,132,70,62
37,Salamanca,226,Palacios del Arzobispo,178,89,89
37,Salamanca,228,Palaciosrubios,422,224,198
37,Salamanca,229,Palencia de Negrilla,162,94,68
37,Salamanca,230,Parada de Arriba,264,137,127
37,Salamanca,231,Parada de Rubiales,309,160,149
37,Salamanca,232,Paradinas de San Juan,452,252,200
37,Salamanca,233,Pastores,59,32,27
37,Salamanca,234,"Payo, El",394,198,196
37,Salamanca,235,Pedraza de Alba,254,131,123
37,Salamanca,236,Pedrosillo de Alba,160,86,74
37,Salamanca,237,Pedrosillo de los Aires,392,214,178
37,Salamanca,238,Pedrosillo el Ralo,136,71,65
37,Salamanca,239,"Pedroso de la Armuña, El",253,124,129
37,Salamanca,240,Pelabravo,1064,557,507
37,Salamanca,241,Pelarrodríguez,182,108,74
37,Salamanca,242,Pelayos,119,66,53
37,Salamanca,243,"Peña, La",123,58,65
37,Salamanca,244,Peñacaballera,168,77,91
37,Salamanca,245,Peñaparda,392,200,192
37,Salamanca,246,Peñaranda de Bracamonte,6800,3377,3423
37,Salamanca,247,Peñarandilla,232,126,106
37,Salamanca,248,Peralejos de Abajo,169,89,80
37,Salamanca,249,Peralejos de Arriba,49,28,21
37,Salamanca,250,Pereña de la Ribera,434,223,211
37,Salamanca,251,Peromingo,147,68,79
37,Salamanca,252,Pinedas,128,73,55
37,Salamanca,253,"Pino de Tormes, El",159,83,76
37,Salamanca,254,Pitiegua,211,119,92
37,Salamanca,255,Pizarral,68,34,34
37,Salamanca,256,Poveda de las Cintas,255,143,112
37,Salamanca,257,Pozos de Hinojo,55,30,25
37,Salamanca,258,Puebla de Azaba,231,123,108
37,Salamanca,259,Puebla de San Medel,47,25,22
37,Salamanca,260,Puebla de Yeltes,175,95,80
37,Salamanca,261,Puente del Congosto,253,143,110
37,Salamanca,262,Puertas,81,43,38
37,Salamanca,263,Puerto de Béjar,396,199,197
37,Salamanca,264,Puerto Seguro,75,41,34
37,Salamanca,265,Rágama,250,125,125
37,Salamanca,266,"Redonda, La",88,48,40
37,Salamanca,267,Retortillo,244,124,120
37,Salamanca,268,"Rinconada de la Sierra, La",121,67,54
37,Salamanca,269,Robleda,531,277,254
37,Salamanca,270,Robliza de Cojos,244,126,118
37,Salamanca,271,Rollán,438,231,207
37,Salamanca,272,Saelices el Chico,170,90,80
37,Salamanca,273,"Sagrada, La",125,63,62
37,Salamanca,303,"Sahugo, El",219,111,108
37,Salamanca,274,Salamanca,152048,70035,82013
37,Salamanca,275,Saldeana,137,76,61
37,Salamanca,276,Salmoral,190,108,82
37,Salamanca,277,Salvatierra de Tormes,65,32,33
37,Salamanca,278,San Cristóbal de la Cuesta,985,524,461
37,Salamanca,284,San Esteban de la Sierra,359,190,169
37,Salamanca,285,San Felices de los Gallegos,484,246,238
37,Salamanca,286,San Martín del Castañar,254,131,123
37,Salamanca,287,San Miguel de Valero,379,181,198
37,Salamanca,36,San Miguel del Robledo,73,33,40
37,Salamanca,288,San Morales,294,167,127
37,Salamanca,289,San Muñoz,280,145,135
37,Salamanca,291,San Pedro de Rozados,312,163,149
37,Salamanca,290,San Pedro del Valle,147,79,68
37,Salamanca,292,San Pelayo de Guareña,94,52,42
37,Salamanca,280,Sanchón de la Ribera,88,50,38
37,Salamanca,281,Sanchón de la Sagrada,38,21,17
37,Salamanca,282,Sanchotello,233,126,107
37,Salamanca,279,Sancti-Spíritus,856,452,404
37,Salamanca,283,Sando,145,82,63
37,Salamanca,293,Santa María de Sando,130,67,63
37,Salamanca,294,Santa Marta de Tormes,14920,7412,7508
37,Salamanca,296,Santiago de la Puebla,401,208,193
37,Salamanca,297,Santibáñez de Béjar,523,266,257
37,Salamanca,298,Santibáñez de la Sierra,211,110,101
37,Salamanca,299,Santiz,256,130,126
37,Salamanca,300,"Santos, Los",680,356,324
37,Salamanca,301,Sardón de los Frailes,84,46,38
37,Salamanca,302,Saucelle,383,194,189
37,Salamanca,304,Sepulcro-Hilario,197,112,85
37,Salamanca,305,Sequeros,230,113,117
37,Salamanca,306,Serradilla del Arroyo,323,171,152
37,Salamanca,307,Serradilla del Llano,182,87,95
37,Salamanca,309,"Sierpe, La",46,28,18
37,Salamanca,310,Sieteiglesias de Tormes,175,86,89
37,Salamanca,311,Sobradillo,266,135,131
37,Salamanca,312,Sorihuela,312,155,157
37,Salamanca,313,Sotoserrano,652,341,311
37,Salamanca,314,Tabera de Abajo,99,57,42
37,Salamanca,315,"Tala, La",100,54,46
37,Salamanca,316,Tamames,918,476,442
37,Salamanca,317,Tarazona de Guareña,354,193,161
37,Salamanca,318,Tardáguila,244,138,106
37,Salamanca,319,"Tejado, El",138,73,65
37,Salamanca,320,Tejeda y Segoyuela,103,58,45
37,Salamanca,321,Tenebrón,174,83,91
37,Salamanca,322,Terradillos,3371,1750,1621
37,Salamanca,323,Topas,610,325,285
37,Salamanca,324,Tordillos,432,230,202
37,Salamanca,325,"Tornadizo, El",111,60,51
37,Salamanca,327,Torresmenudas,208,102,106
37,Salamanca,328,Trabanca,236,116,120
37,Salamanca,329,Tremedal de Tormes,43,21,22
37,Salamanca,330,Valdecarros,384,198,186
37,Salamanca,331,Valdefuentes de Sangusín,250,131,119
37,Salamanca,332,Valdehijaderos,87,49,38
37,Salamanca,333,Valdelacasa,262,148,114
37,Salamanca,334,Valdelageve,90,44,46
37,Salamanca,335,Valdelosa,487,240,247
37,Salamanca,336,Valdemierque,60,37,23
37,Salamanca,337,Valderrodrigo,157,77,80
37,Salamanca,338,Valdunciel,101,51,50
37,Salamanca,339,Valero,341,183,158
37,Salamanca,343,Vallejera de Riofrío,69,33,36
37,Salamanca,340,Valsalabroso,160,93,67
37,Salamanca,341,Valverde de Valdelacasa,78,44,34
37,Salamanca,342,Valverdón,288,149,139
37,Salamanca,344,Vecinos,293,147,146
37,Salamanca,345,Vega de Tirados,200,99,101
37,Salamanca,346,"Veguillas, Las",288,132,156
37,Salamanca,347,"Vellés, La",580,316,264
37,Salamanca,348,Ventosa del Río Almar,123,67,56
37,Salamanca,349,"Vídola, La",141,68,73
37,Salamanca,351,Villaflores,312,160,152
37,Salamanca,352,Villagonzalo de Tormes,224,127,97
37,Salamanca,353,Villalba de los Llanos,150,87,63
37,Salamanca,354,Villamayor,6683,3378,3305
37,Salamanca,355,Villanueva del Conde,175,93,82
37,Salamanca,356,Villar de Argañán,101,54,47
37,Salamanca,357,Villar de Ciervo,297,159,138
37,Salamanca,358,Villar de Gallimazo,173,95,78
37,Salamanca,359,Villar de la Yegua,208,109,99
37,Salamanca,360,Villar de Peralonso,272,132,140
37,Salamanca,361,Villar de Samaniego,97,54,43
37,Salamanca,362,Villares de la Reina,6033,3025,3008
37,Salamanca,363,Villares de Yeltes,132,63,69
37,Salamanca,364,Villarino de los Aires,938,487,451
37,Salamanca,365,Villarmayor,215,116,99
37,Salamanca,366,Villarmuerto,44,27,17
37,Salamanca,367,Villasbuenas,226,121,105
37,Salamanca,368,Villasdardo,20,9,11
37,Salamanca,369,Villaseco de los Gamitos,173,97,76
37,Salamanca,370,Villaseco de los Reyes,401,221,180
37,Salamanca,371,Villasrubias,227,125,102
37,Salamanca,372,Villaverde de Guareña,158,89,69
37,Salamanca,373,Villavieja de Yeltes,899,460,439
37,Salamanca,374,Villoria,1481,753,728
37,Salamanca,375,Villoruela,885,458,427
37,Salamanca,350,Vilvestre,478,232,246
37,Salamanca,376,Vitigudino,2866,1426,1440
37,Salamanca,377,Yecla de Yeltes,285,146,139
37,Salamanca,378,Zamarra,113,63,50
37,Salamanca,379,Zamayón,189,105,84
37,Salamanca,380,Zarapicos,54,28,26
37,Salamanca,381,"Zarza de Pumareda, La",159,88,71
37,Salamanca,382,Zorita de la Frontera,210,111,99
38,Santa Cruz de Tenerife,1,Adeje,46894,24065,22829
38,Santa Cruz de Tenerife,2,Agulo,1164,592,572
38,Santa Cruz de Tenerife,3,Alajeró,2039,1086,953
38,Santa Cruz de Tenerife,4,Arafo,5507,2719,2788
38,Santa Cruz de Tenerife,5,Arico,8090,4154,3936
38,Santa Cruz de Tenerife,6,Arona,77718,40061,37657
38,Santa Cruz de Tenerife,7,Barlovento,2085,1056,1029
38,Santa Cruz de Tenerife,8,Breña Alta,7298,3593,3705
38,Santa Cruz de Tenerife,9,Breña Baja,5492,2781,2711
38,Santa Cruz de Tenerife,10,Buenavista del Norte,4916,2533,2383
38,Santa Cruz de Tenerife,11,Candelaria,26290,12908,13382
38,Santa Cruz de Tenerife,12,Fasnia,2963,1527,1436
38,Santa Cruz de Tenerife,13,Frontera,4104,2091,2013
38,Santa Cruz de Tenerife,14,Fuencaliente de la Palma,1840,936,904
38,Santa Cruz de Tenerife,15,Garachico,5090,2526,2564
38,Santa Cruz de Tenerife,16,Garafía,1654,843,811
38,Santa Cruz de Tenerife,17,Granadilla de Abona,42545,21634,20911
38,Santa Cruz de Tenerife,18,"Guancha, La",5441,2674,2767
38,Santa Cruz de Tenerife,19,Guía de Isora,20387,10235,10152
38,Santa Cruz de Tenerife,20,Güímar,18445,9125,9320
38,Santa Cruz de Tenerife,21,Hermigua,2116,1073,1043
38,Santa Cruz de Tenerife,22,Icod de los Vinos,23726,11784,11942
38,Santa Cruz de Tenerife,24,"Llanos de Aridane, Los",20895,10227,10668
38,Santa Cruz de Tenerife,25,"Matanza de Acentejo, La",8806,4495,4311
38,Santa Cruz de Tenerife,26,"Orotava, La",41726,20564,21162
38,Santa Cruz de Tenerife,27,"Paso, El",7874,3937,3937
38,Santa Cruz de Tenerife,901,"Pinar de El Hierro, El",1854,952,902
38,Santa Cruz de Tenerife,28,Puerto de la Cruz,32665,15958,16707
38,Santa Cruz de Tenerife,29,Puntagorda,1940,984,956
38,Santa Cruz de Tenerife,30,Puntallana,2428,1218,1210
38,Santa Cruz de Tenerife,31,"Realejos, Los",38028,18803,19225
38,Santa Cruz de Tenerife,32,"Rosario, El",17330,8872,8458
38,Santa Cruz de Tenerife,33,San Andrés y Sauces,4637,2334,2303
38,Santa Cruz de Tenerife,23,San Cristóbal de La Laguna,153224,74781,78443
38,Santa Cruz de Tenerife,34,San Juan de la Rambla,5103,2538,2565
38,Santa Cruz de Tenerife,35,San Miguel de Abona,17555,8928,8627
38,Santa Cruz de Tenerife,36,San Sebastián de la Gomera,9055,4578,4477
38,Santa Cruz de Tenerife,37,Santa Cruz de la Palma,16705,8130,8575
38,Santa Cruz de Tenerife,38,Santa Cruz de Tenerife,206965,99040,107925
38,Santa Cruz de Tenerife,39,Santa Úrsula,14374,7205,7169
38,Santa Cruz de Tenerife,40,Santiago del Teide,12392,6195,6197
38,Santa Cruz de Tenerife,41,"Sauzal, El",9037,4479,4558
38,Santa Cruz de Tenerife,42,"Silos, Los",5119,2572,2547
38,Santa Cruz de Tenerife,43,Tacoronte,23718,11908,11810
38,Santa Cruz de Tenerife,44,"Tanque, El",2848,1400,1448
38,Santa Cruz de Tenerife,45,Tazacorte,4957,2528,2429
38,Santa Cruz de Tenerife,46,Tegueste,10904,5392,5512
38,Santa Cruz de Tenerife,47,Tijarafe,2765,1400,1365
38,Santa Cruz de Tenerife,49,Valle Gran Rey,4860,2445,2415
38,Santa Cruz de Tenerife,50,Vallehermoso,3116,1608,1508
38,Santa Cruz de Tenerife,48,Valverde,5075,2601,2474
38,Santa Cruz de Tenerife,51,"Victoria de Acentejo, La",9049,4550,4499
38,Santa Cruz de Tenerife,52,Vilaflor,1825,947,878
38,Santa Cruz de Tenerife,53,Villa de Mazo,4898,2490,2408
40,Segovia,1,Abades,882,447,435
40,Segovia,2,Adrada de Pirón,45,22,23
40,Segovia,3,Adrados,170,93,77
40,Segovia,4,Aguilafuente,679,331,348
40,Segovia,5,Alconada de Maderuelo,34,21,13
40,Segovia,12,Aldea Real,343,184,159
40,Segovia,6,Aldealcorvo,28,19,9
40,Segovia,7,Aldealengua de Pedraza,97,57,40
40,Segovia,8,Aldealengua de Santa María,76,37,39
40,Segovia,9,Aldeanueva de la Serrezuela,52,34,18
40,Segovia,10,Aldeanueva del Codonal,146,77,69
40,Segovia,13,Aldeasoña,67,40,27
40,Segovia,14,Aldehorno,57,30,27
40,Segovia,15,Aldehuela del Codonal,32,16,16
40,Segovia,16,Aldeonte,63,29,34
40,Segovia,17,Anaya,136,63,73
40,Segovia,18,Añe,107,61,46
40,Segovia,19,Arahuetes,43,27,16
40,Segovia,20,Arcones,243,120,123
40,Segovia,21,Arevalillo de Cega,36,19,17
40,Segovia,22,Armuña,242,136,106
40,Segovia,24,Ayllón,1398,746,652
40,Segovia,25,Barbolla,214,122,92
40,Segovia,26,Basardilla,171,80,91
40,Segovia,28,Bercial,121,64,57
40,Segovia,29,Bercimuel,46,25,21
40,Segovia,30,Bernardos,603,320,283
40,Segovia,31,Bernuy de Porreros,697,377,320
40,Segovia,32,Boceguillas,805,403,402
40,Segovia,33,Brieva,81,54,27
40,Segovia,34,Caballar,102,51,51
40,Segovia,35,Cabañas de Polendos,181,98,83
40,Segovia,36,Cabezuela,701,361,340
40,Segovia,37,Calabazas de Fuentidueña,38,21,17
40,Segovia,39,Campo de San Pedro,345,198,147
40,Segovia,40,Cantalejo,4007,2037,1970
40,Segovia,41,Cantimpalos,1401,719,682
40,Segovia,43,Carbonero el Mayor,2600,1332,1268
40,Segovia,44,Carrascal del Río,174,93,81
40,Segovia,45,Casla,171,88,83
40,Segovia,46,Castillejo de Mesleón,144,86,58
40,Segovia,47,Castro de Fuentidueña,51,28,23
40,Segovia,48,Castrojimeno,37,20,17
40,Segovia,49,Castroserna de Abajo,59,25,34
40,Segovia,51,Castroserracín,55,31,24
40,Segovia,52,Cedillo de la Torre,122,58,64
40,Segovia,53,Cerezo de Abajo,153,83,70
40,Segovia,54,Cerezo de Arriba,190,101,89
40,Segovia,65,Chañe,946,443,503
40,Segovia,55,Cilleruelo de San Mamés,42,24,18
40,Segovia,56,Cobos de Fuentidueña,37,17,20
40,Segovia,57,Coca,2063,1017,1046
40,Segovia,58,Codorniz,384,197,187
40,Segovia,59,Collado Hermoso,157,77,80
40,Segovia,60,Condado de Castilnovo,97,54,43
40,Segovia,61,Corral de Ayllón,91,57,34
40,Segovia,902,Cozuelos de Fuentidueña,152,87,65
40,Segovia,62,Cubillo,69,39,30
40,Segovia,63,Cuéllar,9726,4898,4828
40,Segovia,905,Cuevas de Provanco,151,80,71
40,Segovia,68,Domingo García,41,23,18
40,Segovia,69,Donhierro,116,62,54
40,Segovia,70,Duruelo,176,104,72
40,Segovia,71,Encinas,56,32,24
40,Segovia,72,Encinillas,232,133,99
40,Segovia,73,Escalona del Prado,586,304,282
40,Segovia,74,Escarabajosa de Cabezas,336,185,151
40,Segovia,75,Escobar de Polendos,207,106,101
40,Segovia,76,"Espinar, El",9711,4984,4727
40,Segovia,77,Espirdo,1051,562,489
40,Segovia,78,Fresneda de Cuéllar,194,105,89
40,Segovia,79,Fresno de Cantespino,261,147,114
40,Segovia,80,Fresno de la Fuente,108,58,50
40,Segovia,81,Frumales,155,78,77
40,Segovia,82,Fuente de Santa Cruz,137,68,69
40,Segovia,83,Fuente el Olmo de Fuentidueña,200,67,133
40,Segovia,84,Fuente el Olmo de Íscar,79,45,34
40,Segovia,86,Fuentepelayo,984,502,482
40,Segovia,87,Fuentepiñel,117,61,56
40,Segovia,88,Fuenterrebollo,370,194,176
40,Segovia,89,Fuentesaúco de Fuentidueña,278,153,125
40,Segovia,91,Fuentesoto,145,76,69
40,Segovia,92,Fuentidueña,109,54,55
40,Segovia,93,Gallegos,94,51,43
40,Segovia,94,Garcillán,488,263,225
40,Segovia,95,Gomezserracín,721,369,352
40,Segovia,97,Grajera,256,139,117
40,Segovia,99,Honrubia de la Cuesta,69,40,29
40,Segovia,100,Hontalbilla,339,183,156
40,Segovia,101,Hontanares de Eresma,1133,591,542
40,Segovia,103,"Huertos, Los",168,98,70
40,Segovia,104,Ituero y Lama,362,190,172
40,Segovia,105,Juarros de Riomoros,68,40,28
40,Segovia,106,Juarros de Voltoya,250,121,129
40,Segovia,107,Labajos,147,80,67
40,Segovia,108,Laguna de Contreras,119,70,49
40,Segovia,109,Languilla,95,53,42
40,Segovia,110,Lastras de Cuéllar,447,220,227
40,Segovia,111,Lastras del Pozo,87,42,45
40,Segovia,112,"Lastrilla, La",3492,1799,1693
40,Segovia,113,"Losa, La",530,283,247
40,Segovia,115,Maderuelo,136,77,59
40,Segovia,903,Marazoleja,123,74,49
40,Segovia,118,Marazuela,60,33,27
40,Segovia,119,Martín Miguel,252,146,106
40,Segovia,120,Martín Muñoz de la Dehesa,209,112,97
40,Segovia,121,Martín Muñoz de las Posadas,377,192,185
40,Segovia,122,Marugán,666,368,298
40,Segovia,124,Mata de Cuéllar,291,155,136
40,Segovia,123,Matabuena,236,130,106
40,Segovia,125,"Matilla, La",101,56,45
40,Segovia,126,Melque de Cercos,97,50,47
40,Segovia,127,Membibre de la Hoz,43,22,21
40,Segovia,128,Migueláñez,177,87,90
40,Segovia,129,Montejo de Arévalo,215,117,98
40,Segovia,130,Montejo de la Vega de la Serrezuela,154,89,65
40,Segovia,131,Monterrubio,66,36,30
40,Segovia,132,Moral de Hornuez,82,47,35
40,Segovia,134,Mozoncillo,1064,573,491
40,Segovia,135,Muñopedro,340,175,165
40,Segovia,136,Muñoveros,191,93,98
40,Segovia,138,Nava de la Asunción,3014,1527,1487
40,Segovia,139,Navafría,342,183,159
40,Segovia,140,Navalilla,116,60,56
40,Segovia,141,Navalmanzano,1186,616,570
40,Segovia,142,Navares de Ayuso,53,27,26
40,Segovia,143,Navares de Enmedio,108,64,44
40,Segovia,144,Navares de las Cuevas,23,15,8
40,Segovia,145,Navas de Oro,1451,748,703
40,Segovia,904,Navas de Riofrío,423,205,218
40,Segovia,146,Navas de San Antonio,430,230,200
40,Segovia,148,Nieva,344,187,157
40,Segovia,149,Olombrada,681,372,309
40,Segovia,150,Orejana,71,41,30
40,Segovia,151,Ortigosa de Pestaño,100,52,48
40,Segovia,901,Ortigosa del Monte,560,296,264
40,Segovia,152,Otero de Herreros,997,511,486
40,Segovia,154,Pajarejos,23,14,9
40,Segovia,155,Palazuelos de Eresma,4561,2387,2174
40,Segovia,156,Pedraza,461,259,202
40,Segovia,157,Pelayos del Arroyo,70,39,31
40,Segovia,158,Perosillo,21,16,5
40,Segovia,159,Pinarejos,161,95,66
40,Segovia,160,Pinarnegrillo,130,71,59
40,Segovia,161,Pradales,56,29,27
40,Segovia,162,Prádena,605,323,282
40,Segovia,163,Puebla de Pedraza,58,31,27
40,Segovia,164,Rapariegos,224,115,109
40,Segovia,181,Real Sitio de San Ildefonso,5626,2796,2830
40,Segovia,165,Rebollo,102,57,45
40,Segovia,166,Remondo,325,163,162
40,Segovia,168,Riaguas de San Bartolomé,36,19,17
40,Segovia,170,Riaza,2489,1356,1133
40,Segovia,171,Ribota,43,32,11
40,Segovia,172,Riofrío de Riaza,37,24,13
40,Segovia,173,Roda de Eresma,216,118,98
40,Segovia,174,Sacramenia,471,248,223
40,Segovia,176,Samboal,502,272,230
40,Segovia,177,San Cristóbal de Cuéllar,187,101,86
40,Segovia,178,San Cristóbal de la Vega,127,62,65
40,Segovia,906,San Cristóbal de Segovia,2928,1505,1423
40,Segovia,182,San Martín y Mudrián,283,138,145
40,Segovia,183,San Miguel de Bernuy,168,84,84
40,Segovia,184,San Pedro de Gaíllos,317,170,147
40,Segovia,179,Sanchonuño,968,470,498
40,Segovia,180,Sangarcía,398,210,188
40,Segovia,185,Santa María la Real de Nieva,1094,579,515
40,Segovia,186,Santa Marta del Cerro,46,22,24
40,Segovia,188,Santiuste de Pedraza,122,73,49
40,Segovia,189,Santiuste de San Juan Bautista,636,339,297
40,Segovia,190,Santo Domingo de Pirón,58,30,28
40,Segovia,191,Santo Tomé del Puerto,325,176,149
40,Segovia,192,Sauquillo de Cabezas,208,113,95
40,Segovia,193,Sebúlcor,275,143,132
40,Segovia,194,Segovia,54844,26317,28527
40,Segovia,195,Sepúlveda,1232,624,608
40,Segovia,196,Sequera de Fresno,52,28,24
40,Segovia,198,Sotillo,34,19,15
40,Segovia,199,Sotosalbos,136,70,66
40,Segovia,200,Tabanera la Luenga,75,36,39
40,Segovia,201,Tolocirio,55,25,30
40,Segovia,206,Torre Val de San Pedro,203,105,98
40,Segovia,202,Torreadrada,88,39,49
40,Segovia,203,Torrecaballeros,1277,645,632
40,Segovia,204,Torrecilla del Pinar,219,116,103
40,Segovia,205,Torreiglesias,366,181,185
40,Segovia,207,Trescasas,968,488,480
40,Segovia,208,Turégano,1098,544,554
40,Segovia,210,Urueñas,112,66,46
40,Segovia,211,Valdeprados,87,46,41
40,Segovia,212,Valdevacas de Montejo,32,15,17
40,Segovia,213,Valdevacas y Guijar,117,58,59
40,Segovia,218,Valle de Tabladillo,112,65,47
40,Segovia,219,Vallelado,773,412,361
40,Segovia,220,Valleruela de Pedraza,84,42,42
40,Segovia,221,Valleruela de Sepúlveda,60,28,32
40,Segovia,214,Valseca,297,157,140
40,Segovia,215,Valtiendas,130,77,53
40,Segovia,216,Valverde del Majano,1083,540,543
40,Segovia,222,Veganzones,282,156,126
40,Segovia,223,Vegas de Matute,293,177,116
40,Segovia,224,Ventosilla y Tejadilla,30,20,10
40,Segovia,225,Villacastín,1637,840,797
40,Segovia,228,Villaverde de Íscar,685,359,326
40,Segovia,229,Villaverde de Montejo,43,25,18
40,Segovia,230,Villeguillo,154,95,59
40,Segovia,231,Yanguas de Eresma,159,78,81
40,Segovia,233,Zarzuela del Monte,583,296,287
40,Segovia,234,Zarzuela del Pinar,491,252,239
41,Sevilla,1,Aguadulce,2165,1075,1090
41,Sevilla,2,Alanís,1858,923,935
41,Sevilla,3,Albaida del Aljarafe,2987,1505,1482
41,Sevilla,4,Alcalá de Guadaíra,73675,36680,36995
41,Sevilla,5,Alcalá del Río,11513,5831,5682
41,Sevilla,6,Alcolea del Río,3424,1694,1730
41,Sevilla,7,"Algaba, La",15754,7808,7946
41,Sevilla,8,Algámitas,1326,693,633
41,Sevilla,9,Almadén de la Plata,1553,786,767
41,Sevilla,10,Almensilla,5776,2901,2875
41,Sevilla,11,Arahal,19513,9659,9854
41,Sevilla,12,Aznalcázar,4260,2162,2098
41,Sevilla,13,Aznalcóllar,6192,3147,3045
41,Sevilla,14,Badolatosa,3214,1661,1553
41,Sevilla,15,Benacazón,6985,3542,3443
41,Sevilla,16,Bollullos de la Mitación,9756,4886,4870
41,Sevilla,17,Bormujos,20345,10125,10220
41,Sevilla,18,Brenes,12837,6431,6406
41,Sevilla,19,Burguillos,6459,3246,3213
41,Sevilla,20,"Cabezas de San Juan, Las",16562,8394,8168
41,Sevilla,21,Camas,26485,12939,13546
41,Sevilla,22,"Campana, La",5514,2768,2746
41,Sevilla,23,Cantillana,10921,5623,5298
41,Sevilla,901,Cañada Rosal,3272,1637,1635
41,Sevilla,24,Carmona,28814,14540,14274
41,Sevilla,25,Carrión de los Céspedes,2559,1227,1332
41,Sevilla,26,Casariche,5652,2889,2763
41,Sevilla,27,Castilblanco de los Arroyos,5084,2566,2518
41,Sevilla,28,Castilleja de Guzmán,2829,1447,1382
41,Sevilla,29,Castilleja de la Cuesta,17505,8498,9007
41,Sevilla,30,Castilleja del Campo,642,317,325
41,Sevilla,31,"Castillo de las Guardas, El",1575,807,768
41,Sevilla,32,Cazalla de la Sierra,5083,2512,2571
41,Sevilla,33,Constantina,6395,3171,3224
41,Sevilla,34,Coria del Río,29921,15042,14879
41,Sevilla,35,Coripe,1398,705,693
41,Sevilla,36,"Coronil, El",5022,2524,2498
41,Sevilla,37,"Corrales, Los",4090,2096,1994
41,Sevilla,903,"Cuervo de Sevilla, El",8677,4428,4249
41,Sevilla,38,Dos Hermanas,128794,63602,65192
41,Sevilla,39,Écija,40683,20071,20612
41,Sevilla,40,Espartinas,14217,7159,7058
41,Sevilla,41,Estepa,12671,6303,6368
41,Sevilla,42,Fuentes de Andalucía,7315,3638,3677
41,Sevilla,43,"Garrobo, El",777,399,378
41,Sevilla,44,Gelves,9506,4716,4790
41,Sevilla,45,Gerena,7187,3620,3567
41,Sevilla,46,Gilena,3919,1966,1953
41,Sevilla,47,Gines,13302,6578,6724
41,Sevilla,48,Guadalcanal,2897,1431,1466
41,Sevilla,49,Guillena,12139,6125,6014
41,Sevilla,50,Herrera,6526,3234,3292
41,Sevilla,51,Huévar del Aljarafe,2723,1403,1320
41,Sevilla,902,Isla Mayor,5948,2991,2957
41,Sevilla,52,"Lantejuela, La",3938,2011,1927
41,Sevilla,53,Lebrija,27267,13688,13579
41,Sevilla,54,Lora de Estepa,871,442,429
41,Sevilla,55,Lora del Río,19421,9648,9773
41,Sevilla,56,"Luisiana, La",4652,2355,2297
41,Sevilla,57,"Madroño, El",324,162,162
41,Sevilla,58,Mairena del Alcor,22024,11011,11013
41,Sevilla,59,Mairena del Aljarafe,42784,20982,21802
41,Sevilla,60,Marchena,19984,9983,10001
41,Sevilla,61,Marinaleda,2786,1404,1382
41,Sevilla,62,Martín de la Jara,2812,1442,1370
41,Sevilla,63,"Molares, Los",3459,1796,1663
41,Sevilla,64,Montellano,7162,3575,3587
41,Sevilla,65,Morón de la Frontera,28390,14085,14305
41,Sevilla,66,"Navas de la Concepción, Las",1721,841,880
41,Sevilla,67,Olivares,9587,4798,4789
41,Sevilla,68,Osuna,17973,8879,9094
41,Sevilla,69,"Palacios y Villafranca, Los",37741,19039,18702
41,Sevilla,70,Palomares del Río,7709,3874,3835
41,Sevilla,71,Paradas,7085,3551,3534
41,Sevilla,72,Pedrera,5374,2667,2707
41,Sevilla,73,"Pedroso, El",2194,1093,1101
41,Sevilla,74,Peñaflor,3788,1904,1884
41,Sevilla,75,Pilas,13837,7012,6825
41,Sevilla,76,Pruna,2836,1463,1373
41,Sevilla,77,"Puebla de Cazalla, La",11556,5769,5787
41,Sevilla,78,"Puebla de los Infantes, La",3159,1567,1592
41,Sevilla,79,"Puebla del Río, La",12249,6077,6172
41,Sevilla,80,"Real de la Jara, El",1626,798,828
41,Sevilla,81,"Rinconada, La",37508,18700,18808
41,Sevilla,82,"Roda de Andalucía, La",4381,2186,2195
41,Sevilla,83,"Ronquillo, El",1430,746,684
41,Sevilla,84,"Rubio, El",3573,1767,1806
41,Sevilla,85,Salteras,5368,2608,2760
41,Sevilla,86,San Juan de Aznalfarache,21663,10452,11211
41,Sevilla,88,San Nicolás del Puerto,634,328,306
41,Sevilla,87,Sanlúcar la Mayor,13275,6586,6689
41,Sevilla,89,Santiponce,8397,4202,4195
41,Sevilla,90,"Saucejo, El",4484,2246,2238
41,Sevilla,91,Sevilla,702355,333981,368374
41,Sevilla,92,Tocina,9593,4753,4840
41,Sevilla,93,Tomares,23921,11839,12082
41,Sevilla,94,Umbrete,8390,4225,4165
41,Sevilla,95,Utrera,51887,25938,25949
41,Sevilla,96,Valencina de la Concepción,8055,4012,4043
41,Sevilla,97,Villamanrique de la Condesa,4266,2101,2165
41,Sevilla,100,Villanueva de San Juan,1323,643,680
41,Sevilla,98,Villanueva del Ariscal,6159,3022,3137
41,Sevilla,99,Villanueva del Río y Minas,5203,2601,2602
41,Sevilla,101,Villaverde del Río,7614,3882,3732
41,Sevilla,102,"Viso del Alcor, El",18990,9558,9432
42,Soria,1,Abejar,367,205,162
42,Soria,3,Adradas,70,38,32
42,Soria,4,Ágreda,3177,1608,1569
42,Soria,6,Alconaba,190,113,77
42,Soria,7,Alcubilla de Avellaneda,161,84,77
42,Soria,8,Alcubilla de las Peñas,72,43,29
42,Soria,9,Aldealafuente,98,56,42
42,Soria,10,Aldealices,25,15,10
42,Soria,11,Aldealpozo,27,14,13
42,Soria,12,Aldealseñor,43,24,19
42,Soria,13,Aldehuela de Periáñez,50,25,25
42,Soria,14,"Aldehuelas, Las",84,41,43
42,Soria,15,Alentisque,34,20,14
42,Soria,16,Aliud,26,14,12
42,Soria,17,Almajano,222,117,105
42,Soria,18,Almaluez,181,103,78
42,Soria,19,Almarza,645,371,274
42,Soria,20,Almazán,5861,2992,2869
42,Soria,21,Almazul,97,55,42
42,Soria,22,Almenar de Soria,265,154,111
42,Soria,23,Alpanseque,82,45,37
42,Soria,24,Arancón,95,62,33
42,Soria,25,Arcos de Jalón,1839,989,850
42,Soria,26,Arenillas,30,17,13
42,Soria,27,Arévalo de la Sierra,89,58,31
42,Soria,28,Ausejo de la Sierra,69,39,30
42,Soria,29,Baraona,183,101,82
42,Soria,30,Barca,120,68,52
42,Soria,31,Barcones,31,17,14
42,Soria,32,Bayubas de Abajo,192,98,94
42,Soria,33,Bayubas de Arriba,54,30,24
42,Soria,34,Beratón,39,23,16
42,Soria,35,Berlanga de Duero,981,490,491
42,Soria,36,Blacos,53,31,22
42,Soria,37,Bliecos,42,25,17
42,Soria,38,Borjabad,40,23,17
42,Soria,39,Borobia,286,152,134
42,Soria,41,Buberos,36,19,17
42,Soria,42,Buitrago,60,31,29
42,Soria,43,Burgo de Osma-Ciudad de Osma,5228,2615,2613
42,Soria,44,Cabrejas del Campo,64,36,28
42,Soria,45,Cabrejas del Pinar,414,235,179
42,Soria,46,Calatañazor,66,38,28
42,Soria,48,Caltojar,77,45,32
42,Soria,49,Candilichera,136,78,58
42,Soria,50,Cañamaque,33,23,10
42,Soria,51,Carabantes,23,11,12
42,Soria,52,Caracena,18,12,6
42,Soria,53,Carrascosa de Abajo,28,17,11
42,Soria,54,Carrascosa de la Sierra,22,15,7
42,Soria,55,Casarejos,203,104,99
42,Soria,56,Castilfrío de la Sierra,29,20,9
42,Soria,58,Castillejo de Robledo,136,75,61
42,Soria,57,Castilruiz,212,114,98
42,Soria,59,Centenera de Andaluz,25,9,16
42,Soria,60,Cerbón,40,26,14
42,Soria,61,Cidones,347,197,150
42,Soria,62,Cigudosa,34,22,12
42,Soria,63,Cihuela,67,36,31
42,Soria,64,Ciria,99,53,46
42,Soria,65,Cirujales del Río,28,16,12
42,Soria,68,Coscurita,103,61,42
42,Soria,69,Covaleda,1850,957,893
42,Soria,70,Cubilla,45,26,19
42,Soria,71,Cubo de la Solana,182,99,83
42,Soria,73,Cueva de Ágreda,87,53,34
42,Soria,75,Dévanos,96,53,43
42,Soria,76,Deza,262,133,129
42,Soria,78,Duruelo de la Sierra,1297,666,631
42,Soria,79,Escobosa de Almazán,29,19,10
42,Soria,80,Espeja de San Marcelino,180,110,70
42,Soria,81,Espejón,198,103,95
42,Soria,82,Estepa de San Juan,8,5,3
42,Soria,83,Frechilla de Almazán,27,14,13
42,Soria,84,Fresno de Caracena,29,17,12
42,Soria,85,Fuentearmegil,219,124,95
42,Soria,86,Fuentecambrón,44,27,17
42,Soria,87,Fuentecantos,61,29,32
42,Soria,88,Fuentelmonge,80,48,32
42,Soria,89,Fuentelsaz de Soria,58,30,28
42,Soria,90,Fuentepinilla,103,63,40
42,Soria,92,Fuentes de Magaña,94,49,45
42,Soria,93,Fuentestrún,57,31,26
42,Soria,94,Garray,629,347,282
42,Soria,95,Golmayo,2219,1159,1060
42,Soria,96,Gómara,377,212,165
42,Soria,97,Gormaz,26,14,12
42,Soria,98,Herrera de Soria,14,10,4
42,Soria,100,Hinojosa del Campo,32,21,11
42,Soria,103,Langa de Duero,821,446,375
42,Soria,105,Liceras,63,31,32
42,Soria,106,"Losilla, La",15,9,6
42,Soria,107,Magaña,89,55,34
42,Soria,108,Maján,13,8,5
42,Soria,110,Matalebreras,82,45,37
42,Soria,111,Matamala de Almazán,328,179,149
42,Soria,113,Medinaceli,810,398,412
42,Soria,115,Miño de Medinaceli,81,46,35
42,Soria,116,Miño de San Esteban,66,42,24
42,Soria,117,Molinos de Duero,180,97,83
42,Soria,118,Momblona,26,18,8
42,Soria,119,Monteagudo de las Vicarías,246,121,125
42,Soria,120,Montejo de Tiermes,188,123,65
42,Soria,121,Montenegro de Cameros,83,51,32
42,Soria,123,Morón de Almazán,222,110,112
42,Soria,124,Muriel de la Fuente,74,40,34
42,Soria,125,Muriel Viejo,81,46,35
42,Soria,127,Nafría de Ucero,46,27,19
42,Soria,128,Narros,45,24,21
42,Soria,129,Navaleno,877,454,423
42,Soria,130,Nepas,67,41,26
42,Soria,131,Nolay,59,31,28
42,Soria,132,Noviercas,180,94,86
42,Soria,134,Ólvega,3861,1997,1864
42,Soria,135,Oncala,100,64,36
42,Soria,139,Pinilla del Campo,23,14,9
42,Soria,140,Portillo de Soria,17,12,5
42,Soria,141,"Póveda de Soria, La",122,67,55
42,Soria,142,Pozalmuro,73,35,38
42,Soria,144,Quintana Redonda,523,290,233
42,Soria,145,Quintanas de Gormaz,147,83,64
42,Soria,148,Quiñonería,12,7,5
42,Soria,149,"Rábanos, Los",525,307,218
42,Soria,151,Rebollar,42,21,21
42,Soria,152,Recuerda,104,60,44
42,Soria,153,Rello,22,13,9
42,Soria,154,Renieblas,98,63,35
42,Soria,155,Retortillo de Soria,197,104,93
42,Soria,156,Reznos,33,22,11
42,Soria,157,"Riba de Escalote, La",18,12,6
42,Soria,158,Rioseco de Soria,136,78,58
42,Soria,159,Rollamienta,40,25,15
42,Soria,160,"Royo, El",315,170,145
42,Soria,161,Salduero,172,94,78
42,Soria,162,San Esteban de Gormaz,3223,1700,1523
42,Soria,163,San Felices,63,39,24
42,Soria,164,San Leonardo de Yagüe,2274,1162,1112
42,Soria,165,San Pedro Manrique,642,363,279
42,Soria,166,Santa Cruz de Yanguas,76,49,27
42,Soria,167,Santa María de Huerta,352,190,162
42,Soria,168,Santa María de las Hoyas,133,73,60
42,Soria,171,Serón de Nágima,169,95,74
42,Soria,172,Soliedra,34,18,16
42,Soria,173,Soria,40147,19107,21040
42,Soria,174,Sotillo del Rincón,202,103,99
42,Soria,175,Suellacabras,27,17,10
42,Soria,176,Tajahuerce,31,17,14
42,Soria,177,Tajueco,83,46,37
42,Soria,178,Talveila,140,78,62
42,Soria,181,Tardelcuende,484,247,237
42,Soria,182,Taroda,56,29,27
42,Soria,183,Tejado,135,76,59
42,Soria,184,Torlengua,80,42,38
42,Soria,185,Torreblacos,28,15,13
42,Soria,187,Torrubia de Soria,72,49,23
42,Soria,188,Trévago,65,31,34
42,Soria,189,Ucero,75,39,36
42,Soria,190,Vadillo,131,76,55
42,Soria,191,Valdeavellano de Tera,205,113,92
42,Soria,192,Valdegeña,42,28,14
42,Soria,193,Valdelagua del Cerro,17,11,6
42,Soria,194,Valdemaluque,207,99,108
42,Soria,195,Valdenebro,125,73,52
42,Soria,196,Valdeprado,13,9,4
42,Soria,197,Valderrodilla,90,50,40
42,Soria,198,Valtajeros,24,13,11
42,Soria,200,Velamazán,98,62,36
42,Soria,201,Velilla de la Sierra,30,19,11
42,Soria,202,Velilla de los Ajos,31,20,11
42,Soria,204,Viana de Duero,67,46,21
42,Soria,205,Villaciervos,98,60,38
42,Soria,206,Villanueva de Gormaz,10,7,3
42,Soria,207,Villar del Ala,56,26,30
42,Soria,208,Villar del Campo,23,15,8
42,Soria,209,Villar del Río,165,102,63
42,Soria,211,"Villares de Soria, Los",99,55,44
42,Soria,212,Villasayas,75,50,25
42,Soria,213,Villaseca de Arciel,38,21,17
42,Soria,215,Vinuesa,975,534,441
42,Soria,216,Vizmanos,27,16,11
42,Soria,217,Vozmediano,41,26,15
42,Soria,218,Yanguas,123,77,46
42,Soria,219,Yelo,48,25,23
43,Tarragona,1,Aiguamúrcia,906,473,433
43,Tarragona,2,Albinyana,2367,1186,1181
43,Tarragona,3,"Albiol, L'",459,232,227
43,Tarragona,4,Alcanar,10658,5520,5138
43,Tarragona,5,Alcover,5143,2593,2550
43,Tarragona,904,"Aldea, L'",4530,2421,2109
43,Tarragona,6,Aldover,968,486,482
43,Tarragona,7,"Aleixar, L'",926,465,461
43,Tarragona,8,Alfara de Carles,399,213,186
43,Tarragona,9,Alforja,1865,964,901
43,Tarragona,10,Alió,394,196,198
43,Tarragona,11,Almoster,1381,689,692
43,Tarragona,12,Altafulla,4835,2382,2453
43,Tarragona,13,"Ametlla de Mar, L'",7688,3914,3774
43,Tarragona,906,"Ampolla, L'",3606,1844,1762
43,Tarragona,14,Amposta,21434,10867,10567
43,Tarragona,16,"Arboç, L'",5486,2845,2641
43,Tarragona,15,Arbolí,113,61,52
43,Tarragona,17,"Argentera, L'",153,88,65
43,Tarragona,18,Arnes,492,254,238
43,Tarragona,19,Ascó,1680,875,805
43,Tarragona,20,Banyeres del Penedès,3019,1558,1461
43,Tarragona,21,Barberà de la Conca,526,288,238
43,Tarragona,22,Batea,2136,1097,1039
43,Tarragona,23,Bellmunt del Priorat,336,173,163
43,Tarragona,24,Bellvei,2110,1087,1023
43,Tarragona,25,Benifallet,771,390,381
43,Tarragona,26,Benissanet,1280,700,580
43,Tarragona,27,"Bisbal de Falset, La",227,127,100
43,Tarragona,28,"Bisbal del Penedès, La",3428,1782,1646
43,Tarragona,29,Blancafort,418,214,204
43,Tarragona,30,Bonastre,651,346,305
43,Tarragona,31,"Borges del Camp, Les",2127,1065,1062
43,Tarragona,32,Bot,678,353,325
43,Tarragona,33,Botarell,1126,595,531
43,Tarragona,34,Bràfim,670,342,328
43,Tarragona,35,Cabacés,342,177,165
43,Tarragona,36,Cabra del Camp,1165,607,558
43,Tarragona,37,Calafell,24672,12471,12201
43,Tarragona,903,Camarles,3609,1844,1765
43,Tarragona,38,Cambrils,33535,16680,16855
43,Tarragona,907,"Canonja, La",5723,2871,2852
43,Tarragona,39,Capafonts,121,64,57
43,Tarragona,40,Capçanes,421,210,211
43,Tarragona,41,Caseres,284,139,145
43,Tarragona,42,Castellvell del Camp,2845,1419,1426
43,Tarragona,43,"Catllar, El",4164,2141,2023
43,Tarragona,45,Colldejou,177,96,81
43,Tarragona,46,Conesa,130,65,65
43,Tarragona,47,Constantí,6774,3575,3199
43,Tarragona,48,Corbera d'Ebre,1204,649,555
43,Tarragona,49,Cornudella de Montsant,1025,541,484
43,Tarragona,50,Creixell,3431,1758,1673
43,Tarragona,51,Cunit,12626,6349,6277
43,Tarragona,901,Deltebre,12316,6247,6069
43,Tarragona,53,Duesaigües,241,138,103
43,Tarragona,54,"Espluga de Francolí, L'",3913,1911,2002
43,Tarragona,55,Falset,2894,1461,1433
43,Tarragona,56,"Fatarella, La",1089,548,541
43,Tarragona,57,"Febró, La",49,33,16
43,Tarragona,58,"Figuera, La",128,71,57
43,Tarragona,59,Figuerola del Camp,348,170,178
43,Tarragona,60,Flix,3961,1983,1978
43,Tarragona,61,Forès,50,28,22
43,Tarragona,62,Freginals,482,256,226
43,Tarragona,63,"Galera, La",843,434,409
43,Tarragona,64,Gandesa,3162,1636,1526
43,Tarragona,65,Garcia,592,300,292
43,Tarragona,66,"Garidells, Els",193,102,91
43,Tarragona,67,Ginestar,937,486,451
43,Tarragona,68,Godall,812,418,394
43,Tarragona,69,Gratallops,259,136,123
43,Tarragona,70,"Guiamets, Els",311,145,166
43,Tarragona,71,Horta de Sant Joan,1280,690,590
43,Tarragona,72,"Lloar, El",116,64,52
43,Tarragona,73,Llorac,118,63,55
43,Tarragona,74,Llorenç del Penedès,2280,1124,1156
43,Tarragona,76,Marçà,638,333,305
43,Tarragona,75,Margalef,110,62,48
43,Tarragona,77,Mas de Barberans,636,313,323
43,Tarragona,78,Masdenverge,1122,578,544
43,Tarragona,79,Masllorenç,528,287,241
43,Tarragona,80,"Masó, La",296,157,139
43,Tarragona,81,Maspujols,750,394,356
43,Tarragona,82,"Masroig, El",565,296,269
43,Tarragona,83,"Milà, El",174,87,87
43,Tarragona,84,Miravet,789,418,371
43,Tarragona,85,"Molar, El",296,163,133
43,Tarragona,86,Montblanc,7356,3712,3644
43,Tarragona,88,Montbrió del Camp,2515,1276,1239
43,Tarragona,89,Montferri,396,206,190
43,Tarragona,90,"Montmell, El",1511,829,682
43,Tarragona,91,Mont-ral,167,97,70
43,Tarragona,92,Mont-roig del Camp,12702,6614,6088
43,Tarragona,93,Móra d'Ebre,5704,2816,2888
43,Tarragona,94,Móra la Nova,3285,1682,1603
43,Tarragona,95,"Morell, El",3514,1811,1703
43,Tarragona,96,"Morera de Montsant, La",167,100,67
43,Tarragona,97,"Nou de Gaià, La",555,272,283
43,Tarragona,98,Nulles,446,229,217
43,Tarragona,100,"Pallaresos, Els",4387,2231,2156
43,Tarragona,99,"Palma d'Ebre, La",396,189,207
43,Tarragona,101,Passanant i Belltall,161,86,75
43,Tarragona,102,Paüls,602,299,303
43,Tarragona,103,Perafort,1264,665,599
43,Tarragona,104,"Perelló, El",3378,1794,1584
43,Tarragona,105,"Piles, Les",214,114,100
43,Tarragona,106,"Pinell de Brai, El",1124,568,556
43,Tarragona,107,Pira,501,259,242
43,Tarragona,108,"Pla de Santa Maria, El",2375,1251,1124
43,Tarragona,109,"Pobla de Mafumet, La",2948,1526,1422
43,Tarragona,110,"Pobla de Massaluca, La",364,192,172
43,Tarragona,111,"Pobla de Montornès, La",2897,1523,1374
43,Tarragona,112,Poboleda,370,202,168
43,Tarragona,113,"Pont d'Armentera, El",605,316,289
43,Tarragona,141,Pontils,134,72,62
43,Tarragona,114,Porrera,465,256,209
43,Tarragona,115,Pradell de la Teixeta,199,87,112
43,Tarragona,116,Prades,651,333,318
43,Tarragona,117,Prat de Comte,183,101,82
43,Tarragona,118,Pratdip,848,450,398
43,Tarragona,119,Puigpelat,1024,529,495
43,Tarragona,120,Querol,559,310,249
43,Tarragona,121,Rasquera,933,474,459
43,Tarragona,122,Renau,137,71,66
43,Tarragona,123,Reus,107211,52593,54618
43,Tarragona,124,"Riba, La",659,346,313
43,Tarragona,125,Riba-roja d'Ebre,1316,698,618
43,Tarragona,126,"Riera de Gaià, La",1691,860,831
43,Tarragona,127,Riudecanyes,1183,606,577
43,Tarragona,128,Riudecols,1289,662,627
43,Tarragona,129,Riudoms,6530,3354,3176
43,Tarragona,130,Rocafort de Queralt,268,140,128
43,Tarragona,131,Roda de Barà,6299,3286,3013
43,Tarragona,132,Rodonyà,508,269,239
43,Tarragona,133,Roquetes,8333,4347,3986
43,Tarragona,134,"Rourell, El",401,204,197
43,Tarragona,135,Salomó,540,292,248
43,Tarragona,905,Salou,26601,14142,12459
43,Tarragona,136,Sant Carles de la Ràpita,15232,7548,7684
43,Tarragona,137,Sant Jaume dels Domenys,2491,1275,1216
43,Tarragona,902,Sant Jaume d'Enveja,3549,1812,1737
43,Tarragona,138,Santa Bàrbara,3898,1985,1913
43,Tarragona,139,Santa Coloma de Queralt,3040,1523,1517
43,Tarragona,140,Santa Oliva,3322,1710,1612
43,Tarragona,142,Sarral,1662,854,808
43,Tarragona,143,Savallà del Comtat,68,34,34
43,Tarragona,144,"Secuita, La",1607,823,784
43,Tarragona,145,"Selva del Camp, La",5619,2831,2788
43,Tarragona,146,Senan,61,39,22
43,Tarragona,44,"Sénia, La",6083,3103,2980
43,Tarragona,147,Solivella,660,335,325
43,Tarragona,148,Tarragona,133954,65700,68254
43,Tarragona,149,Tivenys,914,466,448
43,Tarragona,150,Tivissa,1818,918,900
43,Tarragona,151,"Torre de Fontaubella, La",131,74,57
43,Tarragona,152,"Torre de l'Espanyol, La",681,351,330
43,Tarragona,153,Torredembarra,15310,7572,7738
43,Tarragona,154,Torroja del Priorat,172,95,77
43,Tarragona,155,Tortosa,34734,17466,17268
43,Tarragona,156,Ulldecona,7372,3830,3542
43,Tarragona,157,Ulldemolins,434,250,184
43,Tarragona,158,Vallclara,125,70,55
43,Tarragona,159,Vallfogona de Riucorb,119,66,53
43,Tarragona,160,Vallmoll,1677,874,803
43,Tarragona,161,Valls,25084,12616,12468
43,Tarragona,162,Vandellòs i l'Hospitalet de l'Infant,5985,2995,2990
43,Tarragona,163,"Vendrell, El",36647,18368,18279
43,Tarragona,164,Vespella de Gaià,395,215,180
43,Tarragona,165,Vilabella,829,428,401
43,Tarragona,175,Vilalba dels Arcs,717,372,345
43,Tarragona,166,Vilallonga del Camp,2204,1123,1081
43,Tarragona,168,Vilanova de Prades,129,67,62
43,Tarragona,167,Vilanova d'Escornalbou,570,311,259
43,Tarragona,169,Vilaplana,628,321,307
43,Tarragona,170,Vila-rodona,1280,662,618
43,Tarragona,171,Vila-seca,22052,11269,10783
43,Tarragona,172,Vilaverd,488,247,241
43,Tarragona,173,"Vilella Alta, La",143,79,64
43,Tarragona,174,"Vilella Baixa, La",222,120,102
43,Tarragona,176,Vimbodí i Poblet,1007,568,439
43,Tarragona,177,Vinebre,495,250,245
43,Tarragona,178,Vinyols i els Arcs,1936,1005,931
43,Tarragona,52,Xerta,1277,627,650
44,Teruel,1,Ababuj,73,43,30
44,Teruel,2,Abejuela,55,35,20
44,Teruel,3,Aguatón,20,8,12
44,Teruel,4,Aguaviva,660,335,325
44,Teruel,5,Aguilar del Alfambra,73,44,29
44,Teruel,6,Alacón,331,161,170
44,Teruel,7,Alba,231,118,113
44,Teruel,8,Albalate del Arzobispo,2087,1070,1017
44,Teruel,9,Albarracín,1102,564,538
44,Teruel,10,Albentosa,290,148,142
44,Teruel,11,Alcaine,69,40,29
44,Teruel,12,Alcalá de la Selva,496,261,235
44,Teruel,13,Alcañiz,16424,8245,8179
44,Teruel,14,Alcorisa,3556,1827,1729
44,Teruel,16,Alfambra,622,329,293
44,Teruel,17,Aliaga,366,207,159
44,Teruel,21,Allepuz,121,60,61
44,Teruel,22,Alloza,673,349,324
44,Teruel,23,Allueva,21,12,9
44,Teruel,18,Almohaja,28,22,6
44,Teruel,19,Alobras,79,44,35
44,Teruel,20,Alpeñés,25,16,9
44,Teruel,24,Anadón,27,17,10
44,Teruel,25,Andorra,8266,4257,4009
44,Teruel,26,Arcos de las Salinas,105,55,50
44,Teruel,27,Arens de Lledó,205,94,111
44,Teruel,28,Argente,224,105,119
44,Teruel,29,Ariño,893,460,433
44,Teruel,31,Azaila,133,70,63
44,Teruel,32,Bádenas,21,12,9
44,Teruel,33,Báguena,370,205,165
44,Teruel,34,Bañón,162,91,71
44,Teruel,35,Barrachina,143,77,66
44,Teruel,36,Bea,30,19,11
44,Teruel,37,Beceite,607,314,293
44,Teruel,39,Bello,282,136,146
44,Teruel,38,Belmonte de San José,126,61,65
44,Teruel,40,Berge,254,127,127
44,Teruel,41,Bezas,78,43,35
44,Teruel,42,Blancas,158,92,66
44,Teruel,43,Blesa,125,78,47
44,Teruel,44,Bordón,131,72,59
44,Teruel,45,Bronchales,472,277,195
44,Teruel,46,Bueña,63,31,32
44,Teruel,47,Burbáguena,292,139,153
44,Teruel,48,Cabra de Mora,79,48,31
44,Teruel,49,Calaceite,1105,574,531
44,Teruel,50,Calamocha,4579,2290,2289
44,Teruel,51,Calanda,3956,1960,1996
44,Teruel,52,Calomarde,90,53,37
44,Teruel,53,Camañas,135,74,61
44,Teruel,54,Camarena de la Sierra,145,84,61
44,Teruel,55,Camarillas,117,75,42
44,Teruel,56,Caminreal,735,378,357
44,Teruel,59,Cantavieja,745,392,353
44,Teruel,60,Cañada de Benatanduz,39,25,14
44,Teruel,61,"Cañada de Verich, La",106,59,47
44,Teruel,62,Cañada Vellida,38,27,11
44,Teruel,63,Cañizar del Olivar,110,62,48
44,Teruel,64,Cascante del Río,91,56,35
44,Teruel,65,Castejón de Tornos,64,36,28
44,Teruel,66,Castel de Cabra,138,72,66
44,Teruel,70,"Castellar, El",64,42,22
44,Teruel,71,Castellote,794,415,379
44,Teruel,67,Castelnou,177,94,83
44,Teruel,68,Castelserás,834,441,393
44,Teruel,74,Cedrillas,631,327,304
44,Teruel,75,Celadas,406,219,187
44,Teruel,76,Cella,2878,1505,1373
44,Teruel,77,"Cerollera, La",116,70,46
44,Teruel,80,"Codoñera, La",377,198,179
44,Teruel,82,Corbalán,107,56,51
44,Teruel,84,Cortes de Aragón,72,36,36
44,Teruel,85,Cosa,61,36,25
44,Teruel,86,Cretas,598,302,296
44,Teruel,87,Crivillén,88,47,41
44,Teruel,88,"Cuba, La",50,28,22
44,Teruel,89,Cubla,62,38,24
44,Teruel,90,Cucalón,108,64,44
44,Teruel,92,"Cuervo, El",91,51,40
44,Teruel,93,Cuevas de Almudén,148,86,62
44,Teruel,94,Cuevas Labradas,128,67,61
44,Teruel,96,Ejulve,208,104,104
44,Teruel,97,Escorihuela,177,88,89
44,Teruel,99,Escucha,995,553,442
44,Teruel,100,Estercuel,259,147,112
44,Teruel,101,Ferreruela de Huerva,70,39,31
44,Teruel,102,Fonfría,30,17,13
44,Teruel,103,Formiche Alto,175,94,81
44,Teruel,105,Fórnoles,105,52,53
44,Teruel,106,Fortanete,222,132,90
44,Teruel,107,Foz-Calanda,279,154,125
44,Teruel,108,"Fresneda, La",486,271,215
44,Teruel,109,Frías de Albarracín,151,88,63
44,Teruel,110,Fuenferrada,62,35,27
44,Teruel,111,Fuentes Calientes,116,65,51
44,Teruel,112,Fuentes Claras,576,309,267
44,Teruel,113,Fuentes de Rubielos,125,65,60
44,Teruel,114,Fuentespalda,317,159,158
44,Teruel,115,Galve,170,91,79
44,Teruel,116,Gargallo,122,64,58
44,Teruel,117,Gea de Albarracín,405,209,196
44,Teruel,118,"Ginebrosa, La",216,123,93
44,Teruel,119,Griegos,143,86,57
44,Teruel,120,Guadalaviar,236,134,102
44,Teruel,121,Gúdar,77,43,34
44,Teruel,122,Híjar,1806,911,895
44,Teruel,123,Hinojosa de Jarque,151,85,66
44,Teruel,124,"Hoz de la Vieja, La",79,41,38
44,Teruel,125,Huesa del Común,86,54,32
44,Teruel,126,"Iglesuela del Cid, La",496,266,230
44,Teruel,127,Jabaloyas,83,48,35
44,Teruel,128,Jarque de la Val,91,49,42
44,Teruel,129,Jatiel,49,28,21
44,Teruel,130,Jorcas,41,23,18
44,Teruel,131,Josa,38,21,17
44,Teruel,132,Lagueruela,69,36,33
44,Teruel,133,Lanzuela,28,20,8
44,Teruel,135,Libros,141,80,61
44,Teruel,136,Lidón,55,25,30
44,Teruel,137,Linares de Mora,296,170,126
44,Teruel,141,Lledó,169,97,72
44,Teruel,138,Loscos,175,107,68
44,Teruel,142,Maicas,38,19,19
44,Teruel,143,Manzanera,554,292,262
44,Teruel,144,Martín del Río,429,219,210
44,Teruel,145,Mas de las Matas,1360,706,654
44,Teruel,146,"Mata de los Olmos, La",281,142,139
44,Teruel,147,Mazaleón,567,304,263
44,Teruel,148,Mezquita de Jarque,118,69,49
44,Teruel,149,Mirambel,129,68,61
44,Teruel,150,Miravete de la Sierra,33,19,14
44,Teruel,151,Molinos,286,159,127
44,Teruel,152,Monforte de Moyuela,63,44,19
44,Teruel,153,Monreal del Campo,2709,1351,1358
44,Teruel,154,Monroyo,390,241,149
44,Teruel,155,Montalbán,1350,687,663
44,Teruel,156,Monteagudo del Castillo,67,38,29
44,Teruel,157,Monterde de Albarracín,66,37,29
44,Teruel,158,Mora de Rubielos,1649,845,804
44,Teruel,159,Moscardón,64,34,30
44,Teruel,160,Mosqueruela,621,333,288
44,Teruel,161,Muniesa,653,338,315
44,Teruel,163,Noguera de Albarracín,152,81,71
44,Teruel,164,Nogueras,31,23,8
44,Teruel,165,Nogueruelas,219,117,102
44,Teruel,167,Obón,39,24,15
44,Teruel,168,Odón,229,120,109
44,Teruel,169,Ojos Negros,445,245,200
44,Teruel,171,Olba,249,138,111
44,Teruel,172,Oliete,459,242,217
44,Teruel,173,"Olmos, Los",124,67,57
44,Teruel,174,Orihuela del Tremedal,572,301,271
44,Teruel,175,Orrios,152,76,76
44,Teruel,176,Palomar de Arroyos,189,110,79
44,Teruel,177,Pancrudo,133,76,57
44,Teruel,178,"Parras de Castellote, Las",69,38,31
44,Teruel,179,Peñarroya de Tastavins,497,268,229
44,Teruel,180,Peracense,77,44,33
44,Teruel,181,Peralejos,83,41,42
44,Teruel,182,Perales del Alfambra,269,147,122
44,Teruel,183,Pitarque,93,43,50
44,Teruel,184,Plou,48,31,17
44,Teruel,185,"Pobo, El",142,91,51
44,Teruel,187,"Portellada, La",254,125,129
44,Teruel,189,Pozondón,71,36,35
44,Teruel,190,Pozuel del Campo,90,45,45
44,Teruel,191,"Puebla de Híjar, La",982,497,485
44,Teruel,192,"Puebla de Valverde, La",550,316,234
44,Teruel,193,Puertomingalvo,144,81,63
44,Teruel,194,Ráfales,159,78,81
44,Teruel,195,Rillo,111,62,49
44,Teruel,196,Riodeva,173,86,87
44,Teruel,197,Ródenas,79,48,31
44,Teruel,198,Royuela,247,135,112
44,Teruel,199,Rubiales,61,35,26
44,Teruel,200,Rubielos de la Cérida,43,22,21
44,Teruel,201,Rubielos de Mora,755,379,376
44,Teruel,203,Salcedillo,10,8,2
44,Teruel,204,Saldón,28,19,9
44,Teruel,205,Samper de Calanda,884,437,447
44,Teruel,206,San Agustín,177,110,67
44,Teruel,207,San Martín del Río,191,98,93
44,Teruel,208,Santa Cruz de Nogueras,39,22,17
44,Teruel,209,Santa Eulalia,1122,564,558
44,Teruel,210,Sarrión,1129,616,513
44,Teruel,211,Segura de los Baños,40,25,15
44,Teruel,212,Seno,45,23,22
44,Teruel,213,Singra,84,49,35
44,Teruel,215,Terriente,191,114,77
44,Teruel,216,Teruel,35841,17320,18521
44,Teruel,217,Toril y Masegoso,35,25,10
44,Teruel,218,Tormón,34,18,16
44,Teruel,219,Tornos,231,124,107
44,Teruel,220,Torralba de los Sisones,181,99,82
44,Teruel,223,Torre de Arcas,88,43,45
44,Teruel,224,Torre de las Arcas,30,15,15
44,Teruel,225,Torre del Compte,148,76,72
44,Teruel,227,Torre los Negros,98,55,43
44,Teruel,221,Torrecilla de Alcañiz,447,236,211
44,Teruel,222,Torrecilla del Rebollar,142,81,61
44,Teruel,226,Torrelacárcel,200,105,95
44,Teruel,228,Torremocha de Jiloca,128,71,57
44,Teruel,229,Torres de Albarracín,167,92,75
44,Teruel,230,Torrevelilla,199,102,97
44,Teruel,231,Torrijas,57,26,31
44,Teruel,232,Torrijo del Campo,506,265,241
44,Teruel,234,Tramacastiel,85,49,36
44,Teruel,235,Tramacastilla,125,60,65
44,Teruel,236,Tronchón,100,56,44
44,Teruel,237,Urrea de Gaén,516,254,262
44,Teruel,238,Utrillas,3238,1686,1552
44,Teruel,239,Valacloche,28,19,9
44,Teruel,240,Valbona,211,116,95
44,Teruel,241,Valdealgorfa,651,322,329
44,Teruel,243,Valdecuenca,56,37,19
44,Teruel,244,Valdelinares,106,62,44
44,Teruel,245,Valdeltormo,317,165,152
44,Teruel,246,Valderrobres,2335,1210,1125
44,Teruel,247,Valjunquera,386,198,188
44,Teruel,249,"Vallecillo, El",54,32,22
44,Teruel,250,Veguillas de la Sierra,20,12,8
44,Teruel,251,Villafranca del Campo,323,165,158
44,Teruel,252,Villahermosa del Campo,99,61,38
44,Teruel,256,Villanueva del Rebollar de la Sierra,47,26,21
44,Teruel,257,Villar del Cobo,202,107,95
44,Teruel,258,Villar del Salz,79,46,33
44,Teruel,260,Villarluengo,200,116,84
44,Teruel,261,Villarquemado,904,476,428
44,Teruel,262,Villarroya de los Pinares,163,85,78
44,Teruel,263,Villastar,480,241,239
44,Teruel,264,Villel,347,199,148
44,Teruel,265,Vinaceite,308,168,140
44,Teruel,266,Visiedo,145,65,80
44,Teruel,267,Vivel del Río Martín,86,45,41
44,Teruel,268,"Zoma, La",22,9,13
45,Toledo,1,Ajofrín,2288,1160,1128
45,Toledo,2,Alameda de la Sagra,3511,1829,1682
45,Toledo,3,Albarreal de Tajo,743,389,354
45,Toledo,4,Alcabón,756,392,364
45,Toledo,5,Alcañizo,319,167,152
45,Toledo,6,Alcaudete de la Jara,2057,1035,1022
45,Toledo,7,Alcolea de Tajo,916,464,452
45,Toledo,8,Aldea en Cabo,218,119,99
45,Toledo,9,Aldeanueva de Barbarroya,650,318,332
45,Toledo,10,Aldeanueva de San Bartolomé,504,247,257
45,Toledo,11,Almendral de la Cañada,361,200,161
45,Toledo,12,Almonacid de Toledo,881,458,423
45,Toledo,13,Almorox,2444,1308,1136
45,Toledo,14,Añover de Tajo,5413,2798,2615
45,Toledo,15,Arcicóllar,822,398,424
45,Toledo,16,Argés,5712,2856,2856
45,Toledo,17,Azután,295,145,150
45,Toledo,18,Barcience,760,401,359
45,Toledo,19,Bargas,9874,4940,4934
45,Toledo,20,Belvís de la Jara,1788,898,890
45,Toledo,21,Borox,3556,1850,1706
45,Toledo,22,Buenaventura,490,260,230
45,Toledo,23,Burguillos de Toledo,2789,1435,1354
45,Toledo,24,Burujón,1446,766,680
45,Toledo,25,Cabañas de la Sagra,1932,1031,901
45,Toledo,26,Cabañas de Yepes,305,160,145
45,Toledo,27,Cabezamesada,490,268,222
45,Toledo,28,Calera y Chozas,4738,2419,2319
45,Toledo,29,Caleruela,261,139,122
45,Toledo,30,Calzada de Oropesa,563,302,261
45,Toledo,31,Camarena,3862,2044,1818
45,Toledo,32,Camarenilla,605,321,284
45,Toledo,33,"Campillo de la Jara, El",446,235,211
45,Toledo,34,Camuñas,1886,960,926
45,Toledo,35,Cardiel de los Montes,390,207,183
45,Toledo,36,Carmena,839,448,391
45,Toledo,37,"Carpio de Tajo, El",2154,1072,1082
45,Toledo,38,Carranque,4473,2306,2167
45,Toledo,39,Carriches,301,157,144
45,Toledo,40,"Casar de Escalona, El",2175,1170,1005
45,Toledo,41,Casarrubios del Monte,5600,2978,2622
45,Toledo,42,Casasbuenas,210,104,106
45,Toledo,43,Castillo de Bayuela,1024,520,504
45,Toledo,45,Cazalegas,1852,953,899
45,Toledo,46,Cebolla,3862,1985,1877
45,Toledo,47,Cedillo del Condado,3426,1809,1617
45,Toledo,48,"Cerralbos, Los",459,245,214
45,Toledo,49,Cervera de los Montes,470,238,232
45,Toledo,56,Chozas de Canales,4104,2195,1909
45,Toledo,57,Chueca,270,153,117
45,Toledo,50,Ciruelos,687,359,328
45,Toledo,51,Cobeja,2373,1237,1136
45,Toledo,52,Cobisa,4120,2088,2032
45,Toledo,53,Consuegra,10923,5563,5360
45,Toledo,54,Corral de Almaguer,6235,3200,3035
45,Toledo,55,Cuerva,1564,825,739
45,Toledo,58,Domingo Pérez,492,249,243
45,Toledo,59,Dosbarrios,2362,1184,1178
45,Toledo,60,Erustes,245,129,116
45,Toledo,61,Escalona,3454,1794,1660
45,Toledo,62,Escalonilla,1546,768,778
45,Toledo,63,Espinoso del Rey,577,314,263
45,Toledo,64,Esquivias,5507,2791,2716
45,Toledo,65,"Estrella, La",305,156,149
45,Toledo,66,Fuensalida,11278,5780,5498
45,Toledo,67,Gálvez,3355,1709,1646
45,Toledo,68,Garciotum,182,94,88
45,Toledo,69,Gerindote,2425,1250,1175
45,Toledo,70,Guadamur,1847,943,904
45,Toledo,71,"Guardia, La",2317,1165,1152
45,Toledo,72,"Herencias, Las",840,428,412
45,Toledo,73,Herreruela de Oropesa,454,225,229
45,Toledo,74,Hinojosa de San Vicente,446,246,200
45,Toledo,75,Hontanar,200,110,90
45,Toledo,76,Hormigos,834,463,371
45,Toledo,77,Huecas,711,369,342
45,Toledo,78,Huerta de Valdecarábanos,1900,943,957
45,Toledo,79,"Iglesuela, La",441,230,211
45,Toledo,80,Illán de Vacas,2,2,0
45,Toledo,81,Illescas,24581,12523,12058
45,Toledo,82,Lagartera,1558,784,774
45,Toledo,83,Layos,589,298,291
45,Toledo,84,Lillo,3114,1609,1505
45,Toledo,85,Lominchar,2369,1254,1115
45,Toledo,86,Lucillos,656,334,322
45,Toledo,87,Madridejos,11206,5642,5564
45,Toledo,88,Magán,3087,1629,1458
45,Toledo,89,Malpica de Tajo,2091,1064,1027
45,Toledo,90,Manzaneque,446,220,226
45,Toledo,91,Maqueda,543,280,263
45,Toledo,92,Marjaliza,316,166,150
45,Toledo,93,Marrupe,175,93,82
45,Toledo,94,Mascaraque,523,259,264
45,Toledo,95,"Mata, La",1019,534,485
45,Toledo,96,Mazarambroz,1315,668,647
45,Toledo,97,Mejorada,1320,689,631
45,Toledo,98,Menasalbas,3117,1661,1456
45,Toledo,99,Méntrida,4987,2569,2418
45,Toledo,100,Mesegar de Tajo,237,128,109
45,Toledo,101,Miguel Esteban,5417,2736,2681
45,Toledo,102,Mocejón,5003,2573,2430
45,Toledo,103,Mohedas de la Jara,491,270,221
45,Toledo,104,Montearagón,555,285,270
45,Toledo,105,Montesclaros,455,233,222
45,Toledo,106,Mora,10466,5335,5131
45,Toledo,107,Nambroca,4298,2217,2081
45,Toledo,108,"Nava de Ricomalillo, La",635,330,305
45,Toledo,109,Navahermosa,4143,2160,1983
45,Toledo,110,Navalcán,2358,1253,1105
45,Toledo,111,Navalmoralejo,73,37,36
45,Toledo,112,"Navalmorales, Los",2872,1520,1352
45,Toledo,113,"Navalucillos, Los",2574,1324,1250
45,Toledo,114,Navamorcuende,683,353,330
45,Toledo,115,Noblejas,3670,1888,1782
45,Toledo,116,Noez,980,515,465
45,Toledo,117,Nombela,1021,527,494
45,Toledo,118,Novés,2950,1538,1412
45,Toledo,119,Numancia de la Sagra,4951,2600,2351
45,Toledo,120,Nuño Gómez,172,92,80
45,Toledo,121,Ocaña,11147,5716,5431
45,Toledo,122,Olías del Rey,7010,3590,3420
45,Toledo,123,Ontígola,4042,2200,1842
45,Toledo,124,Orgaz,2804,1410,1394
45,Toledo,125,Oropesa,2902,1421,1481
45,Toledo,126,Otero,381,189,192
45,Toledo,127,Palomeque,928,503,425
45,Toledo,128,Pantoja,3360,1695,1665
45,Toledo,129,Paredes de Escalona,159,77,82
45,Toledo,130,Parrillas,411,210,201
45,Toledo,131,Pelahustán,380,205,175
45,Toledo,132,Pepino,2643,1366,1277
45,Toledo,133,Polán,4034,2054,1980
45,Toledo,134,Portillo de Toledo,2263,1154,1109
45,Toledo,135,"Puebla de Almoradiel, La",5888,3005,2883
45,Toledo,136,"Puebla de Montalbán, La",8392,4260,4132
45,Toledo,137,"Pueblanueva, La",2394,1213,1181
45,Toledo,138,"Puente del Arzobispo, El",1407,688,719
45,Toledo,139,Puerto de San Vicente,245,124,121
45,Toledo,140,Pulgar,1696,886,810
45,Toledo,141,Quero,1311,668,643
45,Toledo,142,Quintanar de la Orden,13047,6726,6321
45,Toledo,143,Quismondo,1728,878,850
45,Toledo,144,"Real de San Vicente, El",1097,595,502
45,Toledo,145,Recas,4160,2374,1786
45,Toledo,146,Retamoso de la Jara,122,60,62
45,Toledo,147,Rielves,809,399,410
45,Toledo,148,Robledo del Mazo,364,206,158
45,Toledo,149,"Romeral, El",725,361,364
45,Toledo,150,San Bartolomé de las Abiertas,562,306,256
45,Toledo,151,San Martín de Montalbán,850,421,429
45,Toledo,152,San Martín de Pusa,847,450,397
45,Toledo,153,San Pablo de los Montes,2160,1101,1059
45,Toledo,154,San Román de los Montes,1855,989,866
45,Toledo,155,Santa Ana de Pusa,512,282,230
45,Toledo,156,Santa Cruz de la Zarza,4891,2513,2378
45,Toledo,157,Santa Cruz del Retamar,3095,1612,1483
45,Toledo,158,Santa Olalla,3465,1766,1699
45,Toledo,901,Santo Domingo-Caudilla,1065,555,510
45,Toledo,159,Sartajada,107,58,49
45,Toledo,160,Segurilla,1321,672,649
45,Toledo,161,Seseña,19109,9915,9194
45,Toledo,162,Sevilleja de la Jara,826,437,389
45,Toledo,163,Sonseca,11630,5921,5709
45,Toledo,164,Sotillo de las Palomas,207,109,98
45,Toledo,165,Talavera de la Reina,88755,43275,45480
45,Toledo,166,Tembleque,2327,1196,1131
45,Toledo,167,"Toboso, El",2140,1083,1057
45,Toledo,168,Toledo,84019,40321,43698
45,Toledo,169,Torralba de Oropesa,271,144,127
45,Toledo,171,"Torre de Esteban Hambrán, La",1820,953,867
45,Toledo,170,Torrecilla de la Jara,293,148,145
45,Toledo,172,Torrico,861,446,415
45,Toledo,173,Torrijos,13448,6661,6787
45,Toledo,174,Totanés,422,219,203
45,Toledo,175,Turleque,875,443,432
45,Toledo,176,Ugena,5260,2742,2518
45,Toledo,177,Urda,3056,1531,1525
45,Toledo,179,Valdeverdeja,719,349,370
45,Toledo,180,Valmojado,4216,2183,2033
45,Toledo,181,Velada,2860,1503,1357
45,Toledo,182,"Ventas con Peña Aguilera, Las",1301,676,625
45,Toledo,183,"Ventas de Retamosa, Las",3377,1762,1615
45,Toledo,184,"Ventas de San Julián, Las",214,104,110
45,Toledo,186,"Villa de Don Fadrique, La",4102,2040,2062
45,Toledo,185,Villacañas,10515,5258,5257
45,Toledo,187,Villafranca de los Caballeros,5373,2671,2702
45,Toledo,188,Villaluenga de la Sagra,4083,2061,2022
45,Toledo,189,Villamiel de Toledo,941,490,451
45,Toledo,190,Villaminaya,589,299,290
45,Toledo,191,Villamuelas,729,373,356
45,Toledo,192,Villanueva de Alcardete,3761,1966,1795
45,Toledo,193,Villanueva de Bogas,816,418,398
45,Toledo,194,Villarejo de Montalbán,71,37,34
45,Toledo,195,Villarrubia de Santiago,2799,1409,1390
45,Toledo,196,Villaseca de la Sagra,1890,979,911
45,Toledo,197,Villasequilla,2662,1369,1293
45,Toledo,198,Villatobas,2701,1394,1307
45,Toledo,199,"Viso de San Juan, El",3930,2090,1840
45,Toledo,200,"Yébenes, Los",6367,3264,3103
45,Toledo,201,Yeles,5069,2707,2362
45,Toledo,202,Yepes,5150,2641,2509
45,Toledo,203,Yuncler,3724,1902,1822
45,Toledo,204,Yunclillos,856,453,403
45,Toledo,205,Yuncos,10587,5516,5071
46,Valencia/València,1,Ademuz,1258,671,587
46,Valencia/València,2,Ador,1440,735,705
46,Valencia/València,4,Agullent,2465,1218,1247
46,Valencia/València,42,Aielo de Malferit,4743,2359,2384
46,Valencia/València,43,Aielo de Rugat,190,99,91
46,Valencia/València,5,Alaquàs,30202,14965,15237
46,Valencia/València,6,Albaida,6162,3063,3099
46,Valencia/València,7,Albal,15721,7907,7814
46,Valencia/València,8,Albalat de la Ribera,3545,1784,1761
46,Valencia/València,9,Albalat dels Sorells,3911,1913,1998
46,Valencia/València,10,Albalat dels Tarongers,1149,602,547
46,Valencia/València,11,Alberic,11288,5717,5571
46,Valencia/València,12,Alborache,1268,659,609
46,Valencia/València,13,Alboraya,23228,11552,11676
46,Valencia/València,14,Albuixech,3958,1946,2012
46,Valencia/València,16,Alcàntera de Xúquer,1361,678,683
46,Valencia/València,15,Alcàsser,9544,4838,4706
46,Valencia/València,18,Alcublas,767,396,371
46,Valencia/València,20,"Alcúdia de Crespins, l'",5304,2649,2655
46,Valencia/València,19,"Alcúdia, l'",11437,5607,5830
46,Valencia/València,21,Aldaia,30874,15481,15393
46,Valencia/València,22,Alfafar,20852,10300,10552
46,Valencia/València,24,Alfara de la Baronia,570,300,270
46,Valencia/València,25,Alfara del Patriarca,3182,1580,1602
46,Valencia/València,26,Alfarp,1579,820,759
46,Valencia/València,27,Alfarrasí,1303,647,656
46,Valencia/València,23,Alfauir,427,220,207
46,Valencia/València,28,Algar de Palancia,555,281,274
46,Valencia/València,29,Algemesí,28358,14029,14329
46,Valencia/València,30,Algimia de Alfara,1048,526,522
46,Valencia/València,31,Alginet,13379,6783,6596
46,Valencia/València,32,Almàssera,7295,3544,3751
46,Valencia/València,33,Almiserà,314,158,156
46,Valencia/València,34,Almoines,2398,1232,1166
46,Valencia/València,35,Almussafes,8523,4254,4269
46,Valencia/València,36,Alpuente,754,408,346
46,Valencia/València,37,"Alqueria de la Comtessa, l'",1508,749,759
46,Valencia/València,17,Alzira,44941,21935,23006
46,Valencia/València,38,Andilla,405,245,160
46,Valencia/València,39,Anna,2737,1361,1376
46,Valencia/València,40,Antella,1409,693,716
46,Valencia/València,41,Aras de los Olmos,420,238,182
46,Valencia/València,3,Atzeneta d'Albaida,1229,636,593
46,Valencia/València,44,Ayora,5441,2750,2691
46,Valencia/València,46,Barx,1335,694,641
46,Valencia/València,45,Barxeta,1637,841,796
46,Valencia/València,47,Bèlgida,721,359,362
46,Valencia/València,48,Bellreguard,4697,2339,2358
46,Valencia/València,49,Bellús,359,171,188
46,Valencia/València,50,Benagéber,217,116,101
46,Valencia/València,51,Benaguasil,11298,5845,5453
46,Valencia/València,52,Benavites,634,307,327
46,Valencia/València,53,Beneixida,705,335,370
46,Valencia/València,54,Benetússer,14999,7442,7557
46,Valencia/València,55,Beniarjó,1836,901,935
46,Valencia/València,56,Beniatjar,231,118,113
46,Valencia/València,57,Benicolet,679,355,324
46,Valencia/València,904,Benicull de Xúquer,967,486,481
46,Valencia/València,60,Benifaió,11965,5918,6047
46,Valencia/València,59,Benifairó de la Valldigna,1646,811,835
46,Valencia/València,58,Benifairó de les Valls,2236,1114,1122
46,Valencia/València,61,Beniflá,465,235,230
46,Valencia/València,62,Benigánim,6411,3291,3120
46,Valencia/València,63,Benimodo,2301,1181,1120
46,Valencia/València,64,Benimuslem,677,346,331
46,Valencia/València,65,Beniparrell,1980,1021,959
46,Valencia/València,66,Benirredrà,1650,799,851
46,Valencia/València,67,Benisanó,2305,1156,1149
46,Valencia/València,68,Benissoda,414,228,186
46,Valencia/València,69,Benisuera,196,102,94
46,Valencia/València,70,Bétera,21868,10978,10890
46,Valencia/València,71,Bicorp,556,276,280
46,Valencia/València,72,Bocairent,4456,2255,2201
46,Valencia/València,73,Bolbaite,1489,766,723
46,Valencia/València,74,Bonrepòs i Mirambell,3454,1689,1765
46,Valencia/València,75,Bufali,184,99,85
46,Valencia/València,76,Bugarra,831,417,414
46,Valencia/València,77,Buñol,9927,5007,4920
46,Valencia/València,78,Burjassot,38175,18563,19612
46,Valencia/València,79,Calles,464,257,207
46,Valencia/València,80,Camporrobles,1402,712,690
46,Valencia/València,81,Canals,14024,7109,6915
46,Valencia/València,82,Canet d'En Berenguer,6014,3096,2918
46,Valencia/València,83,Carcaixent,20779,10274,10505
46,Valencia/València,84,Càrcer,2051,994,1057
46,Valencia/València,85,Carlet,15296,7650,7646
46,Valencia/València,86,Carrícola,98,47,51
46,Valencia/València,87,Casas Altas,158,88,70
46,Valencia/València,88,Casas Bajas,221,116,105
46,Valencia/València,89,Casinos,2864,1481,1383
46,Valencia/València,90,Castelló de Rugat,2326,1182,1144
46,Valencia/València,91,Castellonet de la Conquesta,169,95,74
46,Valencia/València,92,Castielfabib,301,151,150
46,Valencia/València,93,Catadau,2766,1388,1378
46,Valencia/València,94,Catarroja,27697,13758,13939
46,Valencia/València,95,Caudete de las Fuentes,747,404,343
46,Valencia/València,96,Cerdà,407,212,195
46,Valencia/València,107,Chella,2776,1388,1388
46,Valencia/València,106,Chelva,1627,838,789
46,Valencia/València,108,Chera,582,316,266
46,Valencia/València,109,Cheste,8615,4435,4180
46,Valencia/València,111,Chiva,15185,7860,7325
46,Valencia/València,112,Chulilla,718,390,328
46,Valencia/València,97,Cofrentes,1026,521,505
46,Valencia/València,98,Corbera,3304,1648,1656
46,Valencia/València,99,Cortes de Pallás,1000,528,472
46,Valencia/València,100,Cotes,388,197,191
46,Valencia/València,105,Cullera,22736,11448,11288
46,Valencia/València,113,Daimús,3130,1588,1542
46,Valencia/València,114,Domeño,723,368,355
46,Valencia/València,115,Dos Aguas,496,288,208
46,Valencia/València,116,"Eliana, l'",17292,8547,8745
46,Valencia/València,117,Emperador,633,327,306
46,Valencia/València,118,Enguera,5903,3046,2857
46,Valencia/València,119,"Ènova, l'",974,493,481
46,Valencia/València,120,Estivella,1384,672,712
46,Valencia/València,121,Estubeny,125,66,59
46,Valencia/València,122,Faura,3602,1821,1781
46,Valencia/València,123,Favara,2456,1230,1226
46,Valencia/València,126,Foios,7034,3462,3572
46,Valencia/València,128,"Font de la Figuera, la",2223,1125,1098
46,Valencia/València,127,"Font d'En Carròs, la",4083,2063,2020
46,Valencia/València,124,Fontanars dels Alforins,1020,520,500
46,Valencia/València,125,Fortaleny,1035,504,531
46,Valencia/València,129,Fuenterrobles,719,383,336
46,Valencia/València,131,Gandia,79010,39651,39359
46,Valencia/València,902,Gátova,429,208,221
46,Valencia/València,130,Gavarda,1123,545,578
46,Valencia/València,132,Genovés,2865,1446,1419
46,Valencia/València,133,Gestalgar,737,377,360
46,Valencia/València,134,Gilet,3328,1725,1603
46,Valencia/València,135,Godella,13217,6380,6837
46,Valencia/València,136,Godelleta,3371,1737,1634
46,Valencia/València,137,"Granja de la Costera, la",387,200,187
46,Valencia/València,138,Guadasséquies,447,237,210
46,Valencia/València,139,Guadassuar,6115,3035,3080
46,Valencia/València,140,Guardamar de la Safor,497,263,234
46,Valencia/València,141,Higueruelas,509,266,243
46,Valencia/València,142,Jalance,975,489,486
46,Valencia/València,144,Jarafuel,824,424,400
46,Valencia/València,154,Llanera de Ranes,1143,596,547
46,Valencia/València,155,Llaurí,1333,671,662
46,Valencia/València,147,Llíria,23542,11989,11553
46,Valencia/València,152,Llocnou de la Corona,165,89,76
46,Valencia/València,153,Llocnou de Sant Jeroni,583,287,296
46,Valencia/València,151,Llocnou d'En Fenollet,920,481,439
46,Valencia/València,156,Llombai,2817,1415,1402
46,Valencia/València,157,"Llosa de Ranes, la",4066,2106,1960
46,Valencia/València,150,Llutxent,2508,1274,1234
46,Valencia/València,148,Loriguilla,1827,936,891
46,Valencia/València,149,Losa del Obispo,574,291,283
46,Valencia/València,158,Macastre,1308,687,621
46,Valencia/València,159,Manises,31066,15356,15710
46,Valencia/València,160,Manuel,2546,1244,1302
46,Valencia/València,161,Marines,1850,940,910
46,Valencia/València,162,Massalavés,1640,848,792
46,Valencia/València,163,Massalfassar,2388,1185,1203
46,Valencia/València,164,Massamagrell,15550,7720,7830
46,Valencia/València,165,Massanassa,8809,4380,4429
46,Valencia/València,166,Meliana,10666,5315,5351
46,Valencia/València,167,Millares,451,220,231
46,Valencia/València,168,Miramar,2558,1337,1221
46,Valencia/València,169,Mislata,43800,21450,22350
46,Valencia/València,170,Mogente/Moixent,4737,2419,2318
46,Valencia/València,171,Moncada,21953,10882,11071
46,Valencia/València,173,Montaverner,1815,897,918
46,Valencia/València,174,Montesa,1353,694,659
46,Valencia/València,175,Montitxelvo/Montichelvo,676,346,330
46,Valencia/València,176,Montroy,2902,1536,1366
46,Valencia/València,172,Montserrat,7133,3780,3353
46,Valencia/València,177,Museros,6262,3157,3105
46,Valencia/València,178,Náquera,6009,3114,2895
46,Valencia/València,179,Navarrés,3354,1722,1632
46,Valencia/València,180,Novelé/Novetlè,874,437,437
46,Valencia/València,181,Oliva,28207,14204,14003
46,Valencia/València,183,"Olleria, l'",8630,4352,4278
46,Valencia/València,182,Olocau,1647,863,784
46,Valencia/València,184,Ontinyent,37140,18530,18610
46,Valencia/València,185,Otos,470,240,230
46,Valencia/València,186,Paiporta,24506,12289,12217
46,Valencia/València,187,Palma de Gandía,1819,939,880
46,Valencia/València,188,Palmera,1022,534,488
46,Valencia/València,189,"Palomar, el",595,289,306
46,Valencia/València,190,Paterna,67356,33581,33775
46,Valencia/València,191,Pedralba,2970,1584,1386
46,Valencia/València,192,Petrés,1019,504,515
46,Valencia/València,193,Picanya,11319,5559,5760
46,Valencia/València,194,Picassent,20265,10254,10011
46,Valencia/València,195,Piles,2877,1467,1410
46,Valencia/València,196,Pinet,178,84,94
46,Valencia/València,199,"Pobla de Farnals, la",7677,3911,3766
46,Valencia/València,202,"Pobla de Vallbona, la",22197,11220,10977
46,Valencia/València,200,"Pobla del Duc, la",2547,1250,1297
46,Valencia/València,203,"Pobla Llarga, la",4618,2320,2298
46,Valencia/València,197,Polinyà de Xúquer,2540,1275,1265
46,Valencia/València,198,Potríes,1001,497,504
46,Valencia/València,205,Puçol,19421,9619,9802
46,Valencia/València,201,Puebla de San Miguel,77,45,32
46,Valencia/València,204,Puig,9030,4462,4568
46,Valencia/València,101,Quart de les Valls,1076,517,559
46,Valencia/València,102,Quart de Poblet,25292,12412,12880
46,Valencia/València,103,Quartell,1523,741,782
46,Valencia/València,104,Quatretonda,2468,1253,1215
46,Valencia/València,206,Quesa,735,374,361
46,Valencia/València,207,Rafelbuñol/Rafelbunyol,8670,4278,4392
46,Valencia/València,208,Rafelcofer,1472,696,776
46,Valencia/València,209,Rafelguaraf,2527,1271,1256
46,Valencia/València,210,Ráfol de Salem,426,207,219
46,Valencia/València,212,Real,2330,1228,1102
46,Valencia/València,211,Real de Gandía,2257,1102,1155
46,Valencia/València,213,Requena,21554,10914,10640
46,Valencia/València,214,Riba-roja de Túria,21349,10872,10477
46,Valencia/València,215,Riola,1876,968,908
46,Valencia/València,216,Rocafort,6846,3340,3506
46,Valencia/València,217,Rotglà i Corberà,1194,591,603
46,Valencia/València,218,Rótova,1303,663,640
46,Valencia/València,219,Rugat,193,97,96
46,Valencia/València,220,Sagunto/Sagunt,65238,32198,33040
46,Valencia/València,221,Salem,464,232,232
46,Valencia/València,903,San Antonio de Benagéber,7104,3489,3615
46,Valencia/València,222,Sant Joanet,479,237,242
46,Valencia/València,223,Sedaví,10186,4981,5205
46,Valencia/València,224,Segart,188,95,93
46,Valencia/València,225,Sellent,415,215,200
46,Valencia/València,226,Sempere,46,24,22
46,Valencia/València,227,Senyera,1193,594,599
46,Valencia/València,228,Serra,3356,1763,1593
46,Valencia/València,229,Siete Aguas,1476,780,696
46,Valencia/València,230,Silla,19058,9516,9542
46,Valencia/València,231,Simat de la Valldigna,3705,1918,1787
46,Valencia/València,232,Sinarcas,1174,607,567
46,Valencia/València,233,Sollana,5017,2489,2528
46,Valencia/València,234,Sot de Chera,405,206,199
46,Valencia/València,235,Sueca,29091,14576,14515
46,Valencia/València,236,Sumacàrcer,1259,622,637
46,Valencia/València,237,Tavernes Blanques,9335,4547,4788
46,Valencia/València,238,Tavernes de la Valldigna,18138,9164,8974
46,Valencia/València,239,Teresa de Cofrentes,654,327,327
46,Valencia/València,240,Terrateig,316,163,153
46,Valencia/València,241,Titaguas,508,257,251
46,Valencia/València,242,Torrebaja,463,248,215
46,Valencia/València,243,Torrella,158,86,72
46,Valencia/València,244,Torrent,81402,40741,40661
46,Valencia/València,245,Torres Torres,614,332,282
46,Valencia/València,246,Tous,1301,666,635
46,Valencia/València,247,Tuéjar,1206,663,543
46,Valencia/València,248,Turís,6637,3488,3149
46,Valencia/València,249,Utiel,12429,6250,6179
46,Valencia/València,250,Valencia,797028,381722,415306
46,Valencia/València,251,Vallada,3309,1690,1619
46,Valencia/València,252,Vallanca,160,88,72
46,Valencia/València,253,Vallés,162,88,74
46,Valencia/València,254,Venta del Moro,1443,777,666
46,Valencia/València,256,Vilamarxant,9491,4904,4587
46,Valencia/València,255,Villalonga,4449,2239,2210
46,Valencia/València,257,Villanueva de Castellón,7482,3721,3761
46,Valencia/València,258,Villar del Arzobispo,3777,1913,1864
46,Valencia/València,259,Villargordo del Cabriel,651,340,311
46,Valencia/València,260,Vinalesa,3205,1577,1628
46,Valencia/València,145,Xàtiva,29196,14305,14891
46,Valencia/València,143,Xeraco,6230,3249,2981
46,Valencia/València,146,Xeresa,2294,1157,1137
46,Valencia/València,110,Xirivella,30213,15080,15133
46,Valencia/València,261,Yátova,2136,1114,1022
46,Valencia/València,262,"Yesa, La",256,143,113
46,Valencia/València,263,Zarra,548,304,244
47,Valladolid,1,Adalia,57,31,26
47,Valladolid,2,Aguasal,29,20,9
47,Valladolid,3,Aguilar de Campos,314,174,140
47,Valladolid,4,Alaejos,1494,782,712
47,Valladolid,5,Alcazarén,733,387,346
47,Valladolid,6,Aldea de San Miguel,235,126,109
47,Valladolid,7,Aldeamayor de San Martín,4560,2374,2186
47,Valladolid,8,Almenara de Adaja,29,15,14
47,Valladolid,9,Amusquillo,119,74,45
47,Valladolid,10,Arroyo de la Encomienda,15680,8087,7593
47,Valladolid,11,Ataquines,657,361,296
47,Valladolid,12,Bahabón,160,76,84
47,Valladolid,13,Barcial de la Loma,124,62,62
47,Valladolid,14,Barruelo del Valle,54,34,20
47,Valladolid,15,Becilla de Valderaduey,304,171,133
47,Valladolid,16,Benafarces,96,49,47
47,Valladolid,17,Bercero,216,117,99
47,Valladolid,18,Berceruelo,40,23,17
47,Valladolid,19,Berrueces,111,63,48
47,Valladolid,20,Bobadilla del Campo,314,170,144
47,Valladolid,21,Bocigas,93,51,42
47,Valladolid,22,Bocos de Duero,63,28,35
47,Valladolid,23,Boecillo,3928,2020,1908
47,Valladolid,24,Bolaños de Campos,357,190,167
47,Valladolid,25,Brahojos de Medina,138,70,68
47,Valladolid,26,Bustillo de Chaves,79,47,32
47,Valladolid,27,Cabezón de Pisuerga,3576,1850,1726
47,Valladolid,28,Cabezón de Valderaduey,37,20,17
47,Valladolid,29,Cabreros del Monte,71,38,33
47,Valladolid,30,Campaspero,1311,706,605
47,Valladolid,31,"Campillo, El",230,131,99
47,Valladolid,32,Camporredondo,168,93,75
47,Valladolid,33,Canalejas de Peñafiel,296,161,135
47,Valladolid,34,Canillas de Esgueva,91,51,40
47,Valladolid,35,Carpio,1097,582,515
47,Valladolid,36,Casasola de Arión,304,173,131
47,Valladolid,37,Castrejón de Trabancos,216,109,107
47,Valladolid,38,Castrillo de Duero,144,76,68
47,Valladolid,39,Castrillo-Tejeriego,197,113,84
47,Valladolid,40,Castrobol,70,34,36
47,Valladolid,41,Castrodeza,170,101,69
47,Valladolid,42,Castromembibre,73,38,35
47,Valladolid,43,Castromonte,358,200,158
47,Valladolid,44,Castronuevo de Esgueva,378,207,171
47,Valladolid,45,Castronuño,954,476,478
47,Valladolid,46,Castroponce,166,92,74
47,Valladolid,47,Castroverde de Cerrato,245,151,94
47,Valladolid,48,Ceinos de Campos,261,140,121
47,Valladolid,49,Cervillego de la Cruz,100,59,41
47,Valladolid,50,Cigales,4871,2478,2393
47,Valladolid,51,Ciguñuela,403,223,180
47,Valladolid,52,Cistérniga,8449,4352,4097
47,Valladolid,53,Cogeces de Íscar,159,89,70
47,Valladolid,54,Cogeces del Monte,813,444,369
47,Valladolid,55,Corcos,225,120,105
47,Valladolid,56,Corrales de Duero,100,56,44
47,Valladolid,57,Cubillas de Santa Marta,274,162,112
47,Valladolid,58,Cuenca de Campos,227,119,108
47,Valladolid,59,Curiel de Duero,130,83,47
47,Valladolid,60,Encinas de Esgueva,290,160,130
47,Valladolid,61,Esguevillas de Esgueva,288,155,133
47,Valladolid,62,Fombellida,196,111,85
47,Valladolid,63,Fompedraza,124,70,54
47,Valladolid,64,Fontihoyuelo,34,19,15
47,Valladolid,65,Fresno el Viejo,990,515,475
47,Valladolid,66,Fuensaldaña,1435,734,701
47,Valladolid,67,Fuente el Sol,207,113,94
47,Valladolid,68,Fuente-Olmedo,44,21,23
47,Valladolid,69,Gallegos de Hornija,147,74,73
47,Valladolid,70,Gatón de Campos,38,21,17
47,Valladolid,71,Geria,508,257,251
47,Valladolid,73,Herrín de Campos,155,79,76
47,Valladolid,74,Hornillos de Eresma,184,97,87
47,Valladolid,75,Íscar,6844,3477,3367
47,Valladolid,76,Laguna de Duero,22455,11298,11157
47,Valladolid,77,Langayo,310,186,124
47,Valladolid,79,Llano de Olmedo,74,44,30
47,Valladolid,78,Lomoviejo,197,103,94
47,Valladolid,80,Manzanillo,66,35,31
47,Valladolid,81,Marzales,56,26,30
47,Valladolid,82,Matapozuelos,1038,520,518
47,Valladolid,83,Matilla de los Caños,95,55,40
47,Valladolid,84,Mayorga,1914,941,973
47,Valladolid,86,Medina de Rioseco,4967,2431,2536
47,Valladolid,85,Medina del Campo,21594,10506,11088
47,Valladolid,87,Megeces,455,242,213
47,Valladolid,88,Melgar de Abajo,133,77,56
47,Valladolid,89,Melgar de Arriba,195,105,90
47,Valladolid,90,Mojados,3295,1722,1573
47,Valladolid,91,Monasterio de Vega,103,54,49
47,Valladolid,92,Montealegre de Campos,126,73,53
47,Valladolid,93,Montemayor de Pililla,977,519,458
47,Valladolid,94,Moral de la Reina,208,118,90
47,Valladolid,95,Moraleja de las Panaderas,42,27,15
47,Valladolid,96,Morales de Campos,166,85,81
47,Valladolid,97,Mota del Marqués,393,205,188
47,Valladolid,98,Mucientes,731,375,356
47,Valladolid,99,"Mudarra, La",179,95,84
47,Valladolid,100,Muriel,169,92,77
47,Valladolid,101,Nava del Rey,2103,1084,1019
47,Valladolid,102,Nueva Villa de las Torres,321,182,139
47,Valladolid,103,Olivares de Duero,325,180,145
47,Valladolid,104,Olmedo,3868,1904,1964
47,Valladolid,105,Olmos de Esgueva,234,125,109
47,Valladolid,106,Olmos de Peñafiel,69,36,33
47,Valladolid,109,Palazuelo de Vedija,210,114,96
47,Valladolid,110,"Parrilla, La",523,259,264
47,Valladolid,111,"Pedraja de Portillo, La",1169,598,571
47,Valladolid,112,Pedrajas de San Esteban,3628,1866,1762
47,Valladolid,113,Pedrosa del Rey,191,105,86
47,Valladolid,114,Peñafiel,5628,2842,2786
47,Valladolid,115,Peñaflor de Hornija,343,189,154
47,Valladolid,116,Pesquera de Duero,515,285,230
47,Valladolid,117,Piña de Esgueva,351,176,175
47,Valladolid,118,Piñel de Abajo,198,108,90
47,Valladolid,119,Piñel de Arriba,119,64,55
47,Valladolid,121,Pollos,649,335,314
47,Valladolid,122,Portillo,2534,1307,1227
47,Valladolid,123,Pozal de Gallinas,550,289,261
47,Valladolid,124,Pozaldez,574,306,268
47,Valladolid,125,Pozuelo de la Orden,60,36,24
47,Valladolid,126,Puras,52,29,23
47,Valladolid,127,Quintanilla de Arriba,174,94,80
47,Valladolid,129,Quintanilla de Onésimo,1137,593,544
47,Valladolid,130,Quintanilla de Trigueros,113,59,54
47,Valladolid,128,Quintanilla del Molar,69,32,37
47,Valladolid,131,Rábano,202,111,91
47,Valladolid,132,Ramiro,46,29,17
47,Valladolid,133,Renedo de Esgueva,3259,1694,1565
47,Valladolid,134,Roales de Campos,198,110,88
47,Valladolid,135,Robladillo,98,58,40
47,Valladolid,137,Roturas,32,18,14
47,Valladolid,138,Rubí de Bracamonte,279,159,120
47,Valladolid,139,Rueda,1416,738,678
47,Valladolid,140,Saelices de Mayorga,134,77,57
47,Valladolid,141,Salvador de Zapardiel,151,84,67
47,Valladolid,142,San Cebrián de Mazote,183,108,75
47,Valladolid,143,San Llorente,152,86,66
47,Valladolid,144,San Martín de Valvení,98,56,42
47,Valladolid,145,San Miguel del Arroyo,745,390,355
47,Valladolid,146,San Miguel del Pino,293,164,129
47,Valladolid,147,San Pablo de la Moraleja,136,69,67
47,Valladolid,148,San Pedro de Latarce,555,301,254
47,Valladolid,149,San Pelayo,46,21,25
47,Valladolid,150,San Román de Hornija,391,188,203
47,Valladolid,151,San Salvador,36,20,16
47,Valladolid,156,San Vicente del Palacio,193,105,88
47,Valladolid,152,Santa Eufemia del Arroyo,95,49,46
47,Valladolid,153,Santervás de Campos,136,72,64
47,Valladolid,154,Santibáñez de Valcorba,178,99,79
47,Valladolid,155,Santovenia de Pisuerga,4005,2055,1950
47,Valladolid,157,Sardón de Duero,671,351,320
47,Valladolid,158,"Seca, La",1099,567,532
47,Valladolid,159,Serrada,1221,645,576
47,Valladolid,160,Siete Iglesias de Trabancos,547,285,262
47,Valladolid,161,Simancas,5360,2719,2641
47,Valladolid,162,Tamariz de Campos,75,40,35
47,Valladolid,163,Tiedra,328,168,160
47,Valladolid,164,Tordehumos,468,236,232
47,Valladolid,165,Tordesillas,9186,4702,4484
47,Valladolid,169,Torre de Esgueva,77,36,41
47,Valladolid,170,Torre de Peñafiel,46,26,20
47,Valladolid,166,Torrecilla de la Abadesa,313,155,158
47,Valladolid,167,Torrecilla de la Orden,289,144,145
47,Valladolid,168,Torrecilla de la Torre,36,25,11
47,Valladolid,171,Torrelobatón,497,252,245
47,Valladolid,172,Torrescárcela,173,92,81
47,Valladolid,173,Traspinedo,1079,585,494
47,Valladolid,174,Trigueros del Valle,333,183,150
47,Valladolid,175,Tudela de Duero,8836,4555,4281
47,Valladolid,176,"Unión de Campos, La",255,131,124
47,Valladolid,177,Urones de Castroponce,116,65,51
47,Valladolid,178,Urueña,203,112,91
47,Valladolid,179,Valbuena de Duero,490,262,228
47,Valladolid,180,Valdearcos de la Vega,116,60,56
47,Valladolid,181,Valdenebro de los Valles,217,111,106
47,Valladolid,182,Valdestillas,1780,926,854
47,Valladolid,183,Valdunquillo,170,81,89
47,Valladolid,186,Valladolid,311501,147458,164043
47,Valladolid,184,Valoria la Buena,698,367,331
47,Valladolid,185,Valverde de Campos,115,68,47
47,Valladolid,187,Vega de Ruiponce,120,68,52
47,Valladolid,188,Vega de Valdetronco,130,72,58
47,Valladolid,189,Velascálvaro,182,104,78
47,Valladolid,190,Velilla,122,62,60
47,Valladolid,191,Velliza,114,67,47
47,Valladolid,192,Ventosa de la Cuesta,126,71,55
47,Valladolid,193,Viana de Cega,1987,1029,958
47,Valladolid,195,Villabáñez,537,294,243
47,Valladolid,196,Villabaruz de Campos,42,20,22
47,Valladolid,197,Villabrágima,1091,569,522
47,Valladolid,198,Villacarralón,82,50,32
47,Valladolid,199,Villacid de Campos,91,53,38
47,Valladolid,200,Villaco,103,62,41
47,Valladolid,203,Villafrades de Campos,91,44,47
47,Valladolid,204,Villafranca de Duero,311,161,150
47,Valladolid,205,Villafrechós,546,297,249
47,Valladolid,206,Villafuerte,117,66,51
47,Valladolid,207,Villagarcía de Campos,371,219,152
47,Valladolid,208,Villagómez la Nueva,67,36,31
47,Valladolid,209,Villalán de Campos,44,25,19
47,Valladolid,210,Villalar de los Comuneros,468,229,239
47,Valladolid,211,Villalba de la Loma,60,30,30
47,Valladolid,212,Villalba de los Alcores,461,251,210
47,Valladolid,213,Villalbarba,133,66,67
47,Valladolid,214,Villalón de Campos,1858,917,941
47,Valladolid,215,Villamuriel de Campos,64,32,32
47,Valladolid,216,Villán de Tordesillas,137,75,62
47,Valladolid,217,Villanubla,2367,1233,1134
47,Valladolid,218,Villanueva de Duero,1200,624,576
47,Valladolid,219,Villanueva de la Condesa,64,34,30
47,Valladolid,220,Villanueva de los Caballeros,214,107,107
47,Valladolid,221,Villanueva de los Infantes,118,69,49
47,Valladolid,222,Villanueva de San Mancio,109,56,53
47,Valladolid,223,Villardefrades,189,103,86
47,Valladolid,224,Villarmentero de Esgueva,109,54,55
47,Valladolid,225,Villasexmir,89,50,39
47,Valladolid,226,Villavaquerín,201,112,89
47,Valladolid,227,Villavellid,63,38,25
47,Valladolid,228,Villaverde de Medina,535,287,248
47,Valladolid,229,Villavicencio de los Caballeros,248,120,128
47,Valladolid,194,Viloria,368,195,173
47,Valladolid,230,Wamba,355,189,166
47,Valladolid,231,Zaratán,5843,3000,2843
47,Valladolid,232,"Zarza, La",124,70,54
49,Zamora,2,Abezames,78,40,38
49,Zamora,3,Alcañices,1207,600,607
49,Zamora,4,Alcubilla de Nogales,145,75,70
49,Zamora,5,Alfaraz de Sayago,168,91,77
49,Zamora,6,Algodre,172,92,80
49,Zamora,7,Almaraz de Duero,405,204,201
49,Zamora,8,Almeida de Sayago,561,284,277
49,Zamora,9,Andavías,478,245,233
49,Zamora,10,Arcenillas,406,207,199
49,Zamora,11,Arcos de la Polvorosa,259,136,123
49,Zamora,12,Argañín,80,40,40
49,Zamora,13,Argujillo,324,165,159
49,Zamora,14,Arquillinos,135,70,65
49,Zamora,15,Arrabalde,278,129,149
49,Zamora,16,Aspariegos,294,145,149
49,Zamora,17,Asturianos,275,147,128
49,Zamora,18,Ayoó de Vidriales,372,203,169
49,Zamora,19,Barcial del Barco,279,152,127
49,Zamora,20,Belver de los Montes,339,184,155
49,Zamora,21,Benavente,19259,9366,9893
49,Zamora,22,Benegiles,368,196,172
49,Zamora,23,Bermillo de Sayago,1181,619,562
49,Zamora,24,"Bóveda de Toro, La",863,439,424
49,Zamora,25,Bretó,198,113,85
49,Zamora,26,Bretocino,253,137,116
49,Zamora,27,Brime de Sog,178,85,93
49,Zamora,28,Brime de Urz,127,72,55
49,Zamora,29,Burganes de Valverde,754,396,358
49,Zamora,30,Bustillo del Oro,97,51,46
49,Zamora,31,Cabañas de Sayago,163,88,75
49,Zamora,32,Calzadilla de Tera,386,175,211
49,Zamora,33,Camarzana de Tera,929,461,468
49,Zamora,34,Cañizal,501,260,241
49,Zamora,35,Cañizo,274,137,137
49,Zamora,36,Carbajales de Alba,634,327,307
49,Zamora,37,Carbellino,226,119,107
49,Zamora,38,Casaseca de Campeán,125,69,56
49,Zamora,39,Casaseca de las Chanas,419,233,186
49,Zamora,40,Castrillo de la Guareña,132,69,63
49,Zamora,41,Castrogonzalo,495,261,234
49,Zamora,42,Castronuevo,274,136,138
49,Zamora,43,Castroverde de Campos,376,195,181
49,Zamora,44,Cazurra,82,43,39
49,Zamora,46,Cerecinos de Campos,336,181,155
49,Zamora,47,Cerecinos del Carrizal,135,78,57
49,Zamora,48,Cernadilla,163,78,85
49,Zamora,50,Cobreros,620,338,282
49,Zamora,52,Coomonte,220,110,110
49,Zamora,53,Coreses,1142,588,554
49,Zamora,54,Corrales del Vino,1088,541,547
49,Zamora,55,Cotanes del Monte,124,68,56
49,Zamora,56,Cubillos,351,176,175
49,Zamora,57,Cubo de Benavente,131,75,56
49,Zamora,58,"Cubo de Tierra del Vino, El",389,213,176
49,Zamora,59,Cuelgamures,110,67,43
49,Zamora,61,Entrala,169,90,79
49,Zamora,62,Espadañedo,150,74,76
49,Zamora,63,Faramontanos de Tábara,400,206,194
49,Zamora,64,Fariza,601,308,293
49,Zamora,65,Fermoselle,1450,754,696
49,Zamora,66,Ferreras de Abajo,599,302,297
49,Zamora,67,Ferreras de Arriba,447,235,212
49,Zamora,68,Ferreruela,543,294,249
49,Zamora,69,Figueruela de Arriba,419,203,216
49,Zamora,71,Fonfría,921,474,447
49,Zamora,75,Fresno de la Polvorosa,163,82,81
49,Zamora,76,Fresno de la Ribera,395,213,182
49,Zamora,77,Fresno de Sayago,228,120,108
49,Zamora,78,Friera de Valverde,215,107,108
49,Zamora,79,Fuente Encalada,115,67,48
49,Zamora,80,Fuentelapeña,814,428,386
49,Zamora,82,Fuentes de Ropel,478,241,237
49,Zamora,81,Fuentesaúco,1918,967,951
49,Zamora,83,Fuentesecas,72,36,36
49,Zamora,84,Fuentespreadas,336,182,154
49,Zamora,85,Galende,1361,708,653
49,Zamora,86,Gallegos del Pan,136,77,59
49,Zamora,87,Gallegos del Río,601,321,280
49,Zamora,88,Gamones,96,51,45
49,Zamora,90,Gema,238,123,115
49,Zamora,91,Granja de Moreruela,302,160,142
49,Zamora,92,Granucillo,169,86,83
49,Zamora,93,Guarrate,369,199,170
49,Zamora,94,Hermisende,296,162,134
49,Zamora,95,"Hiniesta, La",339,172,167
49,Zamora,96,Jambrina,197,100,97
49,Zamora,97,Justel,100,56,44
49,Zamora,98,Losacino,249,136,113
49,Zamora,99,Losacio,125,70,55
49,Zamora,100,Lubián,358,185,173
49,Zamora,101,Luelmo,206,105,101
49,Zamora,102,"Maderal, El",233,117,116
49,Zamora,103,Madridanos,508,261,247
49,Zamora,104,Mahide,384,208,176
49,Zamora,105,Maire de Castroponce,163,86,77
49,Zamora,107,Malva,167,82,85
49,Zamora,108,Manganeses de la Lampreana,552,270,282
49,Zamora,109,Manganeses de la Polvorosa,756,366,390
49,Zamora,110,Manzanal de Arriba,393,201,192
49,Zamora,112,Manzanal de los Infantes,142,80,62
49,Zamora,111,Manzanal del Barco,155,79,76
49,Zamora,113,Matilla de Arzón,193,109,84
49,Zamora,114,Matilla la Seca,56,27,29
49,Zamora,115,Mayalde,209,108,101
49,Zamora,116,Melgar de Tera,423,209,214
49,Zamora,117,Micereces de Tera,530,266,264
49,Zamora,118,Milles de la Polvorosa,239,130,109
49,Zamora,119,Molacillos,278,147,131
49,Zamora,120,Molezuelas de la Carballeda,90,50,40
49,Zamora,121,Mombuey,433,234,199
49,Zamora,122,Monfarracinos,924,477,447
49,Zamora,123,Montamarta,618,319,299
49,Zamora,124,Moral de Sayago,304,171,133
49,Zamora,126,Moraleja de Sayago,260,137,123
49,Zamora,125,Moraleja del Vino,1654,864,790
49,Zamora,128,Morales de Rey,669,336,333
49,Zamora,129,Morales de Toro,1063,544,519
49,Zamora,130,Morales de Valverde,218,112,106
49,Zamora,127,Morales del Vino,2858,1488,1370
49,Zamora,131,Moralina,342,171,171
49,Zamora,132,Moreruela de los Infanzones,379,192,187
49,Zamora,133,Moreruela de Tábara,360,189,171
49,Zamora,134,Muelas de los Caballeros,209,107,102
49,Zamora,135,Muelas del Pan,747,381,366
49,Zamora,136,Muga de Sayago,397,193,204
49,Zamora,137,Navianos de Valverde,205,113,92
49,Zamora,138,Olmillos de Castro,281,149,132
49,Zamora,139,Otero de Bodas,204,109,95
49,Zamora,141,Pajares de la Lampreana,419,212,207
49,Zamora,143,Palacios de Sanabria,272,133,139
49,Zamora,142,Palacios del Pan,274,139,135
49,Zamora,145,Pedralba de la Pradería,300,160,140
49,Zamora,146,"Pego, El",348,177,171
49,Zamora,147,Peleagonzalo,313,159,154
49,Zamora,148,Peleas de Abajo,236,121,115
49,Zamora,149,Peñausende,467,233,234
49,Zamora,150,Peque,176,78,98
49,Zamora,151,"Perdigón, El",792,415,377
49,Zamora,152,Pereruela,658,352,306
49,Zamora,153,Perilla de Castro,189,93,96
49,Zamora,154,Pías,149,80,69
49,Zamora,155,Piedrahita de Castro,118,64,54
49,Zamora,156,Pinilla de Toro,272,145,127
49,Zamora,157,Pino del Oro,189,101,88
49,Zamora,158,"Piñero, El",254,132,122
49,Zamora,160,Pobladura de Valderaduey,50,28,22
49,Zamora,159,Pobladura del Valle,331,170,161
49,Zamora,162,Porto,216,117,99
49,Zamora,163,Pozoantiguo,274,140,134
49,Zamora,164,Pozuelo de Tábara,164,78,86
49,Zamora,165,Prado,74,42,32
49,Zamora,166,Puebla de Sanabria,1540,731,809
49,Zamora,167,Pueblica de Valverde,241,126,115
49,Zamora,170,Quintanilla de Urz,123,62,61
49,Zamora,168,Quintanilla del Monte,103,49,54
49,Zamora,169,Quintanilla del Olmo,38,19,19
49,Zamora,171,Quiruelas de Vidriales,762,379,383
49,Zamora,172,Rabanales,654,345,309
49,Zamora,173,Rábano de Aliste,445,223,222
49,Zamora,174,Requejo,181,98,83
49,Zamora,175,Revellinos,285,153,132
49,Zamora,176,Riofrío de Aliste,819,438,381
49,Zamora,177,Rionegro del Puente,319,163,156
49,Zamora,178,Roales,832,434,398
49,Zamora,179,Robleda-Cervantes,482,254,228
49,Zamora,180,Roelos de Sayago,184,91,93
49,Zamora,181,Rosinos de la Requejada,424,222,202
49,Zamora,183,Salce,110,55,55
49,Zamora,184,Samir de los Caños,205,107,98
49,Zamora,185,San Agustín del Pozo,206,105,101
49,Zamora,186,San Cebrián de Castro,284,139,145
49,Zamora,187,San Cristóbal de Entreviñas,1545,804,741
49,Zamora,188,San Esteban del Molar,155,90,65
49,Zamora,189,San Justo,272,148,124
49,Zamora,190,San Martín de Valderaduey,79,41,38
49,Zamora,191,San Miguel de la Ribera,338,172,166
49,Zamora,192,San Miguel del Valle,174,84,90
49,Zamora,193,San Pedro de Ceque,561,286,275
49,Zamora,194,San Pedro de la Nave-Almendra,383,190,193
49,Zamora,208,San Vicente de la Cabeza,466,252,214
49,Zamora,209,San Vitero,618,338,280
49,Zamora,197,Santa Clara de Avedillo,192,96,96
49,Zamora,199,Santa Colomba de las Monjas,292,145,147
49,Zamora,200,Santa Cristina de la Polvorosa,1161,578,583
49,Zamora,201,Santa Croya de Tera,348,181,167
49,Zamora,202,Santa Eufemia del Barco,218,128,90
49,Zamora,203,Santa María de la Vega,370,191,179
49,Zamora,204,Santa María de Valverde,83,38,45
49,Zamora,205,Santibáñez de Tera,450,229,221
49,Zamora,206,Santibáñez de Vidriales,1140,573,567
49,Zamora,207,Santovenia,304,151,153
49,Zamora,210,Sanzoles,571,291,280
49,Zamora,214,Tábara,838,436,402
49,Zamora,216,Tapioles,180,102,78
49,Zamora,219,Toro,9627,4731,4896
49,Zamora,220,"Torre del Valle, La",170,90,80
49,Zamora,221,Torregamones,308,165,143
49,Zamora,222,Torres del Carrizal,459,237,222
49,Zamora,223,Trabazos,1012,533,479
49,Zamora,224,Trefacio,194,98,96
49,Zamora,225,Uña de Quintana,175,93,82
49,Zamora,226,Vadillo de la Guareña,311,161,150
49,Zamora,227,Valcabado,342,171,171
49,Zamora,228,Valdefinjas,61,37,24
49,Zamora,229,Valdescorriel,158,78,80
49,Zamora,230,Vallesa de la Guareña,115,61,54
49,Zamora,231,Vega de Tera,394,194,200
49,Zamora,232,Vega de Villalobos,122,56,66
49,Zamora,233,Vegalatrave,114,65,49
49,Zamora,234,Venialbo,464,247,217
49,Zamora,235,Vezdemarbán,532,267,265
49,Zamora,236,Vidayanes,97,47,50
49,Zamora,237,Videmala,158,82,76
49,Zamora,238,Villabrázaro,284,153,131
49,Zamora,239,Villabuena del Puente,813,420,393
49,Zamora,240,Villadepera,253,136,117
49,Zamora,241,Villaescusa,293,154,139
49,Zamora,242,Villafáfila,567,291,276
49,Zamora,243,Villaferrueña,118,59,59
49,Zamora,244,Villageriz,47,27,20
49,Zamora,245,Villalazán,317,158,159
49,Zamora,246,Villalba de la Lampreana,267,144,123
49,Zamora,247,Villalcampo,537,272,265
49,Zamora,248,Villalobos,303,145,158
49,Zamora,249,Villalonso,91,48,43
49,Zamora,250,Villalpando,1610,803,807
49,Zamora,251,Villalube,199,105,94
49,Zamora,252,Villamayor de Campos,422,214,208
49,Zamora,255,Villamor de los Escuderos,450,235,215
49,Zamora,256,Villanázar,327,165,162
49,Zamora,257,Villanueva de Azoague,327,164,163
49,Zamora,258,Villanueva de Campeán,143,76,67
49,Zamora,259,Villanueva de las Peras,116,62,54
49,Zamora,260,Villanueva del Campo,954,465,489
49,Zamora,263,Villar de Fallaves,62,33,29
49,Zamora,264,Villar del Buey,700,368,332
49,Zamora,261,Villaralbo,1904,969,935
49,Zamora,262,Villardeciervos,456,221,235
49,Zamora,265,Villardiegua de la Ribera,147,74,73
49,Zamora,266,Villárdiga,96,53,43
49,Zamora,267,Villardondiego,108,65,43
49,Zamora,268,Villarrín de Campos,510,273,237
49,Zamora,269,Villaseco del Pan,249,115,134
49,Zamora,270,Villavendimio,177,104,73
49,Zamora,272,Villaveza de Valverde,101,49,52
49,Zamora,271,Villaveza del Agua,225,117,108
49,Zamora,273,Viñas,225,119,106
49,Zamora,275,Zamora,65362,30780,34582
50,Zaragoza,1,Abanto,127,66,61
50,Zaragoza,2,Acered,243,146,97
50,Zaragoza,3,Agón,167,89,78
50,Zaragoza,4,Aguarón,848,450,398
50,Zaragoza,5,Aguilón,254,134,120
50,Zaragoza,6,Ainzón,1214,618,596
50,Zaragoza,7,Aladrén,60,39,21
50,Zaragoza,8,Alagón,7167,3617,3550
50,Zaragoza,9,Alarba,161,90,71
50,Zaragoza,10,Alberite de San Juan,97,59,38
50,Zaragoza,11,Albeta,149,72,77
50,Zaragoza,12,Alborge,118,58,60
50,Zaragoza,13,Alcalá de Ebro,284,134,150
50,Zaragoza,14,Alcalá de Moncayo,193,114,79
50,Zaragoza,15,Alconchel de Ariza,90,53,37
50,Zaragoza,16,Aldehuela de Liestos,51,32,19
50,Zaragoza,17,Alfajarín,2259,1156,1103
50,Zaragoza,18,Alfamén,1609,882,727
50,Zaragoza,19,Alforque,86,47,39
50,Zaragoza,20,Alhama de Aragón,1124,591,533
50,Zaragoza,21,Almochuel,42,21,21
50,Zaragoza,22,"Almolda, La",611,314,297
50,Zaragoza,23,Almonacid de la Cuba,252,131,121
50,Zaragoza,24,Almonacid de la Sierra,781,438,343
50,Zaragoza,25,"Almunia de Doña Godina, La",7792,4032,3760
50,Zaragoza,26,Alpartir,570,293,277
50,Zaragoza,27,Ambel,281,137,144
50,Zaragoza,28,Anento,126,72,54
50,Zaragoza,29,Aniñón,801,441,360
50,Zaragoza,30,Añón de Moncayo,213,127,86
50,Zaragoza,31,Aranda de Moncayo,198,122,76
50,Zaragoza,32,Arándiga,385,197,188
50,Zaragoza,33,Ardisa,83,52,31
50,Zaragoza,34,Ariza,1227,621,606
50,Zaragoza,35,Artieda,90,51,39
50,Zaragoza,36,Asín,115,53,62
50,Zaragoza,37,Atea,152,86,66
50,Zaragoza,38,Ateca,2099,1095,1004
50,Zaragoza,39,Azuara,680,379,301
50,Zaragoza,40,Badules,100,52,48
50,Zaragoza,41,Bagüés,20,11,9
50,Zaragoza,42,Balconchán,14,6,8
50,Zaragoza,43,Bárboles,327,189,138
50,Zaragoza,44,Bardallur,325,159,166
50,Zaragoza,45,Belchite,1655,856,799
50,Zaragoza,46,Belmonte de Gracián,238,133,105
50,Zaragoza,47,Berdejo,63,38,25
50,Zaragoza,48,Berrueco,42,21,21
50,Zaragoza,901,Biel,168,98,70
50,Zaragoza,50,Bijuesca,114,71,43
50,Zaragoza,51,Biota,1073,552,521
50,Zaragoza,52,Bisimbre,99,53,46
50,Zaragoza,53,Boquiñeni,956,486,470
50,Zaragoza,54,Bordalba,71,43,28
50,Zaragoza,55,Borja,5057,2561,2496
50,Zaragoza,56,Botorrita,532,293,239
50,Zaragoza,57,Brea de Aragón,1795,897,898
50,Zaragoza,58,Bubierca,84,45,39
50,Zaragoza,59,Bujaraloz,1054,545,509
50,Zaragoza,60,Bulbuente,235,121,114
50,Zaragoza,61,Bureta,268,138,130
50,Zaragoza,62,"Burgo de Ebro, El",2363,1218,1145
50,Zaragoza,63,"Buste, El",82,43,39
50,Zaragoza,64,Cabañas de Ebro,553,297,256
50,Zaragoza,65,Cabolafuente,44,22,22
50,Zaragoza,66,Cadrete,3293,1724,1569
50,Zaragoza,67,Calatayud,21174,10506,10668
50,Zaragoza,68,Calatorao,3015,1603,1412
50,Zaragoza,69,Calcena,65,38,27
50,Zaragoza,70,Calmarza,77,40,37
50,Zaragoza,71,Campillo de Aragón,152,85,67
50,Zaragoza,72,Carenas,184,99,85
50,Zaragoza,73,Cariñena,3572,1860,1712
50,Zaragoza,74,Caspe,9885,5153,4732
50,Zaragoza,75,Castejón de Alarba,95,55,40
50,Zaragoza,76,Castejón de las Armas,118,64,54
50,Zaragoza,77,Castejón de Valdejasa,257,131,126
50,Zaragoza,78,Castiliscar,310,153,157
50,Zaragoza,79,Cervera de la Cañada,318,170,148
50,Zaragoza,80,Cerveruela,41,26,15
50,Zaragoza,81,Cetina,677,340,337
50,Zaragoza,92,Chiprana,465,243,222
50,Zaragoza,93,Chodes,147,81,66
50,Zaragoza,82,Cimballa,118,57,61
50,Zaragoza,83,Cinco Olivas,119,56,63
50,Zaragoza,84,Clarés de Ribota,89,51,38
50,Zaragoza,85,Codo,205,104,101
50,Zaragoza,86,Codos,241,149,92
50,Zaragoza,87,Contamina,39,23,16
50,Zaragoza,88,Cosuenda,398,204,194
50,Zaragoza,89,Cuarte de Huerva,10394,5411,4983
50,Zaragoza,90,Cubel,187,94,93
50,Zaragoza,91,"Cuerlas, Las",55,28,27
50,Zaragoza,94,Daroca,2288,1129,1159
50,Zaragoza,95,Ejea de los Caballeros,17180,8828,8352
50,Zaragoza,96,Embid de Ariza,52,26,26
50,Zaragoza,98,Encinacorba,239,122,117
50,Zaragoza,99,Épila,4746,2537,2209
50,Zaragoza,100,Erla,400,204,196
50,Zaragoza,101,Escatrón,1133,561,572
50,Zaragoza,102,Fabara,1255,686,569
50,Zaragoza,104,Farlete,428,209,219
50,Zaragoza,105,Fayón,384,197,187
50,Zaragoza,106,"Fayos, Los",152,78,74
50,Zaragoza,107,Figueruelas,1322,688,634
50,Zaragoza,108,Fombuena,52,29,23
50,Zaragoza,109,"Frago, El",109,66,43
50,Zaragoza,110,"Frasno, El",452,237,215
50,Zaragoza,111,Fréscano,208,113,95
50,Zaragoza,113,Fuendejalón,973,528,445
50,Zaragoza,114,Fuendetodos,172,91,81
50,Zaragoza,115,Fuentes de Ebro,4577,2378,2199
50,Zaragoza,116,Fuentes de Jiloca,280,154,126
50,Zaragoza,117,Gallocanta,154,85,69
50,Zaragoza,118,Gallur,2882,1454,1428
50,Zaragoza,119,Gelsa,1173,615,558
50,Zaragoza,120,Godojos,43,22,21
50,Zaragoza,121,Gotor,366,191,175
50,Zaragoza,122,Grisel,66,42,24
50,Zaragoza,123,Grisén,603,313,290
50,Zaragoza,124,Herrera de los Navarros,576,301,275
50,Zaragoza,125,Ibdes,471,242,229
50,Zaragoza,126,Illueca,3290,1629,1661
50,Zaragoza,128,Isuerre,34,22,12
50,Zaragoza,129,Jaraba,355,188,167
50,Zaragoza,130,Jarque,531,290,241
50,Zaragoza,131,Jaulín,279,150,129
50,Zaragoza,132,"Joyosa, La",936,479,457
50,Zaragoza,133,Lagata,135,75,60
50,Zaragoza,134,Langa del Castillo,141,70,71
50,Zaragoza,135,Layana,127,69,58
50,Zaragoza,136,Lécera,757,401,356
50,Zaragoza,138,Lechón,52,31,21
50,Zaragoza,137,Leciñena,1306,650,656
50,Zaragoza,139,Letux,404,227,177
50,Zaragoza,140,Litago,174,97,77
50,Zaragoza,141,Lituénigo,120,61,59
50,Zaragoza,142,Lobera de Onsella,45,28,17
50,Zaragoza,143,Longares,895,509,386
50,Zaragoza,144,Longás,34,24,10
50,Zaragoza,146,Lucena de Jalón,269,146,123
50,Zaragoza,147,Luceni,1045,525,520
50,Zaragoza,148,Luesia,366,201,165
50,Zaragoza,149,Luesma,50,30,20
50,Zaragoza,150,Lumpiaque,921,480,441
50,Zaragoza,151,Luna,825,437,388
50,Zaragoza,152,Maella,1986,1036,950
50,Zaragoza,153,Magallón,1208,630,578
50,Zaragoza,154,Mainar,157,84,73
50,Zaragoza,155,Malanquilla,123,73,50
50,Zaragoza,156,Maleján,325,167,158
50,Zaragoza,160,Mallén,3714,1978,1736
50,Zaragoza,157,Malón,376,194,182
50,Zaragoza,159,Maluenda,1123,562,561
50,Zaragoza,161,Manchones,131,75,56
50,Zaragoza,162,Mara,190,96,94
50,Zaragoza,163,María de Huerva,5265,2724,2541
50,Zaragoza,902,Marracos,106,58,48
50,Zaragoza,164,Mediana de Aragón,468,234,234
50,Zaragoza,165,Mequinenza,2449,1259,1190
50,Zaragoza,166,Mesones de Isuela,318,158,160
50,Zaragoza,167,Mezalocha,210,120,90
50,Zaragoza,168,Mianos,40,22,18
50,Zaragoza,169,Miedes de Aragón,458,247,211
50,Zaragoza,170,Monegrillo,464,258,206
50,Zaragoza,171,Moneva,117,67,50
50,Zaragoza,172,Monreal de Ariza,226,130,96
50,Zaragoza,173,Monterde,169,97,72
50,Zaragoza,174,Montón,133,81,52
50,Zaragoza,175,Morata de Jalón,1266,621,645
50,Zaragoza,176,Morata de Jiloca,280,163,117
50,Zaragoza,177,Morés,402,218,184
50,Zaragoza,178,Moros,441,231,210
50,Zaragoza,179,Moyuela,278,149,129
50,Zaragoza,180,Mozota,107,55,52
50,Zaragoza,181,Muel,1379,705,674
50,Zaragoza,182,"Muela, La",5062,2624,2438
50,Zaragoza,183,Munébrega,470,249,221
50,Zaragoza,184,Murero,140,79,61
50,Zaragoza,185,Murillo de Gállego,202,116,86
50,Zaragoza,186,Navardún,47,29,18
50,Zaragoza,187,Nigüella,74,43,31
50,Zaragoza,188,Nombrevilla,35,20,15
50,Zaragoza,189,Nonaspe,1064,571,493
50,Zaragoza,190,Novallas,948,511,437
50,Zaragoza,191,Novillas,602,299,303
50,Zaragoza,192,Nuévalos,350,197,153
50,Zaragoza,193,Nuez de Ebro,843,428,415
50,Zaragoza,194,Olvés,117,67,50
50,Zaragoza,195,Orcajo,47,26,21
50,Zaragoza,196,Orera,135,68,67
50,Zaragoza,197,Orés,103,61,42
50,Zaragoza,198,Oseja,48,29,19
50,Zaragoza,199,Osera de Ebro,449,228,221
50,Zaragoza,200,Paniza,758,404,354
50,Zaragoza,201,Paracuellos de Jiloca,587,306,281
50,Zaragoza,202,Paracuellos de la Ribera,172,85,87
50,Zaragoza,203,Pastriz,1364,663,701
50,Zaragoza,204,Pedrola,3780,1988,1792
50,Zaragoza,205,"Pedrosas, Las",116,58,58
50,Zaragoza,206,Perdiguera,645,339,306
50,Zaragoza,207,Piedratajada,130,66,64
50,Zaragoza,208,Pina de Ebro,2635,1355,1280
50,Zaragoza,209,Pinseque,3676,1918,1758
50,Zaragoza,210,"Pintanos, Los",45,26,19
50,Zaragoza,211,Plasencia de Jalón,386,214,172
50,Zaragoza,212,Pleitas,52,27,25
50,Zaragoza,213,Plenas,131,69,62
50,Zaragoza,214,Pomer,35,23,12
50,Zaragoza,215,Pozuel de Ariza,22,12,10
50,Zaragoza,216,Pozuelo de Aragón,327,178,149
50,Zaragoza,217,Pradilla de Ebro,627,328,299
50,Zaragoza,218,Puebla de Albortón,128,80,48
50,Zaragoza,219,"Puebla de Alfindén, La",5603,2916,2687
50,Zaragoza,220,Puendeluna,63,34,29
50,Zaragoza,221,Purujosa,40,27,13
50,Zaragoza,222,Quinto,2077,1071,1006
50,Zaragoza,223,Remolinos,1153,587,566
50,Zaragoza,224,Retascón,70,42,28
50,Zaragoza,225,Ricla,3188,1695,1493
50,Zaragoza,227,Romanos,121,71,50
50,Zaragoza,228,Rueda de Jalón,345,190,155
50,Zaragoza,229,Ruesca,75,39,36
50,Zaragoza,241,Sabiñán,749,386,363
50,Zaragoza,230,Sádaba,1577,811,766
50,Zaragoza,231,Salillas de Jalón,373,189,184
50,Zaragoza,232,Salvatierra de Esca,210,105,105
50,Zaragoza,233,Samper del Salz,121,66,55
50,Zaragoza,234,San Martín de la Virgen de Moncayo,297,167,130
50,Zaragoza,235,San Mateo de Gállego,3158,1636,1522
50,Zaragoza,236,Santa Cruz de Grío,148,79,69
50,Zaragoza,237,Santa Cruz de Moncayo,133,71,62
50,Zaragoza,238,Santa Eulalia de Gállego,124,69,55
50,Zaragoza,239,Santed,65,38,27
50,Zaragoza,240,Sástago,1266,646,620
50,Zaragoza,242,Sediles,106,61,45
50,Zaragoza,243,Sestrica,390,222,168
50,Zaragoza,244,Sierra de Luna,291,159,132
50,Zaragoza,245,Sigüés,121,66,55
50,Zaragoza,246,Sisamón,40,26,14
50,Zaragoza,247,Sobradiel,1029,499,530
50,Zaragoza,248,Sos del Rey Católico,646,326,320
50,Zaragoza,249,Tabuenca,387,217,170
50,Zaragoza,250,Talamantes,60,29,31
50,Zaragoza,251,Tarazona,11050,5446,5604
50,Zaragoza,252,Tauste,7382,3693,3689
50,Zaragoza,253,Terrer,475,249,226
50,Zaragoza,254,Tierga,197,111,86
50,Zaragoza,255,Tobed,230,108,122
50,Zaragoza,256,Torralba de los Frailes,90,50,40
50,Zaragoza,257,Torralba de Ribota,205,114,91
50,Zaragoza,258,Torralbilla,56,31,25
50,Zaragoza,259,Torrehermosa,80,42,38
50,Zaragoza,260,Torrelapaja,39,23,16
50,Zaragoza,261,Torrellas,290,157,133
50,Zaragoza,262,Torres de Berrellén,1521,800,721
50,Zaragoza,263,Torrijo de la Cañada,281,157,124
50,Zaragoza,264,Tosos,226,127,99
50,Zaragoza,265,Trasmoz,76,41,35
50,Zaragoza,266,Trasobares,139,85,54
50,Zaragoza,267,Uncastillo,731,354,377
50,Zaragoza,268,Undués de Lerda,76,44,32
50,Zaragoza,269,Urrea de Jalón,396,201,195
50,Zaragoza,270,Urriés,41,25,16
50,Zaragoza,271,Used,304,165,139
50,Zaragoza,272,Utebo,18281,9219,9062
50,Zaragoza,274,Val de San Martín,77,42,35
50,Zaragoza,273,Valdehorna,33,17,16
50,Zaragoza,275,Valmadrid,111,68,43
50,Zaragoza,276,Valpalmas,161,75,86
50,Zaragoza,277,Valtorres,101,48,53
50,Zaragoza,278,Velilla de Ebro,243,128,115
50,Zaragoza,279,Velilla de Jiloca,115,66,49
50,Zaragoza,280,Vera de Moncayo,398,204,194
50,Zaragoza,281,Vierlas,98,48,50
50,Zaragoza,283,Villadoz,87,52,35
50,Zaragoza,284,Villafeliche,209,109,100
50,Zaragoza,285,Villafranca de Ebro,834,412,422
50,Zaragoza,286,Villalba de Perejil,109,58,51
50,Zaragoza,287,Villalengua,386,205,181
50,Zaragoza,903,Villamayor de Gállego,2838,1431,1407
50,Zaragoza,288,Villanueva de Gállego,4611,2339,2272
50,Zaragoza,290,Villanueva de Huerva,559,296,263
50,Zaragoza,289,Villanueva de Jiloca,60,30,30
50,Zaragoza,291,Villar de los Navarros,114,61,53
50,Zaragoza,292,Villarreal de Huerva,230,123,107
50,Zaragoza,293,Villarroya de la Sierra,553,286,267
50,Zaragoza,294,Villarroya del Campo,78,44,34
50,Zaragoza,282,"Vilueña, La",111,54,57
50,Zaragoza,295,Vistabella,52,35,17
50,Zaragoza,296,"Zaida, La",499,246,253
50,Zaragoza,297,Zaragoza,679624,328828,350796
50,Zaragoza,298,Zuera,7738,3995,3743
51,Ceuta,1,Ceuta,84018,42948,41070
52,Melilla,1,Melilla,80802,41569,39233
