province_code,province_name,cmun,municipality_name,population_total,population_male,population_female
02,Albacete,1,Abengibre,775,383,392
02,Albacete,2,Alatoz,580,323,257
02,Albacete,3,Albacete,172487,84399,88088
02,Albacete,4,Albatana,748,380,368
02,Albacete,5,Alborea,778,402,376
02,Albacete,6,Alcadozo,684,360,324
02,Albacete,7,Alcalá del Júcar,1307,699,608
02,Albacete,8,Alcaraz,1533,772,761
02,Albacete,9,Almansa,25024,12444,12580
02,Albacete,10,Alpera,2358,1209,1149
02,Albacete,11,Ayna,719,386,333
02,Albacete,12,Balazote,2417,1251,1166
02,Albacete,14,"Ballestero, El",459,239,220
02,Albacete,13,Balsa de Ves,176,100,76
02,Albacete,15,Barrax,1920,985,935
02,Albacete,16,Bienservida,668,351,317
02,Albacete,17,Bogarra,955,498,457
02,Albacete,18,Bonete,1157,598,559
02,Albacete,19,"Bonillo, El",2956,1496,1460
02,Albacete,20,Carcelén,573,302,271
02,Albacete,21,Casas de Juan Núñez,1372,715,657
02,Albacete,22,Casas de Lázaro,386,218,168
02,Albacete,23,Casas de Ves,689,365,324
02,Albacete,24,Casas-Ibáñez,4713,2444,2269
02,Albacete,25,Caudete,10294,5236,5058
02,Albacete,26,Cenizate,1176,605,571
02,Albacete,29,Chinchilla de Monte-Aragón,4099,2121,1978
02,Albacete,27,Corral-Rubio,365,201,164
02,Albacete,28,Cotillas,139,72,67
02,Albacete,30,Elche de la Sierra,3814,1929,1885
02,Albacete,31,Férez,719,356,363
02,Albacete,32,Fuensanta,345,195,150
02,Albacete,33,Fuente-Álamo,2652,1406,1246
02,Albacete,34,Fuentealbilla,1931,982,949
02,Albacete,35,"Gineta, La",2485,1270,1215
02,Albacete,36,Golosalvo,122,64,58
02,Albacete,37,Hellín,30862,15374,15488
02,Albacete,38,"Herrera, La",349,179,170
02,Albacete,39,Higueruela,1273,651,622
02,Albacete,40,Hoya-Gonzalo,694,363,331
02,Albacete,41,Jorquera,408,215,193
02,Albacete,42,Letur,1018,495,523
02,Albacete,43,Lezuza,1504,768,736
02,Albacete,44,Liétor,1336,690,646
02,Albacete,45,Madrigueras,4739,2423,2316
02,Albacete,46,Mahora,1430,726,704
02,Albacete,47,Masegoso,121,65,56
02,Albacete,48,Minaya,1571,810,761
02,Albacete,49,Molinicos,931,483,448
02,Albacete,50,Montalvos,110,59,51
02,Albacete,51,Montealegre del Castillo,2162,1098,1064
02,Albacete,52,Motilleja,563,290,273
02,Albacete,53,Munera,3678,1866,1812
02,Albacete,54,Navas de Jorquera,520,264,256
02,Albacete,55,Nerpio,1384,754,630
02,Albacete,56,Ontur,2169,1074,1095
02,Albacete,57,Ossa de Montiel,2530,1263,1267
02,Albacete,58,Paterna del Madera,385,204,181
02,Albacete,60,Peñas de San Pedro,1405,814,591
02,Albacete,59,Peñascosa,366,187,179
02,Albacete,61,Pétrola,744,387,357
02,Albacete,62,Povedilla,484,258,226
02,Albacete,901,Pozo Cañada,2815,1411,1404
02,Albacete,63,Pozohondo,1723,901,822
02,Albacete,64,Pozo-Lorente,420,208,212
02,Albacete,65,Pozuelo,534,285,249
02,Albacete,66,"Recueja, La",278,140,138
02,Albacete,67,Riópar,1477,760,717
02,Albacete,68,Robledo,422,215,207
02,Albacete,69,"Roda, La",15979,8064,7915
02,Albacete,70,Salobre,561,288,273
02,Albacete,71,San Pedro,1226,625,601
02,Albacete,72,Socovos,1881,966,915
02,Albacete,73,Tarazona de la Mancha,6550,3306,3244
02,Albacete,74,Tobarra,8075,4091,3984
02,Albacete,75,Valdeganga,1928,984,944
02,Albacete,76,Vianos,389,198,191
02,Albacete,77,Villa de Ves,54,31,23
02,Albacete,78,Villalgordo del Júcar,1157,598,559
02,Albacete,79,Villamalea,4148,2081,2067
02,Albacete,80,Villapalacios,624,329,295
02,Albacete,81,Villarrobledo,26419,13148,13271
02,Albacete,82,Villatoya,112,64,48
02,Albacete,83,Villavaliente,249,144,105
02,Albacete,84,Villaverde de Guadalimar,381,204,177
02,Albacete,85,Viveros,310,152,158
02,Albacete,86,Yeste,2964,1521,1443
03,Alicante/Alacant,1,Adsubia,627,322,305
03,Alicante/Alacant,2,Agost,4752,2392,2360
03,Alicante/Alacant,3,Agres,583,312,271
03,Alicante/Alacant,4,Aigües,984,523,461
03,Alicante/Alacant,5,Albatera,11767,6010,5757
03,Alicante/Alacant,6,Alcalalí,1350,683,667
03,Alicante/Alacant,7,Alcocer de Planes,238,123,115
03,Alicante/Alacant,8,Alcoleja,191,101,90
03,Alicante/Alacant,9,Alcoy/Alcoi,59675,29017,30658
03,Alicante/Alacant,10,Alfafara,418,205,213
03,Alicante/Alacant,11,"Alfàs del Pi, l'",21357,10641,10716
03,Alicante/Alacant,12,Algorfa,3799,1894,1905
03,Alicante/Alacant,13,Algueña,1457,728,729
03,Alicante/Alacant,14,Alicante/Alacant,332067,161343,170724
03,Alicante/Alacant,15,Almoradí,19992,10153,9839
03,Alicante/Alacant,16,Almudaina,112,59,53
03,Alicante/Alacant,17,"Alqueria d'Asnar, l'",527,246,281
03,Alicante/Alacant,18,Altea,22518,11117,11401
03,Alicante/Alacant,19,Aspe,20248,10209,10039
03,Alicante/Alacant,20,Balones,139,69,70
03,Alicante/Alacant,21,Banyeres de Mariola,7174,3585,3589
03,Alicante/Alacant,22,Benasau,158,77,81
03,Alicante/Alacant,23,Beneixama,1738,854,884
03,Alicante/Alacant,24,Benejúzar,5394,2688,2706
03,Alicante/Alacant,25,Benferri,1910,1012,898
03,Alicante/Alacant,26,Beniarbeig,1859,914,945
03,Alicante/Alacant,27,Beniardá,208,111,97
03,Alicante/Alacant,28,Beniarrés,1254,628,626
03,Alicante/Alacant,30,Benidoleig,1189,582,607
03,Alicante/Alacant,31,Benidorm,69010,34467,34543
03,Alicante/Alacant,32,Benifallim,121,64,57
03,Alicante/Alacant,33,Benifato,168,84,84
03,Alicante/Alacant,29,Benigembla,508,259,249
03,Alicante/Alacant,34,Benijófar,3791,1855,1936
03,Alicante/Alacant,35,Benilloba,789,403,386
03,Alicante/Alacant,36,Benillup,104,47,57
03,Alicante/Alacant,37,Benimantell,499,235,264
03,Alicante/Alacant,38,Benimarfull,431,216,215
03,Alicante/Alacant,39,Benimassot,113,60,53
03,Alicante/Alacant,40,Benimeli,419,205,214
03,Alicante/Alacant,41,Benissa,11572,5765,5807
03,Alicante/Alacant,42,"Benitachell/Poble Nou de Benitatxell, el",4659,2312,2347
03,Alicante/Alacant,43,Biar,3670,1796,1874
03,Alicante/Alacant,44,Bigastro,6762,3464,3298
03,Alicante/Alacant,45,Bolulla,421,213,208
03,Alicante/Alacant,46,Busot,3138,1589,1549
03,Alicante/Alacant,49,Callosa de Segura,18079,9114,8965
03,Alicante/Alacant,48,Callosa d'en Sarrià,7370,3738,3632
03,Alicante/Alacant,47,Calp,22437,11355,11082
03,Alicante/Alacant,50,"Campello, el",27081,13280,13801
03,Alicante/Alacant,51,"Campo de Mirra/Camp de Mirra, el",437,223,214
03,Alicante/Alacant,52,Cañada,1242,614,628
03,Alicante/Alacant,53,Castalla,10143,5144,4999
03,Alicante/Alacant,54,Castell de Castells,442,223,219
03,Alicante/Alacant,75,"Castell de Guadalest, el",226,112,114
03,Alicante/Alacant,55,Catral,8663,4395,4268
03,Alicante/Alacant,56,Cocentaina,11519,5804,5715
03,Alicante/Alacant,57,Confrides,232,130,102
03,Alicante/Alacant,58,Cox,7188,3674,3514
03,Alicante/Alacant,59,Crevillent,28328,14381,13947
03,Alicante/Alacant,61,Daya Nueva,1765,890,875
03,Alicante/Alacant,62,Daya Vieja,681,343,338
03,Alicante/Alacant,63,Dénia,41672,20377,21295
03,Alicante/Alacant,64,Dolores,7237,3612,3625
03,Alicante/Alacant,65,Elche/Elx,228647,113510,115137
03,Alicante/Alacant,66,Elda,53540,26089,27451
03,Alicante/Alacant,67,Facheca,104,56,48
03,Alicante/Alacant,68,Famorca,52,25,27
03,Alicante/Alacant,69,Finestrat,6265,3226,3039
03,Alicante/Alacant,77,"Fondó de les Neus, el/Hondón de las Nieves",2632,1320,1312
03,Alicante/Alacant,70,Formentera del Segura,4211,2156,2055
03,Alicante/Alacant,72,Gaianes,449,239,210
03,Alicante/Alacant,71,Gata de Gorgos,5985,3036,2949
03,Alicante/Alacant,73,Gorga,274,146,128
03,Alicante/Alacant,74,Granja de Rocamora,2417,1253,1164
03,Alicante/Alacant,76,Guardamar del Segura,15599,7743,7856
03,Alicante/Alacant,78,Hondón de los Frailes,1095,574,521
03,Alicante/Alacant,79,Ibi,23456,11730,11726
03,Alicante/Alacant,80,Jacarilla,1947,984,963
03,Alicante/Alacant,82,Jávea/Xàbia,29067,14499,14568
03,Alicante/Alacant,83,Jijona/Xixona,7226,3502,3724
03,Alicante/Alacant,85,Llíber,1080,536,544
03,Alicante/Alacant,84,"Lorcha/Orxa, l'",676,335,341
03,Alicante/Alacant,86,Millena,210,110,100
03,Alicante/Alacant,88,Monforte del Cid,7658,4002,3656
03,Alicante/Alacant,89,Monóvar/Monòver,12460,6202,6258
03,Alicante/Alacant,903,"Montesinos, Los",4966,2503,2463
03,Alicante/Alacant,91,Murla,509,246,263
03,Alicante/Alacant,92,Muro de Alcoy,9114,4537,4577
03,Alicante/Alacant,90,Mutxamel,24232,12107,12125
03,Alicante/Alacant,93,Novelda,26292,13062,13230
03,Alicante/Alacant,94,"Nucia, la",20029,10149,9880
03,Alicante/Alacant,95,Ondara,6632,3329,3303
03,Alicante/Alacant,96,Onil,7565,3789,3776
03,Alicante/Alacant,97,Orba,2216,1100,1116
03,Alicante/Alacant,99,Orihuela,83417,41747,41670
03,Alicante/Alacant,98,Orxeta,875,442,433
03,Alicante/Alacant,100,Parcent,1020,501,519
03,Alicante/Alacant,101,Pedreguer,7438,3712,3726
03,Alicante/Alacant,102,Pego,10144,5115,5029
03,Alicante/Alacant,103,Penàguila,324,163,161
03,Alicante/Alacant,104,Petrer,34754,17331,17423
03,Alicante/Alacant,902,Pilar de la Horadada,21588,11121,10467
03,Alicante/Alacant,105,"Pinós, el/Pinoso",7663,3864,3799
03,Alicante/Alacant,106,Planes,778,409,369
03,Alicante/Alacant,901,"Poblets, els",3350,1618,1732
03,Alicante/Alacant,107,Polop,4313,2198,2115
03,Alicante/Alacant,60,Quatretondeta,115,62,53
03,Alicante/Alacant,109,Rafal,4138,2082,2056
03,Alicante/Alacant,110,"Ràfol d'Almúnia, el",659,328,331
03,Alicante/Alacant,111,Redován,7623,3927,3696
03,Alicante/Alacant,112,Relleu,1258,631,627
03,Alicante/Alacant,113,Rojales,18824,9531,9293
03,Alicante/Alacant,114,"Romana, la",2465,1282,1183
03,Alicante/Alacant,115,Sagra,408,210,198
03,Alicante/Alacant,116,Salinas,1583,801,782
03,Alicante/Alacant,118,San Fulgencio,9237,4640,4597
03,Alicante/Alacant,904,San Isidro,1891,975,916
03,Alicante/Alacant,120,San Miguel de Salinas,6911,3451,3460
03,Alicante/Alacant,122,San Vicente del Raspeig/Sant Vicent del Raspeig,55946,27724,28222
03,Alicante/Alacant,117,Sanet y Negrals,670,322,348
03,Alicante/Alacant,119,Sant Joan d'Alacant,22804,11054,11750
03,Alicante/Alacant,121,Santa Pola,31529,15888,15641
03,Alicante/Alacant,123,Sax,9741,4905,4836
03,Alicante/Alacant,124,Sella,584,313,271
03,Alicante/Alacant,125,Senija,622,326,296
03,Alicante/Alacant,127,Tàrbena,686,355,331
03,Alicante/Alacant,128,Teulada,11824,5884,5940
03,Alicante/Alacant,129,Tibi,1657,866,791
03,Alicante/Alacant,130,Tollos,59,32,27
03,Alicante/Alacant,131,Tormos,317,162,155
03,Alicante/Alacant,132,"Torremanzanas/Torre de les Maçanes, la",743,386,357
03,Alicante/Alacant,133,Torrevieja,91415,46089,45326
03,Alicante/Alacant,134,"Vall d'Alcalà, la",175,91,84
03,Alicante/Alacant,136,Vall de Gallinera,595,315,280
03,Alicante/Alacant,137,"Vall de Laguar, la",872,424,448
03,Alicante/Alacant,135,"Vall d'Ebo, la",254,135,119
03,Alicante/Alacant,138,"Verger, el",4688,2349,2339
03,Alicante/Alacant,139,"Villajoyosa/Vila Joiosa, la",33951,16978,16973
03,Alicante/Alacant,140,Villena,34530,17233,17297
03,Alicante/Alacant,81,Xaló,2793,1411,1382
04,Almería,1,Abla,1426,744,682
04,Almería,2,Abrucena,1262,649,613
04,Almería,3,Adra,24782,12506,12276
04,Almería,4,Albánchez,772,388,384
04,Almería,5,Alboloduy,642,312,330
04,Almería,6,Albox,11715,6026,5689
04,Almería,7,Alcolea,861,448,413
04,Almería,8,Alcóntar,578,312,266
04,Almería,9,Alcudia de Monteagud,140,73,67
04,Almería,10,Alhabia,681,348,333
04,Almería,11,Alhama de Almería,3753,1907,1846
04,Almería,12,Alicún,239,122,117
04,Almería,13,Almería,193351,94021,99330
04,Almería,14,Almócita,167,82,85
04,Almería,15,Alsodux,131,72,59
04,Almería,16,Antas,3161,1583,1578
04,Almería,17,Arboleas,4698,2337,2361
04,Almería,18,Armuña de Almanzora,332,167,165
04,Almería,19,Bacares,267,136,131
04,Almería,20,Bayárcal,340,184,156
04,Almería,21,Bayarque,216,109,107
04,Almería,22,Bédar,986,494,492
04,Almería,23,Beires,112,54,58
04,Almería,24,Benahadux,4220,2090,2130
04,Almería,26,Benitagla,71,39,32
04,Almería,27,Benizalón,284,148,136
04,Almería,28,Bentarique,255,144,111
04,Almería,29,Berja,15323,7752,7571
04,Almería,30,Canjáyar,1365,705,660
04,Almería,31,Cantoria,3617,1847,1770
04,Almería,32,Carboneras,7852,4048,3804
04,Almería,33,Castro de Filabres,134,65,69
04,Almería,36,Chercos,280,147,133
04,Almería,37,Chirivel,1689,865,824
04,Almería,34,Cóbdar,154,83,71
04,Almería,35,Cuevas del Almanzora,13737,7133,6604
04,Almería,38,Dalías,3979,1959,2020
04,Almería,902,"Ejido, El",84144,44276,39868
04,Almería,41,Enix,440,252,188
04,Almería,43,Felix,651,363,288
04,Almería,44,Fines,2203,1159,1044
04,Almería,45,Fiñana,2201,1111,1090
04,Almería,46,Fondón,991,517,474
04,Almería,47,Gádor,3096,1614,1482
04,Almería,48,"Gallardos, Los",3126,1597,1529
04,Almería,49,Garrucha,8632,4425,4207
04,Almería,50,Gérgal,1034,538,496
04,Almería,51,Huécija,525,252,273
04,Almería,52,Huércal de Almería,16663,8528,8135
04,Almería,53,Huércal-Overa,18374,9119,9255
04,Almería,54,Illar,386,203,183
04,Almería,55,Instinción,463,223,240
04,Almería,56,Laroya,170,94,76
04,Almería,57,Láujar de Andarax,1633,814,819
04,Almería,58,Líjar,435,222,213
04,Almería,59,Lubrín,1607,785,822
04,Almería,60,Lucainena de las Torres,614,323,291
04,Almería,61,Lúcar,802,402,400
04,Almería,62,Macael,5719,2910,2809
04,Almería,63,María,1315,670,645
04,Almería,64,Mojácar,6838,3428,3410
04,Almería,903,"Mojonera, La",8993,4936,4057
04,Almería,65,Nacimiento,507,265,242
04,Almería,66,Níjar,28627,15512,13115
04,Almería,67,Ohanes,696,343,353
04,Almería,68,Olula de Castro,169,91,78
04,Almería,69,Olula del Río,6387,3286,3101
04,Almería,70,Oria,2495,1294,1201
04,Almería,71,Padules,484,248,236
04,Almería,72,Partaloa,671,318,353
04,Almería,73,Paterna del Río,411,237,174
04,Almería,74,Pechina,3849,1980,1869
04,Almería,75,Pulpí,8562,4422,4140
04,Almería,76,Purchena,1662,863,799
04,Almería,77,Rágol,331,174,157
04,Almería,78,Rioja,1406,713,693
04,Almería,79,Roquetas de Mar,91682,47388,44294
04,Almería,80,Santa Cruz de Marchena,216,108,108
04,Almería,81,Santa Fe de Mondújar,390,196,194
04,Almería,82,Senés,320,169,151
04,Almería,83,Serón,2218,1130,1088
04,Almería,84,Sierro,401,210,191
04,Almería,85,Somontín,502,248,254
04,Almería,86,Sorbas,2689,1422,1267
04,Almería,87,Suflí,219,115,104
04,Almería,88,Tabernas,3646,1894,1752
04,Almería,89,Taberno,1029,509,520
04,Almería,90,Tahal,396,206,190
04,Almería,91,Terque,440,221,219
04,Almería,92,Tíjola,3776,1858,1918
04,Almería,901,"Tres Villas, Las",583,310,273
04,Almería,93,Turre,3563,1806,1757
04,Almería,94,Turrillas,229,131,98
04,Almería,95,Uleila del Campo,924,472,452
04,Almería,96,Urrácal,312,156,156
04,Almería,97,Velefique,278,155,123
04,Almería,98,Vélez-Blanco,2064,1076,988
04,Almería,99,Vélez-Rubio,6791,3319,3472
04,Almería,100,Vera,15018,7650,7368
04,Almería,101,Viator,5605,2873,2732
04,Almería,102,Vícar,24384,12878,11506
04,Almería,103,Zurgena,3129,1557,1572
01,Araba/Álava,1,Alegría-Dulantzi,2925,1513,1412
01,Araba/Álava,2,Amurrio,10239,5108,5131
01,Araba/Álava,49,Añana,165,91,74
01,Araba/Álava,3,Aramaio,1478,780,698
01,Araba/Álava,6,Armiñón,250,129,121
01,Araba/Álava,37,Arraia-Maeztu,714,411,303
01,Araba/Álava,8,Arratzua-Ubarrundia,994,533,461
01,Araba/Álava,4,Artziniega,1818,905,913
01,Araba/Álava,9,Asparrena,1652,836,816
01,Araba/Álava,10,Ayala/Aiara,2929,1461,1468
01,Araba/Álava,11,Baños de Ebro/Mañueta,325,180,145
01,Araba/Álava,13,Barrundia,915,510,405
01,Araba/Álava,14,Berantevilla,477,245,232
01,Araba/Álava,16,Bernedo,545,321,224
01,Araba/Álava,17,Campezo/Kanpezu,1084,567,517
01,Araba/Álava,21,Elburgo/Burgelu,624,327,297
01,Araba/Álava,22,Elciego,1054,518,536
01,Araba/Álava,23,Elvillar/Bilar,351,175,176
01,Araba/Álava,46,Erriberagoitia/Ribera Alta,751,427,324
01,Araba/Álava,56,Harana/Valle de Arana,259,152,107
01,Araba/Álava,901,Iruña Oka/Iruña de Oca,3108,1601,1507
01,Araba/Álava,27,Iruraiz-Gauna,511,283,228
01,Araba/Álava,19,Kripan,188,102,86
01,Araba/Álava,20,Kuartango,356,204,152
01,Araba/Álava,28,Labastida/Bastida,1489,772,717
01,Araba/Álava,30,Lagrán,161,83,78
01,Araba/Álava,31,Laguardia,1518,790,728
01,Araba/Álava,32,Lanciego/Lantziego,681,349,332
01,Araba/Álava,902,Lantarón,931,526,405
01,Araba/Álava,33,Lapuebla de Labarca,861,446,415
01,Araba/Álava,36,Laudio/Llodio,18428,9123,9305
01,Araba/Álava,58,Legutio,1703,897,806
01,Araba/Álava,34,Leza,207,106,101
01,Araba/Álava,39,Moreda de Álava/Moreda Araba,236,119,117
01,Araba/Álava,41,Navaridas,214,126,88
01,Araba/Álava,42,Okondo,1158,609,549
01,Araba/Álava,43,Oyón-Oion,3298,1669,1629
01,Araba/Álava,44,Peñacerrada-Urizaharra,269,165,104
01,Araba/Álava,47,Ribera Baja/Erribera Beitia,1358,735,623
01,Araba/Álava,51,Salvatierra/Agurain,4952,2482,2470
01,Araba/Álava,52,Samaniego,290,152,138
01,Araba/Álava,53,San Millán/Donemiliaga,726,403,323
01,Araba/Álava,54,Urkabustaiz,1278,683,595
01,Araba/Álava,55,Valdegovía/Gaubea,1038,569,469
01,Araba/Álava,57,Villabuena de Álava/Eskuernaga,312,162,150
01,Araba/Álava,59,Vitoria-Gasteiz,242082,118574,123508
01,Araba/Álava,60,Yécora/Iekora,258,133,125
01,Araba/Álava,61,Zalduondo,185,102,83
01,Araba/Álava,62,Zambrana,417,225,192
01,Araba/Álava,18,Zigoitia,1743,940,803
01,Araba/Álava,63,Zuia,2427,1264,1163
33,Asturias,1,Allande,1858,936,922
33,Asturias,2,Aller,11768,5794,5974
33,Asturias,3,Amieva,758,401,357
33,Asturias,4,Avilés,81659,38819,42840
33,Asturias,5,Belmonte de Miranda,1653,854,799
33,Asturias,6,Bimenes,1777,845,932
33,Asturias,7,Boal,1709,853,856
33,Asturias,8,Cabrales,2097,1072,1025
33,Asturias,9,Cabranes,1075,557,518
33,Asturias,10,Candamo,2108,1029,1079
33,Asturias,12,Cangas de Onís,6678,3274,3404
33,Asturias,11,Cangas del Narcea,13710,6813,6897
33,Asturias,13,Caravia,506,258,248
33,Asturias,14,Carreño,10700,5171,5529
33,Asturias,15,Caso,1704,961,743
33,Asturias,16,Castrillón,22816,11064,11752
33,Asturias,17,Castropol,3696,1784,1912
33,Asturias,18,Coaña,3436,1682,1754
33,Asturias,19,Colunga,3569,1732,1837
33,Asturias,20,Corvera de Asturias,16153,7947,8206
33,Asturias,21,Cudillero,5369,2665,2704
33,Asturias,22,Degaña,1110,576,534
33,Asturias,23,"Franco, El",3901,1924,1977
33,Asturias,24,Gijón,275735,130204,145531
33,Asturias,25,Gozón,10675,5199,5476
33,Asturias,26,Grado,10471,5074,5397
33,Asturias,27,Grandas de Salime,943,479,464
33,Asturias,28,Ibias,1516,828,688
33,Asturias,29,Illano,409,206,203
33,Asturias,30,Illas,1040,529,511
33,Asturias,31,Langreo,42403,20118,22285
33,Asturias,32,Laviana,13791,6618,7173
33,Asturias,33,Lena,11949,5763,6186
33,Asturias,35,Llanera,14030,6981,7049
33,Asturias,36,Llanes,13960,6800,7160
33,Asturias,37,Mieres,41013,19457,21556
33,Asturias,38,Morcín,2811,1401,1410
33,Asturias,39,Muros de Nalón,1880,904,976
33,Asturias,40,Nava,5444,2683,2761
33,Asturias,41,Navia,8772,4257,4515
33,Asturias,42,Noreña,5422,2627,2795
33,Asturias,43,Onís,764,402,362
33,Asturias,44,Oviedo,223765,104208,119557
33,Asturias,45,Parres,5590,2734,2856
33,Asturias,46,Peñamellera Alta,570,285,285
33,Asturias,47,Peñamellera Baja,1300,637,663
33,Asturias,48,Pesoz,173,88,85
33,Asturias,49,Piloña,7530,3714,3816
33,Asturias,50,Ponga,663,392,271
33,Asturias,51,Pravia,8799,4269,4530
33,Asturias,52,Proaza,786,443,343
33,Asturias,53,Quirós,1277,718,559
33,Asturias,54,"Regueras, Las",1916,977,939
33,Asturias,55,Ribadedeva,1862,895,967
33,Asturias,56,Ribadesella,6002,2872,3130
33,Asturias,57,Ribera de Arriba,1903,963,940
33,Asturias,58,Riosa,2098,1061,1037
33,Asturias,59,Salas,5516,2722,2794
33,Asturias,61,San Martín de Oscos,446,221,225
33,Asturias,60,San Martín del Rey Aurelio,17460,8398,9062
33,Asturias,63,San Tirso de Abres,498,244,254
33,Asturias,62,Santa Eulalia de Oscos,488,253,235
33,Asturias,64,Santo Adriano,256,128,128
33,Asturias,65,Sariego,1295,622,673
33,Asturias,66,Siero,52380,25557,26823
33,Asturias,67,Sobrescobio,871,464,407
33,Asturias,68,Somiedo,1281,750,531
33,Asturias,69,Soto del Barco,4012,1977,2035
33,Asturias,70,Tapia de Casariego,3929,1902,2027
33,Asturias,71,Taramundi,706,339,367
33,Asturias,72,Teverga,1807,944,863
33,Asturias,73,Tineo,10413,5221,5192
33,Asturias,34,Valdés,12635,6180,6455
33,Asturias,74,Vegadeo,3996,1940,2056
33,Asturias,75,Villanueva de Oscos,316,154,162
33,Asturias,76,Villaviciosa,14820,7306,7514
33,Asturias,77,Villayón,1393,715,678
33,Asturias,78,Yernes y Tameza,166,93,73
05,Ávila,1,Adanero,204,110,94
05,Ávila,2,"Adrada, La",2663,1393,1270
05,Ávila,5,Albornos,205,108,97
05,Ávila,7,Aldeanueva de Santa Cruz,132,75,57
05,Ávila,8,Aldeaseca,254,123,131
05,Ávila,10,"Aldehuela, La",177,90,87
05,Ávila,12,Amavida,154,78,76
05,Ávila,13,"Arenal, El",1004,503,501
05,Ávila,14,Arenas de San Pedro,6754,3301,3453
05,Ávila,15,Arevalillo,87,44,43
05,Ávila,16,Arévalo,8165,3981,4184
05,Ávila,17,Aveinte,85,46,39
05,Ávila,18,Avellaneda,32,18,14
05,Ávila,19,Ávila,58933,28250,30683
05,Ávila,21,"Barco de Ávila, El",2652,1287,1365
05,Ávila,22,"Barraco, El",1989,1027,962
05,Ávila,23,Barromán,195,108,87
05,Ávila,24,Becedas,243,132,111
05,Ávila,25,Becedillas,107,62,45
05,Ávila,26,Bercial de Zapardiel,230,119,111
05,Ávila,27,"Berlanas, Las",349,180,169
05,Ávila,29,Bernuy-Zapardiel,136,80,56
05,Ávila,30,Berrocalejo de Aragona,46,24,22
05,Ávila,33,Blascomillán,198,104,94
05,Ávila,34,Blasconuño de Matacabras,16,10,6
05,Ávila,35,Blascosancho,120,60,60
05,Ávila,36,"Bohodón, El",128,69,59
05,Ávila,37,Bohoyo,312,172,140
05,Ávila,38,Bonilla de la Sierra,124,71,53
05,Ávila,39,Brabos,49,29,20
05,Ávila,40,Bularros,71,43,28
05,Ávila,41,Burgohondo,1241,650,591
05,Ávila,42,Cabezas de Alambre,169,84,85
05,Ávila,43,Cabezas del Pozo,84,47,37
05,Ávila,44,Cabezas del Villar,271,157,114
05,Ávila,45,Cabizuela,100,50,50
05,Ávila,46,Canales,53,28,25
05,Ávila,47,Candeleda,5143,2622,2521
05,Ávila,48,Cantiveros,132,70,62
05,Ávila,49,Cardeñosa,473,253,220
05,Ávila,51,"Carrera, La",203,109,94
05,Ávila,52,Casas del Puerto,101,54,47
05,Ávila,53,Casasola,81,42,39
05,Ávila,54,Casavieja,1536,775,761
05,Ávila,55,Casillas,721,383,338
05,Ávila,56,Castellanos de Zapardiel,98,53,45
05,Ávila,57,Cebreros,3302,1684,1618
05,Ávila,58,Cepeda la Mora,87,47,40
05,Ávila,67,Chamartín,75,46,29
05,Ávila,59,Cillán,104,61,43
05,Ávila,60,Cisla,122,60,62
05,Ávila,61,"Colilla, La",336,170,166
05,Ávila,62,Collado de Contreras,203,106,97
05,Ávila,63,Collado del Mirón,36,23,13
05,Ávila,64,Constanzana,118,70,48
05,Ávila,65,Crespos,518,281,237
05,Ávila,66,Cuevas del Valle,531,287,244
05,Ávila,903,Diego del Carpio,158,85,73
05,Ávila,69,Donjimeno,88,54,34
05,Ávila,70,Donvidas,41,22,19
05,Ávila,72,Espinosa de los Caballeros,101,54,47
05,Ávila,73,Flores de Ávila,326,180,146
05,Ávila,74,Fontiveros,798,422,376
05,Ávila,75,Fresnedilla,122,52,70
05,Ávila,76,"Fresno, El",592,299,293
05,Ávila,77,Fuente el Saúz,189,104,85
05,Ávila,78,Fuentes de Año,131,73,58
05,Ávila,79,Gallegos de Altamiros,68,42,26
05,Ávila,80,Gallegos de Sobrinos,62,26,36
05,Ávila,81,Garganta del Villar,40,28,12
05,Ávila,82,Gavilanes,643,344,299
05,Ávila,83,Gemuño,161,82,79
05,Ávila,85,Gil García,41,22,19
05,Ávila,84,Gilbuena,77,46,31
05,Ávila,86,Gimialcón,86,53,33
05,Ávila,87,Gotarrendura,170,62,108
05,Ávila,88,Grandes y San Martín,31,15,16
05,Ávila,89,Guisando,554,279,275
05,Ávila,90,Gutierre-Muñoz,85,43,42
05,Ávila,92,Hernansancho,185,105,80
05,Ávila,93,Herradón de Pinares,548,310,238
05,Ávila,94,Herreros de Suso,153,79,74
05,Ávila,95,Higuera de las Dueñas,306,169,137
05,Ávila,96,"Hija de Dios, La",79,44,35
05,Ávila,97,"Horcajada, La",515,267,248
05,Ávila,99,Horcajo de las Torres,571,322,249
05,Ávila,100,"Hornillo, El",315,167,148
05,Ávila,102,"Hoyo de Pinares, El",2339,1212,1127
05,Ávila,101,Hoyocasero,283,162,121
05,Ávila,103,Hoyorredondo,78,43,35
05,Ávila,106,Hoyos de Miguel Muñoz,36,18,18
05,Ávila,104,Hoyos del Collado,33,20,13
05,Ávila,105,Hoyos del Espino,389,209,180
05,Ávila,107,Hurtumpascual,67,42,25
05,Ávila,108,Junciana,55,28,27
05,Ávila,109,Langa,526,270,256
05,Ávila,110,Lanzahíta,904,480,424
05,Ávila,113,"Llanos de Tormes, Los",89,43,46
05,Ávila,112,"Losar del Barco, El",114,54,60
05,Ávila,114,Madrigal de las Altas Torres,1544,785,759
05,Ávila,115,Maello,689,352,337
05,Ávila,116,Malpartida de Corneja,127,66,61
05,Ávila,117,Mamblas,225,125,100
05,Ávila,118,Mancera de Arriba,99,57,42
05,Ávila,119,Manjabálago y Ortigosa de Rioalmar,36,21,15
05,Ávila,120,Marlín,39,24,15
05,Ávila,121,Martiherrero,304,160,144
05,Ávila,122,Martínez,143,74,69
05,Ávila,123,Mediana de Voltoya,100,50,50
05,Ávila,124,Medinilla,117,56,61
05,Ávila,125,Mengamuñoz,63,31,32
05,Ávila,126,Mesegar de Corneja,77,42,35
05,Ávila,127,Mijares,760,407,353
05,Ávila,128,Mingorría,411,212,199
05,Ávila,129,"Mirón, El",145,86,59
05,Ávila,130,Mironcillo,103,55,48
05,Ávila,131,Mirueña de los Infanzones,99,50,49
05,Ávila,132,Mombeltrán,1152,597,555
05,Ávila,133,Monsalupe,65,34,31
05,Ávila,134,Moraleja de Matacabras,46,28,18
05,Ávila,135,Muñana,456,239,217
05,Ávila,136,Muñico,103,53,50
05,Ávila,138,Muñogalindo,385,199,186
05,Ávila,139,Muñogrande,64,37,27
05,Ávila,140,Muñomer del Peco,134,69,65
05,Ávila,141,Muñopepe,116,69,47
05,Ávila,142,Muñosancho,110,55,55
05,Ávila,143,Muñotello,61,33,28
05,Ávila,144,Narrillos del Álamo,92,49,43
05,Ávila,145,Narrillos del Rebollar,51,27,24
05,Ávila,149,Narros de Saldueña,116,64,52
05,Ávila,147,Narros del Castillo,188,104,84
05,Ávila,148,Narros del Puerto,27,13,14
05,Ávila,152,Nava de Arévalo,819,436,383
05,Ávila,153,Nava del Barco,102,52,50
05,Ávila,151,Navacepedilla de Corneja,114,60,54
05,Ávila,154,Navadijos,40,28,12
05,Ávila,155,Navaescurial,54,34,20
05,Ávila,156,Navahondilla,327,190,137
05,Ávila,157,Navalacruz,259,132,127
05,Ávila,158,Navalmoral,390,210,180
05,Ávila,159,Navalonguilla,258,134,124
05,Ávila,160,Navalosa,342,189,153
05,Ávila,161,Navalperal de Pinares,902,459,443
05,Ávila,162,Navalperal de Tormes,101,52,49
05,Ávila,163,Navaluenga,2027,1007,1020
05,Ávila,164,Navaquesera,28,11,17
05,Ávila,165,Navarredonda de Gredos,492,254,238
05,Ávila,166,Navarredondilla,231,120,111
05,Ávila,167,Navarrevisca,295,159,136
05,Ávila,168,"Navas del Marqués, Las",5520,2808,2712
05,Ávila,169,Navatalgordo,233,124,109
05,Ávila,170,Navatejares,49,24,25
05,Ávila,171,Neila de San Miguel,79,39,40
05,Ávila,172,Niharra,154,84,70
05,Ávila,173,Ojos-Albos,64,37,27
05,Ávila,174,Orbita,80,40,40
05,Ávila,175,"Oso, El",187,108,79
05,Ávila,176,Padiernos,290,149,141
05,Ávila,177,Pajares de Adaja,182,91,91
05,Ávila,178,Palacios de Goda,425,223,202
05,Ávila,179,Papatrigo,258,131,127
05,Ávila,180,"Parral, El",86,46,40
05,Ávila,181,Pascualcobo,41,25,16
05,Ávila,182,Pedro Bernardo,927,497,430
05,Ávila,183,Pedro-Rodríguez,168,89,79
05,Ávila,184,Peguerinos,330,190,140
05,Ávila,185,Peñalba de Ávila,115,63,52
05,Ávila,186,Piedrahíta,1990,950,1040
05,Ávila,187,Piedralaves,2265,1148,1117
05,Ávila,188,Poveda,56,34,22
05,Ávila,189,Poyales del Hoyo,530,285,245
05,Ávila,190,Pozanco,57,35,22
05,Ávila,191,Pradosegar,140,72,68
05,Ávila,192,Puerto Castilla,112,68,44
05,Ávila,193,Rasueros,211,122,89
05,Ávila,194,Riocabado,157,88,69
05,Ávila,195,Riofrío,241,141,100
05,Ávila,196,Rivilla de Barajas,69,31,38
05,Ávila,197,Salobral,123,63,60
05,Ávila,198,Salvadiós,82,43,39
05,Ávila,199,San Bartolomé de Béjar,44,23,21
05,Ávila,200,San Bartolomé de Corneja,59,30,29
05,Ávila,201,San Bartolomé de Pinares,599,315,284
05,Ávila,206,San Esteban de los Patos,33,17,16
05,Ávila,208,San Esteban de Zapardiel,40,22,18
05,Ávila,207,San Esteban del Valle,816,434,382
05,Ávila,209,San García de Ingelmos,86,51,35
05,Ávila,901,San Juan de Gredos,287,152,135
05,Ávila,210,San Juan de la Encinilla,100,53,47
05,Ávila,211,San Juan de la Nava,522,268,254
05,Ávila,212,San Juan del Molinillo,244,141,103
05,Ávila,213,San Juan del Olmo,117,71,46
05,Ávila,214,San Lorenzo de Tormes,45,24,21
05,Ávila,215,San Martín de la Vega del Alberche,187,113,74
05,Ávila,216,San Martín del Pimpollar,186,107,79
05,Ávila,217,San Miguel de Corneja,64,34,30
05,Ávila,218,San Miguel de Serrezuela,141,80,61
05,Ávila,219,San Pascual,49,32,17
05,Ávila,220,San Pedro del Arroyo,460,237,223
05,Ávila,231,San Vicente de Arévalo,201,106,95
05,Ávila,204,Sanchidrián,799,407,392
05,Ávila,205,Sanchorreja,85,42,43
05,Ávila,222,Santa Cruz de Pinares,163,90,73
05,Ávila,221,Santa Cruz del Valle,414,213,201
05,Ávila,226,Santa María de los Caballeros,80,45,35
05,Ávila,224,Santa María del Arroyo,112,59,53
05,Ávila,225,Santa María del Berrocal,420,217,203
05,Ávila,902,Santa María del Cubillo,350,201,149
05,Ávila,227,Santa María del Tiétar,540,282,258
05,Ávila,228,Santiago del Collado,184,114,70
05,Ávila,904,Santiago del Tormes,151,85,66
05,Ávila,229,Santo Domingo de las Posadas,79,40,39
05,Ávila,230,Santo Tomé de Zabarcos,72,39,33
05,Ávila,232,"Serrada, La",113,58,55
05,Ávila,233,Serranillos,272,148,124
05,Ávila,234,Sigeres,50,24,26
05,Ávila,235,Sinlabajos,126,65,61
05,Ávila,236,Solana de Ávila,146,79,67
05,Ávila,237,Solana de Rioalmar,191,105,86
05,Ávila,238,Solosancho,924,485,439
05,Ávila,239,Sotalbo,228,123,105
05,Ávila,240,Sotillo de la Adrada,4705,2356,2349
05,Ávila,241,"Tiemblo, El",4301,2185,2116
05,Ávila,242,Tiñosillos,804,413,391
05,Ávila,243,Tolbaños,101,55,46
05,Ávila,244,Tormellas,60,32,28
05,Ávila,245,Tornadizos de Ávila,399,194,205
05,Ávila,247,"Torre, La",285,150,135
05,Ávila,246,Tórtoles,65,35,30
05,Ávila,249,Umbrías,117,60,57
05,Ávila,251,Vadillo de la Sierra,72,43,29
05,Ávila,252,Valdecasa,61,37,24
05,Ávila,253,Vega de Santa María,96,49,47
05,Ávila,254,Velayos,248,125,123
05,Ávila,256,Villaflor,130,66,64
05,Ávila,257,Villafranca de la Sierra,136,75,61
05,Ávila,905,Villanueva de Ávila,227,113,114
05,Ávila,258,Villanueva de Gómez,144,78,66
05,Ávila,259,Villanueva del Aceral,141,69,72
05,Ávila,260,Villanueva del Campillo,104,61,43
05,Ávila,261,Villar de Corneja,45,26,19
05,Ávila,262,Villarejo del Valle,394,205,189
05,Ávila,263,Villatoro,191,106,85
05,Ávila,264,Viñegra de Moraña,53,30,23
05,Ávila,265,Vita,90,54,36
05,Ávila,266,Zapardiel de la Cañada,103,53,50
05,Ávila,267,Zapardiel de la Ribera,114,59,55
06,Badajoz,1,Acedera,831,426,405
06,Badajoz,2,Aceuchal,5538,2761,2777
06,Badajoz,3,Ahillones,990,493,497
06,Badajoz,4,Alange,1946,991,955
06,Badajoz,5,"Albuera, La",2029,1040,989
06,Badajoz,6,Alburquerque,5524,2798,2726
06,Badajoz,7,Alconchel,1840,920,920
06,Badajoz,8,Alconera,743,367,376
06,Badajoz,9,Aljucén,230,130,100
06,Badajoz,10,Almendral,1312,637,675
06,Badajoz,11,Almendralejo,35014,17553,17461
06,Badajoz,12,Arroyo de San Serván,4195,2140,2055
06,Badajoz,13,Atalaya,308,157,151
06,Badajoz,14,Azuaga,8145,4030,4115
06,Badajoz,15,Badajoz,150517,73174,77343
06,Badajoz,16,Barcarrota,3631,1860,1771
06,Badajoz,17,Baterno,323,177,146
06,Badajoz,18,Benquerencia de la Serena,903,447,456
06,Badajoz,19,Berlanga,2456,1218,1238
06,Badajoz,20,Bienvenida,2254,1168,1086
06,Badajoz,21,Bodonal de la Sierra,1093,561,532
06,Badajoz,22,Burguillos del Cerro,3204,1589,1615
06,Badajoz,23,Cabeza del Buey,5234,2583,2651
06,Badajoz,24,Cabeza la Vaca,1403,719,684
06,Badajoz,25,Calamonte,6354,3140,3214
06,Badajoz,26,Calera de León,1002,501,501
06,Badajoz,27,Calzadilla de los Barros,848,435,413
06,Badajoz,28,Campanario,5182,2536,2646
06,Badajoz,29,Campillo de Llerena,1424,719,705
06,Badajoz,30,Capilla,187,96,91
06,Badajoz,31,Carmonita,561,278,283
06,Badajoz,32,"Carrascalejo, El",68,37,31
06,Badajoz,33,Casas de Don Pedro,1559,793,766
06,Badajoz,34,Casas de Reina,196,94,102
06,Badajoz,35,Castilblanco,1094,554,540
06,Badajoz,36,Castuera,6255,3087,3168
06,Badajoz,42,Cheles,1220,580,640
06,Badajoz,37,"Codosera, La",2221,1158,1063
06,Badajoz,38,Cordobilla de Lácara,974,499,475
06,Badajoz,39,"Coronada, La",2197,1085,1112
06,Badajoz,40,Corte de Peleas,1301,656,645
06,Badajoz,41,Cristina,565,293,272
06,Badajoz,43,Don Álvaro,771,390,381
06,Badajoz,44,Don Benito,37011,18273,18738
06,Badajoz,45,Entrín Bajo,580,297,283
06,Badajoz,46,Esparragalejo,1498,732,766
06,Badajoz,47,Esparragosa de la Serena,1058,544,514
06,Badajoz,48,Esparragosa de Lares,987,479,508
06,Badajoz,49,Feria,1230,605,625
06,Badajoz,50,Fregenal de la Sierra,5001,2447,2554
06,Badajoz,51,Fuenlabrada de los Montes,1930,939,991
06,Badajoz,52,Fuente de Cantos,5002,2458,2544
06,Badajoz,53,Fuente del Arco,719,364,355
06,Badajoz,54,Fuente del Maestre,6906,3419,3487
06,Badajoz,55,Fuentes de León,2430,1197,1233
06,Badajoz,56,Garbayuela,543,286,257
06,Badajoz,57,Garlitos,631,323,308
06,Badajoz,58,"Garrovilla, La",2434,1232,1202
06,Badajoz,59,Granja de Torrehermosa,2186,1098,1088
06,Badajoz,903,Guadiana del Caudillo,2519,1244,1275
06,Badajoz,60,Guareña,7227,3646,3581
06,Badajoz,61,"Haba, La",1296,659,637
06,Badajoz,62,Helechosa de los Montes,715,402,313
06,Badajoz,63,Herrera del Duque,3706,1886,1820
06,Badajoz,64,Higuera de la Serena,1001,526,475
06,Badajoz,65,Higuera de Llerena,348,175,173
06,Badajoz,66,Higuera de Vargas,2028,1017,1011
06,Badajoz,67,Higuera la Real,2401,1220,1181
06,Badajoz,68,Hinojosa del Valle,519,259,260
06,Badajoz,69,Hornachos,3777,1882,1895
06,Badajoz,70,Jerez de los Caballeros,9623,4785,4838
06,Badajoz,71,"Lapa, La",285,146,139
06,Badajoz,73,Llera,905,467,438
06,Badajoz,74,Llerena,5969,2975,2994
06,Badajoz,72,Lobón,2840,1478,1362
06,Badajoz,75,Magacela,561,296,265
06,Badajoz,76,Maguilla,1010,499,511
06,Badajoz,77,Malcocinado,405,221,184
06,Badajoz,78,Malpartida de la Serena,610,309,301
06,Badajoz,79,Manchita,761,395,366
06,Badajoz,80,Medellín,2321,1166,1155
06,Badajoz,81,Medina de las Torres,1287,661,626
06,Badajoz,82,Mengabril,479,253,226
06,Badajoz,83,Mérida,58985,28801,30184
06,Badajoz,84,Mirandilla,1357,684,673
06,Badajoz,85,Monesterio,4345,2216,2129
06,Badajoz,86,Montemolín,1467,708,759
06,Badajoz,87,Monterrubio de la Serena,2537,1238,1299
06,Badajoz,88,Montijo,15961,7920,8041
06,Badajoz,89,"Morera, La",744,369,375
06,Badajoz,90,"Nava de Santiago, La",1015,505,510
06,Badajoz,91,Navalvillar de Pela,4714,2385,2329
06,Badajoz,92,Nogales,699,348,351
06,Badajoz,93,Oliva de la Frontera,5461,2759,2702
06,Badajoz,94,Oliva de Mérida,1795,920,875
06,Badajoz,95,Olivenza,12104,6069,6035
06,Badajoz,96,Orellana de la Sierra,258,138,120
06,Badajoz,97,Orellana la Vieja,2842,1466,1376
06,Badajoz,98,Palomas,698,346,352
06,Badajoz,99,"Parra, La",1381,709,672
06,Badajoz,100,Peñalsordo,1088,527,561
06,Badajoz,101,Peraleda del Zaucejo,562,288,274
06,Badajoz,102,Puebla de Alcocer,1249,615,634
06,Badajoz,103,Puebla de la Calzada,5991,2974,3017
06,Badajoz,104,Puebla de la Reina,804,403,401
06,Badajoz,107,Puebla de Obando,1913,961,952
06,Badajoz,108,Puebla de Sancho Pérez,2798,1410,1388
06,Badajoz,105,Puebla del Maestre,767,393,374
06,Badajoz,106,Puebla del Prior,523,266,257
06,Badajoz,902,Pueblonuevo del Guadiana,2056,1048,1008
06,Badajoz,109,Quintana de la Serena,4894,2469,2425
06,Badajoz,110,Reina,180,86,94
06,Badajoz,111,Rena,660,342,318
06,Badajoz,112,Retamal de Llerena,484,255,229
06,Badajoz,113,Ribera del Fresno,3496,1735,1761
06,Badajoz,114,Risco,151,74,77
06,Badajoz,115,"Roca de la Sierra, La",1514,739,775
06,Badajoz,116,Salvaleón,1916,944,972
06,Badajoz,117,Salvatierra de los Barros,1721,852,869
06,Badajoz,119,San Pedro de Mérida,853,432,421
06,Badajoz,123,San Vicente de Alcántara,5725,2884,2841
06,Badajoz,118,Sancti-Spíritus,222,120,102
06,Badajoz,120,Santa Amalia,4196,2120,2076
06,Badajoz,121,Santa Marta,4321,2171,2150
06,Badajoz,122,"Santos de Maimona, Los",8249,4199,4050
06,Badajoz,124,Segura de León,2052,1017,1035
06,Badajoz,125,Siruela,2059,1024,1035
06,Badajoz,126,Solana de los Barros,2717,1366,1351
06,Badajoz,127,Talarrubias,3597,1806,1791
06,Badajoz,128,Talavera la Real,5535,2789,2746
06,Badajoz,129,Táliga,746,378,368
06,Badajoz,130,Tamurejo,235,119,116
06,Badajoz,131,Torre de Miguel Sesmero,1274,641,633
06,Badajoz,132,Torremayor,1041,496,545
06,Badajoz,133,Torremejía,2263,1169,1094
06,Badajoz,134,Trasierra,659,356,303
06,Badajoz,135,Trujillanos,1430,749,681
06,Badajoz,136,Usagre,1884,932,952
06,Badajoz,137,Valdecaballeros,1156,588,568
06,Badajoz,901,Valdelacalzada,2752,1418,1334
06,Badajoz,138,Valdetorres,1255,621,634
06,Badajoz,139,Valencia de las Torres,673,362,311
06,Badajoz,140,Valencia del Mombuey,768,384,384
06,Badajoz,141,Valencia del Ventoso,2115,1053,1062
06,Badajoz,146,Valle de la Serena,1332,676,656
06,Badajoz,147,Valle de Matamoros,407,204,203
06,Badajoz,148,Valle de Santa Ana,1162,573,589
06,Badajoz,142,Valverde de Burguillos,302,157,145
06,Badajoz,143,Valverde de Leganés,4193,2109,2084
06,Badajoz,144,Valverde de Llerena,662,331,331
06,Badajoz,145,Valverde de Mérida,1107,564,543
06,Badajoz,149,Villafranca de los Barros,13314,6560,6754
06,Badajoz,150,Villagarcía de la Torre,959,505,454
06,Badajoz,151,Villagonzalo,1290,625,665
06,Badajoz,152,Villalba de los Barros,1588,813,775
06,Badajoz,153,Villanueva de la Serena,26101,12806,13295
06,Badajoz,154,Villanueva del Fresno,3538,1756,1782
06,Badajoz,156,Villar de Rena,1420,741,679
06,Badajoz,155,Villar del Rey,2301,1220,1081
06,Badajoz,157,Villarta de los Montes,522,259,263
06,Badajoz,158,Zafra,16828,8143,8685
06,Badajoz,159,Zahínos,2864,1417,1447
06,Badajoz,160,Zalamea de la Serena,3797,1904,1893
06,Badajoz,162,"Zarza, La",3591,1822,1769
06,Badajoz,161,Zarza-Capilla,363,183,180
07,"Balears, Illes",2,Alaior,9162,4571,4591
07,"Balears, Illes",1,Alaró,5227,2578,2649
07,"Balears, Illes",3,Alcúdia,19768,10049,9719
07,"Balears, Illes",4,Algaida,5354,2752,2602
07,"Balears, Illes",5,Andratx,10806,5388,5418
07,"Balears, Illes",901,Ariany,903,474,429
07,"Balears, Illes",6,Artà,7382,3685,3697
07,"Balears, Illes",7,Banyalbufar,553,313,240
07,"Balears, Illes",8,Binissalem,7936,3927,4009
07,"Balears, Illes",9,Búger,1030,522,508
07,"Balears, Illes",10,Bunyola,6662,3290,3372
07,"Balears, Illes",11,Calvià,50363,25246,25117
07,"Balears, Illes",12,Campanet,2554,1259,1295
07,"Balears, Illes",13,Campos,9765,4909,4856
07,"Balears, Illes",14,Capdepera,11385,5746,5639
07,"Balears, Illes",64,"Castell, Es",7661,3899,3762
07,"Balears, Illes",15,Ciutadella de Menorca,29282,14621,14661
07,"Balears, Illes",16,Consell,3859,1958,1901
07,"Balears, Illes",17,Costitx,1183,583,600
07,"Balears, Illes",18,Deià,768,385,383
07,"Balears, Illes",26,Eivissa,49693,25233,24460
07,"Balears, Illes",19,Escorca,241,139,102
07,"Balears, Illes",20,Esporles,4940,2444,2496
07,"Balears, Illes",21,Estellencs,344,187,157
07,"Balears, Illes",22,Felanitx,17291,8709,8582
07,"Balears, Illes",23,Ferreries,4630,2329,2301
07,"Balears, Illes",24,Formentera,11545,6047,5498
07,"Balears, Illes",25,Fornalutx,704,358,346
07,"Balears, Illes",27,Inca,30625,15437,15188
07,"Balears, Illes",28,Lloret de Vistalegre,1251,632,619
07,"Balears, Illes",29,Lloseta,5686,2838,2848
07,"Balears, Illes",30,Llubí,2216,1101,1115
07,"Balears, Illes",31,Llucmajor,34602,17437,17165
07,"Balears, Illes",33,Manacor,40264,20090,20174
07,"Balears, Illes",34,Mancor de la Vall,1309,652,657
07,"Balears, Illes",32,Maó-Mahón,28460,13939,14521
07,"Balears, Illes",35,Maria de la Salut,2114,1078,1036
07,"Balears, Illes",36,Marratxí,35521,17874,17647
07,"Balears, Illes",37,"Mercadal, Es",5176,2631,2545
07,"Balears, Illes",902,"Migjorn Gran, Es",1470,741,729
07,"Balears, Illes",38,Montuïri,2888,1454,1434
07,"Balears, Illes",39,Muro,6808,3423,3385
07,"Balears, Illes",40,Palma de Mallorca,399093,194439,204654
07,"Balears, Illes",41,Petra,2812,1388,1424
07,"Balears, Illes",44,"Pobla, Sa",12709,6502,6207
07,"Balears, Illes",42,Pollença,16088,7985,8103
07,"Balears, Illes",43,Porreres,5369,2765,2604
07,"Balears, Illes",45,Puigpunyent,2016,1015,1001
07,"Balears, Illes",59,"Salines, Ses",5050,2561,2489
07,"Balears, Illes",46,Sant Antoni de Portmany,23359,12151,11208
07,"Balears, Illes",49,Sant Joan,2030,995,1035
07,"Balears, Illes",50,Sant Joan de Labritja,5668,2912,2756
07,"Balears, Illes",48,Sant Josep de sa Talaia,25362,13260,12102
07,"Balears, Illes",51,Sant Llorenç des Cardassar,8320,4143,4177
07,"Balears, Illes",52,Sant Lluís,7472,3799,3673
07,"Balears, Illes",53,Santa Eugènia,1652,829,823
07,"Balears, Illes",54,Santa Eulalia del Río,36189,18452,17737
07,"Balears, Illes",55,Santa Margalida,11680,5969,5711
07,"Balears, Illes",56,Santa María del Camí,6591,3274,3317
07,"Balears, Illes",57,Santanyí,11636,5879,5757
07,"Balears, Illes",58,Selva,3858,1934,1924
07,"Balears, Illes",47,Sencelles,3073,1543,1530
07,"Balears, Illes",60,Sineu,3681,1827,1854
07,"Balears, Illes",61,Sóller,13842,6977,6865
07,"Balears, Illes",62,Son Servera,11576,5780,5796
07,"Balears, Illes",63,Valldemossa,2025,1036,989
07,"Balears, Illes",65,Vilafranca de Bonany,2910,1458,1452
08,Barcelona,1,Abrera,12125,6167,5958
08,Barcelona,2,Aguilar de Segarra,251,132,119
08,Barcelona,14,Aiguafreda,2498,1194,1304
08,Barcelona,3,Alella,9651,4722,4929
08,Barcelona,4,Alpens,300,162,138
08,Barcelona,5,"Ametlla del Vallès, L'",8283,4177,4106
08,Barcelona,6,Arenys de Mar,15307,7509,7798
08,Barcelona,7,Arenys de Munt,8654,4371,4283
08,Barcelona,8,Argençola,212,113,99
08,Barcelona,9,Argentona,11963,5877,6086
08,Barcelona,10,Artés,5661,2841,2820
08,Barcelona,11,Avià,2258,1129,1129
08,Barcelona,12,Avinyó,2275,1138,1137
08,Barcelona,13,Avinyonet del Penedès,1675,878,797
08,Barcelona,15,Badalona,217210,107587,109623
08,Barcelona,904,Badia del Vallès,13553,6603,6950
08,Barcelona,16,Bagà,2225,1109,1116
08,Barcelona,17,Balenyà,3724,1870,1854
08,Barcelona,18,Balsareny,3343,1644,1699
08,Barcelona,252,Barberà del Vallès,32550,16120,16430
08,Barcelona,19,Barcelona,1602386,758316,844070
08,Barcelona,20,Begues,6620,3282,3338
08,Barcelona,21,Bellprat,78,46,32
08,Barcelona,22,Berga,16456,8076,8380
08,Barcelona,23,Bigues i Riells,8854,4513,4341
08,Barcelona,24,Borredà,540,299,241
08,Barcelona,25,"Bruc, El",1991,1070,921
08,Barcelona,26,"Brull, El",263,145,118
08,Barcelona,27,"Cabanyes, Les",961,497,464
08,Barcelona,28,Cabrera d'Anoia,1363,713,650
08,Barcelona,29,Cabrera de Mar,4525,2275,2250
08,Barcelona,30,Cabrils,7197,3554,3643
08,Barcelona,31,Calaf,3475,1793,1682
08,Barcelona,34,Calders,949,491,458
08,Barcelona,33,Caldes de Montbui,17156,8552,8604
08,Barcelona,32,Caldes d'Estrac,2738,1314,1424
08,Barcelona,35,Calella,18307,8996,9311
08,Barcelona,37,Calldetenes,2429,1242,1187
08,Barcelona,38,Callús,1985,962,1023
08,Barcelona,36,Calonge de Segarra,202,99,103
08,Barcelona,39,Campins,521,261,260
08,Barcelona,40,Canet de Mar,14123,6861,7262
08,Barcelona,41,Canovelles,15954,8277,7677
08,Barcelona,42,Cànoves i Samalús,2863,1454,1409
08,Barcelona,43,Canyelles,4345,2217,2128
08,Barcelona,44,Capellades,5284,2626,2658
08,Barcelona,45,Capolat,88,41,47
08,Barcelona,46,Cardedeu,17698,8712,8986
08,Barcelona,47,Cardona,4921,2413,2508
08,Barcelona,48,Carme,817,424,393
08,Barcelona,49,Casserres,1569,776,793
08,Barcelona,57,Castell de l'Areny,75,42,33
08,Barcelona,52,Castellar de n'Hug,159,86,73
08,Barcelona,50,Castellar del Riu,171,96,75
08,Barcelona,51,Castellar del Vallès,23440,11538,11902
08,Barcelona,53,Castellbell i el Vilar,3624,1856,1768
08,Barcelona,54,Castellbisbal,12434,6331,6103
08,Barcelona,55,Castellcir,718,367,351
08,Barcelona,56,Castelldefels,63255,31286,31969
08,Barcelona,58,Castellet i la Gornal,2237,1127,1110
08,Barcelona,60,Castellfollit de Riubregós,177,97,80
08,Barcelona,59,Castellfollit del Boix,428,217,211
08,Barcelona,61,Castellgalí,2022,1051,971
08,Barcelona,62,Castellnou de Bages,1241,629,612
08,Barcelona,63,Castellolí,571,275,296
08,Barcelona,64,Castellterçol,2400,1191,1209
08,Barcelona,65,Castellví de la Marca,1589,802,787
08,Barcelona,66,Castellví de Rosanes,1760,871,889
08,Barcelona,67,Centelles,7333,3596,3737
08,Barcelona,268,Cercs,1246,628,618
08,Barcelona,266,Cerdanyola del Vallès,57402,28192,29210
08,Barcelona,68,Cervelló,8811,4423,4388
08,Barcelona,69,Collbató,4427,2286,2141
08,Barcelona,70,Collsuspina,338,177,161
08,Barcelona,71,Copons,323,163,160
08,Barcelona,72,Corbera de Llobregat,14237,7134,7103
08,Barcelona,73,Cornellà de Llobregat,86234,42133,44101
08,Barcelona,74,Cubelles,14481,7315,7166
08,Barcelona,75,Dosrius,5137,2611,2526
08,Barcelona,76,Esparreguera,21685,11018,10667
08,Barcelona,77,Esplugues de Llobregat,46133,22250,23883
08,Barcelona,78,"Espunyola, L'",259,129,130
08,Barcelona,79,"Estany, L'",407,206,201
08,Barcelona,134,Figaró-Montmany,1096,550,546
08,Barcelona,80,Fígols,43,22,21
08,Barcelona,82,Fogars de la Selva,1512,794,718
08,Barcelona,81,Fogars de Montclús,482,257,225
08,Barcelona,83,Folgueroles,2259,1138,1121
08,Barcelona,84,Fonollosa,1429,739,690
08,Barcelona,85,Font-rubí,1353,699,654
08,Barcelona,86,"Franqueses del Vallès, Les",19170,9755,9415
08,Barcelona,90,Gaià,163,90,73
08,Barcelona,87,Gallifa,202,103,99
08,Barcelona,88,"Garriga, La",15762,7661,8101
08,Barcelona,89,Gavà,46326,22809,23517
08,Barcelona,91,Gelida,7194,3600,3594
08,Barcelona,92,Gironella,4987,2457,2530
08,Barcelona,93,Gisclareny,25,15,10
08,Barcelona,94,"Granada, La",2073,1062,1011
08,Barcelona,95,Granera,80,52,28
08,Barcelona,96,Granollers,59930,29638,30292
08,Barcelona,97,Gualba,1429,729,700
08,Barcelona,99,Guardiola de Berguedà,937,500,437
08,Barcelona,100,Gurb,2545,1324,1221
08,Barcelona,101,"Hospitalet de Llobregat, L'",253518,123269,130249
08,Barcelona,162,"Hostalets de Pierola, Els",2942,1516,1426
08,Barcelona,102,Igualada,38751,18973,19778
08,Barcelona,103,Jorba,838,420,418
08,Barcelona,104,"Llacuna, La",906,494,412
08,Barcelona,105,"Llagosta, La",13430,6620,6810
08,Barcelona,107,Lliçà d'Amunt,14696,7466,7230
08,Barcelona,108,Lliçà de Vall,6354,3224,3130
08,Barcelona,106,Llinars del Vallès,9536,4732,4804
08,Barcelona,109,Lluçà,257,130,127
08,Barcelona,110,Malgrat de Mar,18417,9244,9173
08,Barcelona,111,Malla,266,131,135
08,Barcelona,112,Manlleu,20279,10112,10167
08,Barcelona,113,Manresa,75297,36809,38488
08,Barcelona,242,Marganell,297,143,154
08,Barcelona,114,Martorell,27895,14313,13582
08,Barcelona,115,Martorelles,4783,2382,2401
08,Barcelona,116,"Masies de Roda, Les",737,365,372
08,Barcelona,117,"Masies de Voltregà, Les",3186,1570,1616
08,Barcelona,118,"Masnou, El",22742,10950,11792
08,Barcelona,119,Masquefa,8406,4246,4160
08,Barcelona,120,Matadepera,8841,4432,4409
08,Barcelona,121,Mataró,124280,61860,62420
08,Barcelona,122,Mediona,2311,1162,1149
08,Barcelona,138,Moià,5760,2894,2866
08,Barcelona,123,Molins de Rei,25152,12278,12874
08,Barcelona,124,Mollet del Vallès,51719,25698,26021
08,Barcelona,128,Monistrol de Calders,695,364,331
08,Barcelona,127,Monistrol de Montserrat,2945,1495,1450
08,Barcelona,125,Montcada i Reixac,34394,17012,17382
08,Barcelona,130,Montclar,117,59,58
08,Barcelona,131,Montesquiu,895,455,440
08,Barcelona,126,Montgat,11315,5610,5705
08,Barcelona,132,Montmajor,476,240,236
08,Barcelona,133,Montmaneu,164,88,76
08,Barcelona,135,Montmeló,8863,4376,4487
08,Barcelona,136,Montornès del Vallès,16217,8241,7976
08,Barcelona,137,Montseny,332,174,158
08,Barcelona,129,Muntanyola,595,302,293
08,Barcelona,139,Mura,211,112,99
08,Barcelona,140,Navarcles,6003,2925,3078
08,Barcelona,141,Navàs,6117,3045,3072
08,Barcelona,142,"Nou de Berguedà, La",150,75,75
08,Barcelona,143,Òdena,3624,1856,1768
08,Barcelona,145,Olèrdola,3579,1853,1726
08,Barcelona,146,Olesa de Bonesvalls,1735,889,846
08,Barcelona,147,Olesa de Montserrat,23543,11776,11767
08,Barcelona,148,Olivella,3609,1917,1692
08,Barcelona,149,Olost,1186,593,593
08,Barcelona,144,Olvan,876,432,444
08,Barcelona,150,Orís,303,154,149
08,Barcelona,151,Oristà,557,272,285
08,Barcelona,152,Orpí,131,73,58
08,Barcelona,153,Òrrius,690,353,337
08,Barcelona,154,Pacs del Penedès,892,440,452
08,Barcelona,155,Palafolls,9065,4504,4561
08,Barcelona,156,Palau-solità i Plegamans,14454,7125,7329
08,Barcelona,157,Pallejà,11253,5641,5612
08,Barcelona,905,"Palma de Cervelló, La",3002,1503,1499
08,Barcelona,158,"Papiol, El",4023,2000,2023
08,Barcelona,159,Parets del Vallès,18733,9414,9319
08,Barcelona,160,Perafita,407,206,201
08,Barcelona,161,Piera,15000,7652,7348
08,Barcelona,163,Pineda de Mar,25948,12980,12968
08,Barcelona,164,"Pla del Penedès, El",1223,615,608
08,Barcelona,165,"Pobla de Claramunt, La",2186,1090,1096
08,Barcelona,166,"Pobla de Lillet, La",1155,571,584
08,Barcelona,167,Polinyà,8238,4172,4066
08,Barcelona,182,"Pont de Vilomara i Rocafort, El",3780,1949,1831
08,Barcelona,168,Pontons,477,258,219
08,Barcelona,169,"Prat de Llobregat, El",62866,30916,31950
08,Barcelona,171,Prats de Lluçanès,2624,1314,1310
08,Barcelona,170,"Prats de Rei, Els",537,281,256
08,Barcelona,230,Premià de Dalt,10311,5171,5140
08,Barcelona,172,Premià de Mar,28163,13820,14343
08,Barcelona,174,Puigdàlber,532,262,270
08,Barcelona,175,Puig-reig,4207,2040,2167
08,Barcelona,176,Pujalt,198,109,89
08,Barcelona,177,"Quar, La",57,32,25
08,Barcelona,178,Rajadell,528,269,259
08,Barcelona,179,Rellinars,726,375,351
08,Barcelona,180,Ripollet,37233,18402,18831
08,Barcelona,181,"Roca del Vallès, La",10518,5289,5229
08,Barcelona,183,Roda de Ter,6124,3002,3122
08,Barcelona,184,Rubí,74353,36911,37442
08,Barcelona,185,Rubió,228,123,105
08,Barcelona,901,Rupit i Pruit,300,155,145
08,Barcelona,187,Sabadell,207444,100979,106465
08,Barcelona,188,Sagàs,149,80,69
08,Barcelona,190,Saldes,283,158,125
08,Barcelona,191,Sallent,6780,3258,3522
08,Barcelona,194,Sant Adrià de Besòs,35386,17410,17976
08,Barcelona,195,Sant Agustí de Lluçanès,91,46,45
08,Barcelona,196,Sant Andreu de la Barca,27268,13666,13602
08,Barcelona,197,Sant Andreu de Llavaneres,10590,5197,5393
08,Barcelona,198,Sant Antoni de Vilamajor,5708,2862,2846
08,Barcelona,199,Sant Bartomeu del Grau,875,448,427
08,Barcelona,200,Sant Boi de Llobregat,83107,40956,42151
08,Barcelona,201,Sant Boi de Lluçanès,556,271,285
08,Barcelona,203,Sant Cebrià de Vallalta,3328,1729,1599
08,Barcelona,202,Sant Celoni,17251,8555,8696
08,Barcelona,204,Sant Climent de Llobregat,3938,1973,1965
08,Barcelona,205,Sant Cugat del Vallès,87118,42428,44690
08,Barcelona,206,Sant Cugat Sesgarrigues,972,481,491
08,Barcelona,207,Sant Esteve de Palautordera,2532,1232,1300
08,Barcelona,208,Sant Esteve Sesrovires,7542,3755,3787
08,Barcelona,210,Sant Feliu de Codines,5900,2972,2928
08,Barcelona,211,Sant Feliu de Llobregat,43715,21288,22427
08,Barcelona,212,Sant Feliu Sasserra,626,323,303
08,Barcelona,209,Sant Fost de Campsentelles,8666,4322,4344
08,Barcelona,213,Sant Fruitós de Bages,8243,4121,4122
08,Barcelona,215,Sant Hipòlit de Voltregà,3446,1712,1734
08,Barcelona,193,Sant Iscle de Vallalta,1304,677,627
08,Barcelona,216,Sant Jaume de Frontanyà,24,15,9
08,Barcelona,218,Sant Joan de Vilatorrada,10733,5376,5357
08,Barcelona,217,Sant Joan Despí,32981,16108,16873
08,Barcelona,903,Sant Julià de Cerdanyola,239,134,105
08,Barcelona,220,Sant Julià de Vilatorta,3123,1532,1591
08,Barcelona,221,Sant Just Desvern,16389,7800,8589
08,Barcelona,222,Sant Llorenç d'Hortons,2517,1260,1257
08,Barcelona,223,Sant Llorenç Savall,2361,1188,1173
08,Barcelona,225,Sant Martí d'Albars,106,54,52
08,Barcelona,224,Sant Martí de Centelles,1093,558,535
08,Barcelona,226,Sant Martí de Tous,1175,593,582
08,Barcelona,227,Sant Martí Sarroca,3130,1537,1593
08,Barcelona,228,Sant Martí Sesgueioles,395,200,195
08,Barcelona,229,Sant Mateu de Bages,644,332,312
08,Barcelona,231,Sant Pere de Ribes,29339,14704,14635
08,Barcelona,232,Sant Pere de Riudebitlles,2364,1187,1177
08,Barcelona,233,Sant Pere de Torelló,2436,1267,1169
08,Barcelona,234,Sant Pere de Vilamajor,4248,2120,2128
08,Barcelona,189,Sant Pere Sallavinera,162,90,72
08,Barcelona,235,Sant Pol de Mar,4997,2504,2493
08,Barcelona,236,Sant Quintí de Mediona,2101,1065,1036
08,Barcelona,237,Sant Quirze de Besora,2148,1054,1094
08,Barcelona,238,Sant Quirze del Vallès,19549,9565,9984
08,Barcelona,239,Sant Quirze Safaja,644,345,299
08,Barcelona,240,Sant Sadurní d'Anoia,12590,6159,6431
08,Barcelona,241,Sant Sadurní d'Osormort,86,50,36
08,Barcelona,98,Sant Salvador de Guardiola,3130,1594,1536
08,Barcelona,262,Sant Vicenç de Castellet,9326,4634,4692
08,Barcelona,264,Sant Vicenç de Montalt,6007,3044,2963
08,Barcelona,265,Sant Vicenç de Torelló,1975,975,1000
08,Barcelona,263,Sant Vicenç dels Horts,28103,14039,14064
08,Barcelona,243,Santa Cecília de Voltregà,173,91,82
08,Barcelona,244,Santa Coloma de Cervelló,8038,3948,4090
08,Barcelona,245,Santa Coloma de Gramenet,118738,59520,59218
08,Barcelona,246,Santa Eugènia de Berga,2233,1143,1090
08,Barcelona,247,Santa Eulàlia de Riuprimer,1259,637,622
08,Barcelona,248,Santa Eulàlia de Ronçana,7114,3577,3537
08,Barcelona,249,Santa Fe del Penedès,379,189,190
08,Barcelona,250,Santa Margarida de Montbui,9641,4802,4839
08,Barcelona,251,Santa Margarida i els Monjos,7337,3741,3596
08,Barcelona,253,Santa Maria de Besora,162,83,79
08,Barcelona,254,Santa Maria de Corcó,2188,1101,1087
08,Barcelona,256,Santa Maria de Martorelles,851,423,428
08,Barcelona,255,Santa Maria de Merlès,177,89,88
08,Barcelona,257,Santa Maria de Miralles,140,71,69
08,Barcelona,259,Santa Maria de Palautordera,9138,4640,4498
08,Barcelona,258,Santa Maria d'Oló,1065,546,519
08,Barcelona,260,Santa Perpètua de Mogoda,25409,12907,12502
08,Barcelona,261,Santa Susanna,3293,1662,1631
08,Barcelona,192,Santpedor,7384,3691,3693
08,Barcelona,267,Sentmenat,8645,4378,4267
08,Barcelona,269,Seva,3488,1782,1706
08,Barcelona,270,Sitges,28171,14029,14142
08,Barcelona,271,Sobremunt,83,36,47
08,Barcelona,272,Sora,175,97,78
08,Barcelona,273,Subirats,3029,1555,1474
08,Barcelona,274,Súria,5999,2891,3108
08,Barcelona,276,Tagamanent,322,174,148
08,Barcelona,277,Talamanca,141,80,61
08,Barcelona,278,Taradell,6219,3123,3096
08,Barcelona,275,Tavèrnoles,317,160,157
08,Barcelona,280,Tavertet,125,70,55
08,Barcelona,281,Teià,6141,3053,3088
08,Barcelona,279,Terrassa,215517,106429,109088
08,Barcelona,282,Tiana,8314,3980,4334
08,Barcelona,283,Tona,8012,3927,4085
08,Barcelona,284,Tordera,16345,8267,8078
08,Barcelona,285,Torelló,13949,6856,7093
08,Barcelona,286,"Torre de Claramunt, La",3819,1968,1851
08,Barcelona,287,Torrelavit,1393,736,657
08,Barcelona,288,Torrelles de Foix,2308,1206,1102
08,Barcelona,289,Torrelles de Llobregat,5851,2895,2956
08,Barcelona,290,Ullastrell,2056,1027,1029
08,Barcelona,291,Vacarisses,6218,3215,3003
08,Barcelona,292,Vallbona d'Anoia,1424,735,689
08,Barcelona,293,Vallcebre,258,146,112
08,Barcelona,294,Vallgorguina,2699,1381,1318
08,Barcelona,295,Vallirana,14612,7301,7311
08,Barcelona,296,Vallromanes,2519,1270,1249
08,Barcelona,297,Veciana,176,102,74
08,Barcelona,298,Vic,41956,20822,21134
08,Barcelona,299,Vilada,443,233,210
08,Barcelona,301,Viladecans,65358,32458,32900
08,Barcelona,300,Viladecavalls,7395,3705,3690
08,Barcelona,305,Vilafranca del Penedès,39221,19306,19915
08,Barcelona,306,Vilalba Sasserra,706,347,359
08,Barcelona,303,Vilanova de Sau,314,156,158
08,Barcelona,302,Vilanova del Camí,12506,6284,6222
08,Barcelona,902,Vilanova del Vallès,5250,2671,2579
08,Barcelona,307,Vilanova i la Geltrú,65941,32069,33872
08,Barcelona,214,Vilassar de Dalt,8882,4375,4507
08,Barcelona,219,Vilassar de Mar,20185,9736,10449
08,Barcelona,304,Vilobí del Penedès,1090,553,537
08,Barcelona,308,Viver i Serrateix,174,91,83
48,Bizkaia,1,Abadiño,7504,3725,3779
48,Bizkaia,2,Abanto y Ciérvana-Abanto Zierbena,9688,4782,4906
48,Bizkaia,911,Ajangiz,463,239,224
48,Bizkaia,912,Alonsotegi,2843,1397,1446
48,Bizkaia,3,Amorebieta-Etxano,18579,9140,9439
48,Bizkaia,4,Amoroto,417,217,200
48,Bizkaia,5,Arakaldo,144,74,70
48,Bizkaia,6,Arantzazu,380,186,194
48,Bizkaia,93,Areatza,1211,579,632
48,Bizkaia,9,Arrankudiaga,974,483,491
48,Bizkaia,914,Arratzu,398,199,199
48,Bizkaia,10,Arrieta,573,291,282
48,Bizkaia,11,Arrigorriaga,12374,6010,6364
48,Bizkaia,23,Artea,775,391,384
48,Bizkaia,8,Artzentales,722,380,342
48,Bizkaia,91,Atxondo,1393,709,684
48,Bizkaia,70,Aulesti,654,327,327
48,Bizkaia,12,Bakio,2615,1328,1287
48,Bizkaia,90,Balmaseda,7829,3822,4007
48,Bizkaia,13,Barakaldo,100080,48414,51666
48,Bizkaia,14,Barrika,1537,753,784
48,Bizkaia,15,Basauri,41624,20275,21349
48,Bizkaia,92,Bedia,1035,490,545
48,Bizkaia,16,Berango,6925,3411,3514
48,Bizkaia,17,Bermeo,17057,8440,8617
48,Bizkaia,18,Berriatua,1236,679,557
48,Bizkaia,19,Berriz,4785,2395,2390
48,Bizkaia,20,Bilbao,346574,163377,183197
48,Bizkaia,21,Busturia,1693,840,853
48,Bizkaia,901,Derio,5940,2900,3040
48,Bizkaia,26,Dima,1416,729,687
48,Bizkaia,27,Durango,28806,14106,14700
48,Bizkaia,28,Ea,865,446,419
48,Bizkaia,31,Elantxobe,391,187,204
48,Bizkaia,32,Elorrio,7240,3585,3655
48,Bizkaia,902,Erandio,24311,11927,12384
48,Bizkaia,33,Ereño,244,127,117
48,Bizkaia,34,Ermua,16109,8059,8050
48,Bizkaia,79,Errigoiti,520,286,234
48,Bizkaia,29,Etxebarri,10754,5376,5378
48,Bizkaia,30,Etxebarria,790,401,389
48,Bizkaia,906,Forua,956,486,470
48,Bizkaia,35,Fruiz,555,288,267
48,Bizkaia,36,Galdakao,29351,14489,14862
48,Bizkaia,37,Galdames,815,428,387
48,Bizkaia,38,Gamiz-Fika,1342,676,666
48,Bizkaia,39,Garai,316,162,154
48,Bizkaia,40,Gatika,1615,829,786
48,Bizkaia,41,Gautegiz Arteaga,868,441,427
48,Bizkaia,46,Gernika-Lumo,16797,8086,8711
48,Bizkaia,44,Getxo,79544,37411,42133
48,Bizkaia,47,Gizaburuaga,212,108,104
48,Bizkaia,42,Gordexola,1710,860,850
48,Bizkaia,43,Gorliz,5664,2811,2853
48,Bizkaia,45,Güeñes,6535,3207,3328
48,Bizkaia,48,Ibarrangelu,639,319,320
48,Bizkaia,94,Igorre,4247,2080,2167
48,Bizkaia,49,Ispaster,708,371,337
48,Bizkaia,910,Iurreta,3781,1866,1915
48,Bizkaia,50,Izurtza,274,164,110
48,Bizkaia,22,Karrantza Harana/Valle de Carranza,2794,1444,1350
48,Bizkaia,907,Kortezubi,461,233,228
48,Bizkaia,51,Lanestosa,266,137,129
48,Bizkaia,52,Larrabetzu,2023,987,1036
48,Bizkaia,53,Laukiz,1129,561,568
48,Bizkaia,54,Leioa,30685,14961,15724
48,Bizkaia,57,Lekeitio,7305,3601,3704
48,Bizkaia,55,Lemoa,3512,1764,1748
48,Bizkaia,56,Lemoiz,1182,622,560
48,Bizkaia,81,Lezama,2432,1195,1237
48,Bizkaia,903,Loiu,2388,1199,1189
48,Bizkaia,58,Mallabia,1211,612,599
48,Bizkaia,59,Mañaria,507,262,245
48,Bizkaia,60,Markina-Xemein,4982,2561,2421
48,Bizkaia,61,Maruri-Jatabe,945,481,464
48,Bizkaia,62,Mendata,379,200,179
48,Bizkaia,63,Mendexa,455,229,226
48,Bizkaia,64,Meñaka,745,386,359
48,Bizkaia,66,Morga,416,212,204
48,Bizkaia,68,Mundaka,1893,913,980
48,Bizkaia,69,Mungia,17055,8330,8725
48,Bizkaia,7,Munitibar-Arbatzegi Gerrikaitz,469,251,218
48,Bizkaia,908,Murueta,311,163,148
48,Bizkaia,71,Muskiz,7612,3775,3837
48,Bizkaia,67,Muxika,1443,737,706
48,Bizkaia,909,Nabarniz,239,124,115
48,Bizkaia,73,Ondarroa,8575,4299,4276
48,Bizkaia,75,Orozko,2610,1292,1318
48,Bizkaia,83,Ortuella,8410,4098,4312
48,Bizkaia,72,Otxandio,1297,659,638
48,Bizkaia,77,Plentzia,4344,2109,2235
48,Bizkaia,78,Portugalete,47117,22606,24511
48,Bizkaia,82,Santurtzi,46651,22615,24036
48,Bizkaia,84,Sestao,28288,13724,14564
48,Bizkaia,904,Sondika,4589,2208,2381
48,Bizkaia,85,Sopelana,13061,6417,6644
48,Bizkaia,86,Sopuerta,2563,1301,1262
48,Bizkaia,76,Sukarrieta,355,179,176
48,Bizkaia,87,Trucios-Turtzioz,525,281,244
48,Bizkaia,88,Ubide,180,91,89
48,Bizkaia,65,Ugao-Miraballes,4085,2056,2029
48,Bizkaia,89,Urduliz,3930,1939,1991
48,Bizkaia,74,Urduña/Orduña,4216,2149,2067
48,Bizkaia,80,Valle de Trápaga-Trapagaran,12129,5904,6225
48,Bizkaia,95,Zaldibar,3062,1532,1530
48,Bizkaia,96,Zalla,8481,4159,4322
48,Bizkaia,905,Zamudio,3263,1607,1656
48,Bizkaia,97,Zaratamo,1652,820,832
48,Bizkaia,24,Zeanuri,1269,650,619
48,Bizkaia,25,Zeberio,1085,542,543
48,Bizkaia,913,Zierbena,1498,800,698
48,Bizkaia,915,Ziortza-Bolibar,434,231,203
09,Burgos,1,Abajas,29,18,11
09,Burgos,3,Adrada de Haza,230,121,109
09,Burgos,6,Aguas Cándidas,63,39,24
09,Burgos,7,Aguilar de Bureba,69,40,29
09,Burgos,9,Albillos,223,121,102
09,Burgos,10,Alcocero de Mola,33,24,9
09,Burgos,11,Alfoz de Bricia,76,48,28
09,Burgos,907,Alfoz de Quintanadueñas,1995,1080,915
09,Burgos,12,Alfoz de Santa Gadea,111,64,47
09,Burgos,13,Altable,49,27,22
09,Burgos,14,"Altos, Los",157,97,60
09,Burgos,16,Ameyugo,101,55,46
09,Burgos,17,Anguix,117,67,50
09,Burgos,18,Aranda de Duero,33065,16183,16882
09,Burgos,19,Arandilla,179,110,69
09,Burgos,20,Arauzo de Miel,367,191,176
09,Burgos,21,Arauzo de Salce,62,34,28
09,Burgos,22,Arauzo de Torre,82,45,37
09,Burgos,23,Arcos,1525,826,699
09,Burgos,24,Arenillas de Riopisuerga,179,101,78
09,Burgos,25,Arija,153,80,73
09,Burgos,26,Arlanzón,442,264,178
09,Burgos,27,Arraya de Oca,47,28,19
09,Burgos,29,Atapuerca,195,111,84
09,Burgos,30,"Ausines, Los",135,83,52
09,Burgos,32,Avellanosa de Muñó,118,63,55
09,Burgos,33,Bahabón de Esgueva,94,58,36
09,Burgos,34,"Balbases, Los",329,177,152
09,Burgos,35,Baños de Valdearados,373,214,159
09,Burgos,36,Bañuelos de Bureba,31,20,11
09,Burgos,37,Barbadillo de Herreros,108,62,46
09,Burgos,38,Barbadillo del Mercado,145,79,66
09,Burgos,39,Barbadillo del Pez,75,46,29
09,Burgos,41,Barrio de Muñó,32,17,15
09,Burgos,43,"Barrios de Bureba, Los",204,124,80
09,Burgos,44,Barrios de Colina,49,24,25
09,Burgos,45,Basconcillos del Tozo,303,175,128
09,Burgos,46,Bascuñana,36,23,13
09,Burgos,47,Belbimbre,77,39,38
09,Burgos,48,Belorado,2010,1050,960
09,Burgos,50,Berberana,76,38,38
09,Burgos,51,Berlangas de Roa,179,93,86
09,Burgos,52,Berzosa de Bureba,34,24,10
09,Burgos,54,Bozoó,106,60,46
09,Burgos,55,Brazacorta,74,39,35
09,Burgos,56,Briviesca,7276,3687,3589
09,Burgos,57,Bugedo,181,115,66
09,Burgos,58,Buniel,511,286,225
09,Burgos,59,Burgos,177776,84939,92837
09,Burgos,60,Busto de Bureba,175,99,76
09,Burgos,61,Cabañes de Esgueva,182,97,85
09,Burgos,62,Cabezón de la Sierra,48,21,27
09,Burgos,64,Caleruega,490,242,248
09,Burgos,65,Campillo de Aranda,176,101,75
09,Burgos,66,Campolara,62,43,19
09,Burgos,67,Canicosa de la Sierra,543,284,259
09,Burgos,68,Cantabrana,32,18,14
09,Burgos,70,Carazo,37,26,11
09,Burgos,71,Carcedo de Bureba,49,28,21
09,Burgos,72,Carcedo de Burgos,380,213,167
09,Burgos,73,Cardeñadijo,1269,700,569
09,Burgos,74,Cardeñajimeno,1011,543,468
09,Burgos,75,Cardeñuela Riopico,137,81,56
09,Burgos,76,Carrias,23,20,3
09,Burgos,77,Cascajares de Bureba,33,18,15
09,Burgos,78,Cascajares de la Sierra,40,21,19
09,Burgos,79,Castellanos de Castro,50,31,19
09,Burgos,83,Castil de Peones,35,20,15
09,Burgos,82,Castildelgado,43,25,18
09,Burgos,84,Castrillo de la Reina,206,133,73
09,Burgos,85,Castrillo de la Vega,638,339,299
09,Burgos,88,Castrillo de Riopisuerga,66,42,24
09,Burgos,86,Castrillo del Val,846,521,325
09,Burgos,90,Castrillo Matajudíos,58,32,26
09,Burgos,91,Castrojeriz,853,448,405
09,Burgos,63,Cavia,259,146,113
09,Burgos,93,Cayuela,186,104,82
09,Burgos,94,Cebrecos,45,28,17
09,Burgos,95,Celada del Camino,105,56,49
09,Burgos,98,Cerezo de Río Tirón,605,334,271
09,Burgos,100,Cerratón de Juarros,57,38,19
09,Burgos,101,Ciadoncha,85,50,35
09,Burgos,102,Cillaperlata,41,27,14
09,Burgos,103,Cilleruelo de Abajo,255,137,118
09,Burgos,104,Cilleruelo de Arriba,62,33,29
09,Burgos,105,Ciruelos de Cervera,104,57,47
09,Burgos,108,Cogollos,478,269,209
09,Burgos,109,Condado de Treviño,1398,795,603
09,Burgos,110,Contreras,82,50,32
09,Burgos,112,Coruña del Conde,126,78,48
09,Burgos,113,Covarrubias,601,316,285
09,Burgos,114,Cubillo del Campo,99,56,43
09,Burgos,115,Cubo de Bureba,96,55,41
09,Burgos,117,"Cueva de Roa, La",102,52,50
09,Burgos,119,Cuevas de San Clemente,53,20,33
09,Burgos,120,Encío,46,24,22
09,Burgos,122,Espinosa de Cervera,101,61,40
09,Burgos,124,Espinosa de los Monteros,1840,983,857
09,Burgos,123,Espinosa del Camino,36,20,16
09,Burgos,125,Estépar,687,408,279
09,Burgos,127,Fontioso,56,30,26
09,Burgos,128,Frandovínez,98,57,41
09,Burgos,129,Fresneda de la Sierra Tirón,134,94,40
09,Burgos,130,Fresneña,86,48,38
09,Burgos,131,Fresnillo de las Dueñas,626,332,294
09,Burgos,132,Fresno de Río Tirón,190,108,82
09,Burgos,133,Fresno de Rodilla,49,29,20
09,Burgos,134,Frías,272,146,126
09,Burgos,135,Fuentebureba,46,19,27
09,Burgos,136,Fuentecén,239,136,103
09,Burgos,137,Fuentelcésped,219,110,109
09,Burgos,138,Fuentelisendo,102,60,42
09,Burgos,139,Fuentemolinos,101,64,37
09,Burgos,140,Fuentenebro,146,89,57
09,Burgos,141,Fuentespina,767,408,359
09,Burgos,143,Galbarros,28,20,8
09,Burgos,144,"Gallega, La",60,36,24
09,Burgos,148,Grijalba,110,54,56
09,Burgos,149,Grisaleña,40,27,13
09,Burgos,151,Gumiel de Izán,589,334,255
09,Burgos,152,Gumiel de Mercado,316,179,137
09,Burgos,154,Hacinas,164,91,73
09,Burgos,155,Haza,26,15,11
09,Burgos,159,Hontanas,68,41,27
09,Burgos,160,Hontangas,111,68,43
09,Burgos,162,Hontoria de la Cantera,148,84,64
09,Burgos,164,Hontoria de Valdearados,213,130,83
09,Burgos,163,Hontoria del Pinar,697,386,311
09,Burgos,166,"Hormazas, Las",107,64,43
09,Burgos,167,Hornillos del Camino,60,35,25
09,Burgos,168,"Horra, La",378,194,184
09,Burgos,169,Hortigüela,101,61,40
09,Burgos,170,Hoyales de Roa,217,110,107
09,Burgos,172,Huérmeces,126,62,64
09,Burgos,173,Huerta de Arriba,127,71,56
09,Burgos,174,Huerta de Rey,1028,549,479
09,Burgos,175,Humada,131,82,49
09,Burgos,176,Hurones,68,42,26
09,Burgos,177,Ibeas de Juarros,1426,792,634
09,Burgos,178,Ibrillos,55,31,24
09,Burgos,179,Iglesiarrubia,43,25,18
09,Burgos,180,Iglesias,135,78,57
09,Burgos,181,Isar,354,176,178
09,Burgos,182,Itero del Castillo,84,44,40
09,Burgos,183,Jaramillo de la Fuente,52,31,21
09,Burgos,184,Jaramillo Quemado,4,2,2
09,Burgos,189,Junta de Traslaloma,138,71,67
09,Burgos,190,Junta de Villalba de Losa,97,52,45
09,Burgos,191,Jurisdicción de Lara,40,21,19
09,Burgos,192,Jurisdicción de San Zadornil,53,27,26
09,Burgos,194,Lerma,2745,1386,1359
09,Burgos,195,Llano de Bureba,69,38,31
09,Burgos,196,Madrigal del Monte,169,103,66
09,Burgos,197,Madrigalejo del Monte,176,109,67
09,Burgos,198,Mahamud,121,68,53
09,Burgos,199,Mambrilla de Castrejón,97,52,45
09,Burgos,200,Mambrillas de Lara,50,29,21
09,Burgos,201,Mamolar,33,23,10
09,Burgos,202,Manciles,21,14,7
09,Burgos,206,Mazuela,63,33,30
09,Burgos,208,Mecerreyes,279,149,130
09,Burgos,209,Medina de Pomar,5933,3012,2921
09,Burgos,211,Melgar de Fernamental,1783,968,815
09,Burgos,213,Merindad de Cuesta-Urria,378,201,177
09,Burgos,214,Merindad de Montija,822,484,338
09,Burgos,906,Merindad de Río Ubierna,1411,772,639
09,Burgos,215,Merindad de Sotoscueva,426,245,181
09,Burgos,216,Merindad de Valdeporres,445,230,215
09,Burgos,217,Merindad de Valdivielso,400,233,167
09,Burgos,218,Milagros,472,254,218
09,Burgos,219,Miranda de Ebro,36724,18085,18639
09,Burgos,220,Miraveche,86,57,29
09,Burgos,221,Modúbar de la Emparedada,583,327,256
09,Burgos,223,Monasterio de la Sierra,47,31,16
09,Burgos,224,Monasterio de Rodilla,185,102,83
09,Burgos,225,Moncalvillo,93,54,39
09,Burgos,226,Monterrubio de la Demanda,61,33,28
09,Burgos,227,Montorio,164,92,72
09,Burgos,228,Moradillo de Roa,193,102,91
09,Burgos,229,Nava de Roa,220,114,106
09,Burgos,230,Navas de Bureba,35,15,20
09,Burgos,231,Nebreda,71,50,21
09,Burgos,232,Neila,175,99,76
09,Burgos,235,Olmedillo de Roa,204,119,85
09,Burgos,236,Olmillos de Muñó,38,22,16
09,Burgos,238,Oña,1109,578,531
09,Burgos,239,Oquillas,63,35,28
09,Burgos,241,Orbaneja Riopico,246,128,118
09,Burgos,242,Padilla de Abajo,89,48,41
09,Burgos,243,Padilla de Arriba,80,51,29
09,Burgos,244,Padrones de Bureba,51,25,26
09,Burgos,246,Palacios de la Sierra,752,381,371
09,Burgos,247,Palacios de Riopisuerga,31,14,17
09,Burgos,248,Palazuelos de la Sierra,76,44,32
09,Burgos,249,Palazuelos de Muñó,60,32,28
09,Burgos,250,Pampliega,348,182,166
09,Burgos,251,Pancorbo,480,260,220
09,Burgos,253,Pardilla,134,75,59
09,Burgos,255,Partido de la Sierra en Tobalina,86,51,35
09,Burgos,256,Pedrosa de Duero,451,252,199
09,Burgos,259,Pedrosa de Río Úrbel,257,156,101
09,Burgos,257,Pedrosa del Páramo,105,62,43
09,Burgos,258,Pedrosa del Príncipe,161,82,79
09,Burgos,261,Peñaranda de Duero,572,295,277
09,Burgos,262,Peral de Arlanza,165,87,78
09,Burgos,265,Piérnigas,38,25,13
09,Burgos,266,Pineda de la Sierra,95,59,36
09,Burgos,267,Pineda Trasmonte,133,82,51
09,Burgos,268,Pinilla de los Barruecos,119,68,51
09,Burgos,269,Pinilla de los Moros,38,24,14
09,Burgos,270,Pinilla Trasmonte,182,103,79
09,Burgos,272,Poza de la Sal,336,172,164
09,Burgos,273,Prádanos de Bureba,61,36,25
09,Burgos,274,Pradoluengo,1315,653,662
09,Burgos,275,Presencio,204,118,86
09,Burgos,276,"Puebla de Arganzón, La",531,288,243
09,Burgos,277,Puentedura,134,87,47
09,Burgos,279,Quemada,272,156,116
09,Burgos,281,Quintana del Pidio,166,85,81
09,Burgos,280,Quintanabureba,32,19,13
09,Burgos,283,Quintanaélez,56,28,28
09,Burgos,287,Quintanaortuño,277,151,126
09,Burgos,288,Quintanapalla,111,65,46
09,Burgos,289,Quintanar de la Sierra,1939,1025,914
09,Burgos,292,Quintanavides,102,59,43
09,Burgos,294,Quintanilla de la Mata,137,83,54
09,Burgos,901,Quintanilla del Agua y Tordueles,446,225,221
09,Burgos,295,Quintanilla del Coco,61,29,32
09,Burgos,298,Quintanilla San García,96,54,42
09,Burgos,301,Quintanilla Vivar,793,419,374
09,Burgos,297,"Quintanillas, Las",389,221,168
09,Burgos,302,Rabanera del Pinar,122,70,52
09,Burgos,303,Rábanos,93,53,40
09,Burgos,304,Rabé de las Calzadas,214,108,106
09,Burgos,306,Rebolledo de la Torre,124,66,58
09,Burgos,307,Redecilla del Camino,125,71,54
09,Burgos,308,Redecilla del Campo,72,42,30
09,Burgos,309,Regumiel de la Sierra,371,191,180
09,Burgos,310,Reinoso,11,8,3
09,Burgos,311,Retuerta,65,43,22
09,Burgos,314,Revilla del Campo,103,64,39
09,Burgos,316,Revilla Vallejera,84,54,30
09,Burgos,312,"Revilla y Ahedo, La",118,62,56
09,Burgos,315,Revillarruz,499,259,240
09,Burgos,317,Rezmondo,15,6,9
09,Burgos,318,Riocavado de la Sierra,57,35,22
09,Burgos,321,Roa,2443,1248,1195
09,Burgos,323,Rojas,70,46,24
09,Burgos,325,Royuela de Río Franco,216,128,88
09,Burgos,326,Rubena,176,103,73
09,Burgos,327,Rublacedo de Abajo,33,17,16
09,Burgos,328,Rucandio,74,36,38
09,Burgos,329,Salas de Bureba,144,85,59
09,Burgos,330,Salas de los Infantes,2140,1101,1039
09,Burgos,332,Saldaña de Burgos,178,100,78
09,Burgos,334,Salinillas de Bureba,51,39,12
09,Burgos,335,San Adrián de Juarros,85,50,35
09,Burgos,337,San Juan del Monte,149,85,64
09,Burgos,338,San Mamés de Burgos,287,165,122
09,Burgos,339,San Martín de Rubiales,143,83,60
09,Burgos,340,San Millán de Lara,79,56,23
09,Burgos,360,San Vicente del Valle,31,22,9
09,Burgos,343,Santa Cecilia,101,59,42
09,Burgos,345,Santa Cruz de la Salceda,163,96,67
09,Burgos,346,Santa Cruz del Valle Urbión,100,62,38
09,Burgos,347,Santa Gadea del Cid,158,88,70
09,Burgos,348,Santa Inés,159,82,77
09,Burgos,350,Santa María del Campo,618,333,285
09,Burgos,351,Santa María del Invierno,64,45,19
09,Burgos,352,Santa María del Mercadillo,121,72,49
09,Burgos,353,Santa María Rivarredonda,98,56,42
09,Burgos,354,Santa Olalla de Bureba,34,25,9
09,Burgos,355,Santibáñez de Esgueva,106,57,49
09,Burgos,356,Santibáñez del Val,56,36,20
09,Burgos,358,Santo Domingo de Silos,302,186,116
09,Burgos,361,Sargentes de la Lora,134,76,58
09,Burgos,362,Sarracín,260,144,116
09,Burgos,363,Sasamón,1093,609,484
09,Burgos,365,"Sequera de Haza, La",35,22,13
09,Burgos,366,Solarana,89,46,43
09,Burgos,368,Sordillos,25,16,9
09,Burgos,369,Sotillo de la Ribera,537,282,255
09,Burgos,372,Sotragero,283,154,129
09,Burgos,373,Sotresgudo,500,285,215
09,Burgos,374,Susinos del Páramo,107,70,37
09,Burgos,375,Tamarón,42,23,19
09,Burgos,377,Tardajos,802,418,384
09,Burgos,378,Tejada,34,22,12
09,Burgos,380,Terradillos de Esgueva,92,44,48
09,Burgos,381,Tinieblas de la Sierra,39,22,17
09,Burgos,382,Tobar,29,17,12
09,Burgos,384,Tordómar,353,198,155
09,Burgos,386,Torrecilla del Monte,77,42,35
09,Burgos,387,Torregalindo,134,80,54
09,Burgos,388,Torrelara,34,22,12
09,Burgos,389,Torrepadre,63,36,27
09,Burgos,390,Torresandino,696,377,319
09,Burgos,391,Tórtoles de Esgueva,506,268,238
09,Burgos,392,Tosantos,56,32,24
09,Burgos,394,Trespaderne,909,484,425
09,Burgos,395,Tubilla del Agua,149,92,57
09,Burgos,396,Tubilla del Lago,157,87,70
09,Burgos,398,Úrbel del Castillo,83,55,28
09,Burgos,400,Vadocondes,383,211,172
09,Burgos,403,Valdeande,103,67,36
09,Burgos,405,Valdezate,143,74,69
09,Burgos,406,Valdorros,308,176,132
09,Burgos,408,Vallarta de Bureba,48,30,18
09,Burgos,904,Valle de las Navas,560,318,242
09,Burgos,908,Valle de Losa,541,317,224
09,Burgos,409,Valle de Manzanedo,128,69,59
09,Burgos,410,Valle de Mena,3856,1983,1873
09,Burgos,411,Valle de Oca,162,100,62
09,Burgos,902,Valle de Santibáñez,513,283,230
09,Burgos,905,Valle de Sedano,467,267,200
09,Burgos,412,Valle de Tobalina,1006,548,458
09,Burgos,413,Valle de Valdebezana,537,286,251
09,Burgos,414,Valle de Valdelaguna,200,112,88
09,Burgos,415,Valle de Valdelucio,320,168,152
09,Burgos,416,Valle de Zamanzas,69,38,31
09,Burgos,417,Vallejera,39,24,15
09,Burgos,418,Valles de Palenzuela,88,45,43
09,Burgos,419,Valluércanes,80,54,26
09,Burgos,407,Valmala,30,15,15
09,Burgos,422,"Vid de Bureba, La",19,8,11
09,Burgos,421,"Vid y Barrios, La",262,152,110
09,Burgos,423,Vileña,31,20,11
09,Burgos,427,Villadiego,1621,886,735
09,Burgos,428,Villaescusa de Roa,118,65,53
09,Burgos,429,Villaescusa la Sombría,68,47,21
09,Burgos,430,Villaespasa,26,13,13
09,Burgos,431,Villafranca Montes de Oca,134,78,56
09,Burgos,432,Villafruela,212,121,91
09,Burgos,433,Villagalijo,67,44,23
09,Burgos,434,Villagonzalo Pedernales,1744,917,827
09,Burgos,437,Villahoz,325,175,150
09,Burgos,438,Villalba de Duero,670,349,321
09,Burgos,439,Villalbilla de Burgos,1256,670,586
09,Burgos,440,Villalbilla de Gumiel,102,61,41
09,Burgos,441,Villaldemiro,69,39,30
09,Burgos,442,Villalmanzo,459,245,214
09,Burgos,443,Villamayor de los Montes,202,102,100
09,Burgos,444,Villamayor de Treviño,78,39,39
09,Burgos,445,Villambistia,45,31,14
09,Burgos,446,Villamedianilla,13,8,5
09,Burgos,447,Villamiel de la Sierra,40,24,16
09,Burgos,448,Villangómez,240,149,91
09,Burgos,449,Villanueva de Argaño,106,66,40
09,Burgos,450,Villanueva de Carazo,32,20,12
09,Burgos,451,Villanueva de Gumiel,276,139,137
09,Burgos,454,Villanueva de Teba,46,31,15
09,Burgos,455,Villaquirán de la Puebla,44,26,18
09,Burgos,456,Villaquirán de los Infantes,152,78,74
09,Burgos,903,Villarcayo de Merindad de Castilla la Vieja,4604,2391,2213
09,Burgos,458,Villariezo,575,325,250
09,Burgos,460,Villasandino,199,118,81
09,Burgos,463,Villasur de Herreros,272,157,115
09,Burgos,464,Villatuelda,46,26,20
09,Burgos,466,Villaverde del Monte,135,76,59
09,Burgos,467,Villaverde-Mogina,83,57,26
09,Burgos,471,Villayerno Morquillas,213,113,100
09,Burgos,472,Villazopeque,59,36,23
09,Burgos,473,Villegas,89,52,37
09,Burgos,476,Villoruebo,59,39,20
09,Burgos,424,Viloria de Rioja,41,24,17
09,Burgos,425,Vilviestre del Pinar,630,345,285
09,Burgos,478,Vizcaínos,46,29,17
09,Burgos,480,Zael,117,62,55
09,Burgos,482,Zarzosa de Río Pisuerga,31,20,11
09,Burgos,483,Zazuar,247,129,118
09,Burgos,485,Zuñeda,58,35,23
10,Cáceres,1,Abadía,324,182,142
10,Cáceres,2,Abertura,436,219,217
10,Cáceres,3,Acebo,594,306,288
10,Cáceres,4,Acehúche,829,402,427
10,Cáceres,5,Aceituna,615,322,293
10,Cáceres,6,Ahigal,1454,754,700
10,Cáceres,903,Alagón del Río,936,471,465
10,Cáceres,7,Albalá,723,362,361
10,Cáceres,8,Alcántara,1571,781,790
10,Cáceres,9,Alcollarín,270,133,137
10,Cáceres,10,Alcuéscar,2809,1453,1356
10,Cáceres,12,Aldea del Cano,683,326,357
10,Cáceres,13,"Aldea del Obispo, La",326,171,155
10,Cáceres,11,Aldeacentenera,630,323,307
10,Cáceres,14,Aldeanueva de la Vera,2163,1049,1114
10,Cáceres,15,Aldeanueva del Camino,796,385,411
10,Cáceres,16,Aldehuela de Jerte,375,198,177
10,Cáceres,17,Alía,936,474,462
10,Cáceres,18,Aliseda,1984,993,991
10,Cáceres,19,Almaraz,1663,854,809
10,Cáceres,20,Almoharín,1943,950,993
10,Cáceres,21,Arroyo de la Luz,6101,3031,3070
10,Cáceres,23,Arroyomolinos,827,440,387
10,Cáceres,22,Arroyomolinos de la Vera,474,239,235
10,Cáceres,24,Baños de Montemayor,782,371,411
10,Cáceres,25,Barrado,436,224,212
10,Cáceres,26,Belvís de Monroy,638,332,306
10,Cáceres,27,Benquerencia,82,47,35
10,Cáceres,28,Berrocalejo,123,67,56
10,Cáceres,29,Berzocana,478,243,235
10,Cáceres,30,Bohonal de Ibor,508,254,254
10,Cáceres,31,Botija,188,101,87
10,Cáceres,32,Brozas,1969,988,981
10,Cáceres,33,Cabañas del Castillo,458,245,213
10,Cáceres,34,Cabezabellosa,391,201,190
10,Cáceres,35,Cabezuela del Valle,2341,1208,1133
10,Cáceres,36,Cabrero,359,197,162
10,Cáceres,37,Cáceres,95855,46059,49796
10,Cáceres,38,Cachorrilla,101,54,47
10,Cáceres,39,Cadalso,483,239,244
10,Cáceres,40,Calzadilla,503,254,249
10,Cáceres,41,Caminomorisco,1267,657,610
10,Cáceres,42,Campillo de Deleitosa,54,21,33
10,Cáceres,43,Campo Lugar,941,480,461
10,Cáceres,44,Cañamero,1732,901,831
10,Cáceres,45,Cañaveral,1136,558,578
10,Cáceres,46,Carbajo,223,113,110
10,Cáceres,47,Carcaboso,1122,569,553
10,Cáceres,48,Carrascalejo,273,134,139
10,Cáceres,49,Casar de Cáceres,4703,2329,2374
10,Cáceres,50,Casar de Palomero,1285,652,633
10,Cáceres,51,Casares de las Hurdes,422,212,210
10,Cáceres,52,Casas de Don Antonio,192,95,97
10,Cáceres,53,Casas de Don Gómez,308,162,146
10,Cáceres,56,Casas de Millán,652,331,321
10,Cáceres,57,Casas de Miravete,148,94,54
10,Cáceres,54,Casas del Castañar,604,294,310
10,Cáceres,55,Casas del Monte,821,412,409
10,Cáceres,58,Casatejada,1439,752,687
10,Cáceres,59,Casillas de Coria,423,202,221
10,Cáceres,60,Castañar de Ibor,1139,586,553
10,Cáceres,61,Ceclavín,1957,995,962
10,Cáceres,62,Cedillo,493,260,233
10,Cáceres,63,Cerezo,185,88,97
10,Cáceres,64,Cilleros,1752,885,867
10,Cáceres,65,Collado de la Vera,156,83,73
10,Cáceres,66,Conquista de la Sierra,202,115,87
10,Cáceres,67,Coria,12921,6343,6578
10,Cáceres,68,Cuacos de Yuste,877,450,427
10,Cáceres,69,"Cumbre, La",929,468,461
10,Cáceres,70,Deleitosa,772,396,376
10,Cáceres,71,Descargamaría,152,86,66
10,Cáceres,72,Eljas,970,500,470
10,Cáceres,73,Escurial,788,418,370
10,Cáceres,75,Fresnedoso de Ibor,304,159,145
10,Cáceres,76,Galisteo,1006,485,521
10,Cáceres,77,Garciaz,801,413,388
10,Cáceres,79,Garganta la Olla,994,529,465
10,Cáceres,78,"Garganta, La",464,251,213
10,Cáceres,80,Gargantilla,423,215,208
10,Cáceres,81,Gargüera,106,56,50
10,Cáceres,82,Garrovillas de Alconétar,2226,1085,1141
10,Cáceres,83,Garvín,97,54,43
10,Cáceres,84,Gata,1618,838,780
10,Cáceres,85,"Gordo, El",378,192,186
10,Cáceres,86,"Granja, La",359,191,168
10,Cáceres,87,Guadalupe,2021,997,1024
10,Cáceres,88,Guijo de Coria,227,119,108
10,Cáceres,89,Guijo de Galisteo,1601,809,792
10,Cáceres,90,Guijo de Granadilla,594,310,284
10,Cáceres,91,Guijo de Santa Bárbara,423,224,199
10,Cáceres,92,Herguijuela,346,174,172
10,Cáceres,93,Hernán-Pérez,489,252,237
10,Cáceres,94,Herrera de Alcántara,275,142,133
10,Cáceres,95,Herreruela,376,185,191
10,Cáceres,96,Hervás,4180,2075,2105
10,Cáceres,97,Higuera,110,68,42
10,Cáceres,98,Hinojal,426,216,210
10,Cáceres,99,Holguera,713,357,356
10,Cáceres,100,Hoyos,909,460,449
10,Cáceres,101,Huélaga,220,113,107
10,Cáceres,102,Ibahernando,567,272,295
10,Cáceres,103,Jaraicejo,531,255,276
10,Cáceres,104,Jaraíz de la Vera,6515,3253,3262
10,Cáceres,105,Jarandilla de la Vera,2994,1496,1498
10,Cáceres,106,Jarilla,156,77,79
10,Cáceres,107,Jerte,1289,659,630
10,Cáceres,108,Ladrillar,197,107,90
10,Cáceres,109,Logrosán,2119,1077,1042
10,Cáceres,110,Losar de la Vera,2846,1466,1380
10,Cáceres,111,Madrigal de la Vera,1751,917,834
10,Cáceres,112,Madrigalejo,1862,930,932
10,Cáceres,113,Madroñera,2749,1357,1392
10,Cáceres,114,Majadas,1321,663,658
10,Cáceres,115,Malpartida de Cáceres,4357,2176,2181
10,Cáceres,116,Malpartida de Plasencia,4707,2357,2350
10,Cáceres,117,Marchagaz,231,122,109
10,Cáceres,118,Mata de Alcántara,314,165,149
10,Cáceres,119,Membrío,701,335,366
10,Cáceres,120,Mesas de Ibor,173,93,80
10,Cáceres,121,Miajadas,10012,4969,5043
10,Cáceres,122,Millanes,255,134,121
10,Cáceres,123,Mirabel,692,348,344
10,Cáceres,124,Mohedas de Granadilla,867,437,430
10,Cáceres,125,Monroy,1053,524,529
10,Cáceres,126,Montánchez,1839,915,924
10,Cáceres,127,Montehermoso,5855,3004,2851
10,Cáceres,128,Moraleja,7072,3525,3547
10,Cáceres,129,Morcillo,406,191,215
10,Cáceres,130,Navaconcejo,2001,1009,992
10,Cáceres,131,Navalmoral de la Mata,17322,8358,8964
10,Cáceres,132,Navalvillar de Ibor,455,226,229
10,Cáceres,133,Navas del Madroño,1377,685,692
10,Cáceres,134,Navezuelas,660,344,316
10,Cáceres,135,Nuñomoral,1393,750,643
10,Cáceres,136,Oliva de Plasencia,264,146,118
10,Cáceres,137,Palomero,374,194,180
10,Cáceres,138,Pasarón de la Vera,659,321,338
10,Cáceres,139,Pedroso de Acim,111,63,48
10,Cáceres,140,Peraleda de la Mata,1420,728,692
10,Cáceres,141,Peraleda de San Román,316,160,156
10,Cáceres,142,Perales del Puerto,977,494,483
10,Cáceres,143,Pescueza,166,79,87
10,Cáceres,144,"Pesga, La",1138,593,545
10,Cáceres,145,Piedras Albas,156,73,83
10,Cáceres,146,Pinofranqueado,1760,934,826
10,Cáceres,147,Piornal,1549,790,759
10,Cáceres,148,Plasencia,40892,19858,21034
10,Cáceres,149,Plasenzuela,497,258,239
10,Cáceres,150,Portaje,390,201,189
10,Cáceres,151,Portezuelo,247,126,121
10,Cáceres,152,Pozuelo de Zarzón,499,243,256
10,Cáceres,153,Puerto de Santa Cruz,359,181,178
10,Cáceres,154,Rebollar,222,112,110
10,Cáceres,155,Riolobos,1310,680,630
10,Cáceres,156,Robledillo de Gata,100,52,48
10,Cáceres,157,Robledillo de la Vera,312,161,151
10,Cáceres,158,Robledillo de Trujillo,384,207,177
10,Cáceres,159,Robledollano,337,188,149
10,Cáceres,160,Romangordo,254,120,134
10,Cáceres,901,Rosalejo,1509,799,710
10,Cáceres,161,Ruanes,67,41,26
10,Cáceres,162,Salorino,642,335,307
10,Cáceres,163,Salvatierra de Santiago,251,124,127
10,Cáceres,164,San Martín de Trevejo,861,436,425
10,Cáceres,165,Santa Ana,275,146,129
10,Cáceres,166,Santa Cruz de la Sierra,337,167,170
10,Cáceres,167,Santa Cruz de Paniagua,341,187,154
10,Cáceres,168,Santa Marta de Magasca,305,149,156
10,Cáceres,169,Santiago de Alcántara,585,289,296
10,Cáceres,170,Santiago del Campo,274,133,141
10,Cáceres,171,Santibáñez el Alto,372,191,181
10,Cáceres,172,Santibáñez el Bajo,757,390,367
10,Cáceres,173,Saucedilla,847,452,395
10,Cáceres,174,Segura de Toro,202,93,109
10,Cáceres,175,Serradilla,1624,826,798
10,Cáceres,176,Serrejón,446,226,220
10,Cáceres,177,Sierra de Fuentes,2043,1049,994
10,Cáceres,178,Talaván,919,470,449
10,Cáceres,179,Talaveruela de la Vera,350,181,169
10,Cáceres,180,Talayuela,8268,4472,3796
10,Cáceres,181,Tejeda de Tiétar,862,465,397
10,Cáceres,904,Tiétar,942,489,453
10,Cáceres,182,Toril,167,106,61
10,Cáceres,183,Tornavacas,1164,604,560
10,Cáceres,184,"Torno, El",960,499,461
10,Cáceres,187,Torre de Don Miguel,516,274,242
10,Cáceres,188,Torre de Santa María,602,305,297
10,Cáceres,185,Torrecilla de los Ángeles,645,336,309
10,Cáceres,186,Torrecillas de la Tiesa,1151,576,575
10,Cáceres,190,Torrejón el Rubio,636,319,317
10,Cáceres,189,Torrejoncillo,3198,1575,1623
10,Cáceres,191,Torremenga,641,346,295
10,Cáceres,192,Torremocha,932,457,475
10,Cáceres,193,Torreorgaz,1710,825,885
10,Cáceres,194,Torrequemada,586,277,309
10,Cáceres,195,Trujillo,9558,4643,4915
10,Cáceres,196,Valdastillas,335,174,161
10,Cáceres,197,Valdecañas de Tajo,139,74,65
10,Cáceres,198,Valdefuentes,1307,643,664
10,Cáceres,199,Valdehúncar,198,106,92
10,Cáceres,200,Valdelacasa de Tajo,424,213,211
10,Cáceres,201,Valdemorales,208,106,102
10,Cáceres,202,Valdeobispo,705,342,363
10,Cáceres,203,Valencia de Alcántara,5786,2864,2922
10,Cáceres,204,Valverde de la Vera,522,263,259
10,Cáceres,205,Valverde del Fresno,2441,1237,1204
10,Cáceres,902,Vegaviana,863,450,413
10,Cáceres,206,Viandar de la Vera,272,135,137
10,Cáceres,207,Villa del Campo,521,257,264
10,Cáceres,208,Villa del Rey,137,72,65
10,Cáceres,209,Villamesías,325,160,165
10,Cáceres,210,Villamiel,542,273,269
10,Cáceres,211,Villanueva de la Sierra,467,234,233
10,Cáceres,212,Villanueva de la Vera,2155,1086,1069
10,Cáceres,214,Villar de Plasencia,235,123,112
10,Cáceres,213,Villar del Pedroso,639,335,304
10,Cáceres,215,Villasbuenas de Gata,392,205,187
10,Cáceres,216,Zarza de Granadilla,1865,957,908
10,Cáceres,217,Zarza de Montánchez,573,285,288
10,Cáceres,218,Zarza la Mayor,1372,680,692
10,Cáceres,219,Zorita,1522,766,756
11,Cádiz,1,Alcalá de los Gazules,5377,2750,2627
11,Cádiz,2,Alcalá del Valle,5221,2635,2586
11,Cádiz,3,Algar,1482,766,716
11,Cádiz,4,Algeciras,117974,58350,59624
11,Cádiz,5,Algodonales,5677,2888,2789
11,Cádiz,6,Arcos de la Frontera,31250,15647,15603
11,Cádiz,7,Barbate,22861,11468,11393
11,Cádiz,8,"Barrios, Los",22991,11504,11487
11,Cádiz,901,Benalup-Casas Viejas,6967,3537,3430
11,Cádiz,9,Benaocaz,719,381,338
11,Cádiz,10,Bornos,8022,4002,4020
11,Cádiz,11,"Bosque, El",2069,1043,1026
11,Cádiz,12,Cádiz,121739,57599,64140
11,Cádiz,13,Castellar de la Frontera,3084,1544,1540
11,Cádiz,15,Chiclana de la Frontera,82298,41499,40799
11,Cádiz,16,Chipiona,19004,9554,9450
11,Cádiz,14,Conil de la Frontera,22063,11141,10922
11,Cádiz,17,Espera,3912,1969,1943
11,Cádiz,18,"Gastor, El",1803,936,867
11,Cádiz,19,Grazalema,2165,1083,1082
11,Cádiz,20,Jerez de la Frontera,212226,103974,108252
11,Cádiz,21,Jimena de la Frontera,9710,4986,4724
11,Cádiz,22,"Línea de la Concepción, La",63132,31001,32131
11,Cádiz,23,Medina-Sidonia,11794,6021,5773
11,Cádiz,24,Olvera,8351,4107,4244
11,Cádiz,25,Paterna de Rivera,5609,2881,2728
11,Cádiz,26,Prado del Rey,5885,2939,2946
11,Cádiz,27,"Puerto de Santa María, El",88700,43625,45075
11,Cádiz,28,Puerto Real,41486,20899,20587
11,Cádiz,29,Puerto Serrano,7127,3606,3521
11,Cádiz,30,Rota,29179,14570,14609
11,Cádiz,31,San Fernando,96335,47352,48983
11,Cádiz,902,San José del Valle,4457,2281,2176
11,Cádiz,33,San Roque,29491,14734,14757
11,Cádiz,32,Sanlúcar de Barrameda,67385,33610,33775
11,Cádiz,34,Setenil de las Bodegas,2856,1464,1392
11,Cádiz,35,Tarifa,17908,9105,8803
11,Cádiz,36,Torre Alháquime,776,398,378
11,Cádiz,37,Trebujena,7090,3544,3546
11,Cádiz,38,Ubrique,16884,8324,8560
11,Cádiz,39,Vejer de la Frontera,12897,6468,6429
11,Cádiz,40,Villaluenga del Rosario,456,238,218
11,Cádiz,41,Villamartín,12303,6170,6133
11,Cádiz,42,Zahara,1460,747,713
39,Cantabria,1,Alfoz de Lloredo,2499,1277,1222
39,Cantabria,2,Ampuero,4228,2165,2063
39,Cantabria,3,Anievas,327,169,158
39,Cantabria,4,Arenas de Iguña,1775,915,860
39,Cantabria,5,Argoños,1705,876,829
39,Cantabria,6,Arnuero,2107,1065,1042
39,Cantabria,7,Arredondo,507,288,219
39,Cantabria,8,"Astillero, El",18282,8954,9328
39,Cantabria,9,Bárcena de Cicero,4080,2127,1953
39,Cantabria,10,Bárcena de Pie de Concha,735,362,373
39,Cantabria,11,Bareyo,2016,1010,1006
39,Cantabria,12,Cabezón de la Sal,8369,4069,4300
39,Cantabria,13,Cabezón de Liébana,628,367,261
39,Cantabria,14,Cabuérniga,1016,545,471
39,Cantabria,15,Camaleño,1001,535,466
39,Cantabria,16,Camargo,31007,15228,15779
39,Cantabria,27,Campoo de Enmedio,3795,1946,1849
39,Cantabria,17,Campoo de Yuso,668,362,306
39,Cantabria,18,Cartes,5687,2894,2793
39,Cantabria,19,Castañeda,2659,1359,1300
39,Cantabria,20,Castro-Urdiales,32144,16133,16011
39,Cantabria,21,Cieza,576,292,284
39,Cantabria,22,Cillorigo de Liébana,1345,725,620
39,Cantabria,23,Colindres,8272,4100,4172
39,Cantabria,24,Comillas,2320,1094,1226
39,Cantabria,25,"Corrales de Buelna, Los",11230,5518,5712
39,Cantabria,26,Corvera de Toranzo,2121,1085,1036
39,Cantabria,28,Entrambasaguas,4914,2520,2394
39,Cantabria,29,Escalante,754,395,359
39,Cantabria,30,Guriezo,2383,1235,1148
39,Cantabria,31,Hazas de Cesto,1524,773,751
39,Cantabria,32,Hermandad de Campoo de Suso,1687,920,767
39,Cantabria,33,Herrerías,648,365,283
39,Cantabria,34,Lamasón,294,190,104
39,Cantabria,35,Laredo,11800,5623,6177
39,Cantabria,36,Liendo,1250,642,608
39,Cantabria,37,Liérganes,2370,1183,1187
39,Cantabria,38,Limpias,1837,912,925
39,Cantabria,39,Luena,650,357,293
39,Cantabria,40,Marina de Cudeyo,5223,2624,2599
39,Cantabria,41,Mazcuerras,2131,1094,1037
39,Cantabria,42,Medio Cudeyo,7576,3692,3884
39,Cantabria,43,Meruelo,1912,967,945
39,Cantabria,44,Miengo,4626,2343,2283
39,Cantabria,45,Miera,417,222,195
39,Cantabria,46,Molledo,1612,792,820
39,Cantabria,47,Noja,2551,1279,1272
39,Cantabria,48,Penagos,1997,1010,987
39,Cantabria,49,Peñarrubia,357,190,167
39,Cantabria,50,Pesaguero,326,187,139
39,Cantabria,51,Pesquera,74,41,33
39,Cantabria,52,Piélagos,23999,11988,12011
39,Cantabria,53,Polaciones,236,152,84
39,Cantabria,54,Polanco,5633,2824,2809
39,Cantabria,55,Potes,1421,704,717
39,Cantabria,56,Puente Viesgo,2851,1456,1395
39,Cantabria,57,Ramales de la Victoria,2820,1422,1398
39,Cantabria,58,Rasines,988,527,461
39,Cantabria,59,Reinosa,9804,4628,5176
39,Cantabria,60,Reocín,8328,4108,4220
39,Cantabria,61,Ribamontán al Mar,4462,2254,2208
39,Cantabria,62,Ribamontán al Monte,2215,1144,1071
39,Cantabria,63,Rionansa,1053,595,458
39,Cantabria,64,Riotuerto,1594,779,815
39,Cantabria,65,"Rozas de Valdearroyo, Las",281,154,127
39,Cantabria,66,Ruente,1034,557,477
39,Cantabria,67,Ruesga,932,497,435
39,Cantabria,68,Ruiloba,784,406,378
39,Cantabria,69,San Felices de Buelna,2394,1189,1205
39,Cantabria,70,San Miguel de Aguayo,174,88,86
39,Cantabria,71,San Pedro del Romeral,477,261,216
39,Cantabria,72,San Roque de Riomiera,393,228,165
39,Cantabria,80,San Vicente de la Barquera,4314,2139,2175
39,Cantabria,73,Santa Cruz de Bezana,12500,6148,6352
39,Cantabria,74,Santa María de Cayón,9097,4599,4498
39,Cantabria,75,Santander,175736,81278,94458
39,Cantabria,76,Santillana del Mar,4197,2048,2149
39,Cantabria,77,Santiurde de Reinosa,285,165,120
39,Cantabria,78,Santiurde de Toranzo,1581,802,779
39,Cantabria,79,Santoña,11222,5494,5728
39,Cantabria,81,Saro,504,260,244
39,Cantabria,82,Selaya,1990,993,997
39,Cantabria,83,Soba,1280,692,588
39,Cantabria,84,Solórzano,1002,539,463
39,Cantabria,85,Suances,8580,4259,4321
39,Cantabria,86,"Tojos, Los",422,250,172
39,Cantabria,87,Torrelavega,54196,25772,28424
39,Cantabria,88,Tresviso,69,48,21
39,Cantabria,89,Tudanca,148,104,44
39,Cantabria,90,Udías,885,443,442
39,Cantabria,95,Val de San Vicente,2823,1455,1368
39,Cantabria,91,Valdáliga,2299,1200,1099
39,Cantabria,92,Valdeolea,1055,549,506
39,Cantabria,93,Valdeprado del Río,321,182,139
39,Cantabria,94,Valderredible,1010,565,445
39,Cantabria,101,Valle de Villaverde,327,161,166
39,Cantabria,96,Vega de Liébana,805,430,375
39,Cantabria,97,Vega de Pas,801,414,387
39,Cantabria,98,Villacarriedo,1701,893,808
39,Cantabria,99,Villaescusa,3808,1904,1904
39,Cantabria,100,Villafufre,1062,554,508
39,Cantabria,102,Voto,2751,1465,1286
12,Castellón/Castelló,2,Aín,129,69,60
12,Castellón/Castelló,3,Albocàsser,1351,666,685
12,Castellón/Castelló,4,Alcalà de Xivert,7233,3694,3539
12,Castellón/Castelló,5,"Alcora, l'",10672,5404,5268
12,Castellón/Castelló,6,Alcudia de Veo,218,116,102
12,Castellón/Castelló,7,Alfondeguilla,893,447,446
12,Castellón/Castelló,8,Algimia de Almonacid,292,171,121
12,Castellón/Castelló,9,Almazora/Almassora,25566,12833,12733
12,Castellón/Castelló,10,Almedíjar,261,139,122
12,Castellón/Castelló,11,Almenara,6123,3056,3067
12,Castellón/Castelló,901,Alquerías del Niño Perdido,4423,2193,2230
12,Castellón/Castelló,12,Altura,3670,1884,1786
12,Castellón/Castelló,13,Arañuel,181,90,91
12,Castellón/Castelló,14,Ares del Maestrat,210,113,97
12,Castellón/Castelló,15,Argelita,91,49,42
12,Castellón/Castelló,16,Artana,1994,1029,965
12,Castellón/Castelló,1,Atzeneta del Maestrat,1321,680,641
12,Castellón/Castelló,17,Ayódar,188,101,87
12,Castellón/Castelló,18,Azuébar,323,168,155
12,Castellón/Castelló,20,Barracas,194,105,89
12,Castellón/Castelló,22,Bejís,406,232,174
12,Castellón/Castelló,24,Benafer,171,90,81
12,Castellón/Castelló,25,Benafigos,156,88,68
12,Castellón/Castelló,26,Benasal,1162,594,568
12,Castellón/Castelló,27,Benicarló,26521,13261,13260
12,Castellón/Castelló,28,Benicasim/Benicàssim,18233,9178,9055
12,Castellón/Castelló,29,Benlloch,1153,584,569
12,Castellón/Castelló,21,Betxí,5770,2867,2903
12,Castellón/Castelló,32,Borriana/Burriana,34783,17274,17509
12,Castellón/Castelló,31,Borriol,5209,2639,2570
12,Castellón/Castelló,33,Cabanes,2985,1504,1481
12,Castellón/Castelló,34,Càlig,2080,1054,1026
12,Castellón/Castelló,36,Canet lo Roig,760,374,386
12,Castellón/Castelló,37,Castell de Cabres,16,10,6
12,Castellón/Castelló,38,Castellfort,215,111,104
12,Castellón/Castelló,39,Castellnovo,991,505,486
12,Castellón/Castelló,40,Castellón de la Plana/Castelló de la Plana,173841,84732,89109
12,Castellón/Castelló,41,Castillo de Villamalefa,105,65,40
12,Castellón/Castelló,42,Catí,787,397,390
12,Castellón/Castelló,43,Caudiel,739,380,359
12,Castellón/Castelló,44,Cervera del Maestre,644,312,332
12,Castellón/Castelló,52,Chert/Xert,819,405,414
12,Castellón/Castelló,53,Chilches/Xilxes,2853,1502,1351
12,Castellón/Castelló,55,Chodos/Xodos,126,71,55
12,Castellón/Castelló,56,Chóvar,339,177,162
12,Castellón/Castelló,45,Cinctorres,454,225,229
12,Castellón/Castelló,46,Cirat,225,125,100
12,Castellón/Castelló,48,Cortes de Arenoso,318,173,145
12,Castellón/Castelló,49,Costur,562,289,273
12,Castellón/Castelló,50,"Coves de Vinromà, les",1910,963,947
12,Castellón/Castelló,51,Culla,559,285,274
12,Castellón/Castelló,57,Eslida,877,432,445
12,Castellón/Castelló,58,Espadilla,96,50,46
12,Castellón/Castelló,59,Fanzara,323,164,159
12,Castellón/Castelló,60,Figueroles,549,277,272
12,Castellón/Castelló,61,Forcall,500,251,249
12,Castellón/Castelló,63,Fuente la Reina,54,30,24
12,Castellón/Castelló,64,Fuentes de Ayódar,135,69,66
12,Castellón/Castelló,65,Gaibiel,198,110,88
12,Castellón/Castelló,67,Geldo,667,343,324
12,Castellón/Castelló,68,Herbés,54,28,26
12,Castellón/Castelló,69,Higueras,59,30,29
12,Castellón/Castelló,70,"Jana, la",733,372,361
12,Castellón/Castelló,71,Jérica,1621,821,800
12,Castellón/Castelló,74,"Llosa, la",972,484,488
12,Castellón/Castelló,72,Lucena del Cid,1417,711,706
12,Castellón/Castelló,73,Ludiente,175,95,80
12,Castellón/Castelló,75,"Mata de Morella, la",181,92,89
12,Castellón/Castelló,76,Matet,93,45,48
12,Castellón/Castelló,77,Moncofa,6339,3266,3073
12,Castellón/Castelló,78,Montán,403,193,210
12,Castellón/Castelló,79,Montanejos,583,284,299
12,Castellón/Castelló,80,Morella,2638,1292,1346
12,Castellón/Castelló,81,Navajas,761,402,359
12,Castellón/Castelló,82,Nules,13456,6691,6765
12,Castellón/Castelló,83,Olocau del Rey,118,63,55
12,Castellón/Castelló,84,Onda,25228,12769,12459
12,Castellón/Castelló,85,Oropesa del Mar/Orpesa,9625,5086,4539
12,Castellón/Castelló,87,Palanques,30,15,15
12,Castellón/Castelló,88,Pavías,54,33,21
12,Castellón/Castelló,89,Peníscola/Peñíscola,7457,3762,3695
12,Castellón/Castelló,90,Pina de Montalgrao,134,67,67
12,Castellón/Castelló,93,"Pobla de Benifassà, la",226,120,106
12,Castellón/Castelló,94,"Pobla Tornesa, la",1172,621,551
12,Castellón/Castelló,91,Portell de Morella,222,113,109
12,Castellón/Castelló,92,Puebla de Arenoso,154,83,71
12,Castellón/Castelló,95,Ribesalbes,1265,632,633
12,Castellón/Castelló,96,Rossell,1041,545,496
12,Castellón/Castelló,97,Sacañet,78,45,33
12,Castellón/Castelló,98,"Salzadella, la",801,405,396
12,Castellón/Castelló,101,San Rafael del Río,512,258,254
12,Castellón/Castelló,902,Sant Joan de Moró,3045,1581,1464
12,Castellón/Castelló,99,Sant Jordi/San Jorge,1078,545,533
12,Castellón/Castelló,100,Sant Mateu,2031,1012,1019
12,Castellón/Castelló,102,Santa Magdalena de Pulpis,830,442,388
12,Castellón/Castelló,104,Segorbe,9233,4556,4677
12,Castellón/Castelló,103,"Serratella, la",99,52,47
12,Castellón/Castelló,105,Sierra Engarcerán,1031,552,479
12,Castellón/Castelló,106,Soneja,1489,733,756
12,Castellón/Castelló,107,Sot de Ferrer,437,224,213
12,Castellón/Castelló,108,Sueras/Suera,599,307,292
12,Castellón/Castelló,109,Tales,858,438,420
12,Castellón/Castelló,110,Teresa,283,147,136
12,Castellón/Castelló,111,Tírig,497,252,245
12,Castellón/Castelló,112,Todolella,140,78,62
12,Castellón/Castelló,113,Toga,112,53,59
12,Castellón/Castelló,114,Torás,238,122,116
12,Castellón/Castelló,115,"Toro, El",256,141,115
12,Castellón/Castelló,116,Torralba del Pinar,48,23,25
12,Castellón/Castelló,119,"Torre d'En Besora, la",167,95,72
12,Castellón/Castelló,120,"Torre d'en Doménec, la",213,108,105
12,Castellón/Castelló,117,Torreblanca,5520,2812,2708
12,Castellón/Castelló,118,Torrechiva,75,45,30
12,Castellón/Castelló,121,Traiguera,1531,775,756
12,Castellón/Castelló,122,"Useras/Useres, les",992,514,478
12,Castellón/Castelló,124,Vall d'Alba,2873,1493,1380
12,Castellón/Castelló,125,Vall de Almonacid,254,134,120
12,Castellón/Castelló,126,"Vall d'Uixó, la",31828,15788,16040
12,Castellón/Castelló,123,Vallat,54,23,31
12,Castellón/Castelló,127,Vallibona,87,49,38
12,Castellón/Castelló,128,Vilafamés,1912,1010,902
12,Castellón/Castelló,132,Vilanova d'Alcolea,604,318,286
12,Castellón/Castelló,134,Vilar de Canes,175,96,79
12,Castellón/Castelló,135,Vila-real,50755,25263,25492
12,Castellón/Castelló,136,"Vilavella, la",3273,1641,1632
12,Castellón/Castelló,129,Villafranca del Cid/Vilafranca,2352,1157,1195
12,Castellón/Castelló,130,Villahermosa del Río,500,266,234
12,Castellón/Castelló,131,Villamalur,75,41,34
12,Castellón/Castelló,133,Villanueva de Viver,68,37,31
12,Castellón/Castelló,137,Villores,42,22,20
12,Castellón/Castelló,138,Vinaròs,28337,14038,14299
12,Castellón/Castelló,139,Vistabella del Maestrazgo,384,202,182
12,Castellón/Castelló,140,Viver,1594,830,764
12,Castellón/Castelló,141,Zorita del Maestrazgo,129,67,62
12,Castellón/Castelló,142,Zucaina,184,100,84
13,Ciudad Real,1,Abenójar,1520,784,736
13,Ciudad Real,2,Agudo,1785,910,875
13,Ciudad Real,3,Alamillo,531,272,259
13,Ciudad Real,4,Albaladejo,1398,737,661
13,Ciudad Real,5,Alcázar de San Juan,31650,15471,16179
13,Ciudad Real,6,Alcoba,639,324,315
13,Ciudad Real,7,Alcolea de Calatrava,1513,763,750
13,Ciudad Real,8,Alcubillas,527,268,259
13,Ciudad Real,9,Aldea del Rey,1858,951,907
13,Ciudad Real,10,Alhambra,1054,533,521
13,Ciudad Real,11,Almadén,5861,2812,3049
13,Ciudad Real,12,Almadenejos,465,240,225
13,Ciudad Real,13,Almagro,9017,4446,4571
13,Ciudad Real,14,Almedina,595,307,288
13,Ciudad Real,15,Almodóvar del Campo,6582,3311,3271
13,Ciudad Real,16,Almuradiel,859,428,431
13,Ciudad Real,17,Anchuras,342,183,159
13,Ciudad Real,903,Arenales de San Gregorio,673,350,323
13,Ciudad Real,18,Arenas de San Juan,1089,561,528
13,Ciudad Real,19,Argamasilla de Alba,7201,3640,3561
13,Ciudad Real,20,Argamasilla de Calatrava,5997,3021,2976
13,Ciudad Real,21,Arroba de los Montes,459,241,218
13,Ciudad Real,22,Ballesteros de Calatrava,428,215,213
13,Ciudad Real,23,Bolaños de Calatrava,12135,6198,5937
13,Ciudad Real,24,Brazatortas,1037,531,506
13,Ciudad Real,25,Cabezarados,324,168,156
13,Ciudad Real,26,Cabezarrubias del Puerto,528,279,249
13,Ciudad Real,27,Calzada de Calatrava,4155,2077,2078
13,Ciudad Real,28,Campo de Criptana,14387,7262,7125
13,Ciudad Real,29,Cañada de Calatrava,110,61,49
13,Ciudad Real,30,Caracuel de Calatrava,169,98,71
13,Ciudad Real,31,Carrión de Calatrava,3080,1546,1534
13,Ciudad Real,32,Carrizosa,1369,685,684
13,Ciudad Real,33,Castellar de Santiago,2123,1061,1062
13,Ciudad Real,38,Chillón,1983,964,1019
13,Ciudad Real,34,Ciudad Real,74960,35474,39486
13,Ciudad Real,35,Corral de Calatrava,1150,572,578
13,Ciudad Real,36,"Cortijos, Los",951,498,453
13,Ciudad Real,37,Cózar,1134,570,564
13,Ciudad Real,39,Daimiel,18647,9307,9340
13,Ciudad Real,40,Fernán Caballero,1089,544,545
13,Ciudad Real,41,Fontanarejo,282,155,127
13,Ciudad Real,42,Fuencaliente,1088,572,516
13,Ciudad Real,43,Fuenllana,271,132,139
13,Ciudad Real,44,Fuente el Fresno,3432,1763,1669
13,Ciudad Real,45,Granátula de Calatrava,824,402,422
13,Ciudad Real,46,Guadalmez,841,421,420
13,Ciudad Real,47,Herencia,8847,4513,4334
13,Ciudad Real,48,Hinojosas de Calatrava,498,255,243
13,Ciudad Real,49,Horcajo de los Montes,961,481,480
13,Ciudad Real,50,"Labores, Las",638,315,323
13,Ciudad Real,904,Llanos del Caudillo,733,370,363
13,Ciudad Real,51,Luciana,407,215,192
13,Ciudad Real,52,Malagón,8433,4184,4249
13,Ciudad Real,53,Manzanares,18924,9444,9480
13,Ciudad Real,54,Membrilla,6246,3144,3102
13,Ciudad Real,55,Mestanza,744,368,376
13,Ciudad Real,56,Miguelturra,14967,7566,7401
13,Ciudad Real,57,Montiel,1472,766,706
13,Ciudad Real,58,Moral de Calatrava,5424,2717,2707
13,Ciudad Real,59,Navalpino,241,120,121
13,Ciudad Real,60,Navas de Estena,279,152,127
13,Ciudad Real,61,Pedro Muñoz,7802,3998,3804
13,Ciudad Real,62,Picón,712,376,336
13,Ciudad Real,63,Piedrabuena,4672,2376,2296
13,Ciudad Real,64,Poblete,2234,1155,1079
13,Ciudad Real,65,Porzuna,3925,2032,1893
13,Ciudad Real,66,Pozuelo de Calatrava,3349,1709,1640
13,Ciudad Real,67,"Pozuelos de Calatrava, Los",430,226,204
13,Ciudad Real,68,Puebla de Don Rodrigo,1236,657,579
13,Ciudad Real,69,Puebla del Príncipe,779,390,389
13,Ciudad Real,70,Puerto Lápice,995,506,489
13,Ciudad Real,71,Puertollano,50608,24642,25966
13,Ciudad Real,72,Retuerta del Bullaque,1036,574,462
13,Ciudad Real,901,"Robledo, El",1250,670,580
13,Ciudad Real,902,Ruidera,609,313,296
13,Ciudad Real,73,Saceruela,622,332,290
13,Ciudad Real,74,San Carlos del Valle,1211,625,586
13,Ciudad Real,75,San Lorenzo de Calatrava,226,119,107
13,Ciudad Real,76,Santa Cruz de los Cáñamos,554,277,277
13,Ciudad Real,77,Santa Cruz de Mudela,4455,2215,2240
13,Ciudad Real,78,Socuéllamos,13293,6799,6494
13,Ciudad Real,80,Solana del Pino,363,195,168
13,Ciudad Real,79,"Solana, La",16042,8114,7928
13,Ciudad Real,81,Terrinches,773,395,378
13,Ciudad Real,82,Tomelloso,38080,19120,18960
13,Ciudad Real,83,Torralba de Calatrava,3106,1541,1565
13,Ciudad Real,84,Torre de Juan Abad,1139,558,581
13,Ciudad Real,85,Torrenueva,2988,1502,1486
13,Ciudad Real,86,Valdemanco del Esteras,207,109,98
13,Ciudad Real,87,Valdepeñas,30705,15064,15641
13,Ciudad Real,88,Valenzuela de Calatrava,712,330,382
13,Ciudad Real,89,Villahermosa,2083,1002,1081
13,Ciudad Real,90,Villamanrique,1309,653,656
13,Ciudad Real,91,Villamayor de Calatrava,616,305,311
13,Ciudad Real,92,Villanueva de la Fuente,2339,1193,1146
13,Ciudad Real,93,Villanueva de los Infantes,5498,2717,2781
13,Ciudad Real,94,Villanueva de San Carlos,324,168,156
13,Ciudad Real,95,Villar del Pozo,89,50,39
13,Ciudad Real,96,Villarrubia de los Ojos,10738,5411,5327
13,Ciudad Real,97,Villarta de San Juan,3000,1521,1479
13,Ciudad Real,98,Viso del Marqués,2578,1261,1317
14,Córdoba,1,Adamuz,4398,2262,2136
14,Córdoba,2,Aguilar de la Frontera,13631,6886,6745
14,Córdoba,3,Alcaracejos,1527,735,792
14,Córdoba,4,Almedinilla,2468,1244,1224
14,Córdoba,5,Almodóvar del Río,7977,4006,3971
14,Córdoba,6,Añora,1555,775,780
14,Córdoba,7,Baena,20207,10317,9890
14,Córdoba,8,Belalcázar,3427,1651,1776
14,Córdoba,9,Belmez,3227,1580,1647
14,Córdoba,10,Benamejí,5123,2550,2573
14,Córdoba,11,"Blázquez, Los",701,362,339
14,Córdoba,12,Bujalance,7744,3866,3878
14,Córdoba,13,Cabra,21001,10293,10708
14,Córdoba,14,Cañete de las Torres,3033,1559,1474
14,Córdoba,15,Carcabuey,2632,1335,1297
14,Córdoba,16,Cardeña,1606,803,803
14,Córdoba,17,"Carlota, La",13872,6990,6882
14,Córdoba,18,"Carpio, El",4516,2241,2275
14,Córdoba,19,Castro del Río,8052,4002,4050
14,Córdoba,20,Conquista,448,222,226
14,Córdoba,21,Córdoba,328041,157704,170337
14,Córdoba,22,Doña Mencía,4935,2414,2521
14,Córdoba,23,Dos Torres,2442,1205,1237
14,Córdoba,24,Encinas Reales,2375,1176,1199
14,Córdoba,25,Espejo,3474,1761,1713
14,Córdoba,26,Espiel,2438,1232,1206
14,Córdoba,27,Fernán-Núñez,9801,4915,4886
14,Córdoba,28,Fuente la Lancha,365,187,178
14,Córdoba,29,Fuente Obejuna,4961,2541,2420
14,Córdoba,30,Fuente Palmera,11068,5577,5491
14,Córdoba,31,Fuente-Tójar,721,344,377
14,Córdoba,32,"Granjuela, La",482,246,236
14,Córdoba,33,Guadalcázar,1604,803,801
14,Córdoba,34,"Guijo, El",382,195,187
14,Córdoba,35,Hinojosa del Duque,7126,3476,3650
14,Córdoba,36,Hornachuelos,4660,2346,2314
14,Córdoba,37,Iznájar,4637,2327,2310
14,Córdoba,38,Lucena,42748,21277,21471
14,Córdoba,39,Luque,3178,1593,1585
14,Córdoba,40,Montalbán de Córdoba,4472,2250,2222
14,Córdoba,41,Montemayor,4001,2002,1999
14,Córdoba,42,Montilla,23622,11669,11953
14,Córdoba,43,Montoro,9744,4792,4952
14,Córdoba,44,Monturque,1995,993,1002
14,Córdoba,45,Moriles,3872,1936,1936
14,Córdoba,46,Nueva Carteya,5540,2807,2733
14,Córdoba,47,Obejo,2012,1023,989
14,Córdoba,48,Palenciana,1571,793,778
14,Córdoba,49,Palma del Río,21582,10764,10818
14,Córdoba,50,Pedro Abad,2960,1496,1464
14,Córdoba,51,Pedroche,1636,797,839
14,Córdoba,52,Peñarroya-Pueblonuevo,11430,5543,5887
14,Córdoba,53,Posadas,7512,3763,3749
14,Córdoba,54,Pozoblanco,17491,8564,8927
14,Córdoba,55,Priego de Córdoba,23112,11320,11792
14,Córdoba,56,Puente Genil,30186,15032,15154
14,Córdoba,57,"Rambla, La",7547,3785,3762
14,Córdoba,58,Rute,10387,5175,5212
14,Córdoba,59,San Sebastián de los Ballesteros,837,419,418
14,Córdoba,61,Santa Eufemia,893,448,445
14,Córdoba,60,Santaella,6097,3082,3015
14,Córdoba,62,Torrecampo,1202,592,610
14,Córdoba,63,Valenzuela,1261,614,647
14,Córdoba,64,Valsequillo,385,188,197
14,Córdoba,65,"Victoria, La",2385,1191,1194
14,Córdoba,66,Villa del Río,7426,3721,3705
14,Córdoba,67,Villafranca de Córdoba,4893,2516,2377
14,Córdoba,68,Villaharta,719,361,358
14,Córdoba,69,Villanueva de Córdoba,9226,4577,4649
14,Córdoba,70,Villanueva del Duque,1580,796,784
14,Córdoba,71,Villanueva del Rey,1122,562,560
14,Córdoba,72,Villaralto,1264,623,641
14,Córdoba,73,Villaviciosa de Córdoba,3478,1763,1715
14,Córdoba,74,"Viso, El",2683,1337,1346
14,Córdoba,75,Zuheros,696,352,344
15,"Coruña, A",1,Abegondo,5585,2769,2816
15,"Coruña, A",2,Ames,29975,14505,15470
15,"Coruña, A",3,Aranga,2033,1023,1010
15,"Coruña, A",4,Ares,5741,2845,2896
15,"Coruña, A",5,Arteixo,30857,15406,15451
15,"Coruña, A",6,Arzúa,6261,3107,3154
15,"Coruña, A",7,"Baña, A",3754,1795,1959
15,"Coruña, A",8,Bergondo,6702,3245,3457
15,"Coruña, A",9,Betanzos,13352,6353,6999
15,"Coruña, A",10,Boimorto,2115,1078,1037
15,"Coruña, A",11,Boiro,19060,9306,9754
15,"Coruña, A",12,Boqueixón,4342,2144,2198
15,"Coruña, A",13,Brión,7519,3643,3876
15,"Coruña, A",14,Cabana de Bergantiños,4623,2270,2353
15,"Coruña, A",15,Cabanas,3294,1616,1678
15,"Coruña, A",16,Camariñas,5774,2815,2959
15,"Coruña, A",17,Cambre,24029,11828,12201
15,"Coruña, A",18,"Capela, A",1356,670,686
15,"Coruña, A",19,Carballo,31288,15315,15973
15,"Coruña, A",901,Cariño,4241,2096,2145
15,"Coruña, A",20,Carnota,4376,2104,2272
15,"Coruña, A",21,Carral,6118,3011,3107
15,"Coruña, A",22,Cedeira,7147,3584,3563
15,"Coruña, A",23,Cee,7760,3721,4039
15,"Coruña, A",24,Cerceda,5156,2517,2639
15,"Coruña, A",25,Cerdido,1249,604,645
15,"Coruña, A",27,Coirós,1747,864,883
15,"Coruña, A",28,Corcubión,1672,823,849
15,"Coruña, A",29,Coristanco,6706,3222,3484
15,"Coruña, A",30,"Coruña, A",244810,113616,131194
15,"Coruña, A",31,Culleredo,29434,14330,15104
15,"Coruña, A",32,Curtis,4048,2025,2023
15,"Coruña, A",33,Dodro,2913,1411,1502
15,"Coruña, A",34,Dumbría,3137,1509,1628
15,"Coruña, A",35,Fene,13498,6449,7049
15,"Coruña, A",36,Ferrol,70389,33124,37265
15,"Coruña, A",37,Fisterra,4824,2441,2383
15,"Coruña, A",38,Frades,2485,1242,1243
15,"Coruña, A",39,Irixoa,1421,717,704
15,"Coruña, A",41,"Laracha, A",11443,5619,5824
15,"Coruña, A",40,Laxe,3207,1597,1610
15,"Coruña, A",42,Lousame,3513,1710,1803
15,"Coruña, A",43,Malpica de Bergantiños,5768,2801,2967
15,"Coruña, A",44,Mañón,1455,706,749
15,"Coruña, A",45,Mazaricos,4289,2056,2233
15,"Coruña, A",46,Melide,7578,3729,3849
15,"Coruña, A",47,Mesía,2795,1391,1404
15,"Coruña, A",48,Miño,5838,2898,2940
15,"Coruña, A",49,Moeche,1303,612,691
15,"Coruña, A",50,Monfero,2089,1066,1023
15,"Coruña, A",51,Mugardos,5417,2617,2800
15,"Coruña, A",53,Muros,9117,4402,4715
15,"Coruña, A",52,Muxía,5068,2462,2606
15,"Coruña, A",54,Narón,39574,19209,20365
15,"Coruña, A",55,Neda,5327,2608,2719
15,"Coruña, A",56,Negreira,7009,3388,3621
15,"Coruña, A",57,Noia,14571,6986,7585
15,"Coruña, A",58,Oleiros,34563,16793,17770
15,"Coruña, A",59,Ordes,12844,6257,6587
15,"Coruña, A",60,Oroso,7400,3668,3732
15,"Coruña, A",61,Ortigueira,5997,2855,3142
15,"Coruña, A",62,Outes,6804,3254,3550
15,"Coruña, A",902,Oza-Cesuras,5275,2650,2625
15,"Coruña, A",64,Paderne,2502,1231,1271
15,"Coruña, A",65,Padrón,8693,4171,4522
15,"Coruña, A",66,"Pino, O",4680,2327,2353
15,"Coruña, A",67,"Pobra do Caramiñal, A",9672,4737,4935
15,"Coruña, A",68,Ponteceso,5893,2944,2949
15,"Coruña, A",69,Pontedeume,8117,3888,4229
15,"Coruña, A",70,"Pontes de García Rodríguez, As",10634,5243,5391
15,"Coruña, A",71,Porto do Son,9571,4762,4809
15,"Coruña, A",72,Rianxo,11479,5609,5870
15,"Coruña, A",73,Ribeira,27565,13639,13926
15,"Coruña, A",74,Rois,4767,2265,2502
15,"Coruña, A",75,Sada,15156,7492,7664
15,"Coruña, A",76,San Sadurniño,3019,1494,1525
15,"Coruña, A",77,Santa Comba,9719,4672,5047
15,"Coruña, A",78,Santiago de Compostela,95800,44486,51314
15,"Coruña, A",79,Santiso,1742,907,835
15,"Coruña, A",80,Sobrado,1965,1017,948
15,"Coruña, A",81,"Somozas, As",1211,612,599
15,"Coruña, A",82,Teo,18254,8962,9292
15,"Coruña, A",83,Toques,1248,645,603
15,"Coruña, A",84,Tordoia,3706,1749,1957
15,"Coruña, A",85,Touro,3853,1905,1948
15,"Coruña, A",86,Trazo,3301,1629,1672
15,"Coruña, A",88,Val do Dubra,4120,1999,2121
15,"Coruña, A",87,Valdoviño,6796,3320,3476
15,"Coruña, A",89,Vedra,5073,2477,2596
15,"Coruña, A",91,Vilarmaior,1236,639,597
15,"Coruña, A",90,Vilasantar,1316,685,631
15,"Coruña, A",92,Vimianzo,7710,3723,3987
15,"Coruña, A",93,Zas,4902,2369,2533
16,Cuenca,1,Abia de la Obispalía,80,50,30
16,Cuenca,2,"Acebrón, El",238,120,118
16,Cuenca,3,Alarcón,149,68,81
16,Cuenca,4,Albaladejo del Cuende,301,157,144
16,Cuenca,5,Albalate de las Nogueras,288,157,131
16,Cuenca,6,Albendea,144,67,77
16,Cuenca,7,"Alberca de Záncara, La",1769,914,855
16,Cuenca,8,Alcalá de la Vega,107,58,49
16,Cuenca,9,Alcantud,73,40,33
16,Cuenca,10,Alcázar del Rey,150,68,82
16,Cuenca,11,Alcohujate,36,21,15
16,Cuenca,12,Alconchel de la Estrella,117,68,49
16,Cuenca,13,Algarra,25,18,7
16,Cuenca,14,Aliaguilla,710,377,333
16,Cuenca,15,"Almarcha, La",426,232,194
16,Cuenca,16,Almendros,272,149,123
16,Cuenca,17,Almodóvar del Pinar,455,240,215
16,Cuenca,18,Almonacid del Marquesado,456,236,220
16,Cuenca,19,Altarejos,183,95,88
16,Cuenca,20,Arandilla del Arroyo,17,10,7
16,Cuenca,905,Arcas,1594,805,789
16,Cuenca,22,Arcos de la Sierra,94,53,41
16,Cuenca,24,Arguisuelas,126,69,57
16,Cuenca,25,Arrancacepas,26,14,12
16,Cuenca,26,Atalaya del Cañavate,112,52,60
16,Cuenca,27,Barajas de Melo,965,507,458
16,Cuenca,29,Barchín del Hoyo,100,56,44
16,Cuenca,30,Bascuñana de San Pedro,21,12,9
16,Cuenca,31,Beamud,48,22,26
16,Cuenca,32,Belinchón,365,190,175
16,Cuenca,33,Belmonte,2033,994,1039
16,Cuenca,34,Belmontejo,198,107,91
16,Cuenca,35,Beteta,309,151,158
16,Cuenca,36,Boniches,145,70,75
16,Cuenca,38,Buciegas,47,26,21
16,Cuenca,39,Buenache de Alarcón,530,279,251
16,Cuenca,40,Buenache de la Sierra,103,62,41
16,Cuenca,41,Buendía,438,237,201
16,Cuenca,42,Campillo de Altobuey,1510,733,777
16,Cuenca,43,Campillos-Paravientos,123,63,60
16,Cuenca,44,Campillos-Sierra,40,20,20
16,Cuenca,901,Campos del Paraíso,880,443,437
16,Cuenca,45,Canalejas del Arroyo,270,145,125
16,Cuenca,46,Cañada del Hoyo,291,149,142
16,Cuenca,47,Cañada Juncosa,277,153,124
16,Cuenca,48,Cañamares,498,266,232
16,Cuenca,49,"Cañavate, El",162,83,79
16,Cuenca,50,Cañaveras,328,168,160
16,Cuenca,51,Cañaveruelas,160,82,78
16,Cuenca,52,Cañete,814,424,390
16,Cuenca,53,Cañizares,520,276,244
16,Cuenca,55,Carboneras de Guadazaón,762,389,373
16,Cuenca,56,Cardenete,556,290,266
16,Cuenca,57,Carrascosa,87,54,33
16,Cuenca,58,Carrascosa de Haro,125,62,63
16,Cuenca,60,Casas de Benítez,940,459,481
16,Cuenca,61,Casas de Fernando Alonso,1358,724,634
16,Cuenca,62,Casas de Garcimolina,30,19,11
16,Cuenca,63,Casas de Guijarro,135,73,62
16,Cuenca,64,Casas de Haro,861,455,406
16,Cuenca,65,Casas de los Pinos,522,255,267
16,Cuenca,66,Casasimarro,3175,1642,1533
16,Cuenca,67,Castejón,158,83,75
16,Cuenca,68,Castillejo de Iniesta,189,105,84
16,Cuenca,70,Castillejo-Sierra,32,18,14
16,Cuenca,72,Castillo de Garcimuñoz,163,89,74
16,Cuenca,71,Castillo-Albaráñez,19,9,10
16,Cuenca,73,Cervera del Llano,241,126,115
16,Cuenca,23,Chillarón de Cuenca,580,320,260
16,Cuenca,81,Chumillas,53,31,22
16,Cuenca,74,"Cierva, La",45,27,18
16,Cuenca,78,Cuenca,55738,26680,29058
16,Cuenca,79,Cueva del Hierro,34,23,11
16,Cuenca,82,Enguídanos,353,187,166
16,Cuenca,83,Fresneda de Altarejos,62,32,30
16,Cuenca,84,Fresneda de la Sierra,55,29,26
16,Cuenca,85,"Frontera, La",180,96,84
16,Cuenca,86,Fuente de Pedro Naharro,1295,675,620
16,Cuenca,87,Fuentelespino de Haro,279,141,138
16,Cuenca,88,Fuentelespino de Moya,123,66,57
16,Cuenca,904,Fuentenava de Jábaga,573,299,274
16,Cuenca,89,Fuentes,483,258,225
16,Cuenca,91,Fuertescusa,77,40,37
16,Cuenca,92,Gabaldón,194,113,81
16,Cuenca,93,Garaballa,83,43,40
16,Cuenca,94,Gascueña,175,91,84
16,Cuenca,95,Graja de Campalbo,98,51,47
16,Cuenca,96,Graja de Iniesta,389,202,187
16,Cuenca,97,Henarejos,177,85,92
16,Cuenca,98,"Herrumblar, El",718,374,344
16,Cuenca,99,"Hinojosa, La",218,110,108
16,Cuenca,100,"Hinojosos, Los",902,441,461
16,Cuenca,101,"Hito, El",174,95,79
16,Cuenca,102,Honrubia,1719,861,858
16,Cuenca,103,Hontanaya,337,183,154
16,Cuenca,104,Hontecillas,61,31,30
16,Cuenca,106,Horcajo de Santiago,3673,1879,1794
16,Cuenca,107,Huélamo,104,65,39
16,Cuenca,108,Huelves,64,32,32
16,Cuenca,109,Huérguina,39,19,20
16,Cuenca,110,Huerta de la Obispalía,140,81,59
16,Cuenca,111,Huerta del Marquesado,203,119,84
16,Cuenca,112,Huete,1881,958,923
16,Cuenca,113,Iniesta,4448,2184,2264
16,Cuenca,115,Laguna del Marquesado,50,25,25
16,Cuenca,116,Lagunaseca,77,44,33
16,Cuenca,117,Landete,1336,691,645
16,Cuenca,118,Ledaña,1723,852,871
16,Cuenca,119,Leganiel,193,101,92
16,Cuenca,121,"Majadas, Las",296,149,147
16,Cuenca,122,Mariana,316,166,150
16,Cuenca,123,Masegosa,80,43,37
16,Cuenca,124,"Mesas, Las",2501,1299,1202
16,Cuenca,125,Minglanilla,2348,1213,1135
16,Cuenca,126,Mira,977,487,490
16,Cuenca,128,Monreal del Llano,74,40,34
16,Cuenca,129,Montalbanejo,121,64,57
16,Cuenca,130,Montalbo,686,373,313
16,Cuenca,131,Monteagudo de las Salinas,128,78,50
16,Cuenca,132,Mota de Altarejos,35,24,11
16,Cuenca,133,Mota del Cuervo,6259,3116,3143
16,Cuenca,134,Motilla del Palancar,5915,2973,2942
16,Cuenca,135,Moya,172,93,79
16,Cuenca,137,Narboneta,44,23,21
16,Cuenca,139,Olivares de Júcar,355,189,166
16,Cuenca,140,Olmeda de la Cuesta,34,18,16
16,Cuenca,141,Olmeda del Rey,136,67,69
16,Cuenca,142,Olmedilla de Alarcón,163,91,72
16,Cuenca,143,Olmedilla de Eliz,21,13,8
16,Cuenca,145,Osa de la Vega,565,292,273
16,Cuenca,146,Pajarón,90,45,45
16,Cuenca,147,Pajaroncillo,68,42,26
16,Cuenca,148,Palomares del Campo,698,349,349
16,Cuenca,149,Palomera,183,96,87
16,Cuenca,150,Paracuellos,113,56,57
16,Cuenca,151,Paredes,66,39,27
16,Cuenca,152,"Parra de las Vegas, La",40,23,17
16,Cuenca,153,"Pedernoso, El",1213,619,594
16,Cuenca,154,"Pedroñeras, Las",6767,3522,3245
16,Cuenca,155,"Peral, El",752,422,330
16,Cuenca,156,"Peraleja, La",111,60,51
16,Cuenca,157,"Pesquera, La",252,132,120
16,Cuenca,158,"Picazo, El",707,364,343
16,Cuenca,159,Pinarejo,239,116,123
16,Cuenca,160,Pineda de Gigüela,73,38,35
16,Cuenca,161,Piqueras del Castillo,61,32,29
16,Cuenca,162,Portalrubio de Guadamejud,41,20,21
16,Cuenca,163,Portilla,74,39,35
16,Cuenca,165,Poyatos,69,36,33
16,Cuenca,166,Pozoamargo,329,174,155
16,Cuenca,908,Pozorrubielos de la Mancha,233,113,120
16,Cuenca,167,Pozorrubio de Santiago,355,166,189
16,Cuenca,169,"Pozuelo, El",59,33,26
16,Cuenca,170,Priego,1043,512,531
16,Cuenca,171,"Provencio, El",2544,1254,1290
16,Cuenca,172,Puebla de Almenara,413,216,197
16,Cuenca,174,Puebla del Salvador,221,122,99
16,Cuenca,175,Quintanar del Rey,7717,4036,3681
16,Cuenca,176,Rada de Haro,64,32,32
16,Cuenca,177,Reíllo,107,56,51
16,Cuenca,181,Rozalén del Monte,81,36,45
16,Cuenca,185,Saceda-Trasierra,52,31,21
16,Cuenca,186,Saelices,559,285,274
16,Cuenca,187,Salinas del Manzano,91,52,39
16,Cuenca,188,Salmeroncillos,130,72,58
16,Cuenca,189,Salvacañete,318,168,150
16,Cuenca,190,San Clemente,7188,3692,3496
16,Cuenca,191,San Lorenzo de la Parrilla,1160,577,583
16,Cuenca,192,San Martín de Boniches,46,28,18
16,Cuenca,193,San Pedro Palmiches,70,40,30
16,Cuenca,194,Santa Cruz de Moya,263,138,125
16,Cuenca,196,Santa María de los Llanos,717,373,344
16,Cuenca,195,Santa María del Campo Rus,652,322,330
16,Cuenca,197,Santa María del Val,61,33,28
16,Cuenca,198,Sisante,1800,907,893
16,Cuenca,199,Solera de Gabaldón,24,10,14
16,Cuenca,909,Sotorribas,829,423,406
16,Cuenca,202,Talayuelas,957,502,455
16,Cuenca,203,Tarancón,15604,7851,7753
16,Cuenca,204,Tébar,313,167,146
16,Cuenca,205,Tejadillos,116,56,60
16,Cuenca,206,Tinajas,224,119,105
16,Cuenca,209,Torralba,134,79,55
16,Cuenca,211,Torrejoncillo del Rey,460,236,224
16,Cuenca,212,Torrubia del Campo,291,145,146
16,Cuenca,213,Torrubia del Castillo,41,23,18
16,Cuenca,215,Tragacete,304,168,136
16,Cuenca,216,Tresjuncos,338,183,155
16,Cuenca,217,Tribaldos,96,49,47
16,Cuenca,218,Uclés,224,120,104
16,Cuenca,219,Uña,106,54,52
16,Cuenca,906,"Valdecolmenas, Los",93,57,36
16,Cuenca,224,Valdemeca,88,47,41
16,Cuenca,225,Valdemorillo de la Sierra,80,47,33
16,Cuenca,227,Valdemoro-Sierra,123,74,49
16,Cuenca,228,Valdeolivas,214,129,85
16,Cuenca,902,Valdetórtola,153,87,66
16,Cuenca,903,"Valeras, Las",1619,856,763
16,Cuenca,231,Valhermoso de la Fuente,62,33,29
16,Cuenca,173,"Valle de Altomira, El",257,144,113
16,Cuenca,234,Valsalobre,34,19,15
16,Cuenca,236,Valverde de Júcar,1193,602,591
16,Cuenca,237,Valverdejo,103,52,51
16,Cuenca,238,Vara de Rey,577,301,276
16,Cuenca,239,Vega del Codorno,149,87,62
16,Cuenca,240,Vellisca,119,64,55
16,Cuenca,242,Villaconejos de Trabaque,414,209,205
16,Cuenca,243,Villaescusa de Haro,550,273,277
16,Cuenca,244,Villagarcía del Llano,808,407,401
16,Cuenca,245,Villalba de la Sierra,535,263,272
16,Cuenca,246,Villalba del Rey,568,312,256
16,Cuenca,247,Villalgordo del Marquesado,103,54,49
16,Cuenca,248,Villalpardo,1023,499,524
16,Cuenca,249,Villamayor de Santiago,2842,1465,1377
16,Cuenca,250,Villanueva de Guadamejud,82,48,34
16,Cuenca,251,Villanueva de la Jara,2273,1137,1136
16,Cuenca,253,Villar de Cañas,476,263,213
16,Cuenca,254,Villar de Domingo García,223,114,109
16,Cuenca,255,Villar de la Encina,156,81,75
16,Cuenca,263,Villar de Olalla,1240,656,584
16,Cuenca,258,Villar del Humo,252,142,110
16,Cuenca,259,Villar del Infantado,43,28,15
16,Cuenca,910,Villar y Velasco,101,55,46
16,Cuenca,264,Villarejo de Fuentes,519,258,261
16,Cuenca,265,Villarejo de la Peñuela,25,11,14
16,Cuenca,266,Villarejo-Periesteban,353,176,177
16,Cuenca,269,Villares del Saz,574,292,282
16,Cuenca,270,Villarrubio,219,120,99
16,Cuenca,271,Villarta,920,465,455
16,Cuenca,272,Villas de la Ventosa,267,140,127
16,Cuenca,273,Villaverde y Pasaconsol,346,183,163
16,Cuenca,274,Víllora,148,78,70
16,Cuenca,275,Vindel,11,6,5
16,Cuenca,276,Yémeda,27,19,8
16,Cuenca,277,Zafra de Záncara,141,73,68
16,Cuenca,278,Zafrilla,76,37,39
16,Cuenca,279,Zarza de Tajo,296,153,143
16,Cuenca,280,Zarzuela,215,114,101
20,Gipuzkoa,1,Abaltzisketa,329,179,150
20,Gipuzkoa,2,Aduna,471,255,216
20,Gipuzkoa,16,Aia,2039,1087,952
20,Gipuzkoa,3,Aizarnazabal,775,389,386
20,Gipuzkoa,4,Albiztur,327,170,157
20,Gipuzkoa,5,Alegia,1744,887,857
20,Gipuzkoa,6,Alkiza,373,193,180
20,Gipuzkoa,906,Altzaga,165,83,82
20,Gipuzkoa,7,Altzo,400,207,193
20,Gipuzkoa,8,Amezketa,968,514,454
20,Gipuzkoa,9,Andoain,14655,7282,7373
20,Gipuzkoa,10,Anoeta,1893,977,916
20,Gipuzkoa,11,Antzuola,2193,1115,1078
20,Gipuzkoa,12,Arama,217,112,105
20,Gipuzkoa,13,Aretxabaleta,6995,3565,3430
20,Gipuzkoa,55,Arrasate/Mondragón,22052,10954,11098
20,Gipuzkoa,14,Asteasu,1523,811,712
20,Gipuzkoa,903,Astigarraga,5535,2835,2700
20,Gipuzkoa,15,Ataun,1700,894,806
20,Gipuzkoa,17,Azkoitia,11480,5750,5730
20,Gipuzkoa,18,Azpeitia,14580,7344,7236
20,Gipuzkoa,904,Baliarrain,130,70,60
20,Gipuzkoa,19,Beasain,13812,6963,6849
20,Gipuzkoa,20,Beizama,167,103,64
20,Gipuzkoa,21,Belauntza,260,142,118
20,Gipuzkoa,22,Berastegi,1056,551,505
20,Gipuzkoa,74,Bergara,14831,7364,7467
20,Gipuzkoa,23,Berrobi,568,294,274
20,Gipuzkoa,24,Bidegoian,524,280,244
20,Gipuzkoa,29,Deba,5450,2747,2703
20,Gipuzkoa,69,Donostia/San Sebastián,186126,87359,98767
20,Gipuzkoa,30,Eibar,27440,13327,14113
20,Gipuzkoa,31,Elduain,239,126,113
20,Gipuzkoa,33,Elgeta,1121,574,547
20,Gipuzkoa,32,Elgoibar,11488,5729,5759
20,Gipuzkoa,67,Errenteria,39230,19076,20154
20,Gipuzkoa,66,Errezil,594,305,289
20,Gipuzkoa,34,Eskoriatza,4090,2087,2003
20,Gipuzkoa,35,Ezkio-Itsaso,609,315,294
20,Gipuzkoa,38,Gabiria,497,263,234
20,Gipuzkoa,37,Gaintza,120,71,49
20,Gipuzkoa,907,Gaztelu,171,96,75
20,Gipuzkoa,39,Getaria,2726,1379,1347
20,Gipuzkoa,40,Hernani,19601,9625,9976
20,Gipuzkoa,41,Hernialde,350,185,165
20,Gipuzkoa,36,Hondarribia,16894,8419,8475
20,Gipuzkoa,42,Ibarra,4256,2174,2082
20,Gipuzkoa,43,Idiazabal,2306,1176,1130
20,Gipuzkoa,44,Ikaztegieta,464,244,220
20,Gipuzkoa,45,Irun,61195,29953,31242
20,Gipuzkoa,46,Irura,1671,873,798
20,Gipuzkoa,47,Itsasondo,666,333,333
20,Gipuzkoa,48,Larraul,260,142,118
20,Gipuzkoa,902,Lasarte-Oria,18082,8825,9257
20,Gipuzkoa,49,Lazkao,5465,2782,2683
20,Gipuzkoa,50,Leaburu,373,196,177
20,Gipuzkoa,51,Legazpi,8608,4379,4229
20,Gipuzkoa,52,Legorreta,1468,751,717
20,Gipuzkoa,68,Leintz-Gatzaga,244,133,111
20,Gipuzkoa,53,Lezo,6007,2988,3019
20,Gipuzkoa,54,Lizartza,640,345,295
20,Gipuzkoa,901,Mendaro,1998,1015,983
20,Gipuzkoa,57,Mutiloa,262,140,122
20,Gipuzkoa,56,Mutriku,5293,2675,2618
20,Gipuzkoa,63,Oiartzun,9970,4967,5003
20,Gipuzkoa,58,Olaberria,957,487,470
20,Gipuzkoa,59,Oñati,11282,5583,5699
20,Gipuzkoa,76,Ordizia,9803,4867,4936
20,Gipuzkoa,905,Orendain,193,101,92
20,Gipuzkoa,60,Orexa,123,64,59
20,Gipuzkoa,61,Orio,5694,2888,2806
20,Gipuzkoa,62,Ormaiztegi,1305,665,640
20,Gipuzkoa,64,Pasaia,15929,7658,8271
20,Gipuzkoa,70,Segura,1480,746,734
20,Gipuzkoa,65,Soraluze/Placencia de las Armas,3991,2003,1988
20,Gipuzkoa,71,Tolosa,18936,9086,9850
20,Gipuzkoa,72,Urnieta,6198,3090,3108
20,Gipuzkoa,77,Urretxu,6890,3445,3445
20,Gipuzkoa,73,Usurbil,6168,3141,3027
20,Gipuzkoa,75,Villabona,5888,2963,2925
20,Gipuzkoa,78,Zaldibia,1558,817,741
20,Gipuzkoa,79,Zarautz,22890,11159,11731
20,Gipuzkoa,25,Zegama,1527,787,740
20,Gipuzkoa,26,Zerain,263,126,137
20,Gipuzkoa,27,Zestoa,3656,1922,1734
20,Gipuzkoa,28,Zizurkil,2997,1503,1494
20,Gipuzkoa,81,Zumaia,9734,4846,4888
20,Gipuzkoa,80,Zumarraga,9950,4923,5027
17,Girona,1,Agullana,826,414,412
17,Girona,2,Aiguaviva,783,392,391
17,Girona,3,Albanyà,155,85,70
17,Girona,4,Albons,727,375,352
17,Girona,6,Alp,1661,876,785
17,Girona,7,Amer,2281,1095,1186
17,Girona,8,Anglès,5606,2786,2820
17,Girona,9,Arbúcies,6481,3377,3104
17,Girona,10,Argelaguer,425,229,196
17,Girona,11,"Armentera, L'",901,450,451
17,Girona,12,Avinyonet de Puigventós,1581,797,784
17,Girona,15,Banyoles,19343,9709,9634
17,Girona,16,Bàscara,949,482,467
17,Girona,13,Begur,3994,2027,1967
17,Girona,18,Bellcaire d'Empordà,650,309,341
17,Girona,19,Besalú,2400,1154,1246
17,Girona,20,Bescanó,4874,2427,2447
17,Girona,21,Beuda,200,108,92
17,Girona,22,"Bisbal d'Empordà, La",10761,5419,5342
17,Girona,234,Biure,245,132,113
17,Girona,23,Blanes,39293,19703,19590
17,Girona,29,Boadella i les Escaules,248,129,119
17,Girona,24,Bolvir,373,197,176
17,Girona,25,Bordils,1690,852,838
17,Girona,26,Borrassà,728,374,354
17,Girona,27,Breda,3751,1876,1875
17,Girona,28,Brunyola,391,197,194
17,Girona,31,Cabanelles,243,136,107
17,Girona,30,Cabanes,921,489,432
17,Girona,32,Cadaqués,2820,1368,1452
17,Girona,33,Caldes de Malavella,7130,3555,3575
17,Girona,34,Calonge,10541,5298,5243
17,Girona,35,Camós,686,345,341
17,Girona,36,Campdevànol,3395,1660,1735
17,Girona,37,Campelles,132,67,65
17,Girona,38,Campllong,515,257,258
17,Girona,39,Camprodon,2359,1149,1210
17,Girona,40,Canet d'Adri,644,331,313
17,Girona,41,Cantallops,324,163,161
17,Girona,42,Capmany,612,323,289
17,Girona,44,Cassà de la Selva,9922,5062,4860
17,Girona,46,Castellfollit de la Roca,1013,518,495
17,Girona,47,Castelló d'Empúries,11473,5835,5638
17,Girona,48,Castell-Platja d'Aro,10721,5309,5412
17,Girona,189,"Cellera de Ter, La",2071,1034,1037
17,Girona,49,Celrà,5053,2519,2534
17,Girona,50,Cervià de Ter,934,470,464
17,Girona,51,Cistella,293,143,150
17,Girona,54,Colera,532,274,258
17,Girona,55,Colomers,195,95,100
17,Girona,57,Corçà,1257,624,633
17,Girona,56,Cornellà del Terri,2235,1139,1096
17,Girona,58,Crespià,245,124,121
17,Girona,901,"Cruïlles, Monells i Sant Sadurní de l'Heura",1284,654,630
17,Girona,60,Darnius,534,271,263
17,Girona,61,Das,220,119,101
17,Girona,62,"Escala, L'",10143,5149,4994
17,Girona,63,Espinelves,196,97,99
17,Girona,64,Espolla,417,210,207
17,Girona,65,Esponellà,458,229,229
17,Girona,5,"Far d'Empordà, El",563,285,278
17,Girona,66,Figueres,45444,22489,22955
17,Girona,67,Flaçà,1041,505,536
17,Girona,68,Foixà,320,156,164
17,Girona,69,Fontanals de Cerdanya,443,229,214
17,Girona,70,Fontanilles,160,92,68
17,Girona,71,Fontcoberta,1442,704,738
17,Girona,902,Forallac,1729,846,883
17,Girona,73,Fornells de la Selva,2479,1209,1270
17,Girona,74,Fortià,710,346,364
17,Girona,75,Garrigàs,398,211,187
17,Girona,76,Garrigoles,159,87,72
17,Girona,77,Garriguella,857,432,425
17,Girona,78,Ger,432,233,199
17,Girona,79,Girona,97227,46734,50493
17,Girona,80,Gombrèn,195,95,100
17,Girona,81,Gualta,362,195,167
17,Girona,82,Guils de Cerdanya,536,282,254
17,Girona,83,Hostalric,4010,2025,1985
17,Girona,84,Isòvol,301,167,134
17,Girona,85,Jafre,396,218,178
17,Girona,86,"Jonquera, La",3115,1576,1539
17,Girona,87,Juià,340,177,163
17,Girona,88,Lladó,767,378,389
17,Girona,89,Llagostera,8198,4217,3981
17,Girona,90,Llambilles,738,377,361
17,Girona,91,Llanars,509,263,246
17,Girona,92,Llançà,4970,2461,2509
17,Girona,93,Llers,1242,619,623
17,Girona,94,Llívia,1536,836,700
17,Girona,95,Lloret de Mar,38624,19972,18652
17,Girona,96,"Llosses, Les",211,121,90
17,Girona,102,Maçanet de Cabrenys,781,394,387
17,Girona,103,Maçanet de la Selva,6963,3567,3396
17,Girona,97,Madremanya,283,140,143
17,Girona,98,Maià de Montcal,443,223,220
17,Girona,100,Masarac,284,153,131
17,Girona,101,Massanes,723,392,331
17,Girona,99,Meranges,94,53,41
17,Girona,105,Mieres,326,165,161
17,Girona,106,Mollet de Peralada,182,96,86
17,Girona,107,Molló,339,165,174
17,Girona,109,Montagut i Oix,970,507,463
17,Girona,110,Mont-ras,1739,867,872
17,Girona,111,Navata,1262,626,636
17,Girona,112,Ogassa,245,147,98
17,Girona,114,Olot,33913,16881,17032
17,Girona,115,Ordis,380,199,181
17,Girona,116,Osor,452,230,222
17,Girona,117,Palafrugell,22763,11373,11390
17,Girona,118,Palamós,17805,8681,9124
17,Girona,119,Palau de Santa Eulàlia,98,57,41
17,Girona,121,Palau-sator,305,158,147
17,Girona,120,Palau-saverdera,1437,712,725
17,Girona,123,Palol de Revardit,474,243,231
17,Girona,124,Pals,2533,1282,1251
17,Girona,125,Pardines,155,88,67
17,Girona,126,Parlavà,410,213,197
17,Girona,128,Pau,569,280,289
17,Girona,129,Pedret i Marzà,189,104,85
17,Girona,130,"Pera, La",467,223,244
17,Girona,132,Peralada,1859,925,934
17,Girona,133,"Planes d'Hostoles, Les",1694,864,830
17,Girona,134,Planoles,300,166,134
17,Girona,135,Pont de Molins,529,264,265
17,Girona,136,Pontós,223,126,97
17,Girona,137,Porqueres,4529,2252,2277
17,Girona,140,"Port de la Selva, El",980,523,457
17,Girona,138,Portbou,1214,596,618
17,Girona,139,"Preses, Les",1772,884,888
17,Girona,141,Puigcerdà,8761,4379,4382
17,Girona,142,Quart,3441,1724,1717
17,Girona,43,Queralbs,182,106,76
17,Girona,143,Rabós,182,89,93
17,Girona,144,Regencós,291,154,137
17,Girona,145,Ribes de Freser,1859,916,943
17,Girona,146,Riells i Viabrea,4000,2063,1937
17,Girona,147,Ripoll,10751,5303,5448
17,Girona,148,Riudarenes,2148,1109,1039
17,Girona,149,Riudaura,463,222,241
17,Girona,150,Riudellots de la Selva,2026,1020,1006
17,Girona,151,Riumors,244,125,119
17,Girona,152,Roses,19600,9795,9805
17,Girona,153,Rupià,246,127,119
17,Girona,154,Sales de Llierca,133,66,67
17,Girona,155,Salt,30103,15921,14182
17,Girona,157,Sant Andreu Salou,155,80,75
17,Girona,183,Sant Aniol de Finestres,351,189,162
17,Girona,158,Sant Climent Sescebes,590,333,257
17,Girona,159,Sant Feliu de Buixalleu,776,402,374
17,Girona,160,Sant Feliu de Guíxols,21810,10791,11019
17,Girona,161,Sant Feliu de Pallerols,1353,660,693
17,Girona,162,Sant Ferriol,240,134,106
17,Girona,163,Sant Gregori,3464,1745,1719
17,Girona,164,Sant Hilari Sacalm,5681,2895,2786
17,Girona,165,Sant Jaume de Llierca,812,398,414
17,Girona,167,Sant Joan de les Abadesses,3413,1693,1720
17,Girona,168,Sant Joan de Mollet,509,248,261
17,Girona,185,Sant Joan les Fonts,2919,1442,1477
17,Girona,166,Sant Jordi Desvalls,708,342,366
17,Girona,169,Sant Julià de Ramis,3434,1730,1704
17,Girona,903,Sant Julià del Llor i Bonmatí,1264,650,614
17,Girona,171,Sant Llorenç de la Muga,249,130,119
17,Girona,172,Sant Martí de Llémena,626,335,291
17,Girona,173,Sant Martí Vell,242,128,114
17,Girona,174,Sant Miquel de Campmajor,232,123,109
17,Girona,175,Sant Miquel de Fluvià,798,410,388
17,Girona,176,Sant Mori,177,97,80
17,Girona,177,Sant Pau de Segúries,674,333,341
17,Girona,178,Sant Pere Pescador,2138,1142,996
17,Girona,180,Santa Coloma de Farners,12601,6393,6208
17,Girona,181,Santa Cristina d'Aro,5194,2630,2564
17,Girona,182,Santa Llogaia d'Àlguema,341,188,153
17,Girona,184,Santa Pau,1567,792,775
17,Girona,186,Sarrià de Ter,4937,2463,2474
17,Girona,187,"Saus, Camallera i Llampaies",815,402,413
17,Girona,188,"Selva de Mar, La",181,102,79
17,Girona,190,Serinyà,1123,572,551
17,Girona,191,Serra de Daró,211,115,96
17,Girona,192,Setcases,195,108,87
17,Girona,193,Sils,5851,2968,2883
17,Girona,52,Siurana,150,74,76
17,Girona,194,Susqueda,95,58,37
17,Girona,195,"Tallada d'Empordà, La",454,236,218
17,Girona,196,Terrades,288,141,147
17,Girona,197,Torrent,170,89,81
17,Girona,198,Torroella de Fluvià,704,362,342
17,Girona,199,Torroella de Montgrí,11381,5784,5597
17,Girona,200,Tortellà,772,370,402
17,Girona,201,Toses,150,89,61
17,Girona,202,Tossa de Mar,5681,2897,2784
17,Girona,204,Ullà,1053,585,468
17,Girona,205,Ullastret,289,143,146
17,Girona,203,Ultramort,204,111,93
17,Girona,206,Urús,185,89,96
17,Girona,14,"Vajol, La",86,48,38
17,Girona,208,"Vall de Bianya, La",1305,657,648
17,Girona,207,"Vall d'en Bas, La",2965,1485,1480
17,Girona,170,Vallfogona de Ripollès,215,116,99
17,Girona,209,Vall-llobrega,901,457,444
17,Girona,210,Ventalló,836,439,397
17,Girona,211,Verges,1195,572,623
17,Girona,212,Vidrà,169,87,82
17,Girona,213,Vidreres,7702,3981,3721
17,Girona,214,Vilabertran,913,468,445
17,Girona,215,Vilablareix,2529,1250,1279
17,Girona,217,Viladamat,440,227,213
17,Girona,216,Viladasens,216,112,104
17,Girona,218,Vilademuls,787,408,379
17,Girona,220,Viladrau,1037,527,510
17,Girona,221,Vilafant,5481,2694,2787
17,Girona,223,Vilajuïga,1190,590,600
17,Girona,224,Vilallonga de Ter,421,219,202
17,Girona,225,Vilamacolum,307,163,144
17,Girona,226,Vilamalla,1103,573,530
17,Girona,227,Vilamaniscle,170,94,76
17,Girona,228,Vilanant,399,199,200
17,Girona,230,Vila-sacra,681,327,354
17,Girona,222,Vilaür,153,75,78
17,Girona,233,Vilobí d'Onyar,3136,1640,1496
17,Girona,232,Vilopriu,209,114,95
18,Granada,1,Agrón,313,162,151
18,Granada,2,Alamedilla,658,341,317
18,Granada,3,Albolote,18306,9151,9155
18,Granada,4,Albondón,797,444,353
18,Granada,5,Albuñán,430,222,208
18,Granada,6,Albuñol,6853,3598,3255
18,Granada,7,Albuñuelas,889,447,442
18,Granada,10,Aldeire,644,339,305
18,Granada,11,Alfacar,5490,2794,2696
18,Granada,12,Algarinejo,2875,1471,1404
18,Granada,13,Alhama de Granada,6191,3299,2892
18,Granada,14,Alhendín,8306,4256,4050
18,Granada,15,Alicún de Ortega,529,272,257
18,Granada,16,Almegíjar,361,204,157
18,Granada,17,Almuñécar,27195,13452,13743
18,Granada,904,Alpujarra de la Sierra,1065,563,502
18,Granada,18,Alquife,701,347,354
18,Granada,20,Arenas del Rey,1913,1003,910
18,Granada,21,Armilla,23175,11575,11600
18,Granada,22,Atarfe,17570,8744,8826
18,Granada,23,Baza,20644,10240,10404
18,Granada,24,Beas de Granada,1005,541,464
18,Granada,25,Beas de Guadix,364,184,180
18,Granada,27,Benalúa,3296,1649,1647
18,Granada,28,Benalúa de las Villas,1163,614,549
18,Granada,29,Benamaurel,2414,1238,1176
18,Granada,30,Bérchules,762,400,362
18,Granada,32,Bubión,315,161,154
18,Granada,33,Busquístar,296,157,139
18,Granada,34,Cacín,594,300,294
18,Granada,35,Cádiar,1545,810,735
18,Granada,36,Cájar,4929,2388,2541
18,Granada,114,"Calahorra, La",748,375,373
18,Granada,37,Calicasas,583,287,296
18,Granada,38,Campotéjar,1317,682,635
18,Granada,39,Caniles,4514,2295,2219
18,Granada,40,Cáñar,408,214,194
18,Granada,42,Capileira,496,246,250
18,Granada,43,Carataunas,209,110,99
18,Granada,44,Cástaras,242,145,97
18,Granada,45,Castilléjar,1487,765,722
18,Granada,46,Castril,2290,1168,1122
18,Granada,47,Cenes de la Vega,7943,4005,3938
18,Granada,59,Chauchina,5499,2739,2760
18,Granada,61,Chimeneas,1387,729,658
18,Granada,62,Churriana de la Vega,13652,6814,6838
18,Granada,48,Cijuela,3209,1633,1576
18,Granada,49,Cogollos de Guadix,664,361,303
18,Granada,50,Cogollos de la Vega,2043,1025,1018
18,Granada,51,Colomera,1431,749,682
18,Granada,53,Cortes de Baza,2098,1055,1043
18,Granada,54,Cortes y Graena,1023,523,500
18,Granada,912,Cuevas del Campo,1919,958,961
18,Granada,56,Cúllar,4500,2270,2230
18,Granada,57,Cúllar Vega,7139,3622,3517
18,Granada,63,Darro,1501,741,760
18,Granada,64,Dehesas de Guadix,453,219,234
18,Granada,66,Deifontes,2574,1297,1277
18,Granada,67,Diezma,766,387,379
18,Granada,68,Dílar,1825,911,914
18,Granada,69,Dólar,619,325,294
18,Granada,70,Dúdar,340,188,152
18,Granada,71,Dúrcal,7159,3552,3607
18,Granada,72,Escúzar,780,403,377
18,Granada,74,Ferreira,326,165,161
18,Granada,76,Fonelas,1050,542,508
18,Granada,78,Freila,985,499,486
18,Granada,79,Fuente Vaqueros,4479,2234,2245
18,Granada,905,"Gabias, Las",19364,9902,9462
18,Granada,82,Galera,1183,588,595
18,Granada,83,Gobernador,304,145,159
18,Granada,84,Gójar,5390,2756,2634
18,Granada,85,Gor,797,407,390
18,Granada,86,Gorafe,415,217,198
18,Granada,87,Granada,237540,110512,127028
18,Granada,88,Guadahortuna,1984,1026,958
18,Granada,89,Guadix,18898,9349,9549
18,Granada,906,"Guajares, Los",1128,597,531
18,Granada,93,Gualchos,4975,2569,2406
18,Granada,94,Güejar Sierra,2946,1545,1401
18,Granada,95,Güevéjar,2558,1331,1227
18,Granada,96,Huélago,438,225,213
18,Granada,97,Huéneja,1193,628,565
18,Granada,98,Huéscar,7772,3852,3920
18,Granada,99,Huétor de Santillán,1916,980,936
18,Granada,100,Huétor Tájar,10075,5084,4991
18,Granada,101,Huétor Vega,11844,5949,5895
18,Granada,102,Illora,10500,5247,5253
18,Granada,103,Itrabo,1014,510,504
18,Granada,105,Iznalloz,6867,3513,3354
18,Granada,107,Jayena,1212,613,599
18,Granada,108,Jerez del Marquesado,1027,530,497
18,Granada,109,Jete,929,478,451
18,Granada,111,Jun,3661,1869,1792
18,Granada,112,Juviles,134,63,71
18,Granada,115,Láchar,3260,1665,1595
18,Granada,116,Lanjarón,3717,1852,1865
18,Granada,117,Lanteira,526,269,257
18,Granada,119,Lecrín,2178,1110,1068
18,Granada,120,Lentegí,358,191,167
18,Granada,121,Lobras,165,84,81
18,Granada,122,Loja,21136,10634,10502
18,Granada,123,Lugros,328,180,148
18,Granada,124,Lújar,504,265,239
18,Granada,126,"Malahá, La",1853,937,916
18,Granada,127,Maracena,21633,10683,10950
18,Granada,128,Marchal,428,194,234
18,Granada,132,Moclín,4059,2008,2051
18,Granada,133,Molvízar,2903,1490,1413
18,Granada,134,Monachil,7398,3815,3583
18,Granada,135,Montefrío,5806,2907,2899
18,Granada,136,Montejícar,2265,1144,1121
18,Granada,137,Montillana,1324,689,635
18,Granada,138,Moraleda de Zafayona,3224,1641,1583
18,Granada,909,Morelábor,685,362,323
18,Granada,140,Motril,60870,29969,30901
18,Granada,141,Murtas,541,318,223
18,Granada,903,Nevada,1149,582,567
18,Granada,143,Nigüelas,1219,614,605
18,Granada,144,Nívar,920,482,438
18,Granada,145,Ogíjares,13681,6761,6920
18,Granada,146,Orce,1264,659,605
18,Granada,147,Órgiva,5393,2697,2696
18,Granada,148,Otívar,1108,557,551
18,Granada,150,Padul,8353,4216,4137
18,Granada,151,Pampaneira,323,165,158
18,Granada,152,Pedro Martínez,1182,576,606
18,Granada,153,Peligros,11212,5574,5638
18,Granada,154,"Peza, La",1263,654,609
18,Granada,910,"Pinar, El",1001,517,484
18,Granada,157,Pinos Genil,1407,727,680
18,Granada,158,Pinos Puente,12808,6389,6419
18,Granada,159,Píñar,1234,681,553
18,Granada,161,Polícar,234,119,115
18,Granada,162,Polopos,1847,985,862
18,Granada,163,Pórtugos,382,203,179
18,Granada,164,Puebla de Don Fadrique,2324,1202,1122
18,Granada,165,Pulianas,5366,2679,2687
18,Granada,167,Purullena,2429,1223,1206
18,Granada,168,Quéntar,992,507,485
18,Granada,170,Rubite,455,244,211
18,Granada,171,Salar,2735,1387,1348
18,Granada,173,Salobreña,12431,6167,6264
18,Granada,174,Santa Cruz del Comercio,552,295,257
18,Granada,175,Santa Fe,15168,7489,7679
18,Granada,176,Soportújar,320,189,131
18,Granada,177,Sorvilán,569,296,273
18,Granada,901,"Taha, La",663,349,314
18,Granada,178,Torre-Cardela,860,443,417
18,Granada,179,Torvizcón,710,369,341
18,Granada,180,Trevélez,792,417,375
18,Granada,181,Turón,289,174,115
18,Granada,182,Ugíjar,2619,1293,1326
18,Granada,907,Valle del Zalabí,2274,1164,1110
18,Granada,902,"Valle, El",1049,515,534
18,Granada,183,Válor,623,317,306
18,Granada,911,Vegas del Genil,10264,5244,5020
18,Granada,184,Vélez de Benaudalla,2876,1441,1435
18,Granada,185,Ventas de Huelma,676,352,324
18,Granada,149,Villa de Otura,6872,3490,3382
18,Granada,908,Villamena,1063,529,534
18,Granada,187,Villanueva de las Torres,677,361,316
18,Granada,188,Villanueva Mesía,2045,1027,1018
18,Granada,189,Víznar,991,499,492
18,Granada,192,Zafarraya,2023,1086,937
18,Granada,913,Zagra,898,455,443
18,Granada,193,"Zubia, La",18574,9100,9474
18,Granada,194,Zújar,2825,1455,1370
19,Guadalajara,1,Abánades,61,35,26
19,Guadalajara,2,Ablanque,80,46,34
19,Guadalajara,3,Adobes,44,23,21
19,Guadalajara,4,Alaminos,71,35,36
19,Guadalajara,5,Alarilla,99,65,34
19,Guadalajara,6,Albalate de Zorita,1022,568,454
19,Guadalajara,7,Albares,542,280,262
19,Guadalajara,8,Albendiego,39,26,13
19,Guadalajara,9,Alcocer,334,168,166
19,Guadalajara,10,Alcolea de las Peñas,11,7,4
19,Guadalajara,11,Alcolea del Pinar,348,194,154
19,Guadalajara,13,Alcoroches,141,83,58
19,Guadalajara,15,Aldeanueva de Guadalajara,81,46,35
19,Guadalajara,16,Algar de Mesa,58,35,23
19,Guadalajara,17,Algora,80,53,27
19,Guadalajara,18,Alhóndiga,196,110,86
19,Guadalajara,19,Alique,20,9,11
19,Guadalajara,20,Almadrones,72,45,27
19,Guadalajara,21,Almoguera,1401,732,669
19,Guadalajara,22,Almonacid de Zorita,740,352,388
19,Guadalajara,23,Alocén,178,97,81
19,Guadalajara,24,Alovera,12237,6262,5975
19,Guadalajara,27,Alustante,186,114,72
19,Guadalajara,31,Angón,17,12,5
19,Guadalajara,32,Anguita,206,111,95
19,Guadalajara,33,Anquela del Ducado,74,42,32
19,Guadalajara,34,Anquela del Pedregal,19,14,5
19,Guadalajara,36,Aranzueque,436,223,213
19,Guadalajara,37,Arbancón,158,95,63
19,Guadalajara,38,Arbeteta,31,20,11
19,Guadalajara,39,Argecilla,70,48,22
19,Guadalajara,40,Armallones,60,36,24
19,Guadalajara,41,Armuña de Tajuña,231,121,110
19,Guadalajara,42,Arroyo de las Fraguas,30,16,14
19,Guadalajara,43,Atanzón,82,52,30
19,Guadalajara,44,Atienza,479,262,217
19,Guadalajara,45,Auñón,177,100,77
19,Guadalajara,46,Azuqueca de Henares,35335,18097,17238
19,Guadalajara,47,Baides,80,38,42
19,Guadalajara,48,Baños de Tajo,18,14,4
19,Guadalajara,49,Bañuelos,16,13,3
19,Guadalajara,50,Barriopedro,20,12,8
19,Guadalajara,51,Berninches,65,38,27
19,Guadalajara,52,"Bodera, La",32,20,12
19,Guadalajara,53,Brihuega,2593,1340,1253
19,Guadalajara,54,Budia,214,119,95
19,Guadalajara,55,Bujalaro,56,31,25
19,Guadalajara,57,Bustares,85,51,34
19,Guadalajara,58,Cabanillas del Campo,9811,4944,4867
19,Guadalajara,59,Campillo de Dueñas,85,50,35
19,Guadalajara,60,Campillo de Ranas,180,114,66
19,Guadalajara,61,Campisábalos,60,41,19
19,Guadalajara,64,Canredondo,93,52,41
19,Guadalajara,65,Cantalojas,161,96,65
19,Guadalajara,66,Cañizar,73,38,35
19,Guadalajara,67,"Cardoso de la Sierra, El",70,46,24
19,Guadalajara,70,Casa de Uceda,117,64,53
19,Guadalajara,71,"Casar, El",11643,5969,5674
19,Guadalajara,73,Casas de San Galindo,22,14,8
19,Guadalajara,74,Caspueñas,100,56,44
19,Guadalajara,75,Castejón de Henares,77,46,31
19,Guadalajara,76,Castellar de la Muela,37,18,19
19,Guadalajara,78,Castilforte,57,38,19
19,Guadalajara,79,Castilnuevo,8,5,3
19,Guadalajara,80,Cendejas de Enmedio,85,44,41
19,Guadalajara,81,Cendejas de la Torre,33,21,12
19,Guadalajara,82,Centenera,102,54,48
19,Guadalajara,103,Checa,288,170,118
19,Guadalajara,104,Chequilla,18,9,9
19,Guadalajara,106,Chillarón del Rey,108,63,45
19,Guadalajara,105,Chiloeches,3310,1728,1582
19,Guadalajara,86,Cifuentes,1961,1006,955
19,Guadalajara,87,Cincovillas,23,13,10
19,Guadalajara,88,Ciruelas,105,58,47
19,Guadalajara,89,Ciruelos del Pinar,31,18,13
19,Guadalajara,90,Cobeta,120,54,66
19,Guadalajara,91,Cogollor,31,16,15
19,Guadalajara,92,Cogolludo,648,381,267
19,Guadalajara,95,Condemios de Abajo,22,13,9
19,Guadalajara,96,Condemios de Arriba,129,69,60
19,Guadalajara,97,Congostrina,23,15,8
19,Guadalajara,98,Copernal,32,22,10
19,Guadalajara,99,Corduente,365,202,163
19,Guadalajara,102,"Cubillo de Uceda, El",155,83,72
19,Guadalajara,107,Driebes,371,192,179
19,Guadalajara,108,Durón,121,65,56
19,Guadalajara,109,Embid,44,24,20
19,Guadalajara,110,Escamilla,73,35,38
19,Guadalajara,111,Escariche,190,109,81
19,Guadalajara,112,Escopete,57,31,26
19,Guadalajara,113,Espinosa de Henares,757,393,364
19,Guadalajara,114,Esplegares,41,26,15
19,Guadalajara,115,Establés,33,19,14
19,Guadalajara,116,Estriégana,18,11,7
19,Guadalajara,117,Fontanar,2349,1236,1113
19,Guadalajara,118,Fuembellida,13,8,5
19,Guadalajara,119,Fuencemillán,102,63,39
19,Guadalajara,120,Fuentelahiguera de Albatages,134,76,58
19,Guadalajara,121,Fuentelencina,307,177,130
19,Guadalajara,122,Fuentelsaz,103,57,46
19,Guadalajara,123,Fuentelviejo,53,27,26
19,Guadalajara,124,Fuentenovilla,565,311,254
19,Guadalajara,125,Gajanejos,52,32,20
19,Guadalajara,126,Galápagos,2339,1246,1093
19,Guadalajara,127,Galve de Sorbe,113,64,49
19,Guadalajara,129,Gascueña de Bornova,42,26,16
19,Guadalajara,130,Guadalajara,83720,40583,43137
19,Guadalajara,132,Henche,106,56,50
19,Guadalajara,133,Heras de Ayuso,262,159,103
19,Guadalajara,134,Herrería,20,15,5
19,Guadalajara,135,Hiendelaencina,133,73,60
19,Guadalajara,136,Hijes,21,14,7
19,Guadalajara,138,Hita,374,209,165
19,Guadalajara,139,Hombrados,34,19,15
19,Guadalajara,142,Hontoba,317,178,139
19,Guadalajara,143,Horche,2473,1256,1217
19,Guadalajara,145,Hortezuela de Océn,54,33,21
19,Guadalajara,146,"Huerce, La",44,24,20
19,Guadalajara,147,Huérmeces del Cerro,45,29,16
19,Guadalajara,148,Huertahernando,56,38,18
19,Guadalajara,150,Hueva,150,87,63
19,Guadalajara,151,Humanes,1539,767,772
19,Guadalajara,152,Illana,799,458,341
19,Guadalajara,153,Iniéstola,25,16,9
19,Guadalajara,154,"Inviernas, Las",70,43,27
19,Guadalajara,155,Irueste,61,38,23
19,Guadalajara,156,Jadraque,1576,811,765
19,Guadalajara,157,Jirueque,61,39,22
19,Guadalajara,159,Ledanca,107,53,54
19,Guadalajara,160,Loranca de Tajuña,1314,719,595
19,Guadalajara,161,Lupiana,247,129,118
19,Guadalajara,162,Luzaga,75,43,32
19,Guadalajara,163,Luzón,75,38,37
19,Guadalajara,165,Majaelrayo,51,28,23
19,Guadalajara,166,Málaga del Fresno,193,111,82
19,Guadalajara,167,Malaguilla,141,75,66
19,Guadalajara,168,Mandayona,335,173,162
19,Guadalajara,169,Mantiel,45,29,16
19,Guadalajara,170,Maranchón,262,145,117
19,Guadalajara,171,Marchamalo,6664,3385,3279
19,Guadalajara,172,Masegoso de Tajuña,67,40,27
19,Guadalajara,173,Matarrubia,49,34,15
19,Guadalajara,174,Matillas,124,60,64
19,Guadalajara,175,Mazarete,45,20,25
19,Guadalajara,176,Mazuecos,307,159,148
19,Guadalajara,177,Medranda,88,46,42
19,Guadalajara,178,Megina,50,33,17
19,Guadalajara,179,Membrillera,95,49,46
19,Guadalajara,181,Miedes de Atienza,67,37,30
19,Guadalajara,182,"Mierla, La",33,24,9
19,Guadalajara,184,Millana,120,68,52
19,Guadalajara,183,Milmarcos,90,48,42
19,Guadalajara,185,"Miñosa, La",40,29,11
19,Guadalajara,186,Mirabueno,103,61,42
19,Guadalajara,187,Miralrío,68,40,28
19,Guadalajara,188,Mochales,52,27,25
19,Guadalajara,189,Mohernando,185,98,87
19,Guadalajara,190,Molina de Aragón,3572,1811,1761
19,Guadalajara,191,Monasterio,16,6,10
19,Guadalajara,192,Mondéjar,2636,1365,1271
19,Guadalajara,193,Montarrón,30,16,14
19,Guadalajara,194,Moratilla de los Meleros,106,55,51
19,Guadalajara,195,Morenilla,46,27,19
19,Guadalajara,196,Muduex,114,60,54
19,Guadalajara,197,"Navas de Jadraque, Las",24,16,8
19,Guadalajara,198,Negredo,23,13,10
19,Guadalajara,199,Ocentejo,21,13,8
19,Guadalajara,200,"Olivar, El",89,55,34
19,Guadalajara,201,Olmeda de Cobeta,68,37,31
19,Guadalajara,202,"Olmeda de Jadraque, La",15,8,7
19,Guadalajara,203,"Ordial, El",33,18,15
19,Guadalajara,204,Orea,218,138,80
19,Guadalajara,208,Pálmaces de Jadraque,47,26,21
19,Guadalajara,209,Pardos,45,26,19
19,Guadalajara,210,Paredes de Sigüenza,26,14,12
19,Guadalajara,211,Pareja,486,280,206
19,Guadalajara,212,Pastrana,1011,516,495
19,Guadalajara,213,"Pedregal, El",85,51,34
19,Guadalajara,214,Peñalén,87,49,38
19,Guadalajara,215,Peñalver,191,116,75
19,Guadalajara,216,Peralejos de las Truchas,155,88,67
19,Guadalajara,217,Peralveche,73,46,27
19,Guadalajara,218,Pinilla de Jadraque,59,33,26
19,Guadalajara,219,Pinilla de Molina,17,12,5
19,Guadalajara,220,Pioz,3579,1934,1645
19,Guadalajara,221,Piqueras,51,34,17
19,Guadalajara,222,"Pobo de Dueñas, El",137,71,66
19,Guadalajara,223,Poveda de la Sierra,135,74,61
19,Guadalajara,224,Pozo de Almoguera,99,55,44
19,Guadalajara,225,Pozo de Guadalajara,1255,657,598
19,Guadalajara,226,Prádena de Atienza,46,30,16
19,Guadalajara,227,Prados Redondos,75,45,30
19,Guadalajara,228,Puebla de Beleña,45,26,19
19,Guadalajara,229,Puebla de Valles,82,43,39
19,Guadalajara,230,Quer,739,390,349
19,Guadalajara,231,Rebollosa de Jadraque,14,10,4
19,Guadalajara,232,"Recuenco, El",73,42,31
19,Guadalajara,233,Renera,126,71,55
19,Guadalajara,234,Retiendas,48,27,21
19,Guadalajara,235,Riba de Saelices,118,66,52
19,Guadalajara,237,Rillo de Gallo,55,32,23
19,Guadalajara,238,Riofrío del Llano,43,26,17
19,Guadalajara,239,Robledillo de Mohernando,121,62,59
19,Guadalajara,240,Robledo de Corpes,51,27,24
19,Guadalajara,241,Romanillos de Atienza,53,33,20
19,Guadalajara,242,Romanones,119,63,56
19,Guadalajara,243,Rueda de la Sierra,58,35,23
19,Guadalajara,244,Sacecorbo,96,53,43
19,Guadalajara,245,Sacedón,1716,899,817
19,Guadalajara,246,Saelices de la Sal,56,31,25
19,Guadalajara,247,Salmerón,177,98,79
19,Guadalajara,248,San Andrés del Congosto,86,49,37
19,Guadalajara,249,San Andrés del Rey,36,15,21
19,Guadalajara,250,Santiuste,20,12,8
19,Guadalajara,251,Saúca,55,31,24
19,Guadalajara,252,Sayatón,95,58,37
19,Guadalajara,254,Selas,64,28,36
19,Guadalajara,901,Semillas,40,24,16
19,Guadalajara,255,Setiles,86,51,35
19,Guadalajara,256,Sienes,58,35,23
19,Guadalajara,257,Sigüenza,4712,2351,2361
19,Guadalajara,258,Solanillos del Extremo,96,55,41
19,Guadalajara,259,Somolinos,33,16,17
19,Guadalajara,260,"Sotillo, El",48,26,22
19,Guadalajara,261,Sotodosos,42,19,23
19,Guadalajara,262,Tamajón,159,84,75
19,Guadalajara,263,Taragudo,47,21,26
19,Guadalajara,264,Taravilla,39,23,16
19,Guadalajara,265,Tartanedo,152,87,65
19,Guadalajara,266,Tendilla,356,199,157
19,Guadalajara,267,Terzaga,19,13,6
19,Guadalajara,268,Tierzo,36,24,12
19,Guadalajara,269,"Toba, La",99,55,44
19,Guadalajara,271,Tordellego,57,32,25
19,Guadalajara,270,Tordelrábano,14,8,6
19,Guadalajara,272,Tordesilos,114,70,44
19,Guadalajara,274,Torija,1482,780,702
19,Guadalajara,279,Torre del Burgo,226,119,107
19,Guadalajara,277,Torrecuadrada de Molina,21,11,10
19,Guadalajara,278,Torrecuadradilla,29,16,13
19,Guadalajara,280,Torrejón del Rey,5150,2672,2478
19,Guadalajara,281,Torremocha de Jadraque,28,19,9
19,Guadalajara,282,Torremocha del Campo,219,123,96
19,Guadalajara,283,Torremocha del Pinar,40,16,24
19,Guadalajara,284,Torremochuela,12,7,5
19,Guadalajara,285,Torrubia,25,15,10
19,Guadalajara,286,Tórtola de Henares,983,528,455
19,Guadalajara,287,Tortuera,201,107,94
19,Guadalajara,288,Tortuero,19,11,8
19,Guadalajara,289,Traíd,33,21,12
19,Guadalajara,290,Trijueque,1336,719,617
19,Guadalajara,291,Trillo,1431,741,690
19,Guadalajara,293,Uceda,2651,1389,1262
19,Guadalajara,294,Ujados,30,18,12
19,Guadalajara,296,Utande,38,26,12
19,Guadalajara,297,Valdarachas,38,17,21
19,Guadalajara,298,Valdearenas,89,57,32
19,Guadalajara,299,Valdeavellano,99,56,43
19,Guadalajara,300,Valdeaveruelo,1060,546,514
19,Guadalajara,301,Valdeconcha,36,22,14
19,Guadalajara,302,Valdegrudas,61,40,21
19,Guadalajara,303,Valdelcubo,63,40,23
19,Guadalajara,304,Valdenuño Fernández,270,156,114
19,Guadalajara,305,Valdepeñas de la Sierra,193,111,82
19,Guadalajara,306,Valderrebollo,36,16,20
19,Guadalajara,307,Valdesotos,23,13,10
19,Guadalajara,308,Valfermoso de Tajuña,56,36,20
19,Guadalajara,309,Valhermoso,35,19,16
19,Guadalajara,310,Valtablado del Río,12,9,3
19,Guadalajara,311,Valverde de los Arroyos,99,54,45
19,Guadalajara,314,Viana de Jadraque,56,37,19
19,Guadalajara,317,Villanueva de Alcorón,184,94,90
19,Guadalajara,318,Villanueva de Argecilla,39,23,16
19,Guadalajara,319,Villanueva de la Torre,6383,3241,3142
19,Guadalajara,321,Villares de Jadraque,55,36,19
19,Guadalajara,322,Villaseca de Henares,33,18,15
19,Guadalajara,323,Villaseca de Uceda,47,27,20
19,Guadalajara,324,Villel de Mesa,204,110,94
19,Guadalajara,325,Viñuelas,153,87,66
19,Guadalajara,326,Yebes,2551,1329,1222
19,Guadalajara,327,Yebra,546,284,262
19,Guadalajara,329,Yélamos de Abajo,61,31,30
19,Guadalajara,330,Yélamos de Arriba,100,57,43
19,Guadalajara,331,Yunquera de Henares,3795,1954,1841
19,Guadalajara,332,"Yunta, La",104,59,45
19,Guadalajara,333,Zaorejas,136,89,47
19,Guadalajara,334,Zarzuela de Jadraque,34,21,13
19,Guadalajara,335,Zorita de los Canes,81,41,40
21,Huelva,1,Alájar,798,409,389
21,Huelva,2,Aljaraque,19857,9906,9951
21,Huelva,3,"Almendro, El",846,446,400
21,Huelva,4,Almonaster la Real,1863,976,887
21,Huelva,5,Almonte,23046,11560,11486
21,Huelva,6,Alosno,4103,1996,2107
21,Huelva,7,Aracena,7859,3899,3960
21,Huelva,8,Aroche,3205,1605,1600
21,Huelva,9,Arroyomolinos de León,998,519,479
21,Huelva,10,Ayamonte,19690,9823,9867
21,Huelva,11,Beas,4190,2122,2068
21,Huelva,12,Berrocal,329,158,171
21,Huelva,13,Bollullos Par del Condado,14393,7187,7206
21,Huelva,14,Bonares,6244,3097,3147
21,Huelva,15,Cabezas Rubias,760,395,365
21,Huelva,16,Cala,1244,626,618
21,Huelva,17,Calañas,4167,2100,2067
21,Huelva,18,"Campillo, El",2144,1040,1104
21,Huelva,19,Campofrío,673,333,340
21,Huelva,20,Cañaveral de León,416,202,214
21,Huelva,21,Cartaya,19168,9877,9291
21,Huelva,22,Castaño del Robledo,211,122,89
21,Huelva,23,"Cerro de Andévalo, El",2460,1224,1236
21,Huelva,30,Chucena,2020,1033,987
21,Huelva,24,Corteconcepción,556,271,285
21,Huelva,25,Cortegana,5025,2541,2484
21,Huelva,26,Cortelazor,289,146,143
21,Huelva,27,Cumbres de Enmedio,48,29,19
21,Huelva,28,Cumbres de San Bartolomé,426,212,214
21,Huelva,29,Cumbres Mayores,1872,938,934
21,Huelva,31,Encinasola,1304,677,627
21,Huelva,32,Escacena del Campo,2082,1024,1058
21,Huelva,33,Fuenteheridos,625,326,299
21,Huelva,34,Galaroza,1503,740,763
21,Huelva,35,Gibraleón,12474,6185,6289
21,Huelva,36,"Granada de Río-Tinto, La",214,110,104
21,Huelva,37,"Granado, El",557,303,254
21,Huelva,38,Higuera de la Sierra,1352,682,670
21,Huelva,39,Hinojales,289,140,149
21,Huelva,40,Hinojos,3905,1947,1958
21,Huelva,41,Huelva,147212,70740,76472
21,Huelva,42,Isla Cristina,21346,10616,10730
21,Huelva,43,Jabugo,2315,1169,1146
21,Huelva,44,Lepe,27054,13969,13085
21,Huelva,45,Linares de la Sierra,230,115,115
21,Huelva,46,Lucena del Puerto,3015,1596,1419
21,Huelva,47,Manzanilla,2118,1072,1046
21,Huelva,48,"Marines, Los",280,139,141
21,Huelva,49,Minas de Riotinto,4070,1959,2111
21,Huelva,50,Moguer,21302,10548,10754
21,Huelva,51,"Nava, La",296,150,146
21,Huelva,52,Nerva,5547,2674,2873
21,Huelva,53,Niebla,4004,2022,1982
21,Huelva,54,"Palma del Condado, La",10618,5320,5298
21,Huelva,55,Palos de la Frontera,10414,5197,5217
21,Huelva,56,Paterna del Campo,3564,1816,1748
21,Huelva,57,Paymogo,1218,607,611
21,Huelva,58,Puebla de Guzmán,3101,1593,1508
21,Huelva,59,Puerto Moral,289,145,144
21,Huelva,60,Punta Umbría,14934,7611,7323
21,Huelva,61,Rociana del Condado,7691,3861,3830
21,Huelva,62,Rosal de la Frontera,1775,896,879
21,Huelva,63,San Bartolomé de la Torre,3658,1854,1804
21,Huelva,64,San Juan del Puerto,8743,4396,4347
21,Huelva,66,San Silvestre de Guzmán,692,375,317
21,Huelva,65,Sanlúcar de Guadiana,447,230,217
21,Huelva,67,Santa Ana la Real,534,245,289
21,Huelva,68,Santa Bárbara de Casa,1093,538,555
21,Huelva,69,Santa Olalla del Cala,2002,1026,976
21,Huelva,70,Trigueros,7780,3872,3908
21,Huelva,71,Valdelarco,227,108,119
21,Huelva,72,Valverde del Camino,12740,6276,6464
21,Huelva,73,Villablanca,2958,1502,1456
21,Huelva,74,Villalba del Alcor,3352,1653,1699
21,Huelva,75,Villanueva de las Cruces,386,185,201
21,Huelva,76,Villanueva de los Castillejos,2758,1387,1371
21,Huelva,77,Villarrasa,2149,1085,1064
21,Huelva,78,Zalamea la Real,3232,1617,1615
21,Huelva,79,Zufre,880,452,428
22,Huesca,1,Abiego,267,139,128
22,Huesca,2,Abizanda,140,71,69
22,Huesca,3,Adahuesca,172,85,87
22,Huesca,4,Agüero,150,87,63
22,Huesca,907,Aínsa-Sobrarbe,2213,1141,1072
22,Huesca,6,Aisa,363,199,164
22,Huesca,7,Albalate de Cinca,1201,634,567
22,Huesca,8,Albalatillo,207,111,96
22,Huesca,9,Albelda,762,398,364
22,Huesca,11,Albero Alto,125,72,53
22,Huesca,12,Albero Bajo,122,66,56
22,Huesca,13,Alberuela de Tubo,327,171,156
22,Huesca,14,Alcalá de Gurrea,277,142,135
22,Huesca,15,Alcalá del Obispo,349,185,164
22,Huesca,16,Alcampell,707,361,346
22,Huesca,17,Alcolea de Cinca,1136,593,543
22,Huesca,18,Alcubierre,401,216,185
22,Huesca,19,Alerre,213,114,99
22,Huesca,20,Alfántega,136,65,71
22,Huesca,21,Almudévar,2519,1296,1223
22,Huesca,22,Almunia de San Juan,681,349,332
22,Huesca,23,Almuniente,528,263,265
22,Huesca,24,Alquézar,297,160,137
22,Huesca,25,Altorricón,1477,792,685
22,Huesca,27,Angüés,404,218,186
22,Huesca,28,Ansó,436,225,211
22,Huesca,29,Antillón,153,83,70
22,Huesca,32,Aragüés del Puerto,123,67,56
22,Huesca,35,Arén,314,166,148
22,Huesca,36,Argavieso,107,63,44
22,Huesca,37,Arguis,125,71,54
22,Huesca,39,Ayerbe,1097,552,545
22,Huesca,40,Azanuy-Alins,184,92,92
22,Huesca,41,Azara,193,97,96
22,Huesca,42,Azlor,137,68,69
22,Huesca,43,Baélls,113,64,49
22,Huesca,44,Bailo,290,171,119
22,Huesca,45,Baldellou,98,55,43
22,Huesca,46,Ballobar,866,452,414
22,Huesca,47,Banastás,303,159,144
22,Huesca,48,Barbastro,17109,8329,8780
22,Huesca,49,Barbués,92,51,41
22,Huesca,50,Barbuñales,100,48,52
22,Huesca,51,Bárcabo,117,70,47
22,Huesca,52,Belver de Cinca,1346,737,609
22,Huesca,53,Benabarre,1153,602,551
22,Huesca,54,Benasque,2149,1140,1009
22,Huesca,246,Beranuy,97,57,40
22,Huesca,55,Berbegal,391,200,191
22,Huesca,57,Bielsa,496,250,246
22,Huesca,58,Bierge,242,136,106
22,Huesca,59,Biescas,1535,824,711
22,Huesca,60,Binaced,1539,804,735
22,Huesca,61,Binéfar,9461,4905,4556
22,Huesca,62,Bisaurri,179,96,83
22,Huesca,63,Biscarrués,209,113,96
22,Huesca,64,Blecua y Torres,202,114,88
22,Huesca,66,Boltaña,1041,553,488
22,Huesca,67,Bonansa,84,45,39
22,Huesca,68,Borau,91,55,36
22,Huesca,69,Broto,523,277,246
22,Huesca,72,Caldearenas,208,117,91
22,Huesca,74,Campo,459,250,209
22,Huesca,75,Camporrélls,148,85,63
22,Huesca,76,Canal de Berdún,376,203,173
22,Huesca,77,Candasnos,339,175,164
22,Huesca,78,Canfranc,554,315,239
22,Huesca,79,Capdesaso,170,75,95
22,Huesca,80,Capella,361,192,169
22,Huesca,81,Casbas de Huesca,295,164,131
22,Huesca,83,Castejón de Monegros,574,300,274
22,Huesca,84,Castejón de Sos,733,374,359
22,Huesca,82,Castejón del Puente,349,182,167
22,Huesca,85,Castelflorite,123,67,56
22,Huesca,86,Castiello de Jaca,243,134,109
22,Huesca,87,Castigaleu,95,56,39
22,Huesca,88,Castillazuelo,191,89,102
22,Huesca,89,Castillonroy,336,170,166
22,Huesca,94,Chalamera,103,55,48
22,Huesca,95,Chía,87,55,32
22,Huesca,96,Chimillas,373,190,183
22,Huesca,90,Colungo,124,70,54
22,Huesca,99,Esplús,646,330,316
22,Huesca,102,Estada,215,118,97
22,Huesca,103,Estadilla,822,394,428
22,Huesca,105,Estopiñán del Castillo,136,72,64
22,Huesca,106,Fago,24,15,9
22,Huesca,107,Fanlo,118,75,43
22,Huesca,109,Fiscal,369,201,168
22,Huesca,110,Fonz,960,488,472
22,Huesca,111,Foradada del Toscar,192,103,89
22,Huesca,112,Fraga,14926,7625,7301
22,Huesca,113,"Fueva, La",622,326,296
22,Huesca,114,Gistaín,143,80,63
22,Huesca,115,"Grado, El",435,231,204
22,Huesca,116,Grañén,1902,997,905
22,Huesca,117,Graus,3429,1739,1690
22,Huesca,119,Gurrea de Gállego,1575,813,762
22,Huesca,122,Hoz de Jaca,73,38,35
22,Huesca,908,Hoz y Costean,237,133,104
22,Huesca,124,Huerto,242,133,109
22,Huesca,125,Huesca,52555,25263,27292
22,Huesca,126,Ibieca,119,66,53
22,Huesca,127,Igriés,700,366,334
22,Huesca,128,Ilche,214,110,104
22,Huesca,129,Isábena,288,152,136
22,Huesca,130,Jaca,13121,6515,6606
22,Huesca,131,Jasa,111,63,48
22,Huesca,133,Labuerda,155,81,74
22,Huesca,135,Laluenga,216,116,100
22,Huesca,136,Lalueza,1024,536,488
22,Huesca,137,Lanaja,1324,708,616
22,Huesca,139,Laperdiguera,94,51,43
22,Huesca,141,Lascellas-Ponzano,146,84,62
22,Huesca,142,Lascuarre,136,70,66
22,Huesca,143,Laspaúles,304,178,126
22,Huesca,144,Laspuña,298,161,137
22,Huesca,149,Loarre,338,190,148
22,Huesca,150,Loporzano,535,301,234
22,Huesca,151,Loscorrales,107,52,55
22,Huesca,905,Lupiñén-Ortilla,373,185,188
22,Huesca,155,Monesma y Cajigar,88,47,41
22,Huesca,156,Monflorite-Lascasas,295,161,134
22,Huesca,157,Montanuy,237,136,101
22,Huesca,158,Monzón,17176,8746,8430
22,Huesca,160,Naval,256,132,124
22,Huesca,162,Novales,176,90,86
22,Huesca,163,Nueno,558,314,244
22,Huesca,164,Olvena,57,26,31
22,Huesca,165,Ontiñena,570,287,283
22,Huesca,167,Osso de Cinca,771,404,367
22,Huesca,168,Palo,22,10,12
22,Huesca,170,Panticosa,757,389,368
22,Huesca,172,Peñalba,691,351,340
22,Huesca,173,"Peñas de Riglos, Las",267,166,101
22,Huesca,174,Peralta de Alcofea,582,303,279
22,Huesca,175,Peralta de Calasanz,240,137,103
22,Huesca,176,Peraltilla,206,110,96
22,Huesca,177,Perarrúa,113,60,53
22,Huesca,178,Pertusa,121,69,52
22,Huesca,181,Piracés,106,58,48
22,Huesca,182,Plan,314,161,153
22,Huesca,184,Poleñino,216,115,101
22,Huesca,186,Pozán de Vero,225,110,115
22,Huesca,187,"Puebla de Castro, La",401,206,195
22,Huesca,188,Puente de Montañana,119,52,67
22,Huesca,902,Puente la Reina de Jaca,276,144,132
22,Huesca,189,Puértolas,217,125,92
22,Huesca,190,"Pueyo de Araguás, El",145,85,60
22,Huesca,193,Pueyo de Santa Cruz,338,172,166
22,Huesca,195,Quicena,300,154,146
22,Huesca,197,Robres,575,288,287
22,Huesca,199,Sabiñánigo,9883,4985,4898
22,Huesca,200,Sahún,304,163,141
22,Huesca,201,Salas Altas,319,161,158
22,Huesca,202,Salas Bajas,161,76,85
22,Huesca,203,Salillas,107,58,49
22,Huesca,204,Sallent de Gállego,1484,748,736
22,Huesca,205,San Esteban de Litera,495,258,237
22,Huesca,207,San Juan de Plan,147,82,65
22,Huesca,903,San Miguel del Cinca,852,414,438
22,Huesca,206,Sangarrén,212,110,102
22,Huesca,208,Santa Cilia,225,114,111
22,Huesca,209,Santa Cruz de la Serós,192,110,82
22,Huesca,906,Santa María de Dulcis,226,119,107
22,Huesca,212,Santaliestra y San Quílez,99,49,50
22,Huesca,213,Sariñena,4293,2209,2084
22,Huesca,214,Secastilla,146,65,81
22,Huesca,215,Seira,147,84,63
22,Huesca,217,Sena,516,284,232
22,Huesca,218,Senés de Alcubierre,52,25,27
22,Huesca,220,Sesa,202,113,89
22,Huesca,221,Sesué,116,63,53
22,Huesca,222,Siétamo,675,370,305
22,Huesca,223,Sopeira,107,59,48
22,Huesca,904,"Sotonera, La",1013,519,494
22,Huesca,225,Tamarite de Litera,3604,1831,1773
22,Huesca,226,Tardienta,1005,509,496
22,Huesca,227,Tella-Sin,260,148,112
22,Huesca,228,Tierz,734,362,372
22,Huesca,229,Tolva,148,86,62
22,Huesca,230,Torla,293,154,139
22,Huesca,232,Torralba de Aragón,113,58,55
22,Huesca,233,Torre la Ribera,106,53,53
22,Huesca,234,Torrente de Cinca,1205,600,605
22,Huesca,235,Torres de Alcanadre,103,59,44
22,Huesca,236,Torres de Barbués,293,145,148
22,Huesca,239,Tramaced,97,57,40
22,Huesca,242,Valfarta,73,42,31
22,Huesca,243,Valle de Bardají,37,21,16
22,Huesca,901,Valle de Hecho,903,467,436
22,Huesca,244,Valle de Lierp,58,32,26
22,Huesca,245,Velilla de Cinca,461,237,224
22,Huesca,909,Vencillón,425,221,204
22,Huesca,247,Viacamp y Litera,43,25,18
22,Huesca,248,Vicién,122,69,53
22,Huesca,249,Villanova,159,82,77
22,Huesca,250,Villanúa,475,260,215
22,Huesca,251,Villanueva de Sigena,434,215,219
22,Huesca,252,Yebra de Basa,142,81,61
22,Huesca,253,Yésero,57,35,22
22,Huesca,254,Zaidín,1837,949,888
23,Jaén,1,Albanchez de Mágina,1140,591,549
23,Jaén,2,Alcalá la Real,22324,11011,11313
23,Jaén,3,Alcaudete,10896,5368,5528
23,Jaén,4,Aldeaquemada,536,279,257
23,Jaén,5,Andújar,38549,19014,19535
23,Jaén,6,Arjona,5732,2846,2886
23,Jaén,7,Arjonilla,3764,1889,1875
23,Jaén,8,Arquillos,1900,948,952
23,Jaén,905,Arroyo del Ojanco,2455,1266,1189
23,Jaén,9,Baeza,16215,8026,8189
23,Jaén,10,Bailén,18419,9214,9205
23,Jaén,11,Baños de la Encina,2669,1358,1311
23,Jaén,12,Beas de Segura,5542,2890,2652
23,Jaén,902,Bedmar y Garcíez,2902,1443,1459
23,Jaén,14,Begíjar,3133,1577,1556
23,Jaén,15,Bélmez de la Moraleda,1709,843,866
23,Jaén,16,Benatae,498,257,241
23,Jaén,17,Cabra del Santo Cristo,1968,1032,936
23,Jaén,18,Cambil,2861,1476,1385
23,Jaén,19,Campillo de Arenas,1977,1032,945
23,Jaén,20,Canena,1981,1002,979
23,Jaén,21,Carboneros,641,331,310
23,Jaén,901,Cárcheles,1458,751,707
23,Jaén,24,"Carolina, La",15808,7823,7985
23,Jaén,25,Castellar,3470,1737,1733
23,Jaén,26,Castillo de Locubín,4381,2153,2228
23,Jaén,27,Cazalilla,870,423,447
23,Jaén,28,Cazorla,7812,3780,4032
23,Jaén,29,Chiclana de Segura,1051,524,527
23,Jaén,30,Chilluévar,1533,754,779
23,Jaén,31,Escañuela,950,477,473
23,Jaén,32,Espelúy,707,354,353
23,Jaén,33,Frailes,1648,815,833
23,Jaén,34,Fuensanta de Martos,3160,1560,1600
23,Jaén,35,Fuerte del Rey,1402,716,686
23,Jaén,37,Génave,617,335,282
23,Jaén,38,"Guardia de Jaén, La",4747,2424,2323
23,Jaén,39,Guarromán,2919,1478,1441
23,Jaén,41,Higuera de Calatrava,642,337,305
23,Jaén,42,Hinojares,370,201,169
23,Jaén,43,Hornos,658,317,341
23,Jaén,44,Huelma,6114,3047,3067
23,Jaén,45,Huesa,2604,1315,1289
23,Jaén,46,Ibros,3002,1489,1513
23,Jaén,47,"Iruela, La",2045,1035,1010
23,Jaén,48,Iznatoraf,1038,548,490
23,Jaén,49,Jabalquinto,2250,1127,1123
23,Jaén,50,Jaén,115837,55842,59995
23,Jaén,51,Jamilena,3466,1765,1701
23,Jaén,52,Jimena,1358,665,693
23,Jaén,53,Jódar,12082,5963,6119
23,Jaén,40,Lahiguera,1804,885,919
23,Jaén,54,Larva,488,249,239
23,Jaén,55,Linares,60290,29556,30734
23,Jaén,56,Lopera,3837,1933,1904
23,Jaén,57,Lupión,924,459,465
23,Jaén,58,Mancha Real,11324,5677,5647
23,Jaén,59,Marmolejo,7183,3572,3611
23,Jaén,60,Martos,24562,12190,12372
23,Jaén,61,Mengíbar,9943,4980,4963
23,Jaén,62,Montizón,1797,928,869
23,Jaén,63,Navas de San Juan,4790,2394,2396
23,Jaén,64,Noalejo,2002,1006,996
23,Jaén,65,Orcera,1927,969,958
23,Jaén,66,Peal de Becerro,5413,2693,2720
23,Jaén,67,Pegalajar,3055,1536,1519
23,Jaén,69,Porcuna,6630,3356,3274
23,Jaén,70,Pozo Alcón,4970,2534,2436
23,Jaén,71,Puente de Génave,2247,1126,1121
23,Jaén,72,"Puerta de Segura, La",2542,1274,1268
23,Jaén,73,Quesada,5613,2832,2781
23,Jaén,74,Rus,3695,1894,1801
23,Jaén,75,Sabiote,4101,2028,2073
23,Jaén,76,Santa Elena,1001,537,464
23,Jaén,77,Santiago de Calatrava,795,408,387
23,Jaén,904,Santiago-Pontones,3422,1750,1672
23,Jaén,79,Santisteban del Puerto,4712,2418,2294
23,Jaén,80,Santo Tomé,2330,1194,1136
23,Jaén,81,Segura de la Sierra,1923,946,977
23,Jaén,82,Siles,2362,1193,1169
23,Jaén,84,Sorihuela del Guadalimar,1298,684,614
23,Jaén,86,Torre del Campo,14616,7341,7275
23,Jaén,85,Torreblascopedro,2783,1401,1382
23,Jaén,87,Torredonjimeno,14036,6900,7136
23,Jaén,88,Torreperogil,7600,3723,3877
23,Jaén,90,Torres,1558,794,764
23,Jaén,91,Torres de Albánchez,909,473,436
23,Jaén,92,Úbeda,35177,17242,17935
23,Jaén,93,Valdepeñas de Jaén,3988,1971,2017
23,Jaén,94,Vilches,4724,2396,2328
23,Jaén,95,Villacarrillo,11092,5595,5497
23,Jaén,96,Villanueva de la Reina,3274,1647,1627
23,Jaén,97,Villanueva del Arzobispo,8595,4448,4147
23,Jaén,98,Villardompardo,1054,522,532
23,Jaén,99,"Villares, Los",5936,2985,2951
23,Jaén,101,Villarrodrigo,458,236,222
23,Jaén,903,Villatorres,4443,2260,2183
24,León,1,Acebedo,222,132,90
24,León,2,Algadefe,300,153,147
24,León,3,Alija del Infantado,758,384,374
24,León,4,Almanza,580,328,252
24,León,5,"Antigua, La",430,242,188
24,León,6,Ardón,611,321,290
24,León,7,Arganza,881,444,437
24,León,8,Astorga,11633,5529,6104
24,León,9,Balboa,337,181,156
24,León,10,"Bañeza, La",10595,5132,5463
24,León,11,Barjas,203,109,94
24,León,12,"Barrios de Luna, Los",329,188,141
24,León,14,Bembibre,9631,4749,4882
24,León,15,Benavides,2666,1324,1342
24,León,16,Benuza,515,293,222
24,León,17,Bercianos del Páramo,637,320,317
24,León,18,Bercianos del Real Camino,197,103,94
24,León,19,Berlanga del Bierzo,384,178,206
24,León,20,Boca de Huérgano,503,296,207
24,León,21,Boñar,1997,1003,994
24,León,22,Borrenes,368,187,181
24,León,23,Brazuelo,311,168,143
24,León,24,"Burgo Ranero, El",779,419,360
24,León,25,Burón,319,184,135
24,León,26,Bustillo del Páramo,1350,702,648
24,León,27,Cabañas Raras,1326,674,652
24,León,28,Cabreros del Río,437,238,199
24,León,29,Cabrillanes,855,433,422
24,León,30,Cacabelos,5337,2680,2657
24,León,31,Calzada del Coto,253,142,111
24,León,32,Campazas,135,66,69
24,León,33,Campo de Villavidel,207,112,95
24,León,34,Camponaraya,4131,2053,2078
24,León,36,Candín,303,155,148
24,León,37,Cármenes,401,216,185
24,León,38,Carracedelo,3630,1790,1840
24,León,39,Carrizo,2433,1237,1196
24,León,40,Carrocera,524,275,249
24,León,41,Carucedo,603,304,299
24,León,42,Castilfalé,77,42,35
24,León,43,Castrillo de Cabrera,133,73,60
24,León,44,Castrillo de la Valduerna,189,83,106
24,León,46,Castrocalbón,1050,551,499
24,León,47,Castrocontrigo,847,447,400
24,León,49,Castropodame,1753,899,854
24,León,50,Castrotierra de Valmadrigal,114,59,55
24,León,51,Cea,481,255,226
24,León,52,Cebanico,182,101,81
24,León,53,Cebrones del Río,532,281,251
24,León,65,Chozas de Abajo,2449,1276,1173
24,León,54,Cimanes de la Vega,497,254,243
24,León,55,Cimanes del Tejar,776,419,357
24,León,56,Cistierna,3489,1739,1750
24,León,57,Congosto,1615,790,825
24,León,58,Corbillos de los Oteros,215,120,95
24,León,59,Corullón,1007,522,485
24,León,60,Crémenes,585,316,269
24,León,61,Cuadros,1998,1011,987
24,León,62,Cubillas de los Oteros,153,82,71
24,León,63,Cubillas de Rueda,475,247,228
24,León,64,Cubillos del Sil,1851,974,877
24,León,66,Destriana,562,269,293
24,León,67,Encinedo,809,420,389
24,León,68,"Ercina, La",501,255,246
24,León,69,Escobar de Campos,48,31,17
24,León,70,Fabero,4956,2414,2542
24,León,71,Folgoso de la Ribera,1182,578,604
24,León,73,Fresno de la Vega,608,303,305
24,León,74,Fuentes de Carbajal,102,57,45
24,León,76,Garrafe de Torío,1409,757,652
24,León,77,Gordaliza del Pino,269,134,135
24,León,78,Gordoncillo,478,241,237
24,León,79,Gradefes,997,531,466
24,León,80,Grajal de Campos,243,123,120
24,León,81,Gusendos de los Oteros,149,84,65
24,León,82,Hospital de Órbigo,982,484,498
24,León,83,Igüeña,1298,688,610
24,León,84,Izagre,193,103,90
24,León,86,Joarilla de las Matas,329,169,160
24,León,87,Laguna Dalga,707,380,327
24,León,88,Laguna de Negrillos,1137,587,550
24,León,89,León,129551,59132,70419
24,León,92,Llamas de la Ribera,916,474,442
24,León,90,Lucillo,408,217,191
24,León,91,Luyego,740,371,369
24,León,93,Magaz de Cepeda,384,198,186
24,León,94,Mansilla de las Mulas,1859,959,900
24,León,95,Mansilla Mayor,338,177,161
24,León,96,Maraña,145,85,60
24,León,97,Matadeón de los Oteros,261,136,125
24,León,98,Matallana de Torío,1372,714,658
24,León,99,Matanza,207,115,92
24,León,100,Molinaseca,898,488,410
24,León,101,Murias de Paredes,444,220,224
24,León,102,Noceda del Bierzo,730,367,363
24,León,103,Oencia,329,190,139
24,León,104,"Omañas, Las",302,162,140
24,León,105,Onzonilla,1798,941,857
24,León,106,Oseja de Sajambre,284,167,117
24,León,107,Pajares de los Oteros,316,196,120
24,León,108,Palacios de la Valduerna,437,214,223
24,León,109,Palacios del Sil,1095,606,489
24,León,110,Páramo del Sil,1395,699,696
24,León,112,Peranzanes,320,187,133
24,León,113,Pobladura de Pelayo García,401,206,195
24,León,114,"Pola de Gordón, La",3653,1811,1842
24,León,115,Ponferrada,67367,32214,35153
24,León,116,Posada de Valdeón,464,278,186
24,León,117,Pozuelo del Páramo,493,257,236
24,León,118,Prado de la Guzpeña,143,79,64
24,León,119,Priaranza del Bierzo,832,420,412
24,León,120,Prioro,378,214,164
24,León,121,Puebla de Lillo,694,386,308
24,León,122,Puente de Domingo Flórez,1537,797,740
24,León,123,Quintana del Castillo,768,420,348
24,León,124,Quintana del Marco,428,227,201
24,León,125,Quintana y Congosto,396,198,198
24,León,127,Regueras de Arriba,331,179,152
24,León,129,Reyero,120,62,58
24,León,130,Riaño,508,294,214
24,León,131,Riego de la Vega,863,446,417
24,León,132,Riello,686,380,306
24,León,133,Rioseco de Tapia,379,205,174
24,León,134,"Robla, La",4387,2228,2159
24,León,136,Roperuelos del Páramo,616,312,304
24,León,137,Sabero,1275,627,648
24,León,139,Sahagún,2783,1376,1407
24,León,141,San Adrián del Valle,107,56,51
24,León,142,San Andrés del Rabanedo,31741,15331,16410
24,León,144,San Cristóbal de la Polantera,808,398,410
24,León,145,San Emiliano,691,373,318
24,León,146,San Esteban de Nogales,285,146,139
24,León,148,San Justo de la Vega,1986,1011,975
24,León,149,San Millán de los Caballeros,185,98,87
24,León,150,San Pedro Bercianos,262,139,123
24,León,143,Sancedo,565,278,287
24,León,151,Santa Colomba de Curueño,537,276,261
24,León,152,Santa Colomba de Somoza,518,283,235
24,León,153,Santa Cristina de Valmadrigal,284,148,136
24,León,154,Santa Elena de Jamuz,1155,600,555
24,León,155,Santa María de la Isla,540,283,257
24,León,158,Santa María de Ordás,353,180,173
24,León,156,Santa María del Monte de Cea,260,136,124
24,León,157,Santa María del Páramo,3157,1553,1604
24,León,159,Santa Marina del Rey,2043,1010,1033
24,León,160,Santas Martas,834,440,394
24,León,161,Santiago Millas,331,182,149
24,León,162,Santovenia de la Valdoncina,1996,1025,971
24,León,163,Sariegos,4819,2446,2373
24,León,164,Sena de Luna,388,196,192
24,León,165,Sobrado,366,183,183
24,León,166,Soto de la Vega,1656,854,802
24,León,167,Soto y Amío,865,438,427
24,León,168,Toral de los Guzmanes,541,286,255
24,León,206,Toral de los Vados,2068,1022,1046
24,León,169,Toreno,3481,1726,1755
24,León,170,Torre del Bierzo,2352,1190,1162
24,León,171,Trabadelo,412,234,178
24,León,172,Truchas,470,236,234
24,León,173,Turcia,1091,553,538
24,León,174,Urdiales del Páramo,520,268,252
24,León,185,Val de San Lorenzo,545,273,272
24,León,175,Valdefresno,2124,1097,1027
24,León,176,Valdefuentes del Páramo,343,180,163
24,León,177,Valdelugueros,548,308,240
24,León,178,Valdemora,81,35,46
24,León,179,Valdepiélago,343,188,155
24,León,180,Valdepolo,1297,681,616
24,León,181,Valderas,1731,877,854
24,León,182,Valderrey,464,220,244
24,León,183,Valderrueda,945,484,461
24,León,184,Valdesamario,216,123,93
24,León,187,Valdevimbre,1013,525,488
24,León,188,Valencia de Don Juan,5204,2547,2657
24,León,191,Vallecillo,130,72,58
24,León,189,Valverde de la Virgen,7275,3739,3536
24,León,190,Valverde-Enrique,181,96,85
24,León,193,"Vecilla, La",396,205,191
24,León,196,Vega de Espinareda,2321,1171,1150
24,León,197,Vega de Infanzones,918,463,455
24,León,198,Vega de Valcarce,672,349,323
24,León,194,Vegacervera,327,178,149
24,León,199,Vegaquemada,454,236,218
24,León,201,Vegas del Condado,1175,660,515
24,León,202,Villablino,9784,4806,4978
24,León,203,Villabraz,110,63,47
24,León,205,Villadangos del Páramo,1100,575,525
24,León,207,Villademor de la Vega,370,196,174
24,León,209,Villafranca del Bierzo,3251,1551,1700
24,León,210,Villagatón,619,325,294
24,León,211,Villamandos,314,172,142
24,León,901,Villamanín,1053,532,521
24,León,212,Villamañán,1218,586,632
24,León,213,Villamartín de Don Sancho,148,80,68
24,León,214,Villamejil,760,401,359
24,León,215,Villamol,175,88,87
24,León,216,Villamontán de la Valduerna,822,429,393
24,León,217,Villamoratiel de las Matas,152,85,67
24,León,218,Villanueva de las Manzanas,506,263,243
24,León,219,Villaobispo de Otero,634,342,292
24,León,902,Villaornate y Castro,386,193,193
24,León,221,Villaquejida,932,467,465
24,León,222,Villaquilambre,18456,9216,9240
24,León,223,Villarejo de Órbigo,3194,1567,1627
24,León,224,Villares de Órbigo,692,371,321
24,León,225,Villasabariego,1195,628,567
24,León,226,Villaselán,219,124,95
24,León,227,Villaturiel,1957,1029,928
24,León,228,Villazala,751,396,355
24,León,229,Villazanzo de Valderaduey,490,280,210
24,León,230,Zotes del Páramo,467,263,204
25,Lleida,1,Abella de la Conca,170,94,76
25,Lleida,2,Àger,594,314,280
25,Lleida,3,Agramunt,5515,2777,2738
25,Lleida,38,Aitona,2415,1225,1190
25,Lleida,4,"Alamús, Els",769,403,366
25,Lleida,5,Alàs i Cerc,356,182,174
25,Lleida,6,"Albagés, L'",419,220,199
25,Lleida,7,Albatàrrec,2139,1112,1027
25,Lleida,8,Albesa,1608,856,752
25,Lleida,9,"Albi, L'",834,436,398
25,Lleida,10,Alcanó,242,118,124
25,Lleida,11,Alcarràs,9252,4815,4437
25,Lleida,12,Alcoletge,3270,1716,1554
25,Lleida,13,Alfarràs,3003,1562,1441
25,Lleida,14,Alfés,315,162,153
25,Lleida,15,Algerri,423,228,195
25,Lleida,16,Alguaire,3093,1636,1457
25,Lleida,17,Alins,286,150,136
25,Lleida,19,Almacelles,6699,3484,3215
25,Lleida,20,Almatret,333,176,157
25,Lleida,21,Almenar,3547,1887,1660
25,Lleida,22,Alòs de Balaguer,126,69,57
25,Lleida,23,Alpicat,6297,3140,3157
25,Lleida,24,Alt Àneu,416,235,181
25,Lleida,27,Anglesola,1360,678,682
25,Lleida,29,Arbeca,2389,1221,1168
25,Lleida,31,Arres,73,45,28
25,Lleida,32,Arsèguel,81,45,36
25,Lleida,33,Artesa de Lleida,1508,784,724
25,Lleida,34,Artesa de Segre,3656,1850,1806
25,Lleida,36,Aspa,215,107,108
25,Lleida,37,"Avellanes i Santa Linya, Les",479,272,207
25,Lleida,39,Baix Pallars,361,192,169
25,Lleida,40,Balaguer,16485,8333,8152
25,Lleida,41,Barbens,875,465,410
25,Lleida,42,"Baronia de Rialb, La",235,124,111
25,Lleida,44,Bassella,244,125,119
25,Lleida,45,Bausen,49,29,20
25,Lleida,46,Belianes,555,275,280
25,Lleida,170,Bellaguarda,307,161,146
25,Lleida,47,Bellcaire d'Urgell,1305,666,639
25,Lleida,48,Bell-lloc d'Urgell,2351,1164,1187
25,Lleida,49,Bellmunt d'Urgell,192,95,97
25,Lleida,50,Bellpuig,4956,2558,2398
25,Lleida,51,Bellver de Cerdanya,2075,1086,989
25,Lleida,52,Bellvís,2342,1184,1158
25,Lleida,53,Benavent de Segrià,1516,792,724
25,Lleida,55,Biosca,197,106,91
25,Lleida,57,"Bòrdes, Es",234,134,100
25,Lleida,58,"Borges Blanques, Les",6088,3094,2994
25,Lleida,59,Bossòst,1140,569,571
25,Lleida,56,Bovera,290,157,133
25,Lleida,60,Cabanabona,88,41,47
25,Lleida,61,Cabó,98,50,48
25,Lleida,62,Camarasa,911,454,457
25,Lleida,63,Canejan,102,57,45
25,Lleida,904,Castell de Mur,163,85,78
25,Lleida,64,Castellar de la Ribera,149,77,72
25,Lleida,67,Castelldans,976,528,448
25,Lleida,68,Castellnou de Seana,740,386,354
25,Lleida,69,Castelló de Farfanya,565,304,261
25,Lleida,70,Castellserà,1083,546,537
25,Lleida,71,Cava,60,34,26
25,Lleida,72,Cervera,9039,4555,4484
25,Lleida,73,Cervià de les Garrigues,708,365,343
25,Lleida,74,Ciutadilla,209,114,95
25,Lleida,75,Clariana de Cardener,140,71,69
25,Lleida,76,"Cogul, El",190,103,87
25,Lleida,77,Coll de Nargó,587,296,291
25,Lleida,163,"Coma i la Pedra, La",269,164,105
25,Lleida,161,Conca de Dalt,443,231,212
25,Lleida,78,Corbins,1400,749,651
25,Lleida,79,Cubells,395,212,183
25,Lleida,81,"Espluga Calba, L'",395,199,196
25,Lleida,82,Espot,357,193,164
25,Lleida,88,Estamariu,119,71,48
25,Lleida,85,Estaràs,176,95,81
25,Lleida,86,Esterri d'Àneu,866,438,428
25,Lleida,87,Esterri de Cardós,72,36,36
25,Lleida,89,Farrera,125,72,53
25,Lleida,908,Fígols i Alinyà,260,147,113
25,Lleida,92,"Floresta, La",162,89,73
25,Lleida,93,Fondarella,838,424,414
25,Lleida,94,Foradada,182,103,79
25,Lleida,96,"Fuliola, La",1294,653,641
25,Lleida,97,Fulleda,98,47,51
25,Lleida,98,Gavet de la Conca,303,151,152
25,Lleida,912,Gimenells i el Pla de la Font,1129,577,552
25,Lleida,99,Golmés,1734,869,865
25,Lleida,100,Gósol,216,127,89
25,Lleida,101,"Granadella, La",715,374,341
25,Lleida,102,"Granja d'Escarp, La",972,505,467
25,Lleida,103,Granyanella,147,81,66
25,Lleida,105,Granyena de les Garrigues,162,96,66
25,Lleida,104,Granyena de Segarra,136,67,69
25,Lleida,109,Guimerà,295,162,133
25,Lleida,903,"Guingueta d'Àneu, La",317,169,148
25,Lleida,110,Guissona,6827,3605,3222
25,Lleida,111,Guixers,128,76,52
25,Lleida,115,Isona i Conca Dellà,1049,548,501
25,Lleida,112,Ivars de Noguera,350,182,168
25,Lleida,113,Ivars d'Urgell,1607,843,764
25,Lleida,114,Ivorra,115,59,56
25,Lleida,910,Josa i Tuixén,128,74,54
25,Lleida,118,Juncosa,438,238,200
25,Lleida,119,Juneda,3497,1843,1654
25,Lleida,121,Les,968,481,487
25,Lleida,122,Linyola,2677,1361,1316
25,Lleida,123,Lladorre,232,114,118
25,Lleida,124,Lladurs,195,106,89
25,Lleida,125,Llardecans,497,257,240
25,Lleida,126,Llavorsí,367,188,179
25,Lleida,120,Lleida,139176,68911,70265
25,Lleida,127,Lles de Cerdanya,260,156,104
25,Lleida,128,Llimiana,159,95,64
25,Lleida,129,Llobera,201,104,97
25,Lleida,133,Maials,959,501,458
25,Lleida,130,Maldà,227,117,110
25,Lleida,131,Massalcoreig,560,292,268
25,Lleida,132,Massoteres,196,108,88
25,Lleida,134,Menàrguens,887,489,398
25,Lleida,135,Miralcamp,1384,697,687
25,Lleida,137,Mollerussa,14963,7629,7334
25,Lleida,136,"Molsosa, La",116,58,58
25,Lleida,139,Montellà i Martinet,623,335,288
25,Lleida,140,Montferrer i Castellbò,1027,549,478
25,Lleida,138,Montgai,671,348,323
25,Lleida,142,Montoliu de Lleida,515,263,252
25,Lleida,141,Montoliu de Segarra,193,111,82
25,Lleida,143,Montornès de Segarra,105,53,52
25,Lleida,145,Nalec,93,48,45
25,Lleida,25,Naut Aran,1782,897,885
25,Lleida,146,Navès,280,137,143
25,Lleida,148,Odèn,267,154,113
25,Lleida,149,Oliana,1870,922,948
25,Lleida,150,Oliola,235,129,106
25,Lleida,151,Olius,902,462,440
25,Lleida,152,"Oluges, Les",158,84,74
25,Lleida,153,"Omellons, Els",232,123,109
25,Lleida,154,"Omells de na Gaia, Els",141,76,65
25,Lleida,155,Organyà,841,413,428
25,Lleida,156,Os de Balaguer,1008,510,498
25,Lleida,157,Ossó de Sió,211,106,105
25,Lleida,158,"Palau d'Anglesola, El",2135,1061,1074
25,Lleida,164,Penelles,504,298,206
25,Lleida,165,Peramola,349,177,172
25,Lleida,166,Pinell de Solsonès,207,116,91
25,Lleida,167,Pinós,302,166,136
25,Lleida,911,"Plans de Sió, Els",560,294,266
25,Lleida,168,"Poal, El",656,342,314
25,Lleida,169,"Pobla de Cérvoles, La",220,123,97
25,Lleida,171,"Pobla de Segur, La",3012,1490,1522
25,Lleida,30,"Pont de Bar, El",172,100,72
25,Lleida,173,"Pont de Suert, El",2318,1172,1146
25,Lleida,172,Ponts,2701,1340,1361
25,Lleida,174,"Portella, La",750,415,335
25,Lleida,175,Prats i Sansor,248,129,119
25,Lleida,176,Preixana,405,202,203
25,Lleida,177,Preixens,450,229,221
25,Lleida,179,Prullans,209,104,105
25,Lleida,180,Puiggròs,296,160,136
25,Lleida,181,Puigverd d'Agramunt,259,150,109
25,Lleida,182,Puigverd de Lleida,1411,727,684
25,Lleida,183,Rialp,667,349,318
25,Lleida,905,Ribera d'Ondara,420,219,201
25,Lleida,185,Ribera d'Urgellet,963,504,459
25,Lleida,186,Riner,281,137,144
25,Lleida,913,Riu de Cerdanya,106,60,46
25,Lleida,189,Rosselló,3021,1543,1478
25,Lleida,190,Salàs de Pallars,365,192,173
25,Lleida,191,Sanaüja,423,219,204
25,Lleida,196,Sant Esteve de la Sarga,132,79,53
25,Lleida,192,Sant Guim de Freixenet,1107,575,532
25,Lleida,197,Sant Guim de la Plana,175,93,82
25,Lleida,193,Sant Llorenç de Morunys,993,492,501
25,Lleida,902,Sant Martí de Riucorb,685,361,324
25,Lleida,194,Sant Ramon,496,266,230
25,Lleida,201,Sarroca de Bellera,124,73,51
25,Lleida,200,Sarroca de Lleida,403,220,183
25,Lleida,202,Senterada,131,77,54
25,Lleida,35,"Sentiu de Sió, La",467,235,232
25,Lleida,204,Seròs,1887,1032,855
25,Lleida,203,"Seu d'Urgell, La",12366,5968,6398
25,Lleida,205,Sidamon,706,371,335
25,Lleida,206,"Soleràs, El",359,185,174
25,Lleida,207,Solsona,9067,4531,4536
25,Lleida,208,Soriguera,377,199,178
25,Lleida,209,Sort,2237,1113,1124
25,Lleida,210,Soses,1754,916,838
25,Lleida,211,Sudanell,872,485,387
25,Lleida,212,Sunyer,307,163,144
25,Lleida,215,Talarn,413,216,197
25,Lleida,216,Talavera,267,148,119
25,Lleida,217,Tàrrega,16587,8256,8331
25,Lleida,218,Tarrés,105,62,43
25,Lleida,219,Tarroja de Segarra,173,90,83
25,Lleida,220,Térmens,1536,769,767
25,Lleida,221,Tírvia,156,76,80
25,Lleida,222,Tiurana,76,36,40
25,Lleida,223,Torà,1202,603,599
25,Lleida,224,"Torms, Els",148,81,67
25,Lleida,225,Tornabous,911,487,424
25,Lleida,227,"Torre de Cabdella, La",761,390,371
25,Lleida,226,Torrebesses,291,152,139
25,Lleida,228,Torrefarrera,4512,2268,2244
25,Lleida,907,Torrefeta i Florejacs,601,315,286
25,Lleida,230,Torregrossa,2235,1133,1102
25,Lleida,231,Torrelameu,709,400,309
25,Lleida,232,Torres de Segre,2301,1184,1117
25,Lleida,233,Torre-serona,388,197,191
25,Lleida,234,Tremp,6305,3145,3160
25,Lleida,43,"Vall de Boí, La",992,528,464
25,Lleida,901,Vall de Cardós,384,210,174
25,Lleida,238,Vallbona de les Monges,262,138,124
25,Lleida,240,Vallfogona de Balaguer,1888,930,958
25,Lleida,906,"Valls d'Aguilar, Les",298,156,142
25,Lleida,239,"Valls de Valira, Les",849,429,420
25,Lleida,909,"Vansa i Fórnols, La",210,110,100
25,Lleida,242,Verdú,964,457,507
25,Lleida,243,Vielha e Mijaran,5474,2764,2710
25,Lleida,244,Vilagrassa,514,267,247
25,Lleida,245,Vilaller,563,304,259
25,Lleida,247,Vilamòs,171,95,76
25,Lleida,248,Vilanova de Bellpuig,1179,603,576
25,Lleida,254,Vilanova de la Barca,1120,563,557
25,Lleida,249,Vilanova de l'Aguda,228,112,116
25,Lleida,250,Vilanova de Meià,422,224,198
25,Lleida,251,Vilanova de Segrià,930,487,443
25,Lleida,252,Vila-sana,706,357,349
25,Lleida,253,"Vilosell, El",188,92,96
25,Lleida,255,Vinaixa,546,278,268
27,Lugo,1,Abadín,2646,1296,1350
27,Lugo,2,Alfoz,1903,923,980
27,Lugo,3,Antas de Ulla,2152,1056,1096
27,Lugo,4,Baleira,1392,738,654
27,Lugo,901,Baralla,2774,1436,1338
27,Lugo,5,Barreiros,2994,1433,1561
27,Lugo,6,Becerreá,3012,1509,1503
27,Lugo,7,Begonte,3179,1587,1592
27,Lugo,8,Bóveda,1571,783,788
27,Lugo,902,Burela,9660,4823,4837
27,Lugo,9,Carballedo,2401,1192,1209
27,Lugo,10,Castro de Rei,5226,2572,2654
27,Lugo,11,Castroverde,2823,1450,1373
27,Lugo,12,Cervantes,1528,867,661
27,Lugo,13,Cervo,4369,2150,2219
27,Lugo,16,Chantada,8553,4167,4386
27,Lugo,14,"Corgo, O",3695,1869,1826
27,Lugo,15,Cospeito,4892,2381,2511
27,Lugo,17,Folgoso do Courel,1106,575,531
27,Lugo,18,"Fonsagrada, A",3960,2064,1896
27,Lugo,19,Foz,9899,4828,5071
27,Lugo,20,Friol,4004,2006,1998
27,Lugo,22,Guitiriz,5564,2769,2795
27,Lugo,23,Guntín,2927,1492,1435
27,Lugo,24,"Incio, O",1797,882,915
27,Lugo,26,Láncara,2789,1402,1387
27,Lugo,27,Lourenzá,2338,1124,1214
27,Lugo,28,Lugo,98560,45948,52612
27,Lugo,29,Meira,1731,869,862
27,Lugo,30,Mondoñedo,3991,1860,2131
27,Lugo,31,Monforte de Lemos,19201,9109,10092
27,Lugo,32,Monterroso,3779,1867,1912
27,Lugo,33,Muras,696,357,339
27,Lugo,34,Navia de Suarna,1254,702,552
27,Lugo,35,Negueira de Muñiz,211,110,101
27,Lugo,37,"Nogais, As",1228,641,587
27,Lugo,38,Ourol,1090,537,553
27,Lugo,39,Outeiro de Rei,5083,2601,2482
27,Lugo,40,Palas de Rei,3601,1767,1834
27,Lugo,41,Pantón,2708,1300,1408
27,Lugo,42,Paradela,1967,974,993
27,Lugo,43,"Páramo, O",1484,742,742
27,Lugo,44,"Pastoriza, A",3309,1655,1654
27,Lugo,45,Pedrafita do Cebreiro,1155,619,536
27,Lugo,47,"Pobra do Brollón, A",1830,912,918
27,Lugo,46,Pol,1738,854,884
27,Lugo,48,"Pontenova, A",2534,1233,1301
27,Lugo,49,Portomarín,1624,823,801
27,Lugo,50,Quiroga,3501,1684,1817
27,Lugo,56,Rábade,1604,805,799
27,Lugo,51,Ribadeo,10010,4788,5222
27,Lugo,52,Ribas de Sil,1011,515,496
27,Lugo,53,Ribeira de Piquín,583,296,287
27,Lugo,54,Riotorto,1395,687,708
27,Lugo,55,Samos,1458,772,686
27,Lugo,57,Sarria,13504,6625,6879
27,Lugo,58,"Saviñao, O",4113,2060,2053
27,Lugo,59,Sober,2453,1192,1261
27,Lugo,60,Taboada,3101,1481,1620
27,Lugo,61,Trabada,1203,580,623
27,Lugo,62,Triacastela,721,360,361
27,Lugo,63,"Valadouro, O",2069,1011,1058
27,Lugo,64,"Vicedo, O",1882,934,948
27,Lugo,65,Vilalba,14788,7189,7599
27,Lugo,66,Viveiro,15932,7781,8151
27,Lugo,21,Xermade,2036,988,1048
27,Lugo,25,Xove,3456,1723,1733
28,Madrid,1,"Acebeda, La",67,37,30
28,Madrid,2,Ajalvir,4339,2284,2055
28,Madrid,3,Alameda del Valle,224,130,94
28,Madrid,4,"Álamo, El",8929,4449,4480
28,Madrid,5,Alcalá de Henares,200768,99461,101307
28,Madrid,6,Alcobendas,112188,54139,58049
28,Madrid,7,Alcorcón,170336,83079,87257
28,Madrid,8,Aldea del Fresno,2528,1338,1190
28,Madrid,9,Algete,20102,9931,10171
28,Madrid,10,Alpedrete,14005,6938,7067
28,Madrid,11,Ambite,607,316,291
28,Madrid,12,Anchuelo,1211,649,562
28,Madrid,13,Aranjuez,57792,28218,29574
28,Madrid,14,Arganda del Rey,55307,28135,27172
28,Madrid,15,Arroyomolinos,25374,12877,12497
28,Madrid,16,"Atazar, El",98,52,46
28,Madrid,17,Batres,1571,800,771
28,Madrid,18,Becerril de la Sierra,5351,2648,2703
28,Madrid,19,Belmonte de Tajo,1591,823,768
28,Madrid,21,"Berrueco, El",634,329,305
28,Madrid,20,Berzosa del Lozoya,189,109,80
28,Madrid,22,Boadilla del Monte,47852,23420,24432
28,Madrid,23,"Boalo, El",6982,3580,3402
28,Madrid,24,Braojos,199,112,87
28,Madrid,25,Brea de Tajo,568,326,242
28,Madrid,26,Brunete,10188,5056,5132
28,Madrid,27,Buitrago del Lozoya,1952,947,1005
28,Madrid,28,Bustarviejo,2348,1191,1157
28,Madrid,29,Cabanillas de la Sierra,732,386,346
28,Madrid,30,"Cabrera, La",2590,1292,1298
28,Madrid,31,Cadalso de los Vidrios,2760,1426,1334
28,Madrid,32,Camarma de Esteruelas,7048,3634,3414
28,Madrid,33,Campo Real,5775,2951,2824
28,Madrid,34,Canencia,476,251,225
28,Madrid,35,Carabaña,1978,991,987
28,Madrid,36,Casarrubuelos,3460,1763,1697
28,Madrid,37,Cenicientos,2073,1013,1060
28,Madrid,38,Cercedilla,6831,3353,3478
28,Madrid,39,Cervera de Buitrago,174,103,71
28,Madrid,51,Chapinería,2140,1094,1046
28,Madrid,52,Chinchón,5447,2765,2682
28,Madrid,40,Ciempozuelos,23739,11865,11874
28,Madrid,41,Cobeña,6921,3415,3506
28,Madrid,46,Collado Mediano,6780,3411,3369
28,Madrid,47,Collado Villalba,62587,30543,32044
28,Madrid,43,Colmenar de Oreja,8409,4319,4090
28,Madrid,42,Colmenar del Arroyo,1581,809,772
28,Madrid,45,Colmenar Viejo,47445,23435,24010
28,Madrid,44,Colmenarejo,8934,4420,4514
28,Madrid,48,Corpa,671,352,319
28,Madrid,49,Coslada,88847,44233,44614
28,Madrid,50,Cubas de la Sagra,5738,2830,2908
28,Madrid,53,Daganzo de Arriba,9841,4962,4879
28,Madrid,54,"Escorial, El",15244,7516,7728
28,Madrid,55,Estremera,1410,725,685
28,Madrid,56,Fresnedillas de la Oliva,1545,798,747
28,Madrid,57,Fresno de Torote,2020,1075,945
28,Madrid,58,Fuenlabrada,195864,97536,98328
28,Madrid,59,Fuente el Saz de Jarama,6409,3256,3153
28,Madrid,60,Fuentidueña de Tajo,2026,1020,1006
28,Madrid,61,Galapagar,32380,16012,16368
28,Madrid,62,Garganta de los Montes,382,198,184
28,Madrid,63,Gargantilla del Lozoya y Pinilla de Buitrago,362,193,169
28,Madrid,64,Gascones,179,102,77
28,Madrid,65,Getafe,173057,85055,88002
28,Madrid,66,Griñón,9928,4932,4996
28,Madrid,67,Guadalix de la Sierra,6057,3052,3005
28,Madrid,68,Guadarrama,15547,7678,7869
28,Madrid,69,"Hiruela, La",55,37,18
28,Madrid,70,Horcajo de la Sierra-Aoslos,179,105,74
28,Madrid,71,Horcajuelo de la Sierra,80,38,42
28,Madrid,72,Hoyo de Manzanares,7834,3945,3889
28,Madrid,73,Humanes de Madrid,19404,9826,9578
28,Madrid,74,Leganés,186696,91224,95472
28,Madrid,75,Loeches,8159,4091,4068
28,Madrid,76,Lozoya,591,309,282
28,Madrid,901,Lozoyuela-Navas-Sieteiglesias,1196,619,577
28,Madrid,78,Madarcos,47,29,18
28,Madrid,79,Madrid,3165235,1472990,1692245
28,Madrid,80,Majadahonda,70359,33445,36914
28,Madrid,82,Manzanares el Real,8182,4170,4012
28,Madrid,83,Meco,13133,6611,6522
28,Madrid,84,Mejorada del Campo,22763,11376,11387
28,Madrid,85,Miraflores de la Sierra,5890,3023,2867
28,Madrid,86,"Molar, El",7983,4039,3944
28,Madrid,87,"Molinos, Los",4374,2154,2220
28,Madrid,88,Montejo de la Sierra,363,181,182
28,Madrid,89,Moraleja de Enmedio,5032,2511,2521
28,Madrid,90,Moralzarzal,12321,6174,6147
28,Madrid,91,Morata de Tajuña,7452,3714,3738
28,Madrid,92,Móstoles,205712,101088,104624
28,Madrid,93,Navacerrada,2862,1411,1451
28,Madrid,94,Navalafuente,1194,621,573
28,Madrid,95,Navalagamella,2465,1288,1177
28,Madrid,96,Navalcarnero,26364,13185,13179
28,Madrid,97,Navarredonda y San Mamés,129,78,51
28,Madrid,99,Navas del Rey,2640,1408,1232
28,Madrid,100,Nuevo Baztán,5959,3004,2955
28,Madrid,101,Olmeda de las Fuentes,334,177,157
28,Madrid,102,Orusco de Tajuña,1283,652,631
28,Madrid,104,Paracuellos de Jarama,21718,11015,10703
28,Madrid,106,Parla,125323,63078,62245
28,Madrid,107,Patones,507,250,257
28,Madrid,108,Pedrezuela,5119,2593,2526
28,Madrid,109,Pelayos de la Presa,2502,1273,1229
28,Madrid,110,Perales de Tajuña,2945,1488,1457
28,Madrid,111,Pezuela de las Torres,795,416,379
28,Madrid,112,Pinilla del Valle,205,119,86
28,Madrid,113,Pinto,47594,23742,23852
28,Madrid,114,Piñuécar-Gandullas,172,91,81
28,Madrid,115,Pozuelo de Alarcón,84360,40406,43954
28,Madrid,116,Pozuelo del Rey,1092,574,518
28,Madrid,117,Prádena del Rincón,132,75,57
28,Madrid,118,Puebla de la Sierra,83,49,34
28,Madrid,902,Puentes Viejas,620,356,264
28,Madrid,119,Quijorna,3221,1646,1575
28,Madrid,120,Rascafría,1798,977,821
28,Madrid,121,Redueña,281,147,134
28,Madrid,122,Ribatejada,689,337,352
28,Madrid,123,Rivas-Vaciamadrid,80483,40255,40228
28,Madrid,124,Robledillo de la Jara,103,52,51
28,Madrid,125,Robledo de Chavela,4037,2108,1929
28,Madrid,126,Robregordo,52,29,23
28,Madrid,127,"Rozas de Madrid, Las",92784,44937,47847
28,Madrid,128,Rozas de Puerto Real,493,291,202
28,Madrid,129,San Agustín del Guadalix,12953,6415,6538
28,Madrid,130,San Fernando de Henares,40781,20109,20672
28,Madrid,131,San Lorenzo de El Escorial,18241,8753,9488
28,Madrid,132,San Martín de la Vega,19092,9874,9218
28,Madrid,133,San Martín de Valdeiglesias,8516,4238,4278
28,Madrid,134,San Sebastián de los Reyes,83329,40790,42539
28,Madrid,135,Santa María de la Alameda,1212,647,565
28,Madrid,136,Santorcaz,833,428,405
28,Madrid,137,"Santos de la Humosa, Los",2445,1239,1206
28,Madrid,138,"Serna del Monte, La",94,50,44
28,Madrid,140,Serranillos del Valle,3957,1950,2007
28,Madrid,141,Sevilla la Nueva,8858,4403,4455
28,Madrid,143,Somosierra,77,42,35
28,Madrid,144,Soto del Real,8482,4138,4344
28,Madrid,145,Talamanca de Jarama,3267,1642,1625
28,Madrid,146,Tielmes,2617,1332,1285
28,Madrid,147,Titulcia,1261,656,605
28,Madrid,148,Torrejón de Ardoz,126878,63165,63713
28,Madrid,149,Torrejón de la Calzada,7739,3846,3893
28,Madrid,150,Torrejón de Velasco,4195,2112,2083
28,Madrid,151,Torrelaguna,4828,2496,2332
28,Madrid,152,Torrelodones,22838,11016,11822
28,Madrid,153,Torremocha de Jarama,926,445,481
28,Madrid,154,Torres de la Alameda,7939,4065,3874
28,Madrid,903,Tres Cantos,42546,20593,21953
28,Madrid,155,Valdaracete,646,320,326
28,Madrid,156,Valdeavero,1475,769,706
28,Madrid,157,Valdelaguna,855,436,419
28,Madrid,158,Valdemanco,972,522,450
28,Madrid,159,Valdemaqueda,804,392,412
28,Madrid,160,Valdemorillo,12058,6179,5879
28,Madrid,161,Valdemoro,72265,36052,36213
28,Madrid,162,Valdeolmos-Alalpardo,3689,1884,1805
28,Madrid,163,Valdepiélagos,563,293,270
28,Madrid,164,Valdetorres de Jarama,4225,2146,2079
28,Madrid,165,Valdilecha,2852,1481,1371
28,Madrid,166,Valverde de Alcalá,439,234,205
28,Madrid,167,Velilla de San Antonio,12334,6232,6102
28,Madrid,168,"Vellón, El",1814,938,876
28,Madrid,169,Venturada,1968,1024,944
28,Madrid,171,Villa del Prado,6506,3338,3168
28,Madrid,170,Villaconejos,3447,1743,1704
28,Madrid,172,Villalbilla,11916,6057,5859
28,Madrid,173,Villamanrique de Tajo,738,376,362
28,Madrid,174,Villamanta,2507,1262,1245
28,Madrid,175,Villamantilla,1241,607,634
28,Madrid,176,Villanueva de la Cañada,18827,9147,9680
28,Madrid,178,Villanueva de Perales,1445,748,697
28,Madrid,177,Villanueva del Pardillo,16730,8186,8544
28,Madrid,179,Villar del Olmo,2085,1078,1007
28,Madrid,180,Villarejo de Salvanés,7301,3683,3618
28,Madrid,181,Villaviciosa de Odón,26911,13117,13794
28,Madrid,182,Villavieja del Lozoya,275,150,125
28,Madrid,183,Zarzalejo,1583,838,745
29,Málaga,1,Alameda,5403,2714,2689
29,Málaga,2,Alcaucín,2454,1240,1214
29,Málaga,3,Alfarnate,1198,607,591
29,Málaga,4,Alfarnatejo,477,243,234
29,Málaga,5,Algarrobo,6103,3067,3036
29,Málaga,6,Algatocín,844,433,411
29,Málaga,7,Alhaurín de la Torre,38300,19070,19230
29,Málaga,8,Alhaurín el Grande,24210,12103,12107
29,Málaga,9,Almáchar,1890,970,920
29,Málaga,10,Almargen,2122,1082,1040
29,Málaga,11,Almogía,3906,2004,1902
29,Málaga,12,Álora,13046,6542,6504
29,Málaga,13,Alozaina,2119,1069,1050
29,Málaga,14,Alpandeire,269,139,130
29,Málaga,15,Antequera,41430,20370,21060
29,Málaga,16,Árchez,444,236,208
29,Málaga,17,Archidona,8577,4302,4275
29,Málaga,18,Ardales,2555,1293,1262
29,Málaga,19,Arenas,1282,673,609
29,Málaga,20,Arriate,4125,2034,2091
29,Málaga,21,Atajate,133,69,64
29,Málaga,22,Benadalid,253,124,129
29,Málaga,23,Benahavís,6660,3360,3300
29,Málaga,24,Benalauría,482,261,221
29,Málaga,25,Benalmádena,66939,33053,33886
29,Málaga,26,Benamargosa,1489,766,723
29,Málaga,27,Benamocarra,3029,1533,1496
29,Málaga,28,Benaoján,1523,797,726
29,Málaga,29,Benarrabá,520,259,261
29,Málaga,30,"Borge, El",963,495,468
29,Málaga,31,"Burgo, El",1922,966,956
29,Málaga,32,Campillos,8570,4285,4285
29,Málaga,33,Canillas de Aceituno,1746,914,832
29,Málaga,34,Canillas de Albaida,875,451,424
29,Málaga,35,Cañete la Real,1768,891,877
29,Málaga,36,Carratraca,793,403,390
29,Málaga,37,Cartajima,252,127,125
29,Málaga,38,Cártama,24328,12376,11952
29,Málaga,39,Casabermeja,3498,1857,1641
29,Málaga,40,Casarabonela,2592,1364,1228
29,Málaga,41,Casares,5744,2968,2776
29,Málaga,42,Coín,21553,10886,10667
29,Málaga,43,Colmenar,3486,1772,1714
29,Málaga,44,Comares,1435,769,666
29,Málaga,45,Cómpeta,3459,1742,1717
29,Málaga,46,Cortes de la Frontera,3357,1721,1636
29,Málaga,47,Cuevas Bajas,1431,702,729
29,Málaga,49,Cuevas de San Marcos,3951,1983,1968
29,Málaga,48,Cuevas del Becerro,1670,825,845
29,Málaga,50,Cútar,635,321,314
29,Málaga,51,Estepona,66566,33092,33474
29,Málaga,52,Faraján,253,123,130
29,Málaga,53,Frigiliana,3093,1547,1546
29,Málaga,54,Fuengirola,75856,37161,38695
29,Málaga,55,Fuente de Piedra,2612,1327,1285
29,Málaga,56,Gaucín,1671,881,790
29,Málaga,57,Genalguacil,437,220,217
29,Málaga,58,Guaro,2143,1076,1067
29,Málaga,59,Humilladero,3377,1702,1675
29,Málaga,60,Igualeja,811,411,400
29,Málaga,61,Istán,1404,712,692
29,Málaga,62,Iznate,906,475,431
29,Málaga,63,Jimera de Líbar,414,213,201
29,Málaga,64,Jubrique,643,320,323
29,Málaga,65,Júzcar,232,134,98
29,Málaga,66,Macharaviaya,465,253,212
29,Málaga,67,Málaga,566913,272674,294239
29,Málaga,68,Manilva,14451,7458,6993
29,Málaga,69,Marbella,138679,67264,71415
29,Málaga,70,Mijas,77521,38970,38551
29,Málaga,71,Moclinejo,1256,650,606
29,Málaga,72,Mollina,4943,2488,2455
29,Málaga,73,Monda,2375,1208,1167
29,Málaga,74,Montejaque,985,482,503
29,Málaga,75,Nerja,20649,10187,10462
29,Málaga,76,Ojén,3326,1704,1622
29,Málaga,77,Parauta,251,121,130
29,Málaga,79,Periana,3361,1755,1606
29,Málaga,80,Pizarra,9201,4666,4535
29,Málaga,81,Pujerra,294,157,137
29,Málaga,82,Rincón de la Victoria,42688,21034,21654
29,Málaga,83,Riogordo,2896,1521,1375
29,Málaga,84,Ronda,36208,17691,18517
29,Málaga,85,Salares,221,115,106
29,Málaga,86,Sayalonga,1512,767,745
29,Málaga,87,Sedella,667,373,294
29,Málaga,88,Sierra de Yeguas,3444,1748,1696
29,Málaga,89,Teba,4001,2015,1986
29,Málaga,90,Tolox,2233,1123,1110
29,Málaga,901,Torremolinos,67353,33757,33596
29,Málaga,91,Torrox,15511,7853,7658
29,Málaga,92,Totalán,723,379,344
29,Málaga,93,Valle de Abdalajís,2664,1346,1318
29,Málaga,94,Vélez-Málaga,77808,38643,39165
29,Málaga,95,Villanueva de Algaidas,4373,2237,2136
29,Málaga,902,Villanueva de la Concepción,3429,1680,1749
29,Málaga,98,Villanueva de Tapia,1564,795,769
29,Málaga,96,Villanueva del Rosario,3538,1727,1811
29,Málaga,97,Villanueva del Trabuco,5270,2629,2641
29,Málaga,99,Viñuela,1921,996,925
29,Málaga,100,Yunquera,3046,1548,1498
30,Murcia,1,Abanilla,6435,3252,3183
30,Murcia,2,Abarán,13086,6563,6523
30,Murcia,3,Águilas,34632,17336,17296
30,Murcia,4,Albudeite,1383,691,692
30,Murcia,5,Alcantarilla,40907,20198,20709
30,Murcia,902,"Alcázares, Los",15735,8070,7665
30,Murcia,6,Aledo,986,485,501
30,Murcia,7,Alguazas,9593,4992,4601
30,Murcia,8,Alhama de Murcia,21298,10817,10481
30,Murcia,9,Archena,18570,9658,8912
30,Murcia,10,Beniel,11112,5713,5399
30,Murcia,11,Blanca,6477,3296,3181
30,Murcia,12,Bullas,12061,6081,5980
30,Murcia,13,Calasparra,10527,5329,5198
30,Murcia,14,Campos del Río,2100,1005,1095
30,Murcia,15,Caravaca de la Cruz,26280,13174,13106
30,Murcia,16,Cartagena,216451,108511,107940
30,Murcia,17,Cehegín,15955,8054,7901
30,Murcia,18,Ceutí,11035,5563,5472
30,Murcia,19,Cieza,35064,17614,17450
30,Murcia,20,Fortuna,9714,5156,4558
30,Murcia,21,Fuente Álamo de Murcia,16338,8524,7814
30,Murcia,22,Jumilla,25476,13211,12265
30,Murcia,23,Librilla,4900,2504,2396
30,Murcia,24,Lorca,91759,47126,44633
30,Murcia,25,Lorquí,6948,3536,3412
30,Murcia,26,Mazarrón,32718,16962,15756
30,Murcia,27,Molina de Segura,68775,34372,34403
30,Murcia,28,Moratalla,8219,4176,4043
30,Murcia,29,Mula,17008,8754,8254
30,Murcia,30,Murcia,439712,215226,224486
30,Murcia,31,Ojós,518,285,233
30,Murcia,32,Pliego,3937,2029,1908
30,Murcia,33,Puerto Lumbreras,14610,7296,7314
30,Murcia,34,Ricote,1398,724,674
30,Murcia,35,San Javier,31988,16262,15726
30,Murcia,36,San Pedro del Pinatar,24091,12175,11916
30,Murcia,901,Santomera,15860,8055,7805
30,Murcia,37,Torre-Pacheco,34151,17789,16362
30,Murcia,38,"Torres de Cotillas, Las",21404,10895,10509
30,Murcia,39,Totana,30669,15790,14879
30,Murcia,40,Ulea,912,465,447
30,Murcia,41,"Unión, La",19452,9831,9621
30,Murcia,42,Villanueva del Río Segura,2444,1230,1214
30,Murcia,43,Yecla,34130,17114,17016
31,Navarra,1,Abáigar,98,53,45
31,Navarra,2,Abárzuza/Abartzuza,556,274,282
31,Navarra,3,Abaurregaina/Abaurrea Alta,132,83,49
31,Navarra,4,Abaurrepea/Abaurrea Baja,38,26,12
31,Navarra,5,Aberin,382,208,174
31,Navarra,6,Ablitas,2549,1302,1247
31,Navarra,7,Adiós,170,90,80
31,Navarra,8,Aguilar de Codés,94,51,43
31,Navarra,9,Aibar/Oibar,836,453,383
31,Navarra,11,Allín/Allin,840,450,390
31,Navarra,12,Allo,1019,511,508
31,Navarra,10,Altsasu/Alsasua,7612,3836,3776
31,Navarra,13,Améscoa Baja,764,413,351
31,Navarra,14,Ancín/Antzin,385,211,174
31,Navarra,15,Andosilla,2779,1425,1354
31,Navarra,16,Ansoáin/Antsoain,10861,5401,5460
31,Navarra,17,Anue,462,253,209
31,Navarra,18,Añorbe,557,303,254
31,Navarra,19,Aoiz/Agoitz,2629,1315,1314
31,Navarra,20,Araitz,533,305,228
31,Navarra,25,Arakil,941,487,454
31,Navarra,21,Aranarache/Aranaratxe,77,43,34
31,Navarra,23,Aranguren,8982,4517,4465
31,Navarra,24,Arano,111,61,50
31,Navarra,22,Arantza,629,337,292
31,Navarra,26,Aras,184,103,81
31,Navarra,27,Arbizu,1117,576,541
31,Navarra,28,Arce/Artzi,282,155,127
31,Navarra,29,"Arcos, Los",1167,582,585
31,Navarra,30,Arellano,184,104,80
31,Navarra,31,Areso,266,143,123
31,Navarra,32,Arguedas,2313,1186,1127
31,Navarra,33,Aria,55,33,22
31,Navarra,34,Aribe,44,25,19
31,Navarra,35,Armañanzas,61,34,27
31,Navarra,36,Arróniz,1078,569,509
31,Navarra,37,Arruazu,111,57,54
31,Navarra,38,Artajona,1697,876,821
31,Navarra,39,Artazu,118,60,58
31,Navarra,40,Atez/Atetz,218,124,94
31,Navarra,58,Auritz/Burguete,260,130,130
31,Navarra,41,Ayegui/Aiegi,2191,1149,1042
31,Navarra,42,Azagra,3801,1951,1850
31,Navarra,43,Azuelo,37,15,22
31,Navarra,44,Bakaiku,336,179,157
31,Navarra,901,Barañain,20458,9881,10577
31,Navarra,45,Barásoain,676,354,322
31,Navarra,46,Barbarin,63,29,34
31,Navarra,47,Bargota,295,143,152
31,Navarra,48,Barillas,201,108,93
31,Navarra,49,Basaburua,871,495,376
31,Navarra,50,Baztan,7848,3948,3900
31,Navarra,137,Beintza-Labaien,234,135,99
31,Navarra,51,Beire,303,160,143
31,Navarra,52,Belascoáin,124,66,58
31,Navarra,250,Bera,3760,1891,1869
31,Navarra,53,Berbinzana,673,343,330
31,Navarra,905,Beriáin,3874,1900,1974
31,Navarra,902,Berrioplano/Berriobeiti,6444,3271,3173
31,Navarra,903,Berriozar,9625,4871,4754
31,Navarra,54,Bertizarana,602,296,306
31,Navarra,55,Betelu,332,177,155
31,Navarra,253,Bidaurreta,160,89,71
31,Navarra,56,Biurrun-Olcoz,223,131,92
31,Navarra,57,Buñuel,2279,1122,1157
31,Navarra,59,Burgui/Burgi,229,130,99
31,Navarra,60,Burlada/Burlata,18237,8874,9363
31,Navarra,61,"Busto, El",70,38,32
31,Navarra,62,Cabanillas,1429,745,684
31,Navarra,63,Cabredo,102,56,46
31,Navarra,64,Cadreita,2046,1070,976
31,Navarra,65,Caparroso,2794,1453,1341
31,Navarra,66,Cárcar,1081,548,533
31,Navarra,67,Carcastillo,2504,1283,1221
31,Navarra,68,Cascante,3888,1926,1962
31,Navarra,69,Cáseda,1014,496,518
31,Navarra,70,Castejón,4120,2041,2079
31,Navarra,71,Castillonuevo,18,13,5
31,Navarra,193,Cendea de Olza/Oltza Zendea,1806,908,898
31,Navarra,72,Cintruénigo,7768,3962,3806
31,Navarra,74,Cirauqui/Zirauki,491,271,220
31,Navarra,75,Ciriza/Ziritza,123,58,65
31,Navarra,76,Cizur,3796,1944,1852
31,Navarra,77,Corella,7753,4014,3739
31,Navarra,78,Cortes,3199,1619,1580
31,Navarra,79,Desojo,83,44,39
31,Navarra,80,Dicastillo,639,340,299
31,Navarra,81,Donamaria,456,226,230
31,Navarra,221,Doneztebe/Santesteban,1644,847,797
31,Navarra,83,Echarri,78,39,39
31,Navarra,86,Egüés,19014,9616,9398
31,Navarra,87,Elgorriaga,226,109,117
31,Navarra,89,Enériz/Eneritz,334,171,163
31,Navarra,90,Eratsun,160,101,59
31,Navarra,91,Ergoiena,400,216,184
31,Navarra,92,Erro,809,463,346
31,Navarra,94,Eslava,127,66,61
31,Navarra,95,Esparza de Salazar/Espartza Zaraitzu,82,42,40
31,Navarra,96,Espronceda,119,67,52
31,Navarra,97,Estella-Lizarra,13695,6626,7069
31,Navarra,98,Esteribar,2509,1305,1204
31,Navarra,99,Etayo,79,38,41
31,Navarra,82,Etxalar,819,434,385
31,Navarra,84,Etxarri-Aranatz,2491,1291,1200
31,Navarra,85,Etxauri,586,307,279
31,Navarra,100,Eulate,315,171,144
31,Navarra,101,Ezcabarte,1816,964,852
31,Navarra,93,Ezcároz/Ezkaroze,329,177,152
31,Navarra,102,Ezkurra,152,103,49
31,Navarra,103,Ezprogui,46,24,22
31,Navarra,104,Falces,2443,1232,1211
31,Navarra,105,Fitero,2062,1029,1033
31,Navarra,106,Fontellas,958,492,466
31,Navarra,107,Funes,2488,1336,1152
31,Navarra,108,Fustiñana,2528,1267,1261
31,Navarra,109,Galar,2007,1069,938
31,Navarra,110,Gallipienzo/Galipentzu,115,62,53
31,Navarra,111,Gallués/Galoze,97,63,34
31,Navarra,112,Garaioa,95,52,43
31,Navarra,113,Garde,161,97,64
31,Navarra,114,Garínoain,495,275,220
31,Navarra,115,Garralda,186,94,92
31,Navarra,116,Genevilla,73,44,29
31,Navarra,117,Goizueta,747,413,334
31,Navarra,118,Goñi,170,107,63
31,Navarra,119,Güesa/Gorza,45,27,18
31,Navarra,120,Guesálaz/Gesalatz,456,269,187
31,Navarra,121,Guirguillano,86,45,41
31,Navarra,256,Hiriberri/Villanueva de Aezkoa,113,64,49
31,Navarra,122,Huarte/Uharte,6941,3497,3444
31,Navarra,124,Ibargoiti,248,145,103
31,Navarra,259,Igantzi,625,327,298
31,Navarra,125,Igúzquiza,333,169,164
31,Navarra,126,Imotz,434,231,203
31,Navarra,127,Irañeta,171,96,75
31,Navarra,904,Irurtzun,2223,1153,1070
31,Navarra,128,Isaba/Izaba,474,227,247
31,Navarra,129,Ituren,525,271,254
31,Navarra,130,Iturmendi,392,202,190
31,Navarra,131,Iza/Itza,1156,627,529
31,Navarra,132,Izagaondoa,180,117,63
31,Navarra,133,Izalzu/Itzaltzu,50,29,21
31,Navarra,134,Jaurrieta,208,117,91
31,Navarra,135,Javier,116,38,78
31,Navarra,136,Juslapeña,548,296,252
31,Navarra,138,Lakuntza,1262,653,609
31,Navarra,139,Lana,182,105,77
31,Navarra,140,Lantz,149,86,63
31,Navarra,141,Lapoblación,141,80,61
31,Navarra,142,Larraga,2093,1122,971
31,Navarra,143,Larraona,116,53,63
31,Navarra,144,Larraun,1002,547,455
31,Navarra,145,Lazagurría,204,102,102
31,Navarra,146,Leache/Leatxe,49,29,20
31,Navarra,147,Legarda,114,61,53
31,Navarra,148,Legaria,106,50,56
31,Navarra,149,Leitza,2906,1531,1375
31,Navarra,908,Lekunberri,1469,728,741
31,Navarra,150,Leoz/Leotz,253,166,87
31,Navarra,151,Lerga,65,40,25
31,Navarra,152,Lerín,1706,864,842
31,Navarra,153,Lesaka,2742,1423,1319
31,Navarra,154,Lezáun,263,159,104
31,Navarra,155,Liédena,318,163,155
31,Navarra,156,Lizoáin-Arriasgoiti,317,194,123
31,Navarra,157,Lodosa,4760,2387,2373
31,Navarra,158,Lónguida/Longida,318,169,149
31,Navarra,159,Lumbier,1346,730,616
31,Navarra,160,Luquin,138,73,65
31,Navarra,248,Luzaide/Valcarlos,380,208,172
31,Navarra,161,Mañeru,436,244,192
31,Navarra,162,Marañón,51,24,27
31,Navarra,163,Marcilla,2823,1406,1417
31,Navarra,164,Mélida,742,377,365
31,Navarra,165,Mendavia,3616,1845,1771
31,Navarra,166,Mendaza,318,163,155
31,Navarra,167,Mendigorría,1078,565,513
31,Navarra,168,Metauten,289,162,127
31,Navarra,169,Milagro,3366,1753,1613
31,Navarra,170,Mirafuentes,54,24,30
31,Navarra,171,Miranda de Arga,878,448,430
31,Navarra,172,Monreal/Elo,478,251,227
31,Navarra,173,Monteagudo,1105,563,542
31,Navarra,174,Morentin,135,69,66
31,Navarra,175,Mues,81,43,38
31,Navarra,176,Murchante,3761,1877,1884
31,Navarra,177,Murieta,346,183,163
31,Navarra,178,Murillo el Cuende,653,344,309
31,Navarra,179,Murillo el Fruto,640,329,311
31,Navarra,180,Muruzábal,271,119,152
31,Navarra,181,Navascués/Nabaskoze,158,95,63
31,Navarra,182,Nazar,45,26,19
31,Navarra,88,Noáin (Valle de Elorz)/Noain (Elortzibar),7837,3963,3874
31,Navarra,183,Obanos,919,451,468
31,Navarra,185,Ochagavía/Otsagabia,584,303,281
31,Navarra,184,Oco,66,34,32
31,Navarra,186,Odieta,364,205,159
31,Navarra,187,Oitz,140,81,59
31,Navarra,188,Olaibar,289,157,132
31,Navarra,189,Olazti/Olazagutía,1552,794,758
31,Navarra,190,Olejua,52,29,23
31,Navarra,191,Olite/Erriberri,3886,1948,1938
31,Navarra,194,Ollo,407,215,192
31,Navarra,192,Olóriz/Oloritz,191,111,80
31,Navarra,195,Orbaizeta,208,105,103
31,Navarra,196,Orbara,41,21,20
31,Navarra,197,Orísoain,94,51,43
31,Navarra,906,Orkoien,3743,1882,1861
31,Navarra,198,Oronz/Orontze,46,25,21
31,Navarra,199,Oroz-Betelu/Orotz-Betelu,156,88,68
31,Navarra,211,Orreaga/Roncesvalles,33,17,16
31,Navarra,200,Oteiza,944,500,444
31,Navarra,201,Pamplona/Iruña,196166,93415,102751
31,Navarra,202,Peralta/Azkoien,5889,2954,2935
31,Navarra,203,Petilla de Aragón,35,22,13
31,Navarra,204,Piedramillera,43,29,14
31,Navarra,205,Pitillas,523,255,268
31,Navarra,206,Puente la Reina/Gares,2812,1440,1372
31,Navarra,207,Pueyo,347,187,160
31,Navarra,208,Ribaforada,3687,1880,1807
31,Navarra,209,Romanzado,166,86,80
31,Navarra,210,Roncal/Erronkari,246,135,111
31,Navarra,212,Sada,172,91,81
31,Navarra,213,Saldías,118,71,47
31,Navarra,214,Salinas de Oro/Jaitz,118,66,52
31,Navarra,215,San Adrián,6216,3081,3135
31,Navarra,217,San Martín de Unx,414,219,195
31,Navarra,216,Sangüesa/Zangoza,5078,2588,2490
31,Navarra,219,Sansol,104,55,49
31,Navarra,220,Santacara,895,469,426
31,Navarra,222,Sarriés/Sartze,62,39,23
31,Navarra,223,Sartaguda,1317,689,628
31,Navarra,224,Sesma,1201,610,591
31,Navarra,225,Sorlada,71,42,29
31,Navarra,226,Sunbilla,650,341,309
31,Navarra,227,Tafalla,10966,5441,5525
31,Navarra,228,Tiebas-Muruarte de Reta,633,324,309
31,Navarra,229,Tirapu,57,32,25
31,Navarra,230,Torralba del Río,120,67,53
31,Navarra,231,Torres del Río,135,65,70
31,Navarra,232,Tudela,35062,17341,17721
31,Navarra,233,Tulebras,125,53,72
31,Navarra,234,Ucar,191,110,81
31,Navarra,123,Uharte-Arakil,839,444,395
31,Navarra,235,Ujué,198,112,86
31,Navarra,236,Ultzama,1668,863,805
31,Navarra,237,Unciti,229,141,88
31,Navarra,238,Unzué/Untzue,127,71,56
31,Navarra,239,Urdazubi/Urdax,392,190,202
31,Navarra,240,Urdiain,677,352,325
31,Navarra,241,Urraul Alto,151,89,62
31,Navarra,242,Urraul Bajo,290,128,162
31,Navarra,244,Urrotz,179,99,80
31,Navarra,243,Urroz-Villa,398,208,190
31,Navarra,245,Urzainqui/Urzainki,100,54,46
31,Navarra,246,Uterga,172,99,73
31,Navarra,247,Uztárroz/Uztarroze,158,78,80
31,Navarra,260,Valle de Yerri/Deierri,1517,778,739
31,Navarra,249,Valtierra,2467,1209,1258
31,Navarra,251,Viana,4084,2110,1974
31,Navarra,252,Vidángoz/Bidankoze,96,51,45
31,Navarra,254,Villafranca,2860,1437,1423
31,Navarra,255,Villamayor de Monjardín,130,69,61
31,Navarra,257,Villatuerta,1128,565,563
31,Navarra,258,Villava/Atarrabia,10211,5007,5204
31,Navarra,261,Yesa,223,119,104
31,Navarra,262,Zabalza/Zabaltza,295,152,143
31,Navarra,73,Ziordia,380,186,194
31,Navarra,907,Zizur Mayor/Zizur Nagusia,14253,7029,7224
31,Navarra,263,Zubieta,319,171,148
31,Navarra,264,Zugarramurdi,225,113,112
31,Navarra,265,Zúñiga,104,68,36
32,Ourense,1,Allariz,6060,3018,3042
32,Ourense,2,Amoeiro,2274,1110,1164
32,Ourense,3,"Arnoia, A",1040,508,532
32,Ourense,4,Avión,2053,941,1112
32,Ourense,5,Baltar,1019,539,480
32,Ourense,6,Bande,1829,875,954
32,Ourense,7,Baños de Molgas,1675,833,842
32,Ourense,8,Barbadás,10371,5044,5327
32,Ourense,9,"Barco de Valdeorras, O",13899,6786,7113
32,Ourense,10,Beade,464,244,220
32,Ourense,11,Beariz,1112,500,612
32,Ourense,12,"Blancos, Os",885,478,407
32,Ourense,13,Boborás,2617,1219,1398
32,Ourense,14,"Bola, A",1350,648,702
32,Ourense,15,"Bolo, O",1013,515,498
32,Ourense,16,Calvos de Randín,985,494,491
32,Ourense,18,Carballeda de Avia,1390,677,713
32,Ourense,17,Carballeda de Valdeorras,1697,862,835
32,Ourense,19,"Carballiño, O",14123,6646,7477
32,Ourense,20,Cartelle,2944,1438,1506
32,Ourense,22,Castrelo de Miño,1620,801,819
32,Ourense,21,Castrelo do Val,1109,575,534
32,Ourense,23,Castro Caldelas,1376,692,684
32,Ourense,24,Celanova,5615,2663,2952
32,Ourense,25,Cenlle,1235,582,653
32,Ourense,29,Chandrexa de Queixa,545,306,239
32,Ourense,26,Coles,3150,1586,1564
32,Ourense,27,Cortegada,1191,596,595
32,Ourense,28,Cualedro,1808,909,899
32,Ourense,30,Entrimo,1323,630,693
32,Ourense,31,Esgos,1216,617,599
32,Ourense,33,Gomesende,833,398,435
32,Ourense,34,"Gudiña, A",1461,775,686
32,Ourense,35,"Irixo, O",1637,774,863
32,Ourense,38,Larouco,544,252,292
32,Ourense,39,Laza,1449,754,695
32,Ourense,40,Leiro,1675,836,839
32,Ourense,41,Lobeira,837,407,430
32,Ourense,42,Lobios,2025,1021,1004
32,Ourense,43,Maceda,2978,1447,1531
32,Ourense,44,Manzaneda,973,482,491
32,Ourense,45,Maside,2906,1408,1498
32,Ourense,46,Melón,1340,633,707
32,Ourense,47,"Merca, A",2078,1011,1067
32,Ourense,48,"Mezquita, A",1155,594,561
32,Ourense,49,Montederramo,822,418,404
32,Ourense,50,Monterrei,2809,1419,1390
32,Ourense,51,Muíños,1622,820,802
32,Ourense,52,Nogueira de Ramuín,2198,1102,1096
32,Ourense,53,Oímbra,2020,1109,911
32,Ourense,54,Ourense,106905,48972,57933
32,Ourense,55,Paderne de Allariz,1515,733,782
32,Ourense,56,Padrenda,1951,926,1025
32,Ourense,57,Parada de Sil,634,332,302
32,Ourense,58,"Pereiro de Aguiar, O",6350,3244,3106
32,Ourense,59,"Peroxa, A",1999,987,1012
32,Ourense,60,Petín,961,465,496
32,Ourense,61,Piñor,1237,623,614
32,Ourense,63,"Pobra de Trives, A",2280,1137,1143
32,Ourense,64,Pontedeva,625,300,325
32,Ourense,62,Porqueira,931,450,481
32,Ourense,65,Punxín,749,358,391
32,Ourense,66,Quintela de Leirado,651,278,373
32,Ourense,67,Rairiz de Veiga,1456,741,715
32,Ourense,68,Ramirás,1643,753,890
32,Ourense,69,Ribadavia,5187,2512,2675
32,Ourense,71,Riós,1684,849,835
32,Ourense,72,"Rúa, A",4634,2300,2334
32,Ourense,73,Rubiá,1494,747,747
32,Ourense,74,San Amaro,1180,572,608
32,Ourense,75,San Cibrao das Viñas,4972,2539,2433
32,Ourense,76,San Cristovo de Cea,2418,1204,1214
32,Ourense,70,San Xoán de Río,632,309,323
32,Ourense,77,Sandiás,1297,587,710
32,Ourense,78,Sarreaus,1313,666,647
32,Ourense,79,Taboadela,1561,800,761
32,Ourense,80,"Teixeira, A",391,199,192
32,Ourense,81,Toén,2511,1314,1197
32,Ourense,82,Trasmiras,1456,719,737
32,Ourense,83,"Veiga, A",965,492,473
32,Ourense,84,Verea,1059,499,560
32,Ourense,85,Verín,14652,7163,7489
32,Ourense,86,Viana do Bolo,3113,1555,1558
32,Ourense,87,Vilamarín,2056,1041,1015
32,Ourense,88,Vilamartín de Valdeorras,1793,905,888
32,Ourense,89,Vilar de Barrio,1500,768,732
32,Ourense,90,Vilar de Santos,922,454,468
32,Ourense,91,Vilardevós,2024,1045,979
32,Ourense,92,Vilariño de Conso,633,358,275
32,Ourense,32,Xinzo de Limia,10200,4997,5203
32,Ourense,36,Xunqueira de Ambía,1546,777,769
32,Ourense,37,Xunqueira de Espadanedo,863,428,435
34,Palencia,1,Abarca de Campos,42,24,18
34,Palencia,3,Abia de las Torres,184,99,85
34,Palencia,4,Aguilar de Campoo,7088,3444,3644
34,Palencia,5,Alar del Rey,989,485,504
34,Palencia,6,Alba de Cerrato,87,47,40
34,Palencia,9,Amayuelas de Arriba,39,24,15
34,Palencia,10,Ampudia,638,338,300
34,Palencia,11,Amusco,447,248,199
34,Palencia,12,Antigüedad,378,199,179
34,Palencia,15,Arconada,46,28,18
34,Palencia,17,Astudillo,1031,521,510
34,Palencia,18,Autilla del Pino,241,134,107
34,Palencia,19,Autillo de Campos,153,78,75
34,Palencia,20,Ayuela,55,32,23
34,Palencia,22,Baltanás,1286,673,613
34,Palencia,24,Baquerín de Campos,39,27,12
34,Palencia,25,Bárcena de Campos,56,27,29
34,Palencia,27,Barruelo de Santullán,1329,648,681
34,Palencia,28,Báscones de Ojeda,159,86,73
34,Palencia,29,Becerril de Campos,847,439,408
34,Palencia,31,Belmonte de Campos,29,15,14
34,Palencia,32,Berzosilla,40,20,20
34,Palencia,33,Boada de Campos,18,12,6
34,Palencia,35,Boadilla de Rioseco,123,73,50
34,Palencia,34,Boadilla del Camino,103,57,46
34,Palencia,36,Brañosera,220,125,95
34,Palencia,37,Buenavista de Valdavia,354,192,162
34,Palencia,38,Bustillo de la Vega,316,169,147
34,Palencia,39,Bustillo del Páramo de Carrión,64,39,25
34,Palencia,41,Calahorra de Boedo,98,52,46
34,Palencia,42,Calzada de los Molinos,339,182,157
34,Palencia,45,Capillas,84,42,42
34,Palencia,46,Cardeñosa de Volpejera,49,27,22
34,Palencia,47,Carrión de los Condes,2198,1054,1144
34,Palencia,48,Castil de Vela,60,30,30
34,Palencia,49,Castrejón de la Peña,415,226,189
34,Palencia,50,Castrillo de Don Juan,237,126,111
34,Palencia,51,Castrillo de Onielo,118,63,55
34,Palencia,52,Castrillo de Villavega,198,104,94
34,Palencia,53,Castromocho,244,127,117
34,Palencia,55,Cervatos de la Cueza,300,175,125
34,Palencia,56,Cervera de Pisuerga,2461,1228,1233
34,Palencia,57,Cevico de la Torre,510,255,255
34,Palencia,58,Cevico Navero,196,104,92
34,Palencia,59,Cisneros,481,242,239
34,Palencia,60,Cobos de Cerrato,153,84,69
34,Palencia,61,Collazos de Boedo,121,65,56
34,Palencia,62,Congosto de Valdavia,186,110,76
34,Palencia,63,Cordovilla la Real,98,55,43
34,Palencia,66,Cubillas de Cerrato,65,35,30
34,Palencia,67,Dehesa de Montejo,136,77,59
34,Palencia,68,Dehesa de Romanos,36,23,13
34,Palencia,69,Dueñas,2755,1423,1332
34,Palencia,70,Espinosa de Cerrato,181,91,90
34,Palencia,71,Espinosa de Villagonzalo,212,111,101
34,Palencia,72,Frechilla,187,91,96
34,Palencia,73,Fresno del Río,189,95,94
34,Palencia,74,Frómista,831,419,412
34,Palencia,76,Fuentes de Nava,695,350,345
34,Palencia,77,Fuentes de Valdepero,394,206,188
34,Palencia,79,Grijota,2059,1070,989
34,Palencia,80,Guardo,6724,3356,3368
34,Palencia,81,Guaza de Campos,61,33,28
34,Palencia,82,Hérmedes de Cerrato,87,47,40
34,Palencia,83,Herrera de Pisuerga,2180,1060,1120
34,Palencia,84,Herrera de Valdecañas,145,79,66
34,Palencia,86,Hontoria de Cerrato,109,58,51
34,Palencia,87,Hornillos de Cerrato,119,60,59
34,Palencia,88,Husillos,292,164,128
34,Palencia,89,Itero de la Vega,187,100,87
34,Palencia,91,Lagartos,138,75,63
34,Palencia,92,Lantadilla,339,179,160
34,Palencia,94,Ledigos,68,39,29
34,Palencia,903,Loma de Ucieza,236,137,99
34,Palencia,96,Lomas,53,32,21
34,Palencia,98,Magaz de Pisuerga,1043,561,482
34,Palencia,99,Manquillos,72,37,35
34,Palencia,100,Mantinos,153,87,66
34,Palencia,101,Marcilla de Campos,39,17,22
34,Palencia,102,Mazariegos,233,138,95
34,Palencia,103,Mazuecos de Valdeginate,102,54,48
34,Palencia,104,Melgar de Yuso,266,153,113
34,Palencia,106,Meneses de Campos,122,61,61
34,Palencia,107,Micieces de Ojeda,85,48,37
34,Palencia,108,Monzón de Campos,630,323,307
34,Palencia,109,Moratinos,64,37,27
34,Palencia,110,Mudá,95,49,46
34,Palencia,112,Nogal de las Huertas,47,28,19
34,Palencia,113,Olea de Boedo,37,14,23
34,Palencia,114,Olmos de Ojeda,214,132,82
34,Palencia,116,Osornillo,66,34,32
34,Palencia,901,Osorno la Mayor,1350,713,637
34,Palencia,120,Palencia,80178,37812,42366
34,Palencia,121,Palenzuela,213,116,97
34,Palencia,122,Páramo de Boedo,76,41,35
34,Palencia,123,Paredes de Nava,1997,1012,985
34,Palencia,124,Payo de Ojeda,65,39,26
34,Palencia,125,Pedraza de Campos,95,52,43
34,Palencia,126,Pedrosa de la Vega,350,198,152
34,Palencia,127,Perales,118,62,56
34,Palencia,904,"Pernía, La",361,210,151
34,Palencia,129,Pino del Río,200,120,80
34,Palencia,130,Piña de Campos,239,124,115
34,Palencia,131,Población de Arroyo,64,34,30
34,Palencia,132,Población de Campos,135,76,59
34,Palencia,133,Población de Cerrato,116,64,52
34,Palencia,134,Polentinos,58,32,26
34,Palencia,135,Pomar de Valdivia,479,269,210
34,Palencia,136,Poza de la Vega,229,130,99
34,Palencia,137,Pozo de Urama,30,19,11
34,Palencia,139,Prádanos de Ojeda,203,112,91
34,Palencia,140,"Puebla de Valdavia, La",106,56,50
34,Palencia,141,Quintana del Puente,274,158,116
34,Palencia,143,Quintanilla de Onsoña,200,115,85
34,Palencia,146,Reinoso de Cerrato,53,33,20
34,Palencia,147,Renedo de la Vega,207,113,94
34,Palencia,149,Requena de Campos,18,8,10
34,Palencia,151,Respenda de la Peña,192,111,81
34,Palencia,152,Revenga de Campos,167,86,81
34,Palencia,154,Revilla de Collazos,84,46,38
34,Palencia,155,Ribas de Campos,166,85,81
34,Palencia,156,Riberos de la Cueza,60,39,21
34,Palencia,157,Saldaña,3149,1578,1571
34,Palencia,158,Salinas de Pisuerga,356,178,178
34,Palencia,159,San Cebrián de Campos,459,257,202
34,Palencia,160,San Cebrián de Mudá,161,87,74
34,Palencia,161,San Cristóbal de Boedo,23,13,10
34,Palencia,163,San Mamés de Campos,58,28,30
34,Palencia,165,San Román de la Cuba,80,42,38
34,Palencia,167,Santa Cecilia del Alcor,127,75,52
34,Palencia,168,Santa Cruz de Boedo,60,35,25
34,Palencia,169,Santervás de la Vega,487,267,220
34,Palencia,170,Santibáñez de Ecla,65,32,33
34,Palencia,171,Santibáñez de la Peña,1121,550,571
34,Palencia,174,Santoyo,230,126,104
34,Palencia,175,"Serna, La",105,65,40
34,Palencia,177,Soto de Cerrato,195,113,82
34,Palencia,176,Sotobañado y Priorato,166,96,70
34,Palencia,178,Tabanera de Cerrato,122,71,51
34,Palencia,179,Tabanera de Valdavia,33,16,17
34,Palencia,180,Támara de Campos,74,41,33
34,Palencia,181,Tariego de Cerrato,528,277,251
34,Palencia,182,Torquemada,1028,559,469
34,Palencia,184,Torremormojón,56,32,24
34,Palencia,185,Triollo,73,41,32
34,Palencia,186,Valbuena de Pisuerga,53,29,24
34,Palencia,189,Valdeolmillos,69,36,33
34,Palencia,190,Valderrábano,53,27,26
34,Palencia,192,Valde-Ucieza,100,59,41
34,Palencia,196,Valle de Cerrato,85,51,34
34,Palencia,902,Valle del Retortillo,190,110,80
34,Palencia,199,Velilla del Río Carrión,1437,740,697
34,Palencia,23,Venta de Baños,6450,3236,3214
34,Palencia,201,Vertavillo,201,107,94
34,Palencia,93,"Vid de Ojeda, La",109,65,44
34,Palencia,202,Villabasta de Valdavia,32,17,15
34,Palencia,204,Villacidaler,48,28,20
34,Palencia,205,Villaconancio,62,38,24
34,Palencia,206,Villada,1042,524,518
34,Palencia,208,Villaeles de Valdavia,64,36,28
34,Palencia,210,Villahán,104,55,49
34,Palencia,211,Villaherreros,212,102,110
34,Palencia,213,Villalaco,63,32,31
34,Palencia,214,Villalba de Guardo,199,107,92
34,Palencia,215,Villalcázar de Sirga,159,79,80
34,Palencia,216,Villalcón,72,37,35
34,Palencia,217,Villalobón,1542,781,761
34,Palencia,218,Villaluenga de la Vega,578,333,245
34,Palencia,220,Villamartín de Campos,187,105,82
34,Palencia,221,Villamediana,185,102,83
34,Palencia,222,Villameriel,130,75,55
34,Palencia,223,Villamoronta,267,152,115
34,Palencia,224,Villamuera de la Cueza,46,28,18
34,Palencia,225,Villamuriel de Cerrato,6450,3315,3135
34,Palencia,227,Villanueva del Rebollar,79,40,39
34,Palencia,228,Villanuño de Valdavia,98,51,47
34,Palencia,229,Villaprovedo,69,46,23
34,Palencia,230,Villarmentero de Campos,18,11,7
34,Palencia,231,Villarrabé,226,118,108
34,Palencia,232,Villarramiel,887,476,411
34,Palencia,233,Villasarracino,144,81,63
34,Palencia,234,Villasila de Valdavia,74,51,23
34,Palencia,236,Villaturde,182,95,87
34,Palencia,237,Villaumbrales,707,363,344
34,Palencia,238,Villaviudas,380,181,199
34,Palencia,240,Villerías de Campos,94,54,40
34,Palencia,241,Villodre,18,13,5
34,Palencia,242,Villodrigo,124,67,57
34,Palencia,243,Villoldo,376,205,171
34,Palencia,245,Villota del Páramo,338,195,143
34,Palencia,246,Villovieco,74,43,31
35,"Palmas, Las",1,Agaete,5656,2832,2824
35,"Palmas, Las",2,Agüimes,30244,15300,14944
35,"Palmas, Las",20,"Aldea de San Nicolás, La",8225,4160,4065
35,"Palmas, Las",3,Antigua,11643,6238,5405
35,"Palmas, Las",4,Arrecife,56880,28611,28269
35,"Palmas, Las",5,Artenara,1180,647,533
35,"Palmas, Las",6,Arucas,37056,18489,18567
35,"Palmas, Las",7,Betancuria,733,375,358
35,"Palmas, Las",8,Firgas,7618,3860,3758
35,"Palmas, Las",9,Gáldar,24209,12136,12073
35,"Palmas, Las",10,Haría,4736,2443,2293
35,"Palmas, Las",11,Ingenio,30173,15312,14861
35,"Palmas, Las",12,Mogán,23491,12181,11310
35,"Palmas, Las",13,Moya,7869,3999,3870
35,"Palmas, Las",14,"Oliva, La",24307,12873,11434
35,"Palmas, Las",15,Pájara,19679,10342,9337
35,"Palmas, Las",16,"Palmas de Gran Canaria, Las",382283,185692,196591
35,"Palmas, Las",17,Puerto del Rosario,36790,18784,18006
35,"Palmas, Las",18,San Bartolomé,18689,9443,9246
35,"Palmas, Las",19,San Bartolomé de Tirajana,54377,28437,25940
35,"Palmas, Las",21,Santa Brígida,18775,9307,9468
35,"Palmas, Las",22,Santa Lucía de Tirajana,68544,34397,34147
35,"Palmas, Las",23,Santa María de Guía de Gran Canaria,13968,6963,7005
35,"Palmas, Las",24,Teguise,21101,10675,10426
35,"Palmas, Las",25,Tejeda,1990,1048,942
35,"Palmas, Las",26,Telde,102076,50527,51549
35,"Palmas, Las",27,Teror,12606,6482,6124
35,"Palmas, Las",28,Tías,19658,10058,9600
35,"Palmas, Las",29,Tinajo,5808,2992,2816
35,"Palmas, Las",30,Tuineje,13778,7080,6698
35,"Palmas, Las",32,Valleseco,3886,2040,1846
35,"Palmas, Las",31,Valsequillo de Gran Canaria,9233,4652,4581
35,"Palmas, Las",33,Vega de San Mateo,7698,3920,3778
35,"Palmas, Las",34,Yaiza,15068,7871,7197
36,Pontevedra,20,Agolada,2651,1312,1339
36,Pontevedra,1,Arbo,2904,1471,1433
36,Pontevedra,3,Baiona,12233,6076,6157
36,Pontevedra,2,Barro,3705,1832,1873
36,Pontevedra,4,Bueu,12352,6072,6280
36,Pontevedra,5,Caldas de Reis,9895,4774,5121
36,Pontevedra,6,Cambados,13399,6506,6893
36,Pontevedra,7,Campo Lameiro,1962,945,1017
36,Pontevedra,8,Cangas,26567,13099,13468
36,Pontevedra,9,"Cañiza, A",5342,2597,2745
36,Pontevedra,10,Catoira,3402,1675,1727
36,Pontevedra,11,Cerdedo,1860,856,1004
36,Pontevedra,12,Cotobade,4327,2079,2248
36,Pontevedra,13,Covelo,2719,1347,1372
36,Pontevedra,14,Crecente,2261,1088,1173
36,Pontevedra,15,Cuntis,4931,2335,2596
36,Pontevedra,16,Dozón,1209,621,588
36,Pontevedra,17,"Estrada, A",21197,10171,11026
36,Pontevedra,18,Forcarei,3696,1735,1961
36,Pontevedra,19,Fornelos de Montes,1784,835,949
36,Pontevedra,21,Gondomar,14051,6942,7109
36,Pontevedra,22,"Grove, O",10851,5343,5508
36,Pontevedra,23,"Guarda, A",10314,5035,5279
36,Pontevedra,901,"Illa de Arousa, A",5006,2478,2528
36,Pontevedra,24,Lalín,20158,9783,10375
36,Pontevedra,25,"Lama, A",2763,1338,1425
36,Pontevedra,26,Marín,25329,12733,12596
36,Pontevedra,27,Meaño,5428,2639,2789
36,Pontevedra,28,Meis,5033,2382,2651
36,Pontevedra,29,Moaña,19365,9448,9917
36,Pontevedra,30,Mondariz,4742,2307,2435
36,Pontevedra,31,Mondariz-Balneario,682,346,336
36,Pontevedra,32,Moraña,4362,2105,2257
36,Pontevedra,33,Mos,15324,7529,7795
36,Pontevedra,34,"Neves, As",4121,2001,2120
36,Pontevedra,35,Nigrán,17715,8684,9031
36,Pontevedra,36,Oia,3042,1518,1524
36,Pontevedra,37,Pazos de Borbén,3075,1483,1592
36,Pontevedra,41,Poio,16794,8325,8469
36,Pontevedra,43,Ponte Caldelas,5625,2728,2897
36,Pontevedra,42,Ponteareas,23115,11283,11832
36,Pontevedra,44,Pontecesures,3092,1566,1526
36,Pontevedra,38,Pontevedra,82946,39345,43601
36,Pontevedra,39,"Porriño, O",18508,9096,9412
36,Pontevedra,40,Portas,3025,1451,1574
36,Pontevedra,45,Redondela,29909,14656,15253
36,Pontevedra,46,Ribadumia,5103,2458,2645
36,Pontevedra,47,Rodeiro,2752,1399,1353
36,Pontevedra,48,"Rosal, O",6455,3180,3275
36,Pontevedra,49,Salceda de Caselas,8890,4467,4423
36,Pontevedra,50,Salvaterra de Miño,9626,4822,4804
36,Pontevedra,51,Sanxenxo,17543,8693,8850
36,Pontevedra,52,Silleda,8966,4379,4587
36,Pontevedra,53,Soutomaior,7356,3679,3677
36,Pontevedra,54,Tomiño,13707,6877,6830
36,Pontevedra,55,Tui,16884,8081,8803
36,Pontevedra,56,Valga,6050,2943,3107
36,Pontevedra,57,Vigo,294997,140326,154671
36,Pontevedra,59,Vila de Cruces,5676,2773,2903
36,Pontevedra,58,Vilaboa,5972,2887,3085
36,Pontevedra,60,Vilagarcía de Arousa,37712,18099,19613
36,Pontevedra,61,Vilanova de Arousa,10459,5134,5325
26,"Rioja, La",1,Ábalos,294,180,114
26,"Rioja, La",2,Agoncillo,1173,662,511
26,"Rioja, La",3,Aguilar del Río Alhama,511,246,265
26,"Rioja, La",4,Ajamil de Cameros,72,48,24
26,"Rioja, La",5,Albelda de Iregua,3269,1686,1583
26,"Rioja, La",6,Alberite,2562,1293,1269
26,"Rioja, La",7,Alcanadre,701,369,332
26,"Rioja, La",8,Aldeanueva de Ebro,2803,1451,1352
26,"Rioja, La",9,Alesanco,528,275,253
26,"Rioja, La",10,Alesón,117,69,48
26,"Rioja, La",11,Alfaro,9688,4887,4801
26,"Rioja, La",12,Almarza de Cameros,22,15,7
26,"Rioja, La",13,Anguciana,462,253,209
26,"Rioja, La",14,Anguiano,545,307,238
26,"Rioja, La",15,Arenzana de Abajo,243,129,114
26,"Rioja, La",16,Arenzana de Arriba,32,20,12
26,"Rioja, La",17,Arnedillo,482,237,245
26,"Rioja, La",18,Arnedo,14551,7201,7350
26,"Rioja, La",19,Arrúbal,474,247,227
26,"Rioja, La",20,Ausejo,899,493,406
26,"Rioja, La",21,Autol,4367,2194,2173
26,"Rioja, La",22,Azofra,213,113,100
26,"Rioja, La",23,Badarán,555,282,273
26,"Rioja, La",24,Bañares,289,145,144
26,"Rioja, La",26,Baños de Río Tobía,1642,812,830
26,"Rioja, La",25,Baños de Rioja,100,56,44
26,"Rioja, La",27,Berceo,178,113,65
26,"Rioja, La",28,Bergasa,157,86,71
26,"Rioja, La",29,Bergasillas Bajera,39,20,19
26,"Rioja, La",30,Bezares,18,9,9
26,"Rioja, La",31,Bobadilla,124,68,56
26,"Rioja, La",32,Brieva de Cameros,56,37,19
26,"Rioja, La",33,Briñas,217,104,113
26,"Rioja, La",34,Briones,841,455,386
26,"Rioja, La",35,Cabezón de Cameros,18,14,4
26,"Rioja, La",36,Calahorra,24202,11902,12300
26,"Rioja, La",37,Camprovín,155,89,66
26,"Rioja, La",38,Canales de la Sierra,73,48,25
26,"Rioja, La",39,Canillas de Río Tuerto,40,20,20
26,"Rioja, La",40,Cañas,88,44,44
26,"Rioja, La",41,Cárdenas,173,90,83
26,"Rioja, La",42,Casalarreina,1187,613,574
26,"Rioja, La",43,Castañares de Rioja,464,227,237
26,"Rioja, La",44,Castroviejo,58,32,26
26,"Rioja, La",45,Cellorigo,12,5,7
26,"Rioja, La",46,Cenicero,2054,1029,1025
26,"Rioja, La",47,Cervera del Río Alhama,2510,1289,1221
26,"Rioja, La",48,Cidamón,29,15,14
26,"Rioja, La",49,Cihuri,230,118,112
26,"Rioja, La",50,Cirueña,134,84,50
26,"Rioja, La",51,Clavijo,282,160,122
26,"Rioja, La",52,Cordovín,174,87,87
26,"Rioja, La",53,Corera,276,149,127
26,"Rioja, La",54,Cornago,366,206,160
26,"Rioja, La",55,Corporales,43,24,19
26,"Rioja, La",56,Cuzcurrita de Río Tirón,496,266,230
26,"Rioja, La",57,Daroca de Rioja,53,35,18
26,"Rioja, La",58,Enciso,164,100,64
26,"Rioja, La",59,Entrena,1541,793,748
26,"Rioja, La",60,Estollo,94,62,32
26,"Rioja, La",61,Ezcaray,2046,1066,980
26,"Rioja, La",62,Foncea,99,53,46
26,"Rioja, La",63,Fonzaleche,161,106,55
26,"Rioja, La",64,Fuenmayor,3156,1586,1570
26,"Rioja, La",65,Galbárruli,48,31,17
26,"Rioja, La",66,Galilea,365,186,179
26,"Rioja, La",67,Gallinero de Cameros,25,17,8
26,"Rioja, La",68,Gimileo,118,64,54
26,"Rioja, La",69,Grañón,285,158,127
26,"Rioja, La",70,Grávalos,211,108,103
26,"Rioja, La",71,Haro,11536,5716,5820
26,"Rioja, La",72,Herce,340,178,162
26,"Rioja, La",73,Herramélluri,110,57,53
26,"Rioja, La",74,Hervías,129,62,67
26,"Rioja, La",75,Hormilla,460,249,211
26,"Rioja, La",76,Hormilleja,155,77,78
26,"Rioja, La",77,Hornillos de Cameros,18,8,10
26,"Rioja, La",78,Hornos de Moncalvillo,86,50,36
26,"Rioja, La",79,Huércanos,857,461,396
26,"Rioja, La",80,Igea,644,361,283
26,"Rioja, La",81,Jalón de Cameros,18,10,8
26,"Rioja, La",82,Laguna de Cameros,120,72,48
26,"Rioja, La",83,Lagunilla del Jubera,309,169,140
26,"Rioja, La",84,Lardero,9306,4739,4567
26,"Rioja, La",86,Ledesma de la Cogolla,19,14,5
26,"Rioja, La",87,Leiva,274,142,132
26,"Rioja, La",88,Leza de Río Leza,41,24,17
26,"Rioja, La",89,Logroño,151962,72621,79341
26,"Rioja, La",91,Lumbreras,163,106,57
26,"Rioja, La",92,Manjarrés,115,65,50
26,"Rioja, La",93,Mansilla de la Sierra,61,43,18
26,"Rioja, La",94,Manzanares de Rioja,85,51,34
26,"Rioja, La",95,Matute,124,62,62
26,"Rioja, La",96,Medrano,314,165,149
26,"Rioja, La",98,Munilla,108,56,52
26,"Rioja, La",99,Murillo de Río Leza,1709,883,826
26,"Rioja, La",100,Muro de Aguas,56,35,21
26,"Rioja, La",101,Muro en Cameros,45,28,17
26,"Rioja, La",102,Nájera,8268,4107,4161
26,"Rioja, La",103,Nalda,959,516,443
26,"Rioja, La",104,Navajún,16,12,4
26,"Rioja, La",105,Navarrete,2955,1494,1461
26,"Rioja, La",106,Nestares,78,47,31
26,"Rioja, La",107,Nieva de Cameros,89,56,33
26,"Rioja, La",109,Ochánduri,95,59,36
26,"Rioja, La",108,Ocón,293,181,112
26,"Rioja, La",110,Ojacastro,190,110,80
26,"Rioja, La",111,Ollauri,293,155,138
26,"Rioja, La",112,Ortigosa de Cameros,264,151,113
26,"Rioja, La",113,Pazuengos,33,23,10
26,"Rioja, La",114,Pedroso,77,52,25
26,"Rioja, La",115,Pinillos,16,9,7
26,"Rioja, La",117,Pradejón,4051,2101,1950
26,"Rioja, La",118,Pradillo,59,31,28
26,"Rioja, La",119,Préjano,259,146,113
26,"Rioja, La",120,Quel,2027,1053,974
26,"Rioja, La",121,Rabanera,35,28,7
26,"Rioja, La",122,"Rasillo de Cameros, El",141,76,65
26,"Rioja, La",123,"Redal, El",145,82,63
26,"Rioja, La",124,Ribafrecha,1013,538,475
26,"Rioja, La",125,Rincón de Soto,3755,1900,1855
26,"Rioja, La",126,Robres del Castillo,30,19,11
26,"Rioja, La",127,Rodezno,278,156,122
26,"Rioja, La",128,Sajazarra,138,67,71
26,"Rioja, La",129,San Asensio,1190,632,558
26,"Rioja, La",130,San Millán de la Cogolla,248,162,86
26,"Rioja, La",131,San Millán de Yécora,34,22,12
26,"Rioja, La",132,San Román de Cameros,152,82,70
26,"Rioja, La",139,San Torcuato,73,42,31
26,"Rioja, La",142,San Vicente de la Sonsierra,1037,542,495
26,"Rioja, La",134,Santa Coloma,112,68,44
26,"Rioja, La",135,Santa Engracia del Jubera,159,97,62
26,"Rioja, La",136,Santa Eulalia Bajera,111,58,53
26,"Rioja, La",138,Santo Domingo de la Calzada,6520,3322,3198
26,"Rioja, La",140,Santurde de Rioja,291,150,141
26,"Rioja, La",141,Santurdejo,126,78,48
26,"Rioja, La",143,Sojuela,288,180,108
26,"Rioja, La",144,Sorzano,248,138,110
26,"Rioja, La",145,Sotés,290,167,123
26,"Rioja, La",146,Soto en Cameros,118,66,52
26,"Rioja, La",147,Terroba,34,16,18
26,"Rioja, La",148,Tirgo,215,111,104
26,"Rioja, La",149,Tobía,64,38,26
26,"Rioja, La",150,Tormantos,140,80,60
26,"Rioja, La",153,Torre en Cameros,12,10,2
26,"Rioja, La",151,Torrecilla en Cameros,482,263,219
26,"Rioja, La",152,Torrecilla sobre Alesanco,35,19,16
26,"Rioja, La",154,Torremontalbo,15,8,7
26,"Rioja, La",155,Treviana,180,96,84
26,"Rioja, La",157,Tricio,388,188,200
26,"Rioja, La",158,Tudelilla,367,202,165
26,"Rioja, La",160,Uruñuela,974,489,485
26,"Rioja, La",161,Valdemadera,8,5,3
26,"Rioja, La",162,Valgañón,137,88,49
26,"Rioja, La",163,Ventosa,169,95,74
26,"Rioja, La",164,Ventrosa,65,39,26
26,"Rioja, La",165,Viguera,447,253,194
26,"Rioja, La",166,Villalba de Rioja,125,78,47
26,"Rioja, La",167,Villalobar de Rioja,69,50,19
26,"Rioja, La",168,Villamediana de Iregua,7585,3851,3734
26,"Rioja, La",169,Villanueva de Cameros,81,47,34
26,"Rioja, La",170,"Villar de Arnedo, El",641,328,313
26,"Rioja, La",171,Villar de Torre,210,123,87
26,"Rioja, La",172,Villarejo,29,23,6
26,"Rioja, La",173,Villarroya,8,4,4
26,"Rioja, La",174,Villarta-Quintana,158,90,68
26,"Rioja, La",175,Villavelayo,56,36,20
26,"Rioja, La",176,Villaverde de Rioja,68,36,32
26,"Rioja, La",177,Villoslada de Cameros,343,212,131
26,"Rioja, La",178,Viniegra de Abajo,87,52,35
26,"Rioja, La",179,Viniegra de Arriba,50,31,19
26,"Rioja, La",180,Zarratón,275,153,122
26,"Rioja, La",181,Zarzosa,17,12,5
26,"Rioja, La",183,Zorraquín,96,47,49
37,Salamanca,1,Abusejo,220,117,103
37,Salamanca,2,Agallas,158,81,77
37,Salamanca,3,Ahigal de los Aceiteros,143,77,66
37,Salamanca,4,Ahigal de Villarino,37,19,18
37,Salamanca,5,"Alameda de Gardón, La",92,48,44
37,Salamanca,6,"Alamedilla, La",150,76,74
37,Salamanca,7,Alaraz,509,260,249
37,Salamanca,8,Alba de Tormes,5341,2643,2698
37,Salamanca,9,Alba de Yeltes,234,126,108
37,Salamanca,10,"Alberca, La",1126,559,567
37,Salamanca,11,"Alberguería de Argañán, La",140,71,69
37,Salamanca,12,Alconada,161,87,74
37,Salamanca,15,Aldea del Obispo,326,177,149
37,Salamanca,13,Aldeacipreste,130,70,60
37,Salamanca,14,Aldeadávila de la Ribera,1288,656,632
37,Salamanca,16,Aldealengua,678,347,331
37,Salamanca,17,Aldeanueva de Figueroa,286,152,134
37,Salamanca,18,Aldeanueva de la Sierra,113,65,48
37,Salamanca,19,Aldearrodrigo,155,80,75
37,Salamanca,20,Aldearrubia,494,274,220
37,Salamanca,21,Aldeaseca de Alba,83,40,43
37,Salamanca,22,Aldeaseca de la Frontera,290,149,141
37,Salamanca,23,Aldeatejada,1673,856,817
37,Salamanca,24,Aldeavieja de Tormes,101,54,47
37,Salamanca,25,Aldehuela de la Bóveda,303,161,142
37,Salamanca,26,Aldehuela de Yeltes,221,121,100
37,Salamanca,27,Almenara de Tormes,261,146,115
37,Salamanca,28,Almendra,178,100,78
37,Salamanca,29,Anaya de Alba,212,122,90
37,Salamanca,30,Añover de Tormes,94,51,43
37,Salamanca,31,Arabayona de Mógica,408,223,185
37,Salamanca,32,Arapiles,632,329,303
37,Salamanca,33,Arcediano,110,59,51
37,Salamanca,34,"Arco, El",89,42,47
37,Salamanca,35,Armenteros,315,177,138
37,Salamanca,37,"Atalaya, La",128,69,59
37,Salamanca,38,Babilafuente,896,464,432
37,Salamanca,39,Bañobárez,321,169,152
37,Salamanca,40,Barbadillo,410,207,203
37,Salamanca,41,Barbalos,76,41,35
37,Salamanca,42,Barceo,48,28,20
37,Salamanca,44,Barruecopardo,510,279,231
37,Salamanca,45,"Bastida, La",27,16,11
37,Salamanca,46,Béjar,13951,6653,7298
37,Salamanca,47,Beleña,212,98,114
37,Salamanca,49,Bermellar,142,74,68
37,Salamanca,50,Berrocal de Huebra,71,39,32
37,Salamanca,51,Berrocal de Salvatierra,84,46,38
37,Salamanca,52,Boada,300,155,145
37,Salamanca,54,"Bodón, El",296,154,142
37,Salamanca,55,Bogajo,144,79,65
37,Salamanca,56,"Bouza, La",73,34,39
37,Salamanca,57,Bóveda del Río Almar,245,130,115
37,Salamanca,58,Brincones,61,30,31
37,Salamanca,59,Buenamadre,134,73,61
37,Salamanca,60,Buenavista,250,135,115
37,Salamanca,61,"Cabaco, El",257,129,128
37,Salamanca,63,"Cabeza de Béjar, La",85,50,35
37,Salamanca,65,Cabeza del Caballo,356,190,166
37,Salamanca,62,Cabezabellosa de la Calzada,95,52,43
37,Salamanca,67,Cabrerizos,4149,2086,2063
37,Salamanca,68,Cabrillas,415,204,211
37,Salamanca,69,Calvarrasa de Abajo,1140,594,546
37,Salamanca,70,Calvarrasa de Arriba,615,319,296
37,Salamanca,71,"Calzada de Béjar, La",87,45,42
37,Salamanca,72,Calzada de Don Diego,192,103,89
37,Salamanca,73,Calzada de Valdunciel,660,344,316
37,Salamanca,74,Campillo de Azaba,180,102,78
37,Salamanca,77,"Campo de Peñaranda, El",284,160,124
37,Salamanca,78,Candelario,970,482,488
37,Salamanca,79,Canillas de Abajo,72,50,22
37,Salamanca,80,Cantagallo,273,147,126
37,Salamanca,81,Cantalapiedra,1039,529,510
37,Salamanca,82,Cantalpino,960,527,433
37,Salamanca,83,Cantaracillo,203,108,95
37,Salamanca,85,Carbajosa de la Sagrada,6763,3430,3333
37,Salamanca,86,Carpio de Azaba,101,59,42
37,Salamanca,87,Carrascal de Barregas,1069,569,500
37,Salamanca,88,Carrascal del Obispo,229,122,107
37,Salamanca,89,Casafranca,70,40,30
37,Salamanca,90,"Casas del Conde, Las",57,31,26
37,Salamanca,91,Casillas de Flores,187,93,94
37,Salamanca,92,Castellanos de Moriscos,2229,1160,1069
37,Salamanca,185,Castellanos de Villiquera,698,375,323
37,Salamanca,96,Castillejo de Martín Viejo,241,135,106
37,Salamanca,97,Castraz,40,25,15
37,Salamanca,98,Cepeda,361,177,184
37,Salamanca,99,Cereceda de la Sierra,87,45,42
37,Salamanca,100,Cerezal de Peñahorcada,83,46,37
37,Salamanca,101,Cerralbo,175,96,79
37,Salamanca,102,"Cerro, El",452,232,220
37,Salamanca,103,Cespedosa de Tormes,544,290,254
37,Salamanca,114,Chagarcía Medianero,94,49,45
37,Salamanca,104,Cilleros de la Bastida,27,14,13
37,Salamanca,106,Cipérez,294,146,148
37,Salamanca,107,Ciudad Rodrigo,13209,6387,6822
37,Salamanca,108,Coca de Alba,103,49,54
37,Salamanca,109,Colmenar de Montemayor,196,106,90
37,Salamanca,110,Cordovilla,124,70,54
37,Salamanca,112,Cristóbal,170,99,71
37,Salamanca,113,"Cubo de Don Sancho, El",466,246,220
37,Salamanca,115,Dios le Guarde,147,78,69
37,Salamanca,116,Doñinos de Ledesma,73,36,37
37,Salamanca,117,Doñinos de Salamanca,1911,1014,897
37,Salamanca,118,Ejeme,131,74,57
37,Salamanca,120,Encina de San Silvestre,114,61,53
37,Salamanca,119,"Encina, La",121,77,44
37,Salamanca,121,Encinas de Abajo,627,329,298
37,Salamanca,122,Encinas de Arriba,253,127,126
37,Salamanca,123,Encinasola de los Comendadores,203,106,97
37,Salamanca,124,Endrinal,238,130,108
37,Salamanca,125,Escurial de la Sierra,265,142,123
37,Salamanca,126,Espadaña,34,20,14
37,Salamanca,127,Espeja,258,133,125
37,Salamanca,128,Espino de la Orbada,275,145,130
37,Salamanca,129,Florida de Liébana,290,157,133
37,Salamanca,130,Forfoleda,194,109,85
37,Salamanca,131,Frades de la Sierra,220,118,102
37,Salamanca,132,"Fregeneda, La",384,186,198
37,Salamanca,133,Fresnedoso,116,66,50
37,Salamanca,134,Fresno Alhándiga,263,141,122
37,Salamanca,135,"Fuente de San Esteban, La",1391,705,686
37,Salamanca,136,Fuenteguinaldo,714,359,355
37,Salamanca,137,Fuenteliante,117,57,60
37,Salamanca,138,Fuenterroble de Salvatierra,256,135,121
37,Salamanca,139,Fuentes de Béjar,251,128,123
37,Salamanca,140,Fuentes de Oñoro,1141,581,560
37,Salamanca,141,Gajates,168,76,92
37,Salamanca,142,Galindo y Perahuy,714,409,305
37,Salamanca,143,Galinduste,467,230,237
37,Salamanca,144,Galisancho,409,228,181
37,Salamanca,145,Gallegos de Argañán,303,158,145
37,Salamanca,146,Gallegos de Solmirón,140,72,68
37,Salamanca,147,Garcibuey,182,100,82
37,Salamanca,148,Garcihernández,499,258,241
37,Salamanca,149,Garcirrey,75,43,32
37,Salamanca,150,Gejuelo del Barro,41,24,17
37,Salamanca,151,Golpejas,150,78,72
37,Salamanca,152,Gomecello,478,250,228
37,Salamanca,154,Guadramiro,156,86,70
37,Salamanca,155,Guijo de Ávila,90,54,36
37,Salamanca,156,Guijuelo,5781,2893,2888
37,Salamanca,157,Herguijuela de Ciudad Rodrigo,84,45,39
37,Salamanca,158,Herguijuela de la Sierra,295,156,139
37,Salamanca,159,Herguijuela del Campo,94,42,52
37,Salamanca,160,Hinojosa de Duero,726,359,367
37,Salamanca,161,Horcajo de Montemayor,158,85,73
37,Salamanca,162,Horcajo Medianero,224,118,106
37,Salamanca,163,"Hoya, La",43,26,17
37,Salamanca,164,Huerta,309,167,142
37,Salamanca,165,Iruelos,39,17,22
37,Salamanca,166,Ituero de Azaba,224,114,110
37,Salamanca,167,Juzbado,165,88,77
37,Salamanca,168,Lagunilla,524,286,238
37,Salamanca,169,Larrodrigo,199,115,84
37,Salamanca,170,Ledesma,1795,880,915
37,Salamanca,171,Ledrada,512,258,254
37,Salamanca,172,Linares de Riofrío,964,525,439
37,Salamanca,173,Lumbrales,1789,893,896
37,Salamanca,175,Machacón,454,241,213
37,Salamanca,174,Macotera,1201,635,566
37,Salamanca,176,Madroñal,157,92,65
37,Salamanca,177,"Maíllo, El",298,162,136
37,Salamanca,178,Malpartida,101,58,43
37,Salamanca,179,Mancera de Abajo,227,116,111
37,Salamanca,180,"Manzano, El",75,39,36
37,Salamanca,181,Martiago,266,138,128
37,Salamanca,183,Martín de Yeltes,441,226,215
37,Salamanca,182,Martinamor,100,62,38
37,Salamanca,184,Masueco,336,175,161
37,Salamanca,186,"Mata de Ledesma, La",110,59,51
37,Salamanca,187,Matilla de los Caños del Río,639,326,313
37,Salamanca,188,"Maya, La",210,125,85
37,Salamanca,189,Membribe de la Sierra,140,83,57
37,Salamanca,190,Mieza,232,113,119
37,Salamanca,191,"Milano, El",119,67,52
37,Salamanca,192,Miranda de Azán,427,228,199
37,Salamanca,193,Miranda del Castañar,467,248,219
37,Salamanca,194,Mogarraz,329,170,159
37,Salamanca,195,Molinillo,60,36,24
37,Salamanca,196,Monforte de la Sierra,84,44,40
37,Salamanca,197,Monleón,92,54,38
37,Salamanca,198,Monleras,250,119,131
37,Salamanca,199,Monsagro,157,82,75
37,Salamanca,200,Montejo,209,112,97
37,Salamanca,201,Montemayor del Río,299,152,147
37,Salamanca,202,Monterrubio de Armuña,1319,702,617
37,Salamanca,203,Monterrubio de la Sierra,178,100,78
37,Salamanca,204,Morasverdes,289,146,143
37,Salamanca,205,Morille,258,132,126
37,Salamanca,206,Moríñigo,106,57,49
37,Salamanca,207,Moriscos,325,181,144
37,Salamanca,208,Moronta,86,52,34
37,Salamanca,209,Mozárbez,502,263,239
37,Salamanca,211,Narros de Matalayegua,237,130,107
37,Salamanca,213,Nava de Béjar,105,57,48
37,Salamanca,214,Nava de Francia,134,73,61
37,Salamanca,215,Nava de Sotrobal,174,99,75
37,Salamanca,212,Navacarros,125,67,58
37,Salamanca,216,Navales,335,179,156
37,Salamanca,217,Navalmoral de Béjar,56,24,32
37,Salamanca,218,Navamorales,78,49,29
37,Salamanca,219,Navarredonda de la Rinconada,194,101,93
37,Salamanca,221,Navasfrías,486,252,234
37,Salamanca,222,Negrilla de Palencia,113,62,51
37,Salamanca,223,Olmedo de Camaces,126,69,57
37,Salamanca,224,"Orbada, La",208,106,102
37,Salamanca,225,Pajares de la Laguna,119,64,55
37,Salamanca,226,Palacios del Arzobispo,164,83,81
37,Salamanca,228,Palaciosrubios,405,215,190
37,Salamanca,229,Palencia de Negrilla,162,90,72
37,Salamanca,230,Parada de Arriba,265,135,130
37,Salamanca,231,Parada de Rubiales,288,150,138
37,Salamanca,232,Paradinas de San Juan,423,237,186
37,Salamanca,233,Pastores,62,33,29
37,Salamanca,234,"Payo, El",368,182,186
37,Salamanca,235,Pedraza de Alba,253,133,120
37,Salamanca,236,Pedrosillo de Alba,152,84,68
37,Salamanca,237,Pedrosillo de los Aires,389,214,175
37,Salamanca,238,Pedrosillo el Ralo,153,80,73
37,Salamanca,239,"Pedroso de la Armuña, El",250,125,125
37,Salamanca,240,Pelabravo,1102,571,531
37,Salamanca,241,Pelarrodríguez,174,106,68
37,Salamanca,242,Pelayos,101,63,38
37,Salamanca,243,"Peña, La",113,54,59
37,Salamanca,244,Peñacaballera,145,70,75
37,Salamanca,245,Peñaparda,384,196,188
37,Salamanca,246,Peñaranda de Bracamonte,6672,3283,3389
37,Salamanca,247,Peñarandilla,223,117,106
37,Salamanca,248,Peralejos de Abajo,163,84,79
37,Salamanca,249,Peralejos de Arriba,47,27,20
37,Salamanca,250,Pereña de la Ribera,392,200,192
37,Salamanca,251,Peromingo,140,67,73
37,Salamanca,252,Pinedas,107,62,45
37,Salamanca,253,"Pino de Tormes, El",157,82,75
37,Salamanca,254,Pitiegua,206,120,86
37,Salamanca,255,Pizarral,57,30,27
37,Salamanca,256,Poveda de las Cintas,248,141,107
37,Salamanca,257,Pozos de Hinojo,53,29,24
37,Salamanca,258,Puebla de Azaba,216,122,94
37,Salamanca,259,Puebla de San Medel,43,24,19
37,Salamanca,260,Puebla de Yeltes,149,85,64
37,Salamanca,261,Puente del Congosto,246,135,111
37,Salamanca,262,Puertas,83,43,40
37,Salamanca,263,Puerto de Béjar,393,198,195
37,Salamanca,264,Puerto Seguro,68,36,32
37,Salamanca,265,Rágama,245,124,121
37,Salamanca,266,"Redonda, La",102,57,45
37,Salamanca,267,Retortillo,241,129,112
37,Salamanca,268,"Rinconada de la Sierra, La",124,67,57
37,Salamanca,269,Robleda,520,282,238
37,Salamanca,270,Robliza de Cojos,224,116,108
37,Salamanca,271,Rollán,388,207,181
37,Salamanca,272,Saelices el Chico,165,82,83
37,Salamanca,273,"Sagrada, La",119,63,56
37,Salamanca,303,"Sahugo, El",196,103,93
37,Salamanca,274,Salamanca,148042,67785,80257
37,Salamanca,275,Saldeana,126,69,57
37,Salamanca,276,Salmoral,155,93,62
37,Salamanca,277,Salvatierra de Tormes,62,29,33
37,Salamanca,278,San Cristóbal de la Cuesta,1001,537,464
37,Salamanca,284,San Esteban de la Sierra,343,184,159
37,Salamanca,285,San Felices de los Gallegos,461,235,226
37,Salamanca,286,San Martín del Castañar,257,135,122
37,Salamanca,287,San Miguel de Valero,366,179,187
37,Salamanca,36,San Miguel del Robledo,69,33,36
37,Salamanca,288,San Morales,281,159,122
37,Salamanca,289,San Muñoz,280,145,135
37,Salamanca,291,San Pedro de Rozados,305,160,145
37,Salamanca,290,San Pedro del Valle,147,80,67
37,Salamanca,292,San Pelayo de Guareña,88,44,44
37,Salamanca,280,Sanchón de la Ribera,75,46,29
37,Salamanca,281,Sanchón de la Sagrada,41,25,16
37,Salamanca,282,Sanchotello,229,120,109
37,Salamanca,279,Sancti-Spíritus,879,466,413
37,Salamanca,283,Sando,144,84,60
37,Salamanca,293,Santa María de Sando,127,64,63
37,Salamanca,294,Santa Marta de Tormes,15011,7422,7589
37,Salamanca,296,Santiago de la Puebla,378,195,183
37,Salamanca,297,Santibáñez de Béjar,494,255,239
37,Salamanca,298,Santibáñez de la Sierra,197,107,90
37,Salamanca,299,Santiz,247,129,118
37,Salamanca,300,"Santos, Los",643,337,306
37,Salamanca,301,Sardón de los Frailes,85,47,38
37,Salamanca,302,Saucelle,339,175,164
37,Salamanca,304,Sepulcro-Hilario,179,103,76
37,Salamanca,305,Sequeros,229,112,117
37,Salamanca,306,Serradilla del Arroyo,296,162,134
37,Salamanca,307,Serradilla del Llano,169,81,88
37,Salamanca,309,"Sierpe, La",50,26,24
37,Salamanca,310,Sieteiglesias de Tormes,205,107,98
37,Salamanca,311,Sobradillo,258,129,129
37,Salamanca,312,Sorihuela,280,145,135
37,Salamanca,313,Sotoserrano,626,330,296
37,Salamanca,314,Tabera de Abajo,110,61,49
37,Salamanca,315,"Tala, La",98,52,46
37,Salamanca,316,Tamames,856,436,420
37,Salamanca,317,Tarazona de Guareña,348,187,161
37,Salamanca,318,Tardáguila,230,132,98
37,Salamanca,319,"Tejado, El",125,64,61
37,Salamanca,320,Tejeda y Segoyuela,106,60,46
37,Salamanca,321,Tenebrón,166,82,84
37,Salamanca,322,Terradillos,3202,1641,1561
37,Salamanca,323,Topas,564,304,260
37,Salamanca,324,Tordillos,409,220,189
37,Salamanca,325,"Tornadizo, El",98,54,44
37,Salamanca,327,Torresmenudas,201,102,99
37,Salamanca,328,Trabanca,223,111,112
37,Salamanca,329,Tremedal de Tormes,41,20,21
37,Salamanca,330,Valdecarros,366,189,177
37,Salamanca,331,Valdefuentes de Sangusín,228,124,104
37,Salamanca,332,Valdehijaderos,82,44,38
37,Salamanca,333,Valdelacasa,250,145,105
37,Salamanca,334,Valdelageve,85,43,42
37,Salamanca,335,Valdelosa,448,229,219
37,Salamanca,336,Valdemierque,55,34,21
37,Salamanca,337,Valderrodrigo,154,75,79
37,Salamanca,338,Valdunciel,90,45,45
37,Salamanca,339,Valero,309,165,144
37,Salamanca,343,Vallejera de Riofrío,70,35,35
37,Salamanca,340,Valsalabroso,150,88,62
37,Salamanca,341,Valverde de Valdelacasa,65,36,29
37,Salamanca,342,Valverdón,280,142,138
37,Salamanca,344,Vecinos,281,141,140
37,Salamanca,345,Vega de Tirados,186,92,94
37,Salamanca,346,"Veguillas, Las",286,130,156
37,Salamanca,347,"Vellés, La",563,308,255
37,Salamanca,348,Ventosa del Río Almar,122,69,53
37,Salamanca,349,"Vídola, La",127,59,68
37,Salamanca,351,Villaflores,291,148,143
37,Salamanca,352,Villagonzalo de Tormes,209,124,85
37,Salamanca,353,Villalba de los Llanos,142,80,62
37,Salamanca,354,Villamayor,6941,3476,3465
37,Salamanca,355,Villanueva del Conde,162,85,77
37,Salamanca,356,Villar de Argañán,95,52,43
37,Salamanca,357,Villar de Ciervo,295,157,138
37,Salamanca,358,Villar de Gallimazo,185,105,80
37,Salamanca,359,Villar de la Yegua,196,103,93
37,Salamanca,360,Villar de Peralonso,260,123,137
37,Salamanca,361,Villar de Samaniego,90,52,38
37,Salamanca,362,Villares de la Reina,6167,3104,3063
37,Salamanca,363,Villares de Yeltes,133,64,69
37,Salamanca,364,Villarino de los Aires,908,469,439
37,Salamanca,365,Villarmayor,216,116,100
37,Salamanca,366,Villarmuerto,41,27,14
37,Salamanca,367,Villasbuenas,214,115,99
37,Salamanca,368,Villasdardo,18,6,12
37,Salamanca,369,Villaseco de los Gamitos,156,89,67
37,Salamanca,370,Villaseco de los Reyes,385,217,168
37,Salamanca,371,Villasrubias,303,164,139
37,Salamanca,372,Villaverde de Guareña,145,82,63
37,Salamanca,373,Villavieja de Yeltes,878,457,421
37,Salamanca,374,Villoria,1469,746,723
37,Salamanca,375,Villoruela,851,430,421
37,Salamanca,350,Vilvestre,454,220,234
37,Salamanca,376,Vitigudino,2750,1360,1390
37,Salamanca,377,Yecla de Yeltes,279,145,134
37,Salamanca,378,Zamarra,110,62,48
37,Salamanca,379,Zamayón,195,110,85
37,Salamanca,380,Zarapicos,51,26,25
37,Salamanca,381,"Zarza de Pumareda, La",142,79,63
37,Salamanca,382,Zorita de la Frontera,202,105,97
38,Santa Cruz de Tenerife,1,Adeje,46667,23745,22922
38,Santa Cruz de Tenerife,2,Agulo,1086,548,538
38,Santa Cruz de Tenerife,3,Alajeró,1954,1039,915
38,Santa Cruz de Tenerife,4,Arafo,5464,2704,2760
38,Santa Cruz de Tenerife,5,Arico,7670,4005,3665
38,Santa Cruz de Tenerife,6,Arona,79890,40893,38997
38,Santa Cruz de Tenerife,7,Barlovento,2005,1019,986
38,Santa Cruz de Tenerife,8,Breña Alta,7293,3600,3693
38,Santa Cruz de Tenerife,9,Breña Baja,5366,2713,2653
38,Santa Cruz de Tenerife,10,Buenavista del Norte,4884,2477,2407
38,Santa Cruz de Tenerife,11,Candelaria,26543,12964,13579
38,Santa Cruz de Tenerife,12,Fasnia,2846,1467,1379
38,Santa Cruz de Tenerife,13,Frontera,3901,1981,1920
38,Santa Cruz de Tenerife,14,Fuencaliente de la Palma,1745,890,855
38,Santa Cruz de Tenerife,15,Garachico,5169,2570,2599
38,Santa Cruz de Tenerife,16,Garafía,1618,836,782
38,Santa Cruz de Tenerife,17,Granadilla de Abona,43455,21894,21561
38,Santa Cruz de Tenerife,18,"Guancha, La",5482,2694,2788
38,Santa Cruz de Tenerife,19,Guía de Isora,20061,10026,10035
38,Santa Cruz de Tenerife,20,Güímar,18751,9282,9469
38,Santa Cruz de Tenerife,21,Hermigua,1919,984,935
38,Santa Cruz de Tenerife,22,Icod de los Vinos,22913,11335,11578
38,Santa Cruz de Tenerife,24,"Llanos de Aridane, Los",20416,9941,10475
38,Santa Cruz de Tenerife,25,"Matanza de Acentejo, La",8745,4408,4337
38,Santa Cruz de Tenerife,26,"Orotava, La",41179,20340,20839
38,Santa Cruz de Tenerife,27,"Paso, El",7617,3800,3817
38,Santa Cruz de Tenerife,901,"Pinar de El Hierro, El",1801,924,877
38,Santa Cruz de Tenerife,28,Puerto de la Cruz,29435,14352,15083
38,Santa Cruz de Tenerife,29,Puntagorda,2031,1031,1000
38,Santa Cruz de Tenerife,30,Puntallana,2348,1181,1167
38,Santa Cruz de Tenerife,31,"Realejos, Los",36860,18138,18722
38,Santa Cruz de Tenerife,32,"Rosario, El",17329,8807,8522
38,Santa Cruz de Tenerife,33,San Andrés y Sauces,4378,2207,2171
38,Santa Cruz de Tenerife,23,San Cristóbal de La Laguna,153009,74480,78529
38,Santa Cruz de Tenerife,34,San Juan de la Rambla,5053,2516,2537
38,Santa Cruz de Tenerife,35,San Miguel de Abona,16221,8158,8063
38,Santa Cruz de Tenerife,36,San Sebastián de la Gomera,8668,4396,4272
38,Santa Cruz de Tenerife,37,Santa Cruz de la Palma,16184,7877,8307
38,Santa Cruz de Tenerife,38,Santa Cruz de Tenerife,205279,98137,107142
38,Santa Cruz de Tenerife,39,Santa Úrsula,14296,7147,7149
38,Santa Cruz de Tenerife,40,Santiago del Teide,10468,5211,5257
38,Santa Cruz de Tenerife,41,"Sauzal, El",8998,4424,4574
38,Santa Cruz de Tenerife,42,"Silos, Los",4727,2372,2355
38,Santa Cruz de Tenerife,43,Tacoronte,23929,11958,11971
38,Santa Cruz de Tenerife,44,"Tanque, El",2775,1359,1416
38,Santa Cruz de Tenerife,45,Tazacorte,4844,2451,2393
38,Santa Cruz de Tenerife,46,Tegueste,11097,5512,5585
38,Santa Cruz de Tenerife,47,Tijarafe,2684,1361,1323
38,Santa Cruz de Tenerife,49,Valle Gran Rey,4181,2124,2057
38,Santa Cruz de Tenerife,50,Vallehermoso,2913,1499,1414
38,Santa Cruz de Tenerife,48,Valverde,4973,2540,2433
38,Santa Cruz de Tenerife,51,"Victoria de Acentejo, La",9026,4519,4507
38,Santa Cruz de Tenerife,52,Vilaflor,1715,883,832
38,Santa Cruz de Tenerife,53,Villa de Mazo,4927,2488,2439
40,Segovia,1,Abades,873,437,436
40,Segovia,2,Adrada de Pirón,36,17,19
40,Segovia,3,Adrados,156,84,72
40,Segovia,4,Aguilafuente,647,313,334
40,Segovia,5,Alconada de Maderuelo,33,21,12
40,Segovia,12,Aldea Real,341,181,160
40,Segovia,6,Aldealcorvo,18,12,6
40,Segovia,7,Aldealengua de Pedraza,89,54,35
40,Segovia,8,Aldealengua de Santa María,58,29,29
40,Segovia,9,Aldeanueva de la Serrezuela,54,40,14
40,Segovia,10,Aldeanueva del Codonal,139,76,63
40,Segovia,13,Aldeasoña,67,39,28
40,Segovia,14,Aldehorno,53,29,24
40,Segovia,15,Aldehuela del Codonal,31,16,15
40,Segovia,16,Aldeonte,62,29,33
40,Segovia,17,Anaya,118,55,63
40,Segovia,18,Añe,103,58,45
40,Segovia,19,Arahuetes,42,27,15
40,Segovia,20,Arcones,233,112,121
40,Segovia,21,Arevalillo de Cega,29,17,12
40,Segovia,22,Armuña,238,134,104
40,Segovia,24,Ayllón,1354,711,643
40,Segovia,25,Barbolla,203,116,87
40,Segovia,26,Basardilla,153,69,84
40,Segovia,28,Bercial,110,57,53
40,Segovia,29,Bercimuel,35,18,17
40,Segovia,30,Bernardos,550,294,256
40,Segovia,31,Bernuy de Porreros,703,378,325
40,Segovia,32,Boceguillas,830,424,406
40,Segovia,33,Brieva,82,49,33
40,Segovia,34,Caballar,98,51,47
40,Segovia,35,Cabañas de Polendos,179,101,78
40,Segovia,36,Cabezuela,687,351,336
40,Segovia,37,Calabazas de Fuentidueña,39,22,17
40,Segovia,39,Campo de San Pedro,290,162,128
40,Segovia,40,Cantalejo,3782,1923,1859
40,Segovia,41,Cantimpalos,1368,713,655
40,Segovia,43,Carbonero el Mayor,2577,1316,1261
40,Segovia,44,Carrascal del Río,162,88,74
40,Segovia,45,Casla,167,88,79
40,Segovia,46,Castillejo de Mesleón,150,93,57
40,Segovia,47,Castro de Fuentidueña,40,23,17
40,Segovia,48,Castrojimeno,37,19,18
40,Segovia,49,Castroserna de Abajo,53,26,27
40,Segovia,51,Castroserracín,44,24,20
40,Segovia,52,Cedillo de la Torre,116,57,59
40,Segovia,53,Cerezo de Abajo,145,76,69
40,Segovia,54,Cerezo de Arriba,161,89,72
40,Segovia,65,Chañe,904,425,479
40,Segovia,55,Cilleruelo de San Mamés,41,25,16
40,Segovia,56,Cobos de Fuentidueña,39,18,21
40,Segovia,57,Coca,1943,970,973
40,Segovia,58,Codorniz,362,186,176
40,Segovia,59,Collado Hermoso,153,74,79
40,Segovia,60,Condado de Castilnovo,86,49,37
40,Segovia,61,Corral de Ayllón,94,58,36
40,Segovia,902,Cozuelos de Fuentidueña,136,77,59
40,Segovia,62,Cubillo,69,40,29
40,Segovia,63,Cuéllar,9547,4828,4719
40,Segovia,905,Cuevas de Provanco,142,77,65
40,Segovia,68,Domingo García,32,19,13
40,Segovia,69,Donhierro,105,56,49
40,Segovia,70,Duruelo,166,99,67
40,Segovia,71,Encinas,52,29,23
40,Segovia,72,Encinillas,242,136,106
40,Segovia,73,Escalona del Prado,564,296,268
40,Segovia,74,Escarabajosa de Cabezas,331,175,156
40,Segovia,75,Escobar de Polendos,193,101,92
40,Segovia,76,"Espinar, El",9654,4972,4682
40,Segovia,77,Espirdo,1088,586,502
40,Segovia,78,Fresneda de Cuéllar,174,97,77
40,Segovia,79,Fresno de Cantespino,267,144,123
40,Segovia,80,Fresno de la Fuente,90,51,39
40,Segovia,81,Frumales,136,69,67
40,Segovia,82,Fuente de Santa Cruz,130,66,64
40,Segovia,83,Fuente el Olmo de Fuentidueña,180,63,117
40,Segovia,84,Fuente el Olmo de Íscar,71,38,33
40,Segovia,86,Fuentepelayo,937,491,446
40,Segovia,87,Fuentepiñel,105,56,49
40,Segovia,88,Fuenterrebollo,359,189,170
40,Segovia,89,Fuentesaúco de Fuentidueña,261,142,119
40,Segovia,91,Fuentesoto,120,62,58
40,Segovia,92,Fuentidueña,150,83,67
40,Segovia,93,Gallegos,95,50,45
40,Segovia,94,Garcillán,480,259,221
40,Segovia,95,Gomezserracín,666,343,323
40,Segovia,97,Grajera,258,141,117
40,Segovia,99,Honrubia de la Cuesta,63,35,28
40,Segovia,100,Hontalbilla,329,175,154
40,Segovia,101,Hontanares de Eresma,1248,663,585
40,Segovia,103,"Huertos, Los",188,112,76
40,Segovia,104,Ituero y Lama,365,193,172
40,Segovia,105,Juarros de Riomoros,61,36,25
40,Segovia,106,Juarros de Voltoya,250,123,127
40,Segovia,107,Labajos,146,81,65
40,Segovia,108,Laguna de Contreras,126,70,56
40,Segovia,109,Languilla,87,48,39
40,Segovia,110,Lastras de Cuéllar,410,207,203
40,Segovia,111,Lastras del Pozo,79,39,40
40,Segovia,112,"Lastrilla, La",3605,1848,1757
40,Segovia,113,"Losa, La",538,288,250
40,Segovia,115,Maderuelo,109,59,50
40,Segovia,903,Marazoleja,117,72,45
40,Segovia,118,Marazuela,53,31,22
40,Segovia,119,Martín Miguel,224,132,92
40,Segovia,120,Martín Muñoz de la Dehesa,220,118,102
40,Segovia,121,Martín Muñoz de las Posadas,356,186,170
40,Segovia,122,Marugán,634,341,293
40,Segovia,124,Mata de Cuéllar,279,142,137
40,Segovia,123,Matabuena,192,105,87
40,Segovia,125,"Matilla, La",96,54,42
40,Segovia,126,Melque de Cercos,91,45,46
40,Segovia,127,Membibre de la Hoz,34,19,15
40,Segovia,128,Migueláñez,167,89,78
40,Segovia,129,Montejo de Arévalo,205,111,94
40,Segovia,130,Montejo de la Vega de la Serrezuela,151,88,63
40,Segovia,131,Monterrubio,63,36,27
40,Segovia,132,Moral de Hornuez,73,41,32
40,Segovia,134,Mozoncillo,956,517,439
40,Segovia,135,Muñopedro,342,177,165
40,Segovia,136,Muñoveros,165,80,85
40,Segovia,138,Nava de la Asunción,2941,1475,1466
40,Segovia,139,Navafría,319,174,145
40,Segovia,140,Navalilla,127,67,60
40,Segovia,141,Navalmanzano,1145,605,540
40,Segovia,142,Navares de Ayuso,60,29,31
40,Segovia,143,Navares de Enmedio,100,58,42
40,Segovia,144,Navares de las Cuevas,23,15,8
40,Segovia,145,Navas de Oro,1402,720,682
40,Segovia,904,Navas de Riofrío,422,200,222
40,Segovia,146,Navas de San Antonio,408,217,191
40,Segovia,148,Nieva,319,170,149
40,Segovia,149,Olombrada,638,346,292
40,Segovia,150,Orejana,72,41,31
40,Segovia,151,Ortigosa de Pestaño,82,42,40
40,Segovia,901,Ortigosa del Monte,587,314,273
40,Segovia,152,Otero de Herreros,982,500,482
40,Segovia,154,Pajarejos,21,13,8
40,Segovia,155,Palazuelos de Eresma,4868,2526,2342
40,Segovia,156,Pedraza,426,233,193
40,Segovia,157,Pelayos del Arroyo,67,38,29
40,Segovia,158,Perosillo,18,13,5
40,Segovia,159,Pinarejos,173,100,73
40,Segovia,160,Pinarnegrillo,120,68,52
40,Segovia,161,Pradales,46,23,23
40,Segovia,162,Prádena,567,307,260
40,Segovia,163,Puebla de Pedraza,58,31,27
40,Segovia,164,Rapariegos,208,109,99
40,Segovia,181,Real Sitio de San Ildefonso,5464,2696,2768
40,Segovia,165,Rebollo,93,53,40
40,Segovia,166,Remondo,319,159,160
40,Segovia,168,Riaguas de San Bartolomé,41,23,18
40,Segovia,170,Riaza,2382,1288,1094
40,Segovia,171,Ribota,43,34,9
40,Segovia,172,Riofrío de Riaza,29,19,10
40,Segovia,173,Roda de Eresma,201,109,92
40,Segovia,174,Sacramenia,429,225,204
40,Segovia,176,Samboal,488,259,229
40,Segovia,177,San Cristóbal de Cuéllar,163,90,73
40,Segovia,178,San Cristóbal de la Vega,124,61,63
40,Segovia,906,San Cristóbal de Segovia,2939,1499,1440
40,Segovia,182,San Martín y Mudrián,273,138,135
40,Segovia,183,San Miguel de Bernuy,150,76,74
40,Segovia,184,San Pedro de Gaíllos,277,147,130
40,Segovia,179,Sanchonuño,945,454,491
40,Segovia,180,Sangarcía,346,187,159
40,Segovia,185,Santa María la Real de Nieva,1052,559,493
40,Segovia,186,Santa Marta del Cerro,38,18,20
40,Segovia,188,Santiuste de Pedraza,116,69,47
40,Segovia,189,Santiuste de San Juan Bautista,622,340,282
40,Segovia,190,Santo Domingo de Pirón,59,33,26
40,Segovia,191,Santo Tomé del Puerto,287,155,132
40,Segovia,192,Sauquillo de Cabezas,200,108,92
40,Segovia,193,Sebúlcor,278,145,133
40,Segovia,194,Segovia,53260,25322,27938
40,Segovia,195,Sepúlveda,1193,617,576
40,Segovia,196,Sequera de Fresno,39,21,18
40,Segovia,198,Sotillo,28,16,12
40,Segovia,199,Sotosalbos,132,69,63
40,Segovia,200,Tabanera la Luenga,63,28,35
40,Segovia,201,Tolocirio,56,25,31
40,Segovia,206,Torre Val de San Pedro,193,100,93
40,Segovia,202,Torreadrada,78,36,42
40,Segovia,203,Torrecaballeros,1305,664,641
40,Segovia,204,Torrecilla del Pinar,216,116,100
40,Segovia,205,Torreiglesias,345,174,171
40,Segovia,207,Trescasas,991,511,480
40,Segovia,208,Turégano,1056,519,537
40,Segovia,210,Urueñas,100,61,39
40,Segovia,211,Valdeprados,84,46,38
40,Segovia,212,Valdevacas de Montejo,32,16,16
40,Segovia,213,Valdevacas y Guijar,97,48,49
40,Segovia,218,Valle de Tabladillo,103,58,45
40,Segovia,219,Vallelado,739,399,340
40,Segovia,220,Valleruela de Pedraza,77,41,36
40,Segovia,221,Valleruela de Sepúlveda,57,28,29
40,Segovia,214,Valseca,272,151,121
40,Segovia,215,Valtiendas,100,60,40
40,Segovia,216,Valverde del Majano,1061,529,532
40,Segovia,222,Veganzones,265,145,120
40,Segovia,223,Vegas de Matute,288,170,118
40,Segovia,224,Ventosilla y Tejadilla,27,18,9
40,Segovia,225,Villacastín,1542,798,744
40,Segovia,228,Villaverde de Íscar,638,339,299
40,Segovia,229,Villaverde de Montejo,39,22,17
40,Segovia,230,Villeguillo,118,70,48
40,Segovia,231,Yanguas de Eresma,133,69,64
40,Segovia,233,Zarzuela del Monte,553,282,271
40,Segovia,234,Zarzuela del Pinar,487,251,236
41,Sevilla,1,Aguadulce,2149,1065,1084
41,Sevilla,2,Alanís,1832,912,920
41,Sevilla,3,Albaida del Aljarafe,3089,1554,1535
41,Sevilla,4,Alcalá de Guadaíra,74404,36998,37406
41,Sevilla,5,Alcalá del Río,11690,5916,5774
41,Sevilla,6,Alcolea del Río,3402,1702,1700
41,Sevilla,7,"Algaba, La",16105,7977,8128
41,Sevilla,8,Algámitas,1316,685,631
41,Sevilla,9,Almadén de la Plata,1503,769,734
41,Sevilla,10,Almensilla,5816,2928,2888
41,Sevilla,11,Arahal,19585,9700,9885
41,Sevilla,12,Aznalcázar,4349,2215,2134
41,Sevilla,13,Aznalcóllar,6144,3139,3005
41,Sevilla,14,Badolatosa,3150,1624,1526
41,Sevilla,15,Benacazón,7214,3635,3579
41,Sevilla,16,Bollullos de la Mitación,10031,5035,4996
41,Sevilla,17,Bormujos,20947,10396,10551
41,Sevilla,18,Brenes,12696,6362,6334
41,Sevilla,19,Burguillos,6475,3259,3216
41,Sevilla,20,"Cabezas de San Juan, Las",16546,8368,8178
41,Sevilla,21,Camas,26665,13044,13621
41,Sevilla,22,"Campana, La",5451,2724,2727
41,Sevilla,23,Cantillana,10842,5565,5277
41,Sevilla,901,Cañada Rosal,3288,1631,1657
41,Sevilla,24,Carmona,28717,14457,14260
41,Sevilla,25,Carrión de los Céspedes,2551,1224,1327
41,Sevilla,26,Casariche,5596,2855,2741
41,Sevilla,27,Castilblanco de los Arroyos,5033,2530,2503
41,Sevilla,28,Castilleja de Guzmán,2871,1451,1420
41,Sevilla,29,Castilleja de la Cuesta,17536,8506,9030
41,Sevilla,30,Castilleja del Campo,643,324,319
41,Sevilla,31,"Castillo de las Guardas, El",1539,775,764
41,Sevilla,32,Cazalla de la Sierra,5038,2475,2563
41,Sevilla,33,Constantina,6264,3101,3163
41,Sevilla,34,Coria del Río,30208,15092,15116
41,Sevilla,35,Coripe,1361,684,677
41,Sevilla,36,"Coronil, El",4996,2506,2490
41,Sevilla,37,"Corrales, Los",4029,2063,1966
41,Sevilla,903,"Cuervo de Sevilla, El",8721,4445,4276
41,Sevilla,38,Dos Hermanas,130369,64370,65999
41,Sevilla,39,Écija,40634,20025,20609
41,Sevilla,40,Espartinas,14723,7402,7321
41,Sevilla,41,Estepa,12667,6280,6387
41,Sevilla,42,Fuentes de Andalucía,7188,3584,3604
41,Sevilla,43,"Garrobo, El",774,394,380
41,Sevilla,44,Gelves,9688,4792,4896
41,Sevilla,45,Gerena,7309,3705,3604
41,Sevilla,46,Gilena,3867,1951,1916
41,Sevilla,47,Gines,13299,6548,6751
41,Sevilla,48,Guadalcanal,2805,1402,1403
41,Sevilla,49,Guillena,12464,6294,6170
41,Sevilla,50,Herrera,6525,3238,3287
41,Sevilla,51,Huévar del Aljarafe,2746,1419,1327
41,Sevilla,902,Isla Mayor,5930,2991,2939
41,Sevilla,52,"Lantejuela, La",3899,2002,1897
41,Sevilla,53,Lebrija,27385,13695,13690
41,Sevilla,54,Lora de Estepa,876,447,429
41,Sevilla,55,Lora del Río,19393,9621,9772
41,Sevilla,56,"Luisiana, La",4672,2346,2326
41,Sevilla,57,"Madroño, El",304,152,152
41,Sevilla,58,Mairena del Alcor,22447,11255,11192
41,Sevilla,59,Mairena del Aljarafe,43723,21371,22352
41,Sevilla,60,Marchena,19940,9964,9976
41,Sevilla,61,Marinaleda,2748,1396,1352
41,Sevilla,62,Martín de la Jara,2796,1429,1367
41,Sevilla,63,"Molares, Los",3508,1798,1710
41,Sevilla,64,Montellano,7092,3556,3536
41,Sevilla,65,Morón de la Frontera,28241,13966,14275
41,Sevilla,66,"Navas de la Concepción, Las",1684,824,860
41,Sevilla,67,Olivares,9564,4808,4756
41,Sevilla,68,Osuna,17818,8791,9027
41,Sevilla,69,"Palacios y Villafranca, Los",38095,19168,18927
41,Sevilla,70,Palomares del Río,8022,4049,3973
41,Sevilla,71,Paradas,7063,3554,3509
41,Sevilla,72,Pedrera,5364,2652,2712
41,Sevilla,73,"Pedroso, El",2163,1072,1091
41,Sevilla,74,Peñaflor,3755,1895,1860
41,Sevilla,75,Pilas,14014,7069,6945
41,Sevilla,76,Pruna,2740,1421,1319
41,Sevilla,77,"Puebla de Cazalla, La",11352,5656,5696
41,Sevilla,78,"Puebla de los Infantes, La",3115,1535,1580
41,Sevilla,79,"Puebla del Río, La",12190,6060,6130
41,Sevilla,80,"Real de la Jara, El",1615,790,825
41,Sevilla,81,"Rinconada, La",38021,18940,19081
41,Sevilla,82,"Roda de Andalucía, La",4297,2126,2171
41,Sevilla,83,"Ronquillo, El",1427,739,688
41,Sevilla,84,"Rubio, El",3520,1740,1780
41,Sevilla,85,Salteras,5468,2662,2806
41,Sevilla,86,San Juan de Aznalfarache,21576,10474,11102
41,Sevilla,88,San Nicolás del Puerto,621,315,306
41,Sevilla,87,Sanlúcar la Mayor,13466,6637,6829
41,Sevilla,89,Santiponce,8439,4224,4215
41,Sevilla,90,"Saucejo, El",4407,2186,2221
41,Sevilla,91,Sevilla,696676,331088,365588
41,Sevilla,92,Tocina,9685,4787,4898
41,Sevilla,93,Tomares,24501,12119,12382
41,Sevilla,94,Umbrete,8608,4345,4263
41,Sevilla,95,Utrera,52437,26151,26286
41,Sevilla,96,Valencina de la Concepción,7930,3943,3987
41,Sevilla,97,Villamanrique de la Condesa,4406,2167,2239
41,Sevilla,100,Villanueva de San Juan,1257,603,654
41,Sevilla,98,Villanueva del Ariscal,6324,3110,3214
41,Sevilla,99,Villanueva del Río y Minas,5035,2525,2510
41,Sevilla,101,Villaverde del Río,7777,3967,3810
41,Sevilla,102,"Viso del Alcor, El",19119,9607,9512
42,Soria,1,Abejar,346,193,153
42,Soria,3,Adradas,53,28,25
42,Soria,4,Ágreda,3084,1564,1520
42,Soria,6,Alconaba,198,123,75
42,Soria,7,Alcubilla de Avellaneda,146,75,71
42,Soria,8,Alcubilla de las Peñas,63,39,24
42,Soria,9,Aldealafuente,94,54,40
42,Soria,10,Aldealices,26,16,10
42,Soria,11,Aldealpozo,23,11,12
42,Soria,12,Aldealseñor,44,25,19
42,Soria,13,Aldehuela de Periáñez,39,19,20
42,Soria,14,"Aldehuelas, Las",75,40,35
42,Soria,15,Alentisque,33,19,14
42,Soria,16,Aliud,19,11,8
42,Soria,17,Almajano,193,100,93
42,Soria,18,Almaluez,172,101,71
42,Soria,19,Almarza,610,348,262
42,Soria,20,Almazán,5744,2926,2818
42,Soria,21,Almazul,88,52,36
42,Soria,22,Almenar de Soria,253,149,104
42,Soria,23,Alpanseque,71,38,33
42,Soria,24,Arancón,92,59,33
42,Soria,25,Arcos de Jalón,1707,912,795
42,Soria,26,Arenillas,33,16,17
42,Soria,27,Arévalo de la Sierra,74,49,25
42,Soria,28,Ausejo de la Sierra,78,43,35
42,Soria,29,Baraona,171,98,73
42,Soria,30,Barca,113,68,45
42,Soria,31,Barcones,26,16,10
42,Soria,32,Bayubas de Abajo,162,83,79
42,Soria,33,Bayubas de Arriba,52,32,20
42,Soria,34,Beratón,36,21,15
42,Soria,35,Berlanga de Duero,983,491,492
42,Soria,36,Blacos,50,28,22
42,Soria,37,Bliecos,37,22,15
42,Soria,38,Borjabad,38,23,15
42,Soria,39,Borobia,270,140,130
42,Soria,41,Buberos,36,19,17
42,Soria,42,Buitrago,61,33,28
42,Soria,43,Burgo de Osma-Ciudad de Osma,5153,2593,2560
42,Soria,44,Cabrejas del Campo,63,36,27
42,Soria,45,Cabrejas del Pinar,388,221,167
42,Soria,46,Calatañazor,54,30,24
42,Soria,48,Caltojar,68,41,27
42,Soria,49,Candilichera,135,79,56
42,Soria,50,Cañamaque,34,25,9
42,Soria,51,Carabantes,22,11,11
42,Soria,52,Caracena,15,10,5
42,Soria,53,Carrascosa de Abajo,27,17,10
42,Soria,54,Carrascosa de la Sierra,22,15,7
42,Soria,55,Casarejos,193,98,95
42,Soria,56,Castilfrío de la Sierra,30,20,10
42,Soria,58,Castillejo de Robledo,119,67,52
42,Soria,57,Castilruiz,201,111,90
42,Soria,59,Centenera de Andaluz,22,9,13
42,Soria,60,Cerbón,36,23,13
42,Soria,61,Cidones,335,190,145
42,Soria,62,Cigudosa,32,21,11
42,Soria,63,Cihuela,58,30,28
42,Soria,64,Ciria,95,51,44
42,Soria,65,Cirujales del Río,25,15,10
42,Soria,68,Coscurita,92,55,37
42,Soria,69,Covaleda,1809,930,879
42,Soria,70,Cubilla,42,27,15
42,Soria,71,Cubo de la Solana,184,101,83
42,Soria,73,Cueva de Ágreda,82,49,33
42,Soria,75,Dévanos,93,50,43
42,Soria,76,Deza,246,126,120
42,Soria,78,Duruelo de la Sierra,1225,624,601
42,Soria,79,Escobosa de Almazán,28,19,9
42,Soria,80,Espeja de San Marcelino,173,97,76
42,Soria,81,Espejón,190,100,90
42,Soria,82,Estepa de San Juan,7,5,2
42,Soria,83,Frechilla de Almazán,26,13,13
42,Soria,84,Fresno de Caracena,26,16,10
42,Soria,85,Fuentearmegil,203,116,87
42,Soria,86,Fuentecambrón,42,27,15
42,Soria,87,Fuentecantos,55,26,29
42,Soria,88,Fuentelmonge,79,45,34
42,Soria,89,Fuentelsaz de Soria,57,29,28
42,Soria,90,Fuentepinilla,99,61,38
42,Soria,92,Fuentes de Magaña,83,46,37
42,Soria,93,Fuentestrún,54,32,22
42,Soria,94,Garray,698,380,318
42,Soria,95,Golmayo,2391,1239,1152
42,Soria,96,Gómara,355,202,153
42,Soria,97,Gormaz,24,15,9
42,Soria,98,Herrera de Soria,12,7,5
42,Soria,100,Hinojosa del Campo,33,21,12
42,Soria,103,Langa de Duero,786,426,360
42,Soria,105,Liceras,61,32,29
42,Soria,106,"Losilla, La",16,10,6
42,Soria,107,Magaña,88,53,35
42,Soria,108,Maján,13,7,6
42,Soria,110,Matalebreras,76,44,32
42,Soria,111,Matamala de Almazán,325,175,150
42,Soria,113,Medinaceli,767,367,400
42,Soria,115,Miño de Medinaceli,82,46,36
42,Soria,116,Miño de San Esteban,53,33,20
42,Soria,117,Molinos de Duero,181,95,86
42,Soria,118,Momblona,26,17,9
42,Soria,119,Monteagudo de las Vicarías,229,111,118
42,Soria,120,Montejo de Tiermes,180,119,61
42,Soria,121,Montenegro de Cameros,72,45,27
42,Soria,123,Morón de Almazán,221,113,108
42,Soria,124,Muriel de la Fuente,69,39,30
42,Soria,125,Muriel Viejo,79,47,32
42,Soria,127,Nafría de Ucero,40,24,16
42,Soria,128,Narros,45,23,22
42,Soria,129,Navaleno,846,443,403
42,Soria,130,Nepas,65,41,24
42,Soria,131,Nolay,58,30,28
42,Soria,132,Noviercas,166,86,80
42,Soria,134,Ólvega,3814,1967,1847
42,Soria,135,Oncala,84,48,36
42,Soria,139,Pinilla del Campo,23,13,10
42,Soria,140,Portillo de Soria,17,12,5
42,Soria,141,"Póveda de Soria, La",113,67,46
42,Soria,142,Pozalmuro,76,35,41
42,Soria,144,Quintana Redonda,519,294,225
42,Soria,145,Quintanas de Gormaz,142,85,57
42,Soria,148,Quiñonería,8,4,4
42,Soria,149,"Rábanos, Los",530,305,225
42,Soria,151,Rebollar,40,19,21
42,Soria,152,Recuerda,100,54,46
42,Soria,153,Rello,19,12,7
42,Soria,154,Renieblas,98,62,36
42,Soria,155,Retortillo de Soria,182,103,79
42,Soria,156,Reznos,32,21,11
42,Soria,157,"Riba de Escalote, La",17,11,6
42,Soria,158,Rioseco de Soria,134,78,56
42,Soria,159,Rollamienta,36,24,12
42,Soria,160,"Royo, El",302,162,140
42,Soria,161,Salduero,163,90,73
42,Soria,162,San Esteban de Gormaz,3067,1614,1453
42,Soria,163,San Felices,55,34,21
42,Soria,164,San Leonardo de Yagüe,2219,1142,1077
42,Soria,165,San Pedro Manrique,588,335,253
42,Soria,166,Santa Cruz de Yanguas,72,47,25
42,Soria,167,Santa María de Huerta,314,171,143
42,Soria,168,Santa María de las Hoyas,123,71,52
42,Soria,171,Serón de Nágima,146,80,66
42,Soria,172,Soliedra,36,20,16
42,Soria,173,Soria,39516,18718,20798
42,Soria,174,Sotillo del Rincón,184,99,85
42,Soria,175,Suellacabras,26,15,11
42,Soria,176,Tajahuerce,30,17,13
42,Soria,177,Tajueco,84,46,38
42,Soria,178,Talveila,143,78,65
42,Soria,181,Tardelcuende,452,235,217
42,Soria,182,Taroda,54,28,26
42,Soria,183,Tejado,129,72,57
42,Soria,184,Torlengua,72,37,35
42,Soria,185,Torreblacos,28,15,13
42,Soria,187,Torrubia de Soria,77,52,25
42,Soria,188,Trévago,55,25,30
42,Soria,189,Ucero,65,33,32
42,Soria,190,Vadillo,125,72,53
42,Soria,191,Valdeavellano de Tera,202,116,86
42,Soria,192,Valdegeña,42,29,13
42,Soria,193,Valdelagua del Cerro,19,12,7
42,Soria,194,Valdemaluque,190,90,100
42,Soria,195,Valdenebro,124,73,51
42,Soria,196,Valdeprado,14,10,4
42,Soria,197,Valderrodilla,83,46,37
42,Soria,198,Valtajeros,22,13,9
42,Soria,200,Velamazán,90,58,32
42,Soria,201,Velilla de la Sierra,26,16,10
42,Soria,202,Velilla de los Ajos,27,17,10
42,Soria,204,Viana de Duero,58,42,16
42,Soria,205,Villaciervos,99,62,37
42,Soria,206,Villanueva de Gormaz,9,6,3
42,Soria,207,Villar del Ala,52,25,27
42,Soria,208,Villar del Campo,25,16,9
42,Soria,209,Villar del Río,162,105,57
42,Soria,211,"Villares de Soria, Los",92,53,39
42,Soria,212,Villasayas,80,53,27
42,Soria,213,Villaseca de Arciel,38,20,18
42,Soria,215,Vinuesa,945,509,436
42,Soria,216,Vizmanos,29,20,9
42,Soria,217,Vozmediano,39,24,15
42,Soria,218,Yanguas,121,78,43
42,Soria,219,Yelo,52,27,25
43,Tarragona,1,Aiguamúrcia,909,487,422
43,Tarragona,2,Albinyana,2335,1181,1154
43,Tarragona,3,"Albiol, L'",458,234,224
43,Tarragona,4,Alcanar,9637,4922,4715
43,Tarragona,5,Alcover,5131,2573,2558
43,Tarragona,904,"Aldea, L'",4376,2318,2058
43,Tarragona,6,Aldover,940,475,465
43,Tarragona,7,"Aleixar, L'",891,450,441
43,Tarragona,8,Alfara de Carles,395,211,184
43,Tarragona,9,Alforja,1859,946,913
43,Tarragona,10,Alió,432,210,222
43,Tarragona,11,Almoster,1396,691,705
43,Tarragona,12,Altafulla,4988,2451,2537
43,Tarragona,13,"Ametlla de Mar, L'",7303,3703,3600
43,Tarragona,906,"Ampolla, L'",3479,1772,1707
43,Tarragona,14,Amposta,21197,10713,10484
43,Tarragona,16,"Arboç, L'",5515,2865,2650
43,Tarragona,15,Arbolí,105,59,46
43,Tarragona,17,"Argentera, L'",146,81,65
43,Tarragona,18,Arnes,474,242,232
43,Tarragona,19,Ascó,1654,862,792
43,Tarragona,20,Banyeres del Penedès,3057,1552,1505
43,Tarragona,21,Barberà de la Conca,519,281,238
43,Tarragona,22,Batea,1975,983,992
43,Tarragona,23,Bellmunt del Priorat,307,156,151
43,Tarragona,24,Bellvei,2174,1121,1053
43,Tarragona,25,Benifallet,703,358,345
43,Tarragona,26,Benissanet,1247,677,570
43,Tarragona,27,"Bisbal de Falset, La",216,119,97
43,Tarragona,28,"Bisbal del Penedès, La",3495,1835,1660
43,Tarragona,29,Blancafort,413,214,199
43,Tarragona,30,Bonastre,622,321,301
43,Tarragona,31,"Borges del Camp, Les",2077,1040,1037
43,Tarragona,32,Bot,630,327,303
43,Tarragona,33,Botarell,1100,576,524
43,Tarragona,34,Bràfim,660,332,328
43,Tarragona,35,Cabacés,326,163,163
43,Tarragona,36,Cabra del Camp,1115,588,527
43,Tarragona,37,Calafell,24333,12210,12123
43,Tarragona,903,Camarles,3514,1804,1710
43,Tarragona,38,Cambrils,33301,16429,16872
43,Tarragona,907,"Canonja, La",5807,2896,2911
43,Tarragona,39,Capafonts,114,57,57
43,Tarragona,40,Capçanes,411,203,208
43,Tarragona,41,Caseres,267,134,133
43,Tarragona,42,Castellvell del Camp,2869,1434,1435
43,Tarragona,43,"Catllar, El",4222,2178,2044
43,Tarragona,45,Colldejou,172,93,79
43,Tarragona,46,Conesa,122,62,60
43,Tarragona,47,Constantí,6539,3396,3143
43,Tarragona,48,Corbera d'Ebre,1136,604,532
43,Tarragona,49,Cornudella de Montsant,954,509,445
43,Tarragona,50,Creixell,3480,1769,1711
43,Tarragona,51,Cunit,11989,5969,6020
43,Tarragona,901,Deltebre,11831,5957,5874
43,Tarragona,53,Duesaigües,239,133,106
43,Tarragona,54,"Espluga de Francolí, L'",3836,1867,1969
43,Tarragona,55,Falset,2838,1429,1409
43,Tarragona,56,"Fatarella, La",1051,524,527
43,Tarragona,57,"Febró, La",40,29,11
43,Tarragona,58,"Figuera, La",118,66,52
43,Tarragona,59,Figuerola del Camp,345,165,180
43,Tarragona,60,Flix,3795,1887,1908
43,Tarragona,61,Forès,46,25,21
43,Tarragona,62,Freginals,405,213,192
43,Tarragona,63,"Galera, La",800,409,391
43,Tarragona,64,Gandesa,3091,1590,1501
43,Tarragona,65,Garcia,559,288,271
43,Tarragona,66,"Garidells, Els",182,89,93
43,Tarragona,67,Ginestar,819,422,397
43,Tarragona,68,Godall,673,340,333
43,Tarragona,69,Gratallops,243,129,114
43,Tarragona,70,"Guiamets, Els",292,134,158
43,Tarragona,71,Horta de Sant Joan,1219,633,586
43,Tarragona,72,"Lloar, El",110,58,52
43,Tarragona,73,Llorac,112,61,51
43,Tarragona,74,Llorenç del Penedès,2306,1130,1176
43,Tarragona,76,Marçà,611,316,295
43,Tarragona,75,Margalef,108,65,43
43,Tarragona,77,Mas de Barberans,619,306,313
43,Tarragona,78,Masdenverge,1106,571,535
43,Tarragona,79,Masllorenç,519,280,239
43,Tarragona,80,"Masó, La",288,153,135
43,Tarragona,81,Maspujols,782,403,379
43,Tarragona,82,"Masroig, El",534,283,251
43,Tarragona,83,"Milà, El",174,86,88
43,Tarragona,84,Miravet,774,416,358
43,Tarragona,85,"Molar, El",293,160,133
43,Tarragona,86,Montblanc,7359,3725,3634
43,Tarragona,88,Montbrió del Camp,2650,1349,1301
43,Tarragona,89,Montferri,369,203,166
43,Tarragona,90,"Montmell, El",1418,769,649
43,Tarragona,91,Mont-ral,165,96,69
43,Tarragona,92,Mont-roig del Camp,12148,6361,5787
43,Tarragona,93,Móra d'Ebre,5578,2750,2828
43,Tarragona,94,Móra la Nova,3190,1613,1577
43,Tarragona,95,"Morell, El",3530,1817,1713
43,Tarragona,96,"Morera de Montsant, La",157,94,63
43,Tarragona,97,"Nou de Gaià, La",548,273,275
43,Tarragona,98,Nulles,453,232,221
43,Tarragona,100,"Pallaresos, Els",4479,2283,2196
43,Tarragona,99,"Palma d'Ebre, La",371,173,198
43,Tarragona,101,Passanant i Belltall,154,86,68
43,Tarragona,102,Paüls,596,290,306
43,Tarragona,103,Perafort,1287,686,601
43,Tarragona,104,"Perelló, El",3155,1648,1507
43,Tarragona,105,"Piles, Les",214,113,101
43,Tarragona,106,"Pinell de Brai, El",1076,551,525
43,Tarragona,107,Pira,480,251,229
43,Tarragona,108,"Pla de Santa Maria, El",2344,1220,1124
43,Tarragona,109,"Pobla de Mafumet, La",3420,1763,1657
43,Tarragona,110,"Pobla de Massaluca, La",354,186,168
43,Tarragona,111,"Pobla de Montornès, La",2860,1499,1361
43,Tarragona,112,Poboleda,361,195,166
43,Tarragona,113,"Pont d'Armentera, El",561,289,272
43,Tarragona,141,Pontils,123,68,55
43,Tarragona,114,Porrera,461,253,208
43,Tarragona,115,Pradell de la Teixeta,181,81,100
43,Tarragona,116,Prades,626,321,305
43,Tarragona,117,Prat de Comte,164,88,76
43,Tarragona,118,Pratdip,685,368,317
43,Tarragona,119,Puigpelat,1083,563,520
43,Tarragona,120,Querol,550,305,245
43,Tarragona,121,Rasquera,858,430,428
43,Tarragona,122,Renau,141,71,70
43,Tarragona,123,Reus,104962,51081,53881
43,Tarragona,124,"Riba, La",601,321,280
43,Tarragona,125,Riba-roja d'Ebre,1195,632,563
43,Tarragona,126,"Riera de Gaià, La",1678,845,833
43,Tarragona,127,Riudecanyes,1142,594,548
43,Tarragona,128,Riudecols,1254,654,600
43,Tarragona,129,Riudoms,6546,3360,3186
43,Tarragona,130,Rocafort de Queralt,256,135,121
43,Tarragona,131,Roda de Berà,6322,3272,3050
43,Tarragona,132,Rodonyà,513,269,244
43,Tarragona,133,Roquetes,8287,4281,4006
43,Tarragona,134,"Rourell, El",394,200,194
43,Tarragona,135,Salomó,539,284,255
43,Tarragona,905,Salou,26558,13982,12576
43,Tarragona,136,Sant Carles de la Ràpita,15003,7392,7611
43,Tarragona,137,Sant Jaume dels Domenys,2493,1279,1214
43,Tarragona,902,Sant Jaume d'Enveja,3555,1806,1749
43,Tarragona,138,Santa Bàrbara,3821,1950,1871
43,Tarragona,139,Santa Coloma de Queralt,2931,1448,1483
43,Tarragona,140,Santa Oliva,3287,1667,1620
43,Tarragona,142,Sarral,1595,830,765
43,Tarragona,143,Savallà del Comtat,65,30,35
43,Tarragona,144,"Secuita, La",1665,837,828
43,Tarragona,145,"Selva del Camp, La",5598,2818,2780
43,Tarragona,146,Senan,53,33,20
43,Tarragona,44,"Sénia, La",5893,2984,2909
43,Tarragona,147,Solivella,653,330,323
43,Tarragona,148,Tarragona,132199,64652,67547
43,Tarragona,149,Tivenys,876,449,427
43,Tarragona,150,Tivissa,1760,871,889
43,Tarragona,151,"Torre de Fontaubella, La",126,67,59
43,Tarragona,152,"Torre de l'Espanyol, La",676,351,325
43,Tarragona,153,Torredembarra,15475,7622,7853
43,Tarragona,154,Torroja del Priorat,160,89,71
43,Tarragona,155,Tortosa,33932,16997,16935
43,Tarragona,156,Ulldecona,6904,3551,3353
43,Tarragona,157,Ulldemolins,412,230,182
43,Tarragona,158,Vallclara,116,64,52
43,Tarragona,159,Vallfogona de Riucorb,99,59,40
43,Tarragona,160,Vallmoll,1670,854,816
43,Tarragona,161,Valls,24570,12263,12307
43,Tarragona,162,Vandellòs i l'Hospitalet de l'Infant,6047,3011,3036
43,Tarragona,163,"Vendrell, El",36719,18345,18374
43,Tarragona,164,Vespella de Gaià,417,222,195
43,Tarragona,165,Vilabella,805,416,389
43,Tarragona,175,Vilalba dels Arcs,682,352,330
43,Tarragona,166,Vilallonga del Camp,2229,1138,1091
43,Tarragona,168,Vilanova de Prades,126,63,63
43,Tarragona,167,Vilanova d'Escornalbou,540,292,248
43,Tarragona,169,Vilaplana,630,325,305
43,Tarragona,170,Vila-rodona,1264,641,623
43,Tarragona,171,Vila-seca,21923,11118,10805
43,Tarragona,172,Vilaverd,487,252,235
43,Tarragona,173,"Vilella Alta, La",129,70,59
43,Tarragona,174,"Vilella Baixa, La",202,107,95
43,Tarragona,176,Vimbodí i Poblet,964,539,425
43,Tarragona,177,Vinebre,449,228,221
43,Tarragona,178,Vinyols i els Arcs,1872,960,912
43,Tarragona,52,Xerta,1250,606,644
44,Teruel,1,Ababuj,65,41,24
44,Teruel,2,Abejuela,41,27,14
44,Teruel,3,Aguatón,18,7,11
44,Teruel,4,Aguaviva,605,301,304
44,Teruel,5,Aguilar del Alfambra,77,46,31
44,Teruel,6,Alacón,314,158,156
44,Teruel,7,Alba,212,113,99
44,Teruel,8,Albalate del Arzobispo,2025,1031,994
44,Teruel,9,Albarracín,1059,545,514
44,Teruel,10,Albentosa,279,144,135
44,Teruel,11,Alcaine,72,44,28
44,Teruel,12,Alcalá de la Selva,424,229,195
44,Teruel,13,Alcañiz,16333,8153,8180
44,Teruel,14,Alcorisa,3433,1752,1681
44,Teruel,16,Alfambra,587,306,281
44,Teruel,17,Aliaga,358,201,157
44,Teruel,21,Allepuz,117,57,60
44,Teruel,22,Alloza,638,322,316
44,Teruel,23,Allueva,15,10,5
44,Teruel,18,Almohaja,21,16,5
44,Teruel,19,Alobras,75,44,31
44,Teruel,20,Alpeñés,19,11,8
44,Teruel,24,Anadón,24,14,10
44,Teruel,25,Andorra,8148,4161,3987
44,Teruel,26,Arcos de las Salinas,100,57,43
44,Teruel,27,Arens de Lledó,208,98,110
44,Teruel,28,Argente,217,103,114
44,Teruel,29,Ariño,775,390,385
44,Teruel,31,Azaila,119,60,59
44,Teruel,32,Bádenas,19,11,8
44,Teruel,33,Báguena,337,186,151
44,Teruel,34,Bañón,154,85,69
44,Teruel,35,Barrachina,137,74,63
44,Teruel,36,Bea,28,18,10
44,Teruel,37,Beceite,583,301,282
44,Teruel,39,Bello,244,120,124
44,Teruel,38,Belmonte de San José,120,59,61
44,Teruel,40,Berge,247,128,119
44,Teruel,41,Bezas,77,40,37
44,Teruel,42,Blancas,152,85,67
44,Teruel,43,Blesa,109,66,43
44,Teruel,44,Bordón,114,67,47
44,Teruel,45,Bronchales,427,246,181
44,Teruel,46,Bueña,62,31,31
44,Teruel,47,Burbáguena,281,140,141
44,Teruel,48,Cabra de Mora,70,43,27
44,Teruel,49,Calaceite,1076,560,516
44,Teruel,50,Calamocha,4469,2213,2256
44,Teruel,51,Calanda,3920,1911,2009
44,Teruel,52,Calomarde,88,50,38
44,Teruel,53,Camañas,128,70,58
44,Teruel,54,Camarena de la Sierra,137,83,54
44,Teruel,55,Camarillas,103,63,40
44,Teruel,56,Caminreal,684,356,328
44,Teruel,59,Cantavieja,724,377,347
44,Teruel,60,Cañada de Benatanduz,41,26,15
44,Teruel,61,"Cañada de Verich, La",102,58,44
44,Teruel,62,Cañada Vellida,37,27,10
44,Teruel,63,Cañizar del Olivar,99,53,46
44,Teruel,64,Cascante del Río,82,51,31
44,Teruel,65,Castejón de Tornos,63,38,25
44,Teruel,66,Castel de Cabra,128,66,62
44,Teruel,70,"Castellar, El",60,37,23
44,Teruel,71,Castellote,754,390,364
44,Teruel,67,Castelnou,140,74,66
44,Teruel,68,Castelserás,830,433,397
44,Teruel,74,Cedrillas,619,316,303
44,Teruel,75,Celadas,399,222,177
44,Teruel,76,Cella,2818,1478,1340
44,Teruel,77,"Cerollera, La",106,65,41
44,Teruel,80,"Codoñera, La",374,197,177
44,Teruel,82,Corbalán,106,59,47
44,Teruel,84,Cortes de Aragón,61,28,33
44,Teruel,85,Cosa,56,33,23
44,Teruel,86,Cretas,601,301,300
44,Teruel,87,Crivillén,75,38,37
44,Teruel,88,"Cuba, La",45,25,20
44,Teruel,89,Cubla,55,34,21
44,Teruel,90,Cucalón,103,61,42
44,Teruel,92,"Cuervo, El",85,46,39
44,Teruel,93,Cuevas de Almudén,145,86,59
44,Teruel,94,Cuevas Labradas,127,71,56
44,Teruel,96,Ejulve,194,102,92
44,Teruel,97,Escorihuela,160,79,81
44,Teruel,99,Escucha,981,543,438
44,Teruel,100,Estercuel,230,132,98
44,Teruel,101,Ferreruela de Huerva,64,35,29
44,Teruel,102,Fonfría,30,17,13
44,Teruel,103,Formiche Alto,168,91,77
44,Teruel,105,Fórnoles,78,40,38
44,Teruel,106,Fortanete,201,114,87
44,Teruel,107,Foz-Calanda,269,149,120
44,Teruel,108,"Fresneda, La",468,266,202
44,Teruel,109,Frías de Albarracín,144,82,62
44,Teruel,110,Fuenferrada,62,36,26
44,Teruel,111,Fuentes Calientes,111,61,50
44,Teruel,112,Fuentes Claras,531,292,239
44,Teruel,113,Fuentes de Rubielos,121,66,55
44,Teruel,114,Fuentespalda,299,151,148
44,Teruel,115,Galve,164,86,78
44,Teruel,116,Gargallo,110,59,51
44,Teruel,117,Gea de Albarracín,397,207,190
44,Teruel,118,"Ginebrosa, La",206,117,89
44,Teruel,119,Griegos,142,87,55
44,Teruel,120,Guadalaviar,248,142,106
44,Teruel,121,Gúdar,76,41,35
44,Teruel,122,Híjar,1763,891,872
44,Teruel,123,Hinojosa de Jarque,136,79,57
44,Teruel,124,"Hoz de la Vieja, La",81,44,37
44,Teruel,125,Huesa del Común,73,44,29
44,Teruel,126,"Iglesuela del Cid, La",462,240,222
44,Teruel,127,Jabaloyas,73,43,30
44,Teruel,128,Jarque de la Val,82,45,37
44,Teruel,129,Jatiel,48,26,22
44,Teruel,130,Jorcas,37,22,15
44,Teruel,131,Josa,36,21,15
44,Teruel,132,Lagueruela,78,39,39
44,Teruel,133,Lanzuela,30,22,8
44,Teruel,135,Libros,129,77,52
44,Teruel,136,Lidón,54,28,26
44,Teruel,137,Linares de Mora,274,156,118
44,Teruel,141,Lledó,169,94,75
44,Teruel,138,Loscos,154,94,60
44,Teruel,142,Maicas,35,19,16
44,Teruel,143,Manzanera,526,276,250
44,Teruel,144,Martín del Río,437,225,212
44,Teruel,145,Mas de las Matas,1324,684,640
44,Teruel,146,"Mata de los Olmos, La",268,134,134
44,Teruel,147,Mazaleón,540,294,246
44,Teruel,148,Mezquita de Jarque,117,66,51
44,Teruel,149,Mirambel,117,64,53
44,Teruel,150,Miravete de la Sierra,34,23,11
44,Teruel,151,Molinos,264,145,119
44,Teruel,152,Monforte de Moyuela,63,44,19
44,Teruel,153,Monreal del Campo,2636,1310,1326
44,Teruel,154,Monroyo,364,222,142
44,Teruel,155,Montalbán,1335,674,661
44,Teruel,156,Monteagudo del Castillo,55,29,26
44,Teruel,157,Monterde de Albarracín,73,41,32
44,Teruel,158,Mora de Rubielos,1612,820,792
44,Teruel,159,Moscardón,60,31,29
44,Teruel,160,Mosqueruela,601,324,277
44,Teruel,161,Muniesa,638,331,307
44,Teruel,163,Noguera de Albarracín,137,71,66
44,Teruel,164,Nogueras,30,21,9
44,Teruel,165,Nogueruelas,214,118,96
44,Teruel,167,Obón,42,25,17
44,Teruel,168,Odón,237,123,114
44,Teruel,169,Ojos Negros,421,233,188
44,Teruel,171,Olba,263,148,115
44,Teruel,172,Oliete,422,222,200
44,Teruel,173,"Olmos, Los",130,70,60
44,Teruel,174,Orihuela del Tremedal,539,289,250
44,Teruel,175,Orrios,140,71,69
44,Teruel,176,Palomar de Arroyos,184,107,77
44,Teruel,177,Pancrudo,117,71,46
44,Teruel,178,"Parras de Castellote, Las",58,32,26
44,Teruel,179,Peñarroya de Tastavins,487,266,221
44,Teruel,180,Peracense,69,41,28
44,Teruel,181,Peralejos,85,43,42
44,Teruel,182,Perales del Alfambra,253,133,120
44,Teruel,183,Pitarque,93,46,47
44,Teruel,184,Plou,46,28,18
44,Teruel,185,"Pobo, El",148,92,56
44,Teruel,187,"Portellada, La",234,119,115
44,Teruel,189,Pozondón,63,33,30
44,Teruel,190,Pozuel del Campo,81,41,40
44,Teruel,191,"Puebla de Híjar, La",965,483,482
44,Teruel,192,"Puebla de Valverde, La",521,286,235
44,Teruel,193,Puertomingalvo,117,65,52
44,Teruel,194,Ráfales,142,75,67
44,Teruel,195,Rillo,106,59,47
44,Teruel,196,Riodeva,165,83,82
44,Teruel,197,Ródenas,75,45,30
44,Teruel,198,Royuela,227,127,100
44,Teruel,199,Rubiales,51,29,22
44,Teruel,200,Rubielos de la Cérida,41,22,19
44,Teruel,201,Rubielos de Mora,687,345,342
44,Teruel,203,Salcedillo,10,8,2
44,Teruel,204,Saldón,27,16,11
44,Teruel,205,Samper de Calanda,861,426,435
44,Teruel,206,San Agustín,141,89,52
44,Teruel,207,San Martín del Río,179,90,89
44,Teruel,208,Santa Cruz de Nogueras,42,21,21
44,Teruel,209,Santa Eulalia,1111,560,551
44,Teruel,210,Sarrión,1152,615,537
44,Teruel,211,Segura de los Baños,39,25,14
44,Teruel,212,Seno,42,22,20
44,Teruel,213,Singra,76,43,33
44,Teruel,215,Terriente,177,100,77
44,Teruel,216,Teruel,35675,17152,18523
44,Teruel,217,Toril y Masegoso,32,27,5
44,Teruel,218,Tormón,28,18,10
44,Teruel,219,Tornos,231,121,110
44,Teruel,220,Torralba de los Sisones,170,94,76
44,Teruel,223,Torre de Arcas,83,39,44
44,Teruel,224,Torre de las Arcas,28,14,14
44,Teruel,225,Torre del Compte,142,72,70
44,Teruel,227,Torre los Negros,94,49,45
44,Teruel,221,Torrecilla de Alcañiz,415,219,196
44,Teruel,222,Torrecilla del Rebollar,142,86,56
44,Teruel,226,Torrelacárcel,197,103,94
44,Teruel,228,Torremocha de Jiloca,126,70,56
44,Teruel,229,Torres de Albarracín,174,97,77
44,Teruel,230,Torrevelilla,208,105,103
44,Teruel,231,Torrijas,45,20,25
44,Teruel,232,Torrijo del Campo,509,268,241
44,Teruel,234,Tramacastiel,74,43,31
44,Teruel,235,Tramacastilla,120,57,63
44,Teruel,236,Tronchón,82,46,36
44,Teruel,237,Urrea de Gaén,494,245,249
44,Teruel,238,Utrillas,3194,1658,1536
44,Teruel,239,Valacloche,23,16,7
44,Teruel,240,Valbona,198,110,88
44,Teruel,241,Valdealgorfa,650,317,333
44,Teruel,243,Valdecuenca,40,26,14
44,Teruel,244,Valdelinares,90,54,36
44,Teruel,245,Valdeltormo,315,158,157
44,Teruel,246,Valderrobres,2337,1197,1140
44,Teruel,247,Valjunquera,365,189,176
44,Teruel,249,"Vallecillo, El",50,31,19
44,Teruel,250,Veguillas de la Sierra,23,14,9
44,Teruel,251,Villafranca del Campo,314,161,153
44,Teruel,252,Villahermosa del Campo,104,65,39
44,Teruel,256,Villanueva del Rebollar de la Sierra,52,30,22
44,Teruel,257,Villar del Cobo,190,105,85
44,Teruel,258,Villar del Salz,75,44,31
44,Teruel,260,Villarluengo,194,117,77
44,Teruel,261,Villarquemado,886,463,423
44,Teruel,262,Villarroya de los Pinares,160,84,76
44,Teruel,263,Villastar,522,267,255
44,Teruel,264,Villel,348,204,144
44,Teruel,265,Vinaceite,274,153,121
44,Teruel,266,Visiedo,137,63,74
44,Teruel,267,Vivel del Río Martín,78,41,37
44,Teruel,268,"Zoma, La",19,7,12
45,Toledo,1,Ajofrín,2336,1160,1176
45,Toledo,2,Alameda de la Sagra,3509,1831,1678
45,Toledo,3,Albarreal de Tajo,734,385,349
45,Toledo,4,Alcabón,710,374,336
45,Toledo,5,Alcañizo,304,160,144
45,Toledo,6,Alcaudete de la Jara,1955,973,982
45,Toledo,7,Alcolea de Tajo,875,448,427
45,Toledo,8,Aldea en Cabo,185,98,87
45,Toledo,9,Aldeanueva de Barbarroya,627,311,316
45,Toledo,10,Aldeanueva de San Bartolomé,473,237,236
45,Toledo,11,Almendral de la Cañada,336,183,153
45,Toledo,12,Almonacid de Toledo,843,424,419
45,Toledo,13,Almorox,2307,1217,1090
45,Toledo,14,Añover de Tajo,5224,2678,2546
45,Toledo,15,Arcicóllar,798,396,402
45,Toledo,16,Argés,5900,2956,2944
45,Toledo,17,Azután,285,139,146
45,Toledo,18,Barcience,725,382,343
45,Toledo,19,Bargas,10002,5002,5000
45,Toledo,20,Belvís de la Jara,1698,845,853
45,Toledo,21,Borox,3561,1872,1689
45,Toledo,22,Buenaventura,462,242,220
45,Toledo,23,Burguillos de Toledo,3002,1531,1471
45,Toledo,24,Burujón,1435,754,681
45,Toledo,25,Cabañas de la Sagra,1825,958,867
45,Toledo,26,Cabañas de Yepes,278,142,136
45,Toledo,27,Cabezamesada,403,224,179
45,Toledo,28,Calera y Chozas,4740,2405,2335
45,Toledo,29,Caleruela,235,126,109
45,Toledo,30,Calzada de Oropesa,556,297,259
45,Toledo,31,Camarena,3788,1984,1804
45,Toledo,32,Camarenilla,553,283,270
45,Toledo,33,"Campillo de la Jara, El",410,211,199
45,Toledo,34,Camuñas,1841,941,900
45,Toledo,35,Cardiel de los Montes,388,213,175
45,Toledo,36,Carmena,790,413,377
45,Toledo,37,"Carpio de Tajo, El",2076,1025,1051
45,Toledo,38,Carranque,4619,2378,2241
45,Toledo,39,Carriches,304,161,143
45,Toledo,40,"Casar de Escalona, El",2037,1089,948
45,Toledo,41,Casarrubios del Monte,5354,2853,2501
45,Toledo,42,Casasbuenas,209,103,106
45,Toledo,43,Castillo de Bayuela,957,492,465
45,Toledo,45,Cazalegas,1832,949,883
45,Toledo,46,Cebolla,3607,1835,1772
45,Toledo,47,Cedillo del Condado,3654,1925,1729
45,Toledo,48,"Cerralbos, Los",414,229,185
45,Toledo,49,Cervera de los Montes,520,267,253
45,Toledo,56,Chozas de Canales,3786,1995,1791
45,Toledo,57,Chueca,271,149,122
45,Toledo,50,Ciruelos,611,322,289
45,Toledo,51,Cobeja,2207,1141,1066
45,Toledo,52,Cobisa,4143,2092,2051
45,Toledo,53,Consuegra,10516,5297,5219
45,Toledo,54,Corral de Almaguer,5590,2845,2745
45,Toledo,55,Cuerva,1490,784,706
45,Toledo,58,Domingo Pérez,474,237,237
45,Toledo,59,Dosbarrios,2302,1172,1130
45,Toledo,60,Erustes,238,127,111
45,Toledo,61,Escalona,3349,1736,1613
45,Toledo,62,Escalonilla,1478,734,744
45,Toledo,63,Espinoso del Rey,532,295,237
45,Toledo,64,Esquivias,5432,2742,2690
45,Toledo,65,"Estrella, La",275,140,135
45,Toledo,66,Fuensalida,11132,5673,5459
45,Toledo,67,Gálvez,3176,1613,1563
45,Toledo,68,Garciotum,178,90,88
45,Toledo,69,Gerindote,2341,1212,1129
45,Toledo,70,Guadamur,1846,934,912
45,Toledo,71,"Guardia, La",2387,1207,1180
45,Toledo,72,"Herencias, Las",839,440,399
45,Toledo,73,Herreruela de Oropesa,380,183,197
45,Toledo,74,Hinojosa de San Vicente,426,236,190
45,Toledo,75,Hontanar,164,94,70
45,Toledo,76,Hormigos,741,407,334
45,Toledo,77,Huecas,656,346,310
45,Toledo,78,Huerta de Valdecarábanos,1817,896,921
45,Toledo,79,"Iglesuela, La",448,238,210
45,Toledo,80,Illán de Vacas,3,2,1
45,Toledo,81,Illescas,25721,13082,12639
45,Toledo,82,Lagartera,1505,753,752
45,Toledo,83,Layos,652,335,317
45,Toledo,84,Lillo,2898,1490,1408
45,Toledo,85,Lominchar,2365,1244,1121
45,Toledo,86,Lucillos,648,330,318
45,Toledo,87,Madridejos,10970,5513,5457
45,Toledo,88,Magán,3240,1690,1550
45,Toledo,89,Malpica de Tajo,1911,970,941
45,Toledo,90,Manzaneque,402,196,206
45,Toledo,91,Maqueda,498,248,250
45,Toledo,92,Marjaliza,297,148,149
45,Toledo,93,Marrupe,161,82,79
45,Toledo,94,Mascaraque,495,252,243
45,Toledo,95,"Mata, La",964,489,475
45,Toledo,96,Mazarambroz,1282,656,626
45,Toledo,97,Mejorada,1320,687,633
45,Toledo,98,Menasalbas,2938,1545,1393
45,Toledo,99,Méntrida,4976,2576,2400
45,Toledo,100,Mesegar de Tajo,225,120,105
45,Toledo,101,Miguel Esteban,5243,2612,2631
45,Toledo,102,Mocejón,4842,2455,2387
45,Toledo,103,Mohedas de la Jara,457,247,210
45,Toledo,104,Montearagón,545,283,262
45,Toledo,105,Montesclaros,445,238,207
45,Toledo,106,Mora,10315,5227,5088
45,Toledo,107,Nambroca,4386,2241,2145
45,Toledo,108,"Nava de Ricomalillo, La",594,302,292
45,Toledo,109,Navahermosa,3972,2059,1913
45,Toledo,110,Navalcán,2155,1149,1006
45,Toledo,111,Navalmoralejo,70,35,35
45,Toledo,112,"Navalmorales, Los",2835,1492,1343
45,Toledo,113,"Navalucillos, Los",2426,1256,1170
45,Toledo,114,Navamorcuende,672,347,325
45,Toledo,115,Noblejas,3589,1832,1757
45,Toledo,116,Noez,949,494,455
45,Toledo,117,Nombela,986,503,483
45,Toledo,118,Novés,2746,1420,1326
45,Toledo,119,Numancia de la Sagra,4801,2522,2279
45,Toledo,120,Nuño Gómez,153,84,69
45,Toledo,121,Ocaña,11093,5691,5402
45,Toledo,122,Olías del Rey,7152,3675,3477
45,Toledo,123,Ontígola,4046,2185,1861
45,Toledo,124,Orgaz,2727,1364,1363
45,Toledo,125,Oropesa,2818,1383,1435
45,Toledo,126,Otero,388,192,196
45,Toledo,127,Palomeque,825,452,373
45,Toledo,128,Pantoja,3424,1723,1701
45,Toledo,129,Paredes de Escalona,158,82,76
45,Toledo,130,Parrillas,374,194,180
45,Toledo,131,Pelahustán,349,190,159
45,Toledo,132,Pepino,2643,1376,1267
45,Toledo,133,Polán,3952,1969,1983
45,Toledo,134,Portillo de Toledo,2210,1107,1103
45,Toledo,135,"Puebla de Almoradiel, La",5653,2863,2790
45,Toledo,136,"Puebla de Montalbán, La",8179,4142,4037
45,Toledo,137,"Pueblanueva, La",2352,1189,1163
45,Toledo,138,"Puente del Arzobispo, El",1340,655,685
45,Toledo,139,Puerto de San Vicente,202,103,99
45,Toledo,140,Pulgar,1639,852,787
45,Toledo,141,Quero,1145,579,566
45,Toledo,142,Quintanar de la Orden,11987,6080,5907
45,Toledo,143,Quismondo,1594,818,776
45,Toledo,144,"Real de San Vicente, El",1011,542,469
45,Toledo,145,Recas,4246,2361,1885
45,Toledo,146,Retamoso de la Jara,114,57,57
45,Toledo,147,Rielves,787,394,393
45,Toledo,148,Robledo del Mazo,330,190,140
45,Toledo,149,"Romeral, El",666,328,338
45,Toledo,150,San Bartolomé de las Abiertas,508,272,236
45,Toledo,151,San Martín de Montalbán,822,412,410
45,Toledo,152,San Martín de Pusa,771,405,366
45,Toledo,153,San Pablo de los Montes,1960,996,964
45,Toledo,154,San Román de los Montes,1850,985,865
45,Toledo,155,Santa Ana de Pusa,437,242,195
45,Toledo,156,Santa Cruz de la Zarza,4538,2301,2237
45,Toledo,157,Santa Cruz del Retamar,2998,1550,1448
45,Toledo,158,Santa Olalla,3326,1687,1639
45,Toledo,901,Santo Domingo-Caudilla,1050,551,499
45,Toledo,159,Sartajada,104,58,46
45,Toledo,160,Segurilla,1302,667,635
45,Toledo,161,Seseña,21121,10964,10157
45,Toledo,162,Sevilleja de la Jara,762,413,349
45,Toledo,163,Sonseca,11437,5788,5649
45,Toledo,164,Sotillo de las Palomas,201,110,91
45,Toledo,165,Talavera de la Reina,86779,42132,44647
45,Toledo,166,Tembleque,2179,1111,1068
45,Toledo,167,"Toboso, El",2039,1021,1018
45,Toledo,168,Toledo,83334,39872,43462
45,Toledo,169,Torralba de Oropesa,254,132,122
45,Toledo,171,"Torre de Esteban Hambrán, La",1763,917,846
45,Toledo,170,Torrecilla de la Jara,260,132,128
45,Toledo,172,Torrico,811,415,396
45,Toledo,173,Torrijos,13241,6554,6687
45,Toledo,174,Totanés,396,207,189
45,Toledo,175,Turleque,850,430,420
45,Toledo,176,Ugena,5357,2768,2589
45,Toledo,177,Urda,2920,1464,1456
45,Toledo,179,Valdeverdeja,673,327,346
45,Toledo,180,Valmojado,4178,2136,2042
45,Toledo,181,Velada,2899,1510,1389
45,Toledo,182,"Ventas con Peña Aguilera, Las",1189,616,573
45,Toledo,183,"Ventas de Retamosa, Las",3389,1786,1603
45,Toledo,184,"Ventas de San Julián, Las",258,123,135
45,Toledo,186,"Villa de Don Fadrique, La",3962,1960,2002
45,Toledo,185,Villacañas,10089,5027,5062
45,Toledo,187,Villafranca de los Caballeros,5259,2617,2642
45,Toledo,188,Villaluenga de la Sagra,3963,1974,1989
45,Toledo,189,Villamiel de Toledo,894,478,416
45,Toledo,190,Villaminaya,565,289,276
45,Toledo,191,Villamuelas,692,358,334
45,Toledo,192,Villanueva de Alcardete,3553,1841,1712
45,Toledo,193,Villanueva de Bogas,787,403,384
45,Toledo,194,Villarejo de Montalbán,76,40,36
45,Toledo,195,Villarrubia de Santiago,2716,1366,1350
45,Toledo,196,Villaseca de la Sagra,1844,934,910
45,Toledo,197,Villasequilla,2587,1335,1252
45,Toledo,198,Villatobas,2606,1345,1261
45,Toledo,199,"Viso de San Juan, El",4261,2268,1993
45,Toledo,200,"Yébenes, Los",6158,3162,2996
45,Toledo,201,Yeles,5109,2710,2399
45,Toledo,202,Yepes,5070,2601,2469
45,Toledo,203,Yuncler,3600,1833,1767
45,Toledo,204,Yunclillos,866,465,401
45,Toledo,205,Yuncos,10566,5469,5097
46,Valencia/València,1,Ademuz,1179,625,554
46,Valencia/València,2,Ador,1411,739,672
46,Valencia/València,4,Agullent,2435,1194,1241
46,Valencia/València,42,Aielo de Malferit,4657,2325,2332
46,Valencia/València,43,Aielo de Rugat,166,87,79
46,Valencia/València,5,Alaquàs,29964,14738,15226
46,Valencia/València,6,Albaida,6031,2989,3042
46,Valencia/València,7,Albal,15935,7945,7990
46,Valencia/València,8,Albalat de la Ribera,3485,1752,1733
46,Valencia/València,9,Albalat dels Sorells,3937,1912,2025
46,Valencia/València,10,Albalat dels Tarongers,1163,617,546
46,Valencia/València,11,Alberic,10826,5462,5364
46,Valencia/València,12,Alborache,1185,622,563
46,Valencia/València,13,Alboraya,23572,11628,11944
46,Valencia/València,14,Albuixech,3920,1914,2006
46,Valencia/València,16,Alcàntera de Xúquer,1350,675,675
46,Valencia/València,15,Alcàsser,9527,4851,4676
46,Valencia/València,18,Alcublas,750,385,365
46,Valencia/València,20,"Alcúdia de Crespins, l'",5231,2599,2632
46,Valencia/València,19,"Alcúdia, l'",11615,5699,5916
46,Valencia/València,21,Aldaia,31000,15493,15507
46,Valencia/València,22,Alfafar,21305,10523,10782
46,Valencia/València,24,Alfara de la Baronia,545,282,263
46,Valencia/València,25,Alfara del Patriarca,3219,1587,1632
46,Valencia/València,26,Alfarp,1553,799,754
46,Valencia/València,27,Alfarrasí,1252,615,637
46,Valencia/València,23,Alfauir,438,220,218
46,Valencia/València,28,Algar de Palancia,495,250,245
46,Valencia/València,29,Algemesí,27808,13807,14001
46,Valencia/València,30,Algimia de Alfara,1043,517,526
46,Valencia/València,31,Alginet,13060,6633,6427
46,Valencia/València,32,Almàssera,7293,3544,3749
46,Valencia/València,33,Almiserà,289,145,144
46,Valencia/València,34,Almoines,2300,1166,1134
46,Valencia/València,35,Almussafes,8744,4411,4333
46,Valencia/València,36,Alpuente,695,382,313
46,Valencia/València,37,"Alqueria de la Comtessa, l'",1521,761,760
46,Valencia/València,17,Alzira,44518,21664,22854
46,Valencia/València,38,Andilla,364,229,135
46,Valencia/València,39,Anna,2655,1325,1330
46,Valencia/València,40,Antella,1343,664,679
46,Valencia/València,41,Aras de los Olmos,386,218,168
46,Valencia/València,3,Atzeneta d'Albaida,1175,609,566
46,Valencia/València,44,Ayora,5359,2696,2663
46,Valencia/València,46,Barx,1317,674,643
46,Valencia/València,45,Barxeta,1606,822,784
46,Valencia/València,47,Bèlgida,694,344,350
46,Valencia/València,48,Bellreguard,4712,2369,2343
46,Valencia/València,49,Bellús,325,161,164
46,Valencia/València,50,Benagéber,212,120,92
46,Valencia/València,51,Benaguasil,11015,5637,5378
46,Valencia/València,52,Benavites,632,299,333
46,Valencia/València,53,Beneixida,686,325,361
46,Valencia/València,54,Benetússer,14529,7111,7418
46,Valencia/València,55,Beniarjó,1815,897,918
46,Valencia/València,56,Beniatjar,250,124,126
46,Valencia/València,57,Benicolet,628,327,301
46,Valencia/València,904,Benicull de Xúquer,996,512,484
46,Valencia/València,60,Benifaió,11819,5860,5959
46,Valencia/València,59,Benifairó de la Valldigna,1616,804,812
46,Valencia/València,58,Benifairó de les Valls,2229,1114,1115
46,Valencia/València,61,Beniflá,451,227,224
46,Valencia/València,62,Benigànim,6183,3134,3049
46,Valencia/València,63,Benimodo,2254,1159,1095
46,Valencia/València,64,Benimuslem,668,344,324
46,Valencia/València,65,Beniparrell,1956,1003,953
46,Valencia/València,66,Benirredrà,1639,796,843
46,Valencia/València,67,Benisanó,2287,1146,1141
46,Valencia/València,68,Benissoda,434,238,196
46,Valencia/València,69,Benisuera,195,101,94
46,Valencia/València,70,Bétera,21846,10983,10863
46,Valencia/València,71,Bicorp,532,271,261
46,Valencia/València,72,Bocairent,4335,2168,2167
46,Valencia/València,73,Bolbaite,1369,684,685
46,Valencia/València,74,Bonrepòs i Mirambell,3507,1733,1774
46,Valencia/València,75,Bufali,175,93,82
46,Valencia/València,76,Bugarra,756,382,374
46,Valencia/València,77,Buñol,9835,4959,4876
46,Valencia/València,78,Burjassot,37641,18214,19427
46,Valencia/València,79,Calles,417,238,179
46,Valencia/València,80,Camporrobles,1319,664,655
46,Valencia/València,81,Canals,13360,6709,6651
46,Valencia/València,82,Canet d'En Berenguer,6296,3237,3059
46,Valencia/València,83,Carcaixent,20613,10185,10428
46,Valencia/València,84,Càrcer,1952,943,1009
46,Valencia/València,85,Carlet,15351,7651,7700
46,Valencia/València,86,Carrícola,99,50,49
46,Valencia/València,87,Casas Altas,149,78,71
46,Valencia/València,88,Casas Bajas,195,98,97
46,Valencia/València,89,Casinos,2829,1458,1371
46,Valencia/València,90,Castelló de Rugat,2302,1169,1133
46,Valencia/València,91,Castellonet de la Conquesta,146,79,67
46,Valencia/València,92,Castielfabib,282,148,134
46,Valencia/València,93,Catadau,2754,1380,1374
46,Valencia/València,94,Catarroja,27478,13623,13855
46,Valencia/València,95,Caudete de las Fuentes,728,392,336
46,Valencia/València,96,Cerdà,386,200,186
46,Valencia/València,107,Chella,2683,1315,1368
46,Valencia/València,106,Chelva,1463,760,703
46,Valencia/València,108,Chera,536,291,245
46,Valencia/València,109,Cheste,8518,4360,4158
46,Valencia/València,111,Chiva,15029,7779,7250
46,Valencia/València,112,Chulilla,664,355,309
46,Valencia/València,97,Cofrentes,1050,537,513
46,Valencia/València,98,Corbera,3231,1606,1625
46,Valencia/València,99,Cortes de Pallás,1012,540,472
46,Valencia/València,100,Cotes,365,182,183
46,Valencia/València,105,Cullera,22461,11216,11245
46,Valencia/València,113,Daimús,3062,1536,1526
46,Valencia/València,114,Domeño,698,356,342
46,Valencia/València,115,Dos Aguas,418,234,184
46,Valencia/València,116,"Eliana, l'",17501,8641,8860
46,Valencia/València,117,Emperador,684,357,327
46,Valencia/València,118,Enguera,5291,2653,2638
46,Valencia/València,119,"Ènova, l'",977,497,480
46,Valencia/València,120,Estivella,1387,681,706
46,Valencia/València,121,Estubeny,124,61,63
46,Valencia/València,122,Faura,3556,1798,1758
46,Valencia/València,123,Favara,2430,1222,1208
46,Valencia/València,126,Foios,7094,3455,3639
46,Valencia/València,128,"Font de la Figuera, la",2172,1090,1082
46,Valencia/València,127,"Font d'En Carròs, la",3796,1893,1903
46,Valencia/València,124,Fontanars dels Alforins,993,509,484
46,Valencia/València,125,Fortaleny,1034,514,520
46,Valencia/València,129,Fuenterrobles,705,378,327
46,Valencia/València,131,Gandia,76497,38097,38400
46,Valencia/València,902,Gátova,384,182,202
46,Valencia/València,130,Gavarda,1125,541,584
46,Valencia/València,132,Genovés,2832,1435,1397
46,Valencia/València,133,Gestalgar,640,331,309
46,Valencia/València,134,Gilet,3327,1708,1619
46,Valencia/València,135,Godella,13125,6314,6811
46,Valencia/València,136,Godelleta,3408,1743,1665
46,Valencia/València,137,"Granja de la Costera, la",337,171,166
46,Valencia/València,138,Guadasséquies,460,249,211
46,Valencia/València,139,Guadassuar,5928,2909,3019
46,Valencia/València,140,Guardamar de la Safor,487,254,233
46,Valencia/València,141,Higueruelas,504,265,239
46,Valencia/València,142,Jalance,927,478,449
46,Valencia/València,144,Jarafuel,805,415,390
46,Valencia/València,154,Llanera de Ranes,1035,523,512
46,Valencia/València,155,Llaurí,1274,637,637
46,Valencia/València,147,Llíria,23261,11835,11426
46,Valencia/València,152,Llocnou de la Corona,133,74,59
46,Valencia/València,153,Llocnou de Sant Jeroni,546,275,271
46,Valencia/València,151,Llocnou d'En Fenollet,927,484,443
46,Valencia/València,156,Llombai,2787,1405,1382
46,Valencia/València,157,"Llosa de Ranes, la",3610,1856,1754
46,Valencia/València,150,Llutxent,2452,1256,1196
46,Valencia/València,148,Loriguilla,1879,975,904
46,Valencia/València,149,Losa del Obispo,510,263,247
46,Valencia/València,158,Macastre,1262,658,604
46,Valencia/València,159,Manises,30834,15243,15591
46,Valencia/València,160,Manuel,2543,1237,1306
46,Valencia/València,161,Marines,1872,964,908
46,Valencia/València,162,Massalavés,1617,842,775
46,Valencia/València,163,Massalfassar,2475,1228,1247
46,Valencia/València,164,Massamagrell,15564,7705,7859
46,Valencia/València,165,Massanassa,9149,4527,4622
46,Valencia/València,166,Meliana,10612,5254,5358
46,Valencia/València,167,Millares,395,194,201
46,Valencia/València,168,Miramar,2571,1348,1223
46,Valencia/València,169,Mislata,43281,21119,22162
46,Valencia/València,170,Mogente/Moixent,4619,2339,2280
46,Valencia/València,171,Moncada,21906,10874,11032
46,Valencia/València,173,Montaverner,1708,853,855
46,Valencia/València,174,Montesa,1278,651,627
46,Valencia/València,175,Montitxelvo/Montichelvo,644,322,322
46,Valencia/València,176,Montroi/Montroy,2857,1507,1350
46,Valencia/València,172,Montserrat,7202,3762,3440
46,Valencia/València,177,Museros,6326,3203,3123
46,Valencia/València,178,Náquera,6129,3203,2926
46,Valencia/València,179,Navarrés,3169,1617,1552
46,Valencia/València,180,Novelé/Novetlè,876,432,444
46,Valencia/València,181,Oliva,26782,13351,13431
46,Valencia/València,183,"Olleria, l'",8379,4239,4140
46,Valencia/València,182,Olocau,1628,864,764
46,Valencia/València,184,Ontinyent,36180,17948,18232
46,Valencia/València,185,Otos,462,238,224
46,Valencia/València,186,Paiporta,24810,12360,12450
46,Valencia/València,187,Palma de Gandía,1687,865,822
46,Valencia/València,188,Palmera,998,529,469
46,Valencia/València,189,"Palomar, el",584,287,297
46,Valencia/València,190,Paterna,67156,33432,33724
46,Valencia/València,191,Pedralba,2932,1544,1388
46,Valencia/València,192,Petrés,982,487,495
46,Valencia/València,193,Picanya,11109,5452,5657
46,Valencia/València,194,Picassent,20393,10296,10097
46,Valencia/València,195,Piles,2701,1374,1327
46,Valencia/València,196,Pinet,171,81,90
46,Valencia/València,199,"Pobla de Farnals, la",7790,3949,3841
46,Valencia/València,202,"Pobla de Vallbona, la",22730,11529,11201
46,Valencia/València,200,"Pobla del Duc, la",2510,1223,1287
46,Valencia/València,203,"Pobla Llarga, la",4524,2271,2253
46,Valencia/València,197,Polinyà de Xúquer,2546,1284,1262
46,Valencia/València,198,Potríes,987,485,502
46,Valencia/València,205,Puçol,19341,9565,9776
46,Valencia/València,201,Puebla de San Miguel,71,41,30
46,Valencia/València,204,"Puig de Santa Maria, el",8883,4312,4571
46,Valencia/València,101,Quart de les Valls,1083,515,568
46,Valencia/València,102,Quart de Poblet,24944,12229,12715
46,Valencia/València,103,Quartell,1538,749,789
46,Valencia/València,104,Quatretonda,2402,1222,1180
46,Valencia/València,206,Quesa,709,358,351
46,Valencia/València,207,Rafelbunyol,8826,4369,4457
46,Valencia/València,208,Rafelcofer,1404,657,747
46,Valencia/València,209,Rafelguaraf,2426,1209,1217
46,Valencia/València,210,Ráfol de Salem,428,205,223
46,Valencia/València,212,Real,2321,1198,1123
46,Valencia/València,211,Real de Gandía,2271,1111,1160
46,Valencia/València,213,Requena,20901,10473,10428
46,Valencia/València,214,Riba-roja de Túria,21499,10940,10559
46,Valencia/València,215,Riola,1835,932,903
46,Valencia/València,216,Rocafort,6819,3348,3471
46,Valencia/València,217,Rotglà i Corberà,1137,564,573
46,Valencia/València,218,Rótova,1262,657,605
46,Valencia/València,219,Rugat,179,89,90
46,Valencia/València,220,Sagunto/Sagunt,65003,31999,33004
46,Valencia/València,221,Salem,438,216,222
46,Valencia/València,903,San Antonio de Benagéber,7676,3762,3914
46,Valencia/València,222,Sant Joanet,486,242,244
46,Valencia/València,223,Sedaví,10183,4931,5252
46,Valencia/València,224,Segart,184,92,92
46,Valencia/València,225,Sellent,397,206,191
46,Valencia/València,226,Sempere,44,22,22
46,Valencia/València,227,Senyera,1174,579,595
46,Valencia/València,228,Serra,3233,1679,1554
46,Valencia/València,229,Siete Aguas,1322,716,606
46,Valencia/València,230,Silla,18644,9272,9372
46,Valencia/València,231,Simat de la Valldigna,3513,1819,1694
46,Valencia/València,232,Sinarcas,1150,588,562
46,Valencia/València,233,Sollana,4932,2423,2509
46,Valencia/València,234,Sot de Chera,374,190,184
46,Valencia/València,235,Sueca,28311,14039,14272
46,Valencia/València,236,Sumacàrcer,1223,602,621
46,Valencia/València,237,Tavernes Blanques,9288,4527,4761
46,Valencia/València,238,Tavernes de la Valldigna,17822,8981,8841
46,Valencia/València,239,Teresa de Cofrentes,620,315,305
46,Valencia/València,240,Terrateig,283,149,134
46,Valencia/València,241,Titaguas,502,257,245
46,Valencia/València,242,Torrebaja,429,218,211
46,Valencia/València,243,Torrella,158,87,71
46,Valencia/València,244,Torrent,80551,39943,40608
46,Valencia/València,245,Torres Torres,630,344,286
46,Valencia/València,246,Tous,1268,640,628
46,Valencia/València,247,Tuéjar,1157,637,520
46,Valencia/València,248,Turís,6588,3446,3142
46,Valencia/València,249,Utiel,12082,6081,6001
46,Valencia/València,250,Valencia,786424,375223,411201
46,Valencia/València,251,Vallada,3135,1599,1536
46,Valencia/València,252,Vallanca,156,85,71
46,Valencia/València,253,Vallés,154,82,72
46,Valencia/València,254,Venta del Moro,1400,745,655
46,Valencia/València,255,Vilallonga/Villalonga,4350,2167,2183
46,Valencia/València,256,Vilamarxant,9204,4753,4451
46,Valencia/València,257,Villanueva de Castellón,7321,3615,3706
46,Valencia/València,258,Villar del Arzobispo,3665,1832,1833
46,Valencia/València,259,Villargordo del Cabriel,654,344,310
46,Valencia/València,260,Vinalesa,3244,1593,1651
46,Valencia/València,145,Xàtiva,29343,14356,14987
46,Valencia/València,143,Xeraco,5907,3038,2869
46,Valencia/València,146,Xeresa,2246,1147,1099
46,Valencia/València,110,Xirivella,29309,14520,14789
46,Valencia/València,261,Yátova,2136,1115,1021
46,Valencia/València,262,"Yesa, La",259,138,121
46,Valencia/València,263,Zarra,484,265,219
47,Valladolid,1,Adalia,57,33,24
47,Valladolid,2,Aguasal,26,19,7
47,Valladolid,3,Aguilar de Campos,295,163,132
47,Valladolid,4,Alaejos,1429,754,675
47,Valladolid,5,Alcazarén,675,354,321
47,Valladolid,6,Aldea de San Miguel,234,124,110
47,Valladolid,7,Aldeamayor de San Martín,4891,2530,2361
47,Valladolid,8,Almenara de Adaja,31,14,17
47,Valladolid,9,Amusquillo,114,72,42
47,Valladolid,10,Arroyo de la Encomienda,17572,8950,8622
47,Valladolid,11,Ataquines,574,316,258
47,Valladolid,12,Bahabón,140,66,74
47,Valladolid,13,Barcial de la Loma,112,59,53
47,Valladolid,14,Barruelo del Valle,70,43,27
47,Valladolid,15,Becilla de Valderaduey,276,152,124
47,Valladolid,16,Benafarces,86,47,39
47,Valladolid,17,Bercero,221,118,103
47,Valladolid,18,Berceruelo,40,22,18
47,Valladolid,19,Berrueces,110,58,52
47,Valladolid,20,Bobadilla del Campo,316,174,142
47,Valladolid,21,Bocigas,91,47,44
47,Valladolid,22,Bocos de Duero,57,26,31
47,Valladolid,23,Boecillo,3989,2036,1953
47,Valladolid,24,Bolaños de Campos,356,190,166
47,Valladolid,25,Brahojos de Medina,131,69,62
47,Valladolid,26,Bustillo de Chaves,83,45,38
47,Valladolid,27,Cabezón de Pisuerga,3622,1864,1758
47,Valladolid,28,Cabezón de Valderaduey,37,20,17
47,Valladolid,29,Cabreros del Monte,73,39,34
47,Valladolid,30,Campaspero,1174,633,541
47,Valladolid,31,"Campillo, El",229,132,97
47,Valladolid,32,Camporredondo,166,95,71
47,Valladolid,33,Canalejas de Peñafiel,298,159,139
47,Valladolid,34,Canillas de Esgueva,84,47,37
47,Valladolid,35,Carpio,1068,569,499
47,Valladolid,36,Casasola de Arión,289,163,126
47,Valladolid,37,Castrejón de Trabancos,194,98,96
47,Valladolid,38,Castrillo de Duero,129,70,59
47,Valladolid,39,Castrillo-Tejeriego,194,109,85
47,Valladolid,40,Castrobol,69,34,35
47,Valladolid,41,Castrodeza,180,110,70
47,Valladolid,42,Castromembibre,65,37,28
47,Valladolid,43,Castromonte,338,186,152
47,Valladolid,44,Castronuevo de Esgueva,386,214,172
47,Valladolid,45,Castronuño,939,467,472
47,Valladolid,46,Castroponce,159,87,72
47,Valladolid,47,Castroverde de Cerrato,224,136,88
47,Valladolid,48,Ceinos de Campos,252,140,112
47,Valladolid,49,Cervillego de la Cruz,95,53,42
47,Valladolid,50,Cigales,5008,2550,2458
47,Valladolid,51,Ciguñuela,387,210,177
47,Valladolid,52,Cistérniga,8734,4464,4270
47,Valladolid,53,Cogeces de Íscar,148,79,69
47,Valladolid,54,Cogeces del Monte,738,400,338
47,Valladolid,55,Corcos,211,110,101
47,Valladolid,56,Corrales de Duero,98,56,42
47,Valladolid,57,Cubillas de Santa Marta,292,170,122
47,Valladolid,58,Cuenca de Campos,254,136,118
47,Valladolid,59,Curiel de Duero,121,79,42
47,Valladolid,60,Encinas de Esgueva,275,154,121
47,Valladolid,61,Esguevillas de Esgueva,282,150,132
47,Valladolid,62,Fombellida,193,110,83
47,Valladolid,63,Fompedraza,127,68,59
47,Valladolid,64,Fontihoyuelo,29,16,13
47,Valladolid,65,Fresno el Viejo,967,509,458
47,Valladolid,66,Fuensaldaña,1468,751,717
47,Valladolid,67,Fuente el Sol,194,104,90
47,Valladolid,68,Fuente-Olmedo,41,20,21
47,Valladolid,69,Gallegos de Hornija,140,70,70
47,Valladolid,70,Gatón de Campos,31,18,13
47,Valladolid,71,Geria,513,252,261
47,Valladolid,73,Herrín de Campos,137,66,71
47,Valladolid,74,Hornillos de Eresma,176,96,80
47,Valladolid,75,Íscar,6678,3401,3277
47,Valladolid,76,Laguna de Duero,22555,11301,11254
47,Valladolid,77,Langayo,284,178,106
47,Valladolid,79,Llano de Olmedo,68,39,29
47,Valladolid,78,Lomoviejo,189,99,90
47,Valladolid,80,Manzanillo,62,33,29
47,Valladolid,81,Marzales,53,25,28
47,Valladolid,82,Matapozuelos,1007,507,500
47,Valladolid,83,Matilla de los Caños,95,53,42
47,Valladolid,84,Mayorga,1687,827,860
47,Valladolid,86,Medina de Rioseco,4906,2409,2497
47,Valladolid,85,Medina del Campo,21274,10297,10977
47,Valladolid,87,Megeces,455,241,214
47,Valladolid,88,Melgar de Abajo,120,67,53
47,Valladolid,89,Melgar de Arriba,184,102,82
47,Valladolid,90,Mojados,3184,1659,1525
47,Valladolid,91,Monasterio de Vega,94,49,45
47,Valladolid,92,Montealegre de Campos,130,74,56
47,Valladolid,93,Montemayor de Pililla,931,500,431
47,Valladolid,94,Moral de la Reina,194,110,84
47,Valladolid,95,Moraleja de las Panaderas,41,28,13
47,Valladolid,96,Morales de Campos,163,86,77
47,Valladolid,97,Mota del Marqués,394,199,195
47,Valladolid,98,Mucientes,713,358,355
47,Valladolid,99,"Mudarra, La",168,86,82
47,Valladolid,100,Muriel,166,88,78
47,Valladolid,101,Nava del Rey,2091,1073,1018
47,Valladolid,102,Nueva Villa de las Torres,318,181,137
47,Valladolid,103,Olivares de Duero,328,179,149
47,Valladolid,104,Olmedo,3759,1847,1912
47,Valladolid,105,Olmos de Esgueva,230,124,106
47,Valladolid,106,Olmos de Peñafiel,64,35,29
47,Valladolid,109,Palazuelo de Vedija,203,110,93
47,Valladolid,110,"Parrilla, La",508,257,251
47,Valladolid,111,"Pedraja de Portillo, La",1134,584,550
47,Valladolid,112,Pedrajas de San Esteban,3503,1787,1716
47,Valladolid,113,Pedrosa del Rey,202,110,92
47,Valladolid,114,Peñafiel,5428,2726,2702
47,Valladolid,115,Peñaflor de Hornija,323,181,142
47,Valladolid,116,Pesquera de Duero,469,257,212
47,Valladolid,117,Piña de Esgueva,326,167,159
47,Valladolid,118,Piñel de Abajo,195,106,89
47,Valladolid,119,Piñel de Arriba,102,54,48
47,Valladolid,121,Pollos,638,335,303
47,Valladolid,122,Portillo,2409,1246,1163
47,Valladolid,123,Pozal de Gallinas,538,291,247
47,Valladolid,124,Pozaldez,514,281,233
47,Valladolid,125,Pozuelo de la Orden,60,36,24
47,Valladolid,126,Puras,54,29,25
47,Valladolid,127,Quintanilla de Arriba,154,86,68
47,Valladolid,129,Quintanilla de Onésimo,1109,583,526
47,Valladolid,130,Quintanilla de Trigueros,107,55,52
47,Valladolid,128,Quintanilla del Molar,64,29,35
47,Valladolid,131,Rábano,198,108,90
47,Valladolid,132,Ramiro,45,26,19
47,Valladolid,133,Renedo de Esgueva,3507,1808,1699
47,Valladolid,134,Roales de Campos,185,102,83
47,Valladolid,135,Robladillo,95,58,37
47,Valladolid,137,Roturas,33,19,14
47,Valladolid,138,Rubí de Bracamonte,247,137,110
47,Valladolid,139,Rueda,1332,688,644
47,Valladolid,140,Saelices de Mayorga,127,72,55
47,Valladolid,141,Salvador de Zapardiel,144,83,61
47,Valladolid,142,San Cebrián de Mazote,186,110,76
47,Valladolid,143,San Llorente,141,80,61
47,Valladolid,144,San Martín de Valvení,91,52,39
47,Valladolid,145,San Miguel del Arroyo,713,379,334
47,Valladolid,146,San Miguel del Pino,316,171,145
47,Valladolid,147,San Pablo de la Moraleja,128,63,65
47,Valladolid,148,San Pedro de Latarce,537,293,244
47,Valladolid,149,San Pelayo,44,19,25
47,Valladolid,150,San Román de Hornija,361,171,190
47,Valladolid,151,San Salvador,33,18,15
47,Valladolid,156,San Vicente del Palacio,186,101,85
47,Valladolid,152,Santa Eufemia del Arroyo,89,47,42
47,Valladolid,153,Santervás de Campos,130,72,58
47,Valladolid,154,Santibáñez de Valcorba,189,107,82
47,Valladolid,155,Santovenia de Pisuerga,4155,2134,2021
47,Valladolid,157,Sardón de Duero,649,341,308
47,Valladolid,158,"Seca, La",1127,574,553
47,Valladolid,159,Serrada,1184,625,559
47,Valladolid,160,Siete Iglesias de Trabancos,496,259,237
47,Valladolid,161,Simancas,5331,2702,2629
47,Valladolid,162,Tamariz de Campos,69,36,33
47,Valladolid,163,Tiedra,307,159,148
47,Valladolid,164,Tordehumos,438,221,217
47,Valladolid,165,Tordesillas,8973,4572,4401
47,Valladolid,169,Torre de Esgueva,73,35,38
47,Valladolid,170,Torre de Peñafiel,43,25,18
47,Valladolid,166,Torrecilla de la Abadesa,305,149,156
47,Valladolid,167,Torrecilla de la Orden,271,137,134
47,Valladolid,168,Torrecilla de la Torre,32,20,12
47,Valladolid,171,Torrelobatón,477,247,230
47,Valladolid,172,Torrescárcela,168,88,80
47,Valladolid,173,Traspinedo,1126,614,512
47,Valladolid,174,Trigueros del Valle,313,167,146
47,Valladolid,175,Tudela de Duero,8717,4482,4235
47,Valladolid,176,"Unión de Campos, La",279,142,137
47,Valladolid,177,Urones de Castroponce,115,65,50
47,Valladolid,178,Urueña,182,98,84
47,Valladolid,179,Valbuena de Duero,482,253,229
47,Valladolid,180,Valdearcos de la Vega,95,50,45
47,Valladolid,181,Valdenebro de los Valles,202,101,101
47,Valladolid,182,Valdestillas,1742,900,842
47,Valladolid,183,Valdunquillo,156,75,81
47,Valladolid,186,Valladolid,306830,144930,161900
47,Valladolid,184,Valoria la Buena,685,363,322
47,Valladolid,185,Valverde de Campos,109,67,42
47,Valladolid,187,Vega de Ruiponce,118,69,49
47,Valladolid,188,Vega de Valdetronco,124,70,54
47,Valladolid,189,Velascálvaro,178,99,79
47,Valladolid,190,Velilla,114,57,57
47,Valladolid,191,Velliza,114,69,45
47,Valladolid,192,Ventosa de la Cuesta,112,64,48
47,Valladolid,193,Viana de Cega,2031,1060,971
47,Valladolid,195,Villabáñez,566,318,248
47,Valladolid,196,Villabaruz de Campos,33,15,18
47,Valladolid,197,Villabrágima,1054,557,497
47,Valladolid,198,Villacarralón,77,47,30
47,Valladolid,199,Villacid de Campos,93,59,34
47,Valladolid,200,Villaco,91,56,35
47,Valladolid,203,Villafrades de Campos,77,36,41
47,Valladolid,204,Villafranca de Duero,300,152,148
47,Valladolid,205,Villafrechós,509,271,238
47,Valladolid,206,Villafuerte,106,59,47
47,Valladolid,207,Villagarcía de Campos,362,205,157
47,Valladolid,208,Villagómez la Nueva,68,35,33
47,Valladolid,209,Villalán de Campos,47,28,19
47,Valladolid,210,Villalar de los Comuneros,443,219,224
47,Valladolid,211,Villalba de la Loma,62,30,32
47,Valladolid,212,Villalba de los Alcores,411,224,187
47,Valladolid,213,Villalbarba,132,69,63
47,Valladolid,214,Villalón de Campos,1733,846,887
47,Valladolid,215,Villamuriel de Campos,58,28,30
47,Valladolid,216,Villán de Tordesillas,132,74,58
47,Valladolid,217,Villanubla,2484,1306,1178
47,Valladolid,218,Villanueva de Duero,1202,627,575
47,Valladolid,219,Villanueva de la Condesa,56,30,26
47,Valladolid,220,Villanueva de los Caballeros,196,99,97
47,Valladolid,221,Villanueva de los Infantes,114,68,46
47,Valladolid,222,Villanueva de San Mancio,97,54,43
47,Valladolid,223,Villardefrades,171,92,79
47,Valladolid,224,Villarmentero de Esgueva,105,52,53
47,Valladolid,225,Villasexmir,83,47,36
47,Valladolid,226,Villavaquerín,189,109,80
47,Valladolid,227,Villavellid,62,37,25
47,Valladolid,228,Villaverde de Medina,523,288,235
47,Valladolid,229,Villavicencio de los Caballeros,251,122,129
47,Valladolid,194,Viloria,360,189,171
47,Valladolid,230,Wamba,346,182,164
47,Valladolid,231,Zaratán,6029,3116,2913
47,Valladolid,232,"Zarza, La",127,70,57
49,Zamora,2,Abezames,72,36,36
49,Zamora,3,Alcañices,1101,548,553
49,Zamora,4,Alcubilla de Nogales,137,74,63
49,Zamora,5,Alfaraz de Sayago,157,87,70
49,Zamora,6,Algodre,166,92,74
49,Zamora,7,Almaraz de Duero,403,200,203
49,Zamora,8,Almeida de Sayago,530,278,252
49,Zamora,9,Andavías,447,233,214
49,Zamora,10,Arcenillas,406,206,200
49,Zamora,11,Arcos de la Polvorosa,253,133,120
49,Zamora,12,Argañín,78,39,39
49,Zamora,13,Argujillo,288,146,142
49,Zamora,14,Arquillinos,120,62,58
49,Zamora,15,Arrabalde,262,127,135
49,Zamora,16,Aspariegos,298,142,156
49,Zamora,17,Asturianos,265,139,126
49,Zamora,18,Ayoó de Vidriales,368,193,175
49,Zamora,19,Barcial del Barco,274,150,124
49,Zamora,20,Belver de los Montes,313,173,140
49,Zamora,21,Benavente,18879,9144,9735
49,Zamora,22,Benegiles,348,184,164
49,Zamora,23,Bermillo de Sayago,1121,590,531
49,Zamora,24,"Bóveda de Toro, La",814,411,403
49,Zamora,25,Bretó,184,108,76
49,Zamora,26,Bretocino,248,130,118
49,Zamora,27,Brime de Sog,165,78,87
49,Zamora,28,Brime de Urz,131,78,53
49,Zamora,29,Burganes de Valverde,713,376,337
49,Zamora,30,Bustillo del Oro,90,45,45
49,Zamora,31,Cabañas de Sayago,156,83,73
49,Zamora,32,Calzadilla de Tera,364,168,196
49,Zamora,33,Camarzana de Tera,907,446,461
49,Zamora,34,Cañizal,485,255,230
49,Zamora,35,Cañizo,259,133,126
49,Zamora,36,Carbajales de Alba,586,298,288
49,Zamora,37,Carbellino,210,111,99
49,Zamora,38,Casaseca de Campeán,115,65,50
49,Zamora,39,Casaseca de las Chanas,381,210,171
49,Zamora,40,Castrillo de la Guareña,123,67,56
49,Zamora,41,Castrogonzalo,501,266,235
49,Zamora,42,Castronuevo,255,124,131
49,Zamora,43,Castroverde de Campos,360,182,178
49,Zamora,44,Cazurra,94,51,43
49,Zamora,46,Cerecinos de Campos,305,166,139
49,Zamora,47,Cerecinos del Carrizal,127,73,54
49,Zamora,48,Cernadilla,147,70,77
49,Zamora,50,Cobreros,587,322,265
49,Zamora,52,Coomonte,194,97,97
49,Zamora,53,Coreses,1069,556,513
49,Zamora,54,Corrales del Vino,1067,524,543
49,Zamora,55,Cotanes del Monte,118,66,52
49,Zamora,56,Cubillos,332,167,165
49,Zamora,57,Cubo de Benavente,120,67,53
49,Zamora,58,"Cubo de Tierra del Vino, El",371,201,170
49,Zamora,59,Cuelgamures,95,57,38
49,Zamora,61,Entrala,164,85,79
49,Zamora,62,Espadañedo,127,63,64
49,Zamora,63,Faramontanos de Tábara,373,194,179
49,Zamora,64,Fariza,581,300,281
49,Zamora,65,Fermoselle,1337,683,654
49,Zamora,66,Ferreras de Abajo,578,292,286
49,Zamora,67,Ferreras de Arriba,420,223,197
49,Zamora,68,Ferreruela,516,282,234
49,Zamora,69,Figueruela de Arriba,412,204,208
49,Zamora,71,Fonfría,843,430,413
49,Zamora,75,Fresno de la Polvorosa,159,81,78
49,Zamora,76,Fresno de la Ribera,389,211,178
49,Zamora,77,Fresno de Sayago,205,107,98
49,Zamora,78,Friera de Valverde,190,96,94
49,Zamora,79,Fuente Encalada,114,64,50
49,Zamora,80,Fuentelapeña,795,417,378
49,Zamora,82,Fuentes de Ropel,433,222,211
49,Zamora,81,Fuentesaúco,1740,868,872
49,Zamora,83,Fuentesecas,65,31,34
49,Zamora,84,Fuentespreadas,322,175,147
49,Zamora,85,Galende,1190,614,576
49,Zamora,86,Gallegos del Pan,134,80,54
49,Zamora,87,Gallegos del Río,573,310,263
49,Zamora,88,Gamones,105,58,47
49,Zamora,90,Gema,226,120,106
49,Zamora,91,Granja de Moreruela,271,149,122
49,Zamora,92,Granucillo,150,76,74
49,Zamora,93,Guarrate,347,183,164
49,Zamora,94,Hermisende,276,149,127
49,Zamora,95,"Hiniesta, La",327,167,160
49,Zamora,96,Jambrina,181,94,87
49,Zamora,97,Justel,84,48,36
49,Zamora,98,Losacino,244,134,110
49,Zamora,99,Losacio,110,63,47
49,Zamora,100,Lubián,342,183,159
49,Zamora,101,Luelmo,183,95,88
49,Zamora,102,"Maderal, El",215,111,104
49,Zamora,103,Madridanos,500,255,245
49,Zamora,104,Mahide,360,194,166
49,Zamora,105,Maire de Castroponce,143,77,66
49,Zamora,107,Malva,153,74,79
49,Zamora,108,Manganeses de la Lampreana,485,242,243
49,Zamora,109,Manganeses de la Polvorosa,732,357,375
49,Zamora,110,Manzanal de Arriba,392,211,181
49,Zamora,112,Manzanal de los Infantes,148,87,61
49,Zamora,111,Manzanal del Barco,147,77,70
49,Zamora,113,Matilla de Arzón,187,110,77
49,Zamora,114,Matilla la Seca,52,26,26
49,Zamora,115,Mayalde,217,116,101
49,Zamora,116,Melgar de Tera,433,218,215
49,Zamora,117,Micereces de Tera,499,246,253
49,Zamora,118,Milles de la Polvorosa,233,127,106
49,Zamora,119,Molacillos,271,144,127
49,Zamora,120,Molezuelas de la Carballeda,85,47,38
49,Zamora,121,Mombuey,437,240,197
49,Zamora,122,Monfarracinos,1001,519,482
49,Zamora,123,Montamarta,607,314,293
49,Zamora,124,Moral de Sayago,281,158,123
49,Zamora,126,Moraleja de Sayago,259,135,124
49,Zamora,125,Moraleja del Vino,1688,870,818
49,Zamora,128,Morales de Rey,636,320,316
49,Zamora,129,Morales de Toro,1004,521,483
49,Zamora,130,Morales de Valverde,207,107,100
49,Zamora,127,Morales del Vino,2887,1503,1384
49,Zamora,131,Moralina,320,163,157
49,Zamora,132,Moreruela de los Infanzones,369,187,182
49,Zamora,133,Moreruela de Tábara,347,172,175
49,Zamora,134,Muelas de los Caballeros,186,99,87
49,Zamora,135,Muelas del Pan,708,359,349
49,Zamora,136,Muga de Sayago,364,177,187
49,Zamora,137,Navianos de Valverde,204,111,93
49,Zamora,138,Olmillos de Castro,252,131,121
49,Zamora,139,Otero de Bodas,193,103,90
49,Zamora,141,Pajares de la Lampreana,392,195,197
49,Zamora,143,Palacios de Sanabria,263,132,131
49,Zamora,142,Palacios del Pan,264,136,128
49,Zamora,145,Pedralba de la Pradería,295,156,139
49,Zamora,146,"Pego, El",321,164,157
49,Zamora,147,Peleagonzalo,271,137,134
49,Zamora,148,Peleas de Abajo,207,107,100
49,Zamora,149,Peñausende,443,225,218
49,Zamora,150,Peque,175,79,96
49,Zamora,151,"Perdigón, El",762,403,359
49,Zamora,152,Pereruela,612,333,279
49,Zamora,153,Perilla de Castro,181,89,92
49,Zamora,154,Pías,144,78,66
49,Zamora,155,Piedrahita de Castro,106,57,49
49,Zamora,156,Pinilla de Toro,261,140,121
49,Zamora,157,Pino del Oro,191,103,88
49,Zamora,158,"Piñero, El",247,133,114
49,Zamora,160,Pobladura de Valderaduey,42,22,20
49,Zamora,159,Pobladura del Valle,314,166,148
49,Zamora,162,Porto,202,111,91
49,Zamora,163,Pozoantiguo,261,133,128
49,Zamora,164,Pozuelo de Tábara,155,78,77
49,Zamora,165,Prado,66,37,29
49,Zamora,166,Puebla de Sanabria,1523,729,794
49,Zamora,167,Pueblica de Valverde,230,125,105
49,Zamora,170,Quintanilla de Urz,113,57,56
49,Zamora,168,Quintanilla del Monte,106,50,56
49,Zamora,169,Quintanilla del Olmo,33,16,17
49,Zamora,171,Quiruelas de Vidriales,728,359,369
49,Zamora,172,Rabanales,610,316,294
49,Zamora,173,Rábano de Aliste,397,196,201
49,Zamora,174,Requejo,155,77,78
49,Zamora,175,Revellinos,265,145,120
49,Zamora,176,Riofrío de Aliste,756,408,348
49,Zamora,177,Rionegro del Puente,319,165,154
49,Zamora,178,Roales,828,445,383
49,Zamora,179,Robleda-Cervantes,439,234,205
49,Zamora,180,Roelos de Sayago,175,82,93
49,Zamora,181,Rosinos de la Requejada,395,211,184
49,Zamora,183,Salce,104,46,58
49,Zamora,184,Samir de los Caños,190,101,89
49,Zamora,185,San Agustín del Pozo,191,101,90
49,Zamora,186,San Cebrián de Castro,279,137,142
49,Zamora,187,San Cristóbal de Entreviñas,1491,780,711
49,Zamora,188,San Esteban del Molar,137,76,61
49,Zamora,189,San Justo,246,131,115
49,Zamora,190,San Martín de Valderaduey,72,38,34
49,Zamora,191,San Miguel de la Ribera,315,161,154
49,Zamora,192,San Miguel del Valle,163,76,87
49,Zamora,193,San Pedro de Ceque,528,278,250
49,Zamora,194,San Pedro de la Nave-Almendra,388,199,189
49,Zamora,208,San Vicente de la Cabeza,449,236,213
49,Zamora,209,San Vitero,578,318,260
49,Zamora,197,Santa Clara de Avedillo,187,97,90
49,Zamora,199,Santa Colomba de las Monjas,282,139,143
49,Zamora,200,Santa Cristina de la Polvorosa,1125,560,565
49,Zamora,201,Santa Croya de Tera,335,170,165
49,Zamora,202,Santa Eufemia del Barco,199,116,83
49,Zamora,203,Santa María de la Vega,350,178,172
49,Zamora,204,Santa María de Valverde,69,29,40
49,Zamora,205,Santibáñez de Tera,420,215,205
49,Zamora,206,Santibáñez de Vidriales,1067,535,532
49,Zamora,207,Santovenia,284,145,139
49,Zamora,210,Sanzoles,559,286,273
49,Zamora,214,Tábara,869,445,424
49,Zamora,216,Tapioles,172,96,76
49,Zamora,219,Toro,9305,4531,4774
49,Zamora,220,"Torre del Valle, La",153,80,73
49,Zamora,221,Torregamones,308,155,153
49,Zamora,222,Torres del Carrizal,440,224,216
49,Zamora,223,Trabazos,984,515,469
49,Zamora,224,Trefacio,187,97,90
49,Zamora,225,Uña de Quintana,161,81,80
49,Zamora,226,Vadillo de la Guareña,284,152,132
49,Zamora,227,Valcabado,337,166,171
49,Zamora,228,Valdefinjas,55,33,22
49,Zamora,229,Valdescorriel,144,71,73
49,Zamora,230,Vallesa de la Guareña,106,58,48
49,Zamora,231,Vega de Tera,393,196,197
49,Zamora,232,Vega de Villalobos,117,59,58
49,Zamora,233,Vegalatrave,99,57,42
49,Zamora,234,Venialbo,473,256,217
49,Zamora,235,Vezdemarbán,455,232,223
49,Zamora,236,Vidayanes,93,48,45
49,Zamora,237,Videmala,160,85,75
49,Zamora,238,Villabrázaro,258,135,123
49,Zamora,239,Villabuena del Puente,781,404,377
49,Zamora,240,Villadepera,244,134,110
49,Zamora,241,Villaescusa,277,152,125
49,Zamora,242,Villafáfila,525,265,260
49,Zamora,243,Villaferrueña,114,58,56
49,Zamora,244,Villageriz,47,28,19
49,Zamora,245,Villalazán,301,146,155
49,Zamora,246,Villalba de la Lampreana,260,142,118
49,Zamora,247,Villalcampo,480,233,247
49,Zamora,248,Villalobos,274,137,137
49,Zamora,249,Villalonso,95,43,52
49,Zamora,250,Villalpando,1551,768,783
49,Zamora,251,Villalube,182,97,85
49,Zamora,252,Villamayor de Campos,360,180,180
49,Zamora,255,Villamor de los Escuderos,420,224,196
49,Zamora,256,Villanázar,310,159,151
49,Zamora,257,Villanueva de Azoague,324,166,158
49,Zamora,258,Villanueva de Campeán,129,72,57
49,Zamora,259,Villanueva de las Peras,90,50,40
49,Zamora,260,Villanueva del Campo,927,456,471
49,Zamora,263,Villar de Fallaves,56,30,26
49,Zamora,264,Villar del Buey,663,344,319
49,Zamora,261,Villaralbo,1915,970,945
49,Zamora,262,Villardeciervos,466,227,239
49,Zamora,265,Villardiegua de la Ribera,136,67,69
49,Zamora,266,Villárdiga,99,53,46
49,Zamora,267,Villardondiego,103,61,42
49,Zamora,268,Villarrín de Campos,466,253,213
49,Zamora,269,Villaseco del Pan,248,117,131
49,Zamora,270,Villavendimio,178,105,73
49,Zamora,272,Villaveza de Valverde,95,47,48
49,Zamora,271,Villaveza del Agua,216,113,103
49,Zamora,273,Viñas,202,102,100
49,Zamora,275,Zamora,64423,30233,34190
50,Zaragoza,1,Abanto,113,61,52
50,Zaragoza,2,Acered,220,130,90
50,Zaragoza,3,Agón,155,82,73
50,Zaragoza,4,Aguarón,796,426,370
50,Zaragoza,5,Aguilón,260,137,123
50,Zaragoza,6,Ainzón,1162,591,571
50,Zaragoza,7,Aladrén,54,35,19
50,Zaragoza,8,Alagón,7052,3543,3509
50,Zaragoza,9,Alarba,153,91,62
50,Zaragoza,10,Alberite de San Juan,86,51,35
50,Zaragoza,11,Albeta,153,74,79
50,Zaragoza,12,Alborge,124,64,60
50,Zaragoza,13,Alcalá de Ebro,281,132,149
50,Zaragoza,14,Alcalá de Moncayo,183,106,77
50,Zaragoza,15,Alconchel de Ariza,82,47,35
50,Zaragoza,16,Aldehuela de Liestos,50,34,16
50,Zaragoza,17,Alfajarín,2250,1158,1092
50,Zaragoza,18,Alfamén,1475,787,688
50,Zaragoza,19,Alforque,70,37,33
50,Zaragoza,20,Alhama de Aragón,1115,585,530
50,Zaragoza,21,Almochuel,35,17,18
50,Zaragoza,22,"Almolda, La",602,307,295
50,Zaragoza,23,Almonacid de la Cuba,244,126,118
50,Zaragoza,24,Almonacid de la Sierra,752,426,326
50,Zaragoza,25,"Almunia de Doña Godina, La",7836,4022,3814
50,Zaragoza,26,Alpartir,574,289,285
50,Zaragoza,27,Ambel,258,125,133
50,Zaragoza,28,Anento,105,68,37
50,Zaragoza,29,Aniñón,757,415,342
50,Zaragoza,30,Añón de Moncayo,210,123,87
50,Zaragoza,31,Aranda de Moncayo,186,117,69
50,Zaragoza,32,Arándiga,369,187,182
50,Zaragoza,33,Ardisa,70,44,26
50,Zaragoza,34,Ariza,1185,609,576
50,Zaragoza,35,Artieda,86,50,36
50,Zaragoza,36,Asín,105,51,54
50,Zaragoza,37,Atea,155,98,57
50,Zaragoza,38,Ateca,2019,1049,970
50,Zaragoza,39,Azuara,630,345,285
50,Zaragoza,40,Badules,97,53,44
50,Zaragoza,41,Bagüés,15,9,6
50,Zaragoza,42,Balconchán,12,5,7
50,Zaragoza,43,Bárboles,317,174,143
50,Zaragoza,44,Bardallur,297,146,151
50,Zaragoza,45,Belchite,1589,816,773
50,Zaragoza,46,Belmonte de Gracián,221,120,101
50,Zaragoza,47,Berdejo,55,34,21
50,Zaragoza,48,Berrueco,38,19,19
50,Zaragoza,901,Biel,157,90,67
50,Zaragoza,50,Bijuesca,105,65,40
50,Zaragoza,51,Biota,1022,515,507
50,Zaragoza,52,Bisimbre,97,52,45
50,Zaragoza,53,Boquiñeni,896,460,436
50,Zaragoza,54,Bordalba,64,40,24
50,Zaragoza,55,Borja,4931,2474,2457
50,Zaragoza,56,Botorrita,506,273,233
50,Zaragoza,57,Brea de Aragón,1734,875,859
50,Zaragoza,58,Bubierca,76,38,38
50,Zaragoza,59,Bujaraloz,1021,531,490
50,Zaragoza,60,Bulbuente,239,125,114
50,Zaragoza,61,Bureta,258,139,119
50,Zaragoza,62,"Burgo de Ebro, El",2381,1223,1158
50,Zaragoza,63,"Buste, El",68,37,31
50,Zaragoza,64,Cabañas de Ebro,536,287,249
50,Zaragoza,65,Cabolafuente,39,21,18
50,Zaragoza,66,Cadrete,3538,1851,1687
50,Zaragoza,67,Calatayud,20658,10259,10399
50,Zaragoza,68,Calatorao,2895,1519,1376
50,Zaragoza,69,Calcena,78,48,30
50,Zaragoza,70,Calmarza,76,43,33
50,Zaragoza,71,Campillo de Aragón,153,83,70
50,Zaragoza,72,Carenas,175,92,83
50,Zaragoza,73,Cariñena,3457,1772,1685
50,Zaragoza,74,Caspe,9927,5158,4769
50,Zaragoza,75,Castejón de Alarba,84,49,35
50,Zaragoza,76,Castejón de las Armas,105,56,49
50,Zaragoza,77,Castejón de Valdejasa,237,124,113
50,Zaragoza,78,Castiliscar,292,148,144
50,Zaragoza,79,Cervera de la Cañada,316,173,143
50,Zaragoza,80,Cerveruela,37,23,14
50,Zaragoza,81,Cetina,666,345,321
50,Zaragoza,92,Chiprana,514,275,239
50,Zaragoza,93,Chodes,135,74,61
50,Zaragoza,82,Cimballa,114,56,58
50,Zaragoza,83,Cinco Olivas,108,53,55
50,Zaragoza,84,Clarés de Ribota,77,44,33
50,Zaragoza,85,Codo,204,104,100
50,Zaragoza,86,Codos,199,124,75
50,Zaragoza,87,Contamina,39,23,16
50,Zaragoza,88,Cosuenda,377,194,183
50,Zaragoza,89,Cuarte de Huerva,11589,6002,5587
50,Zaragoza,90,Cubel,184,93,91
50,Zaragoza,91,"Cuerlas, Las",51,27,24
50,Zaragoza,94,Daroca,2193,1089,1104
50,Zaragoza,95,Ejea de los Caballeros,16870,8648,8222
50,Zaragoza,96,Embid de Ariza,49,24,25
50,Zaragoza,98,Encinacorba,235,115,120
50,Zaragoza,99,Épila,4593,2421,2172
50,Zaragoza,100,Erla,375,188,187
50,Zaragoza,101,Escatrón,1113,550,563
50,Zaragoza,102,Fabara,1231,663,568
50,Zaragoza,104,Farlete,407,205,202
50,Zaragoza,105,Fayón,348,183,165
50,Zaragoza,106,"Fayos, Los",153,78,75
50,Zaragoza,107,Figueruelas,1263,641,622
50,Zaragoza,108,Fombuena,54,31,23
50,Zaragoza,109,"Frago, El",104,64,40
50,Zaragoza,110,"Frasno, El",439,233,206
50,Zaragoza,111,Fréscano,207,113,94
50,Zaragoza,113,Fuendejalón,859,456,403
50,Zaragoza,114,Fuendetodos,153,81,72
50,Zaragoza,115,Fuentes de Ebro,4643,2417,2226
50,Zaragoza,116,Fuentes de Jiloca,243,133,110
50,Zaragoza,117,Gallocanta,158,85,73
50,Zaragoza,118,Gallur,2779,1388,1391
50,Zaragoza,119,Gelsa,1122,583,539
50,Zaragoza,120,Godojos,36,20,16
50,Zaragoza,121,Gotor,347,186,161
50,Zaragoza,122,Grisel,67,41,26
50,Zaragoza,123,Grisén,636,334,302
50,Zaragoza,124,Herrera de los Navarros,565,301,264
50,Zaragoza,125,Ibdes,483,260,223
50,Zaragoza,126,Illueca,3159,1568,1591
50,Zaragoza,128,Isuerre,33,22,11
50,Zaragoza,129,Jaraba,329,171,158
50,Zaragoza,130,Jarque,501,269,232
50,Zaragoza,131,Jaulín,268,144,124
50,Zaragoza,132,"Joyosa, La",1007,521,486
50,Zaragoza,133,Lagata,133,72,61
50,Zaragoza,134,Langa del Castillo,136,68,68
50,Zaragoza,135,Layana,119,67,52
50,Zaragoza,136,Lécera,730,393,337
50,Zaragoza,138,Lechón,53,31,22
50,Zaragoza,137,Leciñena,1234,625,609
50,Zaragoza,139,Letux,379,219,160
50,Zaragoza,140,Litago,174,96,78
50,Zaragoza,141,Lituénigo,126,65,61
50,Zaragoza,142,Lobera de Onsella,42,28,14
50,Zaragoza,143,Longares,898,535,363
50,Zaragoza,144,Longás,35,25,10
50,Zaragoza,146,Lucena de Jalón,252,136,116
50,Zaragoza,147,Luceni,1014,514,500
50,Zaragoza,148,Luesia,307,170,137
50,Zaragoza,149,Luesma,47,28,19
50,Zaragoza,150,Lumpiaque,916,477,439
50,Zaragoza,151,Luna,776,408,368
50,Zaragoza,152,Maella,1958,1030,928
50,Zaragoza,153,Magallón,1183,611,572
50,Zaragoza,154,Mainar,162,85,77
50,Zaragoza,155,Malanquilla,112,68,44
50,Zaragoza,156,Maleján,300,154,146
50,Zaragoza,160,Mallén,3399,1784,1615
50,Zaragoza,157,Malón,364,189,175
50,Zaragoza,159,Maluenda,1080,532,548
50,Zaragoza,161,Manchones,116,70,46
50,Zaragoza,162,Mara,178,90,88
50,Zaragoza,163,María de Huerva,5359,2753,2606
50,Zaragoza,902,Marracos,97,55,42
50,Zaragoza,164,Mediana de Aragón,473,230,243
50,Zaragoza,165,Mequinenza,2393,1228,1165
50,Zaragoza,166,Mesones de Isuela,295,146,149
50,Zaragoza,167,Mezalocha,241,138,103
50,Zaragoza,168,Mianos,30,18,12
50,Zaragoza,169,Miedes de Aragón,464,247,217
50,Zaragoza,170,Monegrillo,440,245,195
50,Zaragoza,171,Moneva,111,64,47
50,Zaragoza,172,Monreal de Ariza,233,129,104
50,Zaragoza,173,Monterde,168,101,67
50,Zaragoza,174,Montón,114,65,49
50,Zaragoza,175,Morata de Jalón,1209,600,609
50,Zaragoza,176,Morata de Jiloca,236,139,97
50,Zaragoza,177,Morés,379,205,174
50,Zaragoza,178,Moros,406,210,196
50,Zaragoza,179,Moyuela,265,146,119
50,Zaragoza,180,Mozota,121,60,61
50,Zaragoza,181,Muel,1375,708,667
50,Zaragoza,182,"Muela, La",4948,2566,2382
50,Zaragoza,183,Munébrega,420,233,187
50,Zaragoza,184,Murero,133,75,58
50,Zaragoza,185,Murillo de Gállego,183,110,73
50,Zaragoza,186,Navardún,43,27,16
50,Zaragoza,187,Nigüella,80,48,32
50,Zaragoza,188,Nombrevilla,37,21,16
50,Zaragoza,189,Nonaspe,1016,548,468
50,Zaragoza,190,Novallas,931,500,431
50,Zaragoza,191,Novillas,586,291,295
50,Zaragoza,192,Nuévalos,332,187,145
50,Zaragoza,193,Nuez de Ebro,843,427,416
50,Zaragoza,194,Olvés,106,60,46
50,Zaragoza,195,Orcajo,57,37,20
50,Zaragoza,196,Orera,131,68,63
50,Zaragoza,197,Orés,110,66,44
50,Zaragoza,198,Oseja,48,29,19
50,Zaragoza,199,Osera de Ebro,424,207,217
50,Zaragoza,200,Paniza,729,388,341
50,Zaragoza,201,Paracuellos de Jiloca,568,297,271
50,Zaragoza,202,Paracuellos de la Ribera,175,87,88
50,Zaragoza,203,Pastriz,1310,634,676
50,Zaragoza,204,Pedrola,3622,1874,1748
50,Zaragoza,205,"Pedrosas, Las",110,51,59
50,Zaragoza,206,Perdiguera,613,321,292
50,Zaragoza,207,Piedratajada,113,58,55
50,Zaragoza,208,Pina de Ebro,2567,1322,1245
50,Zaragoza,209,Pinseque,3625,1873,1752
50,Zaragoza,210,"Pintanos, Los",44,26,18
50,Zaragoza,211,Plasencia de Jalón,370,200,170
50,Zaragoza,212,Pleitas,43,22,21
50,Zaragoza,213,Plenas,120,66,54
50,Zaragoza,214,Pomer,34,23,11
50,Zaragoza,215,Pozuel de Ariza,23,14,9
50,Zaragoza,216,Pozuelo de Aragón,299,163,136
50,Zaragoza,217,Pradilla de Ebro,584,309,275
50,Zaragoza,218,Puebla de Albortón,127,80,47
50,Zaragoza,219,"Puebla de Alfindén, La",5864,3024,2840
50,Zaragoza,220,Puendeluna,51,28,23
50,Zaragoza,221,Purujosa,39,26,13
50,Zaragoza,222,Quinto,2055,1048,1007
50,Zaragoza,223,Remolinos,1149,591,558
50,Zaragoza,224,Retascón,75,47,28
50,Zaragoza,225,Ricla,3203,1678,1525
50,Zaragoza,227,Romanos,107,62,45
50,Zaragoza,228,Rueda de Jalón,344,190,154
50,Zaragoza,229,Ruesca,73,37,36
50,Zaragoza,241,Sabiñán,755,401,354
50,Zaragoza,230,Sádaba,1460,749,711
50,Zaragoza,231,Salillas de Jalón,324,161,163
50,Zaragoza,232,Salvatierra de Esca,211,106,105
50,Zaragoza,233,Samper del Salz,106,63,43
50,Zaragoza,234,San Martín de la Virgen de Moncayo,281,158,123
50,Zaragoza,235,San Mateo de Gállego,3093,1602,1491
50,Zaragoza,236,Santa Cruz de Grío,133,70,63
50,Zaragoza,237,Santa Cruz de Moncayo,137,74,63
50,Zaragoza,238,Santa Eulalia de Gállego,127,70,57
50,Zaragoza,239,Santed,66,41,25
50,Zaragoza,240,Sástago,1221,631,590
50,Zaragoza,242,Sediles,110,65,45
50,Zaragoza,243,Sestrica,413,238,175
50,Zaragoza,244,Sierra de Luna,273,146,127
50,Zaragoza,245,Sigüés,105,58,47
50,Zaragoza,246,Sisamón,38,25,13
50,Zaragoza,247,Sobradiel,1083,530,553
50,Zaragoza,248,Sos del Rey Católico,629,324,305
50,Zaragoza,249,Tabuenca,369,208,161
50,Zaragoza,250,Talamantes,59,26,33
50,Zaragoza,251,Tarazona,10864,5382,5482
50,Zaragoza,252,Tauste,7027,3490,3537
50,Zaragoza,253,Terrer,532,286,246
50,Zaragoza,254,Tierga,197,108,89
50,Zaragoza,255,Tobed,230,118,112
50,Zaragoza,256,Torralba de los Frailes,88,49,39
50,Zaragoza,257,Torralba de Ribota,189,107,82
50,Zaragoza,258,Torralbilla,57,32,25
50,Zaragoza,259,Torrehermosa,71,38,33
50,Zaragoza,260,Torrelapaja,35,21,14
50,Zaragoza,261,Torrellas,275,148,127
50,Zaragoza,262,Torres de Berrellén,1492,774,718
50,Zaragoza,263,Torrijo de la Cañada,251,141,110
50,Zaragoza,264,Tosos,208,116,92
50,Zaragoza,265,Trasmoz,75,41,34
50,Zaragoza,266,Trasobares,137,83,54
50,Zaragoza,267,Uncastillo,688,330,358
50,Zaragoza,268,Undués de Lerda,56,34,22
50,Zaragoza,269,Urrea de Jalón,398,207,191
50,Zaragoza,270,Urriés,38,22,16
50,Zaragoza,271,Used,294,162,132
50,Zaragoza,272,Utebo,18429,9227,9202
50,Zaragoza,274,Val de San Martín,71,40,31
50,Zaragoza,273,Valdehorna,27,14,13
50,Zaragoza,275,Valmadrid,141,91,50
50,Zaragoza,276,Valpalmas,144,68,76
50,Zaragoza,277,Valtorres,87,43,44
50,Zaragoza,278,Velilla de Ebro,241,130,111
50,Zaragoza,279,Velilla de Jiloca,128,68,60
50,Zaragoza,280,Vera de Moncayo,392,200,192
50,Zaragoza,281,Vierlas,105,56,49
50,Zaragoza,283,Villadoz,94,56,38
50,Zaragoza,284,Villafeliche,200,104,96
50,Zaragoza,285,Villafranca de Ebro,820,405,415
50,Zaragoza,286,Villalba de Perejil,102,53,49
50,Zaragoza,287,Villalengua,360,191,169
50,Zaragoza,903,Villamayor de Gállego,2820,1417,1403
50,Zaragoza,288,Villanueva de Gállego,4616,2339,2277
50,Zaragoza,290,Villanueva de Huerva,511,268,243
50,Zaragoza,289,Villanueva de Jiloca,52,25,27
50,Zaragoza,291,Villar de los Navarros,111,61,50
50,Zaragoza,292,Villarreal de Huerva,241,132,109
50,Zaragoza,293,Villarroya de la Sierra,521,275,246
50,Zaragoza,294,Villarroya del Campo,83,48,35
50,Zaragoza,282,"Vilueña, La",106,54,52
50,Zaragoza,295,Vistabella,47,31,16
50,Zaragoza,296,"Zaida, La",481,234,247
50,Zaragoza,297,Zaragoza,666058,320232,345826
50,Zaragoza,298,Zuera,7742,3984,3758
51,Ceuta,1,Ceuta,84963,43354,41609
52,Melilla,1,Melilla,84509,43075,41434
