province_code,province_name,cmun,municipality_name,population_total,population_male,population_female
01,Álava,1,Alegría-Dulantzi,2467,1290,1177
01,Álava,2,Amurrio,10027,5040,4987
01,Álava,49,Añana,176,90,86
01,Álava,3,Aramaio,1489,775,714
01,Álava,6,Armiñón,198,103,95
01,Álava,37,Arraia-Maeztu,707,395,312
01,Álava,8,Arrazua-Ubarrundia,902,473,429
01,Álava,4,Artziniega,1764,894,870
01,Álava,9,Asparrena,1595,804,791
01,Álava,10,Ayala/Aiara,2710,1360,1350
01,Álava,11,Baños de Ebro/Mañueta,357,199,158
01,Álava,13,Barrundia,841,474,367
01,Álava,14,Berantevilla,447,227,220
01,Álava,16,Bernedo,588,330,258
01,Álava,17,Campezo/Kanpezu,1108,593,515
01,Álava,21,Elburgo/Burgelu,526,275,251
01,Álava,22,Elciego,1025,508,517
01,Álava,23,Elvillar/Bilar,357,182,175
01,Álava,56,Harana/Valle de Arana,311,181,130
01,Álava,901,Iruña Oka/Iruña de Oca,2783,1467,1316
01,Álava,27,Iruraiz-Gauna,486,261,225
01,Álava,19,Kripan,184,101,83
01,Álava,20,Kuartango,357,204,153
01,Álava,28,Labastida/Bastida,1503,803,700
01,Álava,30,Lagrán,190,100,90
01,Álava,31,Laguardia,1506,778,728
01,Álava,32,Lanciego/Lantziego,683,361,322
01,Álava,902,Lantarón,938,524,414
01,Álava,33,Lapuebla de Labarca,910,464,446
01,Álava,36,Laudio/Llodio,18276,9033,9243
01,Álava,58,Legutiano,1604,836,768
01,Álava,34,Leza,226,125,101
01,Álava,39,Moreda de Álava,267,134,133
01,Álava,41,Navaridas,219,114,105
01,Álava,42,Okondo,1076,568,508
01,Álava,43,Oyón-Oion,3101,1572,1529
01,Álava,44,Peñacerrada-Urizaharra,271,156,115
01,Álava,46,Ribera Alta,705,399,306
01,Álava,47,Ribera Baja/Erribera Beitia,1173,636,537
01,Álava,51,Salvatierra/Agurain,4628,2345,2283
01,Álava,52,Samaniego,329,178,151
01,Álava,53,San Millán/Donemiliaga,715,400,315
01,Álava,54,Urkabustaiz,1159,613,546
01,Álava,55,Valdegovía/Gaubea,1148,632,516
01,Álava,57,Villabuena de Álava/Eskuernaga,317,160,157
01,Álava,59,Vitoria-Gasteiz,232477,114703,117774
01,Álava,60,Yécora/Iekora,299,156,143
01,Álava,61,Zalduondo,184,100,84
01,Álava,62,Zambrana,358,198,160
01,Álava,18,Zigoitia,1589,838,751
01,Álava,63,Zuia,2379,1224,1155
02,Albacete,1,Abengibre,940,478,462
02,Albacete,2,Alatoz,590,320,270
02,Albacete,3,Albacete,166909,82546,84363
02,Albacete,4,Albatana,817,408,409
02,Albacete,5,Alborea,878,459,419
02,Albacete,6,Alcadozo,736,380,356
02,Albacete,7,Alcalá del Júcar,1376,726,650
02,Albacete,8,Alcaraz,1698,843,855
02,Albacete,9,Almansa,25591,12693,12898
02,Albacete,10,Alpera,2384,1246,1138
02,Albacete,11,Ayna,863,463,400
02,Albacete,12,Balazote,2450,1260,1190
02,Albacete,14,Ballestero (El),488,253,235
02,Albacete,13,Balsa de Ves,222,115,107
02,Albacete,15,Barrax,2033,1031,1002
02,Albacete,16,Bienservida,763,388,375
02,Albacete,17,Bogarra,1043,546,497
02,Albacete,18,Bonete,1245,640,605
02,Albacete,19,Bonillo (El),3085,1566,1519
02,Albacete,20,Carcelén,639,349,290
02,Albacete,21,Casas de Juan Núñez,1385,720,665
02,Albacete,22,Casas de Lázaro,472,256,216
02,Albacete,23,Casas de Ves,789,413,376
02,Albacete,24,Casas-Ibáñez,4674,2408,2266
02,Albacete,25,Caudete,10157,5175,4982
02,Albacete,26,Cenizate,1312,695,617
02,Albacete,29,Chinchilla de Monte-Aragón,3660,1922,1738
02,Albacete,27,Corral-Rubio,411,213,198
02,Albacete,28,Cotillas,163,86,77
02,Albacete,30,Elche de la Sierra,3946,1974,1972
02,Albacete,31,Férez,759,385,374
02,Albacete,32,Fuensanta,366,197,169
02,Albacete,33,Fuente-Álamo,2706,1425,1281
02,Albacete,34,Fuentealbilla,2036,1045,991
02,Albacete,35,Gineta (La),2298,1171,1127
02,Albacete,36,Golosalvo,123,60,63
02,Albacete,37,Hellín,31054,15610,15444
02,Albacete,38,Herrera (La),353,180,173
02,Albacete,39,Higueruela,1289,644,645
02,Albacete,40,Hoya-Gonzalo,776,402,374
02,Albacete,41,Jorquera,477,245,232
02,Albacete,42,Letur,1155,575,580
02,Albacete,43,Lezuza,1701,860,841
02,Albacete,44,Liétor,1452,744,708
02,Albacete,45,Madrigueras,4865,2511,2354
02,Albacete,46,Mahora,1423,706,717
02,Albacete,47,Masegoso,99,56,43
02,Albacete,48,Minaya,1800,922,878
02,Albacete,49,Molinicos,1120,569,551
02,Albacete,50,Montalvos,141,76,65
02,Albacete,51,Montealegre del Castillo,2344,1219,1125
02,Albacete,52,Motilleja,585,297,288
02,Albacete,53,Munera,3885,1961,1924
02,Albacete,54,Navas de Jorquera,533,277,256
02,Albacete,55,Nerpio,1571,853,718
02,Albacete,56,Ontur,2357,1173,1184
02,Albacete,57,Ossa de Montiel,2727,1363,1364
02,Albacete,58,Paterna del Madera,469,242,227
02,Albacete,60,Peñas de San Pedro,1283,702,581
02,Albacete,59,Peñascosa,409,206,203
02,Albacete,61,Pétrola,879,461,418
02,Albacete,62,Povedilla,585,311,274
02,Albacete,901,Pozo Cañada,2888,1461,1427
02,Albacete,63,Pozohondo,1810,947,863
02,Albacete,64,Pozo-Lorente,485,247,238
02,Albacete,65,Pozuelo,650,338,312
02,Albacete,66,Recueja (La),330,157,173
02,Albacete,67,Riópar,1509,778,731
02,Albacete,68,Robledo,467,230,237
02,Albacete,69,Roda (La),16034,8190,7844
02,Albacete,70,Salobre,610,314,296
02,Albacete,71,San Pedro,1268,663,605
02,Albacete,72,Socovos,1942,1010,932
02,Albacete,73,Tarazona de la Mancha,6654,3386,3268
02,Albacete,74,Tobarra,8073,4125,3948
02,Albacete,75,Valdeganga,1940,978,962
02,Albacete,76,Vianos,431,210,221
02,Albacete,77,Villa de Ves,60,28,32
02,Albacete,78,Villalgordo del Júcar,1274,661,613
02,Albacete,79,Villamalea,4024,2057,1967
02,Albacete,80,Villapalacios,697,356,341
02,Albacete,81,Villarrobledo,26311,13250,13061
02,Albacete,82,Villatoya,144,73,71
02,Albacete,83,Villavaliente,275,149,126
02,Albacete,84,Villaverde de Guadalimar,430,230,200
02,Albacete,85,Viveros,421,217,204
02,Albacete,86,Yeste,3427,1745,1682
03,Alicante/Alacant,1,Adsubia,686,350,336
03,Alicante/Alacant,2,Agost,4813,2433,2380
03,Alicante/Alacant,3,Agres,627,328,299
03,Alicante/Alacant,4,Aigües,1047,531,516
03,Alicante/Alacant,5,Albatera,11656,6050,5606
03,Alicante/Alacant,6,Alcalalí,1500,772,728
03,Alicante/Alacant,7,Alcocer de Planes,234,112,122
03,Alicante/Alacant,8,Alcoleja,211,108,103
03,Alicante/Alacant,9,Alcoy/Alcoi,61698,29916,31782
03,Alicante/Alacant,10,Alfafara,422,211,211
03,Alicante/Alacant,11,Alfàs del Pi (l'),20939,10513,10426
03,Alicante/Alacant,12,Algorfa,4125,2062,2063
03,Alicante/Alacant,13,Algueña,1561,768,793
03,Alicante/Alacant,14,Alicante/Alacant,331750,161602,170148
03,Alicante/Alacant,15,Almoradí,18536,9469,9067
03,Alicante/Alacant,16,Almudaina,129,70,59
03,Alicante/Alacant,17,Alqueria d'Asnar (l'),470,224,246
03,Alicante/Alacant,18,Altea,23532,11823,11709
03,Alicante/Alacant,19,Aspe,19893,10039,9854
03,Alicante/Alacant,20,Balones,157,75,82
03,Alicante/Alacant,21,Banyeres de Mariola,7194,3609,3585
03,Alicante/Alacant,22,Benasau,198,97,101
03,Alicante/Alacant,23,Beneixama,1837,928,909
03,Alicante/Alacant,24,Benejúzar,5472,2771,2701
03,Alicante/Alacant,25,Benferri,1746,901,845
03,Alicante/Alacant,26,Beniarbeig,1889,947,942
03,Alicante/Alacant,27,Beniardá,258,138,120
03,Alicante/Alacant,28,Beniarrés,1323,664,659
03,Alicante/Alacant,30,Benidoleig,1221,590,631
03,Alicante/Alacant,31,Benidorm,70280,35516,34764
03,Alicante/Alacant,32,Benifallim,115,53,62
03,Alicante/Alacant,33,Benifato,194,103,91
03,Alicante/Alacant,29,Benigembla,571,292,279
03,Alicante/Alacant,34,Benijófar,3900,1940,1960
03,Alicante/Alacant,35,Benilloba,837,418,419
03,Alicante/Alacant,36,Benillup,102,46,56
03,Alicante/Alacant,37,Benimantell,472,225,247
03,Alicante/Alacant,38,Benimarfull,440,226,214
03,Alicante/Alacant,39,Benimassot,125,70,55
03,Alicante/Alacant,40,Benimeli,427,215,212
03,Alicante/Alacant,41,Benissa,13140,6649,6491
03,Alicante/Alacant,42,Benitachell/Poble Nou de Benitatxell (el),5216,2635,2581
03,Alicante/Alacant,43,Biar,3694,1811,1883
03,Alicante/Alacant,44,Bigastro,6761,3476,3285
03,Alicante/Alacant,45,Bolulla,415,211,204
03,Alicante/Alacant,46,Busot,3021,1528,1493
03,Alicante/Alacant,49,Callosa de Segura,17425,8854,8571
03,Alicante/Alacant,48,Callosa d'En Sarrià,8224,4289,3935
03,Alicante/Alacant,47,Calpe/Calp,29228,15044,14184
03,Alicante/Alacant,50,Campello (el),26043,12984,13059
03,Alicante/Alacant,51,Campo de Mirra/Camp de Mirra (el),426,211,215
03,Alicante/Alacant,52,Cañada,1217,587,630
03,Alicante/Alacant,53,Castalla,10021,5053,4968
03,Alicante/Alacant,54,Castell de Castells,505,248,257
03,Alicante/Alacant,75,Castell de Guadalest (el),217,106,111
03,Alicante/Alacant,55,Catral,8629,4399,4230
03,Alicante/Alacant,56,Cocentaina,11383,5679,5704
03,Alicante/Alacant,57,Confrides,279,151,128
03,Alicante/Alacant,58,Cox,6642,3393,3249
03,Alicante/Alacant,59,Crevillent,28432,14599,13833
03,Alicante/Alacant,61,Daya Nueva,1903,971,932
03,Alicante/Alacant,62,Daya Vieja,598,306,292
03,Alicante/Alacant,63,Dénia,44035,22020,22015
03,Alicante/Alacant,64,Dolores,7313,3717,3596
03,Alicante/Alacant,65,Elche/Elx,228348,114500,113848
03,Alicante/Alacant,66,Elda,55174,27237,27937
03,Alicante/Alacant,67,Facheca,108,56,52
03,Alicante/Alacant,68,Famorca,48,21,27
03,Alicante/Alacant,69,Finestrat,5844,3024,2820
03,Alicante/Alacant,77,Fondó de les Neus (el)/Hondón de las Nieves,2730,1397,1333
03,Alicante/Alacant,70,Formentera del Segura,4118,2156,1962
03,Alicante/Alacant,72,Gaianes,380,193,187
03,Alicante/Alacant,71,Gata de Gorgos,6195,3190,3005
03,Alicante/Alacant,73,Gorga,235,127,108
03,Alicante/Alacant,74,Granja de Rocamora,2323,1220,1103
03,Alicante/Alacant,76,Guardamar del Segura,15951,8053,7898
03,Alicante/Alacant,78,Hondón de los Frailes,1205,623,582
03,Alicante/Alacant,79,Ibi,24093,12116,11977
03,Alicante/Alacant,80,Jacarilla,2088,1036,1052
03,Alicante/Alacant,82,Jávea/Xàbia,31140,15660,15480
03,Alicante/Alacant,83,Jijona/Xixona,7575,3670,3905
03,Alicante/Alacant,85,Llíber,1062,538,524
03,Alicante/Alacant,84,Lorcha/Orxa (l'),748,373,375
03,Alicante/Alacant,86,Millena,195,100,95
03,Alicante/Alacant,88,Monforte del Cid,7006,3696,3310
03,Alicante/Alacant,89,Monóvar/Monòver,13056,6488,6568
03,Alicante/Alacant,903,Montesinos (Los),4736,2385,2351
03,Alicante/Alacant,91,Murla,601,292,309
03,Alicante/Alacant,92,Muro de Alcoy,8725,4330,4395
03,Alicante/Alacant,90,Mutxamel,21481,10801,10680
03,Alicante/Alacant,93,Novelda,27008,13513,13495
03,Alicante/Alacant,94,Nucia (la),16958,8603,8355
03,Alicante/Alacant,95,Ondara,6457,3251,3206
03,Alicante/Alacant,96,Onil,7709,3876,3833
03,Alicante/Alacant,97,Orba,2566,1271,1295
03,Alicante/Alacant,99,Orihuela,84626,42722,41904
03,Alicante/Alacant,98,Orxeta,830,419,411
03,Alicante/Alacant,100,Parcent,1066,526,540
03,Alicante/Alacant,101,Pedreguer,7480,3750,3730
03,Alicante/Alacant,102,Pego,11043,5677,5366
03,Alicante/Alacant,103,Penàguila,323,167,156
03,Alicante/Alacant,104,Petrer,34109,17052,17057
03,Alicante/Alacant,902,Pilar de la Horadada,21424,11193,10231
03,Alicante/Alacant,105,Pinós (el)/Pinoso,7623,3877,3746
03,Alicante/Alacant,106,Planes,839,423,416
03,Alicante/Alacant,901,Poblets (els),3267,1583,1684
03,Alicante/Alacant,107,Polop,4112,2108,2004
03,Alicante/Alacant,60,Quatretondeta,137,68,69
03,Alicante/Alacant,109,Rafal,4028,2068,1960
03,Alicante/Alacant,110,"Ràfol d'Almúnia, el",692,335,357
03,Alicante/Alacant,111,Redován,7261,3713,3548
03,Alicante/Alacant,112,Relleu,1205,618,587
03,Alicante/Alacant,113,Rojales,19247,9862,9385
03,Alicante/Alacant,114,Romana (la),2539,1333,1206
03,Alicante/Alacant,115,Sagra,434,219,215
03,Alicante/Alacant,116,Salinas,1588,816,772
03,Alicante/Alacant,118,San Fulgencio,11594,5899,5695
03,Alicante/Alacant,904,San Isidro,1708,881,827
03,Alicante/Alacant,120,San Miguel de Salinas,8056,4094,3962
03,Alicante/Alacant,122,San Vicente del Raspeig/Sant Vicent del Raspeig,51507,25664,25843
03,Alicante/Alacant,117,Sanet y Negrals,740,353,387
03,Alicante/Alacant,119,Sant Joan d'Alacant,21681,10625,11056
03,Alicante/Alacant,121,Santa Pola,30987,15688,15299
03,Alicante/Alacant,123,Sax,9908,5032,4876
03,Alicante/Alacant,124,Sella,646,335,311
03,Alicante/Alacant,125,Senija,645,343,302
03,Alicante/Alacant,127,Tàrbena,772,398,374
03,Alicante/Alacant,128,Teulada,14236,7241,6995
03,Alicante/Alacant,129,Tibi,1677,883,794
03,Alicante/Alacant,130,Tollos,65,33,32
03,Alicante/Alacant,131,Tormos,375,193,182
03,Alicante/Alacant,132,Torremanzanas/Torre de les Maçanes (la),758,395,363
03,Alicante/Alacant,133,Torrevieja,101381,52035,49346
03,Alicante/Alacant,134,Vall d'Alcalà (la),186,94,92
03,Alicante/Alacant,136,Vall de Gallinera,671,353,318
03,Alicante/Alacant,137,Vall de Laguar (la),997,468,529
03,Alicante/Alacant,135,Vall d'Ebo (la),299,142,157
03,Alicante/Alacant,138,Verger (el),4847,2520,2327
03,Alicante/Alacant,139,Villajoyosa/Vila Joiosa (la),32534,16327,16207
03,Alicante/Alacant,140,Villena,34928,17469,17459
03,Alicante/Alacant,81,Xaló,3189,1607,1582
04,Almería,1,Abla,1503,771,732
04,Almería,2,Abrucena,1366,687,679
04,Almería,3,Adra,23880,12083,11797
04,Almería,4,Albánchez,726,376,350
04,Almería,5,Alboloduy,703,345,358
04,Almería,6,Albox,11427,5962,5465
04,Almería,7,Alcolea,927,487,440
04,Almería,8,Alcóntar,597,310,287
04,Almería,9,Alcudia de Monteagud,148,74,74
04,Almería,10,Alhabia,721,352,369
04,Almería,11,Alhama de Almería,3724,1881,1843
04,Almería,12,Alicún,261,138,123
04,Almería,13,Almería,187521,92046,95475
04,Almería,14,Almócita,163,82,81
04,Almería,15,Alsodux,173,98,75
04,Almería,16,Antas,3389,1718,1671
04,Almería,17,Arboleas,4301,2188,2113
04,Almería,18,Armuña de Almanzora,330,168,162
04,Almería,19,Bacares,283,147,136
04,Almería,20,Bayárcal,317,177,140
04,Almería,21,Bayarque,244,132,112
04,Almería,22,Bédar,976,503,473
04,Almería,23,Beires,132,67,65
04,Almería,24,Benahadux,3814,1873,1941
04,Almería,26,Benitagla,94,55,39
04,Almería,27,Benizalón,293,150,143
04,Almería,28,Bentarique,277,152,125
04,Almería,29,Berja,15001,7463,7538
04,Almería,30,Canjáyar,1529,786,743
04,Almería,31,Cantoria,4025,2059,1966
04,Almería,32,Carboneras,7787,4029,3758
04,Almería,33,Castro de Filabres,160,82,78
04,Almería,36,Chercos,299,149,150
04,Almería,37,Chirivel,1839,908,931
04,Almería,34,Cóbdar,198,104,94
04,Almería,35,Cuevas del Almanzora,12596,6557,6039
04,Almería,38,Dalías,3934,1935,1999
04,Almería,902,Ejido (El),80987,45565,35422
04,Almería,41,Enix,510,275,235
04,Almería,43,Felix,675,359,316
04,Almería,44,Fines,2220,1193,1027
04,Almería,45,Fiñana,2451,1243,1208
04,Almería,46,Fondón,985,504,481
04,Almería,47,Gádor,3190,1663,1527
04,Almería,48,Gallardos (Los),3689,1917,1772
04,Almería,49,Garrucha,8491,4434,4057
04,Almería,50,Gérgal,1126,587,539
04,Almería,51,Huécija,530,266,264
04,Almería,52,Huércal de Almería,13990,7170,6820
04,Almería,53,Huércal-Overa,16834,8398,8436
04,Almería,54,Illar,429,225,204
04,Almería,55,Instinción,502,245,257
04,Almería,56,Laroya,142,79,63
04,Almería,57,Láujar de Andarax,1784,887,897
04,Almería,58,Líjar,492,261,231
04,Almería,59,Lubrín,1784,877,907
04,Almería,60,Lucainena de las Torres,696,393,303
04,Almería,61,Lúcar,883,442,441
04,Almería,62,Macael,6212,3221,2991
04,Almería,63,María,1484,743,741
04,Almería,64,Mojácar,6805,3461,3344
04,Almería,903,Mojonera (La),8102,4413,3689
04,Almería,65,Nacimiento,465,246,219
04,Almería,66,Níjar,26126,14530,11596
04,Almería,67,Ohanes,784,384,400
04,Almería,68,Olula de Castro,215,108,107
04,Almería,69,Olula del Río,6704,3470,3234
04,Almería,70,Oria,2920,1525,1395
04,Almería,71,Padules,513,262,251
04,Almería,72,Partaloa,819,406,413
04,Almería,73,Paterna del Río,475,260,215
04,Almería,74,Pechina,3614,1833,1781
04,Almería,75,Pulpí,8013,4259,3754
04,Almería,76,Purchena,1673,838,835
04,Almería,77,Rágol,385,184,201
04,Almería,78,Rioja,1418,705,713
04,Almería,79,Roquetas de Mar,77423,40038,37385
04,Almería,80,Santa Cruz de Marchena,240,122,118
04,Almería,81,Santa Fe de Mondújar,511,258,253
04,Almería,82,Senés,348,179,169
04,Almería,83,Serón,2409,1211,1198
04,Almería,84,Sierro,451,224,227
04,Almería,85,Somontín,542,274,268
04,Almería,86,Sorbas,2923,1543,1380
04,Almería,87,Suflí,288,153,135
04,Almería,88,Tabernas,3632,1891,1741
04,Almería,89,Taberno,1133,564,569
04,Almería,90,Tahal,439,235,204
04,Almería,91,Terque,456,229,227
04,Almería,92,Tíjola,3961,1971,1990
04,Almería,901,Tres Villas (Las),690,361,329
04,Almería,93,Turre,3453,1776,1677
04,Almería,94,Turrillas,235,135,100
04,Almería,95,Uleila del Campo,1005,515,490
04,Almería,96,Urrácal,368,178,190
04,Almería,97,Velefique,320,174,146
04,Almería,98,Vélez-Blanco,2223,1168,1055
04,Almería,99,Vélez-Rubio,7147,3501,3646
04,Almería,100,Vera,13473,6916,6557
04,Almería,101,Viator,4689,2366,2323
04,Almería,102,Vícar,21515,11338,10177
04,Almería,103,Zurgena,2986,1471,1515
05,Ávila,1,Adanero,306,155,151
05,Ávila,2,Adrada (La),2673,1396,1277
05,Ávila,5,Albornos,251,135,116
05,Ávila,7,Aldeanueva de Santa Cruz,150,84,66
05,Ávila,8,Aldeaseca,279,141,138
05,Ávila,10,Aldehuela (La),210,102,108
05,Ávila,12,Amavida,184,93,91
05,Ávila,13,Arenal (El),1098,552,546
05,Ávila,14,Arenas de San Pedro,6874,3386,3488
05,Ávila,15,Arevalillo,115,56,59
05,Ávila,16,Arévalo,8030,3912,4118
05,Ávila,17,Aveinte,108,60,48
05,Ávila,18,Avellaneda,32,16,16
05,Ávila,19,Ávila,56144,27102,29042
05,Ávila,21,Barco de Ávila (El),2624,1277,1347
05,Ávila,22,Barraco (El),2165,1099,1066
05,Ávila,23,Barromán,231,127,104
05,Ávila,24,Becedas,307,157,150
05,Ávila,25,Becedillas,136,75,61
05,Ávila,26,Bercial de Zapardiel,253,125,128
05,Ávila,27,Berlanas (Las),353,178,175
05,Ávila,29,Bernuy-Zapardiel,158,88,70
05,Ávila,30,Berrocalejo de Aragona,51,28,23
05,Ávila,33,Blascomillán,241,118,123
05,Ávila,34,Blasconuño de Matacabras,18,9,9
05,Ávila,35,Blascosancho,129,66,63
05,Ávila,36,Bohodón (El),157,80,77
05,Ávila,37,Bohoyo,370,197,173
05,Ávila,38,Bonilla de la Sierra,149,79,70
05,Ávila,39,Brabos,60,33,27
05,Ávila,40,Bularros,94,55,39
05,Ávila,41,Burgohondo,1277,664,613
05,Ávila,42,Cabezas de Alambre,181,92,89
05,Ávila,43,Cabezas del Pozo,111,59,52
05,Ávila,44,Cabezas del Villar,373,206,167
05,Ávila,45,Cabizuela,119,58,61
05,Ávila,46,Canales,54,30,24
05,Ávila,47,Candeleda,5145,2651,2494
05,Ávila,48,Cantiveros,157,81,76
05,Ávila,49,Cardeñosa,539,286,253
05,Ávila,51,Carrera (La),213,108,105
05,Ávila,52,Casas del Puerto,113,59,54
05,Ávila,53,Casasola,111,57,54
05,Ávila,54,Casavieja,1619,836,783
05,Ávila,55,Casillas,849,455,394
05,Ávila,56,Castellanos de Zapardiel,116,65,51
05,Ávila,57,Cebreros,3524,1808,1716
05,Ávila,58,Cepeda la Mora,113,61,52
05,Ávila,67,Chamartín,97,57,40
05,Ávila,59,Cillán,124,73,51
05,Ávila,60,Cisla,157,75,82
05,Ávila,61,Colilla (La),309,152,157
05,Ávila,62,Collado de Contreras,233,125,108
05,Ávila,63,Collado del Mirón,51,26,25
05,Ávila,64,Constanzana,146,84,62
05,Ávila,65,Crespos,592,307,285
05,Ávila,66,Cuevas del Valle,550,297,253
05,Ávila,903,Diego del Carpio,206,113,93
05,Ávila,69,Donjimeno,109,61,48
05,Ávila,70,Donvidas,58,33,25
05,Ávila,72,Espinosa de los Caballeros,114,64,50
05,Ávila,73,Flores de Ávila,372,200,172
05,Ávila,74,Fontiveros,874,457,417
05,Ávila,75,Fresnedilla,103,45,58
05,Ávila,76,Fresno (El),541,285,256
05,Ávila,77,Fuente el Saúz,237,125,112
05,Ávila,78,Fuentes de Año,151,82,69
05,Ávila,79,Gallegos de Altamiros,68,41,27
05,Ávila,80,Gallegos de Sobrinos,82,39,43
05,Ávila,81,Garganta del Villar,55,33,22
05,Ávila,82,Gavilanes,636,348,288
05,Ávila,83,Gemuño,182,89,93
05,Ávila,85,Gil García,42,21,21
05,Ávila,84,Gilbuena,93,55,38
05,Ávila,86,Gimialcón,95,56,39
05,Ávila,87,Gotarrendura,189,64,125
05,Ávila,88,Grandes y San Martín,41,23,18
05,Ávila,89,Guisando,604,310,294
05,Ávila,90,Gutierre-Muñoz,105,50,55
05,Ávila,92,Hernansancho,216,113,103
05,Ávila,93,Herradón de Pinares,592,332,260
05,Ávila,94,Herreros de Suso,173,90,83
05,Ávila,95,Higuera de las Dueñas,338,190,148
05,Ávila,96,Hija de Dios (La),74,42,32
05,Ávila,97,Horcajada (La),624,313,311
05,Ávila,99,Horcajo de las Torres,637,353,284
05,Ávila,100,Hornillo (El),373,196,177
05,Ávila,102,Hoyo de Pinares (El),2369,1240,1129
05,Ávila,101,Hoyocasero,342,182,160
05,Ávila,103,Hoyorredondo,95,56,39
05,Ávila,106,Hoyos de Miguel Muñoz,45,23,22
05,Ávila,104,Hoyos del Collado,38,22,16
05,Ávila,105,Hoyos del Espino,468,254,214
05,Ávila,107,Hurtumpascual,86,53,33
05,Ávila,108,Junciana,96,55,41
05,Ávila,109,Langa,547,276,271
05,Ávila,110,Lanzahíta,993,534,459
05,Ávila,113,Llanos de Tormes (Los),99,51,48
05,Ávila,112,Losar del Barco (El),124,66,58
05,Ávila,114,Madrigal de las Altas Torres,1721,880,841
05,Ávila,115,Maello,717,378,339
05,Ávila,116,Malpartida de Corneja,160,79,81
05,Ávila,117,Mamblas,234,128,106
05,Ávila,118,Mancera de Arriba,104,55,49
05,Ávila,119,Manjabálago,45,25,20
05,Ávila,120,Marlín,43,24,19
05,Ávila,121,Martiherrero,279,142,137
05,Ávila,122,Martínez,173,91,82
05,Ávila,123,Mediana de Voltoya,107,52,55
05,Ávila,124,Medinilla,146,69,77
05,Ávila,125,Mengamuñoz,67,32,35
05,Ávila,126,Mesegar de Corneja,87,46,41
05,Ávila,127,Mijares,866,458,408
05,Ávila,128,Mingorría,459,241,218
05,Ávila,129,Mirón (El),186,108,78
05,Ávila,130,Mironcillo,118,63,55
05,Ávila,131,Mirueña de los Infanzones,127,69,58
05,Ávila,132,Mombeltrán,1241,637,604
05,Ávila,133,Monsalupe,70,34,36
05,Ávila,134,Moraleja de Matacabras,53,27,26
05,Ávila,135,Muñana,532,272,260
05,Ávila,136,Muñico,130,69,61
05,Ávila,138,Muñogalindo,410,228,182
05,Ávila,139,Muñogrande,80,43,37
05,Ávila,140,Muñomer del Peco,146,77,69
05,Ávila,141,Muñopepe,99,59,40
05,Ávila,142,Muñosancho,118,57,61
05,Ávila,143,Muñotello,96,52,44
05,Ávila,144,Narrillos del Álamo,102,51,51
05,Ávila,145,Narrillos del Rebollar,53,29,24
05,Ávila,149,Narros de Saldueña,138,74,64
05,Ávila,147,Narros del Castillo,184,102,82
05,Ávila,148,Narros del Puerto,54,31,23
05,Ávila,152,Nava de Arévalo,913,482,431
05,Ávila,153,Nava del Barco,117,59,58
05,Ávila,151,Navacepedilla de Corneja,107,58,49
05,Ávila,154,Navadijos,62,37,25
05,Ávila,155,Navaescurial,64,39,25
05,Ávila,156,Navahondilla,311,175,136
05,Ávila,157,Navalacruz,263,127,136
05,Ávila,158,Navalmoral,476,249,227
05,Ávila,159,Navalonguilla,338,176,162
05,Ávila,160,Navalosa,408,221,187
05,Ávila,161,Navalperal de Pinares,978,512,466
05,Ávila,162,Navalperal de Tormes,125,72,53
05,Ávila,163,Navaluenga,2297,1175,1122
05,Ávila,164,Navaquesera,39,16,23
05,Ávila,165,Navarredonda de Gredos,463,234,229
05,Ávila,166,Navarredondilla,255,124,131
05,Ávila,167,Navarrevisca,369,197,172
05,Ávila,168,Navas del Marqués (Las),5723,2976,2747
05,Ávila,169,Navatalgordo,281,148,133
05,Ávila,170,Navatejares,75,32,43
05,Ávila,171,Neila de San Miguel,92,48,44
05,Ávila,172,Niharra,176,93,83
05,Ávila,173,Ojos-Albos,67,37,30
05,Ávila,174,Orbita,102,52,50
05,Ávila,175,Oso (El),196,110,86
05,Ávila,176,Padiernos,256,138,118
05,Ávila,177,Pajares de Adaja,195,101,94
05,Ávila,178,Palacios de Goda,449,230,219
05,Ávila,179,Papatrigo,275,143,132
05,Ávila,180,Parral (El),115,64,51
05,Ávila,181,Pascualcobo,34,19,15
05,Ávila,182,Pedro Bernardo,1053,550,503
05,Ávila,183,Pedro-Rodríguez,218,102,116
05,Ávila,184,Peguerinos,389,215,174
05,Ávila,185,Peñalba de Ávila,130,75,55
05,Ávila,186,Piedrahíta,2072,1005,1067
05,Ávila,187,Piedralaves,2250,1166,1084
05,Ávila,188,Poveda,70,42,28
05,Ávila,189,Poyales del Hoyo,639,329,310
05,Ávila,190,Pozanco,60,38,22
05,Ávila,191,Pradosegar,163,92,71
05,Ávila,192,Puerto Castilla,125,72,53
05,Ávila,193,Rasueros,260,142,118
05,Ávila,194,Riocabado,192,106,86
05,Ávila,195,Riofrío,274,155,119
05,Ávila,196,Rivilla de Barajas,75,33,42
05,Ávila,197,Salobral,120,61,59
05,Ávila,198,Salvadiós,93,48,45
05,Ávila,199,San Bartolomé de Béjar,48,24,24
05,Ávila,200,San Bartolomé de Corneja,71,32,39
05,Ávila,201,San Bartolomé de Pinares,659,342,317
05,Ávila,206,San Esteban de los Patos,26,13,13
05,Ávila,208,San Esteban de Zapardiel,57,32,25
05,Ávila,207,San Esteban del Valle,863,447,416
05,Ávila,209,San García de Ingelmos,124,71,53
05,Ávila,901,San Juan de Gredos,374,211,163
05,Ávila,210,San Juan de la Encinilla,111,56,55
05,Ávila,211,San Juan de la Nava,554,288,266
05,Ávila,212,San Juan del Molinillo,309,178,131
05,Ávila,213,San Juan del Olmo,129,75,54
05,Ávila,214,San Lorenzo de Tormes,58,31,27
05,Ávila,215,San Martín de la Vega del Alberche,217,130,87
05,Ávila,216,San Martín del Pimpollar,249,140,109
05,Ávila,217,San Miguel de Corneja,87,41,46
05,Ávila,218,San Miguel de Serrezuela,166,94,72
05,Ávila,219,San Pascual,49,35,14
05,Ávila,220,San Pedro del Arroyo,510,280,230
05,Ávila,231,San Vicente de Arévalo,212,113,99
05,Ávila,204,Sanchidrián,850,424,426
05,Ávila,205,Sanchorreja,122,57,65
05,Ávila,222,Santa Cruz de Pinares,197,107,90
05,Ávila,221,Santa Cruz del Valle,487,247,240
05,Ávila,226,Santa María de los Caballeros,105,57,48
05,Ávila,224,Santa María del Arroyo,111,62,49
05,Ávila,225,Santa María del Berrocal,456,222,234
05,Ávila,902,Santa María del Cubillo,358,204,154
05,Ávila,227,Santa María del Tiétar,623,336,287
05,Ávila,228,Santiago del Collado,227,143,84
05,Ávila,904,Santiago del Tormes,158,83,75
05,Ávila,229,Santo Domingo de las Posadas,83,43,40
05,Ávila,230,Santo Tomé de Zabarcos,90,50,40
05,Ávila,232,Serrada (La),123,66,57
05,Ávila,233,Serranillos,311,166,145
05,Ávila,234,Sigeres,67,33,34
05,Ávila,235,Sinlabajos,152,84,68
05,Ávila,236,Solana de Ávila,168,90,78
05,Ávila,237,Solana de Rioalmar,250,127,123
05,Ávila,238,Solosancho,999,524,475
05,Ávila,239,Sotalbo,262,138,124
05,Ávila,240,Sotillo de la Adrada,4742,2396,2346
05,Ávila,241,Tiemblo (El),4330,2242,2088
05,Ávila,242,Tiñosillos,812,414,398
05,Ávila,243,Tolbaños,104,50,54
05,Ávila,244,Tormellas,77,40,37
05,Ávila,245,Tornadizos de Ávila,431,212,219
05,Ávila,247,Torre (La),292,161,131
05,Ávila,246,Tórtoles,93,48,45
05,Ávila,249,Umbrías,132,68,64
05,Ávila,251,Vadillo de la Sierra,97,52,45
05,Ávila,252,Valdecasa,76,41,35
05,Ávila,253,Vega de Santa María,113,60,53
05,Ávila,254,Velayos,242,120,122
05,Ávila,256,Villaflor,143,74,69
05,Ávila,257,Villafranca de la Sierra,165,85,80
05,Ávila,905,Villanueva de Ávila,273,127,146
05,Ávila,258,Villanueva de Gómez,146,72,74
05,Ávila,259,Villanueva del Aceral,158,75,83
05,Ávila,260,Villanueva del Campillo,125,67,58
05,Ávila,261,Villar de Corneja,56,28,28
05,Ávila,262,Villarejo del Valle,448,225,223
05,Ávila,263,Villatoro,194,105,89
05,Ávila,264,Viñegra de Moraña,70,37,33
05,Ávila,265,Vita,100,63,37
05,Ávila,266,Zapardiel de la Cañada,130,61,69
05,Ávila,267,Zapardiel de la Ribera,136,72,64
06,Badajoz,1,Acedera,833,441,392
06,Badajoz,2,Aceuchal,5657,2843,2814
06,Badajoz,3,Ahillones,1058,527,531
06,Badajoz,4,Alange,2019,1029,990
06,Badajoz,5,Albuera (La),1972,1009,963
06,Badajoz,6,Alburquerque,5783,2954,2829
06,Badajoz,7,Alconchel,1966,983,983
06,Badajoz,8,Alconera,739,363,376
06,Badajoz,9,Aljucén,240,131,109
06,Badajoz,10,Almendral,1311,645,666
06,Badajoz,11,Almendralejo,33177,16774,16403
06,Badajoz,12,Arroyo de San Serván,4283,2219,2064
06,Badajoz,13,Atalaya,329,160,169
06,Badajoz,14,Azuaga,8396,4258,4138
06,Badajoz,15,Badajoz,146832,71382,75450
06,Badajoz,16,Barcarrota,3726,1885,1841
06,Badajoz,17,Baterno,362,189,173
06,Badajoz,18,Benquerencia de la Serena,979,479,500
06,Badajoz,19,Berlanga,2511,1233,1278
06,Badajoz,20,Bienvenida,2324,1203,1121
06,Badajoz,21,Bodonal de la Sierra,1146,588,558
06,Badajoz,22,Burguillos del Cerro,3278,1606,1672
06,Badajoz,23,Cabeza del Buey,5499,2708,2791
06,Badajoz,24,Cabeza la Vaca,1499,760,739
06,Badajoz,25,Calamonte,6155,3054,3101
06,Badajoz,26,Calera de León,1070,532,538
06,Badajoz,27,Calzadilla de los Barros,844,420,424
06,Badajoz,28,Campanario,5429,2673,2756
06,Badajoz,29,Campillo de Llerena,1533,752,781
06,Badajoz,30,Capilla,190,94,96
06,Badajoz,31,Carmonita,591,301,290
06,Badajoz,32,Carrascalejo (El),79,43,36
06,Badajoz,33,Casas de Don Pedro,1656,832,824
06,Badajoz,34,Casas de Reina,201,97,104
06,Badajoz,35,Castilblanco,1160,567,593
06,Badajoz,36,Castuera,6652,3259,3393
06,Badajoz,42,Cheles,1308,636,672
06,Badajoz,37,Codosera (La),2305,1214,1091
06,Badajoz,38,Cordobilla de Lácara,983,489,494
06,Badajoz,39,Coronada (La),2238,1106,1132
06,Badajoz,40,Corte de Peleas,1262,617,645
06,Badajoz,41,Cristina,573,302,271
06,Badajoz,43,Don Álvaro,729,367,362
06,Badajoz,44,Don Benito,35334,17526,17808
06,Badajoz,45,Entrín Bajo,616,306,310
06,Badajoz,46,Esparragalejo,1570,771,799
06,Badajoz,47,Esparragosa de la Serena,1094,546,548
06,Badajoz,48,Esparragosa de Lares,1041,507,534
06,Badajoz,49,Feria,1361,678,683
06,Badajoz,50,Fregenal de la Sierra,5277,2580,2697
06,Badajoz,51,Fuenlabrada de los Montes,1935,946,989
06,Badajoz,52,Fuente de Cantos,5086,2517,2569
06,Badajoz,53,Fuente del Arco,772,385,387
06,Badajoz,54,Fuente del Maestre,6939,3459,3480
06,Badajoz,55,Fuentes de León,2588,1286,1302
06,Badajoz,56,Garbayuela,548,293,255
06,Badajoz,57,Garlitos,688,357,331
06,Badajoz,58,Garrovilla (La),2500,1233,1267
06,Badajoz,59,Granja de Torrehermosa,2406,1178,1228
06,Badajoz,60,Guareña,7365,3728,3637
06,Badajoz,61,Haba (La),1383,701,682
06,Badajoz,62,Helechosa de los Montes,722,398,324
06,Badajoz,63,Herrera del Duque,3676,1856,1820
06,Badajoz,64,Higuera de la Serena,1049,540,509
06,Badajoz,65,Higuera de Llerena,364,185,179
06,Badajoz,66,Higuera de Vargas,2152,1086,1066
06,Badajoz,67,Higuera la Real,2519,1273,1246
06,Badajoz,68,Hinojosa del Valle,563,279,284
06,Badajoz,69,Hornachos,3867,1982,1885
06,Badajoz,70,Jerez de los Caballeros,10177,5254,4923
06,Badajoz,71,Lapa (La),294,148,146
06,Badajoz,73,Llera,944,485,459
06,Badajoz,74,Llerena,5943,2954,2989
06,Badajoz,72,Lobón,2655,1369,1286
06,Badajoz,75,Magacela,629,324,305
06,Badajoz,76,Maguilla,1091,539,552
06,Badajoz,77,Malcocinado,452,240,212
06,Badajoz,78,Malpartida de la Serena,676,351,325
06,Badajoz,79,Manchita,754,378,376
06,Badajoz,80,Medellín,2369,1208,1161
06,Badajoz,81,Medina de las Torres,1359,687,672
06,Badajoz,82,Mengabril,477,239,238
06,Badajoz,83,Mérida,55568,27171,28397
06,Badajoz,84,Mirandilla,1374,700,674
06,Badajoz,85,Monesterio,4396,2237,2159
06,Badajoz,86,Montemolín,1520,764,756
06,Badajoz,87,Monterrubio de la Serena,2724,1313,1411
06,Badajoz,88,Montijo,15973,7931,8042
06,Badajoz,89,Morera (La),764,372,392
06,Badajoz,90,Nava de Santiago (La),1105,550,555
06,Badajoz,91,Navalvillar de Pela,4826,2432,2394
06,Badajoz,92,Nogales,718,352,366
06,Badajoz,93,Oliva de la Frontera,5676,2823,2853
06,Badajoz,94,Oliva de Mérida,1878,954,924
06,Badajoz,95,Olivenza,11814,5930,5884
06,Badajoz,96,Orellana de la Sierra,314,165,149
06,Badajoz,97,Orellana la Vieja,3034,1560,1474
06,Badajoz,98,Palomas,691,349,342
06,Badajoz,99,Parra (La),1388,692,696
06,Badajoz,100,Peñalsordo,1235,604,631
06,Badajoz,101,Peraleda del Zaucejo,609,318,291
06,Badajoz,102,Puebla de Alcocer,1291,638,653
06,Badajoz,103,Puebla de la Calzada,5772,2859,2913
06,Badajoz,104,Puebla de la Reina,864,438,426
06,Badajoz,107,Puebla de Obando,2000,1002,998
06,Badajoz,108,Puebla de Sancho Pérez,2886,1449,1437
06,Badajoz,105,Puebla del Maestre,806,404,402
06,Badajoz,106,Puebla del Prior,543,270,273
06,Badajoz,902,Pueblonuevo del Guadiana,2010,1017,993
06,Badajoz,109,Quintana de la Serena,5113,2573,2540
06,Badajoz,110,Reina,196,99,97
06,Badajoz,111,Rena,652,330,322
06,Badajoz,112,Retamal de Llerena,497,270,227
06,Badajoz,113,Ribera del Fresno,3432,1732,1700
06,Badajoz,114,Risco,167,83,84
06,Badajoz,115,Roca de la Sierra (La),1535,761,774
06,Badajoz,116,Salvaleón,2052,1020,1032
06,Badajoz,117,Salvatierra de los Barros,1802,898,904
06,Badajoz,119,San Pedro de Mérida,850,433,417
06,Badajoz,123,San Vicente de Alcántara,5822,2922,2900
06,Badajoz,118,Sancti-Spíritus,242,125,117
06,Badajoz,120,Santa Amalia,4399,2192,2207
06,Badajoz,121,Santa Marta,4287,2152,2135
06,Badajoz,122,Santos de Maimona (Los),8107,4082,4025
06,Badajoz,124,Segura de León,2163,1069,1094
06,Badajoz,125,Siruela,2191,1099,1092
06,Badajoz,126,Solana de los Barros,2814,1397,1417
06,Badajoz,127,Talarrubias,3646,1796,1850
06,Badajoz,128,Talavera la Real,5348,2703,2645
06,Badajoz,129,Táliga,808,407,401
06,Badajoz,130,Tamurejo,257,132,125
06,Badajoz,131,Torre de Miguel Sesmero,1262,641,621
06,Badajoz,132,Torremayor,1000,479,521
06,Badajoz,133,Torremejía,2223,1147,1076
06,Badajoz,134,Trasierra,689,363,326
06,Badajoz,135,Trujillanos,1437,747,690
06,Badajoz,136,Usagre,1968,977,991
06,Badajoz,137,Valdecaballeros,1254,619,635
06,Badajoz,901,Valdelacalzada,2737,1415,1322
06,Badajoz,138,Valdetorres,1329,665,664
06,Badajoz,139,Valencia de las Torres,700,357,343
06,Badajoz,140,Valencia del Mombuey,788,401,387
06,Badajoz,141,Valencia del Ventoso,2238,1123,1115
06,Badajoz,146,Valle de la Serena,1431,707,724
06,Badajoz,147,Valle de Matamoros,431,206,225
06,Badajoz,148,Valle de Santa Ana,1188,604,584
06,Badajoz,142,Valverde de Burguillos,319,165,154
06,Badajoz,143,Valverde de Leganés,4082,2058,2024
06,Badajoz,144,Valverde de Llerena,719,348,371
06,Badajoz,145,Valverde de Mérida,1149,571,578
06,Badajoz,149,Villafranca de los Barros,13201,6556,6645
06,Badajoz,150,Villagarcía de la Torre,986,507,479
06,Badajoz,151,Villagonzalo,1352,664,688
06,Badajoz,152,Villalba de los Barros,1675,845,830
06,Badajoz,153,Villanueva de la Serena,25576,12574,13002
06,Badajoz,154,Villanueva del Fresno,3645,1789,1856
06,Badajoz,156,Villar de Rena,1479,758,721
06,Badajoz,155,Villar del Rey,2447,1299,1148
06,Badajoz,157,Villarta de los Montes,586,289,297
06,Badajoz,158,Zafra,16218,7859,8359
06,Badajoz,159,Zahínos,2903,1448,1455
06,Badajoz,160,Zalamea de la Serena,3978,1982,1996
06,Badajoz,162,Zarza (La),3568,1804,1764
06,Badajoz,161,Zarza-Capilla,417,211,206
07,Balears (Illes),2,Alaior,9133,4598,4535
07,Balears (Illes),1,Alaró,5178,2577,2601
07,Balears (Illes),3,Alcúdia,18327,9466,8861
07,Balears (Illes),4,Algaida,4827,2515,2312
07,Balears (Illes),5,Andratx,11348,5740,5608
07,Balears (Illes),901,Ariany,839,456,383
07,Balears (Illes),6,Artà,7113,3626,3487
07,Balears (Illes),7,Banyalbufar,627,348,279
07,Balears (Illes),8,Binissalem,7030,3562,3468
07,Balears (Illes),9,Búger,1066,541,525
07,Balears (Illes),10,Bunyola,5910,2970,2940
07,Balears (Illes),11,Calvià,50777,25548,25229
07,Balears (Illes),12,Campanet,2601,1307,1294
07,Balears (Illes),13,Campos,9294,4727,4567
07,Balears (Illes),14,Capdepera,11446,5861,5585
07,Balears (Illes),64,Castell (Es),7724,3966,3758
07,Balears (Illes),15,Ciutadella de Menorca,28696,14368,14328
07,Balears (Illes),16,Consell,3413,1731,1682
07,Balears (Illes),17,Costitx,1023,508,515
07,Balears (Illes),18,Deyá,754,398,356
07,Balears (Illes),26,Eivissa,46835,24217,22618
07,Balears (Illes),19,Escorca,276,154,122
07,Balears (Illes),20,Esporles,4696,2343,2353
07,Balears (Illes),21,Estellencs,388,206,182
07,Balears (Illes),22,Felanitx,17969,9374,8595
07,Balears (Illes),23,Ferreries,4617,2372,2245
07,Balears (Illes),24,Formentera,9147,4843,4304
07,Balears (Illes),25,Fornalutx,732,370,362
07,Balears (Illes),27,Inca,29450,15083,14367
07,Balears (Illes),28,Lloret de Vistalegre,1249,637,612
07,Balears (Illes),29,Lloseta,5655,2951,2704
07,Balears (Illes),30,Llubí,2202,1109,1093
07,Balears (Illes),31,Llucmajor,35092,17842,17250
07,Balears (Illes),33,Manacor,39434,19929,19505
07,Balears (Illes),34,Mancor de la Vall,1146,582,564
07,Balears (Illes),32,Maó,28904,14357,14547
07,Balears (Illes),35,Maria de la Salut,2161,1126,1035
07,Balears (Illes),36,Marratxí,32380,16437,15943
07,Balears (Illes),37,Mercadal (Es),5134,2662,2472
07,Balears (Illes),902,Migjorn Gran (Es),1522,741,781
07,Balears (Illes),38,Montuïri,2749,1407,1342
07,Balears (Illes),39,Muro,7058,3652,3406
07,Balears (Illes),40,Palma de Mallorca,396570,195026,201544
07,Balears (Illes),41,Petra,2856,1417,1439
07,Balears (Illes),44,Pobla (Sa),12455,6418,6037
07,Balears (Illes),42,Pollença,16997,8622,8375
07,Balears (Illes),43,Porreres,5272,2816,2456
07,Balears (Illes),45,Puigpunyent,1763,910,853
07,Balears (Illes),59,Salines (Ses),5049,2601,2448
07,Balears (Illes),46,Sant Antoni de Portmany,21082,11058,10024
07,Balears (Illes),49,Sant Joan,1956,995,961
07,Balears (Illes),50,Sant Joan de Labritja,5468,2843,2625
07,Balears (Illes),48,Sant Josep de sa Talaia,21304,11141,10163
07,Balears (Illes),51,Sant Llorenç des Cardassar,8467,4355,4112
07,Balears (Illes),52,Sant Lluís,6704,3399,3305
07,Balears (Illes),53,Santa Eugènia,1562,840,722
07,Balears (Illes),54,Santa Eulalia del Río,30364,15654,14710
07,Balears (Illes),55,Santa Margalida,11207,5777,5430
07,Balears (Illes),56,Santa María del Camí,5672,2854,2818
07,Balears (Illes),57,Santanyí,12303,6263,6040
07,Balears (Illes),58,Selva,3370,1721,1649
07,Balears (Illes),47,Sencelles,3006,1547,1459
07,Balears (Illes),60,Sineu,3398,1703,1695
07,Balears (Illes),61,Sóller,13625,6886,6739
07,Balears (Illes),62,Son Servera,11713,5947,5766
07,Balears (Illes),63,Valldemossa,1977,1014,963
07,Balears (Illes),65,Vilafranca de Bonany,2782,1381,1401
08,Barcelona,1,Abrera,11278,5882,5396
08,Barcelona,2,Aguilar de Segarra,249,132,117
08,Barcelona,14,Aiguafreda,2428,1178,1250
08,Barcelona,3,Alella,9260,4545,4715
08,Barcelona,4,Alpens,312,173,139
08,Barcelona,5,Ametlla del Vallès (L'),7796,3893,3903
08,Barcelona,6,Arenys de Mar,14449,7053,7396
08,Barcelona,7,Arenys de Munt,8023,4004,4019
08,Barcelona,8,Argençola,230,136,94
08,Barcelona,9,Argentona,11544,5741,5803
08,Barcelona,10,Artés,5305,2669,2636
08,Barcelona,11,Avià,2144,1076,1068
08,Barcelona,12,Avinyó,2222,1112,1110
08,Barcelona,13,Avinyonet del Penedès,1660,888,772
08,Barcelona,15,Badalona,215329,107931,107398
08,Barcelona,904,Badia del Vallès,13829,6811,7018
08,Barcelona,16,Bagà,2321,1153,1168
08,Barcelona,17,Balenyà,3672,1838,1834
08,Barcelona,18,Balsareny,3505,1796,1709
08,Barcelona,252,Barberà del Vallès,30271,15131,15140
08,Barcelona,19,Barcelona,1615908,767697,848211
08,Barcelona,20,Begues,6078,3025,3053
08,Barcelona,21,Bellprat,91,52,39
08,Barcelona,22,Berga,17072,8568,8504
08,Barcelona,23,Bigues i Riells,8191,4218,3973
08,Barcelona,24,Borredà,609,325,284
08,Barcelona,25,Bruc (El),1841,990,851
08,Barcelona,26,Brull (El),246,133,113
08,Barcelona,27,Cabanyes (Les),890,449,441
08,Barcelona,28,Cabrera d'Anoia,1274,678,596
08,Barcelona,29,Cabrera de Mar,4321,2211,2110
08,Barcelona,30,Cabrils,6834,3370,3464
08,Barcelona,31,Calaf,3561,1890,1671
08,Barcelona,34,Calders,914,463,451
08,Barcelona,33,Caldes de Montbui,16518,8295,8223
08,Barcelona,32,Caldes d'Estrac,2735,1324,1411
08,Barcelona,35,Calella,18615,9257,9358
08,Barcelona,37,Calldetenes,2329,1187,1142
08,Barcelona,38,Callús,1675,824,851
08,Barcelona,36,Calonge de Segarra,201,107,94
08,Barcelona,39,Campins,380,195,185
08,Barcelona,40,Canet de Mar,13381,6648,6733
08,Barcelona,41,Canovelles,15816,8403,7413
08,Barcelona,42,Cànoves i Samalús,2693,1378,1315
08,Barcelona,43,Canyelles,4005,2060,1945
08,Barcelona,44,Capellades,5458,2693,2765
08,Barcelona,45,Capolat,76,36,40
08,Barcelona,46,Cardedeu,16102,7964,8138
08,Barcelona,47,Cardona,5176,2537,2639
08,Barcelona,48,Carme,805,426,379
08,Barcelona,49,Casserres,1634,812,822
08,Barcelona,57,Castell de l'Areny,78,46,32
08,Barcelona,52,Castellar de n'Hug,208,110,98
08,Barcelona,50,Castellar del Riu,147,77,70
08,Barcelona,51,Castellar del Vallès,22626,11288,11338
08,Barcelona,53,Castellbell i el Vilar,3617,1859,1758
08,Barcelona,54,Castellbisbal,11795,6058,5737
08,Barcelona,55,Castellcir,631,324,307
08,Barcelona,56,Castelldefels,60572,30415,30157
08,Barcelona,58,Castellet i la Gornal,2181,1131,1050
08,Barcelona,60,Castellfollit de Riubregós,192,101,91
08,Barcelona,59,Castellfollit del Boix,425,206,219
08,Barcelona,61,Castellgalí,1760,921,839
08,Barcelona,62,Castellnou de Bages,966,508,458
08,Barcelona,63,Castellolí,474,229,245
08,Barcelona,64,Castellterçol,2325,1164,1161
08,Barcelona,65,Castellví de la Marca,1628,813,815
08,Barcelona,66,Castellví de Rosanes,1659,837,822
08,Barcelona,67,Centelles,7133,3493,3640
08,Barcelona,268,Cercs,1324,676,648
08,Barcelona,266,Cerdanyola del Vallès,58493,28913,29580
08,Barcelona,68,Cervelló,8187,4167,4020
08,Barcelona,69,Collbató,3971,2071,1900
08,Barcelona,70,Collsuspina,334,179,155
08,Barcelona,71,Copons,313,147,166
08,Barcelona,72,Corbera de Llobregat,13435,6861,6574
08,Barcelona,73,Cornellà de Llobregat,85180,42342,42838
08,Barcelona,74,Cubelles,13243,6715,6528
08,Barcelona,75,Dosrius,4869,2459,2410
08,Barcelona,76,Esparreguera,21451,11021,10430
08,Barcelona,77,Esplugues de Llobregat,46586,22795,23791
08,Barcelona,78,Espunyola (L'),269,132,137
08,Barcelona,79,Estany (L'),385,180,205
08,Barcelona,134,Figaró-Montmany,1045,538,507
08,Barcelona,80,Fígols,47,26,21
08,Barcelona,82,Fogars de la Selva,1480,768,712
08,Barcelona,81,Fogars de Montclús,459,248,211
08,Barcelona,83,Folgueroles,2154,1083,1071
08,Barcelona,84,Fonollosa,1362,697,665
08,Barcelona,85,Font-rubí,1461,767,694
08,Barcelona,86,Franqueses del Vallès (Les),16978,8741,8237
08,Barcelona,90,Gaià,160,85,75
08,Barcelona,87,Gallifa,213,112,101
08,Barcelona,88,Garriga (La),14585,7056,7529
08,Barcelona,89,Gavà,45190,22494,22696
08,Barcelona,91,Gelida,6601,3349,3252
08,Barcelona,92,Gironella,5016,2440,2576
08,Barcelona,93,Gisclareny,34,19,15
08,Barcelona,94,Granada (La),1949,996,953
08,Barcelona,95,Granera,72,49,23
08,Barcelona,96,Granollers,60122,30235,29887
08,Barcelona,97,Gualba,1126,574,552
08,Barcelona,99,Guardiola de Berguedà,982,523,459
08,Barcelona,100,Gurb,2394,1228,1166
08,Barcelona,101,Hospitalet de Llobregat (L'),253782,124667,129115
08,Barcelona,162,Hostalets de Pierola (Els),2426,1275,1151
08,Barcelona,102,Igualada,38164,18994,19170
08,Barcelona,103,Jorba,786,388,398
08,Barcelona,104,Llacuna (La),910,488,422
08,Barcelona,105,Llagosta (La),13645,6890,6755
08,Barcelona,107,Lliçà d'Amunt,13809,7070,6739
08,Barcelona,108,Lliçà de Vall,6182,3189,2993
08,Barcelona,106,Llinars del Vallès,8839,4438,4401
08,Barcelona,109,Lluçà,255,132,123
08,Barcelona,110,Malgrat de Mar,18261,9162,9099
08,Barcelona,111,Malla,261,130,131
08,Barcelona,112,Manlleu,20505,10435,10070
08,Barcelona,113,Manresa,75053,37001,38052
08,Barcelona,242,Marganell,301,145,156
08,Barcelona,114,Martorell,26169,13553,12616
08,Barcelona,115,Martorelles,4905,2475,2430
08,Barcelona,116,Masies de Roda (Les),745,370,375
08,Barcelona,117,Masies de Voltregà (Les),3189,1574,1615
08,Barcelona,118,Masnou (El),22066,10613,11453
08,Barcelona,119,Masquefa,8029,4075,3954
08,Barcelona,120,Matadepera,8460,4268,4192
08,Barcelona,121,Mataró,119780,60036,59744
08,Barcelona,122,Mediona,2307,1193,1114
08,Barcelona,138,Moià,5661,2865,2796
08,Barcelona,123,Molins de Rei,23828,11700,12128
08,Barcelona,124,Mollet del Vallès,51912,26196,25716
08,Barcelona,128,Monistrol de Calders,701,357,344
08,Barcelona,127,Monistrol de Montserrat,2983,1547,1436
08,Barcelona,125,Montcada i Reixac,32750,16405,16345
08,Barcelona,130,Montclar,117,55,62
08,Barcelona,131,Montesquiu,880,446,434
08,Barcelona,126,Montgat,10059,4955,5104
08,Barcelona,132,Montmajor,472,248,224
08,Barcelona,133,Montmaneu,200,107,93
08,Barcelona,135,Montmeló,8870,4396,4474
08,Barcelona,136,Montornès del Vallès,15058,7779,7279
08,Barcelona,137,Montseny,320,171,149
08,Barcelona,129,Muntanyola,548,281,267
08,Barcelona,139,Mura,237,128,109
08,Barcelona,140,Navarcles,5818,2875,2943
08,Barcelona,141,Navàs,6133,3066,3067
08,Barcelona,142,Nou de Berguedà (La),156,78,78
08,Barcelona,143,Òdena,3272,1669,1603
08,Barcelona,145,Olèrdola,3375,1755,1620
08,Barcelona,146,Olesa de Bonesvalls,1662,880,782
08,Barcelona,147,Olesa de Montserrat,22914,11568,11346
08,Barcelona,148,Olivella,3123,1664,1459
08,Barcelona,149,Olost,1199,600,599
08,Barcelona,144,Olvan,905,446,459
08,Barcelona,150,Orís,301,150,151
08,Barcelona,151,Oristà,591,292,299
08,Barcelona,152,Orpí,193,101,92
08,Barcelona,153,Òrrius,635,328,307
08,Barcelona,154,Pacs del Penedès,855,438,417
08,Barcelona,155,Palafolls,8368,4233,4135
08,Barcelona,156,Palau-solità i Plegamans,13916,7027,6889
08,Barcelona,157,Pallejà,11011,5546,5465
08,Barcelona,905,Palma de Cervelló (La),3027,1501,1526
08,Barcelona,158,Papiol (El),3828,1927,1901
08,Barcelona,159,Parets del Vallès,17224,8871,8353
08,Barcelona,160,Perafita,407,204,203
08,Barcelona,161,Piera,14025,7217,6808
08,Barcelona,163,Pineda de Mar,25931,13175,12756
08,Barcelona,164,Pla del Penedès (El),1004,514,490
08,Barcelona,165,Pobla de Claramunt (La),2235,1163,1072
08,Barcelona,166,Pobla de Lillet (La),1338,663,675
08,Barcelona,167,Polinyà,7403,3799,3604
08,Barcelona,182,Pont de Vilomara i Rocafort (El),3635,1885,1750
08,Barcelona,168,Pontons,558,302,256
08,Barcelona,169,Prat de Llobregat (El),62899,31425,31474
08,Barcelona,171,Prats de Lluçanès,2719,1344,1375
08,Barcelona,170,Prats de Rei (Els),540,273,267
08,Barcelona,230,Premià de Dalt,9867,4910,4957
08,Barcelona,172,Premià de Mar,27545,13694,13851
08,Barcelona,174,Puigdàlber,484,237,247
08,Barcelona,175,Puig-reig,4326,2122,2204
08,Barcelona,176,Pujalt,199,100,99
08,Barcelona,177,Quar (La),60,35,25
08,Barcelona,178,Rajadell,492,268,224
08,Barcelona,179,Rellinars,685,353,332
08,Barcelona,180,Ripollet,36255,18512,17743
08,Barcelona,181,Roca del Vallès (La),10032,5071,4961
08,Barcelona,183,Roda de Ter,5863,2874,2989
08,Barcelona,184,Rubí,71927,36174,35753
08,Barcelona,185,Rubió,186,95,91
08,Barcelona,901,Rupit i Pruit,329,165,164
08,Barcelona,187,Sabadell,203969,99947,104022
08,Barcelona,188,Sagàs,138,71,67
08,Barcelona,190,Saldes,344,196,148
08,Barcelona,191,Sallent,7061,3428,3633
08,Barcelona,194,Sant Adrià de Besòs,33223,16335,16888
08,Barcelona,195,Sant Agustí de Lluçanès,105,55,50
08,Barcelona,196,Sant Andreu de la Barca,26279,13504,12775
08,Barcelona,197,Sant Andreu de Llavaneres,10009,5091,4918
08,Barcelona,198,Sant Antoni de Vilamajor,5332,2686,2646
08,Barcelona,199,Sant Bartomeu del Grau,961,503,458
08,Barcelona,200,Sant Boi de Llobregat,81335,40386,40949
08,Barcelona,201,Sant Boi de Lluçanès,573,294,279
08,Barcelona,203,Sant Cebrià de Vallalta,3208,1668,1540
08,Barcelona,202,Sant Celoni,16586,8307,8279
08,Barcelona,204,Sant Climent de Llobregat,3676,1853,1823
08,Barcelona,205,Sant Cugat del Vallès,76274,37345,38929
08,Barcelona,206,Sant Cugat Sesgarrigues,923,479,444
08,Barcelona,207,Sant Esteve de Palautordera,2364,1155,1209
08,Barcelona,208,Sant Esteve Sesrovires,6903,3495,3408
08,Barcelona,210,Sant Feliu de Codines,5620,2853,2767
08,Barcelona,211,Sant Feliu de Llobregat,42628,20821,21807
08,Barcelona,212,Sant Feliu Sasserra,633,322,311
08,Barcelona,209,Sant Fost de Campsentelles,7939,4029,3910
08,Barcelona,213,Sant Fruitós de Bages,7782,3991,3791
08,Barcelona,215,Sant Hipòlit de Voltregà,3431,1728,1703
08,Barcelona,193,Sant Iscle de Vallalta,1235,647,588
08,Barcelona,216,Sant Jaume de Frontanyà,29,14,15
08,Barcelona,218,Sant Joan de Vilatorrada,10661,5417,5244
08,Barcelona,217,Sant Joan Despí,31647,15559,16088
08,Barcelona,903,Sant Julià de Cerdanyola,257,139,118
08,Barcelona,220,Sant Julià de Vilatorta,2933,1421,1512
08,Barcelona,221,Sant Just Desvern,15365,7305,8060
08,Barcelona,222,Sant Llorenç d'Hortons,2302,1188,1114
08,Barcelona,223,Sant Llorenç Savall,2357,1184,1173
08,Barcelona,225,Sant Martí d'Albars,112,59,53
08,Barcelona,224,Sant Martí de Centelles,997,530,467
08,Barcelona,226,Sant Martí de Tous,1150,579,571
08,Barcelona,227,Sant Martí Sarroca,3077,1563,1514
08,Barcelona,228,Sant Martí Sesgueioles,376,192,184
08,Barcelona,229,Sant Mateu de Bages,673,351,322
08,Barcelona,231,Sant Pere de Ribes,28066,14229,13837
08,Barcelona,232,Sant Pere de Riudebitlles,2359,1194,1165
08,Barcelona,233,Sant Pere de Torelló,2322,1167,1155
08,Barcelona,234,Sant Pere de Vilamajor,3891,1952,1939
08,Barcelona,189,Sant Pere Sallavinera,171,88,83
08,Barcelona,235,Sant Pol de Mar,4970,2520,2450
08,Barcelona,236,Sant Quintí de Mediona,2167,1102,1065
08,Barcelona,237,Sant Quirze de Besora,2215,1081,1134
08,Barcelona,238,Sant Quirze del Vallès,18225,8988,9237
08,Barcelona,239,Sant Quirze Safaja,617,317,300
08,Barcelona,240,Sant Sadurní d'Anoia,11909,5895,6014
08,Barcelona,241,Sant Sadurní d'Osormort,91,53,38
08,Barcelona,98,Sant Salvador de Guardiola,3044,1548,1496
08,Barcelona,262,Sant Vicenç de Castellet,8275,4115,4160
08,Barcelona,264,Sant Vicenç de Montalt,5434,2769,2665
08,Barcelona,265,Sant Vicenç de Torelló,1977,949,1028
08,Barcelona,263,Sant Vicenç dels Horts,27461,13791,13670
08,Barcelona,243,Santa Cecília de Voltregà,194,101,93
08,Barcelona,244,Santa Coloma de Cervelló,7659,3814,3845
08,Barcelona,245,Santa Coloma de Gramenet,117336,59829,57507
08,Barcelona,246,Santa Eugènia de Berga,2235,1172,1063
08,Barcelona,247,Santa Eulàlia de Riuprimer,1004,512,492
08,Barcelona,248,Santa Eulàlia de Ronçana,6669,3350,3319
08,Barcelona,249,Santa Fe del Penedès,391,199,192
08,Barcelona,250,Santa Margarida de Montbui,9778,4913,4865
08,Barcelona,251,Santa Margarida i els Monjos,6768,3511,3257
08,Barcelona,253,Santa Maria de Besora,169,85,84
08,Barcelona,254,Santa Maria de Corcó,2289,1152,1137
08,Barcelona,256,Santa Maria de Martorelles,813,416,397
08,Barcelona,255,Santa Maria de Merlès,156,77,79
08,Barcelona,257,Santa Maria de Miralles,130,63,67
08,Barcelona,259,Santa Maria de Palautordera,8614,4445,4169
08,Barcelona,258,Santa Maria d'Oló,1089,551,538
08,Barcelona,260,Santa Perpètua de Mogoda,24325,12472,11853
08,Barcelona,261,Santa Susanna,3119,1587,1532
08,Barcelona,192,Santpedor,6787,3392,3395
08,Barcelona,267,Sentmenat,7633,3837,3796
08,Barcelona,269,Seva,3279,1679,1600
08,Barcelona,270,Sitges,27070,13475,13595
08,Barcelona,271,Sobremunt,102,51,51
08,Barcelona,272,Sora,174,95,79
08,Barcelona,273,Subirats,3052,1544,1508
08,Barcelona,274,Súria,6454,3168,3286
08,Barcelona,276,Tagamanent,303,158,145
08,Barcelona,277,Talamanca,152,85,67
08,Barcelona,278,Taradell,5929,3065,2864
08,Barcelona,275,Tavèrnoles,318,161,157
08,Barcelona,280,Tavertet,148,80,68
08,Barcelona,281,Teià,5987,3056,2931
08,Barcelona,279,Terrassa,206245,102875,103370
08,Barcelona,282,Tiana,7505,3670,3835
08,Barcelona,283,Tona,7805,3909,3896
08,Barcelona,284,Tordera,14800,7585,7215
08,Barcelona,285,Torelló,13680,6791,6889
08,Barcelona,286,Torre de Claramunt (La),3615,1885,1730
08,Barcelona,287,Torrelavit,1290,703,587
08,Barcelona,288,Torrelles de Foix,2432,1293,1139
08,Barcelona,289,Torrelles de Llobregat,5208,2609,2599
08,Barcelona,290,Ullastrell,1761,900,861
08,Barcelona,291,Vacarisses,5787,3007,2780
08,Barcelona,292,Vallbona d'Anoia,1387,713,674
08,Barcelona,293,Vallcebre,269,150,119
08,Barcelona,294,Vallgorguina,2404,1242,1162
08,Barcelona,295,Vallirana,13752,6889,6863
08,Barcelona,296,Vallromanes,2206,1120,1086
08,Barcelona,297,Veciana,170,92,78
08,Barcelona,298,Vic,38964,19596,19368
08,Barcelona,299,Vilada,534,266,268
08,Barcelona,301,Viladecans,62573,31429,31144
08,Barcelona,300,Viladecavalls,7170,3602,3568
08,Barcelona,305,Vilafranca del Penedès,37364,18662,18702
08,Barcelona,306,Vilalba Sasserra,585,299,286
08,Barcelona,303,Vilanova de Sau,331,152,179
08,Barcelona,302,Vilanova del Camí,12428,6351,6077
08,Barcelona,902,Vilanova del Vallès,4459,2296,2163
08,Barcelona,307,Vilanova i la Geltrú,64905,32079,32826
08,Barcelona,214,Vilassar de Dalt,8621,4281,4340
08,Barcelona,219,Vilassar de Mar,19090,9282,9808
08,Barcelona,304,Vilobí del Penedès,1109,579,530
08,Barcelona,308,Viver i Serrateix,193,100,93
09,Burgos,1,Abajas,30,16,14
09,Burgos,3,Adrada de Haza,261,144,117
09,Burgos,6,Aguas Cándidas,62,39,23
09,Burgos,7,Aguilar de Bureba,72,44,28
09,Burgos,9,Albillos,219,121,98
09,Burgos,10,Alcocero de Mola,45,29,16
09,Burgos,11,Alfoz de Bricia,96,51,45
09,Burgos,907,Alfoz de Quintanadueñas,1733,949,784
09,Burgos,12,Alfoz de Santa Gadea,112,63,49
09,Burgos,13,Altable,54,33,21
09,Burgos,14,Altos (Los),203,117,86
09,Burgos,16,Ameyugo,100,56,44
09,Burgos,17,Anguix,155,87,68
09,Burgos,18,Aranda de Duero,32460,16248,16212
09,Burgos,19,Arandilla,179,109,70
09,Burgos,20,Arauzo de Miel,333,184,149
09,Burgos,21,Arauzo de Salce,70,41,29
09,Burgos,22,Arauzo de Torre,97,53,44
09,Burgos,23,Arcos,901,501,400
09,Burgos,24,Arenillas de Riopisuerga,188,107,81
09,Burgos,25,Arija,183,95,88
09,Burgos,26,Arlanzón,424,242,182
09,Burgos,27,Arraya de Oca,51,27,24
09,Burgos,29,Atapuerca,209,116,93
09,Burgos,30,Ausines (Los),144,83,61
09,Burgos,32,Avellanosa de Muñó,137,72,65
09,Burgos,33,Bahabón de Esgueva,120,70,50
09,Burgos,34,Balbases (Los),357,197,160
09,Burgos,35,Baños de Valdearados,407,232,175
09,Burgos,36,Bañuelos de Bureba,32,21,11
09,Burgos,37,Barbadillo de Herreros,122,73,49
09,Burgos,38,Barbadillo del Mercado,166,91,75
09,Burgos,39,Barbadillo del Pez,96,59,37
09,Burgos,41,Barrio de Muñó,31,19,12
09,Burgos,43,Barrios de Bureba (Los),236,141,95
09,Burgos,44,Barrios de Colina,68,32,36
09,Burgos,45,Basconcillos del Tozo,341,192,149
09,Burgos,46,Bascuñana,50,31,19
09,Burgos,47,Belbimbre,77,40,37
09,Burgos,48,Belorado,2190,1133,1057
09,Burgos,50,Berberana,73,38,35
09,Burgos,51,Berlangas de Roa,205,109,96
09,Burgos,52,Berzosa de Bureba,41,27,14
09,Burgos,54,Bozoó,110,57,53
09,Burgos,55,Brazacorta,78,43,35
09,Burgos,56,Briviesca,7776,4017,3759
09,Burgos,57,Bugedo,177,114,63
09,Burgos,58,Buniel,394,210,184
09,Burgos,59,Burgos,177879,85936,91943
09,Burgos,60,Busto de Bureba,201,119,82
09,Burgos,61,Cabañes de Esgueva,214,115,99
09,Burgos,62,Cabezón de la Sierra,53,23,30
09,Burgos,64,Caleruega,494,247,247
09,Burgos,65,Campillo de Aranda,196,109,87
09,Burgos,66,Campolara,71,44,27
09,Burgos,67,Canicosa de la Sierra,587,311,276
09,Burgos,68,Cantabrana,32,20,12
09,Burgos,70,Carazo,43,25,18
09,Burgos,71,Carcedo de Bureba,39,19,20
09,Burgos,72,Carcedo de Burgos,291,175,116
09,Burgos,73,Cardeñadijo,1027,566,461
09,Burgos,74,Cardeñajimeno,851,476,375
09,Burgos,75,Cardeñuela Riopico,127,90,37
09,Burgos,76,Carrias,36,25,11
09,Burgos,77,Cascajares de Bureba,45,25,20
09,Burgos,78,Cascajares de la Sierra,35,17,18
09,Burgos,79,Castellanos de Castro,56,35,21
09,Burgos,83,Castil de Peones,25,14,11
09,Burgos,82,Castildelgado,60,31,29
09,Burgos,84,Castrillo de la Reina,240,152,88
09,Burgos,85,Castrillo de la Vega,674,365,309
09,Burgos,88,Castrillo de Riopisuerga,70,42,28
09,Burgos,86,Castrillo del Val,688,387,301
09,Burgos,90,Castrillo Matajudíos,64,33,31
09,Burgos,91,Castrojeriz,890,459,431
09,Burgos,63,Cavia,270,152,118
09,Burgos,93,Cayuela,163,89,74
09,Burgos,94,Cebrecos,59,31,28
09,Burgos,95,Celada del Camino,102,53,49
09,Burgos,98,Cerezo de Río Tirón,669,360,309
09,Burgos,100,Cerratón de Juarros,62,38,24
09,Burgos,101,Ciadoncha,85,54,31
09,Burgos,102,Cillaperlata,35,23,12
09,Burgos,103,Cilleruelo de Abajo,283,156,127
09,Burgos,104,Cilleruelo de Arriba,63,34,29
09,Burgos,105,Ciruelos de Cervera,123,68,55
09,Burgos,108,Cogollos,487,270,217
09,Burgos,109,Condado de Treviño,1399,798,601
09,Burgos,110,Contreras,97,59,38
09,Burgos,112,Coruña del Conde,147,84,63
09,Burgos,113,Covarrubias,643,340,303
09,Burgos,114,Cubillo del Campo,101,54,47
09,Burgos,115,Cubo de Bureba,120,69,51
09,Burgos,117,Cueva de Roa (La),119,65,54
09,Burgos,119,Cuevas de San Clemente,50,24,26
09,Burgos,120,Encío,45,27,18
09,Burgos,122,Espinosa de Cervera,108,66,42
09,Burgos,124,Espinosa de los Monteros,2106,1170,936
09,Burgos,123,Espinosa del Camino,37,24,13
09,Burgos,125,Estépar,754,438,316
09,Burgos,127,Fontioso,65,34,31
09,Burgos,128,Frandovínez,110,60,50
09,Burgos,129,Fresneda de la Sierra Tirón,126,81,45
09,Burgos,130,Fresneña,114,57,57
09,Burgos,131,Fresnillo de las Dueñas,443,238,205
09,Burgos,132,Fresno de Río Tirón,203,118,85
09,Burgos,133,Fresno de Rodilla,50,32,18
09,Burgos,134,Frías,279,150,129
09,Burgos,135,Fuentebureba,53,24,29
09,Burgos,136,Fuentecén,257,151,106
09,Burgos,137,Fuentelcésped,191,98,93
09,Burgos,138,Fuentelisendo,98,59,39
09,Burgos,139,Fuentemolinos,105,65,40
09,Burgos,140,Fuentenebro,174,98,76
09,Burgos,141,Fuentespina,707,380,327
09,Burgos,143,Galbarros,32,22,10
09,Burgos,144,Gallega (La),75,43,32
09,Burgos,148,Grijalba,124,60,64
09,Burgos,149,Grisaleña,46,32,14
09,Burgos,151,Gumiel de Izán,641,360,281
09,Burgos,152,Gumiel de Mercado,382,207,175
09,Burgos,154,Hacinas,180,99,81
09,Burgos,155,Haza,31,19,12
09,Burgos,159,Hontanas,61,36,25
09,Burgos,160,Hontangas,124,79,45
09,Burgos,162,Hontoria de la Cantera,126,68,58
09,Burgos,164,Hontoria de Valdearados,234,152,82
09,Burgos,163,Hontoria del Pinar,821,463,358
09,Burgos,166,Hormazas (Las),120,65,55
09,Burgos,167,Hornillos del Camino,66,38,28
09,Burgos,168,Horra (La),396,206,190
09,Burgos,169,Hortigüela,117,73,44
09,Burgos,170,Hoyales de Roa,245,119,126
09,Burgos,172,Huérmeces,125,65,60
09,Burgos,173,Huerta de Arriba,154,87,67
09,Burgos,174,Huerta de Rey,1136,605,531
09,Burgos,175,Humada,158,98,60
09,Burgos,176,Hurones,77,48,29
09,Burgos,177,Ibeas de Juarros,1323,731,592
09,Burgos,178,Ibrillos,82,48,34
09,Burgos,179,Iglesiarrubia,56,33,23
09,Burgos,180,Iglesias,144,82,62
09,Burgos,181,Isar,386,198,188
09,Burgos,182,Itero del Castillo,104,55,49
09,Burgos,183,Jaramillo de la Fuente,40,23,17
09,Burgos,184,Jaramillo Quemado,8,5,3
09,Burgos,189,Junta de Traslaloma,176,92,84
09,Burgos,190,Junta de Villalba de Losa,118,58,60
09,Burgos,191,Jurisdicción de Lara,53,30,23
09,Burgos,192,Jurisdicción de San Zadornil,102,52,50
09,Burgos,194,Lerma,2808,1371,1437
09,Burgos,195,Llano de Bureba,73,41,32
09,Burgos,196,Madrigal del Monte,196,118,78
09,Burgos,197,Madrigalejo del Monte,194,119,75
09,Burgos,198,Mahamud,151,77,74
09,Burgos,199,Mambrilla de Castrejón,121,66,55
09,Burgos,200,Mambrillas de Lara,60,33,27
09,Burgos,201,Mamolar,52,27,25
09,Burgos,202,Manciles,32,19,13
09,Burgos,206,Mazuela,74,41,33
09,Burgos,208,Mecerreyes,283,152,131
09,Burgos,209,Medina de Pomar,6212,3278,2934
09,Burgos,211,Melgar de Fernamental,1898,1015,883
09,Burgos,213,Merindad de Cuesta-Urria,463,252,211
09,Burgos,214,Merindad de Montija,866,499,367
09,Burgos,906,Merindad de Río Ubierna,1391,762,629
09,Burgos,215,Merindad de Sotoscueva,495,285,210
09,Burgos,216,Merindad de Valdeporres,472,249,223
09,Burgos,217,Merindad de Valdivielso,451,249,202
09,Burgos,218,Milagros,498,267,231
09,Burgos,219,Miranda de Ebro,39589,20084,19505
09,Burgos,220,Miraveche,93,54,39
09,Burgos,221,Modúbar de la Emparedada,392,218,174
09,Burgos,223,Monasterio de la Sierra,46,29,17
09,Burgos,224,Monasterio de Rodilla,214,120,94
09,Burgos,225,Moncalvillo,105,64,41
09,Burgos,226,Monterrubio de la Demanda,81,46,35
09,Burgos,227,Montorio,166,88,78
09,Burgos,228,Moradillo de Roa,202,111,91
09,Burgos,229,Nava de Roa,252,132,120
09,Burgos,230,Navas de Bureba,46,22,24
09,Burgos,231,Nebreda,85,55,30
09,Burgos,232,Neila,212,116,96
09,Burgos,235,Olmedillo de Roa,182,97,85
09,Burgos,236,Olmillos de Muñó,43,27,16
09,Burgos,238,Oña,1301,671,630
09,Burgos,239,Oquillas,63,36,27
09,Burgos,241,Orbaneja Riopico,168,105,63
09,Burgos,242,Padilla de Abajo,86,50,36
09,Burgos,243,Padilla de Arriba,87,53,34
09,Burgos,244,Padrones de Bureba,47,29,18
09,Burgos,246,Palacios de la Sierra,856,447,409
09,Burgos,247,Palacios de Riopisuerga,39,21,18
09,Burgos,248,Palazuelos de la Sierra,69,41,28
09,Burgos,249,Palazuelos de Muñó,64,39,25
09,Burgos,250,Pampliega,398,209,189
09,Burgos,251,Pancorbo,522,281,241
09,Burgos,253,Pardilla,125,71,54
09,Burgos,255,Partido de la Sierra en Tobalina,83,47,36
09,Burgos,256,Pedrosa de Duero,531,310,221
09,Burgos,259,Pedrosa de Río Úrbel,263,162,101
09,Burgos,257,Pedrosa del Páramo,89,48,41
09,Burgos,258,Pedrosa del Príncipe,186,96,90
09,Burgos,261,Peñaranda de Duero,566,302,264
09,Burgos,262,Peral de Arlanza,182,98,84
09,Burgos,265,Piérnigas,43,28,15
09,Burgos,266,Pineda de la Sierra,111,64,47
09,Burgos,267,Pineda Trasmonte,149,87,62
09,Burgos,268,Pinilla de los Barruecos,113,65,48
09,Burgos,269,Pinilla de los Moros,42,28,14
09,Burgos,270,Pinilla Trasmonte,201,112,89
09,Burgos,272,Poza de la Sal,351,173,178
09,Burgos,273,Prádanos de Bureba,48,32,16
09,Burgos,274,Pradoluengo,1503,744,759
09,Burgos,275,Presencio,219,123,96
09,Burgos,276,Puebla de Arganzón (La),489,272,217
09,Burgos,277,Puentedura,120,74,46
09,Burgos,279,Quemada,260,154,106
09,Burgos,281,Quintana del Pidio,183,98,85
09,Burgos,280,Quintanabureba,37,22,15
09,Burgos,283,Quintanaélez,77,44,33
09,Burgos,287,Quintanaortuño,224,122,102
09,Burgos,288,Quintanapalla,122,72,50
09,Burgos,289,Quintanar de la Sierra,2088,1082,1006
09,Burgos,292,Quintanavides,99,59,40
09,Burgos,294,Quintanilla de la Mata,145,80,65
09,Burgos,901,Quintanilla del Agua y Tordueles,560,293,267
09,Burgos,295,Quintanilla del Coco,94,49,45
09,Burgos,298,Quintanilla San García,98,57,41
09,Burgos,301,Quintanilla Vivar,725,389,336
09,Burgos,297,Quintanillas (Las),395,218,177
09,Burgos,302,Rabanera del Pinar,148,83,65
09,Burgos,303,Rábanos,99,56,43
09,Burgos,304,Rabé de las Calzadas,212,109,103
09,Burgos,306,Rebolledo de la Torre,150,82,68
09,Burgos,307,Redecilla del Camino,133,77,56
09,Burgos,308,Redecilla del Campo,75,42,33
09,Burgos,309,Regumiel de la Sierra,433,213,220
09,Burgos,310,Reinoso,17,11,6
09,Burgos,311,Retuerta,66,41,25
09,Burgos,314,Revilla del Campo,125,70,55
09,Burgos,316,Revilla Vallejera,91,57,34
09,Burgos,312,Revilla y Ahedo (La),129,76,53
09,Burgos,315,Revillarruz,353,182,171
09,Burgos,317,Rezmondo,21,9,12
09,Burgos,318,Riocavado de la Sierra,62,35,27
09,Burgos,321,Roa,2454,1280,1174
09,Burgos,323,Rojas,79,50,29
09,Burgos,325,Royuela de Río Franco,250,147,103
09,Burgos,326,Rubena,186,98,88
09,Burgos,327,Rublacedo de Abajo,32,19,13
09,Burgos,328,Rucandio,92,52,40
09,Burgos,329,Salas de Bureba,131,81,50
09,Burgos,330,Salas de los Infantes,2132,1097,1035
09,Burgos,332,Saldaña de Burgos,173,98,75
09,Burgos,334,Salinillas de Bureba,52,32,20
09,Burgos,335,San Adrián de Juarros,61,35,26
09,Burgos,337,San Juan del Monte,151,79,72
09,Burgos,338,San Mamés de Burgos,286,155,131
09,Burgos,339,San Martín de Rubiales,193,112,81
09,Burgos,340,San Millán de Lara,77,55,22
09,Burgos,360,San Vicente del Valle,41,24,17
09,Burgos,343,Santa Cecilia,108,64,44
09,Burgos,345,Santa Cruz de la Salceda,167,98,69
09,Burgos,346,Santa Cruz del Valle Urbión,102,60,42
09,Burgos,347,Santa Gadea del Cid,162,92,70
09,Burgos,348,Santa Inés,156,85,71
09,Burgos,350,Santa María del Campo,677,370,307
09,Burgos,351,Santa María del Invierno,60,43,17
09,Burgos,352,Santa María del Mercadillo,156,86,70
09,Burgos,353,Santa María Rivarredonda,118,66,52
09,Burgos,354,Santa Olalla de Bureba,35,9,26
09,Burgos,355,Santibáñez de Esgueva,128,63,65
09,Burgos,356,Santibáñez del Val,67,40,27
09,Burgos,358,Santo Domingo de Silos,311,189,122
09,Burgos,361,Sargentes de la Lora,161,93,68
09,Burgos,362,Sarracín,288,167,121
09,Burgos,363,Sasamón,1248,695,553
09,Burgos,365,Sequera de Haza (La),42,27,15
09,Burgos,366,Solarana,108,58,50
09,Burgos,368,Sordillos,30,19,11
09,Burgos,369,Sotillo de la Ribera,585,327,258
09,Burgos,372,Sotragero,247,133,114
09,Burgos,373,Sotresgudo,563,331,232
09,Burgos,374,Susinos del Páramo,120,69,51
09,Burgos,375,Tamarón,47,31,16
09,Burgos,377,Tardajos,816,464,352
09,Burgos,378,Tejada,38,23,15
09,Burgos,380,Terradillos de Esgueva,122,63,59
09,Burgos,381,Tinieblas de la Sierra,40,22,18
09,Burgos,382,Tobar,33,21,12
09,Burgos,384,Tordómar,377,216,161
09,Burgos,386,Torrecilla del Monte,77,44,33
09,Burgos,387,Torregalindo,140,80,60
09,Burgos,388,Torrelara,24,14,10
09,Burgos,389,Torrepadre,87,57,30
09,Burgos,390,Torresandino,754,403,351
09,Burgos,391,Tórtoles de Esgueva,508,281,227
09,Burgos,392,Tosantos,54,32,22
09,Burgos,394,Trespaderne,1172,636,536
09,Burgos,395,Tubilla del Agua,188,121,67
09,Burgos,396,Tubilla del Lago,139,79,60
09,Burgos,398,Úrbel del Castillo,102,62,40
09,Burgos,400,Vadocondes,426,231,195
09,Burgos,403,Valdeande,116,73,43
09,Burgos,405,Valdezate,162,83,79
09,Burgos,406,Valdorros,254,137,117
09,Burgos,408,Vallarta de Bureba,54,32,22
09,Burgos,904,Valle de las Navas,643,365,278
09,Burgos,908,Valle de Losa,629,369,260
09,Burgos,409,Valle de Manzanedo,128,71,57
09,Burgos,410,Valle de Mena,3838,1959,1879
09,Burgos,411,Valle de Oca,199,113,86
09,Burgos,902,Valle de Santibáñez,564,309,255
09,Burgos,905,Valle de Sedano,527,305,222
09,Burgos,412,Valle de Tobalina,1044,544,500
09,Burgos,413,Valle de Valdebezana,627,348,279
09,Burgos,414,Valle de Valdelaguna,207,127,80
09,Burgos,415,Valle de Valdelucio,352,185,167
09,Burgos,416,Valle de Zamanzas,68,37,31
09,Burgos,417,Vallejera,53,33,20
09,Burgos,418,Valles de Palenzuela,92,49,43
09,Burgos,419,Valluércanes,90,52,38
09,Burgos,407,Valmala,32,17,15
09,Burgos,422,Vid de Bureba (La),33,17,16
09,Burgos,421,Vid y Barrios (La),283,164,119
09,Burgos,423,Vileña,31,20,11
09,Burgos,427,Villadiego,1820,998,822
09,Burgos,428,Villaescusa de Roa,160,90,70
09,Burgos,429,Villaescusa la Sombría,73,48,25
09,Burgos,430,Villaespasa,19,9,10
09,Burgos,431,Villafranca Montes de Oca,136,73,63
09,Burgos,432,Villafruela,237,139,98
09,Burgos,433,Villagalijo,78,51,27
09,Burgos,434,Villagonzalo Pedernales,1425,771,654
09,Burgos,437,Villahoz,380,200,180
09,Burgos,438,Villalba de Duero,678,360,318
09,Burgos,439,Villalbilla de Burgos,879,497,382
09,Burgos,440,Villalbilla de Gumiel,108,70,38
09,Burgos,441,Villaldemiro,71,40,31
09,Burgos,442,Villalmanzo,454,234,220
09,Burgos,443,Villamayor de los Montes,216,111,105
09,Burgos,444,Villamayor de Treviño,100,58,42
09,Burgos,445,Villambistia,51,27,24
09,Burgos,446,Villamedianilla,19,9,10
09,Burgos,447,Villamiel de la Sierra,37,22,15
09,Burgos,448,Villangómez,281,168,113
09,Burgos,449,Villanueva de Argaño,118,70,48
09,Burgos,450,Villanueva de Carazo,31,19,12
09,Burgos,451,Villanueva de Gumiel,284,149,135
09,Burgos,454,Villanueva de Teba,50,32,18
09,Burgos,455,Villaquirán de la Puebla,52,29,23
09,Burgos,456,Villaquirán de los Infantes,168,90,78
09,Burgos,903,Villarcayo de Merindad de Castilla la Vieja,4765,2557,2208
09,Burgos,458,Villariezo,507,299,208
09,Burgos,460,Villasandino,229,133,96
09,Burgos,463,Villasur de Herreros,307,175,132
09,Burgos,464,Villatuelda,50,30,20
09,Burgos,466,Villaverde del Monte,169,99,70
09,Burgos,467,Villaverde-Mogina,98,61,37
09,Burgos,471,Villayerno Morquillas,208,121,87
09,Burgos,472,Villazopeque,70,43,27
09,Burgos,473,Villegas,99,58,41
09,Burgos,476,Villoruebo,59,38,21
09,Burgos,424,Viloria de Rioja,51,30,21
09,Burgos,425,Vilviestre del Pinar,751,425,326
09,Burgos,478,Vizcaínos,49,31,18
09,Burgos,480,Zael,124,65,59
09,Burgos,482,Zarzosa de Río Pisuerga,42,25,17
09,Burgos,483,Zazuar,257,141,116
09,Burgos,485,Zuñeda,62,35,27
10,Cáceres,1,Abadía,317,172,145
10,Cáceres,2,Abertura,463,238,225
10,Cáceres,3,Acebo,706,374,332
10,Cáceres,4,Acehúche,860,425,435
10,Cáceres,5,Aceituna,612,319,293
10,Cáceres,6,Ahigal,1484,764,720
10,Cáceres,7,Albalá,814,408,406
10,Cáceres,8,Alcántara,1669,821,848
10,Cáceres,9,Alcollarín,277,135,142
10,Cáceres,10,Alcuéscar,3001,1545,1456
10,Cáceres,12,Aldea del Cano,742,357,385
10,Cáceres,13,Aldea del Obispo (La),353,188,165
10,Cáceres,11,Aldeacentenera,779,405,374
10,Cáceres,14,Aldeanueva de la Vera,2276,1108,1168
10,Cáceres,15,Aldeanueva del Camino,789,389,400
10,Cáceres,16,Aldehuela de Jerte,344,191,153
10,Cáceres,17,Alía,1068,544,524
10,Cáceres,18,Aliseda,1992,1004,988
10,Cáceres,19,Almaraz,1250,636,614
10,Cáceres,20,Almoharín,2021,1007,1014
10,Cáceres,21,Arroyo de la Luz,6461,3216,3245
10,Cáceres,23,Arroyomolinos,1009,521,488
10,Cáceres,22,Arroyomolinos de la Vera,514,260,254
10,Cáceres,24,Baños de Montemayor,737,354,383
10,Cáceres,25,Barrado,482,246,236
10,Cáceres,26,Belvís de Monroy,677,341,336
10,Cáceres,27,Benquerencia,102,58,44
10,Cáceres,28,Berrocalejo,98,49,49
10,Cáceres,29,Berzocana,530,269,261
10,Cáceres,30,Bohonal de Ibor,538,278,260
10,Cáceres,31,Botija,191,96,95
10,Cáceres,32,Brozas,2155,1083,1072
10,Cáceres,33,Cabañas del Castillo,435,221,214
10,Cáceres,34,Cabezabellosa,421,210,211
10,Cáceres,35,Cabezuela del Valle,2148,1114,1034
10,Cáceres,36,Cabrero,367,194,173
10,Cáceres,37,Cáceres,92187,44397,47790
10,Cáceres,38,Cachorrilla,99,52,47
10,Cáceres,39,Cadalso,527,266,261
10,Cáceres,40,Calzadilla,486,247,239
10,Cáceres,41,Caminomorisco,1256,648,608
10,Cáceres,42,Campillo de Deleitosa,88,35,53
10,Cáceres,43,Campo Lugar,1064,529,535
10,Cáceres,44,Cañamero,1803,931,872
10,Cáceres,45,Cañaveral,1294,632,662
10,Cáceres,46,Carbajo,228,115,113
10,Cáceres,47,Carcaboso,1124,582,542
10,Cáceres,48,Carrascalejo,348,181,167
10,Cáceres,49,Casar de Cáceres,4894,2437,2457
10,Cáceres,50,Casar de Palomero,1353,676,677
10,Cáceres,51,Casares de las Hurdes,554,270,284
10,Cáceres,52,Casas de Don Antonio,213,100,113
10,Cáceres,53,Casas de Don Gómez,354,190,164
10,Cáceres,56,Casas de Millán,704,354,350
10,Cáceres,57,Casas de Miravete,159,89,70
10,Cáceres,54,Casas del Castañar,637,315,322
10,Cáceres,55,Casas del Monte,785,414,371
10,Cáceres,58,Casatejada,1362,690,672
10,Cáceres,59,Casillas de Coria,465,227,238
10,Cáceres,60,Castañar de Ibor,1200,632,568
10,Cáceres,61,Ceclavín,2096,1056,1040
10,Cáceres,62,Cedillo,518,263,255
10,Cáceres,63,Cerezo,186,91,95
10,Cáceres,64,Cilleros,1897,975,922
10,Cáceres,65,Collado,212,113,99
10,Cáceres,66,Conquista de la Sierra,210,112,98
10,Cáceres,67,Coria,12868,6454,6414
10,Cáceres,68,Cuacos de Yuste,932,490,442
10,Cáceres,69,Cumbre (La),972,487,485
10,Cáceres,70,Deleitosa,850,437,413
10,Cáceres,71,Descargamaría,209,111,98
10,Cáceres,72,Eljas,1046,534,512
10,Cáceres,73,Escurial,871,444,427
10,Cáceres,75,Fresnedoso de Ibor,332,163,169
10,Cáceres,76,Galisteo,1980,999,981
10,Cáceres,77,Garciaz,885,455,430
10,Cáceres,78,Garganta (La),498,270,228
10,Cáceres,79,Garganta la Olla,1085,583,502
10,Cáceres,80,Gargantilla,434,224,210
10,Cáceres,81,Gargüera,136,73,63
10,Cáceres,82,Garrovillas de Alconétar,2306,1129,1177
10,Cáceres,83,Garvín,106,58,48
10,Cáceres,84,Gata,1698,857,841
10,Cáceres,85,Gordo (El),353,184,169
10,Cáceres,86,Granja (La),365,200,165
10,Cáceres,87,Guadalupe,2114,1051,1063
10,Cáceres,88,Guijo de Coria,241,125,116
10,Cáceres,89,Guijo de Galisteo,1614,857,757
10,Cáceres,90,Guijo de Granadilla,632,311,321
10,Cáceres,91,Guijo de Santa Bárbara,390,200,190
10,Cáceres,92,Herguijuela,377,188,189
10,Cáceres,93,Hernán-Pérez,514,264,250
10,Cáceres,94,Herrera de Alcántara,276,146,130
10,Cáceres,95,Herreruela,381,188,193
10,Cáceres,96,Hervás,4062,1994,2068
10,Cáceres,97,Higuera,104,54,50
10,Cáceres,98,Hinojal,439,224,215
10,Cáceres,99,Holguera,762,388,374
10,Cáceres,100,Hoyos,971,495,476
10,Cáceres,101,Huélaga,201,97,104
10,Cáceres,102,Ibahernando,515,255,260
10,Cáceres,103,Jaraicejo,574,277,297
10,Cáceres,104,Jaraíz de la Vera,6464,3233,3231
10,Cáceres,105,Jarandilla de la Vera,3113,1543,1570
10,Cáceres,106,Jarilla,160,74,86
10,Cáceres,107,Jerte,1333,692,641
10,Cáceres,108,Ladrillar,224,120,104
10,Cáceres,109,Logrosán,2139,1104,1035
10,Cáceres,110,Losar de la Vera,2988,1555,1433
10,Cáceres,111,Madrigal de la Vera,1824,954,870
10,Cáceres,112,Madrigalejo,1993,996,997
10,Cáceres,113,Madroñera,2965,1484,1481
10,Cáceres,114,Majadas,1294,662,632
10,Cáceres,115,Malpartida de Cáceres,4461,2248,2213
10,Cáceres,116,Malpartida de Plasencia,4555,2272,2283
10,Cáceres,117,Marchagaz,249,123,126
10,Cáceres,118,Mata de Alcántara,343,172,171
10,Cáceres,119,Membrío,871,419,452
10,Cáceres,120,Mesas de Ibor,180,94,86
10,Cáceres,121,Miajadas,10241,5096,5145
10,Cáceres,122,Millanes,265,131,134
10,Cáceres,123,Mirabel,733,376,357
10,Cáceres,124,Mohedas de Granadilla,1000,502,498
10,Cáceres,125,Monroy,979,516,463
10,Cáceres,126,Montánchez,2057,1026,1031
10,Cáceres,127,Montehermoso,5769,2958,2811
10,Cáceres,128,Moraleja,7983,4021,3962
10,Cáceres,129,Morcillo,420,200,220
10,Cáceres,130,Navaconcejo,2083,1038,1045
10,Cáceres,131,Navalmoral de la Mata,17103,8487,8616
10,Cáceres,132,Navalvillar de Ibor,402,212,190
10,Cáceres,133,Navas del Madroño,1480,737,743
10,Cáceres,134,Navezuelas,699,359,340
10,Cáceres,135,Nuñomoral,1452,770,682
10,Cáceres,136,Oliva de Plasencia,295,161,134
10,Cáceres,137,Palomero,473,238,235
10,Cáceres,138,Pasarón de la Vera,666,322,344
10,Cáceres,139,Pedroso de Acim,102,52,50
10,Cáceres,140,Peraleda de la Mata,1468,745,723
10,Cáceres,141,Peraleda de San Román,309,148,161
10,Cáceres,142,Perales del Puerto,982,490,492
10,Cáceres,143,Pescueza,164,80,84
10,Cáceres,144,Pesga (La),1128,585,543
10,Cáceres,145,Piedras Albas,210,111,99
10,Cáceres,146,Pinofranqueado,1686,913,773
10,Cáceres,147,Piornal,1548,767,781
10,Cáceres,148,Plasencia,40105,19625,20480
10,Cáceres,149,Plasenzuela,542,275,267
10,Cáceres,150,Portaje,405,204,201
10,Cáceres,151,Portezuelo,274,141,133
10,Cáceres,152,Pozuelo de Zarzón,567,277,290
10,Cáceres,153,Puerto de Santa Cruz,398,202,196
10,Cáceres,154,Rebollar,223,114,109
10,Cáceres,155,Riolobos,1184,621,563
10,Cáceres,156,Robledillo de Gata,131,72,59
10,Cáceres,157,Robledillo de la Vera,309,160,149
10,Cáceres,158,Robledillo de Trujillo,443,241,202
10,Cáceres,159,Robledollano,395,216,179
10,Cáceres,160,Romangordo,206,90,116
10,Cáceres,901,Rosalejo,1346,708,638
10,Cáceres,161,Ruanes,74,41,33
10,Cáceres,162,Salorino,707,355,352
10,Cáceres,163,Salvatierra de Santiago,316,152,164
10,Cáceres,164,San Martín de Trevejo,926,446,480
10,Cáceres,165,Santa Ana,313,169,144
10,Cáceres,166,Santa Cruz de la Sierra,274,137,137
10,Cáceres,167,Santa Cruz de Paniagua,331,180,151
10,Cáceres,168,Santa Marta de Magasca,304,150,154
10,Cáceres,169,Santiago de Alcántara,690,341,349
10,Cáceres,170,Santiago del Campo,311,159,152
10,Cáceres,171,Santibáñez el Alto,446,224,222
10,Cáceres,172,Santibáñez el Bajo,829,434,395
10,Cáceres,173,Saucedilla,778,407,371
10,Cáceres,174,Segura de Toro,181,90,91
10,Cáceres,175,Serradilla,1764,913,851
10,Cáceres,176,Serrejón,461,225,236
10,Cáceres,177,Sierra de Fuentes,2022,1051,971
10,Cáceres,178,Talaván,917,465,452
10,Cáceres,179,Talaveruela de la Vera,377,179,198
10,Cáceres,180,Talayuela,9282,5165,4117
10,Cáceres,181,Tejeda de Tiétar,894,476,418
10,Cáceres,182,Toril,182,114,68
10,Cáceres,183,Tornavacas,1214,637,577
10,Cáceres,184,Torno (El),977,522,455
10,Cáceres,187,Torre de Don Miguel,591,304,287
10,Cáceres,188,Torre de Santa María,650,337,313
10,Cáceres,185,Torrecilla de los Ángeles,691,356,335
10,Cáceres,186,Torrecillas de la Tiesa,1168,588,580
10,Cáceres,190,Torrejón el Rubio,619,322,297
10,Cáceres,189,Torrejoncillo,3322,1633,1689
10,Cáceres,191,Torremenga,608,321,287
10,Cáceres,192,Torremocha,1063,526,537
10,Cáceres,193,Torreorgaz,1759,861,898
10,Cáceres,194,Torrequemada,608,291,317
10,Cáceres,195,Trujillo,9860,4840,5020
10,Cáceres,196,Valdastillas,376,202,174
10,Cáceres,197,Valdecañas de Tajo,135,76,59
10,Cáceres,198,Valdefuentes,1461,742,719
10,Cáceres,199,Valdehúncar,208,111,97
10,Cáceres,200,Valdelacasa de Tajo,464,229,235
10,Cáceres,201,Valdemorales,239,121,118
10,Cáceres,202,Valdeobispo,768,386,382
10,Cáceres,203,Valencia de Alcántara,6175,3066,3109
10,Cáceres,204,Valverde de la Vera,594,306,288
10,Cáceres,205,Valverde del Fresno,2525,1304,1221
10,Cáceres,206,Viandar de la Vera,266,132,134
10,Cáceres,207,Villa del Campo,560,277,283
10,Cáceres,208,Villa del Rey,149,78,71
10,Cáceres,209,Villamesías,322,162,160
10,Cáceres,210,Villamiel,696,348,348
10,Cáceres,211,Villanueva de la Sierra,532,268,264
10,Cáceres,212,Villanueva de la Vera,2127,1070,1057
10,Cáceres,214,Villar de Plasencia,233,116,117
10,Cáceres,213,Villar del Pedroso,699,356,343
10,Cáceres,215,Villasbuenas de Gata,468,242,226
10,Cáceres,216,Zarza de Granadilla,1770,908,862
10,Cáceres,217,Zarza de Montánchez,622,306,316
10,Cáceres,218,Zarza la Mayor,1444,747,697
10,Cáceres,219,Zorita,1697,828,869
11,Cádiz,1,Alcalá de los Gazules,5660,2891,2769
11,Cádiz,2,Alcalá del Valle,5363,2756,2607
11,Cádiz,3,Algar,1564,826,738
11,Cádiz,4,Algeciras,115333,59798,55535
11,Cádiz,5,Algodonales,5734,2925,2809
11,Cádiz,6,Arcos de la Frontera,31017,15561,15456
11,Cádiz,7,Barbate,22851,11445,11406
11,Cádiz,8,Barrios (Los),21977,11118,10859
11,Cádiz,901,Benalup-Casas Viejas,7139,3644,3495
11,Cádiz,9,Benaocaz,745,377,368
11,Cádiz,10,Bornos,8123,4045,4078
11,Cádiz,11,Bosque (El),2058,1075,983
11,Cádiz,12,Cádiz,127200,60605,66595
11,Cádiz,13,Castellar de la Frontera,3109,1595,1514
11,Cádiz,15,Chiclana de la Frontera,76171,38590,37581
11,Cádiz,16,Chipiona,18447,9244,9203
11,Cádiz,14,Conil de la Frontera,20752,10568,10184
11,Cádiz,17,Espera,4005,2022,1983
11,Cádiz,18,Gastor (El),1879,996,883
11,Cádiz,19,Grazalema,2227,1159,1068
11,Cádiz,20,Jerez de la Frontera,205364,100390,104974
11,Cádiz,21,Jimena de la Frontera,10330,5392,4938
11,Cádiz,22,Línea de la Concepción (La),64240,31934,32306
11,Cádiz,23,Medina-Sidonia,11514,5952,5562
11,Cádiz,24,Olvera,8629,4276,4353
11,Cádiz,25,Paterna de Rivera,5578,2888,2690
11,Cádiz,26,Prado del Rey,5995,2987,3008
11,Cádiz,27,Puerto de Santa María (El),86288,42683,43605
11,Cádiz,28,Puerto Real,39648,19994,19654
11,Cádiz,29,Puerto Serrano,7092,3605,3487
11,Cádiz,30,Rota,27918,14045,13873
11,Cádiz,31,San Fernando,96155,47462,48693
11,Cádiz,902,San José del Valle,4326,2212,2114
11,Cádiz,33,San Roque,28653,14497,14156
11,Cádiz,32,Sanlúcar de Barrameda,64434,32176,32258
11,Cádiz,34,Setenil de las Bodegas,2994,1540,1454
11,Cádiz,35,Tarifa,17736,9062,8674
11,Cádiz,36,Torre Alháquime,854,444,410
11,Cádiz,37,Trebujena,6920,3583,3337
11,Cádiz,38,Ubrique,17071,8458,8613
11,Cádiz,39,Vejer de la Frontera,12991,6559,6432
11,Cádiz,40,Villaluenga del Rosario,475,247,228
11,Cádiz,41,Villamartín,12385,6201,6184
11,Cádiz,42,Zahara,1523,789,734
12,Castellón/Castelló,2,Aín,145,73,72
12,Castellón/Castelló,3,Albocàsser,1446,726,720
12,Castellón/Castelló,4,Alcalà de Xivert,7884,4052,3832
12,Castellón/Castelló,5,Alcora (l'),11068,5638,5430
12,Castellón/Castelló,6,Alcudia de Veo,212,102,110
12,Castellón/Castelló,7,Alfondeguilla,886,431,455
12,Castellón/Castelló,8,Algimia de Almonacid,321,176,145
12,Castellón/Castelló,9,Almazora/Almassora,23891,12057,11834
12,Castellón/Castelló,10,Almedíjar,256,124,132
12,Castellón/Castelló,11,Almenara,5705,2849,2856
12,Castellón/Castelló,901,Alquerías del Niño Perdido,4142,2053,2089
12,Castellón/Castelló,12,Altura,3784,1950,1834
12,Castellón/Castelló,13,Arañuel,205,97,108
12,Castellón/Castelló,14,Ares del Maestre,217,118,99
12,Castellón/Castelló,15,Argelita,105,54,51
12,Castellón/Castelló,16,Artana,1987,1018,969
12,Castellón/Castelló,1,Atzeneta del Maestrat,1448,737,711
12,Castellón/Castelló,17,Ayódar,236,123,113
12,Castellón/Castelló,18,Azuébar,343,171,172
12,Castellón/Castelló,20,Barracas,179,96,83
12,Castellón/Castelló,22,Bejís,452,255,197
12,Castellón/Castelló,24,Benafer,179,95,84
12,Castellón/Castelló,25,Benafigos,171,94,77
12,Castellón/Castelló,26,Benasal,1332,673,659
12,Castellón/Castelló,27,Benicarló,26381,13344,13037
12,Castellón/Castelló,28,Benicasim/Benicàssim,17870,9006,8864
12,Castellón/Castelló,29,Benlloch,1156,625,531
12,Castellón/Castelló,21,Betxí,5860,2968,2892
12,Castellón/Castelló,31,Borriol,4874,2473,2401
12,Castellón/Castelló,32,Burriana,34235,17217,17018
12,Castellón/Castelló,33,Cabanes,3088,1566,1522
12,Castellón/Castelló,34,Càlig,2170,1102,1068
12,Castellón/Castelló,36,Canet lo Roig,897,451,446
12,Castellón/Castelló,37,Castell de Cabres,18,9,9
12,Castellón/Castelló,38,Castellfort,235,124,111
12,Castellón/Castelló,39,Castellnovo,1080,541,539
12,Castellón/Castelló,40,Castellón de la Plana/Castelló de la Plana,177924,87989,89935
12,Castellón/Castelló,41,Castillo de Villamalefa,88,43,45
12,Castellón/Castelló,42,Catí,861,449,412
12,Castellón/Castelló,43,Caudiel,724,370,354
12,Castellón/Castelló,44,Cervera del Maestre,748,368,380
12,Castellón/Castelló,52,Chert/Xert,927,456,471
12,Castellón/Castelló,53,Chilches/Xilxes,2821,1473,1348
12,Castellón/Castelló,55,Chodos/Xodos,122,66,56
12,Castellón/Castelló,56,Chóvar,354,182,172
12,Castellón/Castelló,45,Cinctorres,504,241,263
12,Castellón/Castelló,46,Cirat,256,140,116
12,Castellón/Castelló,48,Cortes de Arenoso,355,187,168
12,Castellón/Castelló,49,Costur,579,296,283
12,Castellón/Castelló,50,Coves de Vinromà (les),2093,1068,1025
12,Castellón/Castelló,51,Culla,650,341,309
12,Castellón/Castelló,57,Eslida,908,453,455
12,Castellón/Castelló,58,Espadilla,70,33,37
12,Castellón/Castelló,59,Fanzara,447,223,224
12,Castellón/Castelló,60,Figueroles,582,293,289
12,Castellón/Castelló,61,Forcall,540,263,277
12,Castellón/Castelló,63,Fuente la Reina,51,29,22
12,Castellón/Castelló,64,Fuentes de Ayódar,112,67,45
12,Castellón/Castelló,65,Gaibiel,213,114,99
12,Castellón/Castelló,67,Geldo,702,364,338
12,Castellón/Castelló,68,Herbés,65,37,28
12,Castellón/Castelló,69,Higueras,54,27,27
12,Castellón/Castelló,70,Jana (la),830,422,408
12,Castellón/Castelló,71,Jérica,1642,821,821
12,Castellón/Castelló,74,Llosa (la),935,477,458
12,Castellón/Castelló,72,Lucena del Cid,1587,800,787
12,Castellón/Castelló,73,Ludiente,169,91,78
12,Castellón/Castelló,75,Mata de Morella (la),195,104,91
12,Castellón/Castelló,76,Matet,125,64,61
12,Castellón/Castelló,77,Moncofa,5797,2967,2830
12,Castellón/Castelló,78,Montán,386,190,196
12,Castellón/Castelló,79,Montanejos,618,312,306
12,Castellón/Castelló,80,Morella,2854,1435,1419
12,Castellón/Castelló,81,Navajas,733,382,351
12,Castellón/Castelló,82,Nules,13318,6659,6659
12,Castellón/Castelló,83,Olocau del Rey,135,75,60
12,Castellón/Castelló,84,Onda,25362,13012,12350
12,Castellón/Castelló,85,Oropesa del Mar/Orpesa,11245,6245,5000
12,Castellón/Castelló,87,Palanques,34,18,16
12,Castellón/Castelló,88,Pavías,57,31,26
12,Castellón/Castelló,89,Peñíscola,7560,3935,3625
12,Castellón/Castelló,90,Pina de Montalgrao,151,85,66
12,Castellón/Castelló,93,Pobla de Benifassà (la),299,151,148
12,Castellón/Castelló,94,Pobla Tornesa (la),980,510,470
12,Castellón/Castelló,91,Portell de Morella,258,125,133
12,Castellón/Castelló,92,Puebla de Arenoso,211,127,84
12,Castellón/Castelló,95,Ribesalbes,1363,693,670
12,Castellón/Castelló,96,Rossell,1217,643,574
12,Castellón/Castelló,97,Sacañet,100,56,44
12,Castellón/Castelló,98,Salzadella (la),855,432,423
12,Castellón/Castelló,101,San Rafael del Río,551,284,267
12,Castellón/Castelló,902,Sant Joan de Moró,2774,1502,1272
12,Castellón/Castelló,99,Sant Jordi/San Jorge,982,511,471
12,Castellón/Castelló,100,Sant Mateu,2162,1121,1041
12,Castellón/Castelló,102,Santa Magdalena de Pulpis,874,464,410
12,Castellón/Castelló,103,Sarratella,88,47,41
12,Castellón/Castelló,104,Segorbe,9131,4509,4622
12,Castellón/Castelló,105,Sierra Engarcerán,1037,542,495
12,Castellón/Castelló,106,Soneja,1476,738,738
12,Castellón/Castelló,107,Sot de Ferrer,471,243,228
12,Castellón/Castelló,108,Sueras/Suera,643,332,311
12,Castellón/Castelló,109,Tales,879,444,435
12,Castellón/Castelló,110,Teresa,303,154,149
12,Castellón/Castelló,111,Tírig,562,300,262
12,Castellón/Castelló,112,Todolella,143,89,54
12,Castellón/Castelló,113,Toga,118,58,60
12,Castellón/Castelló,114,Torás,250,128,122
12,Castellón/Castelló,115,Toro (El),309,169,140
12,Castellón/Castelló,116,Torralba del Pinar,68,34,34
12,Castellón/Castelló,119,Torre d'En Besora (la),184,103,81
12,Castellón/Castelló,120,Torre Endoménech,243,126,117
12,Castellón/Castelló,117,Torreblanca,6192,3238,2954
12,Castellón/Castelló,118,Torrechiva,98,56,42
12,Castellón/Castelló,121,Traiguera,1704,887,817
12,Castellón/Castelló,122,Useras/Useres (les),1008,528,480
12,Castellón/Castelló,124,Vall d'Alba,2906,1508,1398
12,Castellón/Castelló,125,Vall de Almonacid,275,150,125
12,Castellón/Castelló,126,Vall d'Uixó (la),32617,16279,16338
12,Castellón/Castelló,123,Vallat,79,37,42
12,Castellón/Castelló,127,Vallibona,98,52,46
12,Castellón/Castelló,128,Vilafamés,1992,1051,941
12,Castellón/Castelló,132,Vilanova d'Alcolea,703,373,330
12,Castellón/Castelló,134,Vilar de Canes,176,92,84
12,Castellón/Castelló,135,Vila-real,50626,25517,25109
12,Castellón/Castelló,136,Vilavella (la),3418,1722,1696
12,Castellón/Castelló,129,Villafranca del Cid/Vilafranca,2520,1228,1292
12,Castellón/Castelló,130,Villahermosa del Río,451,237,214
12,Castellón/Castelló,131,Villamalur,90,45,45
12,Castellón/Castelló,133,Villanueva de Viver,74,42,32
12,Castellón/Castelló,137,Villores,53,30,23
12,Castellón/Castelló,138,Vinaròs,27912,13955,13957
12,Castellón/Castelló,139,Vistabella del Maestrazgo,426,226,200
12,Castellón/Castelló,140,Viver,1703,891,812
12,Castellón/Castelló,141,Zorita del Maestrazgo,152,70,82
12,Castellón/Castelló,142,Zucaina,170,95,75
13,Ciudad Real,1,Abenójar,1615,823,792
13,Ciudad Real,2,Agudo,1867,937,930
13,Ciudad Real,3,Alamillo,566,281,285
13,Ciudad Real,4,Albaladejo,1535,795,740
13,Ciudad Real,5,Alcázar de San Juan,30408,15062,15346
13,Ciudad Real,6,Alcoba,726,368,358
13,Ciudad Real,7,Alcolea de Calatrava,1635,829,806
13,Ciudad Real,8,Alcubillas,595,308,287
13,Ciudad Real,9,Aldea del Rey,2047,1028,1019
13,Ciudad Real,10,Alhambra,1145,588,557
13,Ciudad Real,11,Almadén,6288,3020,3268
13,Ciudad Real,12,Almadenejos,490,252,238
13,Ciudad Real,13,Almagro,8581,4241,4340
13,Ciudad Real,14,Almedina,714,361,353
13,Ciudad Real,15,Almodóvar del Campo,6848,3394,3454
13,Ciudad Real,16,Almuradiel,971,475,496
13,Ciudad Real,17,Anchuras,372,213,159
13,Ciudad Real,903,Arenales de San Gregorio,728,381,347
13,Ciudad Real,18,Arenas de San Juan,1055,539,516
13,Ciudad Real,19,Argamasilla de Alba,7387,3779,3608
13,Ciudad Real,20,Argamasilla de Calatrava,5772,2954,2818
13,Ciudad Real,21,Arroba de los Montes,559,292,267
13,Ciudad Real,22,Ballesteros de Calatrava,510,255,255
13,Ciudad Real,23,Bolaños de Calatrava,12374,6398,5976
13,Ciudad Real,24,Brazatortas,1130,591,539
13,Ciudad Real,25,Cabezarados,351,180,171
13,Ciudad Real,26,Cabezarrubias del Puerto,578,302,276
13,Ciudad Real,27,Calzada de Calatrava,4518,2262,2256
13,Ciudad Real,28,Campo de Criptana,14870,7653,7217
13,Ciudad Real,29,Cañada de Calatrava,117,66,51
13,Ciudad Real,30,Caracuel de Calatrava,163,85,78
13,Ciudad Real,31,Carrión de Calatrava,2849,1441,1408
13,Ciudad Real,32,Carrizosa,1491,747,744
13,Ciudad Real,33,Castellar de Santiago,2213,1107,1106
13,Ciudad Real,38,Chillón,2092,1014,1078
13,Ciudad Real,34,Ciudad Real,72208,34302,37906
13,Ciudad Real,35,Corral de Calatrava,1241,627,614
13,Ciudad Real,36,Cortijos (Los),1015,517,498
13,Ciudad Real,37,Cózar,1272,641,631
13,Ciudad Real,39,Daimiel,18389,9176,9213
13,Ciudad Real,40,Fernán Caballero,1165,576,589
13,Ciudad Real,41,Fontanarejo,268,138,130
13,Ciudad Real,42,Fuencaliente,1167,622,545
13,Ciudad Real,43,Fuenllana,302,151,151
13,Ciudad Real,44,Fuente el Fresno,3540,1820,1720
13,Ciudad Real,45,Granátula de Calatrava,963,468,495
13,Ciudad Real,46,Guadalmez,889,455,434
13,Ciudad Real,47,Herencia,8989,4666,4323
13,Ciudad Real,48,Hinojosas de Calatrava,598,299,299
13,Ciudad Real,49,Horcajo de los Montes,1009,506,503
13,Ciudad Real,50,Labores (Las),673,336,337
13,Ciudad Real,904,Llanos del Caudillo,726,376,350
13,Ciudad Real,51,Luciana,416,213,203
13,Ciudad Real,52,Malagón,8702,4337,4365
13,Ciudad Real,53,Manzanares,19027,9453,9574
13,Ciudad Real,54,Membrilla,6474,3272,3202
13,Ciudad Real,55,Mestanza,802,379,423
13,Ciudad Real,56,Miguelturra,13582,6925,6657
13,Ciudad Real,57,Montiel,1613,823,790
13,Ciudad Real,58,Moral de Calatrava,5538,2786,2752
13,Ciudad Real,59,Navalpino,269,132,137
13,Ciudad Real,60,Navas de Estena,398,225,173
13,Ciudad Real,61,Pedro Muñoz,8595,4537,4058
13,Ciudad Real,62,Picón,691,357,334
13,Ciudad Real,63,Piedrabuena,4849,2465,2384
13,Ciudad Real,64,Poblete,1580,820,760
13,Ciudad Real,65,Porzuna,4106,2102,2004
13,Ciudad Real,66,Pozuelo de Calatrava,2894,1457,1437
13,Ciudad Real,67,Pozuelos de Calatrava (Los),471,239,232
13,Ciudad Real,68,Puebla de Don Rodrigo,1265,686,579
13,Ciudad Real,69,Puebla del Príncipe,896,457,439
13,Ciudad Real,70,Puerto Lápice,1051,539,512
13,Ciudad Real,71,Puertollano,51305,25043,26262
13,Ciudad Real,72,Retuerta del Bullaque,1158,645,513
13,Ciudad Real,901,Robledo (El),1282,676,606
13,Ciudad Real,902,Ruidera,636,324,312
13,Ciudad Real,73,Saceruela,672,344,328
13,Ciudad Real,74,San Carlos del Valle,1224,623,601
13,Ciudad Real,75,San Lorenzo de Calatrava,289,153,136
13,Ciudad Real,76,Santa Cruz de los Cáñamos,609,306,303
13,Ciudad Real,77,Santa Cruz de Mudela,4724,2336,2388
13,Ciudad Real,78,Socuéllamos,13357,6882,6475
13,Ciudad Real,79,Solana (La),16392,8350,8042
13,Ciudad Real,80,Solana del Pino,426,214,212
13,Ciudad Real,81,Terrinches,917,497,420
13,Ciudad Real,82,Tomelloso,37532,19008,18524
13,Ciudad Real,83,Torralba de Calatrava,3069,1510,1559
13,Ciudad Real,84,Torre de Juan Abad,1267,624,643
13,Ciudad Real,85,Torrenueva,2983,1516,1467
13,Ciudad Real,86,Valdemanco del Esteras,251,127,124
13,Ciudad Real,87,Valdepeñas,30255,14831,15424
13,Ciudad Real,88,Valenzuela de Calatrava,790,378,412
13,Ciudad Real,89,Villahermosa,2264,1081,1183
13,Ciudad Real,90,Villamanrique,1432,707,725
13,Ciudad Real,91,Villamayor de Calatrava,626,313,313
13,Ciudad Real,92,Villanueva de la Fuente,2560,1300,1260
13,Ciudad Real,93,Villanueva de los Infantes,5854,2920,2934
13,Ciudad Real,94,Villanueva de San Carlos,388,204,184
13,Ciudad Real,95,Villar del Pozo,110,56,54
13,Ciudad Real,96,Villarrubia de los Ojos,11185,5721,5464
13,Ciudad Real,97,Villarta de San Juan,3134,1622,1512
13,Ciudad Real,98,Viso del Marqués,2859,1437,1422
14,Córdoba,1,Adamuz,4472,2296,2176
14,Córdoba,2,Aguilar de la Frontera,13692,6834,6858
14,Córdoba,3,Alcaracejos,1524,763,761
14,Córdoba,4,Almedinilla,2513,1281,1232
14,Córdoba,5,Almodóvar del Río,7746,3882,3864
14,Córdoba,6,Añora,1537,763,774
14,Córdoba,7,Baena,21260,10950,10310
14,Córdoba,8,Belalcázar,3529,1705,1824
14,Córdoba,9,Belmez,3292,1596,1696
14,Córdoba,10,Benamejí,5122,2561,2561
14,Córdoba,11,Blázquez (Los),724,379,345
14,Córdoba,12,Bujalance,7941,3935,4006
14,Córdoba,13,Cabra,21288,10454,10834
14,Córdoba,14,Cañete de las Torres,3173,1605,1568
14,Córdoba,15,Carcabuey,2748,1383,1365
14,Córdoba,16,Cardeña,1721,858,863
14,Córdoba,17,Carlota (La),12827,6441,6386
14,Córdoba,18,Carpio (El),4591,2277,2314
14,Córdoba,19,Castro del Río,8064,3994,4070
14,Córdoba,20,Conquista,479,228,251
14,Córdoba,21,Córdoba,325453,156665,168788
14,Córdoba,22,Doña Mencía,5029,2494,2535
14,Córdoba,23,Dos Torres,2566,1273,1293
14,Córdoba,24,Encinas Reales,2438,1202,1236
14,Córdoba,25,Espejo,3678,1839,1839
14,Córdoba,26,Espiel,2467,1245,1222
14,Córdoba,27,Fernán-Núñez,9594,4801,4793
14,Córdoba,28,Fuente la Lancha,395,191,204
14,Córdoba,29,Fuente Obejuna,5309,2703,2606
14,Córdoba,30,Fuente Palmera,10727,5420,5307
14,Córdoba,31,Fuente-Tójar,803,382,421
14,Córdoba,32,Granjuela (La),518,261,257
14,Córdoba,33,Guadalcázar,1394,693,701
14,Córdoba,34,Guijo (El),408,208,200
14,Córdoba,35,Hinojosa del Duque,7475,3626,3849
14,Córdoba,36,Hornachuelos,4652,2365,2287
14,Córdoba,37,Iznájar,4810,2401,2409
14,Córdoba,38,Lucena,41698,20772,20926
14,Córdoba,39,Luque,3279,1647,1632
14,Córdoba,40,Montalbán de Córdoba,4626,2346,2280
14,Córdoba,41,Montemayor,4067,2035,2032
14,Córdoba,42,Montilla,23811,11822,11989
14,Córdoba,43,Montoro,9895,4897,4998
14,Córdoba,44,Monturque,2003,994,1009
14,Córdoba,45,Moriles,3985,1987,1998
14,Córdoba,46,Nueva Carteya,5696,2868,2828
14,Córdoba,47,Obejo,1824,932,892
14,Córdoba,48,Palenciana,1602,804,798
14,Córdoba,49,Palma del Río,21440,10760,10680
14,Córdoba,50,Pedro Abad,2944,1490,1454
14,Córdoba,51,Pedroche,1689,827,862
14,Córdoba,52,Peñarroya-Pueblonuevo,11863,5729,6134
14,Córdoba,53,Posadas,7322,3631,3691
14,Córdoba,54,Pozoblanco,17590,8630,8960
14,Córdoba,55,Priego de Córdoba,23309,11460,11849
14,Córdoba,56,Puente Genil,29503,14679,14824
14,Córdoba,57,Rambla (La),7564,3785,3779
14,Córdoba,58,Rute,10452,5199,5253
14,Córdoba,59,San Sebastián de los Ballesteros,841,432,409
14,Córdoba,61,Santa Eufemia,975,494,481
14,Córdoba,60,Santaella,6050,3045,3005
14,Córdoba,62,Torrecampo,1313,636,677
14,Córdoba,63,Valenzuela,1339,665,674
14,Córdoba,64,Valsequillo,417,209,208
14,Córdoba,65,Victoria (La),2132,1063,1069
14,Córdoba,66,Villa del Río,7411,3742,3669
14,Córdoba,67,Villafranca de Córdoba,4401,2253,2148
14,Córdoba,68,Villaharta,732,365,367
14,Córdoba,69,Villanueva de Córdoba,9729,4823,4906
14,Córdoba,70,Villanueva del Duque,1649,803,846
14,Córdoba,71,Villanueva del Rey,1207,607,600
14,Córdoba,72,Villaralto,1343,668,675
14,Córdoba,73,Villaviciosa de Córdoba,3569,1821,1748
14,Córdoba,74,Viso (El),2800,1374,1426
14,Córdoba,75,Zuheros,793,410,383
15,Coruña (A),1,Abegondo,5822,2891,2931
15,Coruña (A),2,Ames,25818,12553,13265
15,Coruña (A),3,Aranga,2181,1091,1090
15,Coruña (A),4,Ares,5682,2831,2851
15,Coruña (A),5,Arteixo,28961,14513,14448
15,Coruña (A),6,Arzúa,6484,3219,3265
15,Coruña (A),7,Baña (A),4528,2172,2356
15,Coruña (A),8,Bergondo,6683,3228,3455
15,Coruña (A),9,Betanzos,13522,6435,7087
15,Coruña (A),10,Boimorto,2348,1177,1171
15,Coruña (A),11,Boiro,18730,9107,9623
15,Coruña (A),12,Boqueixón,4445,2182,2263
15,Coruña (A),13,Brión,7104,3457,3647
15,Coruña (A),14,Cabana de Bergantiños,5045,2486,2559
15,Coruña (A),15,Cabanas,3287,1643,1644
15,Coruña (A),16,Camariñas,6207,3081,3126
15,Coruña (A),17,Cambre,22900,11301,11599
15,Coruña (A),18,Capela (A),1439,711,728
15,Coruña (A),19,Carballo,30653,15015,15638
15,Coruña (A),901,Cariño,4617,2252,2365
15,Coruña (A),20,Carnota,4958,2380,2578
15,Coruña (A),21,Carral,5672,2763,2909
15,Coruña (A),22,Cedeira,7511,3752,3759
15,Coruña (A),23,Cee,7691,3716,3975
15,Coruña (A),24,Cerceda,5597,2723,2874
15,Coruña (A),25,Cerdido,1384,677,707
15,Coruña (A),26,Cesuras,2274,1113,1161
15,Coruña (A),27,Coirós,1713,839,874
15,Coruña (A),28,Corcubión,1822,892,930
15,Coruña (A),29,Coristanco,7376,3587,3789
15,Coruña (A),30,Coruña (A),245164,114134,131030
15,Coruña (A),31,Culleredo,27670,13535,14135
15,Coruña (A),32,Curtis,4245,2110,2135
15,Coruña (A),33,Dodro,3024,1472,1552
15,Coruña (A),34,Dumbría,3820,1833,1987
15,Coruña (A),35,Fene,14169,6850,7319
15,Coruña (A),36,Ferrol,74696,35002,39694
15,Coruña (A),37,Fisterra,4959,2500,2459
15,Coruña (A),38,Frades,2732,1352,1380
15,Coruña (A),39,Irixoa,1550,772,778
15,Coruña (A),41,Laracha (A),11079,5437,5642
15,Coruña (A),40,Laxe,3434,1711,1723
15,Coruña (A),42,Lousame,3702,1758,1944
15,Coruña (A),43,Malpica de Bergantiños,6320,3070,3250
15,Coruña (A),44,Mañón,1628,797,831
15,Coruña (A),45,Mazaricos,5050,2429,2621
15,Coruña (A),46,Melide,7901,3882,4019
15,Coruña (A),47,Mesía,3033,1522,1511
15,Coruña (A),48,Miño,5326,2700,2626
15,Coruña (A),49,Moeche,1435,670,765
15,Coruña (A),50,Monfero,2353,1190,1163
15,Coruña (A),51,Mugardos,5605,2734,2871
15,Coruña (A),53,Muros,9823,4770,5053
15,Coruña (A),52,Muxía,5579,2723,2856
15,Coruña (A),54,Narón,37008,18019,18989
15,Coruña (A),55,Neda,5553,2712,2841
15,Coruña (A),56,Negreira,6573,3146,3427
15,Coruña (A),57,Noia,14875,7111,7764
15,Coruña (A),58,Oleiros,32381,15717,16664
15,Coruña (A),59,Ordes,12534,6123,6411
15,Coruña (A),60,Oroso,6804,3402,3402
15,Coruña (A),61,Ortigueira,7311,3497,3814
15,Coruña (A),62,Outes,7547,3618,3929
15,Coruña (A),63,Oza dos Ríos,3206,1601,1605
15,Coruña (A),64,Paderne,2722,1328,1394
15,Coruña (A),65,Padrón,9016,4334,4682
15,Coruña (A),66,Pino (O),4782,2346,2436
15,Coruña (A),67,Pobra do Caramiñal (A),9934,4792,5142
15,Coruña (A),68,Ponteceso,6381,3214,3167
15,Coruña (A),69,Pontedeume,8561,4155,4406
15,Coruña (A),70,Pontes de García Rodríguez (As),11384,5694,5690
15,Coruña (A),71,Porto do Son,9845,4881,4964
15,Coruña (A),72,Rianxo,11578,5644,5934
15,Coruña (A),73,Ribeira,27430,13568,13862
15,Coruña (A),74,Rois,5012,2371,2641
15,Coruña (A),75,Sada,14036,6958,7078
15,Coruña (A),76,San Sadurniño,3125,1534,1591
15,Coruña (A),77,Santa Comba,10577,5144,5433
15,Coruña (A),78,Santiago de Compostela,94339,44041,50298
15,Coruña (A),79,Santiso,2035,1057,978
15,Coruña (A),80,Sobrado,2208,1116,1092
15,Coruña (A),81,Somozas (As),1388,695,693
15,Coruña (A),82,Teo,17625,8634,8991
15,Coruña (A),83,Toques,1416,743,673
15,Coruña (A),84,Tordoia,4399,2089,2310
15,Coruña (A),85,Touro,4266,2100,2166
15,Coruña (A),86,Trazo,3509,1738,1771
15,Coruña (A),88,Val do Dubra,4481,2171,2310
15,Coruña (A),87,Valdoviño,6986,3416,3570
15,Coruña (A),89,Vedra,5063,2451,2612
15,Coruña (A),91,Vilarmaior,1289,666,623
15,Coruña (A),90,Vilasantar,1432,747,685
15,Coruña (A),92,Vimianzo,8300,4057,4243
15,Coruña (A),93,Zas,5459,2667,2792
16,Cuenca,1,Abia de la Obispalía,77,45,32
16,Cuenca,2,Acebrón (El),268,138,130
16,Cuenca,3,Alarcón,181,79,102
16,Cuenca,4,Albaladejo del Cuende,360,188,172
16,Cuenca,5,Albalate de las Nogueras,300,168,132
16,Cuenca,6,Albendea,161,82,79
16,Cuenca,7,Alberca de Záncara (La),1930,993,937
16,Cuenca,8,Alcalá de la Vega,158,86,72
16,Cuenca,9,Alcantud,96,50,46
16,Cuenca,10,Alcázar del Rey,217,112,105
16,Cuenca,11,Alcohujate,34,22,12
16,Cuenca,12,Alconchel de la Estrella,147,76,71
16,Cuenca,13,Algarra,27,19,8
16,Cuenca,14,Aliaguilla,797,412,385
16,Cuenca,15,Almarcha (La),586,323,263
16,Cuenca,16,Almendros,272,142,130
16,Cuenca,17,Almodóvar del Pinar,460,236,224
16,Cuenca,18,Almonacid del Marquesado,505,262,243
16,Cuenca,19,Altarejos,277,141,136
16,Cuenca,20,Arandilla del Arroyo,27,19,8
16,Cuenca,905,Arcas del Villar,1165,599,566
16,Cuenca,22,Arcos de la Sierra,103,55,48
16,Cuenca,24,Arguisuelas,144,78,66
16,Cuenca,25,Arrancacepas,41,22,19
16,Cuenca,26,Atalaya del Cañavate,109,55,54
16,Cuenca,27,Barajas de Melo,974,515,459
16,Cuenca,29,Barchín del Hoyo,98,54,44
16,Cuenca,30,Bascuñana de San Pedro,28,17,11
16,Cuenca,31,Beamud,77,39,38
16,Cuenca,32,Belinchón,355,183,172
16,Cuenca,33,Belmonte,2274,1128,1146
16,Cuenca,34,Belmontejo,217,111,106
16,Cuenca,35,Beteta,370,186,184
16,Cuenca,36,Boniches,168,78,90
16,Cuenca,38,Buciegas,55,27,28
16,Cuenca,39,Buenache de Alarcón,650,341,309
16,Cuenca,40,Buenache de la Sierra,120,75,45
16,Cuenca,41,Buendía,531,284,247
16,Cuenca,42,Campillo de Altobuey,1717,838,879
16,Cuenca,43,Campillos-Paravientos,127,68,59
16,Cuenca,44,Campillos-Sierra,65,36,29
16,Cuenca,901,Campos del Paraíso,869,432,437
16,Cuenca,45,Canalejas del Arroyo,354,186,168
16,Cuenca,46,Cañada del Hoyo,302,151,151
16,Cuenca,47,Cañada Juncosa,327,185,142
16,Cuenca,48,Cañamares,533,304,229
16,Cuenca,49,Cañavate (El),171,84,87
16,Cuenca,50,Cañaveras,383,201,182
16,Cuenca,51,Cañaveruelas,183,91,92
16,Cuenca,52,Cañete,922,480,442
16,Cuenca,53,Cañizares,544,281,263
16,Cuenca,55,Carboneras de Guadazaón,855,438,417
16,Cuenca,56,Cardenete,632,322,310
16,Cuenca,57,Carrascosa,113,70,43
16,Cuenca,58,Carrascosa de Haro,135,63,72
16,Cuenca,60,Casas de Benítez,1039,513,526
16,Cuenca,61,Casas de Fernando Alonso,1433,759,674
16,Cuenca,62,Casas de Garcimolina,31,18,13
16,Cuenca,63,Casas de Guijarro,141,76,65
16,Cuenca,64,Casas de Haro,904,465,439
16,Cuenca,65,Casas de los Pinos,523,245,278
16,Cuenca,66,Casasimarro,3206,1667,1539
16,Cuenca,67,Castejón,222,105,117
16,Cuenca,68,Castillejo de Iniesta,192,109,83
16,Cuenca,70,Castillejo-Sierra,44,23,21
16,Cuenca,72,Castillo de Garcimuñoz,177,93,84
16,Cuenca,71,Castillo-Albaráñez,22,10,12
16,Cuenca,73,Cervera del Llano,278,148,130
16,Cuenca,23,Chillarón de Cuenca,439,223,216
16,Cuenca,81,Chumillas,73,41,32
16,Cuenca,74,Cierva (La),43,27,16
16,Cuenca,78,Cuenca,54600,26338,28262
16,Cuenca,79,Cueva del Hierro,40,26,14
16,Cuenca,82,Enguídanos,429,225,204
16,Cuenca,83,Fresneda de Altarejos,73,40,33
16,Cuenca,84,Fresneda de la Sierra,62,29,33
16,Cuenca,85,Frontera (La),187,91,96
16,Cuenca,86,Fuente de Pedro Naharro,1290,686,604
16,Cuenca,87,Fuentelespino de Haro,298,151,147
16,Cuenca,88,Fuentelespino de Moya,153,81,72
16,Cuenca,904,Fuentenava de Jábaga,533,284,249
16,Cuenca,89,Fuentes,507,275,232
16,Cuenca,91,Fuertescusa,102,56,46
16,Cuenca,92,Gabaldón,190,109,81
16,Cuenca,93,Garaballa,117,65,52
16,Cuenca,94,Gascueña,205,101,104
16,Cuenca,95,Graja de Campalbo,116,61,55
16,Cuenca,96,Graja de Iniesta,448,232,216
16,Cuenca,97,Henarejos,221,111,110
16,Cuenca,98,Herrumblar (El),752,394,358
16,Cuenca,99,Hinojosa (La),276,140,136
16,Cuenca,100,Hinojosos (Los),1044,509,535
16,Cuenca,101,Hito (El),184,97,87
16,Cuenca,102,Honrubia,1768,878,890
16,Cuenca,103,Hontanaya,374,198,176
16,Cuenca,104,Hontecillas,86,41,45
16,Cuenca,106,Horcajo de Santiago,4215,2216,1999
16,Cuenca,107,Huélamo,127,64,63
16,Cuenca,108,Huelves,93,49,44
16,Cuenca,109,Huérguina,74,36,38
16,Cuenca,110,Huerta de la Obispalía,135,77,58
16,Cuenca,111,Huerta del Marquesado,216,127,89
16,Cuenca,112,Huete,2054,1037,1017
16,Cuenca,113,Iniesta,4694,2384,2310
16,Cuenca,115,Laguna del Marquesado,58,32,26
16,Cuenca,116,Lagunaseca,103,48,55
16,Cuenca,117,Landete,1366,703,663
16,Cuenca,118,Ledaña,1914,953,961
16,Cuenca,119,Leganiel,241,128,113
16,Cuenca,121,Majadas (Las),337,170,167
16,Cuenca,122,Mariana,288,140,148
16,Cuenca,123,Masegosa,116,62,54
16,Cuenca,124,Mesas (Las),2526,1304,1222
16,Cuenca,125,Minglanilla,2581,1373,1208
16,Cuenca,126,Mira,935,481,454
16,Cuenca,128,Monreal del Llano,84,44,40
16,Cuenca,129,Montalbanejo,149,70,79
16,Cuenca,130,Montalbo,776,405,371
16,Cuenca,131,Monteagudo de las Salinas,147,84,63
16,Cuenca,132,Mota de Altarejos,47,29,18
16,Cuenca,133,Mota del Cuervo,6262,3191,3071
16,Cuenca,134,Motilla del Palancar,5983,3026,2957
16,Cuenca,135,Moya,209,113,96
16,Cuenca,137,Narboneta,64,33,31
16,Cuenca,139,Olivares de Júcar,434,219,215
16,Cuenca,140,Olmeda de la Cuesta,34,15,19
16,Cuenca,141,Olmeda del Rey,192,96,96
16,Cuenca,142,Olmedilla de Alarcón,153,84,69
16,Cuenca,143,Olmedilla de Eliz,23,11,12
16,Cuenca,145,Osa de la Vega,641,328,313
16,Cuenca,146,Pajarón,109,57,52
16,Cuenca,147,Pajaroncillo,81,41,40
16,Cuenca,148,Palomares del Campo,795,403,392
16,Cuenca,149,Palomera,190,99,91
16,Cuenca,150,Paracuellos,142,66,76
16,Cuenca,151,Paredes,100,56,44
16,Cuenca,152,Parra de las Vegas (La),40,23,17
16,Cuenca,153,Pedernoso (El),1262,644,618
16,Cuenca,154,Pedroñeras (Las),7109,3747,3362
16,Cuenca,155,Peral (El),781,427,354
16,Cuenca,156,Peraleja (La),134,65,69
16,Cuenca,157,Pesquera (La),254,135,119
16,Cuenca,158,Picazo (El),816,417,399
16,Cuenca,159,Pinarejo,345,169,176
16,Cuenca,160,Pineda de Gigüela,98,50,48
16,Cuenca,161,Piqueras del Castillo,72,37,35
16,Cuenca,162,Portalrubio de Guadamejud,49,26,23
16,Cuenca,163,Portilla,84,41,43
16,Cuenca,165,Poyatos,107,61,46
16,Cuenca,166,Pozoamargo,375,186,189
16,Cuenca,908,Pozorrubielos de la Mancha,316,148,168
16,Cuenca,167,Pozorrubio,405,198,207
16,Cuenca,169,Pozuelo (El),100,50,50
16,Cuenca,170,Priego,1171,599,572
16,Cuenca,171,Provencio (El),2743,1367,1376
16,Cuenca,172,Puebla de Almenara,494,246,248
16,Cuenca,173,Puebla de Don Francisco,321,174,147
16,Cuenca,174,Puebla del Salvador,261,143,118
16,Cuenca,175,Quintanar del Rey,7845,4138,3707
16,Cuenca,176,Rada de Haro,63,31,32
16,Cuenca,177,Reíllo,126,66,60
16,Cuenca,181,Rozalén del Monte,78,34,44
16,Cuenca,185,Saceda-Trasierra,95,50,45
16,Cuenca,186,Saelices,669,352,317
16,Cuenca,187,Salinas del Manzano,108,62,46
16,Cuenca,188,Salmeroncillos,170,91,79
16,Cuenca,189,Salvacañete,292,151,141
16,Cuenca,190,San Clemente,7058,3624,3434
16,Cuenca,191,San Lorenzo de la Parrilla,1306,666,640
16,Cuenca,192,San Martín de Boniches,82,43,39
16,Cuenca,193,San Pedro Palmiches,100,56,44
16,Cuenca,194,Santa Cruz de Moya,316,165,151
16,Cuenca,196,Santa María de los Llanos,777,404,373
16,Cuenca,195,Santa María del Campo Rus,735,371,364
16,Cuenca,197,Santa María del Val,96,53,43
16,Cuenca,198,Sisante,1920,964,956
16,Cuenca,199,Solera de Gabaldón,35,12,23
16,Cuenca,909,Sotorribas,871,435,436
16,Cuenca,202,Talayuelas,1071,560,511
16,Cuenca,203,Tarancón,14962,7482,7480
16,Cuenca,204,Tébar,364,190,174
16,Cuenca,205,Tejadillos,146,72,74
16,Cuenca,206,Tinajas,360,190,170
16,Cuenca,209,Torralba,167,94,73
16,Cuenca,211,Torrejoncillo del Rey,607,306,301
16,Cuenca,212,Torrubia del Campo,338,167,171
16,Cuenca,213,Torrubia del Castillo,41,25,16
16,Cuenca,215,Tragacete,366,199,167
16,Cuenca,216,Tresjuncos,425,219,206
16,Cuenca,217,Tribaldos,113,54,59
16,Cuenca,218,Uclés,259,130,129
16,Cuenca,219,Uña,117,61,56
16,Cuenca,906,Valdecolmenas (Los),108,62,46
16,Cuenca,224,Valdemeca,124,66,58
16,Cuenca,225,Valdemorillo de la Sierra,85,46,39
16,Cuenca,227,Valdemoro-Sierra,148,83,65
16,Cuenca,228,Valdeolivas,259,149,110
16,Cuenca,902,Valdetórtola,175,103,72
16,Cuenca,903,Valeras (Las),1653,903,750
16,Cuenca,231,Valhermoso de la Fuente,63,29,34
16,Cuenca,234,Valsalobre,70,41,29
16,Cuenca,236,Valverde de Júcar,1194,604,590
16,Cuenca,237,Valverdejo,121,63,58
16,Cuenca,238,Vara de Rey,628,329,299
16,Cuenca,239,Vega del Codorno,186,100,86
16,Cuenca,240,Vellisca,158,78,80
16,Cuenca,242,Villaconejos de Trabaque,441,224,217
16,Cuenca,243,Villaescusa de Haro,521,256,265
16,Cuenca,244,Villagarcía del Llano,880,450,430
16,Cuenca,245,Villalba de la Sierra,572,292,280
16,Cuenca,246,Villalba del Rey,619,327,292
16,Cuenca,247,Villalgordo del Marquesado,104,57,47
16,Cuenca,248,Villalpardo,1162,573,589
16,Cuenca,249,Villamayor de Santiago,3005,1547,1458
16,Cuenca,250,Villanueva de Guadamejud,114,59,55
16,Cuenca,251,Villanueva de la Jara,2029,1043,986
16,Cuenca,253,Villar de Cañas,461,244,217
16,Cuenca,254,Villar de Domingo García,236,127,109
16,Cuenca,255,Villar de la Encina,186,90,96
16,Cuenca,263,Villar de Olalla,1137,600,537
16,Cuenca,258,Villar del Humo,324,186,138
16,Cuenca,259,Villar del Infantado,47,29,18
16,Cuenca,910,Villar y Velasco,117,65,52
16,Cuenca,264,Villarejo de Fuentes,681,359,322
16,Cuenca,265,Villarejo de la Peñuela,24,11,13
16,Cuenca,266,Villarejo-Periesteban,460,221,239
16,Cuenca,269,Villares del Saz,646,335,311
16,Cuenca,270,Villarrubio,223,114,109
16,Cuenca,271,Villarta,923,470,453
16,Cuenca,272,Villas de la Ventosa,327,171,156
16,Cuenca,273,Villaverde y Pasaconsol,383,195,188
16,Cuenca,274,Víllora,219,112,107
16,Cuenca,275,Vindel,20,11,9
16,Cuenca,276,Yémeda,28,15,13
16,Cuenca,277,Zafra de Záncara,155,83,72
16,Cuenca,278,Zafrilla,100,46,54
16,Cuenca,279,Zarza de Tajo,405,226,179
16,Cuenca,280,Zarzuela,237,130,107
17,Girona,1,Agullana,806,421,385
17,Girona,2,Aiguaviva,678,346,332
17,Girona,3,Albanyà,143,76,67
17,Girona,4,Albons,666,345,321
17,Girona,6,Alp,1686,885,801
17,Girona,7,Amer,2270,1109,1161
17,Girona,8,Anglès,5446,2792,2654
17,Girona,9,Arbúcies,6526,3479,3047
17,Girona,10,Argelaguer,430,224,206
17,Girona,11,Armentera (L'),827,402,425
17,Girona,12,Avinyonet de Puigventós,1417,752,665
17,Girona,15,Banyoles,17917,8975,8942
17,Girona,16,Bàscara,915,489,426
17,Girona,13,Begur,4304,2226,2078
17,Girona,18,Bellcaire d'Empordà,651,317,334
17,Girona,19,Besalú,2290,1107,1183
17,Girona,20,Bescanó,4242,2120,2122
17,Girona,21,Beuda,158,80,78
17,Girona,22,Bisbal d'Empordà (La),10173,5160,5013
17,Girona,234,Biure,244,125,119
17,Girona,23,Blanes,39107,19719,19388
17,Girona,29,Boadella i les Escaules,233,113,120
17,Girona,24,Bolvir,363,197,166
17,Girona,25,Bordils,1703,873,830
17,Girona,26,Borrassà,682,360,322
17,Girona,27,Breda,3753,1913,1840
17,Girona,28,Brunyola,363,181,182
17,Girona,31,Cabanelles,236,135,101
17,Girona,30,Cabanes,903,478,425
17,Girona,32,Cadaqués,2873,1431,1442
17,Girona,33,Caldes de Malavella,6459,3202,3257
17,Girona,34,Calonge,10428,5308,5120
17,Girona,35,Camós,696,352,344
17,Girona,36,Campdevànol,3501,1766,1735
17,Girona,37,Campelles,128,64,64
17,Girona,38,Campllong,423,212,211
17,Girona,39,Camprodon,2578,1280,1298
17,Girona,40,Canet d'Adri,601,309,292
17,Girona,41,Cantallops,320,164,156
17,Girona,42,Capmany,560,301,259
17,Girona,44,Cassà de la Selva,9256,4774,4482
17,Girona,46,Castellfollit de la Roca,1014,514,500
17,Girona,47,Castelló d'Empúries,11653,6054,5599
17,Girona,48,Castell-Platja d'Aro,10150,5168,4982
17,Girona,189,Cellera de Ter (La),2162,1095,1067
17,Girona,49,Celrà,4329,2155,2174
17,Girona,50,Cervià de Ter,863,432,431
17,Girona,51,Cistella,253,132,121
17,Girona,54,Colera,578,301,277
17,Girona,55,Colomers,203,98,105
17,Girona,57,Corçà,1270,627,643
17,Girona,56,Cornellà del Terri,2189,1106,1083
17,Girona,58,Crespià,257,132,125
17,Girona,901,"Cruïlles, Monells i Sant Sadurní de l'Heura",1270,633,637
17,Girona,60,Darnius,534,270,264
17,Girona,61,Das,214,113,101
17,Girona,62,Escala (L'),9829,5079,4750
17,Girona,63,Espinelves,191,97,94
17,Girona,64,Espolla,408,197,211
17,Girona,65,Esponellà,451,218,233
17,Girona,5,Far d'Empordà (El),524,265,259
17,Girona,66,Figueres,42809,21419,21390
17,Girona,67,Flaçà,1050,518,532
17,Girona,68,Foixà,333,179,154
17,Girona,69,Fontanals de Cerdanya,443,227,216
17,Girona,70,Fontanilles,167,101,66
17,Girona,71,Fontcoberta,1200,585,615
17,Girona,902,Forallac,1740,863,877
17,Girona,73,Fornells de la Selva,2110,1010,1100
17,Girona,74,Fortià,628,320,308
17,Girona,75,Garrigàs,395,216,179
17,Girona,76,Garrigoles,167,89,78
17,Girona,77,Garriguella,821,417,404
17,Girona,78,Ger,449,239,210
17,Girona,79,Girona,94484,46380,48104
17,Girona,80,Gombrèn,239,115,124
17,Girona,81,Gualta,347,192,155
17,Girona,82,Guils de Cerdanya,467,247,220
17,Girona,83,Hostalric,3882,1996,1886
17,Girona,84,Isòvol,268,156,112
17,Girona,85,Jafre,402,225,177
17,Girona,86,Jonquera (La),3107,1592,1515
17,Girona,87,Juià,301,159,142
17,Girona,88,Lladó,644,335,309
17,Girona,89,Llagostera,7614,3948,3666
17,Girona,90,Llambilles,660,341,319
17,Girona,91,Llanars,571,304,267
17,Girona,92,Llançà,5082,2542,2540
17,Girona,93,Llers,1157,584,573
17,Girona,94,Llívia,1517,836,681
17,Girona,95,Lloret de Mar,37734,20033,17701
17,Girona,96,Llosses (Les),234,128,106
17,Girona,102,Maçanet de Cabrenys,723,379,344
17,Girona,103,Maçanet de la Selva,6611,3446,3165
17,Girona,97,Madremanya,232,105,127
17,Girona,98,Maià de Montcal,407,211,196
17,Girona,100,Masarac,278,149,129
17,Girona,101,Massanes,709,375,334
17,Girona,99,Meranges,83,51,32
17,Girona,105,Mieres,346,181,165
17,Girona,106,Mollet de Peralada,171,86,85
17,Girona,107,Molló,349,171,178
17,Girona,109,Montagut i Oix,960,500,460
17,Girona,110,Mont-ras,1838,956,882
17,Girona,111,Navata,1080,546,534
17,Girona,112,Ogassa,266,158,108
17,Girona,114,Olot,32903,16593,16310
17,Girona,115,Ordis,375,202,173
17,Girona,116,Osor,361,185,176
17,Girona,117,Palafrugell,22109,11249,10860
17,Girona,118,Palamós,17766,8797,8969
17,Girona,119,Palau de Santa Eulàlia,105,60,45
17,Girona,121,Palau-sator,289,151,138
17,Girona,120,Palau-saverdera,1423,722,701
17,Girona,123,Palol de Revardit,478,243,235
17,Girona,124,Pals,2698,1368,1330
17,Girona,125,Pardines,168,92,76
17,Girona,126,Parlavà,383,195,188
17,Girona,128,Pau,586,301,285
17,Girona,129,Pedret i Marzà,163,85,78
17,Girona,130,Pera (La),445,225,220
17,Girona,132,Peralada,1762,892,870
17,Girona,133,Planes d'Hostoles (Les),1795,908,887
17,Girona,134,Planoles,282,149,133
17,Girona,135,Pont de Molins,490,260,230
17,Girona,136,Pontós,244,133,111
17,Girona,137,Porqueres,4332,2163,2169
17,Girona,140,Port de la Selva (El),1029,535,494
17,Girona,138,Portbou,1306,648,658
17,Girona,139,Preses (Les),1708,842,866
17,Girona,141,Puigcerdà,9365,4855,4510
17,Girona,142,Quart,2762,1419,1343
17,Girona,43,Queralbs,192,110,82
17,Girona,143,Rabós,194,98,96
17,Girona,144,Regencós,313,176,137
17,Girona,145,Ribes de Freser,2006,986,1020
17,Girona,146,Riells i Viabrea,3659,1917,1742
17,Girona,147,Ripoll,11012,5473,5539
17,Girona,148,Riudarenes,2002,1043,959
17,Girona,149,Riudaura,426,213,213
17,Girona,150,Riudellots de la Selva,1940,1009,931
17,Girona,151,Riumors,216,113,103
17,Girona,152,Roses,19463,9968,9495
17,Girona,153,Rupià,240,124,116
17,Girona,154,Sales de Llierca,132,69,63
17,Girona,155,Salt,28763,15458,13305
17,Girona,157,Sant Andreu Salou,157,75,82
17,Girona,183,Sant Aniol de Finestres,319,170,149
17,Girona,158,Sant Climent Sescebes,501,265,236
17,Girona,159,Sant Feliu de Buixalleu,803,429,374
17,Girona,160,Sant Feliu de Guíxols,21726,10888,10838
17,Girona,161,Sant Feliu de Pallerols,1389,687,702
17,Girona,162,Sant Ferriol,216,121,95
17,Girona,163,Sant Gregori,3068,1554,1514
17,Girona,164,Sant Hilari Sacalm,5744,2983,2761
17,Girona,165,Sant Jaume de Llierca,809,410,399
17,Girona,167,Sant Joan de les Abadesses,3589,1803,1786
17,Girona,168,Sant Joan de Mollet,515,255,260
17,Girona,185,Sant Joan les Fonts,2751,1408,1343
17,Girona,166,Sant Jordi Desvalls,626,315,311
17,Girona,169,Sant Julià de Ramis,3133,1625,1508
17,Girona,903,Sant Julià del Llor i Bonmatí,1225,627,598
17,Girona,171,Sant Llorenç de la Muga,218,112,106
17,Girona,172,Sant Martí de Llémena,532,279,253
17,Girona,173,Sant Martí Vell,242,128,114
17,Girona,174,Sant Miquel de Campmajor,243,127,116
17,Girona,175,Sant Miquel de Fluvià,718,363,355
17,Girona,176,Sant Mori,179,86,93
17,Girona,177,Sant Pau de Segúries,699,349,350
17,Girona,178,Sant Pere Pescador,1970,1065,905
17,Girona,180,Santa Coloma de Farners,11412,5889,5523
17,Girona,181,Santa Cristina d'Aro,4713,2405,2308
17,Girona,182,Santa Llogaia d'Àlguema,317,169,148
17,Girona,184,Santa Pau,1584,800,784
17,Girona,186,Sarrià de Ter,4320,2151,2169
17,Girona,187,"Saus, Camallera i Llampaies",761,369,392
17,Girona,188,Selva de Mar (La),213,106,107
17,Girona,190,Serinyà,1101,570,531
17,Girona,191,Serra de Daró,197,114,83
17,Girona,192,Setcases,165,91,74
17,Girona,193,Sils,4850,2499,2351
17,Girona,52,Siurana,211,110,101
17,Girona,194,Susqueda,125,69,56
17,Girona,195,Tallada d'Empordà (La),401,208,193
17,Girona,196,Terrades,254,129,125
17,Girona,197,Torrent,184,95,89
17,Girona,198,Torroella de Fluvià,658,351,307
17,Girona,199,Torroella de Montgrí,11441,5832,5609
17,Girona,200,Tortellà,758,378,380
17,Girona,201,Toses,150,90,60
17,Girona,202,Tossa de Mar,5845,2982,2863
17,Girona,204,Ullà,1067,622,445
17,Girona,205,Ullastret,227,117,110
17,Girona,203,Ultramort,193,112,81
17,Girona,206,Urús,196,102,94
17,Girona,14,Vajol (La),102,61,41
17,Girona,208,Vall de Bianya (La),1307,660,647
17,Girona,207,Vall d'en Bas (La),2735,1376,1359
17,Girona,170,Vallfogona de Ripollès,225,118,107
17,Girona,209,Vall-llobrega,825,433,392
17,Girona,210,Ventalló,730,389,341
17,Girona,211,Verges,1195,602,593
17,Girona,212,Vidrà,178,90,88
17,Girona,213,Vidreres,7316,3819,3497
17,Girona,214,Vilabertran,860,455,405
17,Girona,215,Vilablareix,2277,1129,1148
17,Girona,217,Viladamat,439,231,208
17,Girona,216,Viladasens,207,104,103
17,Girona,218,Vilademuls,781,407,374
17,Girona,220,Viladrau,1066,554,512
17,Girona,221,Vilafant,5314,2640,2674
17,Girona,223,Vilajuïga,1138,570,568
17,Girona,224,Vilallonga de Ter,477,262,215
17,Girona,225,Vilamacolum,318,168,150
17,Girona,226,Vilamalla,1115,599,516
17,Girona,227,Vilamaniscle,173,94,79
17,Girona,228,Vilanant,348,171,177
17,Girona,230,Vila-sacra,545,264,281
17,Girona,222,Vilaür,142,72,70
17,Girona,233,Vilobí d'Onyar,2862,1516,1346
17,Girona,232,Vilopriu,217,111,106
18,Granada,1,Agrón,381,199,182
18,Granada,2,Alamedilla,757,391,366
18,Granada,3,Albolote,16879,8485,8394
18,Granada,4,Albondón,921,518,403
18,Granada,5,Albuñán,435,228,207
18,Granada,6,Albuñol,6459,3390,3069
18,Granada,7,Albuñuelas,1037,531,506
18,Granada,10,Aldeire,701,360,341
18,Granada,11,Alfacar,5401,2784,2617
18,Granada,12,Algarinejo,3817,1954,1863
18,Granada,13,Alhama de Granada,6035,3138,2897
18,Granada,14,Alhendín,6108,3175,2933
18,Granada,15,Alicún de Ortega,539,289,250
18,Granada,16,Almegíjar,409,212,197
18,Granada,17,Almuñécar,27544,13662,13882
18,Granada,904,Alpujarra de la Sierra,1163,601,562
18,Granada,18,Alquife,760,388,372
18,Granada,20,Arenas del Rey,2111,1112,999
18,Granada,21,Armilla,20882,10849,10033
18,Granada,22,Atarfe,14803,7474,7329
18,Granada,23,Baza,23287,11651,11636
18,Granada,24,Beas de Granada,1085,574,511
18,Granada,25,Beas de Guadix,376,195,181
18,Granada,27,Benalúa,3351,1672,1679
18,Granada,28,Benalúa de las Villas,1461,819,642
18,Granada,29,Benamaurel,2397,1225,1172
18,Granada,30,Bérchules,836,445,391
18,Granada,32,Bubión,361,194,167
18,Granada,33,Busquístar,317,174,143
18,Granada,34,Cacín,626,315,311
18,Granada,35,Cádiar,1642,867,775
18,Granada,36,Cájar,4437,2169,2268
18,Granada,114,Calahorra (La),760,397,363
18,Granada,37,Calicasas,589,299,290
18,Granada,38,Campotéjar,1418,729,689
18,Granada,39,Caniles,4956,2501,2455
18,Granada,40,Cáñar,422,223,199
18,Granada,42,Capileira,559,285,274
18,Granada,43,Carataunas,197,93,104
18,Granada,44,Cástaras,266,137,129
18,Granada,45,Castilléjar,1624,810,814
18,Granada,46,Castril,2523,1298,1225
18,Granada,47,Cenes de la Vega,6458,3349,3109
18,Granada,59,Chauchina,4707,2365,2342
18,Granada,61,Chimeneas,1499,789,710
18,Granada,62,Churriana de la Vega,11162,5581,5581
18,Granada,48,Cijuela,2665,1378,1287
18,Granada,49,Cogollos de Guadix,726,387,339
18,Granada,50,Cogollos de la Vega,2099,1073,1026
18,Granada,51,Colomera,1594,839,755
18,Granada,53,Cortes de Baza,2347,1180,1167
18,Granada,54,Cortes y Graena,1063,533,530
18,Granada,912,Cuevas del Campo,2131,1103,1028
18,Granada,56,Cúllar,4832,2429,2403
18,Granada,57,Cúllar Vega,6503,3291,3212
18,Granada,63,Darro,1478,741,737
18,Granada,64,Dehesas de Guadix,516,249,267
18,Granada,66,Deifontes,2522,1290,1232
18,Granada,67,Diezma,839,437,402
18,Granada,68,Dílar,1680,836,844
18,Granada,69,Dólar,610,306,304
18,Granada,70,Dúdar,311,172,139
18,Granada,71,Dúrcal,7152,3648,3504
18,Granada,72,Escúzar,833,423,410
18,Granada,74,Ferreira,345,177,168
18,Granada,76,Fonelas,1136,571,565
18,Granada,78,Freila,1126,552,574
18,Granada,79,Fuente Vaqueros,4327,2184,2143
18,Granada,905,Gabias (Las),14945,7771,7174
18,Granada,82,Galera,1134,567,567
18,Granada,83,Gobernador,307,153,154
18,Granada,84,Gójar,5096,2632,2464
18,Granada,85,Gor,940,490,450
18,Granada,86,Gorafe,501,242,259
18,Granada,87,Granada,236988,110191,126797
18,Granada,88,Guadahortuna,2112,1093,1019
18,Granada,89,Guadix,20326,10083,10243
18,Granada,906,Guajares (Los),1318,735,583
18,Granada,93,Gualchos,4126,2208,1918
18,Granada,94,Güejar Sierra,3002,1610,1392
18,Granada,95,Güevéjar,2284,1172,1112
18,Granada,96,Huélago,416,224,192
18,Granada,97,Huéneja,1231,626,605
18,Granada,98,Huéscar,8226,4101,4125
18,Granada,99,Huétor de Santillán,1811,935,876
18,Granada,100,Huétor Tájar,9654,4877,4777
18,Granada,101,Huétor Vega,11103,5577,5526
18,Granada,102,Illora,10399,5195,5204
18,Granada,103,Itrabo,1123,562,561
18,Granada,105,Iznalloz,7150,3656,3494
18,Granada,107,Jayena,1213,639,574
18,Granada,108,Jerez del Marquesado,1090,554,536
18,Granada,109,Jete,891,492,399
18,Granada,111,Jun,3000,1547,1453
18,Granada,112,Juviles,173,87,86
18,Granada,115,Láchar,3005,1525,1480
18,Granada,116,Lanjarón,3908,1951,1957
18,Granada,117,Lanteira,605,343,262
18,Granada,119,Lecrín,2327,1192,1135
18,Granada,120,Lentegí,328,170,158
18,Granada,121,Lobras,125,62,63
18,Granada,122,Loja,21570,10803,10767
18,Granada,123,Lugros,368,194,174
18,Granada,124,Lújar,495,266,229
18,Granada,126,Malahá (La),1764,919,845
18,Granada,127,Maracena,20297,10069,10228
18,Granada,128,Marchal,413,190,223
18,Granada,132,Moclín,4319,2164,2155
18,Granada,133,Molvízar,3407,1729,1678
18,Granada,134,Monachil,6644,3433,3211
18,Granada,135,Montefrío,6357,3192,3165
18,Granada,136,Montejícar,2525,1274,1251
18,Granada,137,Montillana,1328,687,641
18,Granada,138,Moraleda de Zafayona,3186,1637,1549
18,Granada,909,Morelábor,808,426,382
18,Granada,140,Motril,59163,29461,29702
18,Granada,141,Murtas,710,411,299
18,Granada,903,Nevada,1208,613,595
18,Granada,143,Nigüelas,1132,557,575
18,Granada,144,Nívar,869,454,415
18,Granada,145,Ogíjares,12867,6576,6291
18,Granada,146,Orce,1357,715,642
18,Granada,147,Órgiva,5640,2862,2778
18,Granada,148,Otívar,1145,591,554
18,Granada,149,Otura,6135,3167,2968
18,Granada,150,Padul,8224,4113,4111
18,Granada,151,Pampaneira,313,162,151
18,Granada,152,Pedro Martínez,1144,558,586
18,Granada,153,Peligros,10848,5635,5213
18,Granada,154,Peza (La),1383,735,648
18,Granada,910,Pinar (El),1052,531,521
18,Granada,157,Pinos Genil,1249,657,592
18,Granada,158,Pinos Puente,13551,6981,6570
18,Granada,159,Píñar,1271,674,597
18,Granada,161,Polícar,222,109,113
18,Granada,162,Polopos,1758,975,783
18,Granada,163,Pórtugos,405,200,205
18,Granada,164,Puebla de Don Fadrique,2516,1291,1225
18,Granada,165,Pulianas,4993,2522,2471
18,Granada,167,Purullena,2294,1154,1140
18,Granada,168,Quéntar,1070,551,519
18,Granada,170,Rubite,439,248,191
18,Granada,171,Salar,2860,1450,1410
18,Granada,173,Salobreña,12684,6349,6335
18,Granada,174,Santa Cruz del Comercio,549,294,255
18,Granada,175,Santa Fe,15107,7498,7609
18,Granada,176,Soportújar,245,134,111
18,Granada,177,Sorvilán,656,336,320
18,Granada,901,Taha (La),692,348,344
18,Granada,178,Torre-Cardela,1001,498,503
18,Granada,179,Torvizcón,809,422,387
18,Granada,180,Trevélez,852,451,401
18,Granada,181,Turón,319,181,138
18,Granada,182,Ugíjar,2613,1380,1233
18,Granada,902,Valle (El),1163,573,590
18,Granada,907,Valle del Zalabí,2325,1150,1175
18,Granada,183,Válor,650,326,324
18,Granada,911,Vegas del Genil,8061,4167,3894
18,Granada,184,Vélez de Benaudalla,2980,1519,1461
18,Granada,185,Ventas de Huelma,724,382,342
18,Granada,908,Villamena,1034,511,523
18,Granada,187,Villanueva de las Torres,761,420,341
18,Granada,188,Villanueva Mesía,2158,1099,1059
18,Granada,189,Víznar,850,437,413
18,Granada,192,Zafarraya,2152,1172,980
18,Granada,913,Zagra,998,492,506
18,Granada,193,Zubia (La),17434,8665,8769
18,Granada,194,Zújar,2954,1583,1371
19,Guadalajara,1,Abánades,90,46,44
19,Guadalajara,2,Ablanque,107,56,51
19,Guadalajara,3,Adobes,62,32,30
19,Guadalajara,4,Alaminos,73,39,34
19,Guadalajara,5,Alarilla,134,82,52
19,Guadalajara,6,Albalate de Zorita,1096,596,500
19,Guadalajara,7,Albares,523,271,252
19,Guadalajara,8,Albendiego,37,28,9
19,Guadalajara,9,Alcocer,316,155,161
19,Guadalajara,10,Alcolea de las Peñas,15,11,4
19,Guadalajara,11,Alcolea del Pinar,404,217,187
19,Guadalajara,13,Alcoroches,171,109,62
19,Guadalajara,15,Aldeanueva de Guadalajara,102,55,47
19,Guadalajara,16,Algar de Mesa,58,33,25
19,Guadalajara,17,Algora,107,60,47
19,Guadalajara,18,Alhóndiga,229,122,107
19,Guadalajara,19,Alique,31,13,18
19,Guadalajara,20,Almadrones,97,58,39
19,Guadalajara,21,Almoguera,1478,778,700
19,Guadalajara,22,Almonacid de Zorita,802,384,418
19,Guadalajara,23,Alocén,177,88,89
19,Guadalajara,24,Alovera,9976,5190,4786
19,Guadalajara,27,Alustante,236,141,95
19,Guadalajara,31,Angón,28,17,11
19,Guadalajara,32,Anguita,223,121,102
19,Guadalajara,33,Anquela del Ducado,77,45,32
19,Guadalajara,34,Anquela del Pedregal,22,16,6
19,Guadalajara,36,Aranzueque,396,204,192
19,Guadalajara,37,Arbancón,177,108,69
19,Guadalajara,38,Arbeteta,42,21,21
19,Guadalajara,39,Argecilla,72,42,30
19,Guadalajara,40,Armallones,62,36,26
19,Guadalajara,41,Armuña de Tajuña,227,129,98
19,Guadalajara,42,Arroyo de las Fraguas,44,23,21
19,Guadalajara,43,Atanzón,110,68,42
19,Guadalajara,44,Atienza,476,261,215
19,Guadalajara,45,Auñón,227,129,98
19,Guadalajara,46,Azuqueca de Henares,30794,15948,14846
19,Guadalajara,47,Baides,53,26,27
19,Guadalajara,48,Baños de Tajo,22,15,7
19,Guadalajara,49,Bañuelos,31,20,11
19,Guadalajara,50,Barriopedro,27,15,12
19,Guadalajara,51,Berninches,100,58,42
19,Guadalajara,52,Bodera (La),28,18,10
19,Guadalajara,53,Brihuega,2854,1492,1362
19,Guadalajara,54,Budia,222,117,105
19,Guadalajara,55,Bujalaro,74,38,36
19,Guadalajara,57,Bustares,87,52,35
19,Guadalajara,58,Cabanillas del Campo,8801,4428,4373
19,Guadalajara,59,Campillo de Dueñas,105,59,46
19,Guadalajara,60,Campillo de Ranas,208,116,92
19,Guadalajara,61,Campisábalos,65,38,27
19,Guadalajara,64,Canredondo,118,65,53
19,Guadalajara,65,Cantalojas,157,83,74
19,Guadalajara,66,Cañizar,97,46,51
19,Guadalajara,67,Cardoso de la Sierra (El),70,46,24
19,Guadalajara,70,Casa de Uceda,91,46,45
19,Guadalajara,71,Casar (El),9358,4866,4492
19,Guadalajara,73,Casas de San Galindo,34,19,15
19,Guadalajara,74,Caspueñas,106,63,43
19,Guadalajara,75,Castejón de Henares,104,51,53
19,Guadalajara,76,Castellar de la Muela,34,18,16
19,Guadalajara,78,Castilforte,52,33,19
19,Guadalajara,79,Castilnuevo,13,8,5
19,Guadalajara,80,Cendejas de Enmedio,113,60,53
19,Guadalajara,81,Cendejas de la Torre,50,31,19
19,Guadalajara,82,Centenera,120,64,56
19,Guadalajara,103,Checa,341,191,150
19,Guadalajara,104,Chequilla,18,9,9
19,Guadalajara,106,Chillarón del Rey,113,60,53
19,Guadalajara,105,Chiloeches,2556,1362,1194
19,Guadalajara,86,Cifuentes,2053,1060,993
19,Guadalajara,87,Cincovillas,30,16,14
19,Guadalajara,88,Ciruelas,122,66,56
19,Guadalajara,89,Ciruelos del Pinar,43,25,18
19,Guadalajara,90,Cobeta,119,54,65
19,Guadalajara,91,Cogollor,35,20,15
19,Guadalajara,92,Cogolludo,697,402,295
19,Guadalajara,95,Condemios de Abajo,23,14,9
19,Guadalajara,96,Condemios de Arriba,170,89,81
19,Guadalajara,97,Congostrina,50,31,19
19,Guadalajara,98,Copernal,32,22,10
19,Guadalajara,99,Corduente,417,232,185
19,Guadalajara,102,Cubillo de Uceda (El),179,92,87
19,Guadalajara,107,Driebes,455,235,220
19,Guadalajara,108,Durón,135,68,67
19,Guadalajara,109,Embid,55,31,24
19,Guadalajara,110,Escamilla,102,50,52
19,Guadalajara,111,Escariche,208,113,95
19,Guadalajara,112,Escopete,92,50,42
19,Guadalajara,113,Espinosa de Henares,782,410,372
19,Guadalajara,114,Esplegares,51,32,19
19,Guadalajara,115,Establés,47,26,21
19,Guadalajara,116,Estriégana,25,14,11
19,Guadalajara,117,Fontanar,1763,943,820
19,Guadalajara,118,Fuembellida,16,10,6
19,Guadalajara,119,Fuencemillán,114,66,48
19,Guadalajara,120,Fuentelahiguera de Albatages,146,83,63
19,Guadalajara,121,Fuentelencina,363,197,166
19,Guadalajara,122,Fuentelsaz,107,52,55
19,Guadalajara,123,Fuentelviejo,59,35,24
19,Guadalajara,124,Fuentenovilla,588,321,267
19,Guadalajara,125,Gajanejos,68,40,28
19,Guadalajara,126,Galápagos,1924,1018,906
19,Guadalajara,127,Galve de Sorbe,143,70,73
19,Guadalajara,129,Gascueña de Bornova,66,42,24
19,Guadalajara,130,Guadalajara,81221,39966,41255
19,Guadalajara,132,Henche,108,51,57
19,Guadalajara,133,Heras de Ayuso,214,119,95
19,Guadalajara,134,Herrería,23,14,9
19,Guadalajara,135,Hiendelaencina,130,66,64
19,Guadalajara,136,Hijes,27,14,13
19,Guadalajara,138,Hita,419,225,194
19,Guadalajara,139,Hombrados,33,21,12
19,Guadalajara,142,Hontoba,336,171,165
19,Guadalajara,143,Horche,2267,1214,1053
19,Guadalajara,145,Hortezuela de Océn,72,37,35
19,Guadalajara,146,Huerce (La),56,37,19
19,Guadalajara,147,Huérmeces del Cerro,48,30,18
19,Guadalajara,148,Huertahernando,64,40,24
19,Guadalajara,150,Hueva,136,71,65
19,Guadalajara,151,Humanes,1443,730,713
19,Guadalajara,152,Illana,875,486,389
19,Guadalajara,153,Iniéstola,17,13,4
19,Guadalajara,154,Inviernas (Las),91,55,36
19,Guadalajara,155,Irueste,64,41,23
19,Guadalajara,156,Jadraque,1555,823,732
19,Guadalajara,157,Jirueque,76,50,26
19,Guadalajara,159,Ledanca,99,53,46
19,Guadalajara,160,Loranca de Tajuña,1368,763,605
19,Guadalajara,161,Lupiana,242,126,116
19,Guadalajara,162,Luzaga,91,46,45
19,Guadalajara,163,Luzón,74,38,36
19,Guadalajara,165,Majaelrayo,71,43,28
19,Guadalajara,166,Málaga del Fresno,212,126,86
19,Guadalajara,167,Malaguilla,127,71,56
19,Guadalajara,168,Mandayona,408,202,206
19,Guadalajara,169,Mantiel,85,48,37
19,Guadalajara,170,Maranchón,245,141,104
19,Guadalajara,171,Marchamalo,5072,2636,2436
19,Guadalajara,172,Masegoso de Tajuña,82,43,39
19,Guadalajara,173,Matarrubia,58,38,20
19,Guadalajara,174,Matillas,185,89,96
19,Guadalajara,175,Mazarete,53,25,28
19,Guadalajara,176,Mazuecos,391,206,185
19,Guadalajara,177,Medranda,112,60,52
19,Guadalajara,178,Megina,59,31,28
19,Guadalajara,179,Membrillera,120,59,61
19,Guadalajara,181,Miedes de Atienza,86,48,38
19,Guadalajara,182,Mierla (La),25,19,6
19,Guadalajara,184,Millana,172,88,84
19,Guadalajara,183,Milmarcos,116,64,52
19,Guadalajara,185,Miñosa (La),58,30,28
19,Guadalajara,186,Mirabueno,96,61,35
19,Guadalajara,187,Miralrío,89,48,41
19,Guadalajara,188,Mochales,66,33,33
19,Guadalajara,189,Mohernando,196,99,97
19,Guadalajara,190,Molina de Aragón,3667,1866,1801
19,Guadalajara,191,Monasterio,21,9,12
19,Guadalajara,192,Mondéjar,2637,1370,1267
19,Guadalajara,193,Montarrón,40,24,16
19,Guadalajara,194,Moratilla de los Meleros,121,68,53
19,Guadalajara,195,Morenilla,47,28,19
19,Guadalajara,196,Muduex,118,61,57
19,Guadalajara,197,Navas de Jadraque (Las),36,19,17
19,Guadalajara,198,Negredo,21,11,10
19,Guadalajara,199,Ocentejo,27,16,11
19,Guadalajara,200,Olivar (El),144,87,57
19,Guadalajara,201,Olmeda de Cobeta,87,42,45
19,Guadalajara,202,Olmeda de Jadraque (La),23,10,13
19,Guadalajara,203,Ordial (El),46,23,23
19,Guadalajara,204,Orea,243,147,96
19,Guadalajara,208,Pálmaces de Jadraque,70,38,32
19,Guadalajara,209,Pardos,60,31,29
19,Guadalajara,210,Paredes de Sigüenza,36,19,17
19,Guadalajara,211,Pareja,617,339,278
19,Guadalajara,212,Pastrana,1189,600,589
19,Guadalajara,213,Pedregal (El),93,55,38
19,Guadalajara,214,Peñalén,109,61,48
19,Guadalajara,215,Peñalver,226,130,96
19,Guadalajara,216,Peralejos de las Truchas,187,104,83
19,Guadalajara,217,Peralveche,102,62,40
19,Guadalajara,218,Pinilla de Jadraque,63,33,30
19,Guadalajara,219,Pinilla de Molina,22,14,8
19,Guadalajara,220,Pioz,2191,1200,991
19,Guadalajara,221,Piqueras,53,34,19
19,Guadalajara,222,Pobo de Dueñas (El),158,88,70
19,Guadalajara,223,Poveda de la Sierra,153,89,64
19,Guadalajara,224,Pozo de Almoguera,129,70,59
19,Guadalajara,225,Pozo de Guadalajara,1192,630,562
19,Guadalajara,226,Prádena de Atienza,43,28,15
19,Guadalajara,227,Prados Redondos,111,64,47
19,Guadalajara,228,Puebla de Beleña,66,41,25
19,Guadalajara,229,Puebla de Valles,97,55,42
19,Guadalajara,230,Quer,621,343,278
19,Guadalajara,231,Rebollosa de Jadraque,31,20,11
19,Guadalajara,232,Recuenco (El),80,39,41
19,Guadalajara,233,Renera,115,63,52
19,Guadalajara,234,Retiendas,53,27,26
19,Guadalajara,235,Riba de Saelices,138,76,62
19,Guadalajara,237,Rillo de Gallo,65,41,24
19,Guadalajara,238,Riofrío del Llano,45,26,19
19,Guadalajara,239,Robledillo de Mohernando,139,74,65
19,Guadalajara,240,Robledo de Corpes,73,39,34
19,Guadalajara,241,Romanillos de Atienza,53,33,20
19,Guadalajara,242,Romanones,130,70,60
19,Guadalajara,243,Rueda de la Sierra,50,30,20
19,Guadalajara,244,Sacecorbo,143,90,53
19,Guadalajara,245,Sacedón,1844,973,871
19,Guadalajara,246,Saelices de la Sal,52,29,23
19,Guadalajara,247,Salmerón,193,102,91
19,Guadalajara,248,San Andrés del Congosto,89,56,33
19,Guadalajara,249,San Andrés del Rey,41,17,24
19,Guadalajara,250,Santiuste,27,14,13
19,Guadalajara,251,Saúca,59,27,32
19,Guadalajara,252,Sayatón,120,68,52
19,Guadalajara,254,Selas,65,35,30
19,Guadalajara,901,Semillas,49,30,19
19,Guadalajara,255,Setiles,122,71,51
19,Guadalajara,256,Sienes,83,51,32
19,Guadalajara,257,Sigüenza,5013,2586,2427
19,Guadalajara,258,Solanillos del Extremo,121,66,55
19,Guadalajara,259,Somolinos,45,18,27
19,Guadalajara,260,Sotillo (El),46,28,18
19,Guadalajara,261,Sotodosos,53,22,31
19,Guadalajara,262,Tamajón,196,103,93
19,Guadalajara,263,Taragudo,38,20,18
19,Guadalajara,264,Taravilla,59,32,27
19,Guadalajara,265,Tartanedo,152,86,66
19,Guadalajara,266,Tendilla,398,205,193
19,Guadalajara,267,Terzaga,27,16,11
19,Guadalajara,268,Tierzo,41,25,16
19,Guadalajara,269,Toba (La),118,63,55
19,Guadalajara,271,Tordellego,64,33,31
19,Guadalajara,270,Tordelrábano,10,4,6
19,Guadalajara,272,Tordesilos,113,60,53
19,Guadalajara,274,Torija,1097,612,485
19,Guadalajara,279,Torre del Burgo,183,95,88
19,Guadalajara,277,Torrecuadrada de Molina,18,12,6
19,Guadalajara,278,Torrecuadradilla,46,26,20
19,Guadalajara,280,Torrejón del Rey,4634,2480,2154
19,Guadalajara,281,Torremocha de Jadraque,25,16,9
19,Guadalajara,282,Torremocha del Campo,244,132,112
19,Guadalajara,283,Torremocha del Pinar,64,26,38
19,Guadalajara,284,Torremochuela,15,9,6
19,Guadalajara,285,Torrubia,30,17,13
19,Guadalajara,286,Tórtola de Henares,729,396,333
19,Guadalajara,287,Tortuera,217,111,106
19,Guadalajara,288,Tortuero,24,15,9
19,Guadalajara,289,Traíd,45,22,23
19,Guadalajara,290,Trijueque,1469,786,683
19,Guadalajara,291,Trillo,1388,691,697
19,Guadalajara,293,Uceda,2192,1139,1053
19,Guadalajara,294,Ujados,33,18,15
19,Guadalajara,296,Utande,52,36,16
19,Guadalajara,297,Valdarachas,32,15,17
19,Guadalajara,298,Valdearenas,92,56,36
19,Guadalajara,299,Valdeavellano,101,60,41
19,Guadalajara,300,Valdeaveruelo,961,510,451
19,Guadalajara,301,Valdeconcha,48,30,18
19,Guadalajara,302,Valdegrudas,63,40,23
19,Guadalajara,303,Valdelcubo,68,41,27
19,Guadalajara,304,Valdenuño Fernández,276,157,119
19,Guadalajara,305,Valdepeñas de la Sierra,201,111,90
19,Guadalajara,306,Valderrebollo,45,22,23
19,Guadalajara,307,Valdesotos,28,15,13
19,Guadalajara,308,Valfermoso de Tajuña,74,41,33
19,Guadalajara,309,Valhermoso,37,22,15
19,Guadalajara,310,Valtablado del Río,14,9,5
19,Guadalajara,311,Valverde de los Arroyos,103,59,44
19,Guadalajara,314,Viana de Jadraque,36,24,12
19,Guadalajara,317,Villanueva de Alcorón,215,116,99
19,Guadalajara,318,Villanueva de Argecilla,41,25,16
19,Guadalajara,319,Villanueva de la Torre,5945,3037,2908
19,Guadalajara,321,Villares de Jadraque,76,46,30
19,Guadalajara,322,Villaseca de Henares,74,43,31
19,Guadalajara,323,Villaseca de Uceda,63,38,25
19,Guadalajara,324,Villel de Mesa,189,103,86
19,Guadalajara,325,Viñuelas,109,64,45
19,Guadalajara,326,Yebes,525,312,213
19,Guadalajara,327,Yebra,585,300,285
19,Guadalajara,329,Yélamos de Abajo,72,35,37
19,Guadalajara,330,Yélamos de Arriba,123,71,52
19,Guadalajara,331,Yunquera de Henares,3279,1670,1609
19,Guadalajara,332,Yunta (La),132,71,61
19,Guadalajara,333,Zaorejas,184,110,74
19,Guadalajara,334,Zarzuela de Jadraque,49,27,22
19,Guadalajara,335,Zorita de los Canes,91,49,42
20,Guipúzcoa,1,Abaltzisketa,317,176,141
20,Guipúzcoa,2,Aduna,376,208,168
20,Guipúzcoa,16,Aia,1854,1005,849
20,Guipúzcoa,3,Aizarnazabal,653,355,298
20,Guipúzcoa,4,Albiztur,314,160,154
20,Guipúzcoa,5,Alegia,1710,869,841
20,Guipúzcoa,6,Alkiza,347,193,154
20,Guipúzcoa,906,Altzaga,157,82,75
20,Guipúzcoa,7,Altzo,400,214,186
20,Guipúzcoa,8,Amezketa,983,523,460
20,Guipúzcoa,9,Andoain,14427,7245,7182
20,Guipúzcoa,10,Anoeta,1811,942,869
20,Guipúzcoa,11,Antzuola,2145,1095,1050
20,Guipúzcoa,12,Arama,188,98,90
20,Guipúzcoa,13,Aretxabaleta,6646,3406,3240
20,Guipúzcoa,55,Arrasate/Mondragón,21974,10911,11063
20,Guipúzcoa,14,Asteasu,1488,791,697
20,Guipúzcoa,903,Astigarraga,4522,2329,2193
20,Guipúzcoa,15,Ataun,1654,872,782
20,Guipúzcoa,17,Azkoitia,11091,5576,5515
20,Guipúzcoa,18,Azpeitia,14157,7133,7024
20,Guipúzcoa,904,Baliarrain,100,55,45
20,Guipúzcoa,19,Beasain,13510,6908,6602
20,Guipúzcoa,20,Beizama,180,107,73
20,Guipúzcoa,21,Belauntza,319,181,138
20,Guipúzcoa,22,Berastegi,1031,548,483
20,Guipúzcoa,74,Bergara,14746,7352,7394
20,Guipúzcoa,23,Berrobi,589,317,272
20,Guipúzcoa,24,Bidegoian,492,275,217
20,Guipúzcoa,29,Deba,5404,2726,2678
20,Guipúzcoa,69,Donostia-San Sebastián,184248,86443,97805
20,Guipúzcoa,30,Eibar,27496,13372,14124
20,Guipúzcoa,31,Elduain,236,120,116
20,Guipúzcoa,33,Elgeta,1050,546,504
20,Guipúzcoa,32,Elgoibar,11051,5525,5526
20,Guipúzcoa,67,Errenteria,38505,18872,19633
20,Guipúzcoa,66,Errezil,624,334,290
20,Guipúzcoa,34,Eskoriatza,4071,2108,1963
20,Guipúzcoa,35,Ezkio-Itsaso,578,301,277
20,Guipúzcoa,38,Gabiria,448,249,199
20,Guipúzcoa,37,Gaintza,132,78,54
20,Guipúzcoa,907,Gaztelu,166,98,68
20,Guipúzcoa,39,Getaria,2585,1302,1283
20,Guipúzcoa,40,Hernani,19229,9480,9749
20,Guipúzcoa,41,Hernialde,343,182,161
20,Guipúzcoa,36,Hondarribia,16315,8212,8103
20,Guipúzcoa,42,Ibarra,4298,2237,2061
20,Guipúzcoa,43,Idiazabal,2212,1141,1071
20,Guipúzcoa,44,Ikaztegieta,459,244,215
20,Guipúzcoa,45,Irun,60914,29936,30978
20,Guipúzcoa,46,Irura,1418,751,667
20,Guipúzcoa,47,Itsasondo,631,316,315
20,Guipúzcoa,48,Larraul,239,127,112
20,Guipúzcoa,902,Lasarte-Oria,17694,8771,8923
20,Guipúzcoa,49,Lazkao,5285,2734,2551
20,Guipúzcoa,50,Leaburu,388,206,182
20,Guipúzcoa,51,Legazpi,8709,4483,4226
20,Guipúzcoa,52,Legorreta,1448,748,700
20,Guipúzcoa,68,Leintz-Gatzaga,263,149,114
20,Guipúzcoa,53,Lezo,6022,2990,3032
20,Guipúzcoa,54,Lizartza,628,337,291
20,Guipúzcoa,901,Mendaro,1839,961,878
20,Guipúzcoa,57,Mutiloa,235,127,108
20,Guipúzcoa,56,Mutriku,4973,2504,2469
20,Guipúzcoa,63,Oiartzun,9846,4942,4904
20,Guipúzcoa,58,Olaberria,967,492,475
20,Guipúzcoa,59,Oñati,10816,5377,5439
20,Guipúzcoa,76,Ordizia,9758,4923,4835
20,Guipúzcoa,905,Orendain,180,90,90
20,Guipúzcoa,60,Orexa,121,68,53
20,Guipúzcoa,61,Orio,4969,2489,2480
20,Guipúzcoa,62,Ormaiztegi,1308,686,622
20,Guipúzcoa,64,Pasaia,15996,7733,8263
20,Guipúzcoa,70,Segura,1377,680,697
20,Guipúzcoa,65,Soraluze/Placencia de las Armas,4029,2025,2004
20,Guipúzcoa,71,Tolosa,17894,8628,9266
20,Guipúzcoa,72,Urnieta,6065,3084,2981
20,Guipúzcoa,77,Urretxu,6812,3440,3372
20,Guipúzcoa,73,Usurbil,5793,2986,2807
20,Guipúzcoa,75,Villabona,5760,2928,2832
20,Guipúzcoa,78,Zaldibia,1504,800,704
20,Guipúzcoa,79,Zarautz,22474,11049,11425
20,Guipúzcoa,25,Zegama,1454,780,674
20,Guipúzcoa,26,Zerain,244,121,123
20,Guipúzcoa,27,Zestoa,3426,1769,1657
20,Guipúzcoa,28,Zizurkil,2794,1421,1373
20,Guipúzcoa,81,Zumaia,9099,4526,4573
20,Guipúzcoa,80,Zumarraga,10053,5006,5047
21,Huelva,1,Alájar,802,407,395
21,Huelva,2,Aljaraque,17194,8590,8604
21,Huelva,3,Almendro (El),860,445,415
21,Huelva,4,Almonaster la Real,1849,917,932
21,Huelva,5,Almonte,21452,10777,10675
21,Huelva,6,Alosno,4424,2120,2304
21,Huelva,7,Aracena,7468,3684,3784
21,Huelva,8,Aroche,3214,1587,1627
21,Huelva,9,Arroyomolinos de León,1056,536,520
21,Huelva,10,Ayamonte,19738,9933,9805
21,Huelva,11,Beas,4320,2149,2171
21,Huelva,12,Berrocal,376,179,197
21,Huelva,13,Bollullos Par del Condado,13906,6928,6978
21,Huelva,14,Bonares,5762,2895,2867
21,Huelva,15,Cabezas Rubias,851,449,402
21,Huelva,16,Cala,1310,662,648
21,Huelva,17,Calañas,4337,2149,2188
21,Huelva,18,Campillo (El),2258,1082,1176
21,Huelva,19,Campofrío,818,416,402
21,Huelva,20,Cañaveral de León,439,218,221
21,Huelva,21,Cartaya,17424,8922,8502
21,Huelva,22,Castaño del Robledo,222,119,103
21,Huelva,23,Cerro de Andévalo (El),2503,1214,1289
21,Huelva,30,Chucena,2097,1057,1040
21,Huelva,24,Corteconcepción,615,316,299
21,Huelva,25,Cortegana,5026,2508,2518
21,Huelva,26,Cortelazor,311,157,154
21,Huelva,27,Cumbres de Enmedio,58,34,24
21,Huelva,28,Cumbres de San Bartolomé,465,225,240
21,Huelva,29,Cumbres Mayores,1993,992,1001
21,Huelva,31,Encinasola,1584,807,777
21,Huelva,32,Escacena del Campo,2145,1059,1086
21,Huelva,33,Fuenteheridos,660,335,325
21,Huelva,34,Galaroza,1617,796,821
21,Huelva,35,Gibraleón,12120,6073,6047
21,Huelva,36,Granada de Río-Tinto (La),207,105,102
21,Huelva,37,Granado (El),598,320,278
21,Huelva,38,Higuera de la Sierra,1425,725,700
21,Huelva,39,Hinojales,338,175,163
21,Huelva,40,Hinojos,3807,1913,1894
21,Huelva,41,Huelva,148027,71789,76238
21,Huelva,42,Isla Cristina,20982,10535,10447
21,Huelva,43,Jabugo,2403,1198,1205
21,Huelva,44,Lepe,25041,12817,12224
21,Huelva,45,Linares de la Sierra,305,155,150
21,Huelva,46,Lucena del Puerto,2862,1443,1419
21,Huelva,47,Manzanilla,2361,1192,1169
21,Huelva,48,Marines (Los),349,173,176
21,Huelva,49,Minas de Riotinto,4263,2067,2196
21,Huelva,50,Moguer,19032,9569,9463
21,Huelva,51,Nava (La),330,173,157
21,Huelva,52,Nerva,5994,2891,3103
21,Huelva,53,Niebla,4102,2073,2029
21,Huelva,54,Palma del Condado (La),10340,5132,5208
21,Huelva,55,Palos de la Frontera,8964,4499,4465
21,Huelva,56,Paterna del Campo,3764,1936,1828
21,Huelva,57,Paymogo,1306,649,657
21,Huelva,58,Puebla de Guzmán,3199,1642,1557
21,Huelva,59,Puerto Moral,273,144,129
21,Huelva,60,Punta Umbría,14515,7373,7142
21,Huelva,61,Rociana del Condado,7341,3765,3576
21,Huelva,62,Rosal de la Frontera,1846,912,934
21,Huelva,63,San Bartolomé de la Torre,3446,1751,1695
21,Huelva,64,San Juan del Puerto,7798,3943,3855
21,Huelva,66,San Silvestre de Guzmán,754,396,358
21,Huelva,65,Sanlúcar de Guadiana,370,189,181
21,Huelva,67,Santa Ana la Real,519,245,274
21,Huelva,68,Santa Bárbara de Casa,1188,588,600
21,Huelva,69,Santa Olalla del Cala,2164,1090,1074
21,Huelva,70,Trigueros,7477,3727,3750
21,Huelva,71,Valdelarco,240,114,126
21,Huelva,72,Valverde del Camino,12665,6179,6486
21,Huelva,73,Villablanca,2732,1433,1299
21,Huelva,74,Villalba del Alcor,3527,1754,1773
21,Huelva,75,Villanueva de las Cruces,421,196,225
21,Huelva,76,Villanueva de los Castillejos,2783,1375,1408
21,Huelva,77,Villarrasa,2149,1088,1061
21,Huelva,78,Zalamea la Real,3461,1721,1740
21,Huelva,79,Zufre,973,503,470
22,Huesca,1,Abiego,288,157,131
22,Huesca,2,Abizanda,130,64,66
22,Huesca,3,Adahuesca,163,81,82
22,Huesca,4,Agüero,161,90,71
22,Huesca,907,Aínsa-Sobrarbe,2095,1091,1004
22,Huesca,6,Aisa,402,228,174
22,Huesca,7,Albalate de Cinca,1179,614,565
22,Huesca,8,Albalatillo,248,127,121
22,Huesca,9,Albelda,870,461,409
22,Huesca,11,Albero Alto,117,67,50
22,Huesca,12,Albero Bajo,112,60,52
22,Huesca,13,Alberuela de Tubo,358,186,172
22,Huesca,14,Alcalá de Gurrea,285,143,142
22,Huesca,15,Alcalá del Obispo,425,245,180
22,Huesca,16,Alcampell,796,403,393
22,Huesca,17,Alcolea de Cinca,1204,627,577
22,Huesca,18,Alcubierre,446,237,209
22,Huesca,19,Alerre,224,115,109
22,Huesca,20,Alfántega,125,65,60
22,Huesca,21,Almudévar,2449,1272,1177
22,Huesca,22,Almunia de San Juan,667,343,324
22,Huesca,23,Almuniente,562,281,281
22,Huesca,24,Alquézar,321,168,153
22,Huesca,25,Altorricón,1491,811,680
22,Huesca,27,Angüés,423,221,202
22,Huesca,28,Ansó,496,246,250
22,Huesca,29,Antillón,165,81,84
22,Huesca,32,Aragüés del Puerto,128,68,60
22,Huesca,35,Arén,322,165,157
22,Huesca,36,Argavieso,132,73,59
22,Huesca,37,Arguis,105,59,46
22,Huesca,39,Ayerbe,1126,572,554
22,Huesca,40,Azanuy-Alins,187,94,93
22,Huesca,41,Azara,200,103,97
22,Huesca,42,Azlor,143,72,71
22,Huesca,43,Baélls,124,77,47
22,Huesca,44,Bailo,219,133,86
22,Huesca,45,Baldellou,116,64,52
22,Huesca,46,Ballobar,990,495,495
22,Huesca,47,Banastás,264,140,124
22,Huesca,48,Barbastro,16486,8090,8396
22,Huesca,49,Barbués,106,55,51
22,Huesca,50,Barbuñales,111,54,57
22,Huesca,51,Bárcabo,124,74,50
22,Huesca,52,Belver de Cinca,1380,739,641
22,Huesca,53,Benabarre,1197,632,565
22,Huesca,54,Benasque,2166,1148,1018
22,Huesca,55,Berbegal,468,233,235
22,Huesca,57,Bielsa,528,264,264
22,Huesca,58,Bierge,253,141,112
22,Huesca,59,Biescas,1712,950,762
22,Huesca,60,Binaced,1534,805,729
22,Huesca,61,Binéfar,9288,4856,4432
22,Huesca,62,Bisaurri,234,122,112
22,Huesca,63,Biscarrués,231,119,112
22,Huesca,64,Blecua y Torres,186,103,83
22,Huesca,66,Boltaña,1022,565,457
22,Huesca,67,Bonansa,93,51,42
22,Huesca,68,Borau,73,41,32
22,Huesca,69,Broto,550,289,261
22,Huesca,72,Caldearenas,230,129,101
22,Huesca,74,Campo,252,118,134
22,Huesca,75,Camporrélls,206,115,91
22,Huesca,76,Canal de Berdún,412,221,191
22,Huesca,77,Candasnos,427,221,206
22,Huesca,78,Canfranc,648,363,285
22,Huesca,79,Capdesaso,157,71,86
22,Huesca,80,Capella,389,201,188
22,Huesca,81,Casbas de Huesca,307,158,149
22,Huesca,83,Castejón de Monegros,667,348,319
22,Huesca,84,Castejón de Sos,771,411,360
22,Huesca,82,Castejón del Puente,452,241,211
22,Huesca,85,Castelflorite,129,69,60
22,Huesca,86,Castiello de Jaca,257,141,116
22,Huesca,87,Castigaleu,123,65,58
22,Huesca,88,Castillazuelo,221,108,113
22,Huesca,89,Castillonroy,391,186,205
22,Huesca,94,Chalamera,138,73,65
22,Huesca,95,Chía,113,61,52
22,Huesca,96,Chimillas,356,173,183
22,Huesca,90,Colungo,156,84,72
22,Huesca,99,Esplús,719,376,343
22,Huesca,102,Estada,231,132,99
22,Huesca,103,Estadilla,876,430,446
22,Huesca,105,Estopiñán del Castillo,196,111,85
22,Huesca,106,Fago,31,17,14
22,Huesca,107,Fanlo,159,94,65
22,Huesca,109,Fiscal,301,168,133
22,Huesca,110,Fonz,1031,522,509
22,Huesca,111,Foradada del Toscar,238,126,112
22,Huesca,112,Fraga,14034,7288,6746
22,Huesca,113,Fueva (La),633,329,304
22,Huesca,114,Gistaín,157,85,72
22,Huesca,115,Grado (El),509,269,240
22,Huesca,116,Grañén,2041,1044,997
22,Huesca,117,Graus,3605,1869,1736
22,Huesca,119,Gurrea de Gállego,1710,892,818
22,Huesca,122,Hoz de Jaca,72,36,36
22,Huesca,908,Hoz y Costean,222,121,101
22,Huesca,124,Huerto,274,150,124
22,Huesca,125,Huesca,51117,24899,26218
22,Huesca,126,Ibieca,114,64,50
22,Huesca,127,Igriés,530,274,256
22,Huesca,128,Ilche,271,144,127
22,Huesca,129,Isábena,320,170,150
22,Huesca,130,Jaca,13193,6595,6598
22,Huesca,131,Jasa,122,68,54
22,Huesca,133,Labuerda,180,95,85
22,Huesca,135,Laluenga,233,131,102
22,Huesca,136,Lalueza,1137,598,539
22,Huesca,137,Lanaja,1478,765,713
22,Huesca,139,Laperdiguera,98,53,45
22,Huesca,141,Lascellas-Ponzano,154,87,67
22,Huesca,142,Lascuarre,159,86,73
22,Huesca,143,Laspaúles,309,181,128
22,Huesca,144,Laspuña,302,166,136
22,Huesca,149,Loarre,369,203,166
22,Huesca,150,Loporzano,541,295,246
22,Huesca,151,Loscorrales,108,58,50
22,Huesca,905,Lupiñén-Ortilla,368,193,175
22,Huesca,155,Monesma y Cajigar,111,58,53
22,Huesca,156,Monflorite-Lascasas,281,157,124
22,Huesca,157,Montanuy,307,177,130
22,Huesca,158,Monzón,16749,8596,8153
22,Huesca,160,Naval,270,131,139
22,Huesca,162,Novales,174,88,86
22,Huesca,163,Nueno,524,298,226
22,Huesca,164,Olvena,70,30,40
22,Huesca,165,Ontiñena,617,314,303
22,Huesca,167,Osso de Cinca,774,397,377
22,Huesca,168,Palo,32,22,10
22,Huesca,170,Panticosa,837,425,412
22,Huesca,172,Peñalba,749,385,364
22,Huesca,173,Peñas de Riglos (Las),279,166,113
22,Huesca,174,Peralta de Alcofea,647,327,320
22,Huesca,175,Peralta de Calasanz,248,145,103
22,Huesca,176,Peraltilla,200,104,96
22,Huesca,177,Perarrúa,99,48,51
22,Huesca,178,Pertusa,122,70,52
22,Huesca,181,Piracés,97,62,35
22,Huesca,182,Plan,329,173,156
22,Huesca,184,Poleñino,227,122,105
22,Huesca,186,Pozán de Vero,252,118,134
22,Huesca,187,Puebla de Castro (La),410,211,199
22,Huesca,188,Puente de Montañana,151,71,80
22,Huesca,902,Puente la Reina de Jaca,222,121,101
22,Huesca,189,Puértolas,252,137,115
22,Huesca,190,Pueyo de Araguás (El),155,92,63
22,Huesca,193,Pueyo de Santa Cruz,366,183,183
22,Huesca,195,Quicena,306,158,148
22,Huesca,197,Robres,643,333,310
22,Huesca,199,Sabiñánigo,10112,5153,4959
22,Huesca,200,Sahún,372,194,178
22,Huesca,201,Salas Altas,320,166,154
22,Huesca,202,Salas Bajas,138,63,75
22,Huesca,203,Salillas,119,64,55
22,Huesca,204,Sallent de Gállego,1376,687,689
22,Huesca,205,San Esteban de Litera,550,286,264
22,Huesca,207,San Juan de Plan,153,84,69
22,Huesca,903,San Miguel del Cinca,865,441,424
22,Huesca,206,Sangarrén,272,136,136
22,Huesca,208,Santa Cilia,201,114,87
22,Huesca,209,Santa Cruz de la Serós,143,87,56
22,Huesca,906,Santa María de Dulcis,225,117,108
22,Huesca,212,Santaliestra y San Quílez,101,52,49
22,Huesca,213,Sariñena,4308,2233,2075
22,Huesca,214,Secastilla,135,62,73
22,Huesca,215,Seira,174,89,85
22,Huesca,217,Sena,559,309,250
22,Huesca,218,Senés de Alcubierre,61,33,28
22,Huesca,220,Sesa,241,133,108
22,Huesca,221,Sesué,119,71,48
22,Huesca,222,Siétamo,625,335,290
22,Huesca,223,Sopeira,108,56,52
22,Huesca,904,Sotonera (La),1058,567,491
22,Huesca,225,Tamarite de Litera,3715,1899,1816
22,Huesca,226,Tardienta,1043,536,507
22,Huesca,227,Tella-Sin,307,169,138
22,Huesca,228,Tierz,629,319,310
22,Huesca,229,Tolva,191,106,85
22,Huesca,230,Torla,323,167,156
22,Huesca,232,Torralba de Aragón,116,61,55
22,Huesca,233,Torre la Ribera,121,69,52
22,Huesca,234,Torrente de Cinca,1017,512,505
22,Huesca,235,Torres de Alcanadre,112,60,52
22,Huesca,236,Torres de Barbués,320,159,161
22,Huesca,239,Tramaced,106,62,44
22,Huesca,242,Valfarta,92,51,41
22,Huesca,243,Valle de Bardají,53,29,24
22,Huesca,901,Valle de Hecho,949,498,451
22,Huesca,244,Valle de Lierp,44,23,21
22,Huesca,245,Velilla de Cinca,475,249,226
22,Huesca,909,Vencillón,465,242,223
22,Huesca,246,Veracruz,109,60,49
22,Huesca,247,Viacamp y Litera,27,17,10
22,Huesca,248,Vicién,124,67,57
22,Huesca,249,Villanova,157,77,80
22,Huesca,250,Villanúa,479,279,200
22,Huesca,251,Villanueva de Sigena,525,258,267
22,Huesca,252,Yebra de Basa,154,90,64
22,Huesca,253,Yésero,77,47,30
22,Huesca,254,Zaidín,1762,911,851
23,Jaén,1,Albanchez de Mágina,1264,650,614
23,Jaén,2,Alcalá la Real,22524,11217,11307
23,Jaén,3,Alcaudete,11015,5458,5557
23,Jaén,4,Aldeaquemada,552,287,265
23,Jaén,5,Andújar,38979,19267,19712
23,Jaén,6,Arjona,5826,2921,2905
23,Jaén,7,Arjonilla,3876,1928,1948
23,Jaén,8,Arquillos,1937,969,968
23,Jaén,905,Arroyo del Ojanco,2490,1281,1209
23,Jaén,9,Baeza,16197,8068,8129
23,Jaén,10,Bailén,18798,9641,9157
23,Jaén,11,Baños de la Encina,2713,1408,1305
23,Jaén,12,Beas de Segura,5586,2876,2710
23,Jaén,902,Bedmar y Garcíez,3137,1587,1550
23,Jaén,14,Begíjar,3148,1583,1565
23,Jaén,15,Bélmez de la Moraleda,1868,961,907
23,Jaén,16,Benatae,563,317,246
23,Jaén,17,Cabra del Santo Cristo,2110,1098,1012
23,Jaén,18,Cambil,2967,1547,1420
23,Jaén,19,Campillo de Arenas,1977,1035,942
23,Jaén,20,Canena,2096,1041,1055
23,Jaén,21,Carboneros,670,350,320
23,Jaén,901,Cárcheles,1491,767,724
23,Jaén,24,Carolina (La),15649,7718,7931
23,Jaén,25,Castellar,3614,1852,1762
23,Jaén,26,Castillo de Locubín,4832,2410,2422
23,Jaén,27,Cazalilla,840,431,409
23,Jaén,28,Cazorla,8170,3989,4181
23,Jaén,29,Chiclana de Segura,1194,619,575
23,Jaén,30,Chilluévar,1604,791,813
23,Jaén,31,Escañuela,958,475,483
23,Jaén,32,Espelúy,759,382,377
23,Jaén,33,Frailes,1817,926,891
23,Jaén,34,Fuensanta de Martos,3300,1657,1643
23,Jaén,35,Fuerte del Rey,1315,671,644
23,Jaén,37,Génave,626,337,289
23,Jaén,38,Guardia de Jaén (La),3928,2069,1859
23,Jaén,39,Guarromán,2927,1488,1439
23,Jaén,41,Higuera de Calatrava,661,341,320
23,Jaén,42,Hinojares,425,208,217
23,Jaén,43,Hornos,679,340,339
23,Jaén,44,Huelma,6233,3154,3079
23,Jaén,45,Huesa,2693,1359,1334
23,Jaén,46,Ibros,3160,1595,1565
23,Jaén,47,Iruela (La),1985,1005,980
23,Jaén,48,Iznatoraf,1126,580,546
23,Jaén,49,Jabalquinto,2393,1216,1177
23,Jaén,50,Jaén,116417,56355,60062
23,Jaén,51,Jamilena,3523,1795,1728
23,Jaén,52,Jimena,1493,727,766
23,Jaén,53,Jódar,12119,6050,6069
23,Jaén,40,Lahiguera,1892,939,953
23,Jaén,54,Larva,475,245,230
23,Jaén,55,Linares,61340,30135,31205
23,Jaén,56,Lopera,4028,2011,2017
23,Jaén,57,Lupión,975,485,490
23,Jaén,58,Mancha Real,10754,5517,5237
23,Jaén,59,Marmolejo,7600,3834,3766
23,Jaén,60,Martos,24520,12050,12470
23,Jaén,61,Mengíbar,9378,4715,4663
23,Jaén,62,Montizón,1917,1003,914
23,Jaén,63,Navas de San Juan,5053,2546,2507
23,Jaén,64,Noalejo,2069,1037,1032
23,Jaén,65,Orcera,2138,1090,1048
23,Jaén,66,Peal de Becerro,5551,2820,2731
23,Jaén,67,Pegalajar,3145,1612,1533
23,Jaén,69,Porcuna,6939,3507,3432
23,Jaén,70,Pozo Alcón,5464,2848,2616
23,Jaén,71,Puente de Génave,2174,1075,1099
23,Jaén,72,Puerta de Segura (La),2631,1306,1325
23,Jaén,73,Quesada,5944,2955,2989
23,Jaén,74,Rus,3817,1943,1874
23,Jaén,75,Sabiote,4247,2164,2083
23,Jaén,76,Santa Elena,1003,529,474
23,Jaén,77,Santiago de Calatrava,867,447,420
23,Jaén,904,Santiago-Pontones,3884,1996,1888
23,Jaén,79,Santisteban del Puerto,4918,2541,2377
23,Jaén,80,Santo Tomé,2429,1263,1166
23,Jaén,81,Segura de la Sierra,1986,1050,936
23,Jaén,82,Siles,2465,1260,1205
23,Jaén,84,Sorihuela del Guadalimar,1270,667,603
23,Jaén,86,Torre del Campo,14565,7349,7216
23,Jaén,85,Torreblascopedro,2812,1426,1386
23,Jaén,87,Torredonjimeno,14138,7019,7119
23,Jaén,88,Torreperogil,7367,3662,3705
23,Jaén,90,Torres,1645,836,809
23,Jaén,91,Torres de Albánchez,972,493,479
23,Jaén,92,Úbeda,34462,16870,17592
23,Jaén,93,Valdepeñas de Jaén,4222,2110,2112
23,Jaén,94,Vilches,5008,2551,2457
23,Jaén,95,Villacarrillo,11293,5694,5599
23,Jaén,96,Villanueva de la Reina,3423,1745,1678
23,Jaén,97,Villanueva del Arzobispo,8673,4460,4213
23,Jaén,98,Villardompardo,1140,576,564
23,Jaén,99,Villares (Los),5661,2824,2837
23,Jaén,101,Villarrodrigo,496,254,242
23,Jaén,903,Villatorres,4464,2312,2152
24,León,1,Acebedo,269,162,107
24,León,2,Algadefe,328,171,157
24,León,3,Alija del Infantado,860,443,417
24,León,4,Almanza,640,355,285
24,León,5,Antigua (La),513,287,226
24,León,6,Ardón,643,345,298
24,León,7,Arganza,824,420,404
24,León,8,Astorga,12039,5743,6296
24,León,9,Balboa,407,221,186
24,León,10,Bañeza (La),11040,5340,5700
24,León,11,Barjas,292,153,139
24,León,12,Barrios de Luna (Los),317,161,156
24,León,14,Bembibre,10136,5041,5095
24,León,15,Benavides,2879,1445,1434
24,León,16,Benuza,672,360,312
24,León,17,Bercianos del Páramo,742,377,365
24,León,18,Bercianos del Real Camino,205,103,102
24,León,19,Berlanga del Bierzo,403,187,216
24,León,20,Boca de Huérgano,577,329,248
24,León,21,Boñar,2132,1063,1069
24,León,22,Borrenes,436,222,214
24,León,23,Brazuelo,347,184,163
24,León,24,Burgo Ranero (El),876,471,405
24,León,25,Burón,382,217,165
24,León,26,Bustillo del Páramo,1508,776,732
24,León,27,Cabañas Raras,1295,666,629
24,León,28,Cabreros del Río,497,272,225
24,León,29,Cabrillanes,974,483,491
24,León,30,Cacabelos,5477,2785,2692
24,León,31,Calzada del Coto,265,148,117
24,León,32,Campazas,153,77,76
24,León,33,Campo de Villavidel,254,133,121
24,León,34,Camponaraya,4222,2134,2088
24,León,36,Candín,341,178,163
24,León,37,Cármenes,417,231,186
24,León,38,Carracedelo,3657,1787,1870
24,León,39,Carrizo,2554,1293,1261
24,León,40,Carrocera,574,283,291
24,León,41,Carucedo,646,324,322
24,León,42,Castilfalé,92,49,43
24,León,43,Castrillo de Cabrera,174,89,85
24,León,44,Castrillo de la Valduerna,200,91,109
24,León,46,Castrocalbón,1144,597,547
24,León,47,Castrocontrigo,968,489,479
24,León,49,Castropodame,1834,935,899
24,León,50,Castrotierra de Valmadrigal,135,67,68
24,León,51,Cea,561,291,270
24,León,52,Cebanico,197,111,86
24,León,53,Cebrones del Río,593,309,284
24,León,65,Chozas de Abajo,2388,1242,1146
24,León,54,Cimanes de la Vega,582,300,282
24,León,55,Cimanes del Tejar,857,443,414
24,León,56,Cistierna,3778,1844,1934
24,León,57,Congosto,1747,856,891
24,León,58,Corbillos de los Oteros,264,140,124
24,León,59,Corullón,1103,560,543
24,León,60,Crémenes,705,359,346
24,León,61,Cuadros,1926,961,965
24,León,62,Cubillas de los Oteros,184,101,83
24,León,63,Cubillas de Rueda,529,275,254
24,León,64,Cubillos del Sil,1656,862,794
24,León,66,Destriana,637,305,332
24,León,67,Encinedo,881,457,424
24,León,68,Ercina (La),599,309,290
24,León,69,Escobar de Campos,64,39,25
24,León,70,Fabero,5295,2590,2705
24,León,71,Folgoso de la Ribera,1230,591,639
24,León,73,Fresno de la Vega,632,319,313
24,León,74,Fuentes de Carbajal,127,66,61
24,León,76,Garrafe de Torío,1234,655,579
24,León,77,Gordaliza del Pino,312,154,158
24,León,78,Gordoncillo,522,261,261
24,León,79,Gradefes,1117,571,546
24,León,80,Grajal de Campos,247,117,130
24,León,81,Gusendos de los Oteros,156,85,71
24,León,82,Hospital de Órbigo,1052,511,541
24,León,83,Igüeña,1489,779,710
24,León,84,Izagre,216,109,107
24,León,86,Joarilla de las Matas,386,209,177
24,León,87,Laguna Dalga,771,403,368
24,León,88,Laguna de Negrillos,1222,626,596
24,León,89,León,135119,62301,72818
24,León,92,Llamas de la Ribera,1027,517,510
24,León,90,Lucillo,451,236,215
24,León,91,Luyego,803,398,405
24,León,93,Magaz de Cepeda,427,208,219
24,León,94,Mansilla de las Mulas,1963,981,982
24,León,95,Mansilla Mayor,348,177,171
24,León,96,Maraña,149,84,65
24,León,97,Matadeón de los Oteros,287,154,133
24,León,98,Matallana de Torío,1440,724,716
24,León,99,Matanza,259,125,134
24,León,100,Molinaseca,825,429,396
24,León,101,Murias de Paredes,530,251,279
24,León,102,Noceda del Bierzo,809,397,412
24,León,103,Oencia,428,239,189
24,León,104,Omañas (Las),326,173,153
24,León,105,Onzonilla,1685,875,810
24,León,106,Oseja de Sajambre,289,164,125
24,León,107,Pajares de los Oteros,385,232,153
24,León,108,Palacios de la Valduerna,471,232,239
24,León,109,Palacios del Sil,1261,667,594
24,León,110,Páramo del Sil,1522,769,753
24,León,112,Peranzanes,310,187,123
24,León,113,Pobladura de Pelayo García,479,241,238
24,León,114,Pola de Gordón (La),4142,2095,2047
24,León,115,Ponferrada,67969,32917,35052
24,León,116,Posada de Valdeón,524,296,228
24,León,117,Pozuelo del Páramo,535,270,265
24,León,118,Prado de la Guzpeña,140,72,68
24,León,119,Priaranza del Bierzo,898,445,453
24,León,120,Prioro,422,226,196
24,León,121,Puebla de Lillo,709,384,325
24,León,122,Puente de Domingo Flórez,1790,928,862
24,León,123,Quintana del Castillo,954,500,454
24,León,124,Quintana del Marco,466,242,224
24,León,125,Quintana y Congosto,583,297,286
24,León,127,Regueras de Arriba,355,191,164
24,León,129,Reyero,126,64,62
24,León,130,Riaño,536,311,225
24,León,131,Riego de la Vega,977,492,485
24,León,132,Riello,761,405,356
24,León,133,Rioseco de Tapia,425,225,200
24,León,134,Robla (La),4712,2385,2327
24,León,136,Roperuelos del Páramo,679,351,328
24,León,137,Sabero,1487,723,764
24,León,139,Sahagún,2858,1420,1438
24,León,141,San Adrián del Valle,137,67,70
24,León,142,San Andrés del Rabanedo,30217,14681,15536
24,León,144,San Cristóbal de la Polantera,894,445,449
24,León,145,San Emiliano,711,375,336
24,León,146,San Esteban de Nogales,309,156,153
24,León,148,San Justo de la Vega,2072,1058,1014
24,León,149,San Millán de los Caballeros,199,99,100
24,León,150,San Pedro Bercianos,315,167,148
24,León,143,Sancedo,581,289,292
24,León,151,Santa Colomba de Curueño,595,301,294
24,León,152,Santa Colomba de Somoza,470,245,225
24,León,153,Santa Cristina de Valmadrigal,334,179,155
24,León,154,Santa Elena de Jamuz,1264,649,615
24,León,155,Santa María de la Isla,599,312,287
24,León,158,Santa María de Ordás,330,169,161
24,León,156,Santa María del Monte de Cea,298,155,143
24,León,157,Santa María del Páramo,3165,1572,1593
24,León,159,Santa Marina del Rey,2194,1091,1103
24,León,160,Santas Martas,925,472,453
24,León,161,Santiago Millas,352,184,168
24,León,162,Santovenia de la Valdoncina,1933,995,938
24,León,163,Sariegos,4066,2089,1977
24,León,164,Sena de Luna,402,189,213
24,León,165,Sobrado,452,232,220
24,León,166,Soto de la Vega,1836,941,895
24,León,167,Soto y Amío,989,468,521
24,León,168,Toral de los Guzmanes,644,345,299
24,León,169,Toreno,3806,1871,1935
24,León,170,Torre del Bierzo,2641,1321,1320
24,León,171,Trabadelo,479,259,220
24,León,172,Truchas,573,278,295
24,León,173,Turcia,1168,576,592
24,León,174,Urdiales del Páramo,567,297,270
24,León,185,Val de San Lorenzo,619,312,307
24,León,175,Valdefresno,2040,1055,985
24,León,176,Valdefuentes del Páramo,337,183,154
24,León,177,Valdelugueros,459,268,191
24,León,178,Valdemora,97,42,55
24,León,179,Valdepiélago,436,234,202
24,León,180,Valdepolo,1383,724,659
24,León,181,Valderas,2041,1026,1015
24,León,182,Valderrey,553,265,288
24,León,183,Valderrueda,1036,538,498
24,León,184,Valdesamario,218,120,98
24,León,187,Valdevimbre,1106,571,535
24,León,188,Valencia de Don Juan,4839,2376,2463
24,León,191,Vallecillo,128,71,57
24,León,189,Valverde de la Virgen,6178,3124,3054
24,León,190,Valverde-Enrique,202,108,94
24,León,193,Vecilla (La),437,223,214
24,León,196,Vega de Espinareda,2547,1293,1254
24,León,197,Vega de Infanzones,940,474,466
24,León,198,Vega de Valcarce,752,393,359
24,León,194,Vegacervera,342,181,161
24,León,199,Vegaquemada,468,238,230
24,León,201,Vegas del Condado,1290,692,598
24,León,202,Villablino,10860,5394,5466
24,León,203,Villabraz,139,74,65
24,León,205,Villadangos del Páramo,1128,573,555
24,León,206,Villadecanes,2190,1098,1092
24,León,207,Villademor de la Vega,402,215,187
24,León,209,Villafranca del Bierzo,3504,1717,1787
24,León,210,Villagatón,682,345,337
24,León,211,Villamandos,348,180,168
24,León,901,Villamanín,1111,571,540
24,León,212,Villamañán,1299,645,654
24,León,213,Villamartín de Don Sancho,166,92,74
24,León,214,Villamejil,840,420,420
24,León,215,Villamol,204,100,104
24,León,216,Villamontán de la Valduerna,941,480,461
24,León,217,Villamoratiel de las Matas,167,98,69
24,León,218,Villanueva de las Manzanas,555,276,279
24,León,219,Villaobispo de Otero,638,341,297
24,León,902,Villaornate y Castro,437,231,206
24,León,221,Villaquejida,1025,539,486
24,León,222,Villaquilambre,15996,8034,7962
24,León,223,Villarejo de Órbigo,3285,1596,1689
24,León,224,Villares de Órbigo,770,396,374
24,León,225,Villasabariego,1233,647,586
24,León,226,Villaselán,243,134,109
24,León,227,Villaturiel,1887,1000,887
24,León,228,Villazala,869,456,413
24,León,229,Villazanzo de Valderaduey,580,320,260
24,León,230,Zotes del Páramo,496,279,217
25,Lleida,1,Abella de la Conca,183,100,83
25,Lleida,2,Àger,557,302,255
25,Lleida,3,Agramunt,5577,2918,2659
25,Lleida,38,Aitona,2345,1211,1134
25,Lleida,4,Alamús (Els),724,373,351
25,Lleida,5,Alàs i Cerc,396,205,191
25,Lleida,6,Albagés (L'),476,252,224
25,Lleida,7,Albatàrrec,1749,941,808
25,Lleida,8,Albesa,1546,799,747
25,Lleida,9,Albi (L'),841,427,414
25,Lleida,10,Alcanó,244,119,125
25,Lleida,11,Alcarràs,7281,3780,3501
25,Lleida,12,Alcoletge,2547,1336,1211
25,Lleida,13,Alfarràs,3163,1627,1536
25,Lleida,14,Alfés,323,172,151
25,Lleida,15,Algerri,473,239,234
25,Lleida,16,Alguaire,3129,1632,1497
25,Lleida,17,Alins,265,136,129
25,Lleida,19,Almacelles,6295,3326,2969
25,Lleida,20,Almatret,415,221,194
25,Lleida,21,Almenar,3665,1915,1750
25,Lleida,22,Alòs de Balaguer,153,91,62
25,Lleida,23,Alpicat,5900,2929,2971
25,Lleida,24,Alt Àneu,439,252,187
25,Lleida,27,Anglesola,1332,675,657
25,Lleida,29,Arbeca,2472,1281,1191
25,Lleida,31,Arres,66,46,20
25,Lleida,32,Arsèguel,93,50,43
25,Lleida,33,Artesa de Lleida,1503,787,716
25,Lleida,34,Artesa de Segre,3872,2040,1832
25,Lleida,36,Aspa,262,136,126
25,Lleida,37,Avellanes i Santa Linya (Les),470,266,204
25,Lleida,39,Baix Pallars,407,223,184
25,Lleida,40,Balaguer,16341,8284,8057
25,Lleida,41,Barbens,890,478,412
25,Lleida,42,Baronia de Rialb (La),276,149,127
25,Lleida,44,Bassella,258,136,122
25,Lleida,45,Bausen,60,37,23
25,Lleida,46,Belianes,584,300,284
25,Lleida,170,Bellaguarda,344,181,163
25,Lleida,47,Bellcaire d'Urgell,1269,622,647
25,Lleida,48,Bell-lloc d'Urgell,2413,1201,1212
25,Lleida,49,Bellmunt d'Urgell,215,103,112
25,Lleida,50,Bellpuig,4798,2499,2299
25,Lleida,51,Bellver de Cerdanya,2132,1129,1003
25,Lleida,52,Bellvís,2468,1278,1190
25,Lleida,53,Benavent de Segrià,1445,747,698
25,Lleida,55,Biosca,221,119,102
25,Lleida,57,Bòrdes (Es),237,128,109
25,Lleida,58,Borges Blanques (Les),5942,3025,2917
25,Lleida,59,Bossòst,1202,624,578
25,Lleida,56,Bovera,357,182,175
25,Lleida,60,Cabanabona,101,45,56
25,Lleida,61,Cabó,99,57,42
25,Lleida,62,Camarasa,948,492,456
25,Lleida,63,Canejan,110,59,51
25,Lleida,904,Castell de Mur,177,93,84
25,Lleida,64,Castellar de la Ribera,159,78,81
25,Lleida,67,Castelldans,1029,566,463
25,Lleida,68,Castellnou de Seana,731,381,350
25,Lleida,69,Castelló de Farfanya,584,313,271
25,Lleida,70,Castellserà,1123,585,538
25,Lleida,71,Cava,55,36,19
25,Lleida,72,Cervera,9247,4783,4464
25,Lleida,73,Cervià de les Garrigues,860,447,413
25,Lleida,74,Ciutadilla,226,129,97
25,Lleida,75,Clariana de Cardener,147,78,69
25,Lleida,76,Cogul (El),211,115,96
25,Lleida,77,Coll de Nargó,628,330,298
25,Lleida,163,Coma i la Pedra (La),267,163,104
25,Lleida,161,Conca de Dalt,418,217,201
25,Lleida,78,Corbins,1370,729,641
25,Lleida,79,Cubells,397,202,195
25,Lleida,81,Espluga Calba (L'),424,224,200
25,Lleida,82,Espot,360,196,164
25,Lleida,88,Estamariu,115,61,54
25,Lleida,85,Estaràs,178,98,80
25,Lleida,86,Esterri d'Àneu,891,469,422
25,Lleida,87,Esterri de Cardós,72,31,41
25,Lleida,89,Farrera,115,69,46
25,Lleida,908,Fígols i Alinyà,280,158,122
25,Lleida,92,Floresta (La),199,110,89
25,Lleida,93,Fondarella,811,408,403
25,Lleida,94,Foradada,189,109,80
25,Lleida,96,Fuliola (La),1225,613,612
25,Lleida,97,Fulleda,119,65,54
25,Lleida,98,Gavet de la Conca,304,148,156
25,Lleida,912,Gimenells i el Pla de la Font,1184,602,582
25,Lleida,99,Golmés,1661,836,825
25,Lleida,100,Gósol,233,132,101
25,Lleida,101,Granadella (La),758,392,366
25,Lleida,102,Granja d'Escarp (La),1024,549,475
25,Lleida,103,Granyanella,178,90,88
25,Lleida,105,Granyena de les Garrigues,161,90,71
25,Lleida,104,Granyena de Segarra,144,73,71
25,Lleida,109,Guimerà,341,187,154
25,Lleida,903,Guingueta d'Àneu (La),376,210,166
25,Lleida,110,Guissona,5683,3008,2675
25,Lleida,111,Guixers,140,81,59
25,Lleida,115,Isona i Conca Dellà,1151,614,537
25,Lleida,112,Ivars de Noguera,348,186,162
25,Lleida,113,Ivars d'Urgell,1747,930,817
25,Lleida,114,Ivorra,138,70,68
25,Lleida,910,Josa i Tuixén,159,84,75
25,Lleida,118,Juncosa,508,267,241
25,Lleida,119,Juneda,3342,1748,1594
25,Lleida,121,Les,968,479,489
25,Lleida,122,Linyola,2781,1451,1330
25,Lleida,123,Lladorre,230,113,117
25,Lleida,124,Lladurs,212,117,95
25,Lleida,125,Llardecans,545,280,265
25,Lleida,126,Llavorsí,365,186,179
25,Lleida,120,Lleida,131731,65544,66187
25,Lleida,127,Lles de Cerdanya,263,156,107
25,Lleida,128,Llimiana,163,91,72
25,Lleida,129,Llobera,212,115,97
25,Lleida,133,Maials,977,498,479
25,Lleida,130,Maldà,273,146,127
25,Lleida,131,Massalcoreig,614,327,287
25,Lleida,132,Massoteres,224,121,103
25,Lleida,134,Menàrguens,843,436,407
25,Lleida,135,Miralcamp,1405,697,708
25,Lleida,137,Mollerussa,13675,7157,6518
25,Lleida,136,Molsosa (La),126,63,63
25,Lleida,139,Montellà i Martinet,629,340,289
25,Lleida,140,Montferrer i Castellbò,1070,593,477
25,Lleida,138,Montgai,731,374,357
25,Lleida,142,Montoliu de Lleida,491,249,242
25,Lleida,141,Montoliu de Segarra,188,109,79
25,Lleida,143,Montornès de Segarra,107,50,57
25,Lleida,145,Nalec,93,47,46
25,Lleida,25,Naut Aran,1731,900,831
25,Lleida,146,Navès,274,134,140
25,Lleida,148,Odèn,290,171,119
25,Lleida,149,Oliana,1949,970,979
25,Lleida,150,Oliola,262,149,113
25,Lleida,151,Olius,789,403,386
25,Lleida,152,Oluges (Les),186,103,83
25,Lleida,153,Omellons (Els),241,127,114
25,Lleida,154,Omells de na Gaia (Els),146,78,68
25,Lleida,155,Organyà,946,475,471
25,Lleida,156,Os de Balaguer,998,526,472
25,Lleida,157,Ossó de Sió,227,117,110
25,Lleida,158,Palau d'Anglesola (El),2050,1025,1025
25,Lleida,164,Penelles,551,298,253
25,Lleida,165,Peramola,374,199,175
25,Lleida,166,Pinell de Solsonès,212,115,97
25,Lleida,167,Pinós,320,176,144
25,Lleida,911,Plans de Sió (Els),595,310,285
25,Lleida,168,Poal (El),649,339,310
25,Lleida,169,Pobla de Cérvoles (La),245,131,114
25,Lleida,171,Pobla de Segur (La),3151,1595,1556
25,Lleida,30,Pont de Bar (El),189,110,79
25,Lleida,173,Pont de Suert (El),2553,1332,1221
25,Lleida,172,Ponts,2749,1397,1352
25,Lleida,174,Portella (La),816,444,372
25,Lleida,175,Prats i Sansor,231,130,101
25,Lleida,176,Preixana,413,209,204
25,Lleida,177,Preixens,505,258,247
25,Lleida,179,Prullans,236,123,113
25,Lleida,180,Puiggròs,311,164,147
25,Lleida,181,Puigverd d'Agramunt,284,163,121
25,Lleida,182,Puigverd de Lleida,1356,693,663
25,Lleida,183,Rialp,656,346,310
25,Lleida,905,Ribera d'Ondara,466,246,220
25,Lleida,185,Ribera d'Urgellet,991,533,458
25,Lleida,186,Riner,300,152,148
25,Lleida,913,Riu de Cerdanya,116,61,55
25,Lleida,189,Rosselló,2752,1426,1326
25,Lleida,190,Salàs de Pallars,341,177,164
25,Lleida,191,Sanaüja,458,237,221
25,Lleida,196,Sant Esteve de la Sarga,149,92,57
25,Lleida,192,Sant Guim de Freixenet,1104,546,558
25,Lleida,197,Sant Guim de la Plana,184,99,85
25,Lleida,193,Sant Llorenç de Morunys,1071,552,519
25,Lleida,902,Sant Martí de Riucorb,697,368,329
25,Lleida,194,Sant Ramon,549,299,250
25,Lleida,201,Sarroca de Bellera,136,79,57
25,Lleida,200,Sarroca de Lleida,438,232,206
25,Lleida,202,Senterada,141,75,66
25,Lleida,35,Sentiu de Sió (La),512,251,261
25,Lleida,204,Seròs,1876,1062,814
25,Lleida,203,Seu d'Urgell (La),12986,6431,6555
25,Lleida,205,Sidamon,727,369,358
25,Lleida,206,Soleràs (El),419,226,193
25,Lleida,207,Solsona,9166,4656,4510
25,Lleida,208,Soriguera,360,190,170
25,Lleida,209,Sort,2373,1203,1170
25,Lleida,210,Soses,1662,884,778
25,Lleida,211,Sudanell,863,479,384
25,Lleida,212,Sunyer,296,151,145
25,Lleida,215,Talarn,403,207,196
25,Lleida,216,Talavera,304,168,136
25,Lleida,217,Tàrrega,16149,8169,7980
25,Lleida,218,Tarrés,106,52,54
25,Lleida,219,Tarroja de Segarra,180,95,85
25,Lleida,220,Térmens,1521,786,735
25,Lleida,221,Tírvia,135,72,63
25,Lleida,222,Tiurana,78,40,38
25,Lleida,223,Torà,1370,719,651
25,Lleida,224,Torms (Els),180,95,85
25,Lleida,225,Tornabous,847,449,398
25,Lleida,227,Torre de Cabdella (La),808,408,400
25,Lleida,226,Torrebesses,298,155,143
25,Lleida,228,Torrefarrera,3697,1888,1809
25,Lleida,907,Torrefeta i Florejacs,633,329,304
25,Lleida,230,Torregrossa,2237,1137,1100
25,Lleida,231,Torrelameu,651,360,291
25,Lleida,232,Torres de Segre,2055,1073,982
25,Lleida,233,Torre-serona,353,183,170
25,Lleida,234,Tremp,6190,3088,3102
25,Lleida,43,Vall de Boí (La),1080,589,491
25,Lleida,901,Vall de Cardós,402,214,188
25,Lleida,238,Vallbona de les Monges,251,128,123
25,Lleida,240,Vallfogona de Balaguer,1735,883,852
25,Lleida,906,Valls d'Aguilar (Les),305,169,136
25,Lleida,239,Valls de Valira (Les),861,478,383
25,Lleida,909,Vansa i Fórnols (La),188,104,84
25,Lleida,242,Verdú,1029,506,523
25,Lleida,243,Vielha e Mijaran,5633,3038,2595
25,Lleida,244,Vilagrassa,449,236,213
25,Lleida,245,Vilaller,699,405,294
25,Lleida,247,Vilamòs,187,99,88
25,Lleida,248,Vilanova de Bellpuig,1157,605,552
25,Lleida,254,Vilanova de la Barca,1181,581,600
25,Lleida,249,Vilanova de l'Aguda,227,116,111
25,Lleida,250,Vilanova de Meià,405,215,190
25,Lleida,251,Vilanova de Segrià,822,435,387
25,Lleida,252,Vila-sana,667,335,332
25,Lleida,253,Vilosell (El),203,101,102
25,Lleida,255,Vinaixa,602,309,293
26,Rioja (La),1,Ábalos,371,224,147
26,Rioja (La),2,Agoncillo,1141,645,496
26,Rioja (La),3,Aguilar del Río Alhama,596,281,315
26,Rioja (La),4,Ajamil,66,50,16
26,Rioja (La),5,Albelda de Iregua,3098,1607,1491
26,Rioja (La),6,Alberite,2594,1310,1284
26,Rioja (La),7,Alcanadre,741,388,353
26,Rioja (La),8,Aldeanueva de Ebro,2774,1472,1302
26,Rioja (La),9,Alesanco,494,260,234
26,Rioja (La),10,Alesón,140,77,63
26,Rioja (La),11,Alfaro,9727,5002,4725
26,Rioja (La),12,Almarza de Cameros,27,16,11
26,Rioja (La),13,Anguciana,524,304,220
26,Rioja (La),14,Anguiano,540,301,239
26,Rioja (La),15,Arenzana de Abajo,273,135,138
26,Rioja (La),16,Arenzana de Arriba,42,27,15
26,Rioja (La),17,Arnedillo,476,232,244
26,Rioja (La),18,Arnedo,14289,7173,7116
26,Rioja (La),19,Arrúbal,472,252,220
26,Rioja (La),20,Ausejo,1023,635,388
26,Rioja (La),21,Autol,4166,2166,2000
26,Rioja (La),22,Azofra,276,153,123
26,Rioja (La),23,Badarán,657,341,316
26,Rioja (La),24,Bañares,337,165,172
26,Rioja (La),26,Baños de Río Tobía,1735,873,862
26,Rioja (La),25,Baños de Rioja,98,59,39
26,Rioja (La),27,Berceo,194,117,77
26,Rioja (La),28,Bergasa,148,86,62
26,Rioja (La),29,Bergasillas Bajera,23,12,11
26,Rioja (La),30,Bezares,20,9,11
26,Rioja (La),31,Bobadilla,138,80,58
26,Rioja (La),32,Brieva de Cameros,65,41,24
26,Rioja (La),33,Briñas,260,136,124
26,Rioja (La),34,Briones,944,520,424
26,Rioja (La),35,Cabezón de Cameros,22,17,5
26,Rioja (La),36,Calahorra,24338,12098,12240
26,Rioja (La),37,Camprovín,207,117,90
26,Rioja (La),38,Canales de la Sierra,76,45,31
26,Rioja (La),39,Canillas de Río Tuerto,47,23,24
26,Rioja (La),40,Cañas,99,48,51
26,Rioja (La),41,Cárdenas,188,93,95
26,Rioja (La),42,Casalarreina,1280,708,572
26,Rioja (La),43,Castañares de Rioja,386,182,204
26,Rioja (La),44,Castroviejo,59,36,23
26,Rioja (La),45,Cellorigo,16,8,8
26,Rioja (La),46,Cenicero,2234,1178,1056
26,Rioja (La),47,Cervera del Río Alhama,2939,1538,1401
26,Rioja (La),48,Cidamón,35,18,17
26,Rioja (La),49,Cihuri,219,122,97
26,Rioja (La),50,Cirueña,132,76,56
26,Rioja (La),51,Clavijo,273,152,121
26,Rioja (La),52,Cordovín,201,108,93
26,Rioja (La),53,Corera,282,150,132
26,Rioja (La),54,Cornago,477,266,211
26,Rioja (La),55,Corporales,40,23,17
26,Rioja (La),56,Cuzcurrita de Río Tirón,514,274,240
26,Rioja (La),57,Daroca de Rioja,44,22,22
26,Rioja (La),58,Enciso,171,94,77
26,Rioja (La),59,Entrena,1448,767,681
26,Rioja (La),60,Estollo,106,63,43
26,Rioja (La),61,Ezcaray,2037,1096,941
26,Rioja (La),62,Foncea,100,53,47
26,Rioja (La),63,Fonzaleche,153,101,52
26,Rioja (La),64,Fuenmayor,3159,1616,1543
26,Rioja (La),65,Galbárruli,67,39,28
26,Rioja (La),66,Galilea,381,197,184
26,Rioja (La),67,Gallinero de Cameros,24,17,7
26,Rioja (La),68,Gimileo,159,100,59
26,Rioja (La),69,Grañón,326,178,148
26,Rioja (La),70,Grávalos,240,128,112
26,Rioja (La),71,Haro,12203,6532,5671
26,Rioja (La),72,Herce,389,211,178
26,Rioja (La),73,Herramélluri,102,55,47
26,Rioja (La),74,Hervías,152,82,70
26,Rioja (La),75,Hormilla,474,257,217
26,Rioja (La),76,Hormilleja,176,93,83
26,Rioja (La),77,Hornillos de Cameros,18,8,10
26,Rioja (La),78,Hornos de Moncalvillo,97,53,44
26,Rioja (La),79,Huércanos,919,487,432
26,Rioja (La),80,Igea,720,413,307
26,Rioja (La),81,Jalón de Cameros,24,15,9
26,Rioja (La),82,Laguna de Cameros,137,83,54
26,Rioja (La),83,Lagunilla del Jubera,359,201,158
26,Rioja (La),84,Lardero,7673,3941,3732
26,Rioja (La),86,Ledesma de la Cogolla,27,15,12
26,Rioja (La),87,Leiva,299,151,148
26,Rioja (La),88,Leza de Río Leza,52,28,24
26,Rioja (La),89,Logroño,150071,72776,77295
26,Rioja (La),91,Lumbreras,164,106,58
26,Rioja (La),92,Manjarrés,149,84,65
26,Rioja (La),93,Mansilla de la Sierra,71,48,23
26,Rioja (La),94,Manzanares de Rioja,103,59,44
26,Rioja (La),95,Matute,147,70,77
26,Rioja (La),96,Medrano,238,128,110
26,Rioja (La),98,Munilla,119,55,64
26,Rioja (La),99,Murillo de Río Leza,1750,946,804
26,Rioja (La),100,Muro de Aguas,62,37,25
26,Rioja (La),101,Muro en Cameros,33,20,13
26,Rioja (La),102,Nájera,8326,4175,4151
26,Rioja (La),103,Nalda,1118,641,477
26,Rioja (La),104,Navajún,18,14,4
26,Rioja (La),105,Navarrete,2750,1436,1314
26,Rioja (La),106,Nestares,81,46,35
26,Rioja (La),107,Nieva de Cameros,107,65,42
26,Rioja (La),109,Ochánduri,74,41,33
26,Rioja (La),108,Ocón,354,218,136
26,Rioja (La),110,Ojacastro,211,122,89
26,Rioja (La),111,Ollauri,317,172,145
26,Rioja (La),112,Ortigosa de Cameros,290,168,122
26,Rioja (La),113,Pazuengos,40,26,14
26,Rioja (La),114,Pedroso,107,61,46
26,Rioja (La),115,Pinillos,17,10,7
26,Rioja (La),117,Pradejón,3901,2094,1807
26,Rioja (La),118,Pradillo,73,36,37
26,Rioja (La),119,Préjano,245,126,119
26,Rioja (La),120,Quel,2002,1061,941
26,Rioja (La),121,Rabanera,41,30,11
26,Rioja (La),122,Rasillo de Cameros (El),140,67,73
26,Rioja (La),123,Redal (El),176,95,81
26,Rioja (La),124,Ribafrecha,1008,539,469
26,Rioja (La),125,Rincón de Soto,3710,1923,1787
26,Rioja (La),126,Robres del Castillo,34,21,13
26,Rioja (La),127,Rodezno,329,190,139
26,Rioja (La),128,Sajazarra,124,59,65
26,Rioja (La),129,San Asensio,1284,684,600
26,Rioja (La),130,San Millán de la Cogolla,306,196,110
26,Rioja (La),131,San Millán de Yécora,62,43,19
26,Rioja (La),132,San Román de Cameros,169,91,78
26,Rioja (La),139,San Torcuato,76,41,35
26,Rioja (La),142,San Vicente de la Sonsierra,1155,636,519
26,Rioja (La),134,Santa Coloma,135,80,55
26,Rioja (La),135,Santa Engracia del Jubera,192,112,80
26,Rioja (La),136,Santa Eulalia Bajera,135,73,62
26,Rioja (La),138,Santo Domingo de la Calzada,6698,3524,3174
26,Rioja (La),140,Santurde de Rioja,338,176,162
26,Rioja (La),141,Santurdejo,177,100,77
26,Rioja (La),143,Sojuela,177,108,69
26,Rioja (La),144,Sorzano,270,150,120
26,Rioja (La),145,Sotés,285,168,117
26,Rioja (La),146,Soto en Cameros,158,87,71
26,Rioja (La),147,Terroba,41,22,19
26,Rioja (La),148,Tirgo,257,138,119
26,Rioja (La),149,Tobía,78,44,34
26,Rioja (La),150,Tormantos,176,100,76
26,Rioja (La),153,Torre en Cameros,14,11,3
26,Rioja (La),151,Torrecilla en Cameros,548,306,242
26,Rioja (La),152,Torrecilla sobre Alesanco,48,22,26
26,Rioja (La),154,Torremontalbo,19,7,12
26,Rioja (La),155,Treviana,206,114,92
26,Rioja (La),157,Tricio,432,214,218
26,Rioja (La),158,Tudelilla,444,248,196
26,Rioja (La),160,Uruñuela,910,468,442
26,Rioja (La),161,Valdemadera,10,7,3
26,Rioja (La),162,Valgañón,159,85,74
26,Rioja (La),163,Ventosa,172,95,77
26,Rioja (La),164,Ventrosa,64,40,24
26,Rioja (La),165,Viguera,438,250,188
26,Rioja (La),166,Villalba de Rioja,172,106,66
26,Rioja (La),167,Villalobar de Rioja,68,42,26
26,Rioja (La),168,Villamediana de Iregua,6032,3153,2879
26,Rioja (La),169,Villanueva de Cameros,113,67,46
26,Rioja (La),170,Villar de Arnedo (El),661,340,321
26,Rioja (La),171,Villar de Torre,274,149,125
26,Rioja (La),172,Villarejo,39,28,11
26,Rioja (La),173,Villarroya,10,5,5
26,Rioja (La),174,Villarta-Quintana,154,77,77
26,Rioja (La),175,Villavelayo,75,46,29
26,Rioja (La),176,Villaverde de Rioja,80,47,33
26,Rioja (La),177,Villoslada de Cameros,368,221,147
26,Rioja (La),178,Viniegra de Abajo,111,65,46
26,Rioja (La),179,Viniegra de Arriba,42,26,16
26,Rioja (La),180,Zarratón,306,181,125
26,Rioja (La),181,Zarzosa,15,10,5
26,Rioja (La),183,Zorraquín,79,49,30
27,Lugo,1,Abadín,2988,1444,1544
27,Lugo,2,Alfoz,2133,1038,1095
27,Lugo,3,Antas de Ulla,2499,1213,1286
27,Lugo,4,Baleira,1641,860,781
27,Lugo,901,Baralla,2998,1543,1455
27,Lugo,5,Barreiros,3252,1556,1696
27,Lugo,6,Becerreá,3276,1659,1617
27,Lugo,7,Begonte,3538,1767,1771
27,Lugo,8,Bóveda,1719,851,868
27,Lugo,902,Burela,9171,4603,4568
27,Lugo,9,Carballedo,2799,1392,1407
27,Lugo,10,Castro de Rei,5725,2849,2876
27,Lugo,11,Castroverde,3110,1591,1519
27,Lugo,12,Cervantes,1780,1001,779
27,Lugo,13,Cervo,4724,2350,2374
27,Lugo,16,Chantada,9086,4412,4674
27,Lugo,14,Corgo (O),4046,2053,1993
27,Lugo,15,Cospeito,5275,2580,2695
27,Lugo,17,Folgoso do Courel,1274,665,609
27,Lugo,18,Fonsagrada (A),4638,2430,2208
27,Lugo,19,Foz,9880,4832,5048
27,Lugo,20,Friol,4430,2189,2241
27,Lugo,22,Guitiriz,5907,2931,2976
27,Lugo,23,Guntín,3187,1609,1578
27,Lugo,24,Incio (O),2113,1019,1094
27,Lugo,26,Láncara,3041,1539,1502
27,Lugo,27,Lourenzá,2569,1262,1307
27,Lugo,28,Lugo,95416,44568,50848
27,Lugo,29,Meira,1822,900,922
27,Lugo,30,Mondoñedo,4603,2150,2453
27,Lugo,31,Monforte de Lemos,19486,9363,10123
27,Lugo,32,Monterroso,4088,2020,2068
27,Lugo,33,Muras,860,435,425
27,Lugo,34,Navia de Suarna,1490,800,690
27,Lugo,35,Negueira de Muñiz,221,114,107
27,Lugo,37,Nogais (As),1409,730,679
27,Lugo,38,Ourol,1259,622,637
27,Lugo,39,Outeiro de Rei,4886,2543,2343
27,Lugo,40,Palas de Rei,3682,1804,1878
27,Lugo,41,Pantón,3032,1443,1589
27,Lugo,42,Paradela,2193,1101,1092
27,Lugo,43,Páramo (O),1733,880,853
27,Lugo,44,Pastoriza (A),3631,1807,1824
27,Lugo,45,Pedrafita do Cebreiro,1336,711,625
27,Lugo,47,Pobra do Brollón (A),2162,1060,1102
27,Lugo,46,Pol,1870,935,935
27,Lugo,48,Pontenova (A),2918,1438,1480
27,Lugo,49,Portomarín,1838,933,905
27,Lugo,50,Quiroga,3894,1857,2037
27,Lugo,56,Rábade,1718,861,857
27,Lugo,51,Ribadeo,9854,4671,5183
27,Lugo,52,Ribas de Sil,1169,566,603
27,Lugo,53,Ribeira de Piquín,723,366,357
27,Lugo,54,Riotorto,1559,765,794
27,Lugo,55,Samos,1743,908,835
27,Lugo,57,Sarria,13476,6571,6905
27,Lugo,58,Saviñao (O),4638,2288,2350
27,Lugo,59,Sober,2749,1312,1437
27,Lugo,60,Taboada,3478,1652,1826
27,Lugo,61,Trabada,1436,706,730
27,Lugo,62,Triacastela,792,395,397
27,Lugo,63,Valadouro (O),2210,1087,1123
27,Lugo,64,Vicedo (O),2070,1017,1053
27,Lugo,65,Vilalba,15406,7546,7860
27,Lugo,66,Viveiro,16052,7853,8199
27,Lugo,21,Xermade,2293,1124,1169
27,Lugo,25,Xove,3555,1774,1781
28,Madrid,1,Acebeda (La),57,30,27
28,Madrid,2,Ajalvir,3558,1851,1707
28,Madrid,3,Alameda del Valle,250,146,104
28,Madrid,4,Álamo (El),7580,3945,3635
28,Madrid,5,Alcalá de Henares,203645,102354,101291
28,Madrid,6,Alcobendas,107514,52369,55145
28,Madrid,7,Alcorcón,167997,82792,85205
28,Madrid,8,Aldea del Fresno,2424,1296,1128
28,Madrid,9,Algete,19345,9681,9664
28,Madrid,10,Alpedrete,12357,6149,6208
28,Madrid,11,Ambite,512,268,244
28,Madrid,12,Anchuelo,959,502,457
28,Madrid,13,Aranjuez,52224,25741,26483
28,Madrid,14,Arganda del Rey,50309,26007,24302
28,Madrid,15,Arroyomolinos,11804,6089,5715
28,Madrid,16,Atazar (El),109,55,54
28,Madrid,17,Batres,1432,734,698
28,Madrid,18,Becerril de la Sierra,5022,2530,2492
28,Madrid,19,Belmonte de Tajo,1381,702,679
28,Madrid,21,Berrueco (El),601,319,282
28,Madrid,20,Berzosa del Lozoya,234,121,113
28,Madrid,22,Boadilla del Monte,41807,20490,21317
28,Madrid,23,Boalo (El),6223,3274,2949
28,Madrid,24,Braojos,182,102,80
28,Madrid,25,Brea de Tajo,521,269,252
28,Madrid,26,Brunete,9275,4638,4637
28,Madrid,27,Buitrago del Lozoya,2068,1046,1022
28,Madrid,28,Bustarviejo,2044,1047,997
28,Madrid,29,Cabanillas de la Sierra,734,393,341
28,Madrid,30,Cabrera (La),2422,1253,1169
28,Madrid,31,Cadalso de los Vidrios,2903,1537,1366
28,Madrid,32,Camarma de Esteruelas,6160,3162,2998
28,Madrid,33,Campo Real,4865,2496,2369
28,Madrid,34,Canencia,521,282,239
28,Madrid,35,Carabaña,1831,925,906
28,Madrid,36,Casarrubuelos,3044,1566,1478
28,Madrid,37,Cenicientos,2060,1029,1031
28,Madrid,38,Cercedilla,6970,3442,3528
28,Madrid,39,Cervera de Buitrago,142,84,58
28,Madrid,51,Chapinería,1939,1000,939
28,Madrid,52,Chinchón,5191,2636,2555
28,Madrid,40,Ciempozuelos,21256,10824,10432
28,Madrid,41,Cobeña,5406,2702,2704
28,Madrid,46,Collado Mediano,6427,3254,3173
28,Madrid,47,Collado Villalba,54658,27065,27593
28,Madrid,43,Colmenar de Oreja,8127,4134,3993
28,Madrid,42,Colmenar del Arroyo,1348,678,670
28,Madrid,45,Colmenar Viejo,42649,21333,21316
28,Madrid,44,Colmenarejo,7972,3933,4039
28,Madrid,48,Corpa,540,281,259
28,Madrid,49,Coslada,89918,45199,44719
28,Madrid,50,Cubas de la Sagra,4109,2044,2065
28,Madrid,53,Daganzo de Arriba,8493,4324,4169
28,Madrid,54,Escorial (El),14873,7347,7526
28,Madrid,55,Estremera,1516,766,750
28,Madrid,56,Fresnedillas de la Oliva,1392,719,673
28,Madrid,57,Fresno de Torote,2018,1085,933
28,Madrid,58,Fuenlabrada,194791,98625,96166
28,Madrid,59,Fuente el Saz de Jarama,6079,3122,2957
28,Madrid,60,Fuentidueña de Tajo,2001,1031,970
28,Madrid,61,Galapagar,31261,15715,15546
28,Madrid,62,Garganta de los Montes,405,214,191
28,Madrid,63,Gargantilla del Lozoya y Pinilla de Buitrago,384,222,162
28,Madrid,64,Gascones,145,78,67
28,Madrid,65,Getafe,164043,81619,82424
28,Madrid,66,Griñón,9161,4610,4551
28,Madrid,67,Guadalix de la Sierra,5701,2945,2756
28,Madrid,68,Guadarrama,14318,7074,7244
28,Madrid,69,Hiruela (La),76,43,33
28,Madrid,70,Horcajo de la Sierra,172,100,72
28,Madrid,71,Horcajuelo de la Sierra,102,50,52
28,Madrid,72,Hoyo de Manzanares,7457,3714,3743
28,Madrid,73,Humanes de Madrid,17379,8968,8411
28,Madrid,74,Leganés,184209,91551,92658
28,Madrid,75,Loeches,6210,3131,3079
28,Madrid,76,Lozoya,650,353,297
28,Madrid,901,Lozoyuela-Navas-Sieteiglesias,1068,554,514
28,Madrid,78,Madarcos,47,26,21
28,Madrid,79,Madrid,3213271,1511818,1701453
28,Madrid,80,Majadahonda,66585,31736,34849
28,Madrid,82,Manzanares el Real,6933,3618,3315
28,Madrid,83,Meco,12198,6266,5932
28,Madrid,84,Mejorada del Campo,22267,11227,11040
28,Madrid,85,Miraflores de la Sierra,5811,2916,2895
28,Madrid,86,Molar (El),6869,3566,3303
28,Madrid,87,Molinos (Los),4558,2415,2143
28,Madrid,88,Montejo de la Sierra,356,177,179
28,Madrid,89,Moraleja de Enmedio,4633,2337,2296
28,Madrid,90,Moralzarzal,11318,5697,5621
28,Madrid,91,Morata de Tajuña,7087,3612,3475
28,Madrid,92,Móstoles,206275,102975,103300
28,Madrid,93,Navacerrada,2675,1304,1371
28,Madrid,94,Navalafuente,1039,544,495
28,Madrid,95,Navalagamella,2161,1151,1010
28,Madrid,96,Navalcarnero,20058,10097,9961
28,Madrid,97,Navarredonda y San Mamés,151,82,69
28,Madrid,99,Navas del Rey,2459,1308,1151
28,Madrid,100,Nuevo Baztán,6111,3106,3005
28,Madrid,101,Olmeda de las Fuentes,283,155,128
28,Madrid,102,Orusco de Tajuña,1111,562,549
28,Madrid,104,Paracuellos de Jarama,11424,5888,5536
28,Madrid,106,Parla,108051,55581,52470
28,Madrid,107,Patones,517,242,275
28,Madrid,108,Pedrezuela,3822,2019,1803
28,Madrid,109,Pelayos de la Presa,2417,1217,1200
28,Madrid,110,Perales de Tajuña,2738,1388,1350
28,Madrid,111,Pezuela de las Torres,825,421,404
28,Madrid,112,Pinilla del Valle,185,101,84
28,Madrid,113,Pinto,42445,21460,20985
28,Madrid,114,Piñuécar-Gandullas,193,106,87
28,Madrid,115,Pozuelo de Alarcón,81365,39067,42298
28,Madrid,116,Pozuelo del Rey,646,353,293
28,Madrid,117,Prádena del Rincón,114,63,51
28,Madrid,118,Puebla de la Sierra,107,59,48
28,Madrid,902,Puentes Viejas,562,336,226
28,Madrid,119,Quijorna,2703,1391,1312
28,Madrid,120,Rascafría,2059,1100,959
28,Madrid,121,Redueña,266,147,119
28,Madrid,122,Ribatejada,602,322,280
28,Madrid,123,Rivas-Vaciamadrid,64808,32555,32253
28,Madrid,124,Robledillo de la Jara,130,67,63
28,Madrid,125,Robledo de Chavela,3773,1923,1850
28,Madrid,126,Robregordo,62,33,29
28,Madrid,127,Rozas de Madrid (Las),83428,40493,42935
28,Madrid,128,Rozas de Puerto Real,402,229,173
28,Madrid,129,San Agustín del Guadalix,10433,5287,5146
28,Madrid,130,San Fernando de Henares,40654,20370,20284
28,Madrid,131,San Lorenzo de El Escorial,17346,8388,8958
28,Madrid,132,San Martín de la Vega,17584,9224,8360
28,Madrid,133,San Martín de Valdeiglesias,7888,3954,3934
28,Madrid,134,San Sebastián de los Reyes,72414,35632,36782
28,Madrid,135,Santa María de la Alameda,1178,647,531
28,Madrid,136,Santorcaz,817,425,392
28,Madrid,137,Santos de la Humosa (Los),1997,1035,962
28,Madrid,138,Serna del Monte (La),111,61,50
28,Madrid,140,Serranillos del Valle,3273,1638,1635
28,Madrid,141,Sevilla la Nueva,7814,4003,3811
28,Madrid,143,Somosierra,110,59,51
28,Madrid,144,Soto del Real,8188,4050,4138
28,Madrid,145,Talamanca de Jarama,2472,1277,1195
28,Madrid,146,Tielmes,2553,1323,1230
28,Madrid,147,Titulcia,1045,539,506
28,Madrid,148,Torrejón de Ardoz,116455,58113,58342
28,Madrid,149,Torrejón de la Calzada,6478,3231,3247
28,Madrid,150,Torrejón de Velasco,3924,2015,1909
28,Madrid,151,Torrelaguna,4671,2434,2237
28,Madrid,152,Torrelodones,21231,10358,10873
28,Madrid,153,Torremocha de Jarama,703,362,341
28,Madrid,154,Torres de la Alameda,7474,3851,3623
28,Madrid,903,Tres Cantos,40606,19819,20787
28,Madrid,155,Valdaracete,685,345,340
28,Madrid,156,Valdeavero,1170,611,559
28,Madrid,157,Valdelaguna,807,430,377
28,Madrid,158,Valdemanco,976,524,452
28,Madrid,159,Valdemaqueda,838,423,415
28,Madrid,160,Valdemorillo,10890,5651,5239
28,Madrid,161,Valdemoro,58623,29439,29184
28,Madrid,162,Valdeolmos-Alalpardo,2804,1449,1355
28,Madrid,163,Valdepiélagos,425,218,207
28,Madrid,164,Valdetorres de Jarama,3773,2012,1761
28,Madrid,165,Valdilecha,2699,1390,1309
28,Madrid,166,Valverde de Alcalá,425,234,191
28,Madrid,167,Velilla de San Antonio,11242,5760,5482
28,Madrid,168,Vellón (El),1492,790,702
28,Madrid,169,Venturada,1609,832,777
28,Madrid,171,Villa del Prado,6182,3240,2942
28,Madrid,170,Villaconejos,3159,1617,1542
28,Madrid,172,Villalbilla,8492,4332,4160
28,Madrid,173,Villamanrique de Tajo,764,395,369
28,Madrid,174,Villamanta,2337,1167,1170
28,Madrid,175,Villamantilla,763,383,380
28,Madrid,176,Villanueva de la Cañada,16425,7973,8452
28,Madrid,178,Villanueva de Perales,1175,619,556
28,Madrid,177,Villanueva del Pardillo,14763,7266,7497
28,Madrid,179,Villar del Olmo,2075,1097,978
28,Madrid,180,Villarejo de Salvanés,7219,3698,3521
28,Madrid,181,Villaviciosa de Odón,26248,12752,13496
28,Madrid,182,Villavieja del Lozoya,260,137,123
28,Madrid,183,Zarzalejo,1469,764,705
29,Málaga,1,Alameda,5426,2687,2739
29,Málaga,2,Alcaucín,2469,1239,1230
29,Málaga,3,Alfarnate,1362,702,660
29,Málaga,4,Alfarnatejo,516,268,248
29,Málaga,5,Algarrobo,6144,3090,3054
29,Málaga,6,Algatocín,929,483,446
29,Málaga,7,Alhaurín de la Torre,33567,16787,16780
29,Málaga,8,Alhaurín el Grande,22785,11504,11281
29,Málaga,9,Almáchar,1896,964,932
29,Málaga,10,Almargen,2153,1067,1086
29,Málaga,11,Almogía,4316,2202,2114
29,Málaga,12,Álora,13436,6781,6655
29,Málaga,13,Alozaina,2238,1155,1083
29,Málaga,14,Alpandeire,278,138,140
29,Málaga,15,Antequera,45037,22179,22858
29,Málaga,16,Árchez,437,224,213
29,Málaga,17,Archidona,8868,4420,4448
29,Málaga,18,Ardales,2638,1323,1315
29,Málaga,19,Arenas,1421,761,660
29,Málaga,20,Arriate,4062,1992,2070
29,Málaga,21,Atajate,146,82,64
29,Málaga,22,Benadalid,261,129,132
29,Málaga,23,Benahavís,3844,1981,1863
29,Málaga,24,Benalauría,508,267,241
29,Málaga,25,Benalmádena,55960,27751,28209
29,Málaga,26,Benamargosa,1642,843,799
29,Málaga,27,Benamocarra,3080,1563,1517
29,Málaga,28,Benaoján,1629,822,807
29,Málaga,29,Benarrabá,570,310,260
29,Málaga,30,Borge (El),1046,541,505
29,Málaga,31,Burgo (El),2027,1020,1007
29,Málaga,32,Campillos,8543,4274,4269
29,Málaga,33,Canillas de Aceituno,2320,1183,1137
29,Málaga,34,Canillas de Albaida,902,466,436
29,Málaga,35,Cañete la Real,2024,1044,980
29,Málaga,36,Carratraca,923,467,456
29,Málaga,37,Cartajima,242,123,119
29,Málaga,38,Cártama,20436,10450,9986
29,Málaga,39,Casabermeja,3509,1850,1659
29,Málaga,40,Casarabonela,2767,1467,1300
29,Málaga,41,Casares,4797,2531,2266
29,Málaga,42,Coín,21484,11155,10329
29,Málaga,43,Colmenar,3625,1832,1793
29,Málaga,44,Comares,1570,831,739
29,Málaga,45,Cómpeta,3794,1962,1832
29,Málaga,46,Cortes de la Frontera,3762,1904,1858
29,Málaga,47,Cuevas Bajas,1463,746,717
29,Málaga,49,Cuevas de San Marcos,4142,2088,2054
29,Málaga,48,Cuevas del Becerro,1820,916,904
29,Málaga,50,Cútar,655,332,323
29,Málaga,51,Estepona,62848,31656,31192
29,Málaga,52,Faraján,296,137,159
29,Málaga,53,Frigiliana,2978,1470,1508
29,Málaga,54,Fuengirola,68646,34072,34574
29,Málaga,55,Fuente de Piedra,2582,1300,1282
29,Málaga,56,Gaucín,1983,1047,936
29,Málaga,57,Genalguacil,526,275,251
29,Málaga,58,Guaro,2230,1114,1116
29,Málaga,59,Humilladero,3215,1604,1611
29,Málaga,60,Igualeja,991,490,501
29,Málaga,61,Istán,1386,707,679
29,Málaga,62,Iznate,918,479,439
29,Málaga,63,Jimera de Líbar,453,231,222
29,Málaga,64,Jubrique,803,400,403
29,Málaga,65,Júzcar,205,117,88
29,Málaga,66,Macharaviaya,492,256,236
29,Málaga,67,Málaga,566447,273299,293148
29,Málaga,68,Manilva,13258,6982,6276
29,Málaga,69,Marbella,130549,64011,66538
29,Málaga,70,Mijas,70437,35411,35026
29,Málaga,71,Moclinejo,1264,645,619
29,Málaga,72,Mollina,4963,2501,2462
29,Málaga,73,Monda,2342,1201,1141
29,Málaga,74,Montejaque,1004,503,501
29,Málaga,75,Nerja,21621,10748,10873
29,Málaga,76,Ojén,2668,1363,1305
29,Málaga,77,Parauta,242,118,124
29,Málaga,79,Periana,3600,1852,1748
29,Málaga,80,Pizarra,8652,4371,4281
29,Málaga,81,Pujerra,334,181,153
29,Málaga,82,Rincón de la Victoria,37145,18478,18667
29,Málaga,83,Riogordo,3090,1604,1486
29,Málaga,84,Ronda,36532,18152,18380
29,Málaga,85,Salares,210,113,97
29,Málaga,86,Sayalonga,1532,768,764
29,Málaga,87,Sedella,694,380,314
29,Málaga,88,Sierra de Yeguas,3552,1788,1764
29,Málaga,89,Teba,4253,2153,2100
29,Málaga,90,Tolox,2375,1208,1167
29,Málaga,901,Torremolinos,63077,32121,30956
29,Málaga,91,Torrox,16395,8218,8177
29,Málaga,92,Totalán,724,374,350
29,Málaga,93,Valle de Abdalajís,2908,1409,1499
29,Málaga,94,Vélez-Málaga,72842,36395,36447
29,Málaga,95,Villanueva de Algaidas,4602,2361,2241
29,Málaga,98,Villanueva de Tapia,1671,850,821
29,Málaga,96,Villanueva del Rosario,3613,1806,1807
29,Málaga,97,Villanueva del Trabuco,5385,2714,2671
29,Málaga,99,Viñuela,1973,995,978
29,Málaga,100,Yunquera,3286,1688,1598
30,Murcia,1,Abanilla,6642,3390,3252
30,Murcia,2,Abarán,12987,6526,6461
30,Murcia,3,Águilas,34101,17173,16928
30,Murcia,4,Albudeite,1381,692,689
30,Murcia,5,Alcantarilla,40458,20221,20237
30,Murcia,902,Alcázares (Los),15171,7940,7231
30,Murcia,6,Aledo,1055,541,514
30,Murcia,7,Alguazas,8855,4614,4241
30,Murcia,8,Alhama de Murcia,19417,10016,9401
30,Murcia,9,Archena,18280,9446,8834
30,Murcia,10,Beniel,10581,5554,5027
30,Murcia,11,Blanca,6226,3161,3065
30,Murcia,12,Bullas,12374,6305,6069
30,Murcia,13,Calasparra,10569,5397,5172
30,Murcia,14,Campos del Río,2212,1066,1146
30,Murcia,15,Caravaca de la Cruz,26240,13234,13006
30,Murcia,16,Cartagena,210376,106305,104071
30,Murcia,17,Cehegín,16188,8196,7992
30,Murcia,18,Ceutí,9759,4999,4760
30,Murcia,19,Cieza,35144,17623,17521
30,Murcia,20,Fortuna,9274,4892,4382
30,Murcia,21,Fuente Álamo de Murcia,14925,7952,6973
30,Murcia,22,Jumilla,25348,13113,12235
30,Murcia,23,Librilla,4455,2235,2220
30,Murcia,24,Lorca,90924,47421,43503
30,Murcia,25,Lorquí,6904,3570,3334
30,Murcia,26,Mazarrón,34351,18185,16166
30,Murcia,27,Molina de Segura,62407,31587,30820
30,Murcia,28,Moratalla,8424,4276,4148
30,Murcia,29,Mula,16942,8771,8171
30,Murcia,30,Murcia,430571,213786,216785
30,Murcia,31,Ojós,604,310,294
30,Murcia,32,Pliego,4032,2096,1936
30,Murcia,33,Puerto Lumbreras,13612,6798,6814
30,Murcia,34,Ricote,1546,782,764
30,Murcia,35,San Javier,30653,15808,14845
30,Murcia,36,San Pedro del Pinatar,23272,11888,11384
30,Murcia,901,Santomera,14948,7605,7343
30,Murcia,37,Torre-Pacheco,30351,16099,14252
30,Murcia,38,Torres de Cotillas (Las),20456,10598,9858
30,Murcia,39,Totana,28976,14997,13979
30,Murcia,40,Ulea,956,501,455
30,Murcia,41,Unión (La),17107,8605,8502
30,Murcia,42,Villanueva del Río Segura,2186,1077,1109
30,Murcia,43,Yecla,34869,17648,17221
31,Navarra,1,Abáigar,103,55,48
31,Navarra,2,Abárzuza,584,295,289
31,Navarra,3,Abaurregaina/Abaurrea Alta,141,86,55
31,Navarra,4,Abaurrepea/Abaurrea Baja,41,29,12
31,Navarra,5,Aberin,351,184,167
31,Navarra,6,Ablitas,2559,1303,1256
31,Navarra,7,Adiós,176,97,79
31,Navarra,8,Aguilar de Codés,108,52,56
31,Navarra,9,Aibar/Oibar,920,492,428
31,Navarra,11,Allín,819,433,386
31,Navarra,12,Allo,1075,540,535
31,Navarra,10,Altsasu/Alsasua,7571,3846,3725
31,Navarra,13,Améscoa Baja,816,430,386
31,Navarra,14,Ancín,375,212,163
31,Navarra,15,Andosilla,2899,1489,1410
31,Navarra,16,Ansoáin,10340,5229,5111
31,Navarra,17,Anue,374,217,157
31,Navarra,18,Añorbe,508,268,240
31,Navarra,19,Aoiz/Agoitz,2354,1182,1172
31,Navarra,20,Araitz,586,344,242
31,Navarra,25,Arakil,946,518,428
31,Navarra,21,Aranarache,81,44,37
31,Navarra,23,Aranguren,6820,3481,3339
31,Navarra,24,Arano,136,72,64
31,Navarra,22,Arantza,640,358,282
31,Navarra,26,Aras,200,114,86
31,Navarra,27,Arbizu,1074,571,503
31,Navarra,28,Arce/Artzi,256,152,104
31,Navarra,29,Arcos (Los),1294,648,646
31,Navarra,30,Arellano,206,125,81
31,Navarra,31,Areso,282,149,133
31,Navarra,32,Arguedas,2381,1224,1157
31,Navarra,33,Aria,61,35,26
31,Navarra,34,Aribe,52,27,25
31,Navarra,35,Armañanzas,66,33,33
31,Navarra,36,Arróniz,1144,623,521
31,Navarra,37,Arruazu,104,58,46
31,Navarra,38,Artajona,1721,895,826
31,Navarra,39,Artazu,111,57,54
31,Navarra,40,Atez,249,147,102
31,Navarra,58,Auritz/Burguete,308,153,155
31,Navarra,41,Ayegui,1673,886,787
31,Navarra,42,Azagra,3746,1913,1833
31,Navarra,43,Azuelo,48,23,25
31,Navarra,44,Bakaiku,338,182,156
31,Navarra,901,Barañain,22193,10909,11284
31,Navarra,45,Barásoain,602,304,298
31,Navarra,46,Barbarin,78,40,38
31,Navarra,47,Bargota,340,166,174
31,Navarra,48,Barillas,189,98,91
31,Navarra,49,Basaburua,841,486,355
31,Navarra,50,Baztan,7982,4084,3898
31,Navarra,137,Beintza-Labaien,258,151,107
31,Navarra,51,Beire,322,157,165
31,Navarra,52,Belascoáin,121,60,61
31,Navarra,250,Bera/Vera de Bidasoa,3680,1835,1845
31,Navarra,53,Berbinzana,693,363,330
31,Navarra,905,Beriáin,3536,1738,1798
31,Navarra,902,Berrioplano,3615,1867,1748
31,Navarra,903,Berriozar,8899,4601,4298
31,Navarra,54,Bertizarana,653,329,324
31,Navarra,55,Betelu,346,188,158
31,Navarra,253,Bidaurreta,135,77,58
31,Navarra,56,Biurrun-Olcoz,209,123,86
31,Navarra,57,Buñuel,2403,1212,1191
31,Navarra,59,Burgui/Burgi,227,129,98
31,Navarra,60,Burlada/Burlata,18504,9137,9367
31,Navarra,61,Busto (El),82,42,40
31,Navarra,62,Cabanillas,1477,766,711
31,Navarra,63,Cabredo,105,54,51
31,Navarra,64,Cadreita,2037,1064,973
31,Navarra,65,Caparroso,2685,1355,1330
31,Navarra,66,Cárcar,1185,594,591
31,Navarra,67,Carcastillo,2606,1347,1259
31,Navarra,68,Cascante,3975,2002,1973
31,Navarra,69,Cáseda,1059,514,545
31,Navarra,70,Castejón,4115,2108,2007
31,Navarra,71,Castillonuevo,19,13,6
31,Navarra,193,Cendea de Olza/Oltza Zendea,1543,777,766
31,Navarra,72,Cintruénigo,7332,3761,3571
31,Navarra,74,Cirauqui,482,271,211
31,Navarra,75,Ciriza,112,68,44
31,Navarra,76,Cizur,2838,1409,1429
31,Navarra,77,Corella,7898,4133,3765
31,Navarra,78,Cortes,3370,1746,1624
31,Navarra,79,Desojo,111,60,51
31,Navarra,80,Dicastillo,704,375,329
31,Navarra,81,Donamaria,429,214,215
31,Navarra,221,Doneztebe/Santesteban,1601,822,779
31,Navarra,83,Echarri,68,39,29
31,Navarra,86,Egüés,9137,4611,4526
31,Navarra,87,Elgorriaga,231,116,115
31,Navarra,89,Enériz,295,157,138
31,Navarra,90,Eratsun,165,106,59
31,Navarra,91,Ergoiena,417,225,192
31,Navarra,92,Erro,762,433,329
31,Navarra,94,Eslava,142,76,66
31,Navarra,95,Esparza de Salazar/Espartza Zaraitzu,104,54,50
31,Navarra,96,Espronceda,140,79,61
31,Navarra,97,Estella/Lizarra,14049,6880,7169
31,Navarra,98,Esteribar,2017,1058,959
31,Navarra,99,Etayo,87,43,44
31,Navarra,82,Etxalar,823,437,386
31,Navarra,84,Etxarri-Aranatz,2458,1273,1185
31,Navarra,85,Etxauri,567,294,273
31,Navarra,100,Eulate,351,183,168
31,Navarra,101,Ezcabarte,1637,874,763
31,Navarra,93,Ezcároz/Ezkaroze,356,186,170
31,Navarra,102,Ezkurra,176,115,61
31,Navarra,103,Ezprogui,56,29,27
31,Navarra,104,Falces,2601,1320,1281
31,Navarra,105,Fitero,2236,1186,1050
31,Navarra,106,Fontellas,903,459,444
31,Navarra,107,Funes,2361,1247,1114
31,Navarra,108,Fustiñana,2594,1314,1280
31,Navarra,109,Galar,1568,823,745
31,Navarra,110,Gallipienzo,124,65,59
31,Navarra,111,Gallués/Galoze,104,67,37
31,Navarra,112,Garaioa,113,63,50
31,Navarra,113,Garde,179,109,70
31,Navarra,114,Garínoain,480,271,209
31,Navarra,115,Garralda,201,103,98
31,Navarra,116,Genevilla,97,56,41
31,Navarra,117,Goizueta,800,436,364
31,Navarra,118,Goñi,185,116,69
31,Navarra,119,Güesa/Gorza,57,30,27
31,Navarra,120,Guesálaz,455,275,180
31,Navarra,121,Guirguillano,87,48,39
31,Navarra,256,Hiriberri/Villanueva de Aezkoa,129,76,53
31,Navarra,122,Huarte/Uharte,5505,2815,2690
31,Navarra,124,Ibargoiti,249,151,98
31,Navarra,259,Igantzi,614,325,289
31,Navarra,125,Igúzquiza,346,177,169
31,Navarra,126,Imotz,439,235,204
31,Navarra,127,Irañeta,161,91,70
31,Navarra,904,Irurtzun,2248,1174,1074
31,Navarra,128,Isaba/Izaba,487,243,244
31,Navarra,129,Ituren,481,240,241
31,Navarra,130,Iturmendi,388,201,187
31,Navarra,131,Iza,910,480,430
31,Navarra,132,Izagaondoa,179,113,66
31,Navarra,133,Izalzu/Itzaltzu,50,31,19
31,Navarra,134,Jaurrieta,214,113,101
31,Navarra,135,Javier,112,47,65
31,Navarra,136,Juslapeña,543,295,248
31,Navarra,138,Lakuntza,1168,615,553
31,Navarra,139,Lana,198,117,81
31,Navarra,140,Lantz,112,74,38
31,Navarra,141,Lapoblación,153,85,68
31,Navarra,142,Larraga,2097,1134,963
31,Navarra,143,Larraona,117,55,62
31,Navarra,144,Larraun,1027,573,454
31,Navarra,145,Lazagurría,201,105,96
31,Navarra,146,Leache,54,31,23
31,Navarra,147,Legarda,106,57,49
31,Navarra,148,Legaria,117,58,59
31,Navarra,149,Leitza,2876,1530,1346
31,Navarra,908,Lekunberri,1295,657,638
31,Navarra,150,Leoz,269,173,96
31,Navarra,151,Lerga,65,35,30
31,Navarra,152,Lerín,1877,970,907
31,Navarra,153,Lesaka,2779,1440,1339
31,Navarra,154,Lezáun,266,154,112
31,Navarra,155,Liédena,329,155,174
31,Navarra,156,Lizoáin,293,175,118
31,Navarra,157,Lodosa,4878,2475,2403
31,Navarra,158,Lónguida/Longida,306,166,140
31,Navarra,159,Lumbier,1386,736,650
31,Navarra,160,Luquin,142,74,68
31,Navarra,248,Luzaide/Valcarlos,431,218,213
31,Navarra,161,Mañeru,388,203,185
31,Navarra,162,Marañón,57,30,27
31,Navarra,163,Marcilla,2762,1417,1345
31,Navarra,164,Mélida,786,395,391
31,Navarra,165,Mendavia,3840,1959,1881
31,Navarra,166,Mendaza,318,151,167
31,Navarra,167,Mendigorría,1056,556,500
31,Navarra,168,Metauten,275,157,118
31,Navarra,169,Milagro,3236,1623,1613
31,Navarra,170,Mirafuentes,48,23,25
31,Navarra,171,Miranda de Arga,957,480,477
31,Navarra,172,Monreal,469,245,224
31,Navarra,173,Monteagudo,1151,576,575
31,Navarra,174,Morentin,142,75,67
31,Navarra,175,Mues,100,53,47
31,Navarra,176,Murchante,3549,1761,1788
31,Navarra,177,Murieta,361,193,168
31,Navarra,178,Murillo el Cuende,643,340,303
31,Navarra,179,Murillo el Fruto,744,392,352
31,Navarra,180,Muruzábal,295,137,158
31,Navarra,181,Navascués,195,118,77
31,Navarra,182,Nazar,48,31,17
31,Navarra,88,Noáin (Valle de Elorz)/Noain (Elortzibar),6222,3157,3065
31,Navarra,183,Obanos,937,468,469
31,Navarra,185,Ochagavía/Otsagabia,617,312,305
31,Navarra,184,Oco,75,42,33
31,Navarra,186,Odieta,352,191,161
31,Navarra,187,Oitz,157,97,60
31,Navarra,188,Olaibar,220,110,110
31,Navarra,189,Olazti/Olazagutía,1687,885,802
31,Navarra,190,Olejua,53,25,28
31,Navarra,191,Olite,3607,1819,1788
31,Navarra,194,Ollo,276,163,113
31,Navarra,192,Olóriz,176,101,75
31,Navarra,195,Orbaitzeta,222,114,108
31,Navarra,196,Orbara,46,24,22
31,Navarra,197,Orísoain,80,44,36
31,Navarra,906,Orkoien,2947,1525,1422
31,Navarra,198,Oronz/Orontze,50,27,23
31,Navarra,199,Oroz-Betelu,179,95,84
31,Navarra,211,Orreaga/Roncesvalles,26,11,15
31,Navarra,200,Oteiza,969,514,455
31,Navarra,201,Pamplona/Iruña,197275,94588,102687
31,Navarra,202,Peralta,5808,2950,2858
31,Navarra,203,Petilla de Aragón,29,19,10
31,Navarra,204,Piedramillera,56,36,20
31,Navarra,205,Pitillas,567,277,290
31,Navarra,206,Puente la Reina/Gares,2777,1434,1343
31,Navarra,207,Pueyo,318,174,144
31,Navarra,208,Ribaforada,3552,1799,1753
31,Navarra,209,Romanzado,168,94,74
31,Navarra,210,Roncal/Erronkari,271,146,125
31,Navarra,212,Sada,193,104,89
31,Navarra,213,Saldías,120,72,48
31,Navarra,214,Salinas de Oro,114,61,53
31,Navarra,215,San Adrián,6072,3027,3045
31,Navarra,217,San Martín de Unx,459,241,218
31,Navarra,216,Sangüesa/Zangoza,5130,2639,2491
31,Navarra,219,Sansol,113,58,55
31,Navarra,220,Santacara,965,479,486
31,Navarra,222,Sarriés/Sartze,68,40,28
31,Navarra,223,Sartaguda,1421,743,678
31,Navarra,224,Sesma,1304,653,651
31,Navarra,225,Sorlada,60,34,26
31,Navarra,226,Sunbilla,647,335,312
31,Navarra,227,Tafalla,11296,5637,5659
31,Navarra,228,Tiebas-Muruarte de Reta,616,325,291
31,Navarra,229,Tirapu,57,36,21
31,Navarra,230,Torralba del Río,141,74,67
31,Navarra,231,Torres del Río,153,72,81
31,Navarra,232,Tudela,33910,16902,17008
31,Navarra,233,Tulebras,137,55,82
31,Navarra,234,Ucar,150,86,64
31,Navarra,123,Uharte-Arakil,790,420,370
31,Navarra,235,Ujué,230,121,109
31,Navarra,236,Ultzama,1651,833,818
31,Navarra,237,Unciti,221,132,89
31,Navarra,238,Unzué,133,77,56
31,Navarra,239,Urdazubi/Urdax,380,187,193
31,Navarra,240,Urdiain,693,373,320
31,Navarra,241,Urraul Alto,168,92,76
31,Navarra,242,Urraul Bajo,281,125,156
31,Navarra,244,Urrotz,193,114,79
31,Navarra,243,Urroz-Villa,390,215,175
31,Navarra,245,Urzainqui/Urzainki,97,53,44
31,Navarra,246,Uterga,199,112,87
31,Navarra,247,Uztárroz/Uztarroze,199,96,103
31,Navarra,260,Valle de Yerri/Deierri,1572,810,762
31,Navarra,249,Valtierra,2542,1253,1289
31,Navarra,251,Viana,3759,1907,1852
31,Navarra,252,Vidángoz/Bidankoze,108,59,49
31,Navarra,254,Villafranca,2988,1518,1470
31,Navarra,255,Villamayor de Monjardín,137,69,68
31,Navarra,257,Villatuerta,1050,532,518
31,Navarra,258,Villava/Atarrabia,10462,5186,5276
31,Navarra,261,Yesa,259,140,119
31,Navarra,262,Zabalza,212,110,102
31,Navarra,73,Ziordia,404,193,211
31,Navarra,907,Zizur Mayor/Zizur Nagusia,13312,6609,6703
31,Navarra,263,Zubieta,314,172,142
31,Navarra,264,Zugarramurdi,225,117,108
31,Navarra,265,Zúñiga,135,83,52
32,Ourense,1,Allariz,5690,2780,2910
32,Ourense,2,Amoeiro,2318,1127,1191
32,Ourense,3,Arnoia (A),1147,569,578
32,Ourense,4,Avión,2664,1227,1437
32,Ourense,5,Baltar,1169,585,584
32,Ourense,6,Bande,2183,1012,1171
32,Ourense,7,Baños de Molgas,1902,938,964
32,Ourense,8,Barbadás,8890,4381,4509
32,Ourense,9,Barco de Valdeorras (O),14040,6960,7080
32,Ourense,10,Beade,525,264,261
32,Ourense,11,Beariz,1360,629,731
32,Ourense,12,Blancos (Os),1056,545,511
32,Ourense,13,Boborás,3047,1415,1632
32,Ourense,14,Bola (A),1507,718,789
32,Ourense,15,Bolo (O),1174,581,593
32,Ourense,16,Calvos de Randín,1102,553,549
32,Ourense,18,Carballeda de Avia,1607,778,829
32,Ourense,17,Carballeda de Valdeorras,1906,951,955
32,Ourense,19,Carballiño (O),13983,6591,7392
32,Ourense,20,Cartelle,3436,1683,1753
32,Ourense,22,Castrelo de Miño,1981,987,994
32,Ourense,21,Castrelo do Val,1240,625,615
32,Ourense,23,Castro Caldelas,1629,820,809
32,Ourense,24,Celanova,6075,2894,3181
32,Ourense,25,Cenlle,1466,698,768
32,Ourense,29,Chandrexa de Queixa,700,389,311
32,Ourense,26,Coles,3256,1624,1632
32,Ourense,27,Cortegada,1367,691,676
32,Ourense,28,Cualedro,2092,1028,1064
32,Ourense,30,Entrimo,1406,652,754
32,Ourense,31,Esgos,1226,618,608
32,Ourense,33,Gomesende,1048,496,552
32,Ourense,34,Gudiña (A),1586,799,787
32,Ourense,35,Irixo (O),1876,896,980
32,Ourense,38,Larouco,608,291,317
32,Ourense,39,Laza,1627,805,822
32,Ourense,40,Leiro,1830,886,944
32,Ourense,41,Lobeira,1027,508,519
32,Ourense,42,Lobios,2258,1110,1148
32,Ourense,43,Maceda,3143,1543,1600
32,Ourense,44,Manzaneda,1057,525,532
32,Ourense,45,Maside,3087,1490,1597
32,Ourense,46,Melón,1504,673,831
32,Ourense,47,Merca (A),2268,1082,1186
32,Ourense,48,Mezquita (A),1383,731,652
32,Ourense,49,Montederramo,1039,527,512
32,Ourense,50,Monterrei,3067,1530,1537
32,Ourense,51,Muíños,1888,933,955
32,Ourense,52,Nogueira de Ramuín,2452,1200,1252
32,Ourense,53,Oímbra,1923,975,948
32,Ourense,54,Ourense,107057,49653,57404
32,Ourense,55,Paderne de Allariz,1618,791,827
32,Ourense,56,Padrenda,2405,1179,1226
32,Ourense,57,Parada de Sil,729,355,374
32,Ourense,58,Pereiro de Aguiar (O),6049,3099,2950
32,Ourense,59,Peroxa (A),2347,1137,1210
32,Ourense,60,Petín,1042,510,532
32,Ourense,61,Piñor,1430,718,712
32,Ourense,63,Pobra de Trives (A),2564,1284,1280
32,Ourense,64,Pontedeva,704,336,368
32,Ourense,62,Porqueira,1136,551,585
32,Ourense,65,Punxín,891,427,464
32,Ourense,66,Quintela de Leirado,754,340,414
32,Ourense,67,Rairiz de Veiga,1720,843,877
32,Ourense,68,Ramirás,1989,922,1067
32,Ourense,69,Ribadavia,5491,2631,2860
32,Ourense,71,Riós,1973,970,1003
32,Ourense,72,Rúa (A),4844,2360,2484
32,Ourense,73,Rubiá,1590,776,814
32,Ourense,74,San Amaro,1335,661,674
32,Ourense,75,San Cibrao das Viñas,4200,2075,2125
32,Ourense,76,San Cristovo de Cea,2785,1387,1398
32,Ourense,70,San Xoán de Río,795,385,410
32,Ourense,77,Sandiás,1498,681,817
32,Ourense,78,Sarreaus,1629,809,820
32,Ourense,79,Taboadela,1690,850,840
32,Ourense,80,Teixeira (A),505,245,260
32,Ourense,81,Toén,2631,1333,1298
32,Ourense,82,Trasmiras,1723,840,883
32,Ourense,83,Veiga (A),1130,567,563
32,Ourense,84,Verea,1288,624,664
32,Ourense,85,Verín,14237,7019,7218
32,Ourense,86,Viana do Bolo,3368,1684,1684
32,Ourense,87,Vilamarín,2254,1098,1156
32,Ourense,88,Vilamartín de Valdeorras,2222,1108,1114
32,Ourense,89,Vilar de Barrio,1736,862,874
32,Ourense,90,Vilar de Santos,997,484,513
32,Ourense,91,Vilardevós,2382,1193,1189
32,Ourense,92,Vilariño de Conso,710,394,316
32,Ourense,32,Xinzo de Limia,10033,4962,5071
32,Ourense,36,Xunqueira de Ambía,1823,914,909
32,Ourense,37,Xunqueira de Espadanedo,980,478,502
33,Asturias,1,Allande,2106,1079,1027
33,Asturias,2,Aller,12970,6379,6591
33,Asturias,3,Amieva,837,449,388
33,Asturias,4,Avilés,83517,40034,43483
33,Asturias,5,Belmonte de Miranda,1855,953,902
33,Asturias,6,Bimenes,1907,906,1001
33,Asturias,7,Boal,2040,1010,1030
33,Asturias,8,Cabrales,2233,1137,1096
33,Asturias,9,Cabranes,1111,570,541
33,Asturias,10,Candamo,2218,1088,1130
33,Asturias,12,Cangas de Onís,6731,3326,3405
33,Asturias,11,Cangas del Narcea,14796,7407,7389
33,Asturias,13,Caravia,572,285,287
33,Asturias,14,Carreño,10833,5284,5549
33,Asturias,15,Caso,1911,1029,882
33,Asturias,16,Castrillón,22843,11165,11678
33,Asturias,17,Castropol,3900,1865,2035
33,Asturias,18,Coaña,3458,1690,1768
33,Asturias,19,Colunga,3930,1935,1995
33,Asturias,20,Corvera de Asturias,15785,7745,8040
33,Asturias,21,Cudillero,5855,2887,2968
33,Asturias,22,Degaña,1270,677,593
33,Asturias,23,Franco (El),4075,2026,2049
33,Asturias,24,Gijón,275699,130688,145011
33,Asturias,25,Gozón,10719,5249,5470
33,Asturias,26,Grado,11027,5348,5679
33,Asturias,27,Grandas de Salime,1101,566,535
33,Asturias,28,Ibias,1734,935,799
33,Asturias,29,Illano,497,256,241
33,Asturias,30,Illas,1019,531,488
33,Asturias,31,Langreo,45663,21669,23994
33,Asturias,32,Laviana,14245,6891,7354
33,Asturias,33,Lena,12959,6288,6671
33,Asturias,35,Llanera,13505,6661,6844
33,Asturias,36,Llanes,13915,6801,7114
33,Asturias,37,Mieres,44459,21207,23252
33,Asturias,38,Morcín,2962,1479,1483
33,Asturias,39,Muros de Nalón,1981,915,1066
33,Asturias,40,Nava,5543,2736,2807
33,Asturias,41,Navia,9118,4404,4714
33,Asturias,42,Noreña,5289,2552,2737
33,Asturias,43,Onís,815,423,392
33,Asturias,44,Oviedo,220644,103006,117638
33,Asturias,45,Parres,5803,2861,2942
33,Asturias,46,Peñamellera Alta,643,323,320
33,Asturias,47,Peñamellera Baja,1410,710,700
33,Asturias,48,Pesoz,194,94,100
33,Asturias,49,Piloña,8160,4023,4137
33,Asturias,50,Ponga,678,405,273
33,Asturias,51,Pravia,9135,4436,4699
33,Asturias,52,Proaza,790,426,364
33,Asturias,53,Quirós,1425,774,651
33,Asturias,54,Regueras (Las),2049,1022,1027
33,Asturias,55,Ribadedeva,1875,912,963
33,Asturias,56,Ribadesella,6296,2994,3302
33,Asturias,57,Ribera de Arriba,1997,1008,989
33,Asturias,58,Riosa,2262,1143,1119
33,Asturias,59,Salas,6007,2959,3048
33,Asturias,61,San Martín de Oscos,462,235,227
33,Asturias,60,San Martín del Rey Aurelio,18810,9103,9707
33,Asturias,63,San Tirso de Abres,564,280,284
33,Asturias,62,Santa Eulalia de Oscos,528,267,261
33,Asturias,64,Santo Adriano,268,139,129
33,Asturias,65,Sariego,1323,640,683
33,Asturias,66,Siero,50233,24473,25760
33,Asturias,67,Sobrescobio,871,459,412
33,Asturias,68,Somiedo,1467,812,655
33,Asturias,69,Soto del Barco,4060,1989,2071
33,Asturias,70,Tapia de Casariego,4223,2037,2186
33,Asturias,71,Taramundi,769,375,394
33,Asturias,72,Teverga,1944,1019,925
33,Asturias,73,Tineo,11377,5752,5625
33,Asturias,34,Valdés,13715,6703,7012
33,Asturias,74,Vegadeo,4289,2089,2200
33,Asturias,75,Villanueva de Oscos,404,201,203
33,Asturias,76,Villaviciosa,14639,7187,7452
33,Asturias,77,Villayón,1621,810,811
33,Asturias,78,Yernes y Tameza,200,100,100
34,Palencia,1,Abarca de Campos,41,24,17
34,Palencia,3,Abia de las Torres,175,95,80
34,Palencia,4,Aguilar de Campoo,7196,3489,3707
34,Palencia,5,Alar del Rey,1055,508,547
34,Palencia,6,Alba de Cerrato,96,50,46
34,Palencia,9,Amayuelas de Arriba,38,24,14
34,Palencia,10,Ampudia,607,321,286
34,Palencia,11,Amusco,469,256,213
34,Palencia,12,Antigüedad,399,216,183
34,Palencia,15,Arconada,48,26,22
34,Palencia,17,Astudillo,1149,587,562
34,Palencia,18,Autilla del Pino,238,131,107
34,Palencia,19,Autillo de Campos,174,81,93
34,Palencia,20,Ayuela,67,39,28
34,Palencia,22,Baltanás,1370,718,652
34,Palencia,24,Baquerín de Campos,34,20,14
34,Palencia,25,Bárcena de Campos,56,27,29
34,Palencia,27,Barruelo de Santullán,1526,734,792
34,Palencia,28,Báscones de Ojeda,178,97,81
34,Palencia,29,Becerril de Campos,949,485,464
34,Palencia,31,Belmonte de Campos,35,18,17
34,Palencia,32,Berzosilla,50,23,27
34,Palencia,33,Boada de Campos,19,11,8
34,Palencia,35,Boadilla de Rioseco,137,73,64
34,Palencia,34,Boadilla del Camino,132,71,61
34,Palencia,36,Brañosera,279,156,123
34,Palencia,37,Buenavista de Valdavia,392,202,190
34,Palencia,38,Bustillo de la Vega,326,171,155
34,Palencia,39,Bustillo del Páramo de Carrión,73,43,30
34,Palencia,41,Calahorra de Boedo,115,63,52
34,Palencia,42,Calzada de los Molinos,362,205,157
34,Palencia,45,Capillas,104,52,52
34,Palencia,46,Cardeñosa de Volpejera,40,21,19
34,Palencia,47,Carrión de los Condes,2328,1136,1192
34,Palencia,48,Castil de Vela,76,36,40
34,Palencia,49,Castrejón de la Peña,495,260,235
34,Palencia,50,Castrillo de Don Juan,275,146,129
34,Palencia,51,Castrillo de Onielo,123,64,59
34,Palencia,52,Castrillo de Villavega,207,111,96
34,Palencia,53,Castromocho,237,124,113
34,Palencia,55,Cervatos de la Cueza,309,173,136
34,Palencia,56,Cervera de Pisuerga,2595,1309,1286
34,Palencia,57,Cevico de la Torre,540,275,265
34,Palencia,58,Cevico Navero,232,123,109
34,Palencia,59,Cisneros,516,265,251
34,Palencia,60,Cobos de Cerrato,189,100,89
34,Palencia,61,Collazos de Boedo,138,77,61
34,Palencia,62,Congosto de Valdavia,213,122,91
34,Palencia,63,Cordovilla la Real,100,55,45
34,Palencia,66,Cubillas de Cerrato,81,41,40
34,Palencia,67,Dehesa de Montejo,155,87,68
34,Palencia,68,Dehesa de Romanos,39,24,15
34,Palencia,69,Dueñas,2983,1563,1420
34,Palencia,70,Espinosa de Cerrato,204,105,99
34,Palencia,71,Espinosa de Villagonzalo,210,109,101
34,Palencia,72,Frechilla,213,106,107
34,Palencia,73,Fresno del Río,190,104,86
34,Palencia,74,Frómista,848,434,414
34,Palencia,76,Fuentes de Nava,748,388,360
34,Palencia,77,Fuentes de Valdepero,241,131,110
34,Palencia,79,Grijota,1443,737,706
34,Palencia,80,Guardo,7528,3749,3779
34,Palencia,81,Guaza de Campos,63,30,33
34,Palencia,82,Hérmedes de Cerrato,104,54,50
34,Palencia,83,Herrera de Pisuerga,2373,1173,1200
34,Palencia,84,Herrera de Valdecañas,166,89,77
34,Palencia,86,Hontoria de Cerrato,111,57,54
34,Palencia,87,Hornillos de Cerrato,114,57,57
34,Palencia,88,Husillos,228,127,101
34,Palencia,89,Itero de la Vega,185,94,91
34,Palencia,91,Lagartos,152,83,69
34,Palencia,92,Lantadilla,392,189,203
34,Palencia,94,Ledigos,80,46,34
34,Palencia,903,Loma de Ucieza,279,152,127
34,Palencia,96,Lomas,56,32,24
34,Palencia,98,Magaz de Pisuerga,993,570,423
34,Palencia,99,Manquillos,65,37,28
34,Palencia,100,Mantinos,152,78,74
34,Palencia,101,Marcilla de Campos,48,22,26
34,Palencia,102,Mazariegos,261,148,113
34,Palencia,103,Mazuecos de Valdeginate,107,58,49
34,Palencia,104,Melgar de Yuso,320,182,138
34,Palencia,106,Meneses de Campos,144,72,72
34,Palencia,107,Micieces de Ojeda,96,54,42
34,Palencia,108,Monzón de Campos,654,340,314
34,Palencia,109,Moratinos,76,41,35
34,Palencia,110,Mudá,104,54,50
34,Palencia,112,Nogal de las Huertas,50,28,22
34,Palencia,113,Olea de Boedo,40,18,22
34,Palencia,114,Olmos de Ojeda,273,159,114
34,Palencia,116,Osornillo,80,39,41
34,Palencia,901,Osorno la Mayor,1482,774,708
34,Palencia,120,Palencia,82626,39148,43478
34,Palencia,121,Palenzuela,257,138,119
34,Palencia,122,Páramo de Boedo,102,52,50
34,Palencia,123,Paredes de Nava,2126,1067,1059
34,Palencia,124,Payo de Ojeda,77,45,32
34,Palencia,125,Pedraza de Campos,101,50,51
34,Palencia,126,Pedrosa de la Vega,338,181,157
34,Palencia,127,Perales,167,85,82
34,Palencia,904,Pernía (La),414,233,181
34,Palencia,129,Pino del Río,241,144,97
34,Palencia,130,Piña de Campos,259,134,125
34,Palencia,131,Población de Arroyo,76,40,36
34,Palencia,132,Población de Campos,145,77,68
34,Palencia,133,Población de Cerrato,125,68,57
34,Palencia,134,Polentinos,67,33,34
34,Palencia,135,Pomar de Valdivia,513,273,240
34,Palencia,136,Poza de la Vega,249,134,115
34,Palencia,137,Pozo de Urama,35,19,16
34,Palencia,139,Prádanos de Ojeda,212,117,95
34,Palencia,140,Puebla de Valdavia (La),118,58,60
34,Palencia,141,Quintana del Puente,237,126,111
34,Palencia,143,Quintanilla de Onsoña,207,113,94
34,Palencia,146,Reinoso de Cerrato,66,39,27
34,Palencia,147,Renedo de la Vega,238,134,104
34,Palencia,149,Requena de Campos,28,11,17
34,Palencia,151,Respenda de la Peña,210,117,93
34,Palencia,152,Revenga de Campos,162,83,79
34,Palencia,154,Revilla de Collazos,80,44,36
34,Palencia,155,Ribas de Campos,181,94,87
34,Palencia,156,Riberos de la Cueza,75,45,30
34,Palencia,157,Saldaña,3109,1586,1523
34,Palencia,158,Salinas de Pisuerga,376,176,200
34,Palencia,159,San Cebrián de Campos,480,270,210
34,Palencia,160,San Cebrián de Mudá,153,72,81
34,Palencia,161,San Cristóbal de Boedo,28,17,11
34,Palencia,163,San Mamés de Campos,76,32,44
34,Palencia,165,San Román de la Cuba,93,48,45
34,Palencia,167,Santa Cecilia del Alcor,146,83,63
34,Palencia,168,Santa Cruz de Boedo,76,42,34
34,Palencia,169,Santervás de la Vega,526,291,235
34,Palencia,170,Santibáñez de Ecla,82,36,46
34,Palencia,171,Santibáñez de la Peña,1281,633,648
34,Palencia,174,Santoyo,250,127,123
34,Palencia,175,Serna (La),119,73,46
34,Palencia,177,Soto de Cerrato,194,109,85
34,Palencia,176,Sotobañado y Priorato,168,94,74
34,Palencia,178,Tabanera de Cerrato,128,71,57
34,Palencia,179,Tabanera de Valdavia,41,20,21
34,Palencia,180,Támara de Campos,88,46,42
34,Palencia,181,Tariego de Cerrato,535,279,256
34,Palencia,182,Torquemada,1059,552,507
34,Palencia,184,Torremormojón,54,29,25
34,Palencia,185,Triollo,71,40,31
34,Palencia,186,Valbuena de Pisuerga,60,34,26
34,Palencia,189,Valdeolmillos,67,37,30
34,Palencia,190,Valderrábano,57,32,25
34,Palencia,192,Valde-Ucieza,111,60,51
34,Palencia,196,Valle de Cerrato,101,54,47
34,Palencia,902,Valle del Retortillo,174,92,82
34,Palencia,199,Velilla del Río Carrión,1523,778,745
34,Palencia,23,Venta de Baños,6359,3157,3202
34,Palencia,201,Vertavillo,204,108,96
34,Palencia,93,Vid de Ojeda (La),119,70,49
34,Palencia,202,Villabasta de Valdavia,36,18,18
34,Palencia,204,Villacidaler,59,30,29
34,Palencia,205,Villaconancio,71,45,26
34,Palencia,206,Villada,1106,555,551
34,Palencia,208,Villaeles de Valdavia,74,41,33
34,Palencia,210,Villahán,117,63,54
34,Palencia,211,Villaherreros,242,119,123
34,Palencia,213,Villalaco,71,32,39
34,Palencia,214,Villalba de Guardo,211,112,99
34,Palencia,215,Villalcázar de Sirga,203,98,105
34,Palencia,216,Villalcón,75,37,38
34,Palencia,217,Villalobón,1069,558,511
34,Palencia,218,Villaluenga de la Vega,623,353,270
34,Palencia,220,Villamartín de Campos,153,87,66
34,Palencia,221,Villamediana,202,106,96
34,Palencia,222,Villameriel,130,74,56
34,Palencia,223,Villamoronta,297,169,128
34,Palencia,224,Villamuera de la Cueza,63,36,27
34,Palencia,225,Villamuriel de Cerrato,6010,3119,2891
34,Palencia,227,Villanueva del Rebollar,103,56,47
34,Palencia,228,Villanuño de Valdavia,111,63,48
34,Palencia,229,Villaprovedo,75,47,28
34,Palencia,230,Villarmentero de Campos,13,10,3
34,Palencia,231,Villarrabé,274,137,137
34,Palencia,232,Villarramiel,974,508,466
34,Palencia,233,Villasarracino,195,103,92
34,Palencia,234,Villasila de Valdavia,74,51,23
34,Palencia,236,Villaturde,203,97,106
34,Palencia,237,Villaumbrales,786,399,387
34,Palencia,238,Villaviudas,388,182,206
34,Palencia,240,Villerías de Campos,112,64,48
34,Palencia,241,Villodre,29,19,10
34,Palencia,242,Villodrigo,135,69,66
34,Palencia,243,Villoldo,422,225,197
34,Palencia,245,Villota del Páramo,380,223,157
34,Palencia,246,Villovieco,95,49,46
35,Palmas (Las),1,Agaete,5765,2930,2835
35,Palmas (Las),2,Agüimes,28224,14443,13781
35,Palmas (Las),20,Aldea de San Nicolás (La),8403,4241,4162
35,Palmas (Las),3,Antigua,9715,5302,4413
35,Palmas (Las),4,Arrecife,59040,30553,28487
35,Palmas (Las),5,Artenara,1301,698,603
35,Palmas (Las),6,Arucas,35542,17829,17713
35,Palmas (Las),7,Betancuria,715,361,354
35,Palmas (Las),8,Firgas,7424,3806,3618
35,Palmas (Las),9,Gáldar,23951,12027,11924
35,Palmas (Las),10,Haría,5188,2712,2476
35,Palmas (Las),11,Ingenio,28809,14702,14107
35,Palmas (Las),12,Mogán,20391,10722,9669
35,Palmas (Las),13,Moya,8071,4087,3984
35,Palmas (Las),14,Oliva (La),21354,11578,9776
35,Palmas (Las),15,Pájara,20283,11164,9119
35,Palmas (Las),16,Palmas de Gran Canaria (Las),381123,185770,195353
35,Palmas (Las),17,Puerto del Rosario,35293,18487,16806
35,Palmas (Las),18,San Bartolomé,18300,9465,8835
35,Palmas (Las),19,San Bartolomé de Tirajana,51260,26831,24429
35,Palmas (Las),21,Santa Brígida,19042,9494,9548
35,Palmas (Las),22,Santa Lucía de Tirajana,61325,31090,30235
35,Palmas (Las),23,Santa María de Guía de Gran Canaria,14146,7069,7077
35,Palmas (Las),24,Teguise,18798,9605,9193
35,Palmas (Las),25,Tejeda,2206,1170,1036
35,Palmas (Las),26,Telde,99201,49435,49766
35,Palmas (Las),27,Teror,12818,6548,6270
35,Palmas (Las),28,Tías,19487,10083,9404
35,Palmas (Las),29,Tinajo,5746,3040,2706
35,Palmas (Las),30,Tuineje,13569,7134,6435
35,Palmas (Las),32,Valleseco,4022,2127,1895
35,Palmas (Las),31,Valsequillo de Gran Canaria,8987,4575,4412
35,Palmas (Las),33,Vega de San Mateo,7586,3915,3671
35,Palmas (Las),34,Yaiza,12947,7112,5835
36,Pontevedra,20,Agolada,3176,1560,1616
36,Pontevedra,1,Arbo,3877,1915,1962
36,Pontevedra,3,Baiona,11976,5946,6030
36,Pontevedra,2,Barro,3498,1722,1776
36,Pontevedra,4,Bueu,12375,6090,6285
36,Pontevedra,5,Caldas de Reis,9975,4848,5127
36,Pontevedra,6,Cambados,13620,6667,6953
36,Pontevedra,7,Campo Lameiro,2113,1008,1105
36,Pontevedra,8,Cangas,25537,12681,12856
36,Pontevedra,9,Cañiza (A),6651,3233,3418
36,Pontevedra,10,Catoira,3485,1689,1796
36,Pontevedra,11,Cerdedo,2350,1092,1258
36,Pontevedra,12,Cotobade,4517,2118,2399
36,Pontevedra,13,Covelo,3457,1672,1785
36,Pontevedra,14,Crecente,2652,1254,1398
36,Pontevedra,15,Cuntis,5172,2420,2752
36,Pontevedra,16,Dozón,1864,916,948
36,Pontevedra,17,Estrada (A),21886,10399,11487
36,Pontevedra,18,Forcarei,4336,2036,2300
36,Pontevedra,19,Fornelos de Montes,1991,933,1058
36,Pontevedra,21,Gondomar,13713,6751,6962
36,Pontevedra,22,Grove (O),11264,5556,5708
36,Pontevedra,23,Guarda (A),10404,5060,5344
36,Pontevedra,901,Illa de Arousa (A),4928,2438,2490
36,Pontevedra,24,Lalín,21130,10308,10822
36,Pontevedra,25,Lama (A),3014,1409,1605
36,Pontevedra,26,Marín,25879,12943,12936
36,Pontevedra,27,Meaño,5475,2658,2817
36,Pontevedra,28,Meis,4977,2372,2605
36,Pontevedra,29,Moaña,18709,9163,9546
36,Pontevedra,30,Mondariz,5328,2539,2789
36,Pontevedra,31,Mondariz-Balneario,736,366,370
36,Pontevedra,32,Moraña,4349,2085,2264
36,Pontevedra,33,Mos,14504,7106,7398
36,Pontevedra,34,Neves (As),4471,2185,2286
36,Pontevedra,35,Nigrán,17869,8873,8996
36,Pontevedra,36,Oia,3192,1634,1558
36,Pontevedra,37,Pazos de Borbén,3178,1493,1685
36,Pontevedra,41,Poio,15842,7806,8036
36,Pontevedra,43,Ponte Caldelas,6469,3150,3319
36,Pontevedra,42,Ponteareas,22750,11160,11590
36,Pontevedra,44,Pontecesures,3116,1548,1568
36,Pontevedra,38,Pontevedra,80749,38469,42280
36,Pontevedra,39,Porriño (O),17114,8425,8689
36,Pontevedra,40,Portas,3089,1450,1639
36,Pontevedra,45,Redondela,30036,14653,15383
36,Pontevedra,46,Ribadumia,4781,2282,2499
36,Pontevedra,47,Rodeiro,3194,1628,1566
36,Pontevedra,48,Rosal (O),6462,3193,3269
36,Pontevedra,49,Salceda de Caselas,7938,4017,3921
36,Pontevedra,50,Salvaterra de Miño,9140,4596,4544
36,Pontevedra,51,Sanxenxo,17216,8459,8757
36,Pontevedra,52,Silleda,9166,4476,4690
36,Pontevedra,53,Soutomaior,6537,3200,3337
36,Pontevedra,54,Tomiño,12982,6519,6463
36,Pontevedra,55,Tui,16972,8121,8851
36,Pontevedra,56,Valga,6096,2987,3109
36,Pontevedra,57,Vigo,295703,140870,154833
36,Pontevedra,59,Vila de Cruces,6513,3225,3288
36,Pontevedra,58,Vilaboa,5935,2895,3040
36,Pontevedra,60,Vilagarcía de Arousa,37329,18037,19292
36,Pontevedra,61,Vilanova de Arousa,10643,5165,5478
37,Salamanca,1,Abusejo,244,125,119
37,Salamanca,2,Agallas,165,89,76
37,Salamanca,3,Ahigal de los Aceiteros,159,80,79
37,Salamanca,4,Ahigal de Villarino,45,22,23
37,Salamanca,5,Alameda de Gardón (La),108,52,56
37,Salamanca,6,Alamedilla (La),192,98,94
37,Salamanca,7,Alaraz,582,307,275
37,Salamanca,8,Alba de Tormes,5242,2605,2637
37,Salamanca,9,Alba de Yeltes,254,129,125
37,Salamanca,10,Alberca (La),1177,588,589
37,Salamanca,11,Alberguería de Argañán (La),164,87,77
37,Salamanca,12,Alconada,190,102,88
37,Salamanca,15,Aldea del Obispo,340,178,162
37,Salamanca,13,Aldeacipreste,152,83,69
37,Salamanca,14,Aldeadávila de la Ribera,1391,718,673
37,Salamanca,16,Aldealengua,640,322,318
37,Salamanca,17,Aldeanueva de Figueroa,306,152,154
37,Salamanca,18,Aldeanueva de la Sierra,107,56,51
37,Salamanca,19,Aldearrodrigo,171,92,79
37,Salamanca,20,Aldearrubia,530,280,250
37,Salamanca,21,Aldeaseca de Alba,94,43,51
37,Salamanca,22,Aldeaseca de la Frontera,325,176,149
37,Salamanca,23,Aldeatejada,1192,598,594
37,Salamanca,24,Aldeavieja de Tormes,117,58,59
37,Salamanca,25,Aldehuela de la Bóveda,330,166,164
37,Salamanca,26,Aldehuela de Yeltes,244,130,114
37,Salamanca,27,Almenara de Tormes,288,153,135
37,Salamanca,28,Almendra,193,107,86
37,Salamanca,29,Anaya de Alba,259,142,117
37,Salamanca,30,Añover de Tormes,101,56,45
37,Salamanca,31,Arabayona de Mógica,455,243,212
37,Salamanca,32,Arapiles,507,260,247
37,Salamanca,33,Arcediano,94,47,47
37,Salamanca,34,Arco (El),111,62,49
37,Salamanca,35,Armenteros,493,264,229
37,Salamanca,37,Atalaya (La),141,82,59
37,Salamanca,38,Babilafuente,935,489,446
37,Salamanca,39,Bañobárez,370,189,181
37,Salamanca,40,Barbadillo,494,249,245
37,Salamanca,41,Barbalos,97,54,43
37,Salamanca,42,Barceo,59,30,29
37,Salamanca,44,Barruecopardo,493,256,237
37,Salamanca,45,Bastida (La),30,17,13
37,Salamanca,46,Béjar,15110,7188,7922
37,Salamanca,47,Beleña,160,80,80
37,Salamanca,49,Bermellar,177,84,93
37,Salamanca,50,Berrocal de Huebra,88,46,42
37,Salamanca,51,Berrocal de Salvatierra,99,48,51
37,Salamanca,52,Boada,333,165,168
37,Salamanca,54,Bodón (El),324,167,157
37,Salamanca,55,Bogajo,172,94,78
37,Salamanca,56,Bouza (La),69,36,33
37,Salamanca,57,Bóveda del Río Almar,262,141,121
37,Salamanca,58,Brincones,76,38,38
37,Salamanca,59,Buenamadre,153,87,66
37,Salamanca,60,Buenavista,188,101,87
37,Salamanca,61,Cabaco (El),305,152,153
37,Salamanca,63,Cabeza de Béjar (La),91,47,44
37,Salamanca,65,Cabeza del Caballo,421,216,205
37,Salamanca,62,Cabezabellosa de la Calzada,105,57,48
37,Salamanca,67,Cabrerizos,3641,1838,1803
37,Salamanca,68,Cabrillas,464,233,231
37,Salamanca,69,Calvarrasa de Abajo,1088,556,532
37,Salamanca,70,Calvarrasa de Arriba,663,341,322
37,Salamanca,71,Calzada de Béjar (La),93,50,43
37,Salamanca,72,Calzada de Don Diego,207,107,100
37,Salamanca,73,Calzada de Valdunciel,643,338,305
37,Salamanca,74,Campillo de Azaba,205,103,102
37,Salamanca,77,Campo de Peñaranda (El),316,169,147
37,Salamanca,78,Candelario,993,491,502
37,Salamanca,79,Canillas de Abajo,94,59,35
37,Salamanca,80,Cantagallo,259,133,126
37,Salamanca,81,Cantalapiedra,1150,582,568
37,Salamanca,82,Cantalpino,1037,575,462
37,Salamanca,83,Cantaracillo,227,123,104
37,Salamanca,85,Carbajosa de la Sagrada,5171,2673,2498
37,Salamanca,86,Carpio de Azaba,122,70,52
37,Salamanca,87,Carrascal de Barregas,769,404,365
37,Salamanca,88,Carrascal del Obispo,233,124,109
37,Salamanca,89,Casafranca,81,38,43
37,Salamanca,90,Casas del Conde (Las),76,40,36
37,Salamanca,91,Casillas de Flores,210,104,106
37,Salamanca,92,Castellanos de Moriscos,1213,612,601
37,Salamanca,185,Castellanos de Villiquera,689,364,325
37,Salamanca,96,Castillejo de Martín Viejo,282,155,127
37,Salamanca,97,Castraz,59,33,26
37,Salamanca,98,Cepeda,417,203,214
37,Salamanca,99,Cereceda de la Sierra,121,60,61
37,Salamanca,100,Cerezal de Peñahorcada,99,57,42
37,Salamanca,101,Cerralbo,224,118,106
37,Salamanca,102,Cerro (El),509,267,242
37,Salamanca,103,Cespedosa de Tormes,590,326,264
37,Salamanca,114,Chagarcía Medianero,112,61,51
37,Salamanca,104,Cilleros de la Bastida,38,21,17
37,Salamanca,106,Cipérez,334,166,168
37,Salamanca,107,Ciudad Rodrigo,13975,6777,7198
37,Salamanca,108,Coca de Alba,133,64,69
37,Salamanca,109,Colmenar de Montemayor,215,121,94
37,Salamanca,110,Cordovilla,133,76,57
37,Salamanca,112,Cristóbal,199,104,95
37,Salamanca,113,Cubo de Don Sancho (El),508,265,243
37,Salamanca,115,Dios le Guarde,173,95,78
37,Salamanca,116,Doñinos de Ledesma,82,39,43
37,Salamanca,117,Doñinos de Salamanca,1284,665,619
37,Salamanca,118,Ejeme,166,88,78
37,Salamanca,119,Encina (La),127,72,55
37,Salamanca,120,Encina de San Silvestre,129,64,65
37,Salamanca,121,Encinas de Abajo,631,323,308
37,Salamanca,122,Encinas de Arriba,267,128,139
37,Salamanca,123,Encinasola de los Comendadores,235,124,111
37,Salamanca,124,Endrinal,274,149,125
37,Salamanca,125,Escurial de la Sierra,291,155,136
37,Salamanca,126,Espadaña,40,22,18
37,Salamanca,127,Espeja,282,143,139
37,Salamanca,128,Espino de la Orbada,308,160,148
37,Salamanca,129,Florida de Liébana,281,153,128
37,Salamanca,130,Forfoleda,218,112,106
37,Salamanca,131,Frades de la Sierra,233,124,109
37,Salamanca,132,Fregeneda (La),432,213,219
37,Salamanca,133,Fresnedoso,120,66,54
37,Salamanca,134,Fresno Alhándiga,280,147,133
37,Salamanca,135,Fuente de San Esteban (La),1433,733,700
37,Salamanca,136,Fuenteguinaldo,806,416,390
37,Salamanca,137,Fuenteliante,141,67,74
37,Salamanca,138,Fuenterroble de Salvatierra,262,134,128
37,Salamanca,139,Fuentes de Béjar,256,124,132
37,Salamanca,140,Fuentes de Oñoro,1298,636,662
37,Salamanca,141,Gajates,172,81,91
37,Salamanca,142,Galindo y Perahuy,641,369,272
37,Salamanca,143,Galinduste,506,248,258
37,Salamanca,144,Galisancho,441,237,204
37,Salamanca,145,Gallegos de Argañán,346,184,162
37,Salamanca,146,Gallegos de Solmirón,160,80,80
37,Salamanca,147,Garcibuey,226,125,101
37,Salamanca,148,Garcihernández,544,278,266
37,Salamanca,149,Garcirrey,90,47,43
37,Salamanca,150,Gejuelo del Barro,46,27,19
37,Salamanca,151,Golpejas,187,95,92
37,Salamanca,152,Gomecello,578,309,269
37,Salamanca,154,Guadramiro,176,103,73
37,Salamanca,155,Guijo de Ávila,105,62,43
37,Salamanca,156,Guijuelo,5840,3021,2819
37,Salamanca,157,Herguijuela de Ciudad Rodrigo,119,66,53
37,Salamanca,158,Herguijuela de la Sierra,300,161,139
37,Salamanca,159,Herguijuela del Campo,112,52,60
37,Salamanca,160,Hinojosa de Duero,756,388,368
37,Salamanca,161,Horcajo de Montemayor,181,92,89
37,Salamanca,162,Horcajo Medianero,291,153,138
37,Salamanca,163,Hoya (La),30,20,10
37,Salamanca,164,Huerta,313,178,135
37,Salamanca,165,Iruelos,46,19,27
37,Salamanca,166,Ituero de Azaba,250,137,113
37,Salamanca,167,Juzbado,182,94,88
37,Salamanca,168,Lagunilla,531,286,245
37,Salamanca,169,Larrodrigo,262,146,116
37,Salamanca,170,Ledesma,1889,953,936
37,Salamanca,171,Ledrada,568,290,278
37,Salamanca,172,Linares de Riofrío,1003,514,489
37,Salamanca,173,Lumbrales,1981,973,1008
37,Salamanca,175,Machacón,501,260,241
37,Salamanca,174,Macotera,1412,737,675
37,Salamanca,176,Madroñal,163,90,73
37,Salamanca,177,Maíllo (El),351,182,169
37,Salamanca,178,Malpartida,117,69,48
37,Salamanca,179,Mancera de Abajo,271,141,130
37,Salamanca,180,Manzano (El),85,45,40
37,Salamanca,181,Martiago,342,174,168
37,Salamanca,183,Martín de Yeltes,488,248,240
37,Salamanca,182,Martinamor,87,49,38
37,Salamanca,184,Masueco,391,198,193
37,Salamanca,186,Mata de Ledesma (La),123,64,59
37,Salamanca,187,Matilla de los Caños del Río,671,344,327
37,Salamanca,188,Maya (La),218,129,89
37,Salamanca,189,Membribe de la Sierra,149,93,56
37,Salamanca,190,Mieza,280,143,137
37,Salamanca,191,Milano (El),139,77,62
37,Salamanca,192,Miranda de Azán,438,228,210
37,Salamanca,193,Miranda del Castañar,538,274,264
37,Salamanca,194,Mogarraz,316,168,148
37,Salamanca,195,Molinillo,71,38,33
37,Salamanca,196,Monforte de la Sierra,101,56,45
37,Salamanca,197,Monleón,111,62,49
37,Salamanca,198,Monleras,257,124,133
37,Salamanca,199,Monsagro,182,103,79
37,Salamanca,200,Montejo,229,117,112
37,Salamanca,201,Montemayor del Río,319,163,156
37,Salamanca,202,Monterrubio de Armuña,1074,571,503
37,Salamanca,203,Monterrubio de la Sierra,173,97,76
37,Salamanca,204,Morasverdes,341,175,166
37,Salamanca,205,Morille,255,131,124
37,Salamanca,206,Moríñigo,119,61,58
37,Salamanca,207,Moriscos,151,73,78
37,Salamanca,208,Moronta,107,57,50
37,Salamanca,209,Mozárbez,448,240,208
37,Salamanca,211,Narros de Matalayegua,254,134,120
37,Salamanca,213,Nava de Béjar,113,60,53
37,Salamanca,214,Nava de Francia,148,80,68
37,Salamanca,215,Nava de Sotrobal,197,111,86
37,Salamanca,212,Navacarros,132,76,56
37,Salamanca,216,Navales,356,199,157
37,Salamanca,217,Navalmoral de Béjar,53,23,30
37,Salamanca,218,Navamorales,97,59,38
37,Salamanca,219,Navarredonda de la Rinconada,229,116,113
37,Salamanca,221,Navasfrías,550,286,264
37,Salamanca,222,Negrilla de Palencia,130,64,66
37,Salamanca,223,Olmedo de Camaces,146,72,74
37,Salamanca,224,Orbada (La),256,130,126
37,Salamanca,225,Pajares de la Laguna,143,75,68
37,Salamanca,226,Palacios del Arzobispo,193,98,95
37,Salamanca,228,Palaciosrubios,467,252,215
37,Salamanca,229,Palencia de Negrilla,177,97,80
37,Salamanca,230,Parada de Arriba,287,153,134
37,Salamanca,231,Parada de Rubiales,337,177,160
37,Salamanca,232,Paradinas de San Juan,531,298,233
37,Salamanca,233,Pastores,60,33,27
37,Salamanca,234,Payo (El),406,201,205
37,Salamanca,235,Pedraza de Alba,273,141,132
37,Salamanca,236,Pedrosillo de Alba,181,98,83
37,Salamanca,237,Pedrosillo de los Aires,384,212,172
37,Salamanca,238,Pedrosillo el Ralo,141,73,68
37,Salamanca,239,Pedroso de la Armuña (El),280,136,144
37,Salamanca,240,Pelabravo,956,497,459
37,Salamanca,241,Pelarrodríguez,180,104,76
37,Salamanca,242,Pelayos,122,65,57
37,Salamanca,243,Peña (La),145,68,77
37,Salamanca,244,Peñacaballera,172,83,89
37,Salamanca,245,Peñaparda,431,224,207
37,Salamanca,246,Peñaranda de Bracamonte,6685,3313,3372
37,Salamanca,247,Peñarandilla,239,127,112
37,Salamanca,248,Peralejos de Abajo,191,99,92
37,Salamanca,249,Peralejos de Arriba,53,33,20
37,Salamanca,250,Pereña de la Ribera,432,231,201
37,Salamanca,251,Peromingo,146,67,79
37,Salamanca,252,Pinedas,158,86,72
37,Salamanca,253,Pino de Tormes (El),163,87,76
37,Salamanca,254,Pitiegua,221,119,102
37,Salamanca,255,Pizarral,78,44,34
37,Salamanca,256,Poveda de las Cintas,286,162,124
37,Salamanca,257,Pozos de Hinojo,64,34,30
37,Salamanca,258,Puebla de Azaba,224,118,106
37,Salamanca,259,Puebla de San Medel,48,28,20
37,Salamanca,260,Puebla de Yeltes,192,102,90
37,Salamanca,261,Puente del Congosto,270,143,127
37,Salamanca,262,Puertas,83,47,36
37,Salamanca,263,Puerto de Béjar,399,193,206
37,Salamanca,264,Puerto Seguro,90,48,42
37,Salamanca,265,Rágama,264,136,128
37,Salamanca,266,Redonda (La),91,49,42
37,Salamanca,267,Retortillo,249,122,127
37,Salamanca,268,Rinconada de la Sierra (La),158,87,71
37,Salamanca,269,Robleda,539,283,256
37,Salamanca,270,Robliza de Cojos,232,120,112
37,Salamanca,271,Rollán,491,253,238
37,Salamanca,272,Saelices el Chico,152,76,76
37,Salamanca,273,Sagrada (La),155,80,75
37,Salamanca,303,Sahugo (El),262,137,125
37,Salamanca,274,Salamanca,155740,72154,83586
37,Salamanca,275,Saldeana,138,79,59
37,Salamanca,276,Salmoral,235,128,107
37,Salamanca,277,Salvatierra de Tormes,64,32,32
37,Salamanca,278,San Cristóbal de la Cuesta,710,393,317
37,Salamanca,284,San Esteban de la Sierra,380,190,190
37,Salamanca,285,San Felices de los Gallegos,553,283,270
37,Salamanca,286,San Martín del Castañar,280,152,128
37,Salamanca,287,San Miguel de Valero,376,192,184
37,Salamanca,36,San Miguel del Robledo,90,37,53
37,Salamanca,288,San Morales,257,149,108
37,Salamanca,289,San Muñoz,297,154,143
37,Salamanca,291,San Pedro de Rozados,325,164,161
37,Salamanca,290,San Pedro del Valle,137,73,64
37,Salamanca,292,San Pelayo de Guareña,108,55,53
37,Salamanca,280,Sanchón de la Ribera,103,51,52
37,Salamanca,281,Sanchón de la Sagrada,42,22,20
37,Salamanca,282,Sanchotello,260,130,130
37,Salamanca,279,Sancti-Spíritus,951,486,465
37,Salamanca,283,Sando,166,91,75
37,Salamanca,293,Santa María de Sando,137,69,68
37,Salamanca,294,Santa Marta de Tormes,14315,7189,7126
37,Salamanca,296,Santiago de la Puebla,446,233,213
37,Salamanca,297,Santibáñez de Béjar,571,290,281
37,Salamanca,298,Santibáñez de la Sierra,242,122,120
37,Salamanca,299,Santiz,282,145,137
37,Salamanca,300,Santos (Los),670,351,319
37,Salamanca,301,Sardón de los Frailes,105,58,47
37,Salamanca,302,Saucelle,377,193,184
37,Salamanca,304,Sepulcro-Hilario,218,117,101
37,Salamanca,305,Sequeros,228,109,119
37,Salamanca,306,Serradilla del Arroyo,378,192,186
37,Salamanca,307,Serradilla del Llano,198,99,99
37,Salamanca,309,Sierpe (La),48,30,18
37,Salamanca,310,Sieteiglesias de Tormes,185,84,101
37,Salamanca,311,Sobradillo,286,148,138
37,Salamanca,312,Sorihuela,364,180,184
37,Salamanca,313,Sotoserrano,664,344,320
37,Salamanca,314,Tabera de Abajo,103,57,46
37,Salamanca,315,Tala (La),120,66,54
37,Salamanca,316,Tamames,982,500,482
37,Salamanca,317,Tarazona de Guareña,376,203,173
37,Salamanca,318,Tardáguila,240,131,109
37,Salamanca,319,Tejado (El),144,77,67
37,Salamanca,320,Tejeda y Segoyuela,122,67,55
37,Salamanca,321,Tenebrón,181,88,93
37,Salamanca,322,Terradillos,3430,1774,1656
37,Salamanca,323,Topas,658,338,320
37,Salamanca,324,Tordillos,477,255,222
37,Salamanca,325,Tornadizo (El),118,61,57
37,Salamanca,327,Torresmenudas,201,104,97
37,Salamanca,328,Trabanca,244,126,118
37,Salamanca,329,Tremedal de Tormes,40,21,19
37,Salamanca,330,Valdecarros,393,205,188
37,Salamanca,331,Valdefuentes de Sangusín,280,149,131
37,Salamanca,332,Valdehijaderos,94,48,46
37,Salamanca,333,Valdelacasa,287,156,131
37,Salamanca,334,Valdelageve,96,49,47
37,Salamanca,335,Valdelosa,527,245,282
37,Salamanca,336,Valdemierque,52,28,24
37,Salamanca,337,Valderrodrigo,166,82,84
37,Salamanca,338,Valdunciel,104,54,50
37,Salamanca,339,Valero,398,205,193
37,Salamanca,343,Vallejera de Riofrío,63,31,32
37,Salamanca,340,Valsalabroso,174,99,75
37,Salamanca,341,Valverde de Valdelacasa,75,43,32
37,Salamanca,342,Valverdón,273,142,131
37,Salamanca,344,Vecinos,324,166,158
37,Salamanca,345,Vega de Tirados,216,107,109
37,Salamanca,346,Veguillas (Las),283,135,148
37,Salamanca,347,Vellés (La),525,287,238
37,Salamanca,348,Ventosa del Río Almar,138,74,64
37,Salamanca,349,Vídola (La),157,74,83
37,Salamanca,351,Villaflores,362,182,180
37,Salamanca,352,Villagonzalo de Tormes,204,112,92
37,Salamanca,353,Villalba de los Llanos,169,96,73
37,Salamanca,354,Villamayor,6045,3058,2987
37,Salamanca,355,Villanueva del Conde,190,101,89
37,Salamanca,356,Villar de Argañán,95,47,48
37,Salamanca,357,Villar de Ciervo,331,176,155
37,Salamanca,358,Villar de Gallimazo,183,94,89
37,Salamanca,359,Villar de la Yegua,219,115,104
37,Salamanca,360,Villar de Peralonso,312,144,168
37,Salamanca,361,Villar de Samaniego,108,56,52
37,Salamanca,362,Villares de la Reina,5219,2615,2604
37,Salamanca,363,Villares de Yeltes,139,67,72
37,Salamanca,364,Villarino de los Aires,999,508,491
37,Salamanca,365,Villarmayor,217,118,99
37,Salamanca,366,Villarmuerto,48,32,16
37,Salamanca,367,Villasbuenas,247,134,113
37,Salamanca,368,Villasdardo,18,7,11
37,Salamanca,369,Villaseco de los Gamitos,183,102,81
37,Salamanca,370,Villaseco de los Reyes,399,231,168
37,Salamanca,371,Villasrubias,266,147,119
37,Salamanca,372,Villaverde de Guareña,183,94,89
37,Salamanca,373,Villavieja de Yeltes,972,487,485
37,Salamanca,374,Villoria,1431,717,714
37,Salamanca,375,Villoruela,998,508,490
37,Salamanca,350,Vilvestre,512,257,255
37,Salamanca,376,Vitigudino,2899,1447,1452
37,Salamanca,377,Yecla de Yeltes,313,165,148
37,Salamanca,378,Zamarra,129,70,59
37,Salamanca,379,Zamayón,178,102,76
37,Salamanca,380,Zarapicos,64,34,30
37,Salamanca,381,Zarza de Pumareda (La),158,87,71
37,Salamanca,382,Zorita de la Frontera,240,129,111
38,Santa Cruz de Tenerife,1,Adeje,41002,21235,19767
38,Santa Cruz de Tenerife,2,Agulo,1187,589,598
38,Santa Cruz de Tenerife,3,Alajeró,2146,1167,979
38,Santa Cruz de Tenerife,4,Arafo,5346,2603,2743
38,Santa Cruz de Tenerife,5,Arico,7698,3946,3752
38,Santa Cruz de Tenerife,6,Arona,75903,39479,36424
38,Santa Cruz de Tenerife,7,Barlovento,2387,1217,1170
38,Santa Cruz de Tenerife,8,Breña Alta,7279,3610,3669
38,Santa Cruz de Tenerife,9,Breña Baja,4952,2540,2412
38,Santa Cruz de Tenerife,10,Buenavista del Norte,5227,2660,2567
38,Santa Cruz de Tenerife,11,Candelaria,23394,11543,11851
38,Santa Cruz de Tenerife,12,Fasnia,2805,1437,1368
38,Santa Cruz de Tenerife,13,Frontera,3941,2005,1936
38,Santa Cruz de Tenerife,14,Fuencaliente de la Palma,1925,971,954
38,Santa Cruz de Tenerife,15,Garachico,5450,2719,2731
38,Santa Cruz de Tenerife,16,Garafía,1829,932,897
38,Santa Cruz de Tenerife,17,Granadilla de Abona,38866,20022,18844
38,Santa Cruz de Tenerife,18,Guancha (La),5447,2664,2783
38,Santa Cruz de Tenerife,19,Guía de Isora,20004,10081,9923
38,Santa Cruz de Tenerife,20,Güímar,17253,8480,8773
38,Santa Cruz de Tenerife,21,Hermigua,2178,1097,1081
38,Santa Cruz de Tenerife,22,Icod de los Vinos,24087,11954,12133
38,Santa Cruz de Tenerife,24,Llanos de Aridane (Los),20525,10103,10422
38,Santa Cruz de Tenerife,25,Matanza de Acentejo (La),8245,4183,4062
38,Santa Cruz de Tenerife,26,Orotava (La),40945,20252,20693
38,Santa Cruz de Tenerife,27,Paso (El),7698,3897,3801
38,Santa Cruz de Tenerife,901,Pinar de El Hierro (El),1874,944,930
38,Santa Cruz de Tenerife,28,Puerto de la Cruz,31804,15476,16328
38,Santa Cruz de Tenerife,29,Puntagorda,1955,990,965
38,Santa Cruz de Tenerife,30,Puntallana,2423,1211,1212
38,Santa Cruz de Tenerife,31,Realejos (Los),37385,18522,18863
38,Santa Cruz de Tenerife,32,Rosario (El),17064,8854,8210
38,Santa Cruz de Tenerife,33,San Andrés y Sauces,4972,2523,2449
38,Santa Cruz de Tenerife,23,San Cristóbal de La Laguna,148375,72890,75485
38,Santa Cruz de Tenerife,34,San Juan de la Rambla,5053,2501,2552
38,Santa Cruz de Tenerife,35,San Miguel de Abona,15037,7692,7345
38,Santa Cruz de Tenerife,36,San Sebastián de la Gomera,8744,4431,4313
38,Santa Cruz de Tenerife,37,Santa Cruz de la Palma,17132,8393,8739
38,Santa Cruz de Tenerife,38,Santa Cruz de Tenerife,221956,106858,115098
38,Santa Cruz de Tenerife,39,Santa Úrsula,13835,6910,6925
38,Santa Cruz de Tenerife,40,Santiago del Teide,11825,5955,5870
38,Santa Cruz de Tenerife,41,Sauzal (El),8947,4449,4498
38,Santa Cruz de Tenerife,42,Silos (Los),5307,2671,2636
38,Santa Cruz de Tenerife,43,Tacoronte,23369,11677,11692
38,Santa Cruz de Tenerife,44,Tanque (El),3031,1493,1538
38,Santa Cruz de Tenerife,45,Tazacorte,5786,2911,2875
38,Santa Cruz de Tenerife,46,Tegueste,10613,5257,5356
38,Santa Cruz de Tenerife,47,Tijarafe,2757,1412,1345
38,Santa Cruz de Tenerife,49,Valle Gran Rey,5220,2637,2583
38,Santa Cruz de Tenerife,50,Vallehermoso,3147,1597,1550
38,Santa Cruz de Tenerife,48,Valverde,4938,2524,2414
38,Santa Cruz de Tenerife,51,Victoria de Acentejo (La),8909,4438,4471
38,Santa Cruz de Tenerife,52,Vilaflor,1851,947,904
38,Santa Cruz de Tenerife,53,Villa de Mazo,4908,2483,2425
39,Cantabria,1,Alfoz de Lloredo,2502,1276,1226
39,Cantabria,2,Ampuero,4052,2063,1989
39,Cantabria,3,Anievas,361,181,180
39,Cantabria,4,Arenas de Iguña,1830,943,887
39,Cantabria,5,Argoños,1614,854,760
39,Cantabria,6,Arnuero,2141,1092,1049
39,Cantabria,7,Arredondo,532,304,228
39,Cantabria,8,Astillero (El),17065,8311,8754
39,Cantabria,9,Bárcena de Cicero,3613,1874,1739
39,Cantabria,10,Bárcena de Pie de Concha,787,385,402
39,Cantabria,11,Bareyo,2003,1019,984
39,Cantabria,12,Cabezón de la Sal,8234,4033,4201
39,Cantabria,13,Cabezón de Liébana,685,409,276
39,Cantabria,14,Cabuérniga,1083,570,513
39,Cantabria,15,Camaleño,1113,578,535
39,Cantabria,16,Camargo,31086,15525,15561
39,Cantabria,27,Campoo de Enmedio,3862,1989,1873
39,Cantabria,17,Campoo de Yuso,715,382,333
39,Cantabria,18,Cartes,4761,2426,2335
39,Cantabria,19,Castañeda,1917,973,944
39,Cantabria,20,Castro-Urdiales,30814,15690,15124
39,Cantabria,21,Cieza,634,318,316
39,Cantabria,22,Cillorigo de Liébana,1290,713,577
39,Cantabria,23,Colindres,7677,3821,3856
39,Cantabria,24,Comillas,2483,1162,1321
39,Cantabria,25,Corrales de Buelna (Los),11513,5749,5764
39,Cantabria,26,Corvera de Toranzo,2202,1116,1086
39,Cantabria,28,Entrambasaguas,3496,1785,1711
39,Cantabria,29,Escalante,782,418,364
39,Cantabria,30,Guriezo,2244,1177,1067
39,Cantabria,31,Hazas de Cesto,1347,689,658
39,Cantabria,32,Hermandad de Campoo de Suso,1931,1061,870
39,Cantabria,33,Herrerías,669,383,286
39,Cantabria,34,Lamasón,319,199,120
39,Cantabria,35,Laredo,12648,6131,6517
39,Cantabria,36,Liendo,1177,616,561
39,Cantabria,37,Liérganes,2464,1241,1223
39,Cantabria,38,Limpias,1648,857,791
39,Cantabria,39,Luena,758,410,348
39,Cantabria,40,Marina de Cudeyo,5254,2654,2600
39,Cantabria,41,Mazcuerras,2053,1063,990
39,Cantabria,42,Medio Cudeyo,7393,3663,3730
39,Cantabria,43,Meruelo,1564,809,755
39,Cantabria,44,Miengo,4296,2206,2090
39,Cantabria,45,Miera,455,240,215
39,Cantabria,46,Molledo,1730,849,881
39,Cantabria,47,Noja,2555,1286,1269
39,Cantabria,48,Penagos,1766,893,873
39,Cantabria,49,Peñarrubia,365,185,180
39,Cantabria,50,Pesaguero,344,195,149
39,Cantabria,51,Pesquera,69,37,32
39,Cantabria,52,Piélagos,18934,9575,9359
39,Cantabria,53,Polaciones,272,180,92
39,Cantabria,54,Polanco,4515,2272,2243
39,Cantabria,55,Potes,1511,748,763
39,Cantabria,56,Puente Viesgo,2685,1361,1324
39,Cantabria,57,Ramales de la Victoria,2489,1294,1195
39,Cantabria,58,Rasines,1063,578,485
39,Cantabria,59,Reinosa,10208,4875,5333
39,Cantabria,60,Reocín,8120,4023,4097
39,Cantabria,61,Ribamontán al Mar,4310,2217,2093
39,Cantabria,62,Ribamontán al Monte,2081,1060,1021
39,Cantabria,63,Rionansa,1144,651,493
39,Cantabria,64,Riotuerto,1612,799,813
39,Cantabria,65,Rozas de Valdearroyo (Las),300,171,129
39,Cantabria,66,Ruente,1003,547,456
39,Cantabria,67,Ruesga,1113,587,526
39,Cantabria,68,Ruiloba,769,395,374
39,Cantabria,69,San Felices de Buelna,2309,1155,1154
39,Cantabria,70,San Miguel de Aguayo,153,77,76
39,Cantabria,71,San Pedro del Romeral,548,299,249
39,Cantabria,72,San Roque de Riomiera,453,260,193
39,Cantabria,80,San Vicente de la Barquera,4532,2288,2244
39,Cantabria,73,Santa Cruz de Bezana,10831,5314,5517
39,Cantabria,74,Santa María de Cayón,8148,4233,3915
39,Cantabria,75,Santander,182302,84747,97555
39,Cantabria,76,Santillana del Mar,4049,1979,2070
39,Cantabria,77,Santiurde de Reinosa,317,186,131
39,Cantabria,78,Santiurde de Toranzo,1485,765,720
39,Cantabria,79,Santoña,11601,5812,5789
39,Cantabria,81,Saro,518,266,252
39,Cantabria,82,Selaya,2003,1015,988
39,Cantabria,83,Soba,1427,761,666
39,Cantabria,84,Solórzano,1063,564,499
39,Cantabria,85,Suances,7998,4016,3982
39,Cantabria,86,Tojos (Los),434,250,184
39,Cantabria,87,Torrelavega,55910,26839,29071
39,Cantabria,88,Tresviso,82,50,32
39,Cantabria,89,Tudanca,202,130,72
39,Cantabria,90,Udías,853,441,412
39,Cantabria,95,Val de San Vicente,2758,1449,1309
39,Cantabria,91,Valdáliga,2351,1234,1117
39,Cantabria,92,Valdeolea,1240,630,610
39,Cantabria,93,Valdeprado del Río,315,175,140
39,Cantabria,94,Valderredible,1131,627,504
39,Cantabria,101,Valle de Villaverde,390,202,188
39,Cantabria,96,Vega de Liébana,892,482,410
39,Cantabria,97,Vega de Pas,906,477,429
39,Cantabria,98,Villacarriedo,1775,928,847
39,Cantabria,99,Villaescusa,3543,1792,1751
39,Cantabria,100,Villafufre,1091,563,528
39,Cantabria,102,Voto,2503,1327,1176
40,Segovia,1,Abades,916,468,448
40,Segovia,2,Adrada de Pirón,45,22,23
40,Segovia,3,Adrados,178,96,82
40,Segovia,4,Aguilafuente,709,343,366
40,Segovia,5,Alconada de Maderuelo,45,29,16
40,Segovia,12,Aldea Real,357,188,169
40,Segovia,6,Aldealcorvo,28,19,9
40,Segovia,7,Aldealengua de Pedraza,108,60,48
40,Segovia,8,Aldealengua de Santa María,88,47,41
40,Segovia,9,Aldeanueva de la Serrezuela,44,26,18
40,Segovia,10,Aldeanueva del Codonal,166,91,75
40,Segovia,13,Aldeasoña,76,42,34
40,Segovia,14,Aldehorno,63,30,33
40,Segovia,15,Aldehuela del Codonal,34,19,15
40,Segovia,16,Aldeonte,82,39,43
40,Segovia,17,Anaya,140,68,72
40,Segovia,18,Añe,118,67,51
40,Segovia,19,Arahuetes,50,29,21
40,Segovia,20,Arcones,260,137,123
40,Segovia,21,Arevalillo de Cega,37,20,17
40,Segovia,22,Armuña,232,128,104
40,Segovia,24,Ayllón,1392,729,663
40,Segovia,25,Barbolla,195,105,90
40,Segovia,26,Basardilla,172,79,93
40,Segovia,28,Bercial,118,58,60
40,Segovia,29,Bercimuel,66,33,33
40,Segovia,30,Bernardos,619,322,297
40,Segovia,31,Bernuy de Porreros,534,289,245
40,Segovia,32,Boceguillas,748,381,367
40,Segovia,33,Brieva,88,61,27
40,Segovia,34,Caballar,98,47,51
40,Segovia,35,Cabañas de Polendos,149,80,69
40,Segovia,36,Cabezuela,734,386,348
40,Segovia,37,Calabazas de Fuentidueña,48,26,22
40,Segovia,39,Campo de San Pedro,383,223,160
40,Segovia,40,Cantalejo,3967,2020,1947
40,Segovia,41,Cantimpalos,1420,748,672
40,Segovia,43,Carbonero el Mayor,2598,1328,1270
40,Segovia,44,Carrascal del Río,187,98,89
40,Segovia,45,Casla,173,90,83
40,Segovia,46,Castillejo de Mesleón,143,81,62
40,Segovia,47,Castro de Fuentidueña,64,36,28
40,Segovia,48,Castrojimeno,38,22,16
40,Segovia,49,Castroserna de Abajo,57,30,27
40,Segovia,51,Castroserracín,63,40,23
40,Segovia,52,Cedillo de la Torre,113,56,57
40,Segovia,53,Cerezo de Abajo,182,91,91
40,Segovia,54,Cerezo de Arriba,208,111,97
40,Segovia,65,Chañe,838,424,414
40,Segovia,55,Cilleruelo de San Mamés,43,21,22
40,Segovia,56,Cobos de Fuentidueña,51,23,28
40,Segovia,57,Coca,2151,1054,1097
40,Segovia,58,Codorniz,417,208,209
40,Segovia,59,Collado Hermoso,160,79,81
40,Segovia,60,Condado de Castilnovo,111,57,54
40,Segovia,61,Corral de Ayllón,85,48,37
40,Segovia,902,Cozuelos de Fuentidueña,154,85,69
40,Segovia,62,Cubillo,63,36,27
40,Segovia,63,Cuéllar,9841,5027,4814
40,Segovia,905,Cuevas de Provanco,157,81,76
40,Segovia,68,Domingo García,39,21,18
40,Segovia,69,Donhierro,115,64,51
40,Segovia,70,Duruelo,163,100,63
40,Segovia,71,Encinas,58,31,27
40,Segovia,72,Encinillas,115,67,48
40,Segovia,73,Escalona del Prado,612,326,286
40,Segovia,74,Escarabajosa de Cabezas,351,204,147
40,Segovia,75,Escobar de Polendos,223,117,106
40,Segovia,76,Espinar (El),9217,4781,4436
40,Segovia,77,Espirdo,763,412,351
40,Segovia,78,Fresneda de Cuéllar,201,108,93
40,Segovia,79,Fresno de Cantespino,290,161,129
40,Segovia,80,Fresno de la Fuente,119,66,53
40,Segovia,81,Frumales,179,85,94
40,Segovia,82,Fuente de Santa Cruz,144,71,73
40,Segovia,83,Fuente el Olmo de Fuentidueña,98,54,44
40,Segovia,84,Fuente el Olmo de Íscar,83,46,37
40,Segovia,86,Fuentepelayo,1005,520,485
40,Segovia,87,Fuentepiñel,124,65,59
40,Segovia,88,Fuenterrebollo,359,188,171
40,Segovia,89,Fuentesaúco de Fuentidueña,302,159,143
40,Segovia,91,Fuentesoto,199,106,93
40,Segovia,92,Fuentidueña,142,74,68
40,Segovia,93,Gallegos,99,51,48
40,Segovia,94,Garcillán,412,221,191
40,Segovia,95,Gomezserracín,717,360,357
40,Segovia,97,Grajera,155,85,70
40,Segovia,99,Honrubia de la Cuesta,81,46,35
40,Segovia,100,Hontalbilla,351,190,161
40,Segovia,101,Hontanares de Eresma,904,473,431
40,Segovia,103,Huertos (Los),155,86,69
40,Segovia,104,Ituero y Lama,286,154,132
40,Segovia,105,Juarros de Riomoros,68,40,28
40,Segovia,106,Juarros de Voltoya,274,135,139
40,Segovia,107,Labajos,153,85,68
40,Segovia,108,Laguna de Contreras,137,78,59
40,Segovia,109,Languilla,100,54,46
40,Segovia,110,Lastras de Cuéllar,422,219,203
40,Segovia,111,Lastras del Pozo,92,43,49
40,Segovia,112,Lastrilla (La),3137,1640,1497
40,Segovia,113,Losa (La),525,278,247
40,Segovia,115,Maderuelo,172,97,75
40,Segovia,903,Marazoleja,133,76,57
40,Segovia,118,Marazuela,62,33,29
40,Segovia,119,Martín Miguel,248,140,108
40,Segovia,120,Martín Muñoz de la Dehesa,189,97,92
40,Segovia,121,Martín Muñoz de las Posadas,364,176,188
40,Segovia,122,Marugán,618,333,285
40,Segovia,124,Mata de Cuéllar,308,166,142
40,Segovia,123,Matabuena,255,130,125
40,Segovia,125,Matilla (La),109,60,49
40,Segovia,126,Melque de Cercos,108,55,53
40,Segovia,127,Membibre de la Hoz,48,24,24
40,Segovia,128,Migueláñez,172,81,91
40,Segovia,129,Montejo de Arévalo,244,134,110
40,Segovia,130,Montejo de la Vega de la Serrezuela,169,95,74
40,Segovia,131,Monterrubio,68,39,29
40,Segovia,132,Moral de Hornuez,101,57,44
40,Segovia,134,Mozoncillo,1070,560,510
40,Segovia,135,Muñopedro,347,185,162
40,Segovia,136,Muñoveros,210,105,105
40,Segovia,138,Nava de la Asunción,3005,1544,1461
40,Segovia,139,Navafría,370,199,171
40,Segovia,140,Navalilla,128,65,63
40,Segovia,141,Navalmanzano,1189,609,580
40,Segovia,142,Navares de Ayuso,59,33,26
40,Segovia,143,Navares de Enmedio,125,69,56
40,Segovia,144,Navares de las Cuevas,32,22,10
40,Segovia,145,Navas de Oro,1471,754,717
40,Segovia,904,Navas de Riofrío,369,177,192
40,Segovia,146,Navas de San Antonio,414,225,189
40,Segovia,148,Nieva,355,187,168
40,Segovia,149,Olombrada,731,405,326
40,Segovia,150,Orejana,82,52,30
40,Segovia,151,Ortigosa de Pestaño,111,64,47
40,Segovia,901,Ortigosa del Monte,485,254,231
40,Segovia,152,Otero de Herreros,986,510,476
40,Segovia,154,Pajarejos,38,20,18
40,Segovia,155,Palazuelos de Eresma,3823,2020,1803
40,Segovia,156,Pedraza,484,263,221
40,Segovia,157,Pelayos del Arroyo,60,33,27
40,Segovia,158,Perosillo,26,17,9
40,Segovia,159,Pinarejos,145,84,61
40,Segovia,160,Pinarnegrillo,145,83,62
40,Segovia,161,Pradales,65,36,29
40,Segovia,162,Prádena,584,310,274
40,Segovia,163,Puebla de Pedraza,78,39,39
40,Segovia,164,Rapariegos,244,129,115
40,Segovia,165,Rebollo,114,63,51
40,Segovia,166,Remondo,336,162,174
40,Segovia,168,Riaguas de San Bartolomé,54,32,22
40,Segovia,170,Riaza,2462,1343,1119
40,Segovia,171,Ribota,38,26,12
40,Segovia,172,Riofrío de Riaza,48,23,25
40,Segovia,173,Roda de Eresma,177,101,76
40,Segovia,174,Sacramenia,514,270,244
40,Segovia,176,Samboal,528,270,258
40,Segovia,177,San Cristóbal de Cuéllar,184,96,88
40,Segovia,178,San Cristóbal de la Vega,140,73,67
40,Segovia,906,San Cristóbal de Segovia,2854,1476,1378
40,Segovia,181,San Ildefonso,5637,2780,2857
40,Segovia,182,San Martín y Mudrián,344,146,198
40,Segovia,183,San Miguel de Bernuy,175,85,90
40,Segovia,184,San Pedro de Gaíllos,343,179,164
40,Segovia,179,Sanchonuño,912,451,461
40,Segovia,180,Sangarcía,443,229,214
40,Segovia,185,Santa María la Real de Nieva,1242,649,593
40,Segovia,186,Santa Marta del Cerro,60,27,33
40,Segovia,188,Santiuste de Pedraza,122,67,55
40,Segovia,189,Santiuste de San Juan Bautista,661,340,321
40,Segovia,190,Santo Domingo de Pirón,63,30,33
40,Segovia,191,Santo Tomé del Puerto,370,209,161
40,Segovia,192,Sauquillo de Cabezas,204,110,94
40,Segovia,193,Sebúlcor,268,148,120
40,Segovia,194,Segovia,56858,27584,29274
40,Segovia,195,Sepúlveda,1287,670,617
40,Segovia,196,Sequera de Fresno,61,34,27
40,Segovia,198,Sotillo,32,17,15
40,Segovia,199,Sotosalbos,114,61,53
40,Segovia,200,Tabanera la Luenga,78,41,37
40,Segovia,201,Tolocirio,55,27,28
40,Segovia,206,Torre Val de San Pedro,195,110,85
40,Segovia,202,Torreadrada,94,40,54
40,Segovia,203,Torrecaballeros,1106,578,528
40,Segovia,204,Torrecilla del Pinar,253,125,128
40,Segovia,205,Torreiglesias,335,176,159
40,Segovia,207,Trescasas,718,368,350
40,Segovia,208,Turégano,1145,581,564
40,Segovia,210,Urueñas,110,65,45
40,Segovia,211,Valdeprados,87,47,40
40,Segovia,212,Valdevacas de Montejo,36,19,17
40,Segovia,213,Valdevacas y Guijar,139,71,68
40,Segovia,218,Valle de Tabladillo,133,72,61
40,Segovia,219,Vallelado,817,434,383
40,Segovia,220,Valleruela de Pedraza,77,41,36
40,Segovia,221,Valleruela de Sepúlveda,59,28,31
40,Segovia,214,Valseca,312,170,142
40,Segovia,215,Valtiendas,144,81,63
40,Segovia,216,Valverde del Majano,905,459,446
40,Segovia,222,Veganzones,285,153,132
40,Segovia,223,Vegas de Matute,284,172,112
40,Segovia,224,Ventosilla y Tejadilla,39,24,15
40,Segovia,225,Villacastín,1627,844,783
40,Segovia,228,Villaverde de Íscar,740,378,362
40,Segovia,229,Villaverde de Montejo,50,28,22
40,Segovia,230,Villeguillo,163,93,70
40,Segovia,231,Yanguas de Eresma,167,85,82
40,Segovia,233,Zarzuela del Monte,580,314,266
40,Segovia,234,Zarzuela del Pinar,549,286,263
41,Sevilla,1,Aguadulce,2124,1070,1054
41,Sevilla,2,Alanís,1891,946,945
41,Sevilla,3,Albaida del Aljarafe,2798,1423,1375
41,Sevilla,4,Alcalá de Guadaíra,68452,34126,34326
41,Sevilla,5,Alcalá del Río,10479,5313,5166
41,Sevilla,6,Alcolea del Río,3370,1662,1708
41,Sevilla,7,Algaba (La),14642,7332,7310
41,Sevilla,8,Algámitas,1341,694,647
41,Sevilla,9,Almadén de la Plata,1560,788,772
41,Sevilla,10,Almensilla,5438,2770,2668
41,Sevilla,11,Arahal,19150,9479,9671
41,Sevilla,12,Aznalcázar,4003,2036,1967
41,Sevilla,13,Aznalcóllar,6188,3195,2993
41,Sevilla,14,Badolatosa,3228,1660,1568
41,Sevilla,15,Benacazón,6103,3114,2989
41,Sevilla,16,Bollullos de la Mitación,8334,4195,4139
41,Sevilla,17,Bormujos,17670,8776,8894
41,Sevilla,18,Brenes,12245,6157,6088
41,Sevilla,19,Burguillos,5335,2709,2626
41,Sevilla,20,Cabezas de San Juan (Las),16292,8306,7986
41,Sevilla,21,Camas,25780,12637,13143
41,Sevilla,22,Campana (La),5467,2750,2717
41,Sevilla,23,Cantillana,10442,5351,5091
41,Sevilla,901,Cañada Rosal,3175,1583,1592
41,Sevilla,24,Carmona,27950,14242,13708
41,Sevilla,25,Carrión de los Céspedes,2412,1160,1252
41,Sevilla,26,Casariche,5552,2822,2730
41,Sevilla,27,Castilblanco de los Arroyos,5028,2543,2485
41,Sevilla,28,Castilleja de Guzmán,2687,1380,1307
41,Sevilla,29,Castilleja de la Cuesta,17075,8423,8652
41,Sevilla,30,Castilleja del Campo,633,313,320
41,Sevilla,31,Castillo de las Guardas (El),1609,833,776
41,Sevilla,32,Cazalla de la Sierra,5047,2500,2547
41,Sevilla,33,Constantina,6612,3267,3345
41,Sevilla,34,Coria del Río,27528,13854,13674
41,Sevilla,35,Coripe,1456,744,712
41,Sevilla,36,Coronil (El),5045,2554,2491
41,Sevilla,37,Corrales (Los),4081,2085,1996
41,Sevilla,903,Cuervo de Sevilla (El),8489,4317,4172
41,Sevilla,38,Dos Hermanas,120323,59687,60636
41,Sevilla,39,Écija,40143,19769,20374
41,Sevilla,40,Espartinas,11838,5955,5883
41,Sevilla,41,Estepa,12547,6235,6312
41,Sevilla,42,Fuentes de Andalucía,7360,3675,3685
41,Sevilla,43,Garrobo (El),786,396,390
41,Sevilla,44,Gelves,8828,4394,4434
41,Sevilla,45,Gerena,6180,3112,3068
41,Sevilla,46,Gilena,3948,1977,1971
41,Sevilla,47,Gines,12651,6228,6423
41,Sevilla,48,Guadalcanal,3001,1486,1515
41,Sevilla,49,Guillena,10654,5351,5303
41,Sevilla,50,Herrera,6521,3239,3282
41,Sevilla,51,Huévar del Aljarafe,2589,1336,1253
41,Sevilla,902,Isla Mayor,5810,2931,2879
41,Sevilla,52,Lantejuela (La),3852,1963,1889
41,Sevilla,53,Lebrija,26046,13128,12918
41,Sevilla,54,Lora de Estepa,853,436,417
41,Sevilla,55,Lora del Río,19327,9610,9717
41,Sevilla,56,Luisiana (La),4583,2319,2264
41,Sevilla,57,Madroño (El),347,178,169
41,Sevilla,58,Mairena del Alcor,19924,9973,9951
41,Sevilla,59,Mairena del Aljarafe,39831,19897,19934
41,Sevilla,60,Marchena,19497,9721,9776
41,Sevilla,61,Marinaleda,2708,1375,1333
41,Sevilla,62,Martín de la Jara,2758,1423,1335
41,Sevilla,63,Molares (Los),3042,1568,1474
41,Sevilla,64,Montellano,7085,3552,3533
41,Sevilla,65,Morón de la Frontera,28259,14072,14187
41,Sevilla,66,Navas de la Concepción (Las),1778,884,894
41,Sevilla,67,Olivares,9182,4633,4549
41,Sevilla,68,Osuna,17813,8796,9017
41,Sevilla,69,Palacios y Villafranca (Los),36350,18376,17974
41,Sevilla,70,Palomares del Río,6411,3230,3181
41,Sevilla,71,Paradas,7036,3537,3499
41,Sevilla,72,Pedrera,5240,2611,2629
41,Sevilla,73,Pedroso (El),2272,1129,1143
41,Sevilla,74,Peñaflor,3764,1896,1868
41,Sevilla,75,Pilas,12988,6566,6422
41,Sevilla,76,Pruna,2955,1515,1440
41,Sevilla,77,Puebla de Cazalla (La),11237,5643,5594
41,Sevilla,78,Puebla de los Infantes (La),3299,1642,1657
41,Sevilla,79,Puebla del Río (La),11951,5937,6014
41,Sevilla,80,Real de la Jara (El),1639,795,844
41,Sevilla,81,Rinconada (La),35097,17556,17541
41,Sevilla,82,Roda de Andalucía (La),4419,2219,2200
41,Sevilla,83,Ronquillo (El),1425,733,692
41,Sevilla,84,Rubio (El),3569,1772,1797
41,Sevilla,85,Salteras,4897,2382,2515
41,Sevilla,86,San Juan de Aznalfarache,20249,9805,10444
41,Sevilla,88,San Nicolás del Puerto,681,341,340
41,Sevilla,87,Sanlúcar la Mayor,12485,6218,6267
41,Sevilla,89,Santiponce,7948,3977,3971
41,Sevilla,90,Saucejo (El),4457,2230,2227
41,Sevilla,91,Sevilla,699759,333490,366269
41,Sevilla,92,Tocina,9316,4625,4691
41,Sevilla,93,Tomares,21921,10843,11078
41,Sevilla,94,Umbrete,7365,3699,3666
41,Sevilla,95,Utrera,50098,25094,25004
41,Sevilla,96,Valencina de la Concepción,7875,3946,3929
41,Sevilla,97,Villamanrique de la Condesa,4097,2028,2069
41,Sevilla,100,Villanueva de San Juan,1418,699,719
41,Sevilla,98,Villanueva del Ariscal,5946,2941,3005
41,Sevilla,99,Villanueva del Río y Minas,5286,2617,2669
41,Sevilla,101,Villaverde del Río,7178,3659,3519
41,Sevilla,102,Viso del Alcor (El),18059,9097,8962
42,Soria,1,Abejar,390,212,178
42,Soria,3,Adradas,77,45,32
42,Soria,4,Ágreda,3238,1630,1608
42,Soria,6,Alconaba,175,105,70
42,Soria,7,Alcubilla de Avellaneda,165,83,82
42,Soria,8,Alcubilla de las Peñas,71,38,33
42,Soria,9,Aldealafuente,121,61,60
42,Soria,10,Aldealices,24,13,11
42,Soria,11,Aldealpozo,30,15,15
42,Soria,12,Aldealseñor,40,24,16
42,Soria,13,Aldehuela de Periáñez,53,27,26
42,Soria,14,Aldehuelas (Las),98,52,46
42,Soria,15,Alentisque,33,17,16
42,Soria,16,Aliud,29,17,12
42,Soria,17,Almajano,205,108,97
42,Soria,18,Almaluez,211,111,100
42,Soria,19,Almarza,651,371,280
42,Soria,20,Almazán,5984,2986,2998
42,Soria,21,Almazul,112,59,53
42,Soria,22,Almenar de Soria,317,172,145
42,Soria,23,Alpanseque,89,46,43
42,Soria,24,Arancón,98,58,40
42,Soria,25,Arcos de Jalón,1807,944,863
42,Soria,26,Arenillas,28,17,11
42,Soria,27,Arévalo de la Sierra,82,53,29
42,Soria,28,Ausejo de la Sierra,67,36,31
42,Soria,29,Baraona,192,104,88
42,Soria,30,Barca,111,68,43
42,Soria,31,Barcones,33,19,14
42,Soria,32,Bayubas de Abajo,217,116,101
42,Soria,33,Bayubas de Arriba,66,35,31
42,Soria,34,Beratón,44,30,14
42,Soria,35,Berlanga de Duero,1034,519,515
42,Soria,36,Blacos,54,32,22
42,Soria,37,Bliecos,43,25,18
42,Soria,38,Borjabad,47,28,19
42,Soria,39,Borobia,295,155,140
42,Soria,41,Buberos,42,23,19
42,Soria,42,Buitrago,50,23,27
42,Soria,43,Burgo de Osma-Ciudad de Osma,5158,2558,2600
42,Soria,44,Cabrejas del Campo,75,39,36
42,Soria,45,Cabrejas del Pinar,457,250,207
42,Soria,46,Calatañazor,66,37,29
42,Soria,48,Caltojar,91,51,40
42,Soria,49,Candilichera,171,94,77
42,Soria,50,Cañamaque,27,18,9
42,Soria,51,Carabantes,26,13,13
42,Soria,52,Caracena,24,18,6
42,Soria,53,Carrascosa de Abajo,32,19,13
42,Soria,54,Carrascosa de la Sierra,13,8,5
42,Soria,55,Casarejos,227,117,110
42,Soria,56,Castilfrío de la Sierra,38,23,15
42,Soria,58,Castillejo de Robledo,149,82,67
42,Soria,57,Castilruiz,236,124,112
42,Soria,59,Centenera de Andaluz,25,8,17
42,Soria,60,Cerbón,38,23,15
42,Soria,61,Cidones,354,197,157
42,Soria,62,Cigudosa,45,27,18
42,Soria,63,Cihuela,76,37,39
42,Soria,64,Ciria,105,53,52
42,Soria,65,Cirujales del Río,31,16,15
42,Soria,68,Coscurita,116,63,53
42,Soria,69,Covaleda,1944,1000,944
42,Soria,70,Cubilla,58,29,29
42,Soria,71,Cubo de la Solana,216,117,99
42,Soria,73,Cueva de Ágreda,94,52,42
42,Soria,75,Dévanos,100,52,48
42,Soria,76,Deza,291,143,148
42,Soria,78,Duruelo de la Sierra,1345,687,658
42,Soria,79,Escobosa de Almazán,39,23,16
42,Soria,80,Espeja de San Marcelino,213,128,85
42,Soria,81,Espejón,201,106,95
42,Soria,82,Estepa de San Juan,9,5,4
42,Soria,83,Frechilla de Almazán,30,15,15
42,Soria,84,Fresno de Caracena,29,15,14
42,Soria,85,Fuentearmegil,258,142,116
42,Soria,86,Fuentecambrón,49,28,21
42,Soria,87,Fuentecantos,53,28,25
42,Soria,88,Fuentelmonge,92,56,36
42,Soria,89,Fuentelsaz de Soria,60,28,32
42,Soria,90,Fuentepinilla,116,67,49
42,Soria,92,Fuentes de Magaña,77,39,38
42,Soria,93,Fuentestrún,53,31,22
42,Soria,94,Garray,556,305,251
42,Soria,95,Golmayo,1815,961,854
42,Soria,96,Gómara,417,228,189
42,Soria,97,Gormaz,17,7,10
42,Soria,98,Herrera de Soria,12,8,4
42,Soria,100,Hinojosa del Campo,33,21,12
42,Soria,103,Langa de Duero,859,469,390
42,Soria,105,Liceras,56,28,28
42,Soria,106,Losilla (La),12,8,4
42,Soria,107,Magaña,98,57,41
42,Soria,108,Maján,16,9,7
42,Soria,110,Matalebreras,101,50,51
42,Soria,111,Matamala de Almazán,365,201,164
42,Soria,113,Medinaceli,775,389,386
42,Soria,115,Miño de Medinaceli,83,46,37
42,Soria,116,Miño de San Esteban,72,41,31
42,Soria,117,Molinos de Duero,193,102,91
42,Soria,118,Momblona,32,20,12
42,Soria,119,Monteagudo de las Vicarías,242,127,115
42,Soria,120,Montejo de Tiermes,219,131,88
42,Soria,121,Montenegro de Cameros,97,60,37
42,Soria,123,Morón de Almazán,239,109,130
42,Soria,124,Muriel de la Fuente,79,50,29
42,Soria,125,Muriel Viejo,70,38,32
42,Soria,127,Nafría de Ucero,63,36,27
42,Soria,128,Narros,44,21,23
42,Soria,129,Navaleno,942,489,453
42,Soria,130,Nepas,78,46,32
42,Soria,131,Nolay,70,37,33
42,Soria,132,Noviercas,205,110,95
42,Soria,134,Ólvega,3690,1947,1743
42,Soria,135,Oncala,97,61,36
42,Soria,139,Pinilla del Campo,21,12,9
42,Soria,140,Portillo de Soria,18,12,6
42,Soria,141,Póveda de Soria (La),131,67,64
42,Soria,142,Pozalmuro,85,42,43
42,Soria,144,Quintana Redonda,542,293,249
42,Soria,145,Quintanas de Gormaz,154,87,67
42,Soria,148,Quiñonería,20,8,12
42,Soria,149,Rábanos (Los),532,319,213
42,Soria,151,Rebollar,47,24,23
42,Soria,152,Recuerda,96,54,42
42,Soria,153,Rello,27,14,13
42,Soria,154,Renieblas,110,65,45
42,Soria,155,Retortillo de Soria,222,115,107
42,Soria,156,Reznos,36,24,12
42,Soria,157,Riba de Escalote (La),23,13,10
42,Soria,158,Rioseco de Soria,137,73,64
42,Soria,159,Rollamienta,46,26,20
42,Soria,160,Royo (El),328,172,156
42,Soria,161,Salduero,173,93,80
42,Soria,162,San Esteban de Gormaz,3268,1704,1564
42,Soria,163,San Felices,56,32,24
42,Soria,164,San Leonardo de Yagüe,2335,1209,1126
42,Soria,165,San Pedro Manrique,600,334,266
42,Soria,166,Santa Cruz de Yanguas,63,39,24
42,Soria,167,Santa María de Huerta,388,211,177
42,Soria,168,Santa María de las Hoyas,168,94,74
42,Soria,171,Serón de Nágima,220,121,99
42,Soria,172,Soliedra,37,19,18
42,Soria,173,Soria,39078,18681,20397
42,Soria,174,Sotillo del Rincón,211,112,99
42,Soria,175,Suellacabras,33,22,11
42,Soria,176,Tajahuerce,34,17,17
42,Soria,177,Tajueco,98,51,47
42,Soria,178,Talveila,167,93,74
42,Soria,181,Tardelcuende,530,264,266
42,Soria,182,Taroda,65,31,34
42,Soria,183,Tejado,159,86,73
42,Soria,184,Torlengua,92,46,46
42,Soria,185,Torreblacos,32,15,17
42,Soria,187,Torrubia de Soria,76,49,27
42,Soria,188,Trévago,73,33,40
42,Soria,189,Ucero,93,44,49
42,Soria,190,Vadillo,147,76,71
42,Soria,191,Valdeavellano de Tera,230,123,107
42,Soria,192,Valdegeña,47,31,16
42,Soria,193,Valdelagua del Cerro,16,10,6
42,Soria,194,Valdemaluque,238,119,119
42,Soria,195,Valdenebro,134,74,60
42,Soria,196,Valdeprado,13,8,5
42,Soria,197,Valderrodilla,96,50,46
42,Soria,198,Valtajeros,22,12,10
42,Soria,200,Velamazán,109,70,39
42,Soria,201,Velilla de la Sierra,34,19,15
42,Soria,202,Velilla de los Ajos,36,21,15
42,Soria,204,Viana de Duero,67,44,23
42,Soria,205,Villaciervos,111,65,46
42,Soria,206,Villanueva de Gormaz,14,9,5
42,Soria,207,Villar del Ala,59,29,30
42,Soria,208,Villar del Campo,27,17,10
42,Soria,209,Villar del Río,188,105,83
42,Soria,211,Villares de Soria (Los),97,53,44
42,Soria,212,Villasayas,86,58,28
42,Soria,213,Villaseca de Arciel,39,22,17
42,Soria,215,Vinuesa,997,550,447
42,Soria,216,Vizmanos,26,18,8
42,Soria,217,Vozmediano,40,25,15
42,Soria,218,Yanguas,120,67,53
42,Soria,219,Yelo,52,31,21
43,Tarragona,1,Aiguamúrcia,886,472,414
43,Tarragona,2,Albinyana,2292,1159,1133
43,Tarragona,3,Albiol (L'),415,216,199
43,Tarragona,4,Alcanar,10510,5425,5085
43,Tarragona,5,Alcover,4962,2574,2388
43,Tarragona,904,Aldea (L'),3966,2123,1843
43,Tarragona,6,Aldover,957,471,486
43,Tarragona,7,Aleixar (L'),900,453,447
43,Tarragona,8,Alfara de Carles,392,211,181
43,Tarragona,9,Alforja,1814,940,874
43,Tarragona,10,Alió,379,192,187
43,Tarragona,11,Almoster,1339,667,672
43,Tarragona,12,Altafulla,4554,2284,2270
43,Tarragona,13,Ametlla de Mar (L'),7424,3798,3626
43,Tarragona,906,Ampolla (L'),2947,1514,1433
43,Tarragona,14,Amposta,20652,10573,10079
43,Tarragona,16,Arboç (L'),5377,2868,2509
43,Tarragona,15,Arbolí,111,60,51
43,Tarragona,17,Argentera (L'),143,82,61
43,Tarragona,18,Arnes,497,255,242
43,Tarragona,19,Ascó,1601,826,775
43,Tarragona,20,Banyeres del Penedès,2845,1470,1375
43,Tarragona,21,Barberà de la Conca,521,284,237
43,Tarragona,22,Batea,2169,1123,1046
43,Tarragona,23,Bellmunt del Priorat,347,175,172
43,Tarragona,24,Bellvei,1985,1061,924
43,Tarragona,25,Benifallet,802,401,401
43,Tarragona,26,Benissanet,1268,684,584
43,Tarragona,27,Bisbal de Falset (La),241,126,115
43,Tarragona,28,Bisbal del Penedès (La),3328,1739,1589
43,Tarragona,29,Blancafort,428,227,201
43,Tarragona,30,Bonastre,642,346,296
43,Tarragona,31,Borges del Camp (Les),2061,1045,1016
43,Tarragona,32,Bot,708,362,346
43,Tarragona,33,Botarell,1032,548,484
43,Tarragona,34,Bràfim,652,329,323
43,Tarragona,35,Cabacés,342,185,157
43,Tarragona,36,Cabra del Camp,1078,571,507
43,Tarragona,37,Calafell,22939,11716,11223
43,Tarragona,903,Camarles,3629,1872,1757
43,Tarragona,38,Cambrils,30956,15517,15439
43,Tarragona,39,Capafonts,117,62,55
43,Tarragona,40,Capçanes,408,200,208
43,Tarragona,41,Caseres,294,145,149
43,Tarragona,42,Castellvell del Camp,2588,1328,1260
43,Tarragona,43,Catllar (El),3973,2056,1917
43,Tarragona,45,Colldejou,186,101,85
43,Tarragona,46,Conesa,134,68,66
43,Tarragona,47,Constantí,6401,3464,2937
43,Tarragona,48,Corbera d'Ebre,1169,626,543
43,Tarragona,49,Cornudella de Montsant,1006,525,481
43,Tarragona,50,Creixell,3154,1633,1521
43,Tarragona,51,Cunit,11730,6048,5682
43,Tarragona,901,Deltebre,11445,5864,5581
43,Tarragona,53,Duesaigües,236,138,98
43,Tarragona,54,Espluga de Francolí (L'),3934,1956,1978
43,Tarragona,55,Falset,2807,1407,1400
43,Tarragona,56,Fatarella (La),1139,573,566
43,Tarragona,57,Febró (La),49,31,18
43,Tarragona,58,Figuera (La),156,86,70
43,Tarragona,59,Figuerola del Camp,330,152,178
43,Tarragona,60,Flix,4054,2062,1992
43,Tarragona,61,Forès,49,29,20
43,Tarragona,62,Freginals,449,238,211
43,Tarragona,63,Galera (La),851,443,408
43,Tarragona,64,Gandesa,3173,1635,1538
43,Tarragona,65,Garcia,606,307,299
43,Tarragona,66,Garidells (Els),222,111,111
43,Tarragona,67,Ginestar,1098,592,506
43,Tarragona,68,Godall,836,428,408
43,Tarragona,69,Gratallops,257,135,122
43,Tarragona,70,Guiamets (Els),327,167,160
43,Tarragona,71,Horta de Sant Joan,1287,699,588
43,Tarragona,72,Lloar (El),115,68,47
43,Tarragona,73,Llorac,106,56,50
43,Tarragona,74,Llorenç del Penedès,2157,1086,1071
43,Tarragona,76,Marçà,651,330,321
43,Tarragona,75,Margalef,120,67,53
43,Tarragona,77,Mas de Barberans,676,340,336
43,Tarragona,78,Masdenverge,1121,589,532
43,Tarragona,79,Masllorenç,517,268,249
43,Tarragona,80,Masó (La),291,146,145
43,Tarragona,81,Maspujols,565,295,270
43,Tarragona,82,Masroig (El),550,279,271
43,Tarragona,83,Milà (El),177,85,92
43,Tarragona,84,Miravet,799,425,374
43,Tarragona,85,Molar (El),293,163,130
43,Tarragona,86,Montblanc,7069,3635,3434
43,Tarragona,88,Montbrió del Camp,2061,1051,1010
43,Tarragona,89,Montferri,350,185,165
43,Tarragona,90,Montmell (El),1420,766,654
43,Tarragona,91,Mont-ral,175,95,80
43,Tarragona,92,Mont-roig del Camp,11131,5843,5288
43,Tarragona,93,Móra d'Ebre,5500,2715,2785
43,Tarragona,94,Móra la Nova,3212,1650,1562
43,Tarragona,95,Morell (El),3080,1611,1469
43,Tarragona,96,Morera de Montsant (La),153,90,63
43,Tarragona,97,Nou de Gaià (La),475,240,235
43,Tarragona,98,Nulles,415,211,204
43,Tarragona,100,Pallaresos (Els),3828,1961,1867
43,Tarragona,99,Palma d'Ebre (La),416,201,215
43,Tarragona,101,Passanant i Belltall,175,96,79
43,Tarragona,102,Paüls,626,311,315
43,Tarragona,103,Perafort,1099,581,518
43,Tarragona,104,Perelló (El),3140,1694,1446
43,Tarragona,105,Piles (Les),220,120,100
43,Tarragona,106,Pinell de Brai (El),1132,581,551
43,Tarragona,107,Pira,504,252,252
43,Tarragona,108,Pla de Santa Maria (El),2213,1155,1058
43,Tarragona,109,Pobla de Mafumet (La),2108,1066,1042
43,Tarragona,110,Pobla de Massaluca (La),400,205,195
43,Tarragona,111,Pobla de Montornès (La),2741,1462,1279
43,Tarragona,112,Poboleda,369,205,164
43,Tarragona,113,Pont d'Armentera (El),606,314,292
43,Tarragona,141,Pontils,152,84,68
43,Tarragona,114,Porrera,464,248,216
43,Tarragona,115,Pradell de la Teixeta,164,80,84
43,Tarragona,116,Prades,683,353,330
43,Tarragona,117,Prat de Comte,194,101,93
43,Tarragona,118,Pratdip,833,446,387
43,Tarragona,119,Puigpelat,953,504,449
43,Tarragona,120,Querol,549,297,252
43,Tarragona,121,Rasquera,952,485,467
43,Tarragona,122,Renau,94,44,50
43,Tarragona,123,Reus,107770,53845,53925
43,Tarragona,124,Riba (La),720,395,325
43,Tarragona,125,Riba-roja d'Ebre,1328,699,629
43,Tarragona,126,Riera de Gaià (La),1540,790,750
43,Tarragona,127,Riudecanyes,1041,532,509
43,Tarragona,128,Riudecols,1218,644,574
43,Tarragona,129,Riudoms,6385,3266,3119
43,Tarragona,130,Rocafort de Queralt,284,155,129
43,Tarragona,131,Roda de Barà,6002,3174,2828
43,Tarragona,132,Rodonyà,520,282,238
43,Tarragona,133,Roquetes,7987,4191,3796
43,Tarragona,134,Rourell (El),376,190,186
43,Tarragona,135,Salomó,482,257,225
43,Tarragona,905,Salou,25754,14019,11735
43,Tarragona,136,Sant Carles de la Ràpita,15307,7706,7601
43,Tarragona,137,Sant Jaume dels Domenys,2348,1233,1115
43,Tarragona,902,Sant Jaume d'Enveja,3479,1778,1701
43,Tarragona,138,Santa Bàrbara,3965,2034,1931
43,Tarragona,139,Santa Coloma de Queralt,3128,1588,1540
43,Tarragona,140,Santa Oliva,3133,1655,1478
43,Tarragona,142,Sarral,1686,870,816
43,Tarragona,143,Savallà del Comtat,72,39,33
43,Tarragona,144,Secuita (La),1466,753,713
43,Tarragona,145,Selva del Camp (La),5238,2652,2586
43,Tarragona,146,Senan,59,39,20
43,Tarragona,44,Sénia (La),6225,3218,3007
43,Tarragona,147,Solivella,685,350,335
43,Tarragona,148,Tarragona,137536,68213,69323
43,Tarragona,149,Tivenys,948,486,462
43,Tarragona,150,Tivissa,1841,941,900
43,Tarragona,151,Torre de Fontaubella (La),140,72,68
43,Tarragona,152,Torre de l'Espanyol (La),673,352,321
43,Tarragona,153,Torredembarra,15056,7522,7534
43,Tarragona,154,Torroja del Priorat,169,94,75
43,Tarragona,155,Tortosa,35734,18429,17305
43,Tarragona,156,Ulldecona,6987,3621,3366
43,Tarragona,157,Ulldemolins,473,262,211
43,Tarragona,158,Vallclara,126,70,56
43,Tarragona,159,Vallfogona de Riucorb,129,76,53
43,Tarragona,160,Vallmoll,1599,847,752
43,Tarragona,161,Valls,24710,12486,12224
43,Tarragona,162,Vandellòs i l'Hospitalet de l'Infant,5653,2875,2778
43,Tarragona,163,Vendrell (El),34931,17692,17239
43,Tarragona,164,Vespella de Gaià,395,217,178
43,Tarragona,165,Vilabella,808,409,399
43,Tarragona,175,Vilalba dels Arcs,723,381,342
43,Tarragona,166,Vilallonga del Camp,1772,901,871
43,Tarragona,168,Vilanova de Prades,145,79,66
43,Tarragona,167,Vilanova d'Escornalbou,531,290,241
43,Tarragona,169,Vilaplana,609,311,298
43,Tarragona,170,Vila-rodona,1207,627,580
43,Tarragona,171,Vila-seca,20039,10219,9820
43,Tarragona,172,Vilaverd,490,248,242
43,Tarragona,173,Vilella Alta (La),112,64,48
43,Tarragona,174,Vilella Baixa (La),205,107,98
43,Tarragona,176,Vimbodí i Poblet,1065,595,470
43,Tarragona,177,Vinebre,496,251,245
43,Tarragona,178,Vinyols i els Arcs,1738,894,844
43,Tarragona,52,Xerta,1307,651,656
44,Teruel,1,Ababuj,83,52,31
44,Teruel,2,Abejuela,61,41,20
44,Teruel,3,Aguatón,21,9,12
44,Teruel,4,Aguaviva,718,367,351
44,Teruel,5,Aguilar del Alfambra,71,39,32
44,Teruel,6,Alacón,410,219,191
44,Teruel,7,Alba,244,122,122
44,Teruel,8,Albalate del Arzobispo,2233,1150,1083
44,Teruel,9,Albarracín,1110,567,543
44,Teruel,10,Albentosa,310,168,142
44,Teruel,11,Alcaine,65,37,28
44,Teruel,12,Alcalá de la Selva,506,291,215
44,Teruel,13,Alcañiz,16233,8200,8033
44,Teruel,14,Alcorisa,3692,1895,1797
44,Teruel,16,Alfambra,740,397,343
44,Teruel,17,Aliaga,415,232,183
44,Teruel,21,Allepuz,140,69,71
44,Teruel,22,Alloza,709,364,345
44,Teruel,23,Allueva,15,10,5
44,Teruel,18,Almohaja,28,20,8
44,Teruel,19,Alobras,73,44,29
44,Teruel,20,Alpeñés,25,17,8
44,Teruel,24,Anadón,20,14,6
44,Teruel,25,Andorra,8290,4308,3982
44,Teruel,26,Arcos de las Salinas,115,58,57
44,Teruel,27,Arens de Lledó,217,99,118
44,Teruel,28,Argente,240,117,123
44,Teruel,29,Ariño,954,500,454
44,Teruel,31,Azaila,155,88,67
44,Teruel,32,Bádenas,27,16,11
44,Teruel,33,Báguena,442,242,200
44,Teruel,34,Bañón,163,90,73
44,Teruel,35,Barrachina,159,86,73
44,Teruel,36,Bea,40,25,15
44,Teruel,37,Beceite,631,327,304
44,Teruel,39,Bello,297,136,161
44,Teruel,38,Belmonte de San José,140,70,70
44,Teruel,40,Berge,264,132,132
44,Teruel,41,Bezas,72,43,29
44,Teruel,42,Blancas,162,96,66
44,Teruel,43,Blesa,124,78,46
44,Teruel,44,Bordón,132,74,58
44,Teruel,45,Bronchales,488,284,204
44,Teruel,46,Bueña,71,39,32
44,Teruel,47,Burbáguena,303,139,164
44,Teruel,48,Cabra de Mora,105,60,45
44,Teruel,49,Calaceite,1132,596,536
44,Teruel,50,Calamocha,4752,2467,2285
44,Teruel,51,Calanda,3825,1950,1875
44,Teruel,52,Calomarde,96,57,39
44,Teruel,53,Camañas,116,68,48
44,Teruel,54,Camarena de la Sierra,163,92,71
44,Teruel,55,Camarillas,121,78,43
44,Teruel,56,Caminreal,788,410,378
44,Teruel,59,Cantavieja,735,395,340
44,Teruel,60,Cañada de Benatanduz,51,32,19
44,Teruel,61,Cañada de Verich (La),109,58,51
44,Teruel,62,Cañada Vellida,44,31,13
44,Teruel,63,Cañizar del Olivar,106,63,43
44,Teruel,64,Cascante del Río,91,54,37
44,Teruel,65,Castejón de Tornos,67,40,27
44,Teruel,66,Castel de Cabra,147,77,70
44,Teruel,70,Castellar (El),75,47,28
44,Teruel,71,Castellote,832,436,396
44,Teruel,67,Castelnou,112,60,52
44,Teruel,68,Castelserás,839,439,400
44,Teruel,74,Cedrillas,601,317,284
44,Teruel,75,Celadas,440,252,188
44,Teruel,76,Cella,3122,1704,1418
44,Teruel,77,Cerollera (La),125,69,56
44,Teruel,80,Codoñera (La),374,202,172
44,Teruel,82,Corbalán,94,53,41
44,Teruel,84,Cortes de Aragón,86,44,42
44,Teruel,85,Cosa,77,42,35
44,Teruel,86,Cretas,632,324,308
44,Teruel,87,Crivillén,95,50,45
44,Teruel,88,Cuba (La),68,37,31
44,Teruel,89,Cubla,58,33,25
44,Teruel,90,Cucalón,104,60,44
44,Teruel,92,Cuervo (El),113,60,53
44,Teruel,93,Cuevas de Almudén,123,72,51
44,Teruel,94,Cuevas Labradas,146,75,71
44,Teruel,96,Ejulve,219,108,111
44,Teruel,97,Escorihuela,196,101,95
44,Teruel,99,Escucha,1034,578,456
44,Teruel,100,Estercuel,255,141,114
44,Teruel,101,Ferreruela de Huerva,74,41,33
44,Teruel,102,Fonfría,30,18,12
44,Teruel,103,Formiche Alto,195,105,90
44,Teruel,105,Fórnoles,103,56,47
44,Teruel,106,Fortanete,240,140,100
44,Teruel,107,Foz-Calanda,299,171,128
44,Teruel,108,Fresneda (La),490,277,213
44,Teruel,109,Frías de Albarracín,172,96,76
44,Teruel,110,Fuenferrada,41,21,20
44,Teruel,111,Fuentes Calientes,116,65,51
44,Teruel,112,Fuentes Claras,673,405,268
44,Teruel,113,Fuentes de Rubielos,127,70,57
44,Teruel,114,Fuentespalda,345,172,173
44,Teruel,115,Galve,136,74,62
44,Teruel,116,Gargallo,106,58,48
44,Teruel,117,Gea de Albarracín,447,230,217
44,Teruel,118,Ginebrosa (La),247,147,100
44,Teruel,119,Griegos,144,90,54
44,Teruel,120,Guadalaviar,263,136,127
44,Teruel,121,Gúdar,107,55,52
44,Teruel,122,Híjar,1928,999,929
44,Teruel,123,Hinojosa de Jarque,150,83,67
44,Teruel,124,Hoz de la Vieja (La),96,49,47
44,Teruel,125,Huesa del Común,101,66,35
44,Teruel,126,Iglesuela del Cid (La),505,278,227
44,Teruel,127,Jabaloyas,85,47,38
44,Teruel,128,Jarque de la Val,100,57,43
44,Teruel,129,Jatiel,57,26,31
44,Teruel,130,Jorcas,46,31,15
44,Teruel,131,Josa,33,20,13
44,Teruel,132,Lagueruela,66,35,31
44,Teruel,133,Lanzuela,29,21,8
44,Teruel,135,Libros,149,81,68
44,Teruel,136,Lidón,66,31,35
44,Teruel,137,Linares de Mora,324,198,126
44,Teruel,141,Lledó,182,103,79
44,Teruel,138,Loscos,189,113,76
44,Teruel,142,Maicas,38,21,17
44,Teruel,143,Manzanera,541,305,236
44,Teruel,144,Martín del Río,466,238,228
44,Teruel,145,Mas de las Matas,1445,745,700
44,Teruel,146,Mata de los Olmos (La),268,139,129
44,Teruel,147,Mazaleón,582,314,268
44,Teruel,148,Mezquita de Jarque,131,75,56
44,Teruel,149,Mirambel,129,76,53
44,Teruel,150,Miravete de la Sierra,41,25,16
44,Teruel,151,Molinos,301,169,132
44,Teruel,152,Monforte de Moyuela,84,53,31
44,Teruel,153,Monreal del Campo,2766,1375,1391
44,Teruel,154,Monroyo,385,239,146
44,Teruel,155,Montalbán,1477,758,719
44,Teruel,156,Monteagudo del Castillo,77,48,29
44,Teruel,157,Monterde de Albarracín,74,42,32
44,Teruel,158,Mora de Rubielos,1699,914,785
44,Teruel,159,Moscardón,59,34,25
44,Teruel,160,Mosqueruela,631,338,293
44,Teruel,161,Muniesa,714,389,325
44,Teruel,163,Noguera de Albarracín,143,76,67
44,Teruel,164,Nogueras,31,24,7
44,Teruel,165,Nogueruelas,264,141,123
44,Teruel,167,Obón,52,29,23
44,Teruel,168,Odón,232,109,123
44,Teruel,169,Ojos Negros,514,267,247
44,Teruel,171,Olba,220,121,99
44,Teruel,172,Oliete,504,270,234
44,Teruel,173,Olmos (Los),142,74,68
44,Teruel,174,Orihuela del Tremedal,577,299,278
44,Teruel,175,Orrios,172,89,83
44,Teruel,176,Palomar de Arroyos,210,121,89
44,Teruel,177,Pancrudo,104,59,45
44,Teruel,178,Parras de Castellote (Las),73,40,33
44,Teruel,179,Peñarroya de Tastavins,518,276,242
44,Teruel,180,Peracense,96,56,40
44,Teruel,181,Peralejos,83,44,39
44,Teruel,182,Perales del Alfambra,296,162,134
44,Teruel,183,Pitarque,104,48,56
44,Teruel,184,Plou,50,31,19
44,Teruel,185,Pobo (El),139,85,54
44,Teruel,187,Portellada (La),266,137,129
44,Teruel,189,Pozondón,83,40,43
44,Teruel,190,Pozuel del Campo,107,56,51
44,Teruel,191,Puebla de Híjar (La),1018,521,497
44,Teruel,192,Puebla de Valverde (La),540,301,239
44,Teruel,193,Puertomingalvo,259,176,83
44,Teruel,194,Ráfales,153,85,68
44,Teruel,195,Rillo,104,57,47
44,Teruel,196,Riodeva,198,97,101
44,Teruel,197,Ródenas,77,44,33
44,Teruel,198,Royuela,223,120,103
44,Teruel,199,Rubiales,58,36,22
44,Teruel,200,Rubielos de la Cérida,49,25,24
44,Teruel,201,Rubielos de Mora,770,399,371
44,Teruel,203,Salcedillo,13,7,6
44,Teruel,204,Saldón,31,21,10
44,Teruel,205,Samper de Calanda,961,479,482
44,Teruel,206,San Agustín,168,105,63
44,Teruel,207,San Martín del Río,210,105,105
44,Teruel,208,Santa Cruz de Nogueras,32,20,12
44,Teruel,209,Santa Eulalia,1163,576,587
44,Teruel,210,Sarrión,1124,622,502
44,Teruel,211,Segura de los Baños,39,26,13
44,Teruel,212,Seno,42,23,19
44,Teruel,213,Singra,94,54,40
44,Teruel,215,Terriente,187,110,77
44,Teruel,216,Teruel,35037,17130,17907
44,Teruel,217,Toril y Masegoso,34,24,10
44,Teruel,218,Tormón,35,21,14
44,Teruel,219,Tornos,240,127,113
44,Teruel,220,Torralba de los Sisones,222,122,100
44,Teruel,223,Torre de Arcas,106,57,49
44,Teruel,224,Torre de las Arcas,37,19,18
44,Teruel,225,Torre del Compte,162,84,78
44,Teruel,227,Torre los Negros,99,51,48
44,Teruel,221,Torrecilla de Alcañiz,433,225,208
44,Teruel,222,Torrecilla del Rebollar,160,83,77
44,Teruel,226,Torrelacárcel,218,115,103
44,Teruel,228,Torremocha de Jiloca,146,81,65
44,Teruel,229,Torres de Albarracín,151,82,69
44,Teruel,230,Torrevelilla,193,96,97
44,Teruel,231,Torrijas,73,34,39
44,Teruel,232,Torrijo del Campo,581,306,275
44,Teruel,234,Tramacastiel,101,60,41
44,Teruel,235,Tramacastilla,122,62,60
44,Teruel,236,Tronchón,111,60,51
44,Teruel,237,Urrea de Gaén,525,259,266
44,Teruel,238,Utrillas,3353,1756,1597
44,Teruel,239,Valacloche,37,20,17
44,Teruel,240,Valbona,205,114,91
44,Teruel,241,Valdealgorfa,685,333,352
44,Teruel,243,Valdecuenca,60,42,18
44,Teruel,244,Valdelinares,110,63,47
44,Teruel,245,Valdeltormo,338,181,157
44,Teruel,246,Valderrobres,2242,1210,1032
44,Teruel,247,Valjunquera,410,214,196
44,Teruel,249,Vallecillo (El),41,25,16
44,Teruel,250,Veguillas de la Sierra,29,18,11
44,Teruel,251,Villafranca del Campo,365,191,174
44,Teruel,252,Villahermosa del Campo,91,53,38
44,Teruel,256,Villanueva del Rebollar de la Sierra,51,28,23
44,Teruel,257,Villar del Cobo,217,115,102
44,Teruel,258,Villar del Salz,88,53,35
44,Teruel,260,Villarluengo,213,121,92
44,Teruel,261,Villarquemado,944,490,454
44,Teruel,262,Villarroya de los Pinares,187,103,84
44,Teruel,263,Villastar,359,189,170
44,Teruel,264,Villel,377,223,154
44,Teruel,265,Vinaceite,322,179,143
44,Teruel,266,Visiedo,162,73,89
44,Teruel,267,Vivel del Río Martín,92,48,44
44,Teruel,268,Zoma (La),22,9,13
45,Toledo,1,Ajofrín,2328,1215,1113
45,Toledo,2,Alameda de la Sagra,3324,1760,1564
45,Toledo,3,Albarreal de Tajo,709,362,347
45,Toledo,4,Alcabón,742,375,367
45,Toledo,5,Alcañizo,345,184,161
45,Toledo,6,Alcaudete de la Jara,2060,1030,1030
45,Toledo,7,Alcolea de Tajo,882,457,425
45,Toledo,8,Aldea en Cabo,217,122,95
45,Toledo,9,Aldeanueva de Barbarroya,681,339,342
45,Toledo,10,Aldeanueva de San Bartolomé,516,250,266
45,Toledo,11,Almendral de la Cañada,390,205,185
45,Toledo,12,Almonacid de Toledo,903,471,432
45,Toledo,13,Almorox,2465,1319,1146
45,Toledo,14,Añover de Tajo,5299,2755,2544
45,Toledo,15,Arcicóllar,762,398,364
45,Toledo,16,Argés,5178,2674,2504
45,Toledo,17,Azután,310,152,158
45,Toledo,18,Barcience,481,269,212
45,Toledo,19,Bargas,8654,4423,4231
45,Toledo,20,Belvís de la Jara,1868,950,918
45,Toledo,21,Borox,3017,1564,1453
45,Toledo,22,Buenaventura,488,256,232
45,Toledo,23,Burguillos de Toledo,2399,1215,1184
45,Toledo,24,Burujón,1411,742,669
45,Toledo,25,Cabañas de la Sagra,1802,961,841
45,Toledo,26,Cabañas de Yepes,270,139,131
45,Toledo,27,Cabezamesada,484,261,223
45,Toledo,28,Calera y Chozas,4452,2283,2169
45,Toledo,29,Caleruela,283,149,134
45,Toledo,30,Calzada de Oropesa,578,308,270
45,Toledo,31,Camarena,3291,1708,1583
45,Toledo,32,Camarenilla,630,343,287
45,Toledo,33,Campillo de la Jara (El),430,228,202
45,Toledo,34,Camuñas,1910,990,920
45,Toledo,35,Cardiel de los Montes,359,193,166
45,Toledo,36,Carmena,906,491,415
45,Toledo,37,Carpio de Tajo (El),2182,1089,1093
45,Toledo,38,Carranque,3591,1853,1738
45,Toledo,39,Carriches,313,166,147
45,Toledo,40,Casar de Escalona (El),2145,1163,982
45,Toledo,41,Casarrubios del Monte,4793,2560,2233
45,Toledo,42,Casasbuenas,241,122,119
45,Toledo,43,Castillo de Bayuela,1089,570,519
45,Toledo,45,Cazalegas,1760,913,847
45,Toledo,46,Cebolla,3723,1904,1819
45,Toledo,47,Cedillo del Condado,2520,1314,1206
45,Toledo,48,Cerralbos (Los),431,229,202
45,Toledo,49,Cervera de los Montes,414,221,193
45,Toledo,56,Chozas de Canales,3485,1888,1597
45,Toledo,57,Chueca,253,136,117
45,Toledo,50,Ciruelos,660,361,299
45,Toledo,51,Cobeja,2280,1203,1077
45,Toledo,52,Cobisa,3645,1889,1756
45,Toledo,53,Consuegra,10876,5525,5351
45,Toledo,54,Corral de Almaguer,6194,3211,2983
45,Toledo,55,Cuerva,1571,826,745
45,Toledo,58,Domingo Pérez,552,280,272
45,Toledo,59,Dosbarrios,2520,1295,1225
45,Toledo,60,Erustes,253,127,126
45,Toledo,61,Escalona,3468,1792,1676
45,Toledo,62,Escalonilla,1616,825,791
45,Toledo,63,Espinoso del Rey,609,329,280
45,Toledo,64,Esquivias,5130,2582,2548
45,Toledo,65,Estrella (La),318,160,158
45,Toledo,66,Fuensalida,10591,5439,5152
45,Toledo,67,Gálvez,3476,1800,1676
45,Toledo,68,Garciotum,152,74,78
45,Toledo,69,Gerindote,2376,1230,1146
45,Toledo,70,Guadamur,1819,929,890
45,Toledo,71,Guardia (La),2525,1269,1256
45,Toledo,72,Herencias (Las),811,429,382
45,Toledo,73,Herreruela de Oropesa,463,229,234
45,Toledo,74,Hinojosa de San Vicente,470,262,208
45,Toledo,75,Hontanar,159,87,72
45,Toledo,76,Hormigos,734,418,316
45,Toledo,77,Huecas,609,318,291
45,Toledo,78,Huerta de Valdecarábanos,1934,955,979
45,Toledo,79,Iglesuela (La),427,215,212
45,Toledo,80,Illán de Vacas,6,4,2
45,Toledo,81,Illescas,19167,9722,9445
45,Toledo,82,Lagartera,1601,800,801
45,Toledo,83,Layos,444,224,220
45,Toledo,84,Lillo,3126,1615,1511
45,Toledo,85,Lominchar,1735,923,812
45,Toledo,86,Lucillos,632,317,315
45,Toledo,87,Madridejos,11354,5754,5600
45,Toledo,88,Magán,2738,1466,1272
45,Toledo,89,Malpica de Tajo,2148,1090,1058
45,Toledo,90,Manzaneque,472,237,235
45,Toledo,91,Maqueda,544,283,261
45,Toledo,92,Marjaliza,321,165,156
45,Toledo,93,Marrupe,162,83,79
45,Toledo,94,Mascaraque,533,269,264
45,Toledo,95,Mata (La),1048,541,507
45,Toledo,96,Mazarambroz,1349,697,652
45,Toledo,97,Mejorada,1342,702,640
45,Toledo,98,Menasalbas,3344,1831,1513
45,Toledo,99,Méntrida,4288,2268,2020
45,Toledo,100,Mesegar de Tajo,258,134,124
45,Toledo,101,Miguel Esteban,5918,3064,2854
45,Toledo,102,Mocejón,4860,2517,2343
45,Toledo,103,Mohedas de la Jara,513,277,236
45,Toledo,104,Montearagón,568,288,280
45,Toledo,105,Montesclaros,395,211,184
45,Toledo,106,Mora,10536,5420,5116
45,Toledo,107,Nambroca,3415,1770,1645
45,Toledo,108,Nava de Ricomalillo (La),647,326,321
45,Toledo,109,Navahermosa,4310,2265,2045
45,Toledo,110,Navalcán,2361,1248,1113
45,Toledo,111,Navalmoralejo,77,39,38
45,Toledo,112,Navalmorales (Los),2770,1454,1316
45,Toledo,113,Navalucillos (Los),2665,1364,1301
45,Toledo,114,Navamorcuende,706,370,336
45,Toledo,115,Noblejas,3453,1819,1634
45,Toledo,116,Noez,863,454,409
45,Toledo,117,Nombela,1032,537,495
45,Toledo,118,Novés,2500,1326,1174
45,Toledo,119,Numancia de la Sagra,4448,2339,2109
45,Toledo,120,Nuño Gómez,198,108,90
45,Toledo,121,Ocaña,8835,4503,4332
45,Toledo,122,Olías del Rey,6413,3350,3063
45,Toledo,123,Ontígola,3451,1902,1549
45,Toledo,124,Orgaz,2838,1423,1415
45,Toledo,125,Oropesa,2940,1454,1486
45,Toledo,126,Otero,328,154,174
45,Toledo,127,Palomeque,878,476,402
45,Toledo,128,Pantoja,3427,1734,1693
45,Toledo,129,Paredes de Escalona,171,75,96
45,Toledo,130,Parrillas,418,211,207
45,Toledo,131,Pelahustán,385,208,177
45,Toledo,132,Pepino,2109,1101,1008
45,Toledo,133,Polán,3937,2025,1912
45,Toledo,134,Portillo de Toledo,2157,1112,1045
45,Toledo,135,Puebla de Almoradiel (La),6092,3112,2980
45,Toledo,136,Puebla de Montalbán (La),8216,4234,3982
45,Toledo,137,Pueblanueva (La),2331,1193,1138
45,Toledo,138,Puente del Arzobispo (El),1454,711,743
45,Toledo,139,Puerto de San Vicente,226,124,102
45,Toledo,140,Pulgar,1653,890,763
45,Toledo,141,Quero,1323,679,644
45,Toledo,142,Quintanar de la Orden,11067,5672,5395
45,Toledo,143,Quismondo,1664,845,819
45,Toledo,144,Real de San Vicente (El),1116,597,519
45,Toledo,145,Recas,3498,1973,1525
45,Toledo,146,Retamoso de la Jara,130,69,61
45,Toledo,147,Rielves,700,352,348
45,Toledo,148,Robledo del Mazo,414,221,193
45,Toledo,149,Romeral (El),824,413,411
45,Toledo,150,San Bartolomé de las Abiertas,574,311,263
45,Toledo,151,San Martín de Montalbán,794,387,407
45,Toledo,152,San Martín de Pusa,840,440,400
45,Toledo,153,San Pablo de los Montes,2271,1151,1120
45,Toledo,154,San Román de los Montes,1674,905,769
45,Toledo,155,Santa Ana de Pusa,484,263,221
45,Toledo,156,Santa Cruz de la Zarza,4955,2557,2398
45,Toledo,157,Santa Cruz del Retamar,2876,1486,1390
45,Toledo,158,Santa Olalla,3416,1773,1643
45,Toledo,901,Santo Domingo-Caudilla,954,475,479
45,Toledo,159,Sartajada,115,69,46
45,Toledo,160,Segurilla,1228,626,602
45,Toledo,161,Seseña,13843,7249,6594
45,Toledo,162,Sevilleja de la Jara,895,478,417
45,Toledo,163,Sonseca,11178,5717,5461
45,Toledo,164,Sotillo de las Palomas,215,113,102
45,Toledo,165,Talavera de la Reina,87763,43115,44648
45,Toledo,166,Tembleque,2361,1215,1146
45,Toledo,167,Toboso (El),2243,1138,1105
45,Toledo,168,Toledo,80810,39023,41787
45,Toledo,169,Torralba de Oropesa,274,134,140
45,Toledo,171,Torre de Esteban Hambrán (La),1758,930,828
45,Toledo,170,Torrecilla de la Jara,317,155,162
45,Toledo,172,Torrico,855,453,402
45,Toledo,173,Torrijos,12674,6377,6297
45,Toledo,174,Totanés,438,221,217
45,Toledo,175,Turleque,958,479,479
45,Toledo,176,Ugena,4967,2605,2362
45,Toledo,177,Urda,3166,1588,1578
45,Toledo,179,Valdeverdeja,732,344,388
45,Toledo,180,Valmojado,3555,1880,1675
45,Toledo,181,Velada,2715,1412,1303
45,Toledo,182,Ventas con Peña Aguilera (Las),1355,696,659
45,Toledo,183,Ventas de Retamosa (Las),2477,1310,1167
45,Toledo,184,Ventas de San Julián (Las),232,107,125
45,Toledo,186,Villa de Don Fadrique (La),4210,2110,2100
45,Toledo,185,Villacañas,10605,5326,5279
45,Toledo,187,Villafranca de los Caballeros,5555,2789,2766
45,Toledo,188,Villaluenga de la Sagra,3756,1912,1844
45,Toledo,189,Villamiel de Toledo,812,427,385
45,Toledo,190,Villaminaya,608,304,304
45,Toledo,191,Villamuelas,751,376,375
45,Toledo,192,Villanueva de Alcardete,3806,1973,1833
45,Toledo,193,Villanueva de Bogas,802,410,392
45,Toledo,194,Villarejo de Montalbán,67,36,31
45,Toledo,195,Villarrubia de Santiago,2910,1479,1431
45,Toledo,196,Villaseca de la Sagra,1715,873,842
45,Toledo,197,Villasequilla,2641,1391,1250
45,Toledo,198,Villatobas,2682,1361,1321
45,Toledo,199,Viso de San Juan (El),3058,1667,1391
45,Toledo,200,Yébenes (Los),6434,3275,3159
45,Toledo,201,Yeles,4231,2280,1951
45,Toledo,202,Yepes,5179,2672,2507
45,Toledo,203,Yuncler,3161,1637,1524
45,Toledo,204,Yunclillos,791,415,376
45,Toledo,205,Yuncos,8623,4520,4103
46,Valencia/València,1,Ademuz,1269,668,601
46,Valencia/València,2,Ador,1513,782,731
46,Valencia/València,4,Agullent,2418,1177,1241
46,Valencia/València,42,Aielo de Malferit,4637,2311,2326
46,Valencia/València,43,Aielo de Rugat,188,102,86
46,Valencia/València,5,Alaquàs,30297,15079,15218
46,Valencia/València,6,Albaida,6420,3213,3207
46,Valencia/València,7,Albal,15084,7639,7445
46,Valencia/València,8,Albalat de la Ribera,3541,1772,1769
46,Valencia/València,9,Albalat dels Sorells,3758,1830,1928
46,Valencia/València,10,Albalat dels Tarongers,1121,566,555
46,Valencia/València,11,Alberic,10932,5508,5424
46,Valencia/València,12,Alborache,1107,569,538
46,Valencia/València,13,Alboraya,22174,11136,11038
46,Valencia/València,14,Albuixech,3793,1872,1921
46,Valencia/València,16,Alcàntera de Xúquer,1446,720,726
46,Valencia/València,15,Alcàsser,8925,4554,4371
46,Valencia/València,18,Alcublas,842,433,409
46,Valencia/València,19,Alcúdia (l'),11331,5592,5739
46,Valencia/València,20,Alcúdia de Crespins (l'),5206,2679,2527
46,Valencia/València,21,Aldaia,29173,14597,14576
46,Valencia/València,22,Alfafar,20655,10271,10384
46,Valencia/València,24,Alfara de Algimia,518,261,257
46,Valencia/València,25,Alfara del Patriarca,2985,1499,1486
46,Valencia/València,26,Alfarp,1441,730,711
46,Valencia/València,27,Alfarrasí,1313,640,673
46,Valencia/València,23,Alfauir,444,229,215
46,Valencia/València,28,Algar de Palancia,583,299,284
46,Valencia/València,29,Algemesí,27770,13791,13979
46,Valencia/València,30,Algimia de Alfara,1078,537,541
46,Valencia/València,31,Alginet,13057,6646,6411
46,Valencia/València,32,Almàssera,6955,3365,3590
46,Valencia/València,33,Almiserà,294,148,146
46,Valencia/València,34,Almoines,2339,1202,1137
46,Valencia/València,35,Almussafes,8189,4113,4076
46,Valencia/València,36,Alpuente,833,454,379
46,Valencia/València,37,Alqueria de la Comtessa (l'),1508,757,751
46,Valencia/València,17,Alzira,43892,21456,22436
46,Valencia/València,38,Andilla,346,198,148
46,Valencia/València,39,Anna,2753,1392,1361
46,Valencia/València,40,Antella,1549,778,771
46,Valencia/València,41,Aras de los Olmos,427,241,186
46,Valencia/València,3,Atzeneta d'Albaida,1280,671,609
46,Valencia/València,44,Ayora,5507,2798,2709
46,Valencia/València,46,Barx,1481,740,741
46,Valencia/València,45,Barxeta,1671,854,817
46,Valencia/València,47,Bèlgida,722,356,366
46,Valencia/València,48,Bellreguard,4647,2319,2328
46,Valencia/València,49,Bellús,385,194,191
46,Valencia/València,50,Benagéber,156,82,74
46,Valencia/València,51,Benaguasil,10728,5541,5187
46,Valencia/València,52,Benavites,629,304,325
46,Valencia/València,53,Beneixida,676,318,358
46,Valencia/València,54,Benetússer,14824,7472,7352
46,Valencia/València,55,Beniarjó,1759,863,896
46,Valencia/València,56,Beniatjar,249,129,120
46,Valencia/València,57,Benicolet,627,321,306
46,Valencia/València,904,Benicull de Xúquer,950,480,470
46,Valencia/València,60,Benifaió,12119,5983,6136
46,Valencia/València,59,Benifairó de la Valldigna,1697,861,836
46,Valencia/València,58,Benifairó de les Valls,2079,1044,1035
46,Valencia/València,61,Beniflá,396,217,179
46,Valencia/València,62,Benigánim,6366,3301,3065
46,Valencia/València,63,Benimodo,2209,1130,1079
46,Valencia/València,64,Benimuslem,620,312,308
46,Valencia/València,65,Beniparrell,1955,1017,938
46,Valencia/València,66,Benirredrà,1566,765,801
46,Valencia/València,67,Benisanó,2136,1091,1045
46,Valencia/València,68,Benissoda,371,202,169
46,Valencia/València,69,Benisuera,192,99,93
46,Valencia/València,70,Bétera,20292,10137,10155
46,Valencia/València,71,Bicorp,596,306,290
46,Valencia/València,72,Bocairent,4514,2271,2243
46,Valencia/València,73,Bolbaite,1487,774,713
46,Valencia/València,74,Bonrepòs i Mirambell,3132,1542,1590
46,Valencia/València,75,Bufali,191,102,89
46,Valencia/València,76,Bugarra,871,448,423
46,Valencia/València,77,Buñol,9940,5001,4939
46,Valencia/València,78,Burjassot,37667,18414,19253
46,Valencia/València,79,Calles,439,240,199
46,Valencia/València,80,Camporrobles,1423,726,697
46,Valencia/València,81,Canals,13851,7012,6839
46,Valencia/València,82,Canet d'En Berenguer,5418,2800,2618
46,Valencia/València,83,Carcaixent,21973,10927,11046
46,Valencia/València,84,Càrcer,2120,1027,1093
46,Valencia/València,85,Carlet,15366,7761,7605
46,Valencia/València,86,Carrícola,82,42,40
46,Valencia/València,87,Casas Altas,188,100,88
46,Valencia/València,88,Casas Bajas,231,126,105
46,Valencia/València,89,Casinos,2590,1329,1261
46,Valencia/València,90,Castelló de Rugat,2405,1232,1173
46,Valencia/València,91,Castellonet de la Conquesta,164,90,74
46,Valencia/València,92,Castielfabib,232,125,107
46,Valencia/València,93,Catadau,2649,1338,1311
46,Valencia/València,94,Catarroja,26552,13210,13342
46,Valencia/València,95,Caudete de las Fuentes,796,438,358
46,Valencia/València,96,Cerdà,379,196,183
46,Valencia/València,107,Chella,2860,1447,1413
46,Valencia/València,106,Chelva,1803,926,877
46,Valencia/València,108,Chera,619,338,281
46,Valencia/València,109,Cheste,8127,4223,3904
46,Valencia/València,111,Chiva,13494,6985,6509
46,Valencia/València,112,Chulilla,848,446,402
46,Valencia/València,97,Cofrentes,974,478,496
46,Valencia/València,98,Corbera,3300,1625,1675
46,Valencia/València,99,Cortes de Pallás,974,503,471
46,Valencia/València,100,Cotes,378,188,190
46,Valencia/València,105,Cullera,23777,12059,11718
46,Valencia/València,113,Daimús,3007,1538,1469
46,Valencia/València,114,Domeño,744,385,359
46,Valencia/València,115,Dos Aguas,496,291,205
46,Valencia/València,116,Eliana (l'),16549,8196,8353
46,Valencia/València,117,Emperador,559,289,270
46,Valencia/València,118,Enguera,5895,3084,2811
46,Valencia/València,119,Ènova (l'),1018,522,496
46,Valencia/València,120,Estivella,1302,632,670
46,Valencia/València,121,Estubeny,138,71,67
46,Valencia/València,122,Faura,3420,1744,1676
46,Valencia/València,123,Favara,2118,1056,1062
46,Valencia/València,126,Foios,6477,3182,3295
46,Valencia/València,128,Font de la Figuera (la),2240,1131,1109
46,Valencia/València,127,Font d'En Carròs (la),4127,2084,2043
46,Valencia/València,124,Fontanars dels Alforins,1024,527,497
46,Valencia/València,125,Fortaleny,1014,504,510
46,Valencia/València,129,Fuenterrobles,737,385,352
46,Valencia/València,131,Gandia,79958,40557,39401
46,Valencia/València,902,Gátova,478,231,247
46,Valencia/València,130,Gavarda,1161,578,583
46,Valencia/València,132,Genovés,2816,1425,1391
46,Valencia/València,133,Gestalgar,763,392,371
46,Valencia/València,134,Gilet,2725,1412,1313
46,Valencia/València,135,Godella,12835,6238,6597
46,Valencia/València,136,Godelleta,3248,1666,1582
46,Valencia/València,137,Granja de la Costera (la),342,173,169
46,Valencia/València,138,Guadasequies,439,226,213
46,Valencia/València,139,Guadassuar,6160,3069,3091
46,Valencia/València,140,Guardamar de la Safor,362,206,156
46,Valencia/València,141,Higueruelas,520,265,255
46,Valencia/València,142,Jalance,1052,529,523
46,Valencia/València,144,Jarafuel,822,428,394
46,Valencia/València,154,Llanera de Ranes,1098,573,525
46,Valencia/València,155,Llaurí,1343,694,649
46,Valencia/València,147,Llíria,22441,11425,11016
46,Valencia/València,152,Llocnou de la Corona,105,56,49
46,Valencia/València,153,Llocnou de Sant Jeroni,577,276,301
46,Valencia/València,151,Llocnou d'En Fenollet,869,453,416
46,Valencia/València,156,Llombai,2739,1409,1330
46,Valencia/València,157,Llosa de Ranes (la),3928,2057,1871
46,Valencia/València,150,Llutxent,2588,1322,1266
46,Valencia/València,148,Loriguilla,1364,697,667
46,Valencia/València,149,Losa del Obispo,580,311,269
46,Valencia/València,158,Macastre,1293,658,635
46,Valencia/València,159,Manises,30478,15235,15243
46,Valencia/València,160,Manuel,2693,1310,1383
46,Valencia/València,161,Marines,1688,860,828
46,Valencia/València,162,Masalavés,1635,865,770
46,Valencia/València,163,Massalfassar,2026,1008,1018
46,Valencia/València,164,Massamagrell,14861,7385,7476
46,Valencia/València,165,Massanassa,8784,4337,4447
46,Valencia/València,166,Meliana,10198,5072,5126
46,Valencia/València,167,Millares,503,244,259
46,Valencia/València,168,Miramar,2168,1124,1044
46,Valencia/València,169,Mislata,43740,21494,22246
46,Valencia/València,170,Mogente/Moixent,4724,2412,2312
46,Valencia/València,171,Moncada,21651,10814,10837
46,Valencia/València,173,Montaverner,1853,913,940
46,Valencia/València,174,Montesa,1424,728,696
46,Valencia/València,175,Montitxelvo/Montichelvo,651,333,318
46,Valencia/València,176,Montroy,2720,1461,1259
46,Valencia/València,172,Montserrat,6089,3299,2790
46,Valencia/València,177,Museros,5072,2577,2495
46,Valencia/València,178,Náquera,5248,2714,2534
46,Valencia/València,179,Navarrés,3185,1654,1531
46,Valencia/València,180,Novelé/Novetlè,789,390,399
46,Valencia/València,181,Oliva,28279,14345,13934
46,Valencia/València,183,Olleria (l'),8514,4332,4182
46,Valencia/València,182,Olocau,1415,735,680
46,Valencia/València,184,Ontinyent,37518,18821,18697
46,Valencia/València,185,Otos,503,258,245
46,Valencia/València,186,Paiporta,23245,11742,11503
46,Valencia/València,187,Palma de Gandía,1845,949,896
46,Valencia/València,188,Palmera,926,471,455
46,Valencia/València,189,Palomar (el),568,276,292
46,Valencia/València,190,Paterna,61941,31097,30844
46,Valencia/València,191,Pedralba,2793,1515,1278
46,Valencia/València,192,Petrés,971,486,485
46,Valencia/València,193,Picanya,10861,5393,5468
46,Valencia/València,194,Picassent,19385,9885,9500
46,Valencia/València,195,Piles,2773,1428,1345
46,Valencia/València,196,Pinet,193,100,93
46,Valencia/València,199,Pobla de Farnals (la),7080,3593,3487
46,Valencia/València,202,Pobla de Vallbona (la),19540,9976,9564
46,Valencia/València,200,Pobla del Duc (la),2599,1277,1322
46,Valencia/València,203,Pobla Llarga (la),4510,2237,2273
46,Valencia/València,197,Polinyà de Xúquer,2479,1250,1229
46,Valencia/València,198,Potríes,953,469,484
46,Valencia/València,205,Puçol,18482,9205,9277
46,Valencia/València,201,Puebla de San Miguel,66,42,24
46,Valencia/València,204,Puig,8499,4232,4267
46,Valencia/València,101,Quart de les Valls,1086,526,560
46,Valencia/València,102,Quart de Poblet,25441,12518,12923
46,Valencia/València,103,Quartell,1443,712,731
46,Valencia/València,104,Quatretonda,2534,1304,1230
46,Valencia/València,206,Quesa,722,383,339
46,Valencia/València,207,Rafelbuñol/Rafelbunyol,7647,3793,3854
46,Valencia/València,208,Rafelcofer,1510,728,782
46,Valencia/València,209,Rafelguaraf,2489,1231,1258
46,Valencia/València,210,Ráfol de Salem,450,224,226
46,Valencia/València,211,Real de Gandía,2141,1055,1086
46,Valencia/València,212,Real de Montroi,2283,1216,1067
46,Valencia/València,213,Requena,20807,10540,10267
46,Valencia/València,214,Riba-roja de Túria,19938,10132,9806
46,Valencia/València,215,Riola,1826,934,892
46,Valencia/València,216,Rocafort,6584,3259,3325
46,Valencia/València,217,Rotglà i Corberà,1223,614,609
46,Valencia/València,218,Rótova,1341,693,648
46,Valencia/València,219,Rugat,181,90,91
46,Valencia/València,220,Sagunto/Sagunt,65821,32781,33040
46,Valencia/València,221,Salem,476,242,234
46,Valencia/València,903,San Antonio de Benagéber,5330,2659,2671
46,Valencia/València,222,San Juan de Énova,448,217,231
46,Valencia/València,223,Sedaví,9750,4799,4951
46,Valencia/València,224,Segart,140,66,74
46,Valencia/València,225,Sellent,437,227,210
46,Valencia/València,226,Sempere,38,18,20
46,Valencia/València,227,Senyera,1197,603,594
46,Valencia/València,228,Serra,2990,1547,1443
46,Valencia/València,229,Siete Aguas,1424,734,690
46,Valencia/València,230,Silla,18985,9649,9336
46,Valencia/València,231,Simat de la Valldigna,3589,1858,1731
46,Valencia/València,232,Sinarcas,1193,615,578
46,Valencia/València,233,Sollana,4889,2415,2474
46,Valencia/València,234,Sot de Chera,441,222,219
46,Valencia/València,235,Sueca,28713,14359,14354
46,Valencia/València,236,Sumacàrcer,1295,653,642
46,Valencia/València,237,Tavernes Blanques,9353,4629,4724
46,Valencia/València,238,Tavernes de la Valldigna,18364,9315,9049
46,Valencia/València,239,Teresa de Cofrentes,724,374,350
46,Valencia/València,240,Terrateig,339,177,162
46,Valencia/València,241,Titaguas,534,267,267
46,Valencia/València,242,Torrebaja,433,239,194
46,Valencia/València,243,Torrella,150,84,66
46,Valencia/València,244,Torrent,76927,38580,38347
46,Valencia/València,245,Torres Torres,550,295,255
46,Valencia/València,246,Tous,1172,603,569
46,Valencia/València,247,Tuéjar,1271,676,595
46,Valencia/València,248,Turís,6317,3324,2993
46,Valencia/València,249,Utiel,12294,6164,6130
46,Valencia/València,250,Valencia,807200,388589,418611
46,Valencia/València,251,Vallada,3466,1773,1693
46,Valencia/València,252,Vallanca,170,85,85
46,Valencia/València,253,Vallés,131,73,58
46,Valencia/València,254,Venta del Moro,1401,728,673
46,Valencia/València,256,Vilamarxant,8257,4257,4000
46,Valencia/València,255,Villalonga,4316,2172,2144
46,Valencia/València,257,Villanueva de Castellón,7666,3855,3811
46,Valencia/València,258,Villar del Arzobispo,3863,1988,1875
46,Valencia/València,259,Villargordo del Cabriel,700,363,337
46,Valencia/València,260,Vinalesa,2970,1453,1517
46,Valencia/València,145,Xàtiva,29363,14497,14866
46,Valencia/València,143,Xeraco,6259,3279,2980
46,Valencia/València,146,Xeresa,2220,1124,1096
46,Valencia/València,110,Xirivella,30633,15444,15189
46,Valencia/València,261,Yátova,2166,1121,1045
46,Valencia/València,262,Yesa (La),259,141,118
46,Valencia/València,263,Zarra,547,304,243
47,Valladolid,1,Adalia,61,33,28
47,Valladolid,2,Aguasal,31,20,11
47,Valladolid,3,Aguilar de Campos,306,166,140
47,Valladolid,4,Alaejos,1613,843,770
47,Valladolid,5,Alcazarén,717,388,329
47,Valladolid,6,Aldea de San Miguel,228,118,110
47,Valladolid,7,Aldeamayor de San Martín,2852,1449,1403
47,Valladolid,8,Almenara de Adaja,32,18,14
47,Valladolid,9,Amusquillo,130,77,53
47,Valladolid,10,Arroyo de la Encomienda,10872,5608,5264
47,Valladolid,11,Ataquines,750,404,346
47,Valladolid,12,Bahabón,173,86,87
47,Valladolid,13,Barcial de la Loma,136,70,66
47,Valladolid,14,Barruelo del Valle,64,40,24
47,Valladolid,15,Becilla de Valderaduey,318,173,145
47,Valladolid,16,Benafarces,92,50,42
47,Valladolid,17,Bercero,235,128,107
47,Valladolid,18,Berceruelo,47,26,21
47,Valladolid,19,Berrueces,116,69,47
47,Valladolid,20,Bobadilla del Campo,342,185,157
47,Valladolid,21,Bocigas,110,52,58
47,Valladolid,22,Bocos de Duero,68,28,40
47,Valladolid,23,Boecillo,3324,1718,1606
47,Valladolid,24,Bolaños de Campos,359,189,170
47,Valladolid,25,Brahojos de Medina,155,80,75
47,Valladolid,26,Bustillo de Chaves,104,54,50
47,Valladolid,27,Cabezón de Pisuerga,3146,1611,1535
47,Valladolid,28,Cabezón de Valderaduey,49,29,20
47,Valladolid,29,Cabreros del Monte,89,46,43
47,Valladolid,30,Campaspero,1413,751,662
47,Valladolid,31,Campillo (El),251,138,113
47,Valladolid,32,Camporredondo,172,94,78
47,Valladolid,33,Canalejas de Peñafiel,306,158,148
47,Valladolid,34,Canillas de Esgueva,101,53,48
47,Valladolid,35,Carpio,1108,584,524
47,Valladolid,36,Casasola de Arión,320,174,146
47,Valladolid,37,Castrejón de Trabancos,226,113,113
47,Valladolid,38,Castrillo de Duero,152,82,70
47,Valladolid,39,Castrillo-Tejeriego,214,119,95
47,Valladolid,40,Castrobol,93,42,51
47,Valladolid,41,Castrodeza,187,111,76
47,Valladolid,42,Castromembibre,74,38,36
47,Valladolid,43,Castromonte,415,222,193
47,Valladolid,44,Castronuevo de Esgueva,388,212,176
47,Valladolid,45,Castronuño,1006,498,508
47,Valladolid,46,Castroponce,163,91,72
47,Valladolid,47,Castroverde de Cerrato,271,162,109
47,Valladolid,48,Ceinos de Campos,265,134,131
47,Valladolid,49,Cervillego de la Cruz,118,59,59
47,Valladolid,50,Cigales,4157,2138,2019
47,Valladolid,51,Ciguñuela,385,202,183
47,Valladolid,52,Cistérniga,7620,3929,3691
47,Valladolid,53,Cogeces de Íscar,174,100,74
47,Valladolid,54,Cogeces del Monte,818,451,367
47,Valladolid,55,Corcos,245,133,112
47,Valladolid,56,Corrales de Duero,110,67,43
47,Valladolid,57,Cubillas de Santa Marta,309,180,129
47,Valladolid,58,Cuenca de Campos,229,120,109
47,Valladolid,59,Curiel de Duero,130,78,52
47,Valladolid,60,Encinas de Esgueva,292,157,135
47,Valladolid,61,Esguevillas de Esgueva,309,160,149
47,Valladolid,62,Fombellida,213,117,96
47,Valladolid,63,Fompedraza,133,74,59
47,Valladolid,64,Fontihoyuelo,37,22,15
47,Valladolid,65,Fresno el Viejo,1089,569,520
47,Valladolid,66,Fuensaldaña,1346,674,672
47,Valladolid,67,Fuente el Sol,238,131,107
47,Valladolid,68,Fuente-Olmedo,48,27,21
47,Valladolid,69,Gallegos de Hornija,150,73,77
47,Valladolid,70,Gatón de Campos,39,24,15
47,Valladolid,71,Geria,487,262,225
47,Valladolid,73,Herrín de Campos,170,82,88
47,Valladolid,74,Hornillos de Eresma,186,99,87
47,Valladolid,75,Íscar,6913,3527,3386
47,Valladolid,76,Laguna de Duero,21483,10885,10598
47,Valladolid,77,Langayo,346,199,147
47,Valladolid,79,Llano de Olmedo,78,44,34
47,Valladolid,78,Lomoviejo,219,116,103
47,Valladolid,80,Manzanillo,58,31,27
47,Valladolid,81,Marzales,59,28,31
47,Valladolid,82,Matapozuelos,1066,543,523
47,Valladolid,83,Matilla de los Caños,103,60,43
47,Valladolid,84,Mayorga,1966,973,993
47,Valladolid,86,Medina de Rioseco,5008,2456,2552
47,Valladolid,85,Medina del Campo,21256,10369,10887
47,Valladolid,87,Megeces,479,248,231
47,Valladolid,88,Melgar de Abajo,149,85,64
47,Valladolid,89,Melgar de Arriba,233,121,112
47,Valladolid,90,Mojados,3281,1702,1579
47,Valladolid,91,Monasterio de Vega,91,48,43
47,Valladolid,92,Montealegre de Campos,145,85,60
47,Valladolid,93,Montemayor de Pililla,1029,532,497
47,Valladolid,94,Moral de la Reina,208,111,97
47,Valladolid,95,Moraleja de las Panaderas,46,31,15
47,Valladolid,96,Morales de Campos,166,81,85
47,Valladolid,97,Mota del Marqués,420,215,205
47,Valladolid,98,Mucientes,709,366,343
47,Valladolid,99,Mudarra (La),196,110,86
47,Valladolid,100,Muriel,184,95,89
47,Valladolid,101,Nava del Rey,2179,1110,1069
47,Valladolid,102,Nueva Villa de las Torres,369,210,159
47,Valladolid,103,Olivares de Duero,321,174,147
47,Valladolid,104,Olmedo,3811,1884,1927
47,Valladolid,105,Olmos de Esgueva,234,128,106
47,Valladolid,106,Olmos de Peñafiel,76,42,34
47,Valladolid,109,Palazuelo de Vedija,249,132,117
47,Valladolid,110,Parrilla (La),583,294,289
47,Valladolid,111,Pedraja de Portillo (La),1154,600,554
47,Valladolid,112,Pedrajas de San Esteban,3661,1862,1799
47,Valladolid,113,Pedrosa del Rey,210,111,99
47,Valladolid,114,Peñafiel,5567,2808,2759
47,Valladolid,115,Peñaflor de Hornija,365,197,168
47,Valladolid,116,Pesquera de Duero,539,288,251
47,Valladolid,117,Piña de Esgueva,362,177,185
47,Valladolid,118,Piñel de Abajo,193,107,86
47,Valladolid,119,Piñel de Arriba,146,77,69
47,Valladolid,121,Pollos,730,387,343
47,Valladolid,122,Portillo,2607,1347,1260
47,Valladolid,123,Pozal de Gallinas,507,278,229
47,Valladolid,124,Pozaldez,564,287,277
47,Valladolid,125,Pozuelo de la Orden,63,38,25
47,Valladolid,126,Puras,56,28,28
47,Valladolid,127,Quintanilla de Arriba,204,110,94
47,Valladolid,129,Quintanilla de Onésimo,1173,603,570
47,Valladolid,130,Quintanilla de Trigueros,115,58,57
47,Valladolid,128,Quintanilla del Molar,75,35,40
47,Valladolid,131,Rábano,221,117,104
47,Valladolid,132,Ramiro,52,30,22
47,Valladolid,133,Renedo de Esgueva,2527,1321,1206
47,Valladolid,134,Roales de Campos,234,123,111
47,Valladolid,135,Robladillo,101,52,49
47,Valladolid,137,Roturas,34,18,16
47,Valladolid,138,Rubí de Bracamonte,309,163,146
47,Valladolid,139,Rueda,1418,731,687
47,Valladolid,140,Saelices de Mayorga,156,85,71
47,Valladolid,141,Salvador de Zapardiel,172,97,75
47,Valladolid,142,San Cebrián de Mazote,179,99,80
47,Valladolid,143,San Llorente,172,94,78
47,Valladolid,144,San Martín de Valvení,98,53,45
47,Valladolid,145,San Miguel del Arroyo,776,401,375
47,Valladolid,146,San Miguel del Pino,280,150,130
47,Valladolid,147,San Pablo de la Moraleja,156,81,75
47,Valladolid,148,San Pedro de Latarce,577,306,271
47,Valladolid,149,San Pelayo,43,21,22
47,Valladolid,150,San Román de Hornija,408,191,217
47,Valladolid,151,San Salvador,37,21,16
47,Valladolid,156,San Vicente del Palacio,223,120,103
47,Valladolid,152,Santa Eufemia del Arroyo,113,58,55
47,Valladolid,153,Santervás de Campos,141,80,61
47,Valladolid,154,Santibáñez de Valcorba,193,101,92
47,Valladolid,155,Santovenia de Pisuerga,3415,1743,1672
47,Valladolid,157,Sardón de Duero,707,356,351
47,Valladolid,158,Seca (La),1105,574,531
47,Valladolid,159,Serrada,1146,591,555
47,Valladolid,160,Siete Iglesias de Trabancos,561,305,256
47,Valladolid,161,Simancas,5053,2584,2469
47,Valladolid,162,Tamariz de Campos,101,52,49
47,Valladolid,163,Tiedra,360,179,181
47,Valladolid,164,Tordehumos,483,244,239
47,Valladolid,165,Tordesillas,8512,4333,4179
47,Valladolid,169,Torre de Esgueva,83,40,43
47,Valladolid,170,Torre de Peñafiel,45,25,20
47,Valladolid,166,Torrecilla de la Abadesa,323,166,157
47,Valladolid,167,Torrecilla de la Orden,300,150,150
47,Valladolid,168,Torrecilla de la Torre,36,24,12
47,Valladolid,171,Torrelobatón,519,252,267
47,Valladolid,172,Torrescárcela,167,92,75
47,Valladolid,173,Traspinedo,1007,544,463
47,Valladolid,174,Trigueros del Valle,350,186,164
47,Valladolid,175,Tudela de Duero,8252,4251,4001
47,Valladolid,176,Unión de Campos (La),293,147,146
47,Valladolid,177,Urones de Castroponce,127,73,54
47,Valladolid,178,Urueña,221,118,103
47,Valladolid,179,Valbuena de Duero,506,267,239
47,Valladolid,180,Valdearcos de la Vega,131,62,69
47,Valladolid,181,Valdenebro de los Valles,221,112,109
47,Valladolid,182,Valdestillas,1818,944,874
47,Valladolid,183,Valdunquillo,172,84,88
47,Valladolid,186,Valladolid,318461,152085,166376
47,Valladolid,184,Valoria la Buena,667,354,313
47,Valladolid,185,Valverde de Campos,123,68,55
47,Valladolid,187,Vega de Ruiponce,121,66,55
47,Valladolid,188,Vega de Valdetronco,146,79,67
47,Valladolid,189,Velascálvaro,199,110,89
47,Valladolid,190,Velilla,133,67,66
47,Valladolid,191,Velliza,134,79,55
47,Valladolid,192,Ventosa de la Cuesta,150,88,62
47,Valladolid,193,Viana de Cega,1898,973,925
47,Valladolid,195,Villabáñez,518,279,239
47,Valladolid,196,Villabaruz de Campos,43,22,21
47,Valladolid,197,Villabrágima,1121,596,525
47,Valladolid,198,Villacarralón,106,57,49
47,Valladolid,199,Villacid de Campos,100,53,47
47,Valladolid,200,Villaco,105,63,42
47,Valladolid,203,Villafrades de Campos,83,38,45
47,Valladolid,204,Villafranca de Duero,385,201,184
47,Valladolid,205,Villafrechós,509,268,241
47,Valladolid,206,Villafuerte,129,68,61
47,Valladolid,207,Villagarcía de Campos,393,228,165
47,Valladolid,208,Villagómez la Nueva,73,39,34
47,Valladolid,209,Villalán de Campos,49,27,22
47,Valladolid,210,Villalar de los Comuneros,457,227,230
47,Valladolid,211,Villalba de la Loma,47,25,22
47,Valladolid,212,Villalba de los Alcores,501,266,235
47,Valladolid,213,Villalbarba,143,72,71
47,Valladolid,214,Villalón de Campos,1942,957,985
47,Valladolid,215,Villamuriel de Campos,81,37,44
47,Valladolid,216,Villán de Tordesillas,146,76,70
47,Valladolid,217,Villanubla,1931,1017,914
47,Valladolid,218,Villanueva de Duero,1183,613,570
47,Valladolid,219,Villanueva de la Condesa,69,35,34
47,Valladolid,220,Villanueva de los Caballeros,234,118,116
47,Valladolid,221,Villanueva de los Infantes,127,74,53
47,Valladolid,222,Villanueva de San Mancio,123,66,57
47,Valladolid,223,Villardefrades,200,108,92
47,Valladolid,224,Villarmentero de Esgueva,111,58,53
47,Valladolid,225,Villasexmir,98,53,45
47,Valladolid,226,Villavaquerín,202,113,89
47,Valladolid,227,Villavellid,75,41,34
47,Valladolid,228,Villaverde de Medina,556,301,255
47,Valladolid,229,Villavicencio de los Caballeros,260,129,131
47,Valladolid,194,Viloria,384,205,179
47,Valladolid,230,Wamba,360,193,167
47,Valladolid,231,Zaratán,4687,2396,2291
47,Valladolid,232,Zarza (La),142,81,61
48,Vizcaya,1,Abadiño,7197,3617,3580
48,Vizcaya,2,Abanto y Ciérvana-Abanto Zierbena,9608,4733,4875
48,Vizcaya,911,Ajangiz,445,214,231
48,Vizcaya,912,Alonsotegi,2831,1379,1452
48,Vizcaya,3,Amorebieta-Etxano,17626,8715,8911
48,Vizcaya,4,Amoroto,404,205,199
48,Vizcaya,5,Arakaldo,93,53,40
48,Vizcaya,6,Arantzazu,307,148,159
48,Vizcaya,93,Areatza,1110,529,581
48,Vizcaya,9,Arrankudiaga,885,433,452
48,Vizcaya,914,Arratzu,358,180,178
48,Vizcaya,10,Arrieta,551,281,270
48,Vizcaya,11,Arrigorriaga,12399,6143,6256
48,Vizcaya,23,Artea,727,365,362
48,Vizcaya,8,Artzentales,710,390,320
48,Vizcaya,91,Atxondo,1456,733,723
48,Vizcaya,70,Aulesti,680,339,341
48,Vizcaya,12,Bakio,2258,1139,1119
48,Vizcaya,90,Balmaseda,7174,3503,3671
48,Vizcaya,13,Barakaldo,97328,47242,50086
48,Vizcaya,14,Barrika,1417,706,711
48,Vizcaya,15,Basauri,42966,21073,21893
48,Vizcaya,92,Bedia,982,472,510
48,Vizcaya,16,Berango,6440,3148,3292
48,Vizcaya,17,Bermeo,16940,8323,8617
48,Vizcaya,18,Berriatua,1282,715,567
48,Vizcaya,19,Berriz,4829,2454,2375
48,Vizcaya,20,Bilbao,353340,167030,186310
48,Vizcaya,21,Busturia,1716,881,835
48,Vizcaya,901,Derio,5253,2613,2640
48,Vizcaya,26,Dima,1266,659,607
48,Vizcaya,27,Durango,27861,13673,14188
48,Vizcaya,28,Ea,892,459,433
48,Vizcaya,31,Elantxobe,438,208,230
48,Vizcaya,32,Elorrio,7165,3550,3615
48,Vizcaya,902,Erandio,23987,11781,12206
48,Vizcaya,33,Ereño,253,126,127
48,Vizcaya,34,Ermua,16277,8238,8039
48,Vizcaya,79,Errigoiti,518,280,238
48,Vizcaya,29,Etxebarri,8536,4347,4189
48,Vizcaya,30,Etxebarria,832,437,395
48,Vizcaya,906,Forua,986,501,485
48,Vizcaya,35,Fruiz,408,212,196
48,Vizcaya,36,Galdakao,29234,14507,14727
48,Vizcaya,37,Galdames,813,424,389
48,Vizcaya,38,Gamiz-Fika,1283,660,623
48,Vizcaya,39,Garai,321,158,163
48,Vizcaya,40,Gatika,1520,782,738
48,Vizcaya,41,Gautegiz Arteaga,870,436,434
48,Vizcaya,46,Gernika-Lumo,16255,7896,8359
48,Vizcaya,44,Getxo,81260,38368,42892
48,Vizcaya,47,Gizaburuaga,182,90,92
48,Vizcaya,42,Gordexola,1704,838,866
48,Vizcaya,43,Gorliz,5287,2630,2657
48,Vizcaya,45,Güeñes,6275,3127,3148
48,Vizcaya,48,Ibarrangelu,611,308,303
48,Vizcaya,94,Igorre,4162,2054,2108
48,Vizcaya,49,Ispaster,662,348,314
48,Vizcaya,910,Iurreta,3854,1922,1932
48,Vizcaya,50,Izurtza,260,143,117
48,Vizcaya,22,Karrantza Harana/Valle de Carranza,2831,1480,1351
48,Vizcaya,907,Kortezubi,409,211,198
48,Vizcaya,51,Lanestosa,286,145,141
48,Vizcaya,52,Larrabetzu,1840,911,929
48,Vizcaya,53,Laukiz,1056,539,517
48,Vizcaya,54,Leioa,29748,14549,15199
48,Vizcaya,57,Lekeitio,7490,3688,3802
48,Vizcaya,55,Lemoa,3114,1550,1564
48,Vizcaya,56,Lemoiz,1031,560,471
48,Vizcaya,81,Lezama,2443,1220,1223
48,Vizcaya,903,Loiu,2147,1084,1063
48,Vizcaya,58,Mallabia,1171,593,578
48,Vizcaya,59,Mañaria,474,261,213
48,Vizcaya,60,Markina-Xemein,4804,2523,2281
48,Vizcaya,61,Maruri-Jatabe,855,428,427
48,Vizcaya,62,Mendata,371,194,177
48,Vizcaya,63,Mendexa,414,216,198
48,Vizcaya,64,Meñaka,664,336,328
48,Vizcaya,66,Morga,399,218,181
48,Vizcaya,68,Mundaka,1863,909,954
48,Vizcaya,69,Mungia,15848,7749,8099
48,Vizcaya,7,Munitibar-Arbatzegi Gerrikaitz,395,215,180
48,Vizcaya,908,Murueta,309,159,150
48,Vizcaya,71,Muskiz,7089,3528,3561
48,Vizcaya,67,Muxika,1448,738,710
48,Vizcaya,909,Nabarniz,225,117,108
48,Vizcaya,73,Ondarroa,8987,4537,4450
48,Vizcaya,75,Orozko,2382,1195,1187
48,Vizcaya,83,Ortuella,8504,4133,4371
48,Vizcaya,72,Otxandio,1220,638,582
48,Vizcaya,77,Plentzia,4146,2015,2131
48,Vizcaya,78,Portugalete,48205,23254,24951
48,Vizcaya,82,Santurtzi,47004,22869,24135
48,Vizcaya,84,Sestao,29638,14391,15247
48,Vizcaya,904,Sondika,4484,2169,2315
48,Vizcaya,85,Sopelana,12242,6057,6185
48,Vizcaya,86,Sopuerta,2427,1235,1192
48,Vizcaya,76,Sukarrieta,345,173,172
48,Vizcaya,87,Trucios-Turtzioz,546,277,269
48,Vizcaya,88,Ubide,158,77,81
48,Vizcaya,65,Ugao-Miraballes,4014,2033,1981
48,Vizcaya,89,Urduliz,3300,1643,1657
48,Vizcaya,74,Urduña-Orduña,4197,2166,2031
48,Vizcaya,80,Valle de Trápaga-Trapagaran,12402,6101,6301
48,Vizcaya,95,Zaldibar,2931,1428,1503
48,Vizcaya,96,Zalla,8178,4015,4163
48,Vizcaya,905,Zamudio,3227,1610,1617
48,Vizcaya,97,Zaratamo,1741,882,859
48,Vizcaya,24,Zeanuri,1317,674,643
48,Vizcaya,25,Zeberio,1072,534,538
48,Vizcaya,913,Zierbena,1351,735,616
48,Vizcaya,915,Ziortza-Bolibar,395,215,180
49,Zamora,2,Abezames,91,47,44
49,Zamora,3,Alcañices,1063,547,516
49,Zamora,4,Alcubilla de Nogales,155,78,77
49,Zamora,5,Alfaraz de Sayago,177,96,81
49,Zamora,6,Algodre,184,99,85
49,Zamora,7,Almaraz de Duero,421,216,205
49,Zamora,8,Almeida de Sayago,582,300,282
49,Zamora,9,Andavías,479,245,234
49,Zamora,10,Arcenillas,325,169,156
49,Zamora,11,Arcos de la Polvorosa,262,142,120
49,Zamora,12,Argañín,81,38,43
49,Zamora,13,Argujillo,344,178,166
49,Zamora,14,Arquillinos,146,81,65
49,Zamora,15,Arrabalde,311,145,166
49,Zamora,16,Aspariegos,301,150,151
49,Zamora,17,Asturianos,281,146,135
49,Zamora,18,Ayoó de Vidriales,399,208,191
49,Zamora,19,Barcial del Barco,289,156,133
49,Zamora,20,Belver de los Montes,388,214,174
49,Zamora,21,Benavente,19093,9431,9662
49,Zamora,22,Benegiles,387,210,177
49,Zamora,23,Bermillo de Sayago,1280,683,597
49,Zamora,24,Bóveda de Toro (La),875,435,440
49,Zamora,25,Bretó,214,116,98
49,Zamora,26,Bretocino,275,148,127
49,Zamora,27,Brime de Sog,194,90,104
49,Zamora,28,Brime de Urz,154,83,71
49,Zamora,29,Burganes de Valverde,824,426,398
49,Zamora,30,Bustillo del Oro,114,63,51
49,Zamora,31,Cabañas de Sayago,186,96,90
49,Zamora,32,Calzadilla de Tera,414,193,221
49,Zamora,33,Camarzana de Tera,995,481,514
49,Zamora,34,Cañizal,552,297,255
49,Zamora,35,Cañizo,286,146,140
49,Zamora,36,Carbajales de Alba,702,353,349
49,Zamora,37,Carbellino,229,117,112
49,Zamora,38,Casaseca de Campeán,125,69,56
49,Zamora,39,Casaseca de las Chanas,401,216,185
49,Zamora,40,Castrillo de la Guareña,145,71,74
49,Zamora,41,Castrogonzalo,517,281,236
49,Zamora,42,Castronuevo,318,158,160
49,Zamora,43,Castroverde de Campos,362,191,171
49,Zamora,44,Cazurra,79,43,36
49,Zamora,46,Cerecinos de Campos,381,202,179
49,Zamora,47,Cerecinos del Carrizal,144,83,61
49,Zamora,48,Cernadilla,166,79,87
49,Zamora,50,Cobreros,623,321,302
49,Zamora,52,Coomonte,262,133,129
49,Zamora,53,Coreses,1152,586,566
49,Zamora,54,Corrales,1082,535,547
49,Zamora,55,Cotanes del Monte,131,69,62
49,Zamora,56,Cubillos,365,183,182
49,Zamora,57,Cubo de Benavente,144,81,63
49,Zamora,58,Cubo de Tierra del Vino (El),420,229,191
49,Zamora,59,Cuelgamures,122,72,50
49,Zamora,61,Entrala,163,86,77
49,Zamora,62,Espadañedo,171,91,80
49,Zamora,63,Faramontanos de Tábara,452,238,214
49,Zamora,64,Fariza,663,330,333
49,Zamora,65,Fermoselle,1479,759,720
49,Zamora,66,Ferreras de Abajo,614,300,314
49,Zamora,67,Ferreras de Arriba,487,248,239
49,Zamora,68,Ferreruela,572,302,270
49,Zamora,69,Figueruela de Arriba,442,210,232
49,Zamora,71,Fonfría,993,501,492
49,Zamora,75,Fresno de la Polvorosa,184,91,93
49,Zamora,76,Fresno de la Ribera,392,216,176
49,Zamora,77,Fresno de Sayago,242,124,118
49,Zamora,78,Friera de Valverde,232,119,113
49,Zamora,79,Fuente Encalada,123,63,60
49,Zamora,80,Fuentelapeña,864,445,419
49,Zamora,82,Fuentes de Ropel,520,267,253
49,Zamora,81,Fuentesaúco,1967,1009,958
49,Zamora,83,Fuentesecas,75,36,39
49,Zamora,84,Fuentespreadas,342,181,161
49,Zamora,85,Galende,1374,689,685
49,Zamora,86,Gallegos del Pan,140,76,64
49,Zamora,87,Gallegos del Río,693,375,318
49,Zamora,88,Gamones,100,57,43
49,Zamora,90,Gema,242,123,119
49,Zamora,91,Granja de Moreruela,313,162,151
49,Zamora,92,Granucillo,193,99,94
49,Zamora,93,Guarrate,363,193,170
49,Zamora,94,Hermisende,339,192,147
49,Zamora,95,Hiniesta (La),332,164,168
49,Zamora,96,Jambrina,215,105,110
49,Zamora,97,Justel,122,71,51
49,Zamora,98,Losacino,273,146,127
49,Zamora,99,Losacio,100,54,46
49,Zamora,100,Lubián,395,209,186
49,Zamora,101,Luelmo,224,112,112
49,Zamora,102,Maderal (El),258,139,119
49,Zamora,103,Madridanos,523,269,254
49,Zamora,104,Mahide,435,232,203
49,Zamora,105,Maire de Castroponce,190,100,90
49,Zamora,107,Malva,179,93,86
49,Zamora,108,Manganeses de la Lampreana,607,303,304
49,Zamora,109,Manganeses de la Polvorosa,753,372,381
49,Zamora,110,Manzanal de Arriba,436,225,211
49,Zamora,112,Manzanal de los Infantes,149,82,67
49,Zamora,111,Manzanal del Barco,170,89,81
49,Zamora,113,Matilla de Arzón,218,118,100
49,Zamora,114,Matilla la Seca,64,32,32
49,Zamora,115,Mayalde,232,115,117
49,Zamora,116,Melgar de Tera,469,231,238
49,Zamora,117,Micereces de Tera,563,285,278
49,Zamora,118,Milles de la Polvorosa,259,142,117
49,Zamora,119,Molacillos,282,148,134
49,Zamora,120,Molezuelas de la Carballeda,89,43,46
49,Zamora,121,Mombuey,438,233,205
49,Zamora,122,Monfarracinos,859,459,400
49,Zamora,123,Montamarta,612,308,304
49,Zamora,124,Moral de Sayago,326,182,144
49,Zamora,126,Moraleja de Sayago,284,153,131
49,Zamora,125,Moraleja del Vino,1433,768,665
49,Zamora,128,Morales de Rey,691,345,346
49,Zamora,129,Morales de Toro,1172,589,583
49,Zamora,130,Morales de Valverde,246,125,121
49,Zamora,127,Morales del Vino,2512,1308,1204
49,Zamora,131,Moralina,340,167,173
49,Zamora,132,Moreruela de los Infanzones,414,215,199
49,Zamora,133,Moreruela de Tábara,422,223,199
49,Zamora,134,Muelas de los Caballeros,236,130,106
49,Zamora,135,Muelas del Pan,797,403,394
49,Zamora,136,Muga de Sayago,410,201,209
49,Zamora,137,Navianos de Valverde,230,128,102
49,Zamora,138,Olmillos de Castro,331,175,156
49,Zamora,139,Otero de Bodas,210,110,100
49,Zamora,141,Pajares de la Lampreana,463,234,229
49,Zamora,143,Palacios de Sanabria,307,157,150
49,Zamora,142,Palacios del Pan,234,111,123
49,Zamora,145,Pedralba de la Pradería,311,165,146
49,Zamora,146,Pego (El),372,189,183
49,Zamora,147,Peleagonzalo,351,181,170
49,Zamora,148,Peleas de Abajo,274,133,141
49,Zamora,149,Peñausende,504,255,249
49,Zamora,150,Peque,174,81,93
49,Zamora,151,Perdigón (El),780,404,376
49,Zamora,152,Pereruela,676,357,319
49,Zamora,153,Perilla de Castro,202,99,103
49,Zamora,154,Pías,160,85,75
49,Zamora,155,Piedrahita de Castro,127,70,57
49,Zamora,156,Pinilla de Toro,301,158,143
49,Zamora,157,Pino del Oro,198,105,93
49,Zamora,158,Piñero (El),255,131,124
49,Zamora,160,Pobladura de Valderaduey,64,36,28
49,Zamora,159,Pobladura del Valle,318,167,151
49,Zamora,162,Porto,250,132,118
49,Zamora,163,Pozoantiguo,287,146,141
49,Zamora,164,Pozuelo de Tábara,171,81,90
49,Zamora,165,Prado,84,47,37
49,Zamora,166,Puebla de Sanabria,1595,767,828
49,Zamora,167,Pueblica de Valverde,262,138,124
49,Zamora,170,Quintanilla de Urz,146,72,74
49,Zamora,168,Quintanilla del Monte,110,53,57
49,Zamora,169,Quintanilla del Olmo,41,21,20
49,Zamora,171,Quiruelas de Vidriales,831,404,427
49,Zamora,172,Rabanales,684,362,322
49,Zamora,173,Rábano de Aliste,429,219,210
49,Zamora,174,Requejo,169,93,76
49,Zamora,175,Revellinos,337,184,153
49,Zamora,176,Riofrío de Aliste,936,501,435
49,Zamora,177,Rionegro del Puente,331,169,162
49,Zamora,178,Roales,564,291,273
49,Zamora,179,Robleda-Cervantes,509,268,241
49,Zamora,180,Roelos de Sayago,165,83,82
49,Zamora,181,Rosinos de la Requejada,446,224,222
49,Zamora,183,Salce,118,60,58
49,Zamora,184,Samir de los Caños,208,109,99
49,Zamora,185,San Agustín del Pozo,207,105,102
49,Zamora,186,San Cebrián de Castro,303,146,157
49,Zamora,187,San Cristóbal de Entreviñas,1609,837,772
49,Zamora,188,San Esteban del Molar,160,91,69
49,Zamora,189,San Justo,303,160,143
49,Zamora,190,San Martín de Valderaduey,88,44,44
49,Zamora,191,San Miguel de la Ribera,365,185,180
49,Zamora,192,San Miguel del Valle,202,99,103
49,Zamora,193,San Pedro de Ceque,600,304,296
49,Zamora,194,San Pedro de la Nave-Almendra,436,221,215
49,Zamora,208,San Vicente de la Cabeza,498,261,237
49,Zamora,209,San Vitero,669,363,306
49,Zamora,197,Santa Clara de Avedillo,214,105,109
49,Zamora,199,Santa Colomba de las Monjas,303,150,153
49,Zamora,200,Santa Cristina de la Polvorosa,1213,622,591
49,Zamora,201,Santa Croya de Tera,397,205,192
49,Zamora,202,Santa Eufemia del Barco,248,137,111
49,Zamora,203,Santa María de la Vega,415,212,203
49,Zamora,204,Santa María de Valverde,90,43,47
49,Zamora,205,Santibáñez de Tera,513,257,256
49,Zamora,206,Santibáñez de Vidriales,1196,603,593
49,Zamora,207,Santovenia,326,154,172
49,Zamora,210,Sanzoles,628,320,308
49,Zamora,214,Tábara,892,463,429
49,Zamora,216,Tapioles,196,105,91
49,Zamora,219,Toro,9850,4837,5013
49,Zamora,220,Torre del Valle (La),184,102,82
49,Zamora,221,Torregamones,314,171,143
49,Zamora,222,Torres del Carrizal,470,240,230
49,Zamora,223,Trabazos,1027,541,486
49,Zamora,224,Trefacio,208,102,106
49,Zamora,225,Uña de Quintana,182,94,88
49,Zamora,226,Vadillo de la Guareña,324,164,160
49,Zamora,227,Valcabado,333,166,167
49,Zamora,228,Valdefinjas,84,49,35
49,Zamora,229,Valdescorriel,190,96,94
49,Zamora,230,Vallesa de la Guareña,144,75,69
49,Zamora,231,Vega de Tera,426,207,219
49,Zamora,232,Vega de Villalobos,128,56,72
49,Zamora,233,Vegalatrave,141,76,65
49,Zamora,234,Venialbo,491,265,226
49,Zamora,235,Vezdemarbán,592,291,301
49,Zamora,236,Vidayanes,95,50,45
49,Zamora,237,Videmala,172,86,86
49,Zamora,238,Villabrázaro,315,161,154
49,Zamora,239,Villabuena del Puente,853,443,410
49,Zamora,240,Villadepera,268,137,131
49,Zamora,241,Villaescusa,320,162,158
49,Zamora,242,Villafáfila,592,304,288
49,Zamora,243,Villaferrueña,138,70,68
49,Zamora,244,Villageriz,57,31,26
49,Zamora,245,Villalazán,356,174,182
49,Zamora,246,Villalba de la Lampreana,273,151,122
49,Zamora,247,Villalcampo,566,282,284
49,Zamora,248,Villalobos,322,160,162
49,Zamora,249,Villalonso,100,56,44
49,Zamora,250,Villalpando,1656,815,841
49,Zamora,251,Villalube,222,115,107
49,Zamora,252,Villamayor de Campos,454,230,224
49,Zamora,255,Villamor de los Escuderos,518,263,255
49,Zamora,256,Villanázar,344,166,178
49,Zamora,257,Villanueva de Azoague,328,167,161
49,Zamora,258,Villanueva de Campeán,146,74,72
49,Zamora,259,Villanueva de las Peras,136,71,65
49,Zamora,260,Villanueva del Campo,1008,504,504
49,Zamora,263,Villar de Fallaves,86,46,40
49,Zamora,264,Villar del Buey,746,399,347
49,Zamora,261,Villaralbo,1861,943,918
49,Zamora,262,Villardeciervos,491,241,250
49,Zamora,265,Villardiegua de la Ribera,160,83,77
49,Zamora,266,Villárdiga,99,53,46
49,Zamora,267,Villardondiego,120,69,51
49,Zamora,268,Villarrín de Campos,556,298,258
49,Zamora,269,Villaseco del Pan,267,119,148
49,Zamora,270,Villavendimio,191,108,83
49,Zamora,272,Villaveza de Valverde,112,56,56
49,Zamora,271,Villaveza del Agua,256,130,126
49,Zamora,273,Viñas,236,126,110
49,Zamora,275,Zamora,66672,31586,35086
50,Zaragoza,1,Abanto,133,71,62
50,Zaragoza,2,Acered,189,102,87
50,Zaragoza,3,Agón,167,89,78
50,Zaragoza,4,Aguarón,903,488,415
50,Zaragoza,5,Aguilón,259,129,130
50,Zaragoza,6,Ainzón,1274,663,611
50,Zaragoza,7,Aladrén,62,38,24
50,Zaragoza,8,Alagón,6894,3524,3370
50,Zaragoza,9,Alarba,161,91,70
50,Zaragoza,10,Alberite de San Juan,98,60,38
50,Zaragoza,11,Albeta,135,68,67
50,Zaragoza,12,Alborge,124,64,60
50,Zaragoza,13,Alcalá de Ebro,297,140,157
50,Zaragoza,14,Alcalá de Moncayo,154,90,64
50,Zaragoza,15,Alconchel de Ariza,109,62,47
50,Zaragoza,16,Aldehuela de Liestos,64,35,29
50,Zaragoza,17,Alfajarín,2032,1065,967
50,Zaragoza,18,Alfamén,1462,802,660
50,Zaragoza,19,Alforque,69,38,31
50,Zaragoza,20,Alhama de Aragón,1211,629,582
50,Zaragoza,21,Almochuel,33,18,15
50,Zaragoza,22,Almolda (La),643,334,309
50,Zaragoza,23,Almonacid de la Cuba,299,155,144
50,Zaragoza,24,Almonacid de la Sierra,821,442,379
50,Zaragoza,25,Almunia de Doña Godina (La),7633,3942,3691
50,Zaragoza,26,Alpartir,563,292,271
50,Zaragoza,27,Ambel,320,149,171
50,Zaragoza,28,Anento,138,81,57
50,Zaragoza,29,Aniñón,828,452,376
50,Zaragoza,30,Añón de Moncayo,229,135,94
50,Zaragoza,31,Aranda de Moncayo,232,130,102
50,Zaragoza,32,Arándiga,418,212,206
50,Zaragoza,33,Ardisa,84,53,31
50,Zaragoza,34,Ariza,1289,655,634
50,Zaragoza,35,Artieda,102,59,43
50,Zaragoza,36,Asín,107,56,51
50,Zaragoza,37,Atea,148,83,65
50,Zaragoza,38,Ateca,2089,1055,1034
50,Zaragoza,39,Azuara,703,388,315
50,Zaragoza,40,Badules,106,55,51
50,Zaragoza,41,Bagüés,32,20,12
50,Zaragoza,42,Balconchán,13,5,8
50,Zaragoza,43,Bárboles,346,190,156
50,Zaragoza,44,Bardallur,314,164,150
50,Zaragoza,45,Belchite,1692,889,803
50,Zaragoza,46,Belmonte de Gracián,216,117,99
50,Zaragoza,47,Berdejo,63,36,27
50,Zaragoza,48,Berrueco,45,23,22
50,Zaragoza,901,Biel,217,126,91
50,Zaragoza,50,Bijuesca,123,76,47
50,Zaragoza,51,Biota,1138,587,551
50,Zaragoza,52,Bisimbre,108,55,53
50,Zaragoza,53,Boquiñeni,1012,512,500
50,Zaragoza,54,Bordalba,82,49,33
50,Zaragoza,55,Borja,4838,2462,2376
50,Zaragoza,56,Botorrita,538,293,245
50,Zaragoza,57,Brea de Aragón,1922,968,954
50,Zaragoza,58,Bubierca,87,43,44
50,Zaragoza,59,Bujaraloz,1048,547,501
50,Zaragoza,60,Bulbuente,269,135,134
50,Zaragoza,61,Bureta,272,141,131
50,Zaragoza,62,Burgo de Ebro (El),2188,1144,1044
50,Zaragoza,63,Buste (El),90,44,46
50,Zaragoza,64,Cabañas de Ebro,541,283,258
50,Zaragoza,65,Cabolafuente,50,26,24
50,Zaragoza,66,Cadrete,2528,1340,1188
50,Zaragoza,67,Calatayud,21905,10884,11021
50,Zaragoza,68,Calatorao,3024,1602,1422
50,Zaragoza,69,Calcena,52,27,25
50,Zaragoza,70,Calmarza,76,43,33
50,Zaragoza,71,Campillo de Aragón,163,90,73
50,Zaragoza,72,Carenas,214,110,104
50,Zaragoza,73,Cariñena,3509,1856,1653
50,Zaragoza,74,Caspe,8848,4549,4299
50,Zaragoza,75,Castejón de Alarba,104,56,48
50,Zaragoza,76,Castejón de las Armas,127,72,55
50,Zaragoza,77,Castejón de Valdejasa,283,147,136
50,Zaragoza,78,Castiliscar,347,185,162
50,Zaragoza,79,Cervera de la Cañada,331,172,159
50,Zaragoza,80,Cerveruela,41,28,13
50,Zaragoza,81,Cetina,703,350,353
50,Zaragoza,92,Chiprana,298,141,157
50,Zaragoza,93,Chodes,148,78,70
50,Zaragoza,82,Cimballa,122,57,65
50,Zaragoza,83,Cinco Olivas,120,57,63
50,Zaragoza,84,Clarés de Ribota,92,50,42
50,Zaragoza,85,Codo,228,114,114
50,Zaragoza,86,Codos,246,152,94
50,Zaragoza,87,Contamina,42,24,18
50,Zaragoza,88,Cosuenda,391,200,191
50,Zaragoza,89,Cuarte de Huerva,6404,3391,3013
50,Zaragoza,90,Cubel,211,104,107
50,Zaragoza,91,Cuerlas (Las),69,33,36
50,Zaragoza,94,Daroca,2345,1190,1155
50,Zaragoza,95,Ejea de los Caballeros,17178,8965,8213
50,Zaragoza,96,Embid de Ariza,60,32,28
50,Zaragoza,98,Encinacorba,271,140,131
50,Zaragoza,99,Épila,4682,2488,2194
50,Zaragoza,100,Erla,426,209,217
50,Zaragoza,101,Escatrón,1154,583,571
50,Zaragoza,102,Fabara,1228,658,570
50,Zaragoza,104,Farlete,444,219,225
50,Zaragoza,105,Fayón,436,223,213
50,Zaragoza,106,Fayos (Los),168,85,83
50,Zaragoza,107,Figueruelas,1267,646,621
50,Zaragoza,108,Fombuena,54,32,22
50,Zaragoza,109,Frago (El),118,72,46
50,Zaragoza,110,Frasno (El),480,257,223
50,Zaragoza,111,Fréscano,233,123,110
50,Zaragoza,113,Fuendejalón,1034,594,440
50,Zaragoza,114,Fuendetodos,174,92,82
50,Zaragoza,115,Fuentes de Ebro,4416,2332,2084
50,Zaragoza,116,Fuentes de Jiloca,294,155,139
50,Zaragoza,117,Gallocanta,158,81,77
50,Zaragoza,118,Gallur,3004,1527,1477
50,Zaragoza,119,Gelsa,1207,617,590
50,Zaragoza,120,Godojos,54,28,26
50,Zaragoza,121,Gotor,385,200,185
50,Zaragoza,122,Grisel,97,60,37
50,Zaragoza,123,Grisén,519,273,246
50,Zaragoza,124,Herrera de los Navarros,628,334,294
50,Zaragoza,125,Ibdes,512,271,241
50,Zaragoza,126,Illueca,3269,1626,1643
50,Zaragoza,128,Isuerre,39,25,14
50,Zaragoza,129,Jaraba,349,179,170
50,Zaragoza,130,Jarque,549,294,255
50,Zaragoza,131,Jaulín,295,160,135
50,Zaragoza,132,Joyosa (La),873,451,422
50,Zaragoza,133,Lagata,141,82,59
50,Zaragoza,134,Langa del Castillo,151,70,81
50,Zaragoza,135,Layana,114,64,50
50,Zaragoza,136,Lécera,736,391,345
50,Zaragoza,138,Lechón,56,31,25
50,Zaragoza,137,Leciñena,1309,652,657
50,Zaragoza,139,Letux,418,233,185
50,Zaragoza,140,Litago,184,95,89
50,Zaragoza,141,Lituénigo,117,59,58
50,Zaragoza,142,Lobera de Onsella,53,31,22
50,Zaragoza,143,Longares,904,512,392
50,Zaragoza,144,Longás,42,27,15
50,Zaragoza,146,Lucena de Jalón,307,176,131
50,Zaragoza,147,Luceni,1080,548,532
50,Zaragoza,148,Luesia,394,219,175
50,Zaragoza,149,Luesma,38,22,16
50,Zaragoza,150,Lumpiaque,1053,557,496
50,Zaragoza,151,Luna,872,448,424
50,Zaragoza,152,Maella,2051,1056,995
50,Zaragoza,153,Magallón,1221,663,558
50,Zaragoza,154,Mainar,187,90,97
50,Zaragoza,155,Malanquilla,126,70,56
50,Zaragoza,156,Maleján,322,163,159
50,Zaragoza,160,Mallén,3680,1946,1734
50,Zaragoza,157,Malón,383,196,187
50,Zaragoza,159,Maluenda,1095,544,551
50,Zaragoza,161,Manchones,131,72,59
50,Zaragoza,162,Mara,212,109,103
50,Zaragoza,163,María de Huerva,4008,2149,1859
50,Zaragoza,902,Marracos,113,57,56
50,Zaragoza,164,Mediana de Aragón,514,259,255
50,Zaragoza,165,Mequinenza,2478,1258,1220
50,Zaragoza,166,Mesones de Isuela,325,164,161
50,Zaragoza,167,Mezalocha,256,146,110
50,Zaragoza,168,Mianos,48,26,22
50,Zaragoza,169,Miedes de Aragón,462,236,226
50,Zaragoza,170,Monegrillo,500,279,221
50,Zaragoza,171,Moneva,98,55,43
50,Zaragoza,172,Monreal de Ariza,207,114,93
50,Zaragoza,173,Monterde,210,120,90
50,Zaragoza,174,Montón,129,76,53
50,Zaragoza,175,Morata de Jalón,1354,661,693
50,Zaragoza,176,Morata de Jiloca,317,180,137
50,Zaragoza,177,Morés,444,231,213
50,Zaragoza,178,Moros,474,246,228
50,Zaragoza,179,Moyuela,289,153,136
50,Zaragoza,180,Mozota,117,57,60
50,Zaragoza,181,Muel,1279,660,619
50,Zaragoza,182,Muela (La),4419,2273,2146
50,Zaragoza,183,Munébrega,440,235,205
50,Zaragoza,184,Murero,159,88,71
50,Zaragoza,185,Murillo de Gállego,169,93,76
50,Zaragoza,186,Navardún,49,30,19
50,Zaragoza,187,Nigüella,87,47,40
50,Zaragoza,188,Nombrevilla,38,21,17
50,Zaragoza,189,Nonaspe,1079,572,507
50,Zaragoza,190,Novallas,885,467,418
50,Zaragoza,191,Novillas,639,329,310
50,Zaragoza,192,Nuévalos,353,193,160
50,Zaragoza,193,Nuez de Ebro,754,386,368
50,Zaragoza,194,Olvés,120,66,54
50,Zaragoza,195,Orcajo,36,19,17
50,Zaragoza,196,Orera,128,67,61
50,Zaragoza,197,Orés,107,63,44
50,Zaragoza,198,Oseja,52,29,23
50,Zaragoza,199,Osera de Ebro,446,228,218
50,Zaragoza,200,Paniza,798,429,369
50,Zaragoza,201,Paracuellos de Jiloca,537,273,264
50,Zaragoza,202,Paracuellos de la Ribera,190,89,101
50,Zaragoza,203,Pastriz,1381,678,703
50,Zaragoza,204,Pedrola,3488,1842,1646
50,Zaragoza,205,Pedrosas (Las),122,63,59
50,Zaragoza,206,Perdiguera,664,350,314
50,Zaragoza,207,Piedratajada,156,80,76
50,Zaragoza,208,Pina de Ebro,2552,1329,1223
50,Zaragoza,209,Pinseque,3252,1663,1589
50,Zaragoza,210,Pintanos (Los),41,26,15
50,Zaragoza,211,Plasencia de Jalón,378,219,159
50,Zaragoza,212,Pleitas,57,32,25
50,Zaragoza,213,Plenas,123,62,61
50,Zaragoza,214,Pomer,31,20,11
50,Zaragoza,215,Pozuel de Ariza,22,13,9
50,Zaragoza,216,Pozuelo de Aragón,338,180,158
50,Zaragoza,217,Pradilla de Ebro,642,326,316
50,Zaragoza,218,Puebla de Albortón,138,84,54
50,Zaragoza,219,Puebla de Alfindén (La),4687,2463,2224
50,Zaragoza,220,Puendeluna,55,34,21
50,Zaragoza,221,Purujosa,48,39,9
50,Zaragoza,222,Quinto,2101,1073,1028
50,Zaragoza,223,Remolinos,1198,614,584
50,Zaragoza,224,Retascón,89,50,39
50,Zaragoza,225,Ricla,3400,1882,1518
50,Zaragoza,227,Romanos,113,66,47
50,Zaragoza,228,Rueda de Jalón,361,186,175
50,Zaragoza,229,Ruesca,78,41,37
50,Zaragoza,241,Sabiñán,816,407,409
50,Zaragoza,230,Sádaba,1696,858,838
50,Zaragoza,231,Salillas de Jalón,378,200,178
50,Zaragoza,232,Salvatierra de Esca,248,121,127
50,Zaragoza,233,Samper del Salz,107,58,49
50,Zaragoza,234,San Martín de la Virgen de Moncayo,292,165,127
50,Zaragoza,235,San Mateo de Gállego,2895,1506,1389
50,Zaragoza,236,Santa Cruz de Grío,186,106,80
50,Zaragoza,237,Santa Cruz de Moncayo,135,64,71
50,Zaragoza,238,Santa Eulalia de Gállego,126,68,58
50,Zaragoza,239,Santed,63,34,29
50,Zaragoza,240,Sástago,1138,580,558
50,Zaragoza,242,Sediles,101,58,43
50,Zaragoza,243,Sestrica,405,224,181
50,Zaragoza,244,Sierra de Luna,313,166,147
50,Zaragoza,245,Sigüés,138,74,64
50,Zaragoza,246,Sisamón,52,36,16
50,Zaragoza,247,Sobradiel,965,480,485
50,Zaragoza,248,Sos del Rey Católico,707,359,348
50,Zaragoza,249,Tabuenca,414,228,186
50,Zaragoza,250,Talamantes,65,36,29
50,Zaragoza,251,Tarazona,11095,5470,5625
50,Zaragoza,252,Tauste,7690,3860,3830
50,Zaragoza,253,Terrer,525,265,260
50,Zaragoza,254,Tierga,196,108,88
50,Zaragoza,255,Tobed,259,130,129
50,Zaragoza,256,Torralba de los Frailes,102,58,44
50,Zaragoza,257,Torralba de Ribota,190,102,88
50,Zaragoza,258,Torralbilla,64,33,31
50,Zaragoza,259,Torrehermosa,89,47,42
50,Zaragoza,260,Torrelapaja,44,26,18
50,Zaragoza,261,Torrellas,304,163,141
50,Zaragoza,262,Torres de Berrellén,1517,792,725
50,Zaragoza,263,Torrijo de la Cañada,303,171,132
50,Zaragoza,264,Tosos,246,137,109
50,Zaragoza,265,Trasmoz,87,46,41
50,Zaragoza,266,Trasobares,165,96,69
50,Zaragoza,267,Uncastillo,814,396,418
50,Zaragoza,268,Undués de Lerda,67,42,25
50,Zaragoza,269,Urrea de Jalón,408,211,197
50,Zaragoza,270,Urriés,45,30,15
50,Zaragoza,271,Used,349,197,152
50,Zaragoza,272,Utebo,16966,8663,8303
50,Zaragoza,274,Val de San Martín,88,48,40
50,Zaragoza,273,Valdehorna,42,21,21
50,Zaragoza,275,Valmadrid,103,71,32
50,Zaragoza,276,Valpalmas,165,81,84
50,Zaragoza,277,Valtorres,114,60,54
50,Zaragoza,278,Velilla de Ebro,250,126,124
50,Zaragoza,279,Velilla de Jiloca,108,56,52
50,Zaragoza,280,Vera de Moncayo,424,213,211
50,Zaragoza,281,Vierlas,103,52,51
50,Zaragoza,283,Villadoz,86,50,36
50,Zaragoza,284,Villafeliche,187,93,94
50,Zaragoza,285,Villafranca de Ebro,750,363,387
50,Zaragoza,286,Villalba de Perejil,114,61,53
50,Zaragoza,287,Villalengua,387,198,189
50,Zaragoza,903,Villamayor de Gállego,2878,1438,1440
50,Zaragoza,288,Villanueva de Gállego,4101,2063,2038
50,Zaragoza,290,Villanueva de Huerva,599,328,271
50,Zaragoza,289,Villanueva de Jiloca,83,46,37
50,Zaragoza,291,Villar de los Navarros,130,69,61
50,Zaragoza,292,Villarreal de Huerva,203,116,87
50,Zaragoza,293,Villarroya de la Sierra,609,319,290
50,Zaragoza,294,Villarroya del Campo,76,41,35
50,Zaragoza,282,Vilueña (La),117,59,58
50,Zaragoza,295,Vistabella,48,33,15
50,Zaragoza,296,Zaida (La),525,260,265
50,Zaragoza,297,Zaragoza,666129,324017,342112
50,Zaragoza,298,Zuera,7288,3807,3481
51,Ceuta,1,Ceuta,77389,39385,38004
52,Melilla,1,Melilla,71448,36336,35112
