CPRO,PROVINCIA,CMUN,NOMBRE,POB05,VARONES,MUJERES
1,Álava,1,Alegría-Dulantzi,2048,1050,998
1,Álava,2,Amurrio,9592,4796,4796
1,Álava,49,Añana,185,98,87
1,Álava,3,Aramaio,1503,799,704
1,Álava,6,Armiñón,175,94,81
1,Álava,37,Arraia-Maeztu,734,407,327
1,Álava,8,Arrazua-Ubarrundia,807,433,374
1,Álava,4,Artziniega,1499,743,756
1,Álava,9,Asparrena,1606,799,807
1,Álava,10,Ayala/Aiara,2542,1290,1252
1,Álava,11,Baños de Ebro/Mañueta,344,191,153
1,Álava,13,Barrundia,779,433,346
1,Álava,14,Berantevilla,458,238,220
1,Álava,16,Bernedo,566,330,236
1,Álava,17,Campezo/Kanpezu,1083,590,493
1,Álava,21,Elburgo/Burgelu,475,250,225
1,Álava,22,Elciego,941,475,466
1,Álava,23,Elvillar/Bilar,366,193,173
1,Álava,56,Harana/Valle de Arana,338,196,142
1,Álava,901,Iruña Oka/Iruña de Oca,2252,1181,1071
1,Álava,27,Iruraiz-Gauna,478,254,224
1,Álava,19,Kripan,193,108,85
1,Álava,20,Kuartango,356,199,157
1,Álava,28,Labastida,1391,760,631
1,Álava,30,Lagrán,192,105,87
1,Álava,31,Laguardia,1483,783,700
1,Álava,32,Lanciego/Lantziego,660,334,326
1,Álava,902,Lantarón,966,523,443
1,Álava,33,Lapuebla de Labarca,854,443,411
1,Álava,58,Legutiano,1499,790,709
1,Álava,34,Leza,230,124,106
1,Álava,36,Llodio,18633,9288,9345
1,Álava,39,Moreda de Álava,280,141,139
1,Álava,41,Navaridas,210,110,100
1,Álava,42,Okondo,1015,536,479
1,Álava,43,Oyón-Oion,2827,1434,1393
1,Álava,44,Peñacerrada-Urizaharra,257,144,113
1,Álava,46,Ribera Alta,586,333,253
1,Álava,47,Ribera Baja/Erribera Beitia,1036,569,467
1,Álava,51,Salvatierra/Agurain,4118,2051,2067
1,Álava,52,Samaniego,310,160,150
1,Álava,53,San Millán/Donemiliaga,721,407,314
1,Álava,54,Urkabustaiz,999,537,462
1,Álava,55,Valdegovía,1070,579,491
1,Álava,57,Villabuena de Álava/Eskuernaga,322,164,158
1,Álava,59,Vitoria-Gasteiz,226490,111804,114686
1,Álava,60,Yécora/Iekora,279,145,134
1,Álava,61,Zalduondo,169,88,81
1,Álava,62,Zambrana,367,208,159
1,Álava,18,Zigoitia,1378,745,633
1,Álava,63,Zuia,2295,1171,1124
2,Albacete,1,Abengibre,977,483,494
2,Albacete,2,Alatoz,603,323,280
2,Albacete,3,Albacete,159518,78416,81102
2,Albacete,4,Albatana,856,417,439
2,Albacete,5,Alborea,827,425,402
2,Albacete,6,Alcadozo,774,405,369
2,Albacete,7,Alcalá del Júcar,1404,731,673
2,Albacete,8,Alcaraz,1766,877,889
2,Albacete,9,Almansa,24974,12315,12659
2,Albacete,10,Alpera,2389,1261,1128
2,Albacete,11,Ayna,913,476,437
2,Albacete,12,Balazote,2576,1400,1176
2,Albacete,14,Ballestero (El),527,269,258
2,Albacete,13,Balsa de Ves,226,118,108
2,Albacete,15,Barrax,1978,996,982
2,Albacete,16,Bienservida,786,403,383
2,Albacete,17,Bogarra,1121,583,538
2,Albacete,18,Bonete,1270,656,614
2,Albacete,19,Bonillo (El),3174,1612,1562
2,Albacete,20,Carcelén,651,350,301
2,Albacete,21,Casas de Juan Núñez,1340,706,634
2,Albacete,22,Casas de Lázaro,427,227,200
2,Albacete,23,Casas de Ves,825,435,390
2,Albacete,24,Casas-Ibáñez,4415,2243,2172
2,Albacete,25,Caudete,9553,4855,4698
2,Albacete,26,Cenizate,1239,647,592
2,Albacete,29,Chinchilla de Monte-Aragón,3375,1796,1579
2,Albacete,27,Corral-Rubio,451,229,222
2,Albacete,28,Cotillas,176,87,89
2,Albacete,30,Elche de la Sierra,3878,1934,1944
2,Albacete,31,Férez,795,404,391
2,Albacete,32,Fuensanta,388,216,172
2,Albacete,33,Fuente-Álamo,2720,1442,1278
2,Albacete,34,Fuentealbilla,1943,996,947
2,Albacete,35,Gineta (La),2141,1086,1055
2,Albacete,36,Golosalvo,110,51,59
2,Albacete,37,Hellín,29847,14936,14911
2,Albacete,38,Herrera (La),356,185,171
2,Albacete,39,Higueruela,1350,684,666
2,Albacete,40,Hoya-Gonzalo,833,431,402
2,Albacete,41,Jorquera,511,261,250
2,Albacete,42,Letur,1209,600,609
2,Albacete,43,Lezuza,1708,888,820
2,Albacete,44,Liétor,1537,794,743
2,Albacete,45,Madrigueras,4647,2389,2258
2,Albacete,46,Mahora,1379,674,705
2,Albacete,47,Masegoso,119,70,49
2,Albacete,48,Minaya,1741,933,808
2,Albacete,49,Molinicos,1164,601,563
2,Albacete,50,Montalvos,146,76,70
2,Albacete,51,Montealegre del Castillo,2291,1173,1118
2,Albacete,52,Motilleja,536,271,265
2,Albacete,53,Munera,3974,2017,1957
2,Albacete,54,Navas de Jorquera,533,274,259
2,Albacete,55,Nerpio,1639,891,748
2,Albacete,56,Ontur,2421,1198,1223
2,Albacete,57,Ossa de Montiel,2836,1414,1422
2,Albacete,58,Paterna del Madera,484,250,234
2,Albacete,60,Peñas de San Pedro,1222,660,562
2,Albacete,59,Peñascosa,374,188,186
2,Albacete,61,Pétrola,878,449,429
2,Albacete,62,Povedilla,646,343,303
2,Albacete,901,Pozo Cañada,2718,1342,1376
2,Albacete,63,Pozohondo,1840,949,891
2,Albacete,64,Pozo-Lorente,502,249,253
2,Albacete,65,Pozuelo,671,358,313
2,Albacete,66,Recueja (La),321,153,168
2,Albacete,67,Riópar,1479,757,722
2,Albacete,68,Robledo,459,238,221
2,Albacete,69,Roda (La),14881,7513,7368
2,Albacete,70,Salobre,615,316,299
2,Albacete,71,San Pedro,1275,657,618
2,Albacete,72,Socovos,1936,1004,932
2,Albacete,73,Tarazona de la Mancha,6576,3363,3213
2,Albacete,74,Tobarra,7869,4027,3842
2,Albacete,75,Valdeganga,1881,930,951
2,Albacete,76,Vianos,442,217,225
2,Albacete,77,Villa de Ves,67,32,35
2,Albacete,78,Villalgordo del Júcar,1241,619,622
2,Albacete,79,Villamalea,3951,2039,1912
2,Albacete,80,Villapalacios,741,365,376
2,Albacete,81,Villarrobledo,24729,12416,12313
2,Albacete,82,Villatoya,167,90,77
2,Albacete,83,Villavaliente,285,150,135
2,Albacete,84,Villaverde de Guadalimar,450,238,212
2,Albacete,85,Viveros,480,253,227
2,Albacete,86,Yeste,3597,1829,1768
3,Alicante/Alacant,1,Adsubia,611,312,299
3,Alicante/Alacant,2,Agost,4601,2317,2284
3,Alicante/Alacant,3,Agres,653,350,303
3,Alicante/Alacant,4,Aigües,801,413,388
3,Alicante/Alacant,5,Albatera,10449,5392,5057
3,Alicante/Alacant,6,Alcalalí,1352,707,645
3,Alicante/Alacant,7,Alcocer de Planes,179,82,97
3,Alicante/Alacant,8,Alcoleja,228,117,111
3,Alicante/Alacant,9,Alcoy/Alcoi,60931,29562,31369
3,Alicante/Alacant,10,Alfafara,430,209,221
3,Alicante/Alacant,11,Alfàs del Pi (l'),16843,8446,8397
3,Alicante/Alacant,12,Algorfa,2297,1165,1132
3,Alicante/Alacant,13,Algueña,1501,736,765
3,Alicante/Alacant,14,Alicante/Alacant,319380,155204,164176
3,Alicante/Alacant,15,Almoradí,16547,8535,8012
3,Alicante/Alacant,16,Almudaina,116,66,50
3,Alicante/Alacant,17,Alqueria d'Asnar (l'),449,229,220
3,Alicante/Alacant,18,Altea,21154,10563,10591
3,Alicante/Alacant,19,Aspe,18203,9205,8998
3,Alicante/Alacant,20,Balones,169,78,91
3,Alicante/Alacant,21,Banyeres de Mariola,7282,3650,3632
3,Alicante/Alacant,22,Benasau,222,109,113
3,Alicante/Alacant,23,Beneixama,1886,943,943
3,Alicante/Alacant,24,Benejúzar,5249,2639,2610
3,Alicante/Alacant,25,Benferri,1385,710,675
3,Alicante/Alacant,26,Beniarbeig,1548,768,780
3,Alicante/Alacant,27,Beniardá,235,124,111
3,Alicante/Alacant,28,Beniarrés,1380,693,687
3,Alicante/Alacant,30,Benidoleig,1044,510,534
3,Alicante/Alacant,31,Benidorm,67492,34038,33454
3,Alicante/Alacant,32,Benifallim,124,57,67
3,Alicante/Alacant,33,Benifato,165,85,80
3,Alicante/Alacant,29,Benigembla,559,287,272
3,Alicante/Alacant,34,Benijófar,3380,1673,1707
3,Alicante/Alacant,35,Benilloba,874,436,438
3,Alicante/Alacant,36,Benillup,102,47,55
3,Alicante/Alacant,37,Benimantell,487,238,249
3,Alicante/Alacant,38,Benimarfull,441,218,223
3,Alicante/Alacant,39,Benimassot,140,81,59
3,Alicante/Alacant,40,Benimeli,363,183,180
3,Alicante/Alacant,41,Benissa,11935,6066,5869
3,Alicante/Alacant,42,Benitachell/Poble Nou de Benitatxell (el),3808,1948,1860
3,Alicante/Alacant,43,Biar,3620,1784,1836
3,Alicante/Alacant,44,Bigastro,5962,3048,2914
3,Alicante/Alacant,45,Bolulla,392,199,193
3,Alicante/Alacant,46,Busot,2421,1217,1204
3,Alicante/Alacant,49,Callosa de Segura,16866,8586,8280
3,Alicante/Alacant,48,Callosa d'En Sarrià,8179,4340,3839
3,Alicante/Alacant,47,Calpe/Calp,25190,12943,12247
3,Alicante/Alacant,50,Campello (el),23640,11667,11973
3,Alicante/Alacant,51,Campo de Mirra/Camp de Mirra (el),416,204,212
3,Alicante/Alacant,52,Cañada,1198,567,631
3,Alicante/Alacant,53,Castalla,8977,4543,4434
3,Alicante/Alacant,54,Castell de Castells,482,233,249
3,Alicante/Alacant,75,Castell de Guadalest (el),207,104,103
3,Alicante/Alacant,55,Catral,6642,3386,3256
3,Alicante/Alacant,56,Cocentaina,10992,5448,5544
3,Alicante/Alacant,57,Confrides,286,156,130
3,Alicante/Alacant,58,Cox,6477,3319,3158
3,Alicante/Alacant,59,Crevillent,27323,14014,13309
3,Alicante/Alacant,61,Daya Nueva,1562,809,753
3,Alicante/Alacant,62,Daya Vieja,336,172,164
3,Alicante/Alacant,63,Dénia,40601,20205,20396
3,Alicante/Alacant,64,Dolores,7095,3651,3444
3,Alicante/Alacant,65,Elche/Elx,215137,107440,107697
3,Alicante/Alacant,66,Elda,55571,27263,28308
3,Alicante/Alacant,67,Facheca,98,52,46
3,Alicante/Alacant,68,Famorca,63,29,34
3,Alicante/Alacant,69,Finestrat,3797,1927,1870
3,Alicante/Alacant,70,Formentera del Segura,2898,1479,1419
3,Alicante/Alacant,72,Gaianes,340,163,177
3,Alicante/Alacant,71,Gata de Gorgos,5375,2757,2618
3,Alicante/Alacant,73,Gorga,256,135,121
3,Alicante/Alacant,74,Granja de Rocamora,2099,1096,1003
3,Alicante/Alacant,76,Guardamar del Segura,13122,6661,6461
3,Alicante/Alacant,77,Hondón de las Nieves,2162,1082,1080
3,Alicante/Alacant,78,Hondón de los Frailes,1023,526,497
3,Alicante/Alacant,79,Ibi,23059,11483,11576
3,Alicante/Alacant,80,Jacarilla,1776,881,895
3,Alicante/Alacant,81,Jalón/Xaló,2805,1417,1388
3,Alicante/Alacant,82,Jávea/Xàbia,28242,14307,13935
3,Alicante/Alacant,83,Jijona/Xixona,7494,3594,3900
3,Alicante/Alacant,85,Llíber,930,467,463
3,Alicante/Alacant,84,Lorcha/Orxa (l'),721,354,367
3,Alicante/Alacant,86,Millena,178,82,96
3,Alicante/Alacant,88,Monforte del Cid,6053,3172,2881
3,Alicante/Alacant,89,Monóvar/Monòver,12727,6318,6409
3,Alicante/Alacant,903,Montesinos (Los),3319,1686,1633
3,Alicante/Alacant,91,Murla,515,242,273
3,Alicante/Alacant,92,Muro de Alcoy,8148,4051,4097
3,Alicante/Alacant,90,Mutxamel,18452,9287,9165
3,Alicante/Alacant,93,Novelda,26233,13108,13125
3,Alicante/Alacant,94,Nucia (la),12573,6422,6151
3,Alicante/Alacant,95,Ondara,5834,2938,2896
3,Alicante/Alacant,96,Onil,7500,3757,3743
3,Alicante/Alacant,97,Orba,2117,1035,1082
3,Alicante/Alacant,99,Orihuela,75009,38098,36911
3,Alicante/Alacant,98,Orxeta,718,351,367
3,Alicante/Alacant,100,Parcent,960,475,485
3,Alicante/Alacant,101,Pedreguer,6733,3369,3364
3,Alicante/Alacant,102,Pego,10781,5565,5216
3,Alicante/Alacant,103,Penàguila,354,177,177
3,Alicante/Alacant,104,Petrer,32388,16211,16177
3,Alicante/Alacant,902,Pilar de la Horadada,18051,9598,8453
3,Alicante/Alacant,105,Pinoso,7072,3567,3505
3,Alicante/Alacant,106,Planes,793,397,396
3,Alicante/Alacant,901,Poblets (els),2404,1153,1251
3,Alicante/Alacant,107,Polop,3353,1711,1642
3,Alicante/Alacant,60,Quatretondeta,150,73,77
3,Alicante/Alacant,109,Rafal,3770,1948,1822
3,Alicante/Alacant,110,"Ràfol d'Almúnia, el",532,267,265
3,Alicante/Alacant,111,Redován,6645,3388,3257
3,Alicante/Alacant,112,Relleu,1022,519,503
3,Alicante/Alacant,113,Rojales,13807,7078,6729
3,Alicante/Alacant,114,Romana (la),2361,1220,1141
3,Alicante/Alacant,115,Sagra,456,215,241
3,Alicante/Alacant,116,Salinas,1466,754,712
3,Alicante/Alacant,118,San Fulgencio,8197,4146,4051
3,Alicante/Alacant,904,San Isidro,1368,704,664
3,Alicante/Alacant,120,San Miguel de Salinas,6620,3400,3220
3,Alicante/Alacant,122,San Vicente del Raspeig/Sant Vicent del Raspeig,46034,22964,23070
3,Alicante/Alacant,117,Sanet y Negrals,664,313,351
3,Alicante/Alacant,119,Sant Joan d'Alacant,19711,9610,10101
3,Alicante/Alacant,121,Santa Pola,25494,12781,12713
3,Alicante/Alacant,123,Sax,9399,4739,4660
3,Alicante/Alacant,124,Sella,633,321,312
3,Alicante/Alacant,125,Senija,619,337,282
3,Alicante/Alacant,127,Tàrbena,736,375,361
3,Alicante/Alacant,128,Teulada,11983,6087,5896
3,Alicante/Alacant,129,Tibi,1485,768,717
3,Alicante/Alacant,130,Tollos,35,19,16
3,Alicante/Alacant,131,Tormos,328,161,167
3,Alicante/Alacant,132,Torremanzanas/Torre de les Maçanes (la),727,377,350
3,Alicante/Alacant,133,Torrevieja,84348,43440,40908
3,Alicante/Alacant,134,Vall d'Alcalà (la),167,79,88
3,Alicante/Alacant,135,Vall de Ebo,328,160,168
3,Alicante/Alacant,136,Vall de Gallinera,622,337,285
3,Alicante/Alacant,137,Vall de Laguar (la),932,439,493
3,Alicante/Alacant,138,Verger (el),4490,2326,2164
3,Alicante/Alacant,139,Villajoyosa/Vila Joiosa (la),27983,14022,13961
3,Alicante/Alacant,140,Villena,34185,16964,17221
4,Almería,1,Abla,1512,747,765
4,Almería,2,Abrucena,1358,689,669
4,Almería,3,Adra,23195,11769,11426
4,Almería,4,Albánchez,681,347,334
4,Almería,5,Alboloduy,745,359,386
4,Almería,6,Albox,11271,6055,5216
4,Almería,7,Alcolea,966,496,470
4,Almería,8,Alcóntar,647,341,306
4,Almería,9,Alcudia de Monteagud,158,76,82
4,Almería,10,Alhabia,692,342,350
4,Almería,11,Alhama de Almería,3438,1740,1698
4,Almería,12,Alicún,253,131,122
4,Almería,13,Almería,181702,88798,92904
4,Almería,14,Almócita,167,89,78
4,Almería,15,Alsodux,121,63,58
4,Almería,16,Antas,3223,1647,1576
4,Almería,17,Arboleas,2819,1455,1364
4,Almería,18,Armuña de Almanzora,322,164,158
4,Almería,19,Bacares,291,149,142
4,Almería,20,Bayárcal,303,160,143
4,Almería,21,Bayarque,250,126,124
4,Almería,22,Bédar,777,401,376
4,Almería,23,Beires,126,62,64
4,Almería,24,Benahadux,3205,1574,1631
4,Almería,26,Benitagla,65,36,29
4,Almería,27,Benizalón,308,154,154
4,Almería,28,Bentarique,275,144,131
4,Almería,29,Berja,14249,7108,7141
4,Almería,30,Canjáyar,1573,817,756
4,Almería,31,Cantoria,3565,1822,1743
4,Almería,32,Carboneras,7267,3758,3509
4,Almería,33,Castro de Filabres,163,84,79
4,Almería,36,Chercos,295,155,140
4,Almería,37,Chirivel,1849,912,937
4,Almería,34,Cóbdar,210,109,101
4,Almería,35,Cuevas del Almanzora,11484,5945,5539
4,Almería,38,Dalías,3773,1868,1905
4,Almería,902,Ejido (El),68828,37983,30845
4,Almería,41,Enix,322,177,145
4,Almería,43,Felix,534,274,260
4,Almería,44,Fines,2032,1082,950
4,Almería,45,Fiñana,2442,1231,1211
4,Almería,46,Fondón,934,484,450
4,Almería,47,Gádor,2933,1509,1424
4,Almería,48,Gallardos (Los),2887,1490,1397
4,Almería,49,Garrucha,7037,3613,3424
4,Almería,50,Gérgal,1057,545,512
4,Almería,51,Huécija,539,267,272
4,Almería,52,Huércal de Almería,11128,5667,5461
4,Almería,53,Huércal-Overa,16156,8028,8128
4,Almería,54,Illar,419,207,212
4,Almería,55,Instinción,524,262,262
4,Almería,56,Laroya,127,71,56
4,Almería,57,Láujar de Andarax,1836,907,929
4,Almería,58,Líjar,500,253,247
4,Almería,59,Lubrín,1670,792,878
4,Almería,60,Lucainena de las Torres,664,384,280
4,Almería,61,Lúcar,822,402,420
4,Almería,62,Macael,6091,3143,2948
4,Almería,63,María,1565,781,784
4,Almería,64,Mojácar,6092,3097,2995
4,Almería,903,Mojonera (La),7900,4358,3542
4,Almería,65,Nacimiento,467,246,221
4,Almería,66,Níjar,24435,14123,10312
4,Almería,67,Ohanes,795,405,390
4,Almería,68,Olula de Castro,150,81,69
4,Almería,69,Olula del Río,6358,3229,3129
4,Almería,70,Oria,2488,1279,1209
4,Almería,71,Padules,504,257,247
4,Almería,72,Partaloa,611,294,317
4,Almería,73,Paterna del Río,396,214,182
4,Almería,74,Pechina,3307,1693,1614
4,Almería,75,Pulpí,7600,4010,3590
4,Almería,76,Purchena,1645,824,821
4,Almería,77,Rágol,367,173,194
4,Almería,78,Rioja,1329,665,664
4,Almería,79,Roquetas de Mar,65886,34656,31230
4,Almería,80,Santa Cruz de Marchena,237,116,121
4,Almería,81,Santa Fe de Mondújar,437,215,222
4,Almería,82,Senés,319,166,153
4,Almería,83,Serón,2429,1194,1235
4,Almería,84,Sierro,457,227,230
4,Almería,85,Somontín,515,260,255
4,Almería,86,Sorbas,2840,1507,1333
4,Almería,87,Suflí,260,138,122
4,Almería,88,Tabernas,3410,1783,1627
4,Almería,89,Taberno,1085,546,539
4,Almería,90,Tahal,383,197,186
4,Almería,91,Terque,464,238,226
4,Almería,92,Tíjola,3820,1901,1919
4,Almería,901,Tres Villas (Las),587,310,277
4,Almería,93,Turre,2884,1481,1403
4,Almería,94,Turrillas,241,138,103
4,Almería,95,Uleila del Campo,988,505,483
4,Almería,96,Urrácal,353,166,187
4,Almería,97,Velefique,261,136,125
4,Almería,98,Vélez-Blanco,2126,1109,1017
4,Almería,99,Vélez-Rubio,7037,3441,3596
4,Almería,100,Vera,10439,5349,5090
4,Almería,101,Viator,3950,1994,1956
4,Almería,102,Vícar,19830,10947,8883
4,Almería,103,Zurgena,2288,1144,1144
5,Ávila,1,Adanero,363,187,176
5,Ávila,2,Adrada (La),2264,1168,1096
5,Ávila,5,Albornos,239,127,112
5,Ávila,7,Aldeanueva de Santa Cruz,172,94,78
5,Ávila,8,Aldeaseca,301,150,151
5,Ávila,10,Aldehuela (La),233,114,119
5,Ávila,12,Amavida,187,95,92
5,Ávila,13,Arenal (El),1068,519,549
5,Ávila,14,Arenas de San Pedro,6656,3259,3397
5,Ávila,15,Arevalillo,121,59,62
5,Ávila,16,Arévalo,7745,3753,3992
5,Ávila,17,Aveinte,109,57,52
5,Ávila,18,Avellaneda,37,17,20
5,Ávila,19,Ávila,52612,25202,27410
5,Ávila,21,Barco de Ávila (El),2613,1264,1349
5,Ávila,22,Barraco (El),2109,1055,1054
5,Ávila,23,Barromán,233,132,101
5,Ávila,24,Becedas,345,181,164
5,Ávila,25,Becedillas,150,81,69
5,Ávila,26,Bercial de Zapardiel,267,130,137
5,Ávila,27,Berlanas (Las),344,189,155
5,Ávila,29,Bernuy-Zapardiel,182,104,78
5,Ávila,30,Berrocalejo de Aragona,52,29,23
5,Ávila,33,Blascomillán,256,117,139
5,Ávila,34,Blasconuño de Matacabras,21,10,11
5,Ávila,35,Blascosancho,133,66,67
5,Ávila,36,Bohodón (El),168,88,80
5,Ávila,37,Bohoyo,414,214,200
5,Ávila,38,Bonilla de la Sierra,160,89,71
5,Ávila,39,Brabos,65,36,29
5,Ávila,40,Bularros,96,53,43
5,Ávila,41,Burgohondo,1209,619,590
5,Ávila,42,Cabezas de Alambre,196,100,96
5,Ávila,43,Cabezas del Pozo,114,58,56
5,Ávila,44,Cabezas del Villar,414,226,188
5,Ávila,45,Cabizuela,131,64,67
5,Ávila,46,Canales,54,29,25
5,Ávila,47,Candeleda,5047,2608,2439
5,Ávila,48,Cantiveros,176,91,85
5,Ávila,49,Cardeñosa,527,279,248
5,Ávila,51,Carrera (La),240,123,117
5,Ávila,52,Casas del Puerto,108,56,52
5,Ávila,53,Casasola,127,68,59
5,Ávila,54,Casavieja,1496,780,716
5,Ávila,55,Casillas,823,438,385
5,Ávila,56,Castellanos de Zapardiel,141,78,63
5,Ávila,57,Cebreros,3216,1626,1590
5,Ávila,58,Cepeda la Mora,108,57,51
5,Ávila,67,Chamartín,100,59,41
5,Ávila,59,Cillán,129,75,54
5,Ávila,60,Cisla,175,85,90
5,Ávila,61,Colilla (La),273,132,141
5,Ávila,62,Collado de Contreras,250,137,113
5,Ávila,63,Collado del Mirón,58,30,28
5,Ávila,64,Constanzana,162,89,73
5,Ávila,65,Crespos,626,325,301
5,Ávila,66,Cuevas del Valle,565,305,260
5,Ávila,903,Diego del Carpio,238,129,109
5,Ávila,69,Donjimeno,120,64,56
5,Ávila,70,Donvidas,67,35,32
5,Ávila,72,Espinosa de los Caballeros,112,64,48
5,Ávila,73,Flores de Ávila,394,209,185
5,Ávila,74,Fontiveros,936,477,459
5,Ávila,75,Fresnedilla,100,39,61
5,Ávila,76,Fresno (El),517,265,252
5,Ávila,77,Fuente el Saúz,252,134,118
5,Ávila,78,Fuentes de Año,164,90,74
5,Ávila,79,Gallegos de Altamiros,94,56,38
5,Ávila,80,Gallegos de Sobrinos,92,45,47
5,Ávila,81,Garganta del Villar,57,32,25
5,Ávila,82,Gavilanes,695,387,308
5,Ávila,83,Gemuño,182,85,97
5,Ávila,85,Gil García,51,22,29
5,Ávila,84,Gilbuena,97,52,45
5,Ávila,86,Gimialcón,103,60,43
5,Ávila,87,Gotarrendura,190,66,124
5,Ávila,88,Grandes y San Martín,45,24,21
5,Ávila,89,Guisando,619,321,298
5,Ávila,90,Gutierre-Muñoz,119,57,62
5,Ávila,92,Hernansancho,214,112,102
5,Ávila,93,Herradón de Pinares,541,291,250
5,Ávila,94,Herreros de Suso,192,98,94
5,Ávila,95,Higuera de las Dueñas,311,180,131
5,Ávila,96,Hija de Dios (La),88,51,37
5,Ávila,97,Horcajada (La),680,334,346
5,Ávila,99,Horcajo de las Torres,695,386,309
5,Ávila,100,Hornillo (El),392,200,192
5,Ávila,102,Hoyo de Pinares (El),2393,1258,1135
5,Ávila,101,Hoyocasero,359,181,178
5,Ávila,103,Hoyorredondo,108,60,48
5,Ávila,106,Hoyos de Miguel Muñoz,49,24,25
5,Ávila,104,Hoyos del Collado,40,24,16
5,Ávila,105,Hoyos del Espino,449,251,198
5,Ávila,107,Hurtumpascual,99,58,41
5,Ávila,108,Junciana,85,47,38
5,Ávila,109,Langa,570,292,278
5,Ávila,110,Lanzahíta,967,521,446
5,Ávila,113,Llanos de Tormes (Los),108,53,55
5,Ávila,112,Losar del Barco (El),124,61,63
5,Ávila,114,Madrigal de las Altas Torres,1825,932,893
5,Ávila,115,Maello,690,366,324
5,Ávila,116,Malpartida de Corneja,177,89,88
5,Ávila,117,Mamblas,262,150,112
5,Ávila,118,Mancera de Arriba,120,62,58
5,Ávila,119,Manjabálago,55,27,28
5,Ávila,120,Marlín,40,23,17
5,Ávila,121,Martiherrero,281,150,131
5,Ávila,122,Martínez,190,102,88
5,Ávila,123,Mediana de Voltoya,109,57,52
5,Ávila,124,Medinilla,167,79,88
5,Ávila,125,Mengamuñoz,68,32,36
5,Ávila,126,Mesegar de Corneja,97,50,47
5,Ávila,127,Mijares,874,456,418
5,Ávila,128,Mingorría,466,249,217
5,Ávila,129,Mirón (El),203,117,86
5,Ávila,130,Mironcillo,133,73,60
5,Ávila,131,Mirueña de los Infanzones,150,79,71
5,Ávila,132,Mombeltrán,1141,592,549
5,Ávila,133,Monsalupe,68,29,39
5,Ávila,134,Moraleja de Matacabras,63,36,27
5,Ávila,135,Muñana,550,278,272
5,Ávila,136,Muñico,129,68,61
5,Ávila,138,Muñogalindo,431,235,196
5,Ávila,139,Muñogrande,93,49,44
5,Ávila,140,Muñomer del Peco,126,66,60
5,Ávila,141,Muñopepe,112,67,45
5,Ávila,142,Muñosancho,138,64,74
5,Ávila,143,Muñotello,104,53,51
5,Ávila,144,Narrillos del Álamo,128,68,60
5,Ávila,145,Narrillos del Rebollar,64,34,30
5,Ávila,149,Narros de Saldueña,146,80,66
5,Ávila,147,Narros del Castillo,206,112,94
5,Ávila,148,Narros del Puerto,43,23,20
5,Ávila,152,Nava de Arévalo,932,488,444
5,Ávila,153,Nava del Barco,139,70,69
5,Ávila,151,Navacepedilla de Corneja,145,81,64
5,Ávila,154,Navadijos,54,33,21
5,Ávila,155,Navaescurial,74,43,31
5,Ávila,156,Navahondilla,248,140,108
5,Ávila,157,Navalacruz,265,126,139
5,Ávila,158,Navalmoral,480,251,229
5,Ávila,159,Navalonguilla,389,197,192
5,Ávila,160,Navalosa,442,233,209
5,Ávila,161,Navalperal de Pinares,1003,524,479
5,Ávila,162,Navalperal de Tormes,127,69,58
5,Ávila,163,Navaluenga,2143,1081,1062
5,Ávila,164,Navaquesera,42,17,25
5,Ávila,165,Navarredonda de Gredos,474,241,233
5,Ávila,166,Navarredondilla,274,131,143
5,Ávila,167,Navarrevisca,384,194,190
5,Ávila,168,Navas del Marqués (Las),5113,2661,2452
5,Ávila,169,Navatalgordo,298,156,142
5,Ávila,170,Navatejares,78,36,42
5,Ávila,171,Neila de San Miguel,100,53,47
5,Ávila,172,Niharra,187,97,90
5,Ávila,173,Ojos-Albos,60,36,24
5,Ávila,174,Orbita,96,44,52
5,Ávila,175,Oso (El),213,116,97
5,Ávila,176,Padiernos,223,121,102
5,Ávila,177,Pajares de Adaja,178,92,86
5,Ávila,178,Palacios de Goda,480,243,237
5,Ávila,179,Papatrigo,294,157,137
5,Ávila,180,Parral (El),122,66,56
5,Ávila,181,Pascualcobo,45,25,20
5,Ávila,182,Pedro Bernardo,1186,613,573
5,Ávila,183,Pedro-Rodríguez,215,100,115
5,Ávila,184,Peguerinos,331,180,151
5,Ávila,185,Peñalba de Ávila,126,69,57
5,Ávila,186,Piedrahíta,1980,971,1009
5,Ávila,187,Piedralaves,2154,1093,1061
5,Ávila,188,Poveda,80,48,32
5,Ávila,189,Poyales del Hoyo,608,303,305
5,Ávila,190,Pozanco,52,31,21
5,Ávila,191,Pradosegar,185,102,83
5,Ávila,192,Puerto Castilla,144,86,58
5,Ávila,193,Rasueros,278,148,130
5,Ávila,194,Riocabado,188,106,82
5,Ávila,195,Riofrío,311,171,140
5,Ávila,196,Rivilla de Barajas,85,42,43
5,Ávila,197,Salobral,117,62,55
5,Ávila,198,Salvadiós,103,51,52
5,Ávila,199,San Bartolomé de Béjar,56,28,28
5,Ávila,200,San Bartolomé de Corneja,75,37,38
5,Ávila,201,San Bartolomé de Pinares,691,366,325
5,Ávila,206,San Esteban de los Patos,33,18,15
5,Ávila,208,San Esteban de Zapardiel,57,32,25
5,Ávila,207,San Esteban del Valle,893,462,431
5,Ávila,209,San García de Ingelmos,133,75,58
5,Ávila,901,San Juan de Gredos,391,216,175
5,Ávila,210,San Juan de la Encinilla,124,61,63
5,Ávila,211,San Juan de la Nava,619,317,302
5,Ávila,212,San Juan del Molinillo,327,184,143
5,Ávila,213,San Juan del Olmo,147,84,63
5,Ávila,214,San Lorenzo de Tormes,54,28,26
5,Ávila,215,San Martín de la Vega del Alberche,259,149,110
5,Ávila,216,San Martín del Pimpollar,278,153,125
5,Ávila,217,San Miguel de Corneja,96,44,52
5,Ávila,218,San Miguel de Serrezuela,180,97,83
5,Ávila,219,San Pascual,47,31,16
5,Ávila,220,San Pedro del Arroyo,470,236,234
5,Ávila,231,San Vicente de Arévalo,225,116,109
5,Ávila,204,Sanchidrián,795,397,398
5,Ávila,205,Sanchorreja,127,58,69
5,Ávila,222,Santa Cruz de Pinares,201,109,92
5,Ávila,221,Santa Cruz del Valle,551,283,268
5,Ávila,226,Santa María de los Caballeros,115,61,54
5,Ávila,224,Santa María del Arroyo,115,62,53
5,Ávila,225,Santa María del Berrocal,509,243,266
5,Ávila,902,Santa María del Cubillo,378,214,164
5,Ávila,227,Santa María del Tiétar,479,247,232
5,Ávila,228,Santiago del Collado,254,158,96
5,Ávila,904,Santiago del Tormes,194,100,94
5,Ávila,229,Santo Domingo de las Posadas,100,51,49
5,Ávila,230,Santo Tomé de Zabarcos,101,55,46
5,Ávila,232,Serrada (La),141,71,70
5,Ávila,233,Serranillos,355,189,166
5,Ávila,234,Sigeres,73,35,38
5,Ávila,235,Sinlabajos,182,101,81
5,Ávila,236,Solana de Ávila,188,103,85
5,Ávila,237,Solana de Rioalmar,260,138,122
5,Ávila,238,Solosancho,1022,538,484
5,Ávila,239,Sotalbo,273,144,129
5,Ávila,240,Sotillo de la Adrada,4191,2074,2117
5,Ávila,241,Tiemblo (El),3837,1946,1891
5,Ávila,242,Tiñosillos,786,408,378
5,Ávila,243,Tolbaños,109,52,57
5,Ávila,244,Tormellas,87,45,42
5,Ávila,245,Tornadizos de Ávila,378,188,190
5,Ávila,247,Torre (La),351,196,155
5,Ávila,246,Tórtoles,104,55,49
5,Ávila,249,Umbrías,144,76,68
5,Ávila,251,Vadillo de la Sierra,113,60,53
5,Ávila,252,Valdecasa,88,48,40
5,Ávila,253,Vega de Santa María,128,70,58
5,Ávila,254,Velayos,249,124,125
5,Ávila,256,Villaflor,152,79,73
5,Ávila,257,Villafranca de la Sierra,162,85,77
5,Ávila,905,Villanueva de Ávila,300,150,150
5,Ávila,258,Villanueva de Gómez,143,70,73
5,Ávila,259,Villanueva del Aceral,159,74,85
5,Ávila,260,Villanueva del Campillo,161,86,75
5,Ávila,261,Villar de Corneja,67,36,31
5,Ávila,262,Villarejo del Valle,476,241,235
5,Ávila,263,Villatoro,237,127,110
5,Ávila,264,Viñegra de Moraña,81,44,37
5,Ávila,265,Vita,105,65,40
5,Ávila,266,Zapardiel de la Cañada,149,73,76
5,Ávila,267,Zapardiel de la Ribera,125,62,63
6,Badajoz,1,Acedera,859,445,414
6,Badajoz,2,Aceuchal,5422,2701,2721
6,Badajoz,3,Ahillones,1107,548,559
6,Badajoz,4,Alange,2020,1044,976
6,Badajoz,5,Albuera (La),1820,923,897
6,Badajoz,6,Alburquerque,5639,2851,2788
6,Badajoz,7,Alconchel,2000,1015,985
6,Badajoz,8,Alconera,747,373,374
6,Badajoz,9,Aljucén,247,132,115
6,Badajoz,10,Almendral,1361,670,691
6,Badajoz,11,Almendralejo,29889,14893,14996
6,Badajoz,12,Arroyo de San Serván,4083,2110,1973
6,Badajoz,13,Atalaya,336,159,177
6,Badajoz,14,Azuaga,8611,4370,4241
6,Badajoz,15,Badajoz,143019,69555,73464
6,Badajoz,16,Barcarrota,3627,1847,1780
6,Badajoz,17,Baterno,362,190,172
6,Badajoz,18,Benquerencia de la Serena,972,479,493
6,Badajoz,19,Berlanga,2616,1279,1337
6,Badajoz,20,Bienvenida,2349,1213,1136
6,Badajoz,21,Bodonal de la Sierra,1174,599,575
6,Badajoz,22,Burguillos del Cerro,3196,1530,1666
6,Badajoz,23,Cabeza del Buey,5648,2790,2858
6,Badajoz,24,Cabeza la Vaca,1579,797,782
6,Badajoz,25,Calamonte,6128,3050,3078
6,Badajoz,26,Calera de León,1095,554,541
6,Badajoz,27,Calzadilla de los Barros,851,421,430
6,Badajoz,28,Campanario,5529,2718,2811
6,Badajoz,29,Campillo de Llerena,1624,801,823
6,Badajoz,30,Capilla,193,93,100
6,Badajoz,31,Carmonita,627,318,309
6,Badajoz,32,Carrascalejo (El),82,44,38
6,Badajoz,33,Casas de Don Pedro,1624,815,809
6,Badajoz,34,Casas de Reina,193,91,102
6,Badajoz,35,Castilblanco,1146,552,594
6,Badajoz,36,Castuera,6714,3311,3403
6,Badajoz,42,Cheles,1296,648,648
6,Badajoz,37,Codosera (La),2239,1171,1068
6,Badajoz,38,Cordobilla de Lácara,1023,521,502
6,Badajoz,39,Coronada (La),2337,1168,1169
6,Badajoz,40,Corte de Peleas,1256,624,632
6,Badajoz,41,Cristina,561,296,265
6,Badajoz,43,Don Álvaro,633,316,317
6,Badajoz,44,Don Benito,33392,16481,16911
6,Badajoz,45,Entrín Bajo,605,300,305
6,Badajoz,46,Esparragalejo,1550,758,792
6,Badajoz,47,Esparragosa de la Serena,1108,551,557
6,Badajoz,48,Esparragosa de Lares,1066,524,542
6,Badajoz,49,Feria,1391,689,702
6,Badajoz,50,Fregenal de la Sierra,5253,2531,2722
6,Badajoz,51,Fuenlabrada de los Montes,1967,969,998
6,Badajoz,52,Fuente de Cantos,5068,2522,2546
6,Badajoz,53,Fuente del Arco,754,379,375
6,Badajoz,54,Fuente del Maestre,6798,3403,3395
6,Badajoz,55,Fuentes de León,2674,1321,1353
6,Badajoz,56,Garbayuela,537,289,248
6,Badajoz,57,Garlitos,725,374,351
6,Badajoz,58,Garrovilla (La),2477,1250,1227
6,Badajoz,59,Granja de Torrehermosa,2456,1206,1250
6,Badajoz,60,Guareña,7314,3682,3632
6,Badajoz,61,Haba (La),1441,729,712
6,Badajoz,62,Helechosa de los Montes,775,436,339
6,Badajoz,63,Herrera del Duque,3695,1871,1824
6,Badajoz,64,Higuera de la Serena,1115,578,537
6,Badajoz,65,Higuera de Llerena,392,190,202
6,Badajoz,66,Higuera de Vargas,2184,1100,1084
6,Badajoz,67,Higuera la Real,2505,1270,1235
6,Badajoz,68,Hinojosa del Valle,557,276,281
6,Badajoz,69,Hornachos,3840,1963,1877
6,Badajoz,70,Jerez de los Caballeros,9776,4861,4915
6,Badajoz,71,Lapa (La),310,157,153
6,Badajoz,73,Llera,948,488,460
6,Badajoz,74,Llerena,5764,2843,2921
6,Badajoz,72,Lobón,2647,1377,1270
6,Badajoz,75,Magacela,648,337,311
6,Badajoz,76,Maguilla,1132,558,574
6,Badajoz,77,Malcocinado,486,260,226
6,Badajoz,78,Malpartida de la Serena,719,371,348
6,Badajoz,79,Manchita,749,377,372
6,Badajoz,80,Medellín,2348,1187,1161
6,Badajoz,81,Medina de las Torres,1403,696,707
6,Badajoz,82,Mengabril,442,225,217
6,Badajoz,83,Mérida,53089,25811,27278
6,Badajoz,84,Mirandilla,1358,694,664
6,Badajoz,85,Monesterio,4413,2244,2169
6,Badajoz,86,Montemolín,1582,802,780
6,Badajoz,87,Monterrubio de la Serena,2904,1396,1508
6,Badajoz,88,Montijo,15620,7728,7892
6,Badajoz,89,Morera (La),768,381,387
6,Badajoz,90,Nava de Santiago (La),1135,571,564
6,Badajoz,91,Navalvillar de Pela,4782,2430,2352
6,Badajoz,92,Nogales,706,349,357
6,Badajoz,93,Oliva de la Frontera,5721,2825,2896
6,Badajoz,94,Oliva de Mérida,1888,942,946
6,Badajoz,95,Olivenza,11389,5651,5738
6,Badajoz,96,Orellana de la Sierra,311,171,140
6,Badajoz,97,Orellana la Vieja,3102,1554,1548
6,Badajoz,98,Palomas,726,373,353
6,Badajoz,99,Parra (La),1425,711,714
6,Badajoz,100,Peñalsordo,1347,662,685
6,Badajoz,101,Peraleda del Zaucejo,590,299,291
6,Badajoz,102,Puebla de Alcocer,1269,625,644
6,Badajoz,103,Puebla de la Calzada,5587,2752,2835
6,Badajoz,104,Puebla de la Reina,912,469,443
6,Badajoz,107,Puebla de Obando,2033,1033,1000
6,Badajoz,108,Puebla de Sancho Pérez,2880,1448,1432
6,Badajoz,105,Puebla del Maestre,831,409,422
6,Badajoz,106,Puebla del Prior,545,271,274
6,Badajoz,902,Pueblonuevo del Guadiana,1993,1020,973
6,Badajoz,109,Quintana de la Serena,5260,2661,2599
6,Badajoz,110,Reina,200,103,97
6,Badajoz,111,Rena,637,318,319
6,Badajoz,112,Retamal de Llerena,510,273,237
6,Badajoz,113,Ribera del Fresno,3369,1669,1700
6,Badajoz,114,Risco,194,93,101
6,Badajoz,115,Roca de la Sierra (La),1578,778,800
6,Badajoz,116,Salvaleón,2172,1090,1082
6,Badajoz,117,Salvatierra de los Barros,1866,946,920
6,Badajoz,119,San Pedro de Mérida,845,426,419
6,Badajoz,123,San Vicente de Alcántara,5821,2875,2946
6,Badajoz,118,Sancti-Spíritus,241,114,127
6,Badajoz,120,Santa Amalia,4398,2190,2208
6,Badajoz,121,Santa Marta,4237,2110,2127
6,Badajoz,122,Santos de Maimona (Los),7982,3990,3992
6,Badajoz,124,Segura de León,2208,1105,1103
6,Badajoz,125,Siruela,2251,1128,1123
6,Badajoz,126,Solana de los Barros,2611,1302,1309
6,Badajoz,127,Talarrubias,3616,1789,1827
6,Badajoz,128,Talavera la Real,5164,2602,2562
6,Badajoz,129,Táliga,694,352,342
6,Badajoz,130,Tamurejo,266,135,131
6,Badajoz,131,Torre de Miguel Sesmero,1206,606,600
6,Badajoz,132,Torremayor,1020,489,531
6,Badajoz,133,Torremejía,2148,1105,1043
6,Badajoz,134,Trasierra,702,370,332
6,Badajoz,135,Trujillanos,1363,713,650
6,Badajoz,136,Usagre,2011,1016,995
6,Badajoz,137,Valdecaballeros,1277,645,632
6,Badajoz,901,Valdelacalzada,2601,1345,1256
6,Badajoz,138,Valdetorres,1332,674,658
6,Badajoz,139,Valencia de las Torres,724,372,352
6,Badajoz,140,Valencia del Mombuey,793,393,400
6,Badajoz,141,Valencia del Ventoso,2215,1103,1112
6,Badajoz,146,Valle de la Serena,1501,731,770
6,Badajoz,147,Valle de Matamoros,456,221,235
6,Badajoz,148,Valle de Santa Ana,1208,616,592
6,Badajoz,142,Valverde de Burguillos,326,165,161
6,Badajoz,143,Valverde de Leganés,3894,1958,1936
6,Badajoz,144,Valverde de Llerena,762,361,401
6,Badajoz,145,Valverde de Mérida,1181,586,595
6,Badajoz,149,Villafranca de los Barros,12894,6408,6486
6,Badajoz,150,Villagarcía de la Torre,1018,513,505
6,Badajoz,151,Villagonzalo,1336,658,678
6,Badajoz,152,Villalba de los Barros,1670,860,810
6,Badajoz,153,Villanueva de la Serena,24713,12151,12562
6,Badajoz,154,Villanueva del Fresno,3534,1745,1789
6,Badajoz,156,Villar de Rena,1540,805,735
6,Badajoz,155,Villar del Rey,2432,1277,1155
6,Badajoz,157,Villarta de los Montes,621,308,313
6,Badajoz,158,Zafra,15674,7541,8133
6,Badajoz,159,Zahínos,2959,1493,1466
6,Badajoz,160,Zalamea de la Serena,4303,2146,2157
6,Badajoz,162,Zarza (La),3565,1808,1757
6,Badajoz,161,Zarza-Capilla,449,225,224
7,Balears (Illes),2,Alaior,8671,4378,4293
7,Balears (Illes),1,Alaró,4707,2322,2385
7,Balears (Illes),3,Alcúdia,15897,8190,7707
7,Balears (Illes),4,Algaida,4258,2204,2054
7,Balears (Illes),5,Andratx,9906,4963,4943
7,Balears (Illes),901,Ariany,750,392,358
7,Balears (Illes),6,Artà,6649,3361,3288
7,Balears (Illes),7,Banyalbufar,568,321,247
7,Balears (Illes),8,Binissalem,6326,3225,3101
7,Balears (Illes),9,Búger,1016,515,501
7,Balears (Illes),10,Bunyola,5475,2726,2749
7,Balears (Illes),11,Calvià,43499,21958,21541
7,Balears (Illes),12,Campanet,2515,1263,1252
7,Balears (Illes),13,Campos,8122,4082,4040
7,Balears (Illes),14,Capdepera,10245,5124,5121
7,Balears (Illes),64,Castell (Es),7440,3802,3638
7,Balears (Illes),15,Ciutadella de Menorca,26972,13520,13452
7,Balears (Illes),16,Consell,2877,1445,1432
7,Balears (Illes),17,Costitx,1004,496,508
7,Balears (Illes),18,Deyá,708,375,333
7,Balears (Illes),26,Eivissa,42797,21838,20959
7,Balears (Illes),19,Escorca,293,167,126
7,Balears (Illes),20,Esporles,4457,2205,2252
7,Balears (Illes),21,Estellencs,386,207,179
7,Balears (Illes),22,Felanitx,16566,8503,8063
7,Balears (Illes),23,Ferreries,4416,2275,2141
7,Balears (Illes),24,Formentera,7506,3934,3572
7,Balears (Illes),25,Fornalutx,698,347,351
7,Balears (Illes),27,Inca,26504,13454,13050
7,Balears (Illes),28,Lloret de Vistalegre,1134,576,558
7,Balears (Illes),29,Lloseta,5295,2736,2559
7,Balears (Illes),30,Llubí,2030,1013,1017
7,Balears (Illes),31,Llucmajor,29891,15169,14722
7,Balears (Illes),32,Mahón,27669,13707,13962
7,Balears (Illes),33,Manacor,35908,18080,17828
7,Balears (Illes),34,Mancor de la Vall,980,480,500
7,Balears (Illes),35,Maria de la Salut,2118,1097,1021
7,Balears (Illes),36,Marratxí,28237,14271,13966
7,Balears (Illes),37,Mercadal (Es),4255,2202,2053
7,Balears (Illes),902,Migjorn Gran (Es),1409,700,709
7,Balears (Illes),38,Montuïri,2594,1307,1287
7,Balears (Illes),39,Muro,6610,3424,3186
7,Balears (Illes),40,Palma de Mallorca,375773,183977,191796
7,Balears (Illes),41,Petra,2707,1350,1357
7,Balears (Illes),44,Pobla (Sa),11767,6115,5652
7,Balears (Illes),42,Pollença,15987,8071,7916
7,Balears (Illes),43,Porreres,4597,2413,2184
7,Balears (Illes),45,Puigpunyent,1513,786,727
7,Balears (Illes),59,Salines (Ses),4290,2201,2089
7,Balears (Illes),46,Sant Antoni de Portmany,18366,9487,8879
7,Balears (Illes),49,Sant Joan,1847,935,912
7,Balears (Illes),50,Sant Joan de Labritja,4838,2517,2321
7,Balears (Illes),48,Sant Josep de sa Talaia,18382,9620,8762
7,Balears (Illes),51,Sant Llorenç des Cardassar,7498,3835,3663
7,Balears (Illes),52,Sant Lluís,5865,2987,2878
7,Balears (Illes),53,Santa Eugènia,1420,756,664
7,Balears (Illes),54,Santa Eulalia del Río,26724,13798,12926
7,Balears (Illes),55,Santa Margalida,9719,4970,4749
7,Balears (Illes),56,Santa María del Camí,5175,2579,2596
7,Balears (Illes),57,Santanyí,10673,5405,5268
7,Balears (Illes),58,Selva,3205,1591,1614
7,Balears (Illes),47,Sencelles,2656,1368,1288
7,Balears (Illes),60,Sineu,3053,1519,1534
7,Balears (Illes),61,Sóller,12521,6278,6243
7,Balears (Illes),62,Son Servera,10766,5498,5268
7,Balears (Illes),63,Valldemossa,1910,971,939
7,Balears (Illes),65,Vilafranca de Bonany,2521,1261,1260
8,Barcelona,1,Abrera,9839,5088,4751
8,Barcelona,2,Aguilar de Segarra,235,123,112
8,Barcelona,14,Aiguafreda,2308,1122,1186
8,Barcelona,3,Alella,8940,4427,4513
8,Barcelona,4,Alpens,288,153,135
8,Barcelona,5,Ametlla del Vallès (L'),7319,3652,3667
8,Barcelona,6,Arenys de Mar,13860,6760,7100
8,Barcelona,7,Arenys de Munt,7369,3682,3687
8,Barcelona,8,Argençola,210,117,93
8,Barcelona,9,Argentona,10868,5374,5494
8,Barcelona,10,Artés,4949,2499,2450
8,Barcelona,11,Avià,2015,1016,999
8,Barcelona,12,Avinyó,2067,1038,1029
8,Barcelona,13,Avinyonet del Penedès,1529,822,707
8,Barcelona,15,Badalona,218553,109979,108574
8,Barcelona,904,Badia del Vallès,14230,7091,7139
8,Barcelona,16,Bagà,2160,1056,1104
8,Barcelona,17,Balenyà,3421,1699,1722
8,Barcelona,18,Balsareny,3277,1620,1657
8,Barcelona,252,Barberà del Vallès,27827,13916,13911
8,Barcelona,19,Barcelona,1593075,754463,838612
8,Barcelona,20,Begues,5470,2741,2729
8,Barcelona,21,Bellprat,89,50,39
8,Barcelona,22,Berga,16175,7977,8198
8,Barcelona,23,Bigues i Riells,7155,3708,3447
8,Barcelona,24,Borredà,518,266,252
8,Barcelona,25,Bruc (El),1543,830,713
8,Barcelona,26,Brull (El),202,108,94
8,Barcelona,27,Cabanyes (Les),682,350,332
8,Barcelona,29,Cabrera de Mar,4119,2102,2017
8,Barcelona,28,Cabrera d'Igualada,944,509,435
8,Barcelona,30,Cabrils,6238,3067,3171
8,Barcelona,31,Calaf,3271,1711,1560
8,Barcelona,34,Calders,810,411,399
8,Barcelona,33,Caldes de Montbui,15536,7771,7765
8,Barcelona,32,Caldes d'Estrac,2508,1219,1289
8,Barcelona,35,Calella,16927,8413,8514
8,Barcelona,37,Calldetenes,2183,1140,1043
8,Barcelona,38,Callús,1477,722,755
8,Barcelona,36,Calonge de Segarra,206,107,99
8,Barcelona,39,Campins,354,180,174
8,Barcelona,40,Canet de Mar,12429,6149,6280
8,Barcelona,41,Canovelles,14668,7675,6993
8,Barcelona,42,Cànoves i Samalús,2375,1236,1139
8,Barcelona,43,Canyelles,3127,1650,1477
8,Barcelona,44,Capellades,5302,2592,2710
8,Barcelona,45,Capolat,79,41,38
8,Barcelona,46,Cardedeu,15018,7456,7562
8,Barcelona,47,Cardona,5232,2538,2694
8,Barcelona,48,Carme,726,372,354
8,Barcelona,49,Casserres,1548,751,797
8,Barcelona,57,Castell de l'Areny,60,35,25
8,Barcelona,52,Castellar de n'Hug,184,94,90
8,Barcelona,50,Castellar del Riu,152,84,68
8,Barcelona,51,Castellar del Vallès,20437,10196,10241
8,Barcelona,53,Castellbell i el Vilar,3307,1688,1619
8,Barcelona,54,Castellbisbal,10842,5591,5251
8,Barcelona,55,Castellcir,528,281,247
8,Barcelona,56,Castelldefels,56718,28317,28401
8,Barcelona,58,Castellet i la Gornal,1798,922,876
8,Barcelona,60,Castellfollit de Riubregós,202,102,100
8,Barcelona,59,Castellfollit del Boix,403,201,202
8,Barcelona,61,Castellgalí,1282,681,601
8,Barcelona,62,Castellnou de Bages,791,423,368
8,Barcelona,63,Castellolí,459,223,236
8,Barcelona,64,Castellterçol,2195,1077,1118
8,Barcelona,65,Castellví de la Marca,1563,792,771
8,Barcelona,66,Castellví de Rosanes,1370,701,669
8,Barcelona,67,Centelles,6493,3176,3317
8,Barcelona,268,Cercs,1342,688,654
8,Barcelona,266,Cerdanyola del Vallès,57114,28408,28706
8,Barcelona,68,Cervelló,7350,3760,3590
8,Barcelona,69,Collbató,3337,1747,1590
8,Barcelona,70,Collsuspina,306,162,144
8,Barcelona,71,Copons,289,142,147
8,Barcelona,72,Corbera de Llobregat,12025,6174,5851
8,Barcelona,73,Cornellà de Llobregat,84131,41815,42316
8,Barcelona,74,Cubelles,10617,5511,5106
8,Barcelona,75,Dosrius,4093,2045,2048
8,Barcelona,76,Esparreguera,20740,10631,10109
8,Barcelona,77,Esplugues de Llobregat,46550,22878,23672
8,Barcelona,78,Espunyola (L'),270,133,137
8,Barcelona,79,Estany (L'),393,186,207
8,Barcelona,134,Figaró-Montmany,1020,523,497
8,Barcelona,80,Fígols,48,27,21
8,Barcelona,82,Fogars de la Selva,1171,611,560
8,Barcelona,81,Fogars de Montclús,417,224,193
8,Barcelona,83,Folgueroles,1905,953,952
8,Barcelona,84,Fonollosa,1208,616,592
8,Barcelona,85,Font-rubí,1382,735,647
8,Barcelona,86,Franqueses del Vallès (Les),15196,7792,7404
8,Barcelona,90,Gaià,157,79,78
8,Barcelona,87,Gallifa,210,106,104
8,Barcelona,88,Garriga (La),13472,6539,6933
8,Barcelona,89,Gavà,44210,22092,22118
8,Barcelona,91,Gelida,5650,2895,2755
8,Barcelona,92,Gironella,4853,2364,2489
8,Barcelona,93,Gisclareny,36,20,16
8,Barcelona,94,Granada (La),1594,804,790
8,Barcelona,95,Granera,79,54,25
8,Barcelona,96,Granollers,57796,28744,29052
8,Barcelona,97,Gualba,988,528,460
8,Barcelona,99,Guardiola de Berguedà,926,474,452
8,Barcelona,100,Gurb,2189,1111,1078
8,Barcelona,101,Hospitalet de Llobregat (L'),252884,124300,128584
8,Barcelona,162,Hostalets de Pierola (Els),1879,988,891
8,Barcelona,102,Igualada,35933,17764,18169
8,Barcelona,103,Jorba,665,324,341
8,Barcelona,104,Llacuna (La),869,463,406
8,Barcelona,105,Llagosta (La),13455,6747,6708
8,Barcelona,107,Lliçà d'Amunt,12439,6413,6026
8,Barcelona,108,Lliçà de Vall,5821,3013,2808
8,Barcelona,106,Llinars del Vallès,8166,4076,4090
8,Barcelona,109,Lluçà,249,134,115
8,Barcelona,110,Malgrat de Mar,16833,8511,8322
8,Barcelona,111,Malla,258,120,138
8,Barcelona,112,Manlleu,19488,9887,9601
8,Barcelona,113,Manresa,70343,34565,35778
8,Barcelona,242,Marganell,275,122,153
8,Barcelona,114,Martorell,25766,13312,12454
8,Barcelona,115,Martorelles,4903,2492,2411
8,Barcelona,116,Masies de Roda (Les),719,358,361
8,Barcelona,117,Masies de Voltregà (Les),3067,1505,1562
8,Barcelona,118,Masnou (El),21464,10405,11059
8,Barcelona,119,Masquefa,7070,3617,3453
8,Barcelona,120,Matadepera,7966,4017,3949
8,Barcelona,121,Mataró,116698,58468,58230
8,Barcelona,122,Mediona,1943,1023,920
8,Barcelona,138,Moià,5142,2618,2524
8,Barcelona,123,Molins de Rei,23069,11382,11687
8,Barcelona,124,Mollet del Vallès,51218,25978,25240
8,Barcelona,128,Monistrol de Calders,665,332,333
8,Barcelona,127,Monistrol de Montserrat,2723,1420,1303
8,Barcelona,125,Montcada i Reixac,31725,15807,15918
8,Barcelona,130,Montclar,121,59,62
8,Barcelona,131,Montesquiu,858,438,420
8,Barcelona,126,Montgat,9112,4499,4613
8,Barcelona,132,Montmajor,460,240,220
8,Barcelona,133,Montmaneu,203,106,97
8,Barcelona,135,Montmeló,8804,4424,4380
8,Barcelona,136,Montornès del Vallès,14190,7282,6908
8,Barcelona,137,Montseny,306,165,141
8,Barcelona,129,Muntanyola,427,230,197
8,Barcelona,139,Mura,220,115,105
8,Barcelona,140,Navarcles,5638,2799,2839
8,Barcelona,141,Navàs,5731,2844,2887
8,Barcelona,142,Nou de Berguedà (La),159,80,79
8,Barcelona,143,Òdena,2936,1487,1449
8,Barcelona,145,Olèrdola,2864,1482,1382
8,Barcelona,146,Olesa de Bonesvalls,1383,717,666
8,Barcelona,147,Olesa de Montserrat,21114,10699,10415
8,Barcelona,148,Olivella,2179,1163,1016
8,Barcelona,149,Olost,1193,593,600
8,Barcelona,144,Olvan,897,437,460
8,Barcelona,150,Orís,278,139,139
8,Barcelona,151,Oristà,601,291,310
8,Barcelona,152,Orpí,184,99,85
8,Barcelona,153,Òrrius,315,163,152
8,Barcelona,154,Pacs del Penedès,745,374,371
8,Barcelona,155,Palafolls,7098,3561,3537
8,Barcelona,156,Palau-solità i Plegamans,12836,6537,6299
8,Barcelona,157,Pallejà,10192,5178,5014
8,Barcelona,905,Palma de Cervelló (La),2923,1469,1454
8,Barcelona,158,Papiol (El),3686,1863,1823
8,Barcelona,159,Parets del Vallès,16202,8265,7937
8,Barcelona,160,Perafita,378,184,194
8,Barcelona,161,Piera,12230,6289,5941
8,Barcelona,163,Pineda de Mar,24702,12601,12101
8,Barcelona,164,Pla del Penedès (El),906,468,438
8,Barcelona,165,Pobla de Claramunt (La),2060,1077,983
8,Barcelona,166,Pobla de Lillet (La),1348,654,694
8,Barcelona,167,Polinyà,6428,3290,3138
8,Barcelona,182,Pont de Vilomara i Rocafort (El),3154,1615,1539
8,Barcelona,168,Pontons,482,260,222
8,Barcelona,169,Prat de Llobregat (El),63190,31672,31518
8,Barcelona,171,Prats de Lluçanès,2691,1352,1339
8,Barcelona,170,Prats de Rei (Els),537,273,264
8,Barcelona,230,Premià de Dalt,9768,4869,4899
8,Barcelona,172,Premià de Mar,27653,13843,13810
8,Barcelona,174,Puigdàlber,388,186,202
8,Barcelona,175,Puig-reig,4197,2042,2155
8,Barcelona,176,Pujalt,199,102,97
8,Barcelona,177,Quar (La),68,39,29
8,Barcelona,178,Rajadell,451,240,211
8,Barcelona,179,Rellinars,605,312,293
8,Barcelona,180,Ripollet,34735,17600,17135
8,Barcelona,181,Roca del Vallès (La),8946,4513,4433
8,Barcelona,183,Roda de Ter,5450,2651,2799
8,Barcelona,184,Rubí,68102,34368,33734
8,Barcelona,185,Rubió,135,76,59
8,Barcelona,901,Rupit i Pruit,345,171,174
8,Barcelona,187,Sabadell,196971,96418,100553
8,Barcelona,188,Sagàs,140,71,69
8,Barcelona,190,Saldes,346,196,150
8,Barcelona,191,Sallent,7088,3405,3683
8,Barcelona,194,Sant Adrià de Besòs,32940,16247,16693
8,Barcelona,195,Sant Agustí de Lluçanès,111,58,53
8,Barcelona,196,Sant Andreu de la Barca,24863,12806,12057
8,Barcelona,197,Sant Andreu de Llavaneres,9180,4716,4464
8,Barcelona,198,Sant Antoni de Vilamajor,4627,2339,2288
8,Barcelona,199,Sant Bartomeu del Grau,1032,539,493
8,Barcelona,200,Sant Boi de Llobregat,81181,40415,40766
8,Barcelona,201,Sant Boi de Lluçanès,569,291,278
8,Barcelona,203,Sant Cebrià de Vallalta,2575,1387,1188
8,Barcelona,202,Sant Celoni,15081,7577,7504
8,Barcelona,204,Sant Climent de Llobregat,3443,1729,1714
8,Barcelona,205,Sant Cugat del Vallès,70514,34660,35854
8,Barcelona,206,Sant Cugat Sesgarrigues,871,459,412
8,Barcelona,207,Sant Esteve de Palautordera,1961,970,991
8,Barcelona,208,Sant Esteve Sesrovires,6310,3252,3058
8,Barcelona,210,Sant Feliu de Codines,5282,2741,2541
8,Barcelona,211,Sant Feliu de Llobregat,42267,20821,21446
8,Barcelona,212,Sant Feliu Sasserra,638,320,318
8,Barcelona,209,Sant Fost de Campsentelles,7265,3702,3563
8,Barcelona,213,Sant Fruitós de Bages,6839,3495,3344
8,Barcelona,215,Sant Hipòlit de Voltregà,3222,1615,1607
8,Barcelona,193,Sant Iscle de Vallalta,1095,571,524
8,Barcelona,216,Sant Jaume de Frontanyà,28,14,14
8,Barcelona,218,Sant Joan de Vilatorrada,10064,5079,4985
8,Barcelona,217,Sant Joan Despí,31162,15401,15761
8,Barcelona,903,Sant Julià de Cerdanyola,258,138,120
8,Barcelona,220,Sant Julià de Vilatorta,2729,1339,1390
8,Barcelona,221,Sant Just Desvern,15282,7274,8008
8,Barcelona,222,Sant Llorenç d'Hortons,2022,1021,1001
8,Barcelona,223,Sant Llorenç Savall,2229,1126,1103
8,Barcelona,225,Sant Martí d'Albars,116,60,56
8,Barcelona,224,Sant Martí de Centelles,898,465,433
8,Barcelona,226,Sant Martí de Tous,1093,556,537
8,Barcelona,227,Sant Martí Sarroca,2721,1391,1330
8,Barcelona,228,Sant Martí Sesgueioles,340,174,166
8,Barcelona,229,Sant Mateu de Bages,665,339,326
8,Barcelona,231,Sant Pere de Ribes,26108,13238,12870
8,Barcelona,232,Sant Pere de Riudebitlles,2176,1097,1079
8,Barcelona,233,Sant Pere de Torelló,2265,1126,1139
8,Barcelona,234,Sant Pere de Vilamajor,3444,1760,1684
8,Barcelona,189,Sant Pere Sallavinera,163,83,80
8,Barcelona,235,Sant Pol de Mar,4597,2365,2232
8,Barcelona,236,Sant Quintí de Mediona,1998,1052,946
8,Barcelona,237,Sant Quirze de Besora,2007,992,1015
8,Barcelona,238,Sant Quirze del Vallès,16581,8213,8368
8,Barcelona,239,Sant Quirze Safaja,543,288,255
8,Barcelona,240,Sant Sadurní d'Anoia,11359,5645,5714
8,Barcelona,241,Sant Sadurní d'Osormort,82,47,35
8,Barcelona,98,Sant Salvador de Guardiola,2753,1416,1337
8,Barcelona,262,Sant Vicenç de Castellet,7737,3763,3974
8,Barcelona,264,Sant Vicenç de Montalt,4771,2442,2329
8,Barcelona,265,Sant Vicenç de Torelló,1927,932,995
8,Barcelona,263,Sant Vicenç dels Horts,26676,13435,13241
8,Barcelona,243,Santa Cecília de Voltregà,206,113,93
8,Barcelona,244,Santa Coloma de Cervelló,6964,3497,3467
8,Barcelona,245,Santa Coloma de Gramenet,118129,59720,58409
8,Barcelona,246,Santa Eugènia de Berga,2046,1066,980
8,Barcelona,247,Santa Eulàlia de Riuprimer,885,449,436
8,Barcelona,248,Santa Eulàlia de Ronçana,5814,2933,2881
8,Barcelona,249,Santa Fe del Penedès,338,174,164
8,Barcelona,250,Santa Margarida de Montbui,9485,4774,4711
8,Barcelona,251,Santa Margarida i els Monjos,5933,3108,2825
8,Barcelona,253,Santa Maria de Besora,187,95,92
8,Barcelona,254,Santa Maria de Corcó,2200,1082,1118
8,Barcelona,256,Santa Maria de Martorelles,763,392,371
8,Barcelona,255,Santa Maria de Merlès,151,80,71
8,Barcelona,257,Santa Maria de Miralles,123,60,63
8,Barcelona,259,Santa Maria de Palautordera,7762,4018,3744
8,Barcelona,258,Santa Maria d'Oló,1044,524,520
8,Barcelona,260,Santa Perpètua de Mogoda,21409,10873,10536
8,Barcelona,261,Santa Susanna,2868,1468,1400
8,Barcelona,192,Santpedor,6037,3025,3012
8,Barcelona,267,Sentmenat,6988,3512,3476
8,Barcelona,269,Seva,2956,1517,1439
8,Barcelona,270,Sitges,24470,12030,12440
8,Barcelona,271,Sobremunt,92,44,48
8,Barcelona,272,Sora,213,107,106
8,Barcelona,273,Subirats,2820,1411,1409
8,Barcelona,274,Súria,6202,3040,3162
8,Barcelona,276,Tagamanent,265,140,125
8,Barcelona,277,Talamanca,117,61,56
8,Barcelona,278,Taradell,5613,2877,2736
8,Barcelona,275,Tavèrnoles,301,152,149
8,Barcelona,280,Tavertet,151,84,67
8,Barcelona,281,Teià,5835,2957,2878
8,Barcelona,279,Terrassa,194947,96960,97987
8,Barcelona,282,Tiana,7079,3483,3596
8,Barcelona,283,Tona,7030,3565,3465
8,Barcelona,284,Tordera,12597,6415,6182
8,Barcelona,285,Torelló,13008,6452,6556
8,Barcelona,286,Torre de Claramunt (La),3063,1591,1472
8,Barcelona,287,Torrelavit,1209,647,562
8,Barcelona,288,Torrelles de Foix,2175,1181,994
8,Barcelona,289,Torrelles de Llobregat,4604,2329,2275
8,Barcelona,290,Ullastrell,1450,751,699
8,Barcelona,291,Vacarisses,4592,2379,2213
8,Barcelona,292,Vallbona d'Anoia,1254,642,612
8,Barcelona,293,Vallcebre,284,151,133
8,Barcelona,294,Vallgorguina,1881,968,913
8,Barcelona,295,Vallirana,12339,6225,6114
8,Barcelona,296,Vallromanes,1911,982,929
8,Barcelona,297,Veciana,159,84,75
8,Barcelona,298,Vic,37825,19197,18628
8,Barcelona,299,Vilada,507,252,255
8,Barcelona,301,Viladecans,61043,30763,30280
8,Barcelona,300,Viladecavalls,6890,3482,3408
8,Barcelona,305,Vilafranca del Penedès,35864,17968,17896
8,Barcelona,306,Vilalba Sasserra,564,286,278
8,Barcelona,303,Vilanova de Sau,330,153,177
8,Barcelona,302,Vilanova del Camí,11555,5861,5694
8,Barcelona,902,Vilanova del Vallès,3282,1679,1603
8,Barcelona,307,Vilanova i la Geltrú,61427,30333,31094
8,Barcelona,214,Vilassar de Dalt,8011,3992,4019
8,Barcelona,219,Vilassar de Mar,18900,9269,9631
8,Barcelona,304,Vilobí del Penedès,1013,520,493
8,Barcelona,308,Viver i Serrateix,193,100,93
9,Burgos,1,Abajas,39,21,18
9,Burgos,3,Adrada de Haza,257,136,121
9,Burgos,6,Aguas Cándidas,90,52,38
9,Burgos,7,Aguilar de Bureba,69,37,32
9,Burgos,9,Albillos,214,120,94
9,Burgos,10,Alcocero de Mola,49,31,18
9,Burgos,11,Alfoz de Bricia,115,63,52
9,Burgos,907,Alfoz de Quintanadueñas,1412,773,639
9,Burgos,12,Alfoz de Santa Gadea,123,64,59
9,Burgos,13,Altable,58,35,23
9,Burgos,14,Altos (Los),208,118,90
9,Burgos,16,Ameyugo,90,49,41
9,Burgos,17,Anguix,158,87,71
9,Burgos,18,Aranda de Duero,31247,15605,15642
9,Burgos,19,Arandilla,188,113,75
9,Burgos,20,Arauzo de Miel,341,190,151
9,Burgos,21,Arauzo de Salce,76,41,35
9,Burgos,22,Arauzo de Torre,103,57,46
9,Burgos,23,Arcos,600,324,276
9,Burgos,24,Arenillas de Riopisuerga,208,115,93
9,Burgos,25,Arija,199,102,97
9,Burgos,26,Arlanzón,429,242,187
9,Burgos,27,Arraya de Oca,52,27,25
9,Burgos,29,Atapuerca,195,101,94
9,Burgos,30,Ausines (Los),138,78,60
9,Burgos,32,Avellanosa de Muñó,143,77,66
9,Burgos,33,Bahabón de Esgueva,122,71,51
9,Burgos,34,Balbases (Los),354,191,163
9,Burgos,35,Baños de Valdearados,424,241,183
9,Burgos,36,Bañuelos de Bureba,38,23,15
9,Burgos,37,Barbadillo de Herreros,137,81,56
9,Burgos,38,Barbadillo del Mercado,172,90,82
9,Burgos,39,Barbadillo del Pez,95,56,39
9,Burgos,41,Barrio de Muñó,30,17,13
9,Burgos,43,Barrios de Bureba (Los),236,130,106
9,Burgos,44,Barrios de Colina,71,36,35
9,Burgos,45,Basconcillos del Tozo,381,209,172
9,Burgos,46,Bascuñana,53,31,22
9,Burgos,47,Belbimbre,80,45,35
9,Burgos,48,Belorado,2150,1093,1057
9,Burgos,50,Berberana,81,42,39
9,Burgos,51,Berlangas de Roa,225,118,107
9,Burgos,52,Berzosa de Bureba,43,27,16
9,Burgos,54,Bozoó,110,56,54
9,Burgos,55,Brazacorta,86,45,41
9,Burgos,56,Briviesca,6926,3482,3444
9,Burgos,57,Bugedo,155,107,48
9,Burgos,58,Buniel,300,163,137
9,Burgos,59,Burgos,172421,83098,89323
9,Burgos,60,Busto de Bureba,200,109,91
9,Burgos,61,Cabañes de Esgueva,233,123,110
9,Burgos,62,Cabezón de la Sierra,58,26,32
9,Burgos,64,Caleruega,489,247,242
9,Burgos,65,Campillo de Aranda,197,104,93
9,Burgos,66,Campolara,82,50,32
9,Burgos,67,Canicosa de la Sierra,565,298,267
9,Burgos,68,Cantabrana,38,23,15
9,Burgos,70,Carazo,49,30,19
9,Burgos,71,Carcedo de Bureba,43,21,22
9,Burgos,72,Carcedo de Burgos,237,141,96
9,Burgos,73,Cardeñadijo,694,377,317
9,Burgos,74,Cardeñajimeno,624,334,290
9,Burgos,75,Cardeñuela Riopico,103,62,41
9,Burgos,76,Carrias,41,29,12
9,Burgos,77,Cascajares de Bureba,55,29,26
9,Burgos,78,Cascajares de la Sierra,32,14,18
9,Burgos,79,Castellanos de Castro,61,36,25
9,Burgos,83,Castil de Peones,26,15,11
9,Burgos,82,Castildelgado,69,36,33
9,Burgos,84,Castrillo de la Reina,257,161,96
9,Burgos,85,Castrillo de la Vega,638,348,290
9,Burgos,88,Castrillo de Riopisuerga,85,50,35
9,Burgos,86,Castrillo del Val,553,319,234
9,Burgos,90,Castrillo Matajudíos,72,35,37
9,Burgos,91,Castrojeriz,929,473,456
9,Burgos,63,Cavia,259,142,117
9,Burgos,93,Cayuela,126,71,55
9,Burgos,94,Cebrecos,64,36,28
9,Burgos,95,Celada del Camino,100,50,50
9,Burgos,98,Cerezo de Río Tirón,704,380,324
9,Burgos,100,Cerratón de Juarros,63,40,23
9,Burgos,101,Ciadoncha,93,57,36
9,Burgos,102,Cillaperlata,41,26,15
9,Burgos,103,Cilleruelo de Abajo,290,161,129
9,Burgos,104,Cilleruelo de Arriba,74,38,36
9,Burgos,105,Ciruelos de Cervera,143,81,62
9,Burgos,108,Cogollos,378,207,171
9,Burgos,109,Condado de Treviño,1333,744,589
9,Burgos,110,Contreras,102,62,40
9,Burgos,112,Coruña del Conde,158,90,68
9,Burgos,113,Covarrubias,632,333,299
9,Burgos,114,Cubillo del Campo,79,38,41
9,Burgos,115,Cubo de Bureba,116,66,50
9,Burgos,117,Cueva de Roa (La),103,54,49
9,Burgos,119,Cuevas de San Clemente,57,29,28
9,Burgos,120,Encío,48,28,20
9,Burgos,122,Espinosa de Cervera,101,58,43
9,Burgos,124,Espinosa de los Monteros,1974,1018,956
9,Burgos,123,Espinosa del Camino,35,21,14
9,Burgos,125,Estépar,777,432,345
9,Burgos,127,Fontioso,69,36,33
9,Burgos,128,Frandovínez,125,72,53
9,Burgos,129,Fresneda de la Sierra Tirón,118,69,49
9,Burgos,130,Fresneña,108,56,52
9,Burgos,131,Fresnillo de las Dueñas,381,205,176
9,Burgos,132,Fresno de Río Tirón,220,124,96
9,Burgos,133,Fresno de Rodilla,41,26,15
9,Burgos,134,Frías,298,154,144
9,Burgos,135,Fuentebureba,70,33,37
9,Burgos,136,Fuentecén,280,152,128
9,Burgos,137,Fuentelcésped,190,95,95
9,Burgos,138,Fuentelisendo,104,59,45
9,Burgos,139,Fuentemolinos,112,64,48
9,Burgos,140,Fuentenebro,170,97,73
9,Burgos,141,Fuentespina,666,353,313
9,Burgos,143,Galbarros,33,22,11
9,Burgos,144,Gallega (La),83,46,37
9,Burgos,148,Grijalba,130,64,66
9,Burgos,149,Grisaleña,48,31,17
9,Burgos,151,Gumiel de Izán,657,376,281
9,Burgos,152,Gumiel de Mercado,387,221,166
9,Burgos,154,Hacinas,184,102,82
9,Burgos,155,Haza,33,21,12
9,Burgos,159,Hontanas,70,41,29
9,Burgos,160,Hontangas,129,83,46
9,Burgos,162,Hontoria de la Cantera,142,75,67
9,Burgos,164,Hontoria de Valdearados,238,146,92
9,Burgos,163,Hontoria del Pinar,837,449,388
9,Burgos,166,Hormazas (Las),127,69,58
9,Burgos,167,Hornillos del Camino,66,36,30
9,Burgos,168,Horra (La),416,216,200
9,Burgos,169,Hortigüela,121,69,52
9,Burgos,170,Hoyales de Roa,261,126,135
9,Burgos,172,Huérmeces,128,71,57
9,Burgos,173,Huerta de Arriba,161,90,71
9,Burgos,174,Huerta de Rey,1204,632,572
9,Burgos,175,Humada,174,105,69
9,Burgos,176,Hurones,68,43,25
9,Burgos,177,Ibeas de Juarros,1233,668,565
9,Burgos,178,Ibrillos,88,49,39
9,Burgos,179,Iglesiarrubia,56,32,24
9,Burgos,180,Iglesias,163,91,72
9,Burgos,181,Isar,376,171,205
9,Burgos,182,Itero del Castillo,107,56,51
9,Burgos,183,Jaramillo de la Fuente,39,22,17
9,Burgos,184,Jaramillo Quemado,13,8,5
9,Burgos,189,Junta de Traslaloma,196,106,90
9,Burgos,190,Junta de Villalba de Losa,126,63,63
9,Burgos,191,Jurisdicción de Lara,59,34,25
9,Burgos,192,Jurisdicción de San Zadornil,96,42,54
9,Burgos,194,Lerma,2744,1322,1422
9,Burgos,195,Llano de Bureba,70,40,30
9,Burgos,196,Madrigal del Monte,202,113,89
9,Burgos,197,Madrigalejo del Monte,202,117,85
9,Burgos,198,Mahamud,157,82,75
9,Burgos,199,Mambrilla de Castrejón,141,74,67
9,Burgos,200,Mambrillas de Lara,68,35,33
9,Burgos,201,Mamolar,60,33,27
9,Burgos,202,Manciles,34,19,15
9,Burgos,206,Mazuela,77,42,35
9,Burgos,208,Mecerreyes,300,162,138
9,Burgos,209,Medina de Pomar,5483,2839,2644
9,Burgos,211,Melgar de Fernamental,1906,1002,904
9,Burgos,213,Merindad de Cuesta-Urria,493,272,221
9,Burgos,214,Merindad de Montija,850,476,374
9,Burgos,906,Merindad de Río Ubierna,1369,729,640
9,Burgos,215,Merindad de Sotoscueva,505,288,217
9,Burgos,216,Merindad de Valdeporres,477,245,232
9,Burgos,217,Merindad de Valdivielso,474,262,212
9,Burgos,218,Milagros,476,257,219
9,Burgos,219,Miranda de Ebro,37664,18751,18913
9,Burgos,220,Miraveche,106,64,42
9,Burgos,221,Modúbar de la Emparedada,372,211,161
9,Burgos,223,Monasterio de la Sierra,45,28,17
9,Burgos,224,Monasterio de Rodilla,220,126,94
9,Burgos,225,Moncalvillo,105,66,39
9,Burgos,226,Monterrubio de la Demanda,95,51,44
9,Burgos,227,Montorio,167,88,79
9,Burgos,228,Moradillo de Roa,212,120,92
9,Burgos,229,Nava de Roa,247,129,118
9,Burgos,230,Navas de Bureba,46,23,23
9,Burgos,231,Nebreda,93,57,36
9,Burgos,232,Neila,236,125,111
9,Burgos,235,Olmedillo de Roa,187,98,89
9,Burgos,236,Olmillos de Muñó,39,24,15
9,Burgos,238,Oña,1452,741,711
9,Burgos,239,Oquillas,75,41,34
9,Burgos,241,Orbaneja Riopico,179,105,74
9,Burgos,242,Padilla de Abajo,101,60,41
9,Burgos,243,Padilla de Arriba,106,61,45
9,Burgos,244,Padrones de Bureba,55,33,22
9,Burgos,246,Palacios de la Sierra,861,444,417
9,Burgos,247,Palacios de Riopisuerga,30,16,14
9,Burgos,248,Palazuelos de la Sierra,69,40,29
9,Burgos,249,Palazuelos de Muñó,66,40,26
9,Burgos,250,Pampliega,395,206,189
9,Burgos,251,Pancorbo,464,244,220
9,Burgos,253,Pardilla,134,71,63
9,Burgos,255,Partido de la Sierra en Tobalina,80,50,30
9,Burgos,256,Pedrosa de Duero,520,292,228
9,Burgos,259,Pedrosa de Río Úrbel,255,154,101
9,Burgos,257,Pedrosa del Páramo,100,53,47
9,Burgos,258,Pedrosa del Príncipe,208,106,102
9,Burgos,261,Peñaranda de Duero,568,305,263
9,Burgos,262,Peral de Arlanza,216,113,103
9,Burgos,265,Piérnigas,34,24,10
9,Burgos,266,Pineda de la Sierra,126,69,57
9,Burgos,267,Pineda Trasmonte,154,87,67
9,Burgos,268,Pinilla de los Barruecos,126,72,54
9,Burgos,269,Pinilla de los Moros,41,29,12
9,Burgos,270,Pinilla Trasmonte,208,115,93
9,Burgos,272,Poza de la Sal,374,184,190
9,Burgos,273,Prádanos de Bureba,54,34,20
9,Burgos,274,Pradoluengo,1607,812,795
9,Burgos,275,Presencio,250,140,110
9,Burgos,276,Puebla de Arganzón (La),467,258,209
9,Burgos,277,Puentedura,132,82,50
9,Burgos,279,Quemada,260,153,107
9,Burgos,281,Quintana del Pidio,175,95,80
9,Burgos,280,Quintanabureba,35,20,15
9,Burgos,283,Quintanaélez,77,36,41
9,Burgos,287,Quintanaortuño,191,106,85
9,Burgos,288,Quintanapalla,119,67,52
9,Burgos,289,Quintanar de la Sierra,1984,1024,960
9,Burgos,292,Quintanavides,106,56,50
9,Burgos,294,Quintanilla de la Mata,150,81,69
9,Burgos,901,Quintanilla del Agua y Tordueles,590,327,263
9,Burgos,295,Quintanilla del Coco,102,55,47
9,Burgos,298,Quintanilla San García,94,51,43
9,Burgos,301,Quintanilla Vivar,612,314,298
9,Burgos,297,Quintanillas (Las),375,207,168
9,Burgos,302,Rabanera del Pinar,143,78,65
9,Burgos,303,Rábanos,101,59,42
9,Burgos,304,Rabé de las Calzadas,163,83,80
9,Burgos,306,Rebolledo de la Torre,168,95,73
9,Burgos,307,Redecilla del Camino,146,80,66
9,Burgos,308,Redecilla del Campo,78,44,34
9,Burgos,309,Regumiel de la Sierra,450,223,227
9,Burgos,310,Reinoso,20,12,8
9,Burgos,311,Retuerta,73,43,30
9,Burgos,314,Revilla del Campo,129,70,59
9,Burgos,316,Revilla Vallejera,108,66,42
9,Burgos,312,Revilla y Ahedo (La),124,76,48
9,Burgos,315,Revillarruz,211,107,104
9,Burgos,317,Rezmondo,25,10,15
9,Burgos,318,Riocavado de la Sierra,66,38,28
9,Burgos,321,Roa,2334,1216,1118
9,Burgos,323,Rojas,87,52,35
9,Burgos,325,Royuela de Río Franco,271,156,115
9,Burgos,326,Rubena,186,100,86
9,Burgos,327,Rublacedo de Abajo,38,21,17
9,Burgos,328,Rucandio,87,46,41
9,Burgos,329,Salas de Bureba,143,84,59
9,Burgos,330,Salas de los Infantes,2071,1059,1012
9,Burgos,332,Saldaña de Burgos,138,77,61
9,Burgos,334,Salinillas de Bureba,49,30,19
9,Burgos,335,San Adrián de Juarros,45,26,19
9,Burgos,337,San Juan del Monte,160,85,75
9,Burgos,338,San Mamés de Burgos,277,152,125
9,Burgos,339,San Martín de Rubiales,231,129,102
9,Burgos,340,San Millán de Lara,80,56,24
9,Burgos,360,San Vicente del Valle,47,27,20
9,Burgos,343,Santa Cecilia,110,64,46
9,Burgos,345,Santa Cruz de la Salceda,181,106,75
9,Burgos,346,Santa Cruz del Valle Urbión,109,63,46
9,Burgos,347,Santa Gadea del Cid,179,96,83
9,Burgos,348,Santa Inés,178,98,80
9,Burgos,350,Santa María del Campo,697,376,321
9,Burgos,351,Santa María del Invierno,64,43,21
9,Burgos,352,Santa María del Mercadillo,161,91,70
9,Burgos,353,Santa María Rivarredonda,111,58,53
9,Burgos,354,Santa Olalla de Bureba,40,9,31
9,Burgos,355,Santibáñez de Esgueva,140,68,72
9,Burgos,356,Santibáñez del Val,65,41,24
9,Burgos,358,Santo Domingo de Silos,311,195,116
9,Burgos,361,Sargentes de la Lora,185,102,83
9,Burgos,362,Sarracín,282,152,130
9,Burgos,363,Sasamón,1315,730,585
9,Burgos,365,Sequera de Haza (La),53,33,20
9,Burgos,366,Solarana,108,61,47
9,Burgos,368,Sordillos,30,18,12
9,Burgos,369,Sotillo de la Ribera,604,338,266
9,Burgos,372,Sotragero,204,106,98
9,Burgos,373,Sotresgudo,629,349,280
9,Burgos,374,Susinos del Páramo,118,58,60
9,Burgos,375,Tamarón,43,29,14
9,Burgos,377,Tardajos,730,410,320
9,Burgos,378,Tejada,41,25,16
9,Burgos,380,Terradillos de Esgueva,123,59,64
9,Burgos,381,Tinieblas de la Sierra,46,23,23
9,Burgos,382,Tobar,43,25,18
9,Burgos,384,Tordómar,340,196,144
9,Burgos,386,Torrecilla del Monte,77,40,37
9,Burgos,387,Torregalindo,140,80,60
9,Burgos,388,Torrelara,26,14,12
9,Burgos,389,Torrepadre,88,56,32
9,Burgos,390,Torresandino,799,428,371
9,Burgos,391,Tórtoles de Esgueva,520,286,234
9,Burgos,392,Tosantos,62,34,28
9,Burgos,394,Trespaderne,1053,545,508
9,Burgos,395,Tubilla del Agua,206,126,80
9,Burgos,396,Tubilla del Lago,170,97,73
9,Burgos,398,Úrbel del Castillo,92,58,34
9,Burgos,400,Vadocondes,428,224,204
9,Burgos,403,Valdeande,132,81,51
9,Burgos,405,Valdezate,180,92,88
9,Burgos,406,Valdorros,172,100,72
9,Burgos,408,Vallarta de Bureba,60,35,25
9,Burgos,904,Valle de las Navas,608,339,269
9,Burgos,908,Valle de Losa,611,352,259
9,Burgos,409,Valle de Manzanedo,130,70,60
9,Burgos,410,Valle de Mena,3515,1804,1711
9,Burgos,411,Valle de Oca,212,111,101
9,Burgos,902,Valle de Santibáñez,579,306,273
9,Burgos,905,Valle de Sedano,506,281,225
9,Burgos,412,Valle de Tobalina,1046,571,475
9,Burgos,413,Valle de Valdebezana,654,361,293
9,Burgos,414,Valle de Valdelaguna,207,123,84
9,Burgos,415,Valle de Valdelucio,366,199,167
9,Burgos,416,Valle de Zamanzas,78,43,35
9,Burgos,417,Vallejera,52,32,20
9,Burgos,418,Valles de Palenzuela,101,53,48
9,Burgos,419,Valluércanes,97,57,40
9,Burgos,407,Valmala,35,18,17
9,Burgos,422,Vid de Bureba (La),30,12,18
9,Burgos,421,Vid y Barrios (La),315,181,134
9,Burgos,423,Vileña,30,20,10
9,Burgos,427,Villadiego,1868,1014,854
9,Burgos,428,Villaescusa de Roa,172,96,76
9,Burgos,429,Villaescusa la Sombría,65,42,23
9,Burgos,430,Villaespasa,21,11,10
9,Burgos,431,Villafranca Montes de Oca,164,90,74
9,Burgos,432,Villafruela,243,140,103
9,Burgos,433,Villagalijo,85,53,32
9,Burgos,434,Villagonzalo Pedernales,1122,584,538
9,Burgos,437,Villahoz,339,175,164
9,Burgos,438,Villalba de Duero,622,330,292
9,Burgos,439,Villalbilla de Burgos,827,457,370
9,Burgos,440,Villalbilla de Gumiel,114,70,44
9,Burgos,441,Villaldemiro,70,40,30
9,Burgos,442,Villalmanzo,457,245,212
9,Burgos,443,Villamayor de los Montes,216,107,109
9,Burgos,444,Villamayor de Treviño,97,53,44
9,Burgos,445,Villambistia,61,32,29
9,Burgos,446,Villamedianilla,25,13,12
9,Burgos,447,Villamiel de la Sierra,38,21,17
9,Burgos,448,Villangómez,308,183,125
9,Burgos,449,Villanueva de Argaño,120,71,49
9,Burgos,450,Villanueva de Carazo,25,16,9
9,Burgos,451,Villanueva de Gumiel,281,147,134
9,Burgos,454,Villanueva de Teba,57,35,22
9,Burgos,455,Villaquirán de la Puebla,54,29,25
9,Burgos,456,Villaquirán de los Infantes,180,92,88
9,Burgos,903,Villarcayo de Merindad de Castilla la Vieja,4178,2145,2033
9,Burgos,458,Villariezo,385,217,168
9,Burgos,460,Villasandino,223,124,99
9,Burgos,463,Villasur de Herreros,316,172,144
9,Burgos,464,Villatuelda,62,36,26
9,Burgos,466,Villaverde del Monte,174,99,75
9,Burgos,467,Villaverde-Mogina,106,65,41
9,Burgos,471,Villayerno Morquillas,195,99,96
9,Burgos,472,Villazopeque,76,45,31
9,Burgos,473,Villegas,110,62,48
9,Burgos,476,Villoruebo,61,38,23
9,Burgos,424,Viloria de Rioja,60,35,25
9,Burgos,425,Vilviestre del Pinar,742,394,348
9,Burgos,478,Vizcaínos,51,30,21
9,Burgos,480,Zael,133,70,63
9,Burgos,482,Zarzosa de Río Pisuerga,50,28,22
9,Burgos,483,Zazuar,267,142,125
9,Burgos,485,Zuñeda,64,36,28
10,Cáceres,1,Abadía,277,157,120
10,Cáceres,2,Abertura,505,263,242
10,Cáceres,3,Acebo,719,386,333
10,Cáceres,4,Acehúche,871,433,438
10,Cáceres,5,Aceituna,632,330,302
10,Cáceres,6,Ahigal,1580,825,755
10,Cáceres,7,Albalá,860,432,428
10,Cáceres,8,Alcántara,1721,851,870
10,Cáceres,9,Alcollarín,308,153,155
10,Cáceres,10,Alcuéscar,3016,1575,1441
10,Cáceres,12,Aldea del Cano,742,353,389
10,Cáceres,13,Aldea del Obispo (La),375,195,180
10,Cáceres,11,Aldeacentenera,840,434,406
10,Cáceres,14,Aldeanueva de la Vera,2346,1153,1193
10,Cáceres,15,Aldeanueva del Camino,837,410,427
10,Cáceres,16,Aldehuela de Jerte,348,197,151
10,Cáceres,17,Alía,1163,590,573
10,Cáceres,18,Aliseda,1909,957,952
10,Cáceres,19,Almaraz,1295,665,630
10,Cáceres,20,Almoharín,2050,1032,1018
10,Cáceres,21,Arroyo de la Luz,6607,3283,3324
10,Cáceres,23,Arroyomolinos,940,484,456
10,Cáceres,22,Arroyomolinos de la Vera,545,273,272
10,Cáceres,24,Baños de Montemayor,702,327,375
10,Cáceres,25,Barrado,507,259,248
10,Cáceres,26,Belvís de Monroy,601,298,303
10,Cáceres,27,Benquerencia,101,57,44
10,Cáceres,28,Berrocalejo,115,54,61
10,Cáceres,29,Berzocana,497,255,242
10,Cáceres,30,Bohonal de Ibor,556,294,262
10,Cáceres,31,Botija,148,66,82
10,Cáceres,32,Brozas,2226,1107,1119
10,Cáceres,33,Cabañas del Castillo,497,255,242
10,Cáceres,34,Cabezabellosa,449,220,229
10,Cáceres,35,Cabezuela del Valle,2173,1129,1044
10,Cáceres,36,Cabrero,372,200,172
10,Cáceres,37,Cáceres,89029,42801,46228
10,Cáceres,38,Cachorrilla,87,43,44
10,Cáceres,39,Cadalso,552,285,267
10,Cáceres,40,Calzadilla,492,252,240
10,Cáceres,41,Caminomorisco,1292,679,613
10,Cáceres,42,Campillo de Deleitosa,110,50,60
10,Cáceres,43,Campo Lugar,1133,571,562
10,Cáceres,44,Cañamero,1630,839,791
10,Cáceres,45,Cañaveral,1304,633,671
10,Cáceres,46,Carbajo,251,130,121
10,Cáceres,47,Carcaboso,1012,569,443
10,Cáceres,48,Carrascalejo,360,185,175
10,Cáceres,49,Casar de Cáceres,4707,2346,2361
10,Cáceres,50,Casar de Palomero,1276,656,620
10,Cáceres,51,Casares de las Hurdes,592,290,302
10,Cáceres,52,Casas de Don Antonio,225,103,122
10,Cáceres,53,Casas de Don Gómez,343,177,166
10,Cáceres,56,Casas de Millán,720,362,358
10,Cáceres,57,Casas de Miravete,185,104,81
10,Cáceres,54,Casas del Castañar,652,329,323
10,Cáceres,55,Casas del Monte,880,460,420
10,Cáceres,58,Casatejada,1324,690,634
10,Cáceres,59,Casillas de Coria,484,228,256
10,Cáceres,60,Castañar de Ibor,1182,608,574
10,Cáceres,61,Ceclavín,2115,1047,1068
10,Cáceres,62,Cedillo,552,283,269
10,Cáceres,63,Cerezo,198,91,107
10,Cáceres,64,Cilleros,1994,1019,975
10,Cáceres,65,Collado,229,120,109
10,Cáceres,66,Conquista de la Sierra,225,120,105
10,Cáceres,67,Coria,12947,6526,6421
10,Cáceres,68,Cuacos de Yuste,963,506,457
10,Cáceres,69,Cumbre (La),1026,515,511
10,Cáceres,70,Deleitosa,833,427,406
10,Cáceres,71,Descargamaría,255,143,112
10,Cáceres,72,Eljas,1117,569,548
10,Cáceres,73,Escurial,904,461,443
10,Cáceres,75,Fresnedoso de Ibor,343,169,174
10,Cáceres,76,Galisteo,1996,1003,993
10,Cáceres,77,Garciaz,923,473,450
10,Cáceres,78,Garganta (La),546,299,247
10,Cáceres,79,Garganta la Olla,1152,607,545
10,Cáceres,80,Gargantilla,449,231,218
10,Cáceres,81,Gargüera,163,85,78
10,Cáceres,82,Garrovillas de Alconétar,2372,1161,1211
10,Cáceres,83,Garvín,108,59,49
10,Cáceres,84,Gata,1753,891,862
10,Cáceres,85,Gordo (El),300,139,161
10,Cáceres,86,Granja (La),342,191,151
10,Cáceres,87,Guadalupe,2227,1103,1124
10,Cáceres,88,Guijo de Coria,249,130,119
10,Cáceres,89,Guijo de Galisteo,1511,821,690
10,Cáceres,90,Guijo de Granadilla,655,325,330
10,Cáceres,91,Guijo de Santa Bárbara,429,220,209
10,Cáceres,92,Herguijuela,364,188,176
10,Cáceres,93,Hernán-Pérez,515,267,248
10,Cáceres,94,Herrera de Alcántara,279,146,133
10,Cáceres,95,Herreruela,400,201,199
10,Cáceres,96,Hervás,3891,1907,1984
10,Cáceres,97,Higuera,93,50,43
10,Cáceres,98,Hinojal,431,213,218
10,Cáceres,99,Holguera,766,383,383
10,Cáceres,100,Hoyos,988,500,488
10,Cáceres,101,Huélaga,191,89,102
10,Cáceres,102,Ibahernando,591,288,303
10,Cáceres,103,Jaraicejo,616,300,316
10,Cáceres,104,Jaraíz de la Vera,6833,3506,3327
10,Cáceres,105,Jarandilla de la Vera,3080,1534,1546
10,Cáceres,106,Jarilla,151,75,76
10,Cáceres,107,Jerte,1313,662,651
10,Cáceres,108,Ladrillar,265,142,123
10,Cáceres,109,Logrosán,2219,1142,1077
10,Cáceres,110,Losar de la Vera,3144,1649,1495
10,Cáceres,111,Madrigal de la Vera,1734,909,825
10,Cáceres,112,Madrigalejo,2077,1045,1032
10,Cáceres,113,Madroñera,2952,1469,1483
10,Cáceres,114,Majadas,1328,695,633
10,Cáceres,115,Malpartida de Cáceres,4381,2234,2147
10,Cáceres,116,Malpartida de Plasencia,4354,2177,2177
10,Cáceres,117,Marchagaz,278,141,137
10,Cáceres,118,Mata de Alcántara,320,156,164
10,Cáceres,119,Membrío,921,439,482
10,Cáceres,120,Mesas de Ibor,204,111,93
10,Cáceres,121,Miajadas,10107,5041,5066
10,Cáceres,122,Millanes,184,99,85
10,Cáceres,123,Mirabel,759,390,369
10,Cáceres,124,Mohedas de Granadilla,1061,537,524
10,Cáceres,125,Monroy,986,508,478
10,Cáceres,126,Montánchez,2083,1037,1046
10,Cáceres,127,Montehermoso,5623,2873,2750
10,Cáceres,128,Moraleja,7984,4026,3958
10,Cáceres,129,Morcillo,436,214,222
10,Cáceres,130,Navaconcejo,2102,1059,1043
10,Cáceres,131,Navalmoral de la Mata,17145,8689,8456
10,Cáceres,132,Navalvillar de Ibor,434,229,205
10,Cáceres,133,Navas del Madroño,1511,754,757
10,Cáceres,134,Navezuelas,740,394,346
10,Cáceres,135,Nuñomoral,1520,809,711
10,Cáceres,136,Oliva de Plasencia,252,137,115
10,Cáceres,137,Palomero,512,262,250
10,Cáceres,138,Pasarón de la Vera,689,342,347
10,Cáceres,139,Pedroso de Acim,112,58,54
10,Cáceres,140,Peraleda de la Mata,1521,782,739
10,Cáceres,141,Peraleda de San Román,352,175,177
10,Cáceres,142,Perales del Puerto,985,492,493
10,Cáceres,143,Pescueza,167,79,88
10,Cáceres,144,Pesga (La),1162,603,559
10,Cáceres,145,Piedras Albas,154,73,81
10,Cáceres,146,Pinofranqueado,1651,888,763
10,Cáceres,147,Piornal,1532,754,778
10,Cáceres,148,Plasencia,39596,19391,20205
10,Cáceres,149,Plasenzuela,549,269,280
10,Cáceres,150,Portaje,379,188,191
10,Cáceres,151,Portezuelo,293,145,148
10,Cáceres,152,Pozuelo de Zarzón,580,280,300
10,Cáceres,153,Puerto de Santa Cruz,404,208,196
10,Cáceres,154,Rebollar,221,109,112
10,Cáceres,155,Riolobos,1316,686,630
10,Cáceres,156,Robledillo de Gata,141,76,65
10,Cáceres,157,Robledillo de la Vera,317,160,157
10,Cáceres,158,Robledillo de Trujillo,465,244,221
10,Cáceres,159,Robledollano,386,213,173
10,Cáceres,160,Romangordo,156,75,81
10,Cáceres,901,Rosalejo,1417,764,653
10,Cáceres,161,Ruanes,76,42,34
10,Cáceres,162,Salorino,764,386,378
10,Cáceres,163,Salvatierra de Santiago,369,178,191
10,Cáceres,164,San Martín de Trevejo,948,453,495
10,Cáceres,165,Santa Ana,328,170,158
10,Cáceres,166,Santa Cruz de la Sierra,308,155,153
10,Cáceres,167,Santa Cruz de Paniagua,378,205,173
10,Cáceres,168,Santa Marta de Magasca,262,127,135
10,Cáceres,169,Santiago de Alcántara,725,364,361
10,Cáceres,170,Santiago del Campo,330,167,163
10,Cáceres,171,Santibáñez el Alto,485,242,243
10,Cáceres,172,Santibáñez el Bajo,891,456,435
10,Cáceres,173,Saucedilla,725,382,343
10,Cáceres,174,Segura de Toro,190,92,98
10,Cáceres,175,Serradilla,1792,921,871
10,Cáceres,176,Serrejón,481,243,238
10,Cáceres,177,Sierra de Fuentes,1813,939,874
10,Cáceres,178,Talaván,928,470,458
10,Cáceres,179,Talaveruela de la Vera,398,189,209
10,Cáceres,180,Talayuela,10249,6006,4243
10,Cáceres,181,Tejeda de Tiétar,976,513,463
10,Cáceres,182,Toril,218,133,85
10,Cáceres,183,Tornavacas,1263,664,599
10,Cáceres,184,Torno (El),938,496,442
10,Cáceres,187,Torre de Don Miguel,612,318,294
10,Cáceres,188,Torre de Santa María,673,343,330
10,Cáceres,185,Torrecilla de los Ángeles,720,369,351
10,Cáceres,186,Torrecillas de la Tiesa,1163,583,580
10,Cáceres,190,Torrejón el Rubio,613,320,293
10,Cáceres,189,Torrejoncillo,3373,1657,1716
10,Cáceres,191,Torremenga,627,333,294
10,Cáceres,192,Torremocha,1118,554,564
10,Cáceres,193,Torreorgaz,1713,843,870
10,Cáceres,194,Torrequemada,610,290,320
10,Cáceres,195,Trujillo,9672,4748,4924
10,Cáceres,196,Valdastillas,371,193,178
10,Cáceres,197,Valdecañas de Tajo,186,103,83
10,Cáceres,198,Valdefuentes,1515,780,735
10,Cáceres,199,Valdehúncar,198,98,100
10,Cáceres,200,Valdelacasa de Tajo,497,239,258
10,Cáceres,201,Valdemorales,244,120,124
10,Cáceres,202,Valdeobispo,775,381,394
10,Cáceres,203,Valencia de Alcántara,6115,3007,3108
10,Cáceres,204,Valverde de la Vera,618,313,305
10,Cáceres,205,Valverde del Fresno,2599,1330,1269
10,Cáceres,206,Viandar de la Vera,291,139,152
10,Cáceres,207,Villa del Campo,596,290,306
10,Cáceres,208,Villa del Rey,140,74,66
10,Cáceres,209,Villamesías,360,180,180
10,Cáceres,210,Villamiel,758,382,376
10,Cáceres,211,Villanueva de la Sierra,577,284,293
10,Cáceres,212,Villanueva de la Vera,2117,1097,1020
10,Cáceres,214,Villar de Plasencia,242,123,119
10,Cáceres,213,Villar del Pedroso,727,364,363
10,Cáceres,215,Villasbuenas de Gata,490,254,236
10,Cáceres,216,Zarza de Granadilla,1744,886,858
10,Cáceres,217,Zarza de Montánchez,609,302,307
10,Cáceres,218,Zarza la Mayor,1499,767,732
10,Cáceres,219,Zorita,1792,881,911
11,Cádiz,1,Alcalá de los Gazules,5633,2885,2748
11,Cádiz,2,Alcalá del Valle,5355,2750,2605
11,Cádiz,3,Algar,1644,873,771
11,Cádiz,4,Algeciras,111283,56546,54737
11,Cádiz,5,Algodonales,5630,2882,2748
11,Cádiz,6,Arcos de la Frontera,29420,14707,14713
11,Cádiz,7,Barbate,22496,11294,11202
11,Cádiz,8,Barrios (Los),20119,10132,9987
11,Cádiz,901,Benalup-Casas Viejas,6754,3437,3317
11,Cádiz,9,Benaocaz,729,373,356
11,Cádiz,10,Bornos,8164,4039,4125
11,Cádiz,11,Bosque (El),2004,1031,973
11,Cádiz,12,Cádiz,131813,63022,68791
11,Cádiz,13,Castellar de la Frontera,2874,1467,1407
11,Cádiz,15,Chiclana de la Frontera,70338,35630,34708
11,Cádiz,16,Chipiona,17730,8891,8839
11,Cádiz,14,Conil de la Frontera,19417,9865,9552
11,Cádiz,17,Espera,3909,1988,1921
11,Cádiz,18,Gastor (El),1948,1025,923
11,Cádiz,19,Grazalema,2225,1161,1064
11,Cádiz,20,Jerez de la Frontera,196275,95875,100400
11,Cádiz,21,Jimena de la Frontera,9754,5083,4671
11,Cádiz,22,Línea de la Concepción (La),62682,31064,31618
11,Cádiz,23,Medina-Sidonia,10962,5688,5274
11,Cádiz,24,Olvera,8585,4264,4321
11,Cádiz,25,Paterna de Rivera,5354,2788,2566
11,Cádiz,26,Prado del Rey,5968,2980,2988
11,Cádiz,27,Puerto de Santa María (El),82306,40928,41378
11,Cádiz,28,Puerto Real,37886,19077,18809
11,Cádiz,29,Puerto Serrano,6852,3514,3338
11,Cádiz,30,Rota,26792,13486,13306
11,Cádiz,31,San Fernando,92666,45753,46913
11,Cádiz,902,San José del Valle,4210,2158,2052
11,Cádiz,33,San Roque,25548,12903,12645
11,Cádiz,32,Sanlúcar de Barrameda,63187,31575,31612
11,Cádiz,34,Setenil de las Bodegas,3016,1548,1468
11,Cádiz,35,Tarifa,17199,8771,8428
11,Cádiz,36,Torre Alháquime,877,460,417
11,Cádiz,37,Trebujena,6893,3569,3324
11,Cádiz,38,Ubrique,17362,8585,8777
11,Cádiz,39,Vejer de la Frontera,12776,6470,6306
11,Cádiz,40,Villaluenga del Rosario,481,250,231
11,Cádiz,41,Villamartín,12145,6104,6041
11,Cádiz,42,Zahara,1556,809,747
12,Castellón/Castelló,2,Aín,149,76,73
12,Castellón/Castelló,3,Albocàsser,1395,691,704
12,Castellón/Castelló,4,Alcalà de Xivert,6752,3483,3269
12,Castellón/Castelló,5,Alcora (l'),10297,5252,5045
12,Castellón/Castelló,6,Alcudia de Veo,205,100,105
12,Castellón/Castelló,7,Alfondeguilla,899,445,454
12,Castellón/Castelló,8,Algimia de Almonacid,282,161,121
12,Castellón/Castelló,9,Almazora/Almassora,19688,9845,9843
12,Castellón/Castelló,10,Almedíjar,276,134,142
12,Castellón/Castelló,11,Almenara,5069,2504,2565
12,Castellón/Castelló,901,Alquerías del Niño Perdido,3805,1876,1929
12,Castellón/Castelló,12,Altura,3355,1705,1650
12,Castellón/Castelló,13,Arañuel,199,91,108
12,Castellón/Castelló,14,Ares del Maestre,228,116,112
12,Castellón/Castelló,15,Argelita,118,59,59
12,Castellón/Castelló,16,Artana,1803,907,896
12,Castellón/Castelló,1,Atzeneta del Maestrat,1457,746,711
12,Castellón/Castelló,17,Ayódar,228,126,102
12,Castellón/Castelló,18,Azuébar,366,181,185
12,Castellón/Castelló,20,Barracas,195,102,93
12,Castellón/Castelló,22,Bejís,413,232,181
12,Castellón/Castelló,24,Benafer,148,79,69
12,Castellón/Castelló,25,Benafigos,195,108,87
12,Castellón/Castelló,26,Benasal,1340,676,664
12,Castellón/Castelló,27,Benicarló,23552,11832,11720
12,Castellón/Castelló,28,Benicasim/Benicàssim,16200,8203,7997
12,Castellón/Castelló,29,Benlloch,1019,533,486
12,Castellón/Castelló,21,Betxí,5551,2804,2747
12,Castellón/Castelló,31,Borriol,4288,2189,2099
12,Castellón/Castelló,32,Burriana,31281,15610,15671
12,Castellón/Castelló,33,Cabanes,2659,1345,1314
12,Castellón/Castelló,34,Càlig,1647,818,829
12,Castellón/Castelló,36,Canet lo Roig,916,442,474
12,Castellón/Castelló,37,Castell de Cabres,19,9,10
12,Castellón/Castelló,38,Castellfort,217,113,104
12,Castellón/Castelló,39,Castellnovo,1029,498,531
12,Castellón/Castelló,40,Castellón de la Plana/Castelló de la Plana,167455,82859,84596
12,Castellón/Castelló,41,Castillo de Villamalefa,104,50,54
12,Castellón/Castelló,42,Catí,857,442,415
12,Castellón/Castelló,43,Caudiel,701,352,349
12,Castellón/Castelló,44,Cervera del Maestre,663,324,339
12,Castellón/Castelló,52,Chert/Xert,914,449,465
12,Castellón/Castelló,53,Chilches/Xilxes,2566,1316,1250
12,Castellón/Castelló,55,Chodos/Xodos,136,74,62
12,Castellón/Castelló,56,Chóvar,353,179,174
12,Castellón/Castelló,45,Cinctorres,524,249,275
12,Castellón/Castelló,46,Cirat,272,146,126
12,Castellón/Castelló,48,Cortes de Arenoso,413,221,192
12,Castellón/Castelló,49,Costur,490,246,244
12,Castellón/Castelló,50,Coves de Vinromà (les),1857,926,931
12,Castellón/Castelló,51,Culla,677,353,324
12,Castellón/Castelló,57,Eslida,861,428,433
12,Castellón/Castelló,58,Espadilla,69,33,36
12,Castellón/Castelló,59,Fanzara,270,131,139
12,Castellón/Castelló,60,Figueroles,571,287,284
12,Castellón/Castelló,61,Forcall,539,260,279
12,Castellón/Castelló,63,Fuente la Reina,39,20,19
12,Castellón/Castelló,64,Fuentes de Ayódar,101,56,45
12,Castellón/Castelló,65,Gaibiel,195,106,89
12,Castellón/Castelló,67,Geldo,716,364,352
12,Castellón/Castelló,68,Herbés,73,43,30
12,Castellón/Castelló,69,Higueras,84,41,43
12,Castellón/Castelló,70,Jana (la),828,420,408
12,Castellón/Castelló,71,Jérica,1577,788,789
12,Castellón/Castelló,74,Llosa (la),924,472,452
12,Castellón/Castelló,72,Lucena del Cid,1578,806,772
12,Castellón/Castelló,73,Ludiente,203,107,96
12,Castellón/Castelló,75,Mata de Morella (la),172,90,82
12,Castellón/Castelló,76,Matet,133,67,66
12,Castellón/Castelló,77,Moncofa,4977,2562,2415
12,Castellón/Castelló,78,Montán,370,185,185
12,Castellón/Castelló,79,Montanejos,488,245,243
12,Castellón/Castelló,80,Morella,2815,1388,1427
12,Castellón/Castelló,81,Navajas,641,329,312
12,Castellón/Castelló,82,Nules,12418,6220,6198
12,Castellón/Castelló,83,Olocau del Rey,136,75,61
12,Castellón/Castelló,84,Onda,22281,11320,10961
12,Castellón/Castelló,85,Oropesa del Mar/Orpesa,7208,3955,3253
12,Castellón/Castelló,87,Palanques,32,18,14
12,Castellón/Castelló,88,Pavías,60,37,23
12,Castellón/Castelló,89,Peñíscola,6149,3179,2970
12,Castellón/Castelló,90,Pina de Montalgrao,153,82,71
12,Castellón/Castelló,93,Pobla de Benifassà (la),246,126,120
12,Castellón/Castelló,94,Pobla Tornesa (la),790,404,386
12,Castellón/Castelló,91,Portell de Morella,248,121,127
12,Castellón/Castelló,92,Puebla de Arenoso,169,89,80
12,Castellón/Castelló,95,Ribesalbes,1336,690,646
12,Castellón/Castelló,96,Rossell,1260,666,594
12,Castellón/Castelló,97,Sacañet,116,70,46
12,Castellón/Castelló,98,Salzadella (la),806,424,382
12,Castellón/Castelló,101,San Rafael del Río,482,252,230
12,Castellón/Castelló,902,Sant Joan de Moró,2157,1162,995
12,Castellón/Castelló,99,Sant Jordi/San Jorge,744,380,364
12,Castellón/Castelló,100,Sant Mateu,1999,1027,972
12,Castellón/Castelló,102,Santa Magdalena de Pulpis,835,437,398
12,Castellón/Castelló,103,Sarratella,91,48,43
12,Castellón/Castelló,104,Segorbe,8456,4131,4325
12,Castellón/Castelló,105,Sierra Engarcerán,1079,554,525
12,Castellón/Castelló,106,Soneja,1365,684,681
12,Castellón/Castelló,107,Sot de Ferrer,470,236,234
12,Castellón/Castelló,108,Sueras/Suera,640,323,317
12,Castellón/Castelló,109,Tales,796,397,399
12,Castellón/Castelló,110,Teresa,341,170,171
12,Castellón/Castelló,111,Tírig,570,302,268
12,Castellón/Castelló,112,Todolella,133,79,54
12,Castellón/Castelló,113,Toga,90,43,47
12,Castellón/Castelló,114,Torás,269,132,137
12,Castellón/Castelló,115,Toro (El),284,149,135
12,Castellón/Castelló,116,Torralba del Pinar,66,32,34
12,Castellón/Castelló,119,Torre d'En Besora (la),204,112,92
12,Castellón/Castelló,120,Torre Endoménech,236,128,108
12,Castellón/Castelló,117,Torreblanca,5656,2943,2713
12,Castellón/Castelló,118,Torrechiva,100,62,38
12,Castellón/Castelló,121,Traiguera,1632,868,764
12,Castellón/Castelló,122,Useras/Useres (les),1004,526,478
12,Castellón/Castelló,124,Vall d'Alba,2103,1060,1043
12,Castellón/Castelló,125,Vall de Almonacid,269,138,131
12,Castellón/Castelló,126,Vall d'Uixó (la),31065,15568,15497
12,Castellón/Castelló,123,Vallat,71,35,36
12,Castellón/Castelló,127,Vallibona,91,49,42
12,Castellón/Castelló,128,Vilafamés,1730,940,790
12,Castellón/Castelló,132,Vilanova d'Alcolea,671,354,317
12,Castellón/Castelló,134,Vilar de Canes,185,94,91
12,Castellón/Castelló,136,Vilavella (la),3363,1692,1671
12,Castellón/Castelló,129,Villafranca del Cid/Vilafranca,2547,1243,1304
12,Castellón/Castelló,130,Villahermosa del Río,441,237,204
12,Castellón/Castelló,131,Villamalur,104,56,48
12,Castellón/Castelló,133,Villanueva de Viver,73,41,32
12,Castellón/Castelló,135,Villarreal/Vila-real,46696,23391,23305
12,Castellón/Castelló,137,Villores,62,35,27
12,Castellón/Castelló,138,Vinaròs,25232,12503,12729
12,Castellón/Castelló,139,Vistabella del Maestrazgo,410,210,200
12,Castellón/Castelló,140,Viver,1441,735,706
12,Castellón/Castelló,141,Zorita del Maestrazgo,132,64,68
12,Castellón/Castelló,142,Zucaina,193,111,82
13,Ciudad Real,1,Abenójar,1708,858,850
13,Ciudad Real,2,Agudo,1943,969,974
13,Ciudad Real,3,Alamillo,618,312,306
13,Ciudad Real,4,Albaladejo,1569,813,756
13,Ciudad Real,5,Alcázar de San Juan,28783,14170,14613
13,Ciudad Real,6,Alcoba,753,376,377
13,Ciudad Real,7,Alcolea de Calatrava,1623,832,791
13,Ciudad Real,8,Alcubillas,672,361,311
13,Ciudad Real,9,Aldea del Rey,2015,994,1021
13,Ciudad Real,10,Alhambra,1167,590,577
13,Ciudad Real,11,Almadén,6457,3083,3374
13,Ciudad Real,12,Almadenejos,537,288,249
13,Ciudad Real,13,Almagro,8502,4166,4336
13,Ciudad Real,14,Almedina,704,359,345
13,Ciudad Real,15,Almodóvar del Campo,6952,3410,3542
13,Ciudad Real,16,Almuradiel,983,473,510
13,Ciudad Real,17,Anchuras,392,230,162
13,Ciudad Real,903,Arenales de San Gregorio,696,360,336
13,Ciudad Real,18,Arenas de San Juan,1061,545,516
13,Ciudad Real,19,Argamasilla de Alba,6812,3377,3435
13,Ciudad Real,20,Argamasilla de Calatrava,5420,2742,2678
13,Ciudad Real,21,Arroba de los Montes,560,298,262
13,Ciudad Real,22,Ballesteros de Calatrava,574,286,288
13,Ciudad Real,23,Bolaños de Calatrava,12071,6223,5848
13,Ciudad Real,24,Brazatortas,1132,574,558
13,Ciudad Real,25,Cabezarados,381,193,188
13,Ciudad Real,26,Cabezarrubias del Puerto,589,302,287
13,Ciudad Real,27,Calzada de Calatrava,4607,2300,2307
13,Ciudad Real,28,Campo de Criptana,13541,6785,6756
13,Ciudad Real,29,Cañada de Calatrava,106,57,49
13,Ciudad Real,30,Caracuel de Calatrava,174,90,84
13,Ciudad Real,31,Carrión de Calatrava,2676,1340,1336
13,Ciudad Real,32,Carrizosa,1550,771,779
13,Ciudad Real,33,Castellar de Santiago,2214,1095,1119
13,Ciudad Real,38,Chillón,2166,1053,1113
13,Ciudad Real,34,Ciudad Real,69063,32800,36263
13,Ciudad Real,35,Corral de Calatrava,1275,633,642
13,Ciudad Real,36,Cortijos (Los),1029,508,521
13,Ciudad Real,37,Cózar,1350,687,663
13,Ciudad Real,39,Daimiel,17721,8748,8973
13,Ciudad Real,40,Fernán Caballero,1129,548,581
13,Ciudad Real,41,Fontanarejo,305,154,151
13,Ciudad Real,42,Fuencaliente,1232,649,583
13,Ciudad Real,43,Fuenllana,290,139,151
13,Ciudad Real,44,Fuente el Fresno,3481,1758,1723
13,Ciudad Real,45,Granátula de Calatrava,1018,508,510
13,Ciudad Real,46,Guadalmez,946,484,462
13,Ciudad Real,47,Herencia,8020,4161,3859
13,Ciudad Real,48,Hinojosas de Calatrava,679,328,351
13,Ciudad Real,49,Horcajo de los Montes,1005,503,502
13,Ciudad Real,50,Labores (Las),682,347,335
13,Ciudad Real,904,Llanos del Caudillo,667,345,322
13,Ciudad Real,51,Luciana,445,231,214
13,Ciudad Real,52,Malagón,8021,3976,4045
13,Ciudad Real,53,Manzanares,18525,9240,9285
13,Ciudad Real,54,Membrilla,6500,3239,3261
13,Ciudad Real,55,Mestanza,823,399,424
13,Ciudad Real,56,Miguelturra,11737,5896,5841
13,Ciudad Real,57,Montiel,1700,870,830
13,Ciudad Real,58,Moral de Calatrava,5306,2648,2658
13,Ciudad Real,59,Navalpino,278,138,140
13,Ciudad Real,60,Navas de Estena,395,216,179
13,Ciudad Real,61,Pedro Muñoz,7970,4141,3829
13,Ciudad Real,62,Picón,669,346,323
13,Ciudad Real,63,Piedrabuena,4879,2469,2410
13,Ciudad Real,64,Poblete,1007,506,501
13,Ciudad Real,65,Porzuna,3974,2012,1962
13,Ciudad Real,66,Pozuelo de Calatrava,2741,1378,1363
13,Ciudad Real,67,Pozuelos de Calatrava (Los),461,232,229
13,Ciudad Real,68,Puebla de Don Rodrigo,1287,694,593
13,Ciudad Real,69,Puebla del Príncipe,941,477,464
13,Ciudad Real,70,Puerto Lápice,1002,517,485
13,Ciudad Real,71,Puertollano,50082,24406,25676
13,Ciudad Real,72,Retuerta del Bullaque,1084,579,505
13,Ciudad Real,901,Robledo (El),1103,564,539
13,Ciudad Real,902,Ruidera,598,303,295
13,Ciudad Real,73,Saceruela,694,357,337
13,Ciudad Real,74,San Carlos del Valle,1208,616,592
13,Ciudad Real,75,San Lorenzo de Calatrava,283,144,139
13,Ciudad Real,76,Santa Cruz de los Cáñamos,635,315,320
13,Ciudad Real,77,Santa Cruz de Mudela,4789,2358,2431
13,Ciudad Real,78,Socuéllamos,12850,6581,6269
13,Ciudad Real,79,Solana (La),15761,7966,7795
13,Ciudad Real,80,Solana del Pino,426,210,216
13,Ciudad Real,81,Terrinches,1007,545,462
13,Ciudad Real,82,Tomelloso,33548,16784,16764
13,Ciudad Real,83,Torralba de Calatrava,2952,1465,1487
13,Ciudad Real,84,Torre de Juan Abad,1359,667,692
13,Ciudad Real,85,Torrenueva,3066,1565,1501
13,Ciudad Real,86,Valdemanco del Esteras,271,133,138
13,Ciudad Real,87,Valdepeñas,27634,13426,14208
13,Ciudad Real,88,Valenzuela de Calatrava,798,382,416
13,Ciudad Real,89,Villahermosa,2392,1131,1261
13,Ciudad Real,90,Villamanrique,1521,747,774
13,Ciudad Real,91,Villamayor de Calatrava,603,302,301
13,Ciudad Real,92,Villanueva de la Fuente,2600,1311,1289
13,Ciudad Real,93,Villanueva de los Infantes,5894,2916,2978
13,Ciudad Real,94,Villanueva de San Carlos,414,213,201
13,Ciudad Real,95,Villar del Pozo,115,61,54
13,Ciudad Real,96,Villarrubia de los Ojos,10125,5101,5024
13,Ciudad Real,97,Villarta de San Juan,3047,1562,1485
13,Ciudad Real,98,Viso del Marqués,2940,1485,1455
14,Córdoba,1,Adamuz,4443,2251,2192
14,Córdoba,2,Aguilar de la Frontera,13589,6759,6830
14,Córdoba,3,Alcaracejos,1472,712,760
14,Córdoba,4,Almedinilla,2534,1283,1251
14,Córdoba,5,Almodóvar del Río,7420,3693,3727
14,Córdoba,6,Añora,1531,753,778
14,Córdoba,7,Baena,20447,10371,10076
14,Córdoba,8,Belalcázar,3576,1721,1855
14,Córdoba,9,Belmez,3440,1653,1787
14,Córdoba,10,Benamejí,5030,2511,2519
14,Córdoba,11,Blázquez (Los),685,347,338
14,Córdoba,12,Bujalance,7870,3885,3985
14,Córdoba,13,Cabra,20940,10209,10731
14,Córdoba,14,Cañete de las Torres,3210,1612,1598
14,Córdoba,15,Carcabuey,2825,1426,1399
14,Córdoba,16,Cardeña,1761,883,878
14,Córdoba,17,Carlota (La),11488,5774,5714
14,Córdoba,18,Carpio (El),4491,2218,2273
14,Córdoba,19,Castro del Río,8088,3992,4096
14,Córdoba,20,Conquista,483,233,250
14,Córdoba,21,Córdoba,321164,154681,166483
14,Córdoba,22,Doña Mencía,5003,2478,2525
14,Córdoba,23,Dos Torres,2616,1286,1330
14,Córdoba,24,Encinas Reales,2415,1189,1226
14,Córdoba,25,Espejo,3797,1891,1906
14,Córdoba,26,Espiel,2386,1195,1191
14,Córdoba,27,Fernán-Núñez,9438,4712,4726
14,Córdoba,28,Fuente la Lancha,418,202,216
14,Córdoba,29,Fuente Obejuna,5434,2743,2691
14,Córdoba,30,Fuente Palmera,10220,5148,5072
14,Córdoba,31,Fuente-Tójar,807,382,425
14,Córdoba,32,Granjuela (La),487,253,234
14,Córdoba,33,Guadalcázar,1258,633,625
14,Córdoba,34,Guijo (El),395,199,196
14,Córdoba,35,Hinojosa del Duque,7595,3670,3925
14,Córdoba,36,Hornachuelos,4678,2350,2328
14,Córdoba,37,Iznájar,4960,2480,2480
14,Córdoba,38,Lucena,39783,19798,19985
14,Córdoba,39,Luque,3311,1643,1668
14,Córdoba,40,Montalbán de Córdoba,4602,2335,2267
14,Córdoba,41,Montemayor,3890,1943,1947
14,Córdoba,42,Montilla,23391,11558,11833
14,Córdoba,43,Montoro,9583,4733,4850
14,Córdoba,44,Monturque,2007,1007,1000
14,Córdoba,45,Moriles,3874,1942,1932
14,Córdoba,46,Nueva Carteya,5581,2812,2769
14,Córdoba,47,Obejo,1502,743,759
14,Córdoba,48,Palenciana,1579,794,785
14,Córdoba,49,Palma del Río,20403,10220,10183
14,Córdoba,50,Pedro Abad,2892,1447,1445
14,Córdoba,51,Pedroche,1699,838,861
14,Córdoba,52,Peñarroya-Pueblonuevo,12171,5839,6332
14,Córdoba,53,Posadas,7316,3630,3686
14,Córdoba,54,Pozoblanco,16996,8248,8748
14,Córdoba,55,Priego de Córdoba,23151,11415,11736
14,Córdoba,56,Puente Genil,28543,14183,14360
14,Córdoba,57,Rambla (La),7415,3691,3724
14,Córdoba,58,Rute,10143,5040,5103
14,Córdoba,59,San Sebastián de los Ballesteros,840,441,399
14,Córdoba,61,Santa Eufemia,1021,519,502
14,Córdoba,60,Santaella,5976,2997,2979
14,Córdoba,62,Torrecampo,1355,655,700
14,Córdoba,63,Valenzuela,1366,668,698
14,Córdoba,64,Valsequillo,425,200,225
14,Córdoba,65,Victoria (La),1822,919,903
14,Córdoba,66,Villa del Río,7432,3778,3654
14,Córdoba,67,Villafranca de Córdoba,3893,1986,1907
14,Córdoba,68,Villaharta,637,328,309
14,Córdoba,69,Villanueva de Córdoba,9719,4790,4929
14,Córdoba,70,Villanueva del Duque,1694,818,876
14,Córdoba,71,Villanueva del Rey,1223,625,598
14,Córdoba,72,Villaralto,1385,678,707
14,Córdoba,73,Villaviciosa de Córdoba,3657,1870,1787
14,Córdoba,74,Viso (El),2870,1413,1457
14,Córdoba,75,Zuheros,835,427,408
15,Coruña (A),1,Abegondo,5756,2853,2903
15,Coruña (A),2,Ames,22228,10785,11443
15,Coruña (A),3,Aranga,2264,1140,1124
15,Coruña (A),4,Ares,5301,2630,2671
15,Coruña (A),5,Arteixo,26272,13124,13148
15,Coruña (A),6,Arzúa,6602,3241,3361
15,Coruña (A),7,Baña (A),4802,2309,2493
15,Coruña (A),8,Bergondo,6495,3145,3350
15,Coruña (A),9,Betanzos,13059,6193,6866
15,Coruña (A),10,Boimorto,2461,1238,1223
15,Coruña (A),11,Boiro,18469,8938,9531
15,Coruña (A),12,Boqueixón,4378,2154,2224
15,Coruña (A),13,Brión,6849,3309,3540
15,Coruña (A),14,Cabana de Bergantiños,5294,2615,2679
15,Coruña (A),15,Cabanas,3368,1679,1689
15,Coruña (A),16,Camariñas,6467,3192,3275
15,Coruña (A),17,Cambre,21523,10622,10901
15,Coruña (A),18,Capela (A),1514,745,769
15,Coruña (A),19,Carballo,29689,14443,15246
15,Coruña (A),901,Cariño,4788,2341,2447
15,Coruña (A),20,Carnota,5244,2524,2720
15,Coruña (A),21,Carral,5527,2689,2838
15,Coruña (A),22,Cedeira,7429,3678,3751
15,Coruña (A),23,Cee,7467,3600,3867
15,Coruña (A),24,Cerceda,5500,2663,2837
15,Coruña (A),25,Cerdido,1522,740,782
15,Coruña (A),26,Cesuras,2427,1194,1233
15,Coruña (A),27,Coirós,1654,814,840
15,Coruña (A),28,Corcubión,1927,944,983
15,Coruña (A),29,Coristanco,7646,3730,3916
15,Coruña (A),30,Coruña (A),243349,113510,129839
15,Coruña (A),31,Culleredo,25650,12485,13165
15,Coruña (A),32,Curtis,4369,2147,2222
15,Coruña (A),33,Dodro,3122,1522,1600
15,Coruña (A),34,Dumbría,4067,1975,2092
15,Coruña (A),35,Fene,14355,6983,7372
15,Coruña (A),36,Ferrol,77155,35958,41197
15,Coruña (A),37,Fisterra,5042,2552,2490
15,Coruña (A),38,Frades,2871,1429,1442
15,Coruña (A),39,Irixoa,1579,781,798
15,Coruña (A),41,Laracha (A),10806,5264,5542
15,Coruña (A),40,Laxe,3539,1777,1762
15,Coruña (A),42,Lousame,3854,1837,2017
15,Coruña (A),43,Malpica de Bergantiños,6786,3324,3462
15,Coruña (A),44,Mañón,1803,874,929
15,Coruña (A),45,Mazaricos,5488,2636,2852
15,Coruña (A),46,Melide,7866,3838,4028
15,Coruña (A),47,Mesía,3174,1600,1574
15,Coruña (A),48,Miño,5127,2460,2667
15,Coruña (A),49,Moeche,1469,677,792
15,Coruña (A),50,Monfero,2444,1242,1202
15,Coruña (A),51,Mugardos,5628,2729,2899
15,Coruña (A),53,Muros,9995,4837,5158
15,Coruña (A),52,Muxía,5823,2856,2967
15,Coruña (A),54,Narón,35083,17038,18045
15,Coruña (A),55,Neda,5771,2825,2946
15,Coruña (A),56,Negreira,6519,3121,3398
15,Coruña (A),57,Noia,14637,6967,7670
15,Coruña (A),58,Oleiros,30467,14801,15666
15,Coruña (A),59,Ordes,12272,5965,6307
15,Coruña (A),60,Oroso,6345,3142,3203
15,Coruña (A),61,Ortigueira,7697,3689,4008
15,Coruña (A),62,Outes,7889,3774,4115
15,Coruña (A),63,Oza dos Ríos,3163,1544,1619
15,Coruña (A),64,Paderne,2715,1321,1394
15,Coruña (A),65,Padrón,9035,4327,4708
15,Coruña (A),66,Pino (O),4901,2419,2482
15,Coruña (A),67,Pobra do Caramiñal (A),9951,4782,5169
15,Coruña (A),68,Ponteceso,6698,3352,3346
15,Coruña (A),69,Pontedeume,8663,4162,4501
15,Coruña (A),70,Pontes de García Rodríguez (As),11771,5904,5867
15,Coruña (A),71,Porto do Son,9990,4918,5072
15,Coruña (A),72,Rianxo,11528,5629,5899
15,Coruña (A),73,Ribeira,26884,13284,13600
15,Coruña (A),74,Rois,5149,2445,2704
15,Coruña (A),75,Sada,12867,6337,6530
15,Coruña (A),76,San Sadurniño,3179,1541,1638
15,Coruña (A),77,Santa Comba,10683,5201,5482
15,Coruña (A),78,Santiago de Compostela,92919,43455,49464
15,Coruña (A),79,Santiso,2160,1109,1051
15,Coruña (A),80,Sobrado,2316,1165,1151
15,Coruña (A),81,Somozas (As),1411,704,707
15,Coruña (A),82,Teo,16809,8237,8572
15,Coruña (A),83,Toques,1512,786,726
15,Coruña (A),84,Tordoia,4617,2203,2414
15,Coruña (A),85,Touro,4532,2237,2295
15,Coruña (A),86,Trazo,3617,1784,1833
15,Coruña (A),88,Val do Dubra,4605,2225,2380
15,Coruña (A),87,Valdoviño,6888,3370,3518
15,Coruña (A),89,Vedra,5054,2422,2632
15,Coruña (A),91,Vilarmaior,1343,688,655
15,Coruña (A),90,Vilasantar,1538,802,736
15,Coruña (A),92,Vimianzo,8466,4115,4351
15,Coruña (A),93,Zas,5780,2834,2946
16,Cuenca,1,Abia de la Obispalía,84,48,36
16,Cuenca,2,Acebrón (El),265,138,127
16,Cuenca,3,Alarcón,176,80,96
16,Cuenca,4,Albaladejo del Cuende,383,200,183
16,Cuenca,5,Albalate de las Nogueras,345,193,152
16,Cuenca,6,Albendea,170,87,83
16,Cuenca,7,Alberca de Záncara (La),1974,1028,946
16,Cuenca,8,Alcalá de la Vega,159,82,77
16,Cuenca,9,Alcantud,98,54,44
16,Cuenca,10,Alcázar del Rey,227,113,114
16,Cuenca,11,Alcohujate,53,34,19
16,Cuenca,12,Alconchel de la Estrella,168,90,78
16,Cuenca,13,Algarra,33,19,14
16,Cuenca,14,Aliaguilla,841,431,410
16,Cuenca,15,Almarcha (La),584,301,283
16,Cuenca,16,Almendros,303,156,147
16,Cuenca,17,Almodóvar del Pinar,505,267,238
16,Cuenca,18,Almonacid del Marquesado,535,281,254
16,Cuenca,19,Altarejos,299,156,143
16,Cuenca,20,Arandilla del Arroyo,35,18,17
16,Cuenca,905,Arcas del Villar,885,458,427
16,Cuenca,22,Arcos de la Sierra,111,56,55
16,Cuenca,24,Arguisuelas,166,92,74
16,Cuenca,25,Arrancacepas,39,20,19
16,Cuenca,26,Atalaya del Cañavate,113,57,56
16,Cuenca,27,Barajas de Melo,818,424,394
16,Cuenca,29,Barchín del Hoyo,119,68,51
16,Cuenca,30,Bascuñana de San Pedro,34,20,14
16,Cuenca,31,Beamud,93,49,44
16,Cuenca,32,Belinchón,356,180,176
16,Cuenca,33,Belmonte,2278,1099,1179
16,Cuenca,34,Belmontejo,218,106,112
16,Cuenca,35,Beteta,401,195,206
16,Cuenca,36,Boniches,164,78,86
16,Cuenca,38,Buciegas,63,32,31
16,Cuenca,39,Buenache de Alarcón,641,331,310
16,Cuenca,40,Buenache de la Sierra,106,68,38
16,Cuenca,41,Buendía,505,256,249
16,Cuenca,42,Campillo de Altobuey,1710,855,855
16,Cuenca,43,Campillos-Paravientos,130,72,58
16,Cuenca,44,Campillos-Sierra,77,41,36
16,Cuenca,901,Campos del Paraíso,1013,488,525
16,Cuenca,45,Canalejas del Arroyo,387,201,186
16,Cuenca,46,Cañada del Hoyo,318,161,157
16,Cuenca,47,Cañada Juncosa,330,182,148
16,Cuenca,48,Cañamares,598,322,276
16,Cuenca,49,Cañavate (El),206,100,106
16,Cuenca,50,Cañaveras,411,207,204
16,Cuenca,51,Cañaveruelas,189,93,96
16,Cuenca,52,Cañete,910,460,450
16,Cuenca,53,Cañizares,568,294,274
16,Cuenca,55,Carboneras de Guadazaón,937,485,452
16,Cuenca,56,Cardenete,691,355,336
16,Cuenca,57,Carrascosa,114,67,47
16,Cuenca,58,Carrascosa de Haro,137,67,70
16,Cuenca,60,Casas de Benítez,1090,523,567
16,Cuenca,61,Casas de Fernando Alonso,1321,676,645
16,Cuenca,62,Casas de Garcimolina,31,20,11
16,Cuenca,63,Casas de Guijarro,130,67,63
16,Cuenca,64,Casas de Haro,882,461,421
16,Cuenca,65,Casas de los Pinos,520,247,273
16,Cuenca,66,Casasimarro,3049,1553,1496
16,Cuenca,67,Castejón,221,99,122
16,Cuenca,68,Castillejo de Iniesta,224,127,97
16,Cuenca,70,Castillejo-Sierra,49,26,23
16,Cuenca,72,Castillo de Garcimuñoz,195,102,93
16,Cuenca,71,Castillo-Albaráñez,24,11,13
16,Cuenca,73,Cervera del Llano,288,149,139
16,Cuenca,23,Chillarón de Cuenca,428,228,200
16,Cuenca,81,Chumillas,68,38,30
16,Cuenca,74,Cierva (La),48,28,20
16,Cuenca,78,Cuenca,49912,23920,25992
16,Cuenca,79,Cueva del Hierro,53,30,23
16,Cuenca,82,Enguídanos,468,236,232
16,Cuenca,83,Fresneda de Altarejos,84,45,39
16,Cuenca,84,Fresneda de la Sierra,68,33,35
16,Cuenca,85,Frontera (La),201,103,98
16,Cuenca,86,Fuente de Pedro Naharro,1285,671,614
16,Cuenca,87,Fuentelespino de Haro,299,159,140
16,Cuenca,88,Fuentelespino de Moya,162,87,75
16,Cuenca,904,Fuentenava de Jábaga,474,243,231
16,Cuenca,89,Fuentes,508,267,241
16,Cuenca,91,Fuertescusa,112,66,46
16,Cuenca,92,Gabaldón,197,114,83
16,Cuenca,93,Garaballa,128,70,58
16,Cuenca,94,Gascueña,142,61,81
16,Cuenca,95,Graja de Campalbo,125,67,58
16,Cuenca,96,Graja de Iniesta,435,244,191
16,Cuenca,97,Henarejos,240,116,124
16,Cuenca,98,Herrumblar (El),767,402,365
16,Cuenca,99,Hinojosa (La),293,146,147
16,Cuenca,100,Hinojosos (Los),1078,536,542
16,Cuenca,101,Hito (El),209,110,99
16,Cuenca,102,Honrubia,1658,829,829
16,Cuenca,103,Hontanaya,405,208,197
16,Cuenca,104,Hontecillas,94,46,48
16,Cuenca,106,Horcajo de Santiago,3740,1933,1807
16,Cuenca,107,Huélamo,126,65,61
16,Cuenca,108,Huelves,63,28,35
16,Cuenca,109,Huérguina,91,52,39
16,Cuenca,110,Huerta de la Obispalía,142,83,59
16,Cuenca,111,Huerta del Marquesado,222,127,95
16,Cuenca,112,Huete,2024,1036,988
16,Cuenca,113,Iniesta,4577,2334,2243
16,Cuenca,115,Laguna del Marquesado,72,34,38
16,Cuenca,116,Lagunaseca,117,55,62
16,Cuenca,117,Landete,1381,697,684
16,Cuenca,118,Ledaña,1937,973,964
16,Cuenca,119,Leganiel,242,120,122
16,Cuenca,121,Majadas (Las),352,176,176
16,Cuenca,122,Mariana,307,149,158
16,Cuenca,123,Masegosa,119,65,54
16,Cuenca,124,Mesas (Las),2514,1297,1217
16,Cuenca,125,Minglanilla,2385,1235,1150
16,Cuenca,126,Mira,1169,605,564
16,Cuenca,128,Monreal del Llano,71,37,34
16,Cuenca,129,Montalbanejo,159,75,84
16,Cuenca,130,Montalbo,703,365,338
16,Cuenca,131,Monteagudo de las Salinas,153,90,63
16,Cuenca,132,Mota de Altarejos,55,35,20
16,Cuenca,133,Mota del Cuervo,6003,3022,2981
16,Cuenca,134,Motilla del Palancar,5551,2798,2753
16,Cuenca,135,Moya,241,126,115
16,Cuenca,137,Narboneta,93,46,47
16,Cuenca,139,Olivares de Júcar,502,261,241
16,Cuenca,140,Olmeda de la Cuesta,41,21,20
16,Cuenca,141,Olmeda del Rey,213,104,109
16,Cuenca,142,Olmedilla de Alarcón,143,80,63
16,Cuenca,143,Olmedilla de Eliz,25,12,13
16,Cuenca,145,Osa de la Vega,650,327,323
16,Cuenca,146,Pajarón,118,62,56
16,Cuenca,147,Pajaroncillo,88,45,43
16,Cuenca,148,Palomares del Campo,907,453,454
16,Cuenca,149,Palomera,178,88,90
16,Cuenca,150,Paracuellos,158,75,83
16,Cuenca,151,Paredes,94,53,41
16,Cuenca,152,Parra de las Vegas (La),43,25,18
16,Cuenca,153,Pedernoso (El),1321,667,654
16,Cuenca,154,Pedroñeras (Las),7058,3804,3254
16,Cuenca,155,Peral (El),743,391,352
16,Cuenca,156,Peraleja (La),131,67,64
16,Cuenca,157,Pesquera (La),267,138,129
16,Cuenca,158,Picazo (El),763,385,378
16,Cuenca,159,Pinarejo,356,168,188
16,Cuenca,160,Pineda de Gigüela,123,64,59
16,Cuenca,161,Piqueras del Castillo,79,42,37
16,Cuenca,162,Portalrubio de Guadamejud,62,32,30
16,Cuenca,163,Portilla,92,45,47
16,Cuenca,165,Poyatos,95,56,39
16,Cuenca,166,Pozoamargo,348,172,176
16,Cuenca,908,Pozorrubielos de la Mancha,310,154,156
16,Cuenca,167,Pozorrubio,443,212,231
16,Cuenca,169,Pozuelo (El),109,52,57
16,Cuenca,170,Priego,1087,564,523
16,Cuenca,171,Provencio (El),2679,1359,1320
16,Cuenca,172,Puebla de Almenara,487,244,243
16,Cuenca,173,Puebla de Don Francisco,347,180,167
16,Cuenca,174,Puebla del Salvador,275,146,129
16,Cuenca,175,Quintanar del Rey,7359,3906,3453
16,Cuenca,176,Rada de Haro,61,34,27
16,Cuenca,177,Reíllo,130,67,63
16,Cuenca,181,Rozalén del Monte,89,37,52
16,Cuenca,185,Saceda-Trasierra,90,53,37
16,Cuenca,186,Saelices,651,320,331
16,Cuenca,187,Salinas del Manzano,106,58,48
16,Cuenca,188,Salmeroncillos,180,94,86
16,Cuenca,189,Salvacañete,335,176,159
16,Cuenca,190,San Clemente,6948,3607,3341
16,Cuenca,191,San Lorenzo de la Parrilla,1319,655,664
16,Cuenca,192,San Martín de Boniches,87,42,45
16,Cuenca,193,San Pedro Palmiches,103,53,50
16,Cuenca,194,Santa Cruz de Moya,387,204,183
16,Cuenca,196,Santa María de los Llanos,794,416,378
16,Cuenca,195,Santa María del Campo Rus,775,396,379
16,Cuenca,197,Santa María del Val,98,55,43
16,Cuenca,198,Sisante,1806,909,897
16,Cuenca,199,Solera de Gabaldón,40,17,23
16,Cuenca,909,Sotorribas,901,455,446
16,Cuenca,202,Talayuelas,1113,571,542
16,Cuenca,203,Tarancón,13266,6593,6673
16,Cuenca,204,Tébar,383,201,182
16,Cuenca,205,Tejadillos,171,83,88
16,Cuenca,206,Tinajas,382,206,176
16,Cuenca,209,Torralba,183,101,82
16,Cuenca,211,Torrejoncillo del Rey,646,317,329
16,Cuenca,212,Torrubia del Campo,347,170,177
16,Cuenca,213,Torrubia del Castillo,40,22,18
16,Cuenca,215,Tragacete,320,174,146
16,Cuenca,216,Tresjuncos,448,228,220
16,Cuenca,217,Tribaldos,124,57,67
16,Cuenca,218,Uclés,266,128,138
16,Cuenca,219,Uña,128,67,61
16,Cuenca,906,Valdecolmenas (Los),111,61,50
16,Cuenca,224,Valdemeca,101,56,45
16,Cuenca,225,Valdemorillo de la Sierra,84,44,40
16,Cuenca,227,Valdemoro-Sierra,166,93,73
16,Cuenca,228,Valdeolivas,264,143,121
16,Cuenca,902,Valdetórtola,156,91,65
16,Cuenca,903,Valeras (Las),1554,818,736
16,Cuenca,231,Valhermoso de la Fuente,43,20,23
16,Cuenca,234,Valsalobre,62,35,27
16,Cuenca,236,Valverde de Júcar,1321,677,644
16,Cuenca,237,Valverdejo,128,64,64
16,Cuenca,238,Vara de Rey,630,325,305
16,Cuenca,239,Vega del Codorno,202,106,96
16,Cuenca,240,Vellisca,161,79,82
16,Cuenca,242,Villaconejos de Trabaque,466,232,234
16,Cuenca,243,Villaescusa de Haro,596,300,296
16,Cuenca,244,Villagarcía del Llano,941,483,458
16,Cuenca,245,Villalba de la Sierra,571,289,282
16,Cuenca,246,Villalba del Rey,639,326,313
16,Cuenca,247,Villalgordo del Marquesado,112,59,53
16,Cuenca,248,Villalpardo,1191,606,585
16,Cuenca,249,Villamayor de Santiago,2782,1402,1380
16,Cuenca,250,Villanueva de Guadamejud,109,61,48
16,Cuenca,251,Villanueva de la Jara,2182,1117,1065
16,Cuenca,253,Villar de Cañas,484,248,236
16,Cuenca,254,Villar de Domingo García,267,142,125
16,Cuenca,255,Villar de la Encina,213,106,107
16,Cuenca,263,Villar de Olalla,1039,540,499
16,Cuenca,258,Villar del Humo,334,194,140
16,Cuenca,259,Villar del Infantado,45,25,20
16,Cuenca,910,Villar y Velasco,111,61,50
16,Cuenca,264,Villarejo de Fuentes,740,364,376
16,Cuenca,265,Villarejo de la Peñuela,30,15,15
16,Cuenca,266,Villarejo-Periesteban,505,252,253
16,Cuenca,269,Villares del Saz,627,323,304
16,Cuenca,270,Villarrubio,258,133,125
16,Cuenca,271,Villarta,864,444,420
16,Cuenca,272,Villas de la Ventosa,359,192,167
16,Cuenca,273,Villaverde y Pasaconsol,399,198,201
16,Cuenca,274,Víllora,201,89,112
16,Cuenca,275,Vindel,22,11,11
16,Cuenca,276,Yémeda,29,14,15
16,Cuenca,277,Zafra de Záncara,162,83,79
16,Cuenca,278,Zafrilla,117,56,61
16,Cuenca,279,Zarza de Tajo,271,139,132
16,Cuenca,280,Zarzuela,267,139,128
17,Girona,1,Agullana,759,393,366
17,Girona,2,Aiguaviva,601,304,297
17,Girona,3,Albanyà,131,72,59
17,Girona,4,Albons,589,308,281
17,Girona,6,Alp,1389,726,663
17,Girona,7,Amer,2237,1111,1126
17,Girona,8,Anglès,5191,2687,2504
17,Girona,9,Arbúcies,6002,3208,2794
17,Girona,10,Argelaguer,408,218,190
17,Girona,11,Armentera (L'),765,379,386
17,Girona,12,Avinyonet de Puigventós,1101,557,544
17,Girona,15,Banyoles,16938,8499,8439
17,Girona,16,Bàscara,877,464,413
17,Girona,13,Begur,3986,2051,1935
17,Girona,18,Bellcaire d'Empordà,668,346,322
17,Girona,19,Besalú,2211,1088,1123
17,Girona,20,Bescanó,3762,1893,1869
17,Girona,21,Beuda,147,75,72
17,Girona,22,Bisbal d'Empordà (La),9196,4594,4602
17,Girona,234,Biure,237,120,117
17,Girona,23,Blanes,36711,18503,18208
17,Girona,29,Boadella i les Escaules,240,116,124
17,Girona,24,Bolvir,287,148,139
17,Girona,25,Bordils,1501,776,725
17,Girona,26,Borrassà,586,308,278
17,Girona,27,Breda,3625,1853,1772
17,Girona,28,Brunyola,353,178,175
17,Girona,31,Cabanelles,249,141,108
17,Girona,30,Cabanes,911,475,436
17,Girona,32,Cadaqués,2623,1266,1357
17,Girona,33,Caldes de Malavella,5280,2664,2616
17,Girona,34,Calonge,9162,4671,4491
17,Girona,35,Camós,673,350,323
17,Girona,36,Campdevànol,3432,1711,1721
17,Girona,37,Campelles,114,60,54
17,Girona,38,Campllong,368,188,180
17,Girona,39,Camprodon,2446,1208,1238
17,Girona,40,Canet d'Adri,564,292,272
17,Girona,41,Cantallops,271,137,134
17,Girona,42,Capmany,500,264,236
17,Girona,44,Cassà de la Selva,8612,4422,4190
17,Girona,46,Castellfollit de la Roca,964,490,474
17,Girona,47,Castelló d'Empúries,9167,4743,4424
17,Girona,48,Castell-Platja d'Aro,9239,4781,4458
17,Girona,189,Cellera de Ter (La),2064,1054,1010
17,Girona,49,Celrà,3510,1774,1736
17,Girona,50,Cervià de Ter,796,396,400
17,Girona,51,Cistella,239,120,119
17,Girona,54,Colera,606,312,294
17,Girona,55,Colomers,207,104,103
17,Girona,57,Corçà,1232,622,610
17,Girona,56,Cornellà del Terri,2017,1012,1005
17,Girona,58,Crespià,241,123,118
17,Girona,901,"Cruïlles, Monells i Sant Sadurní de l'Heura",1233,614,619
17,Girona,60,Darnius,543,279,264
17,Girona,61,Das,171,92,79
17,Girona,62,Escala (L'),8311,4283,4028
17,Girona,63,Espinelves,193,104,89
17,Girona,64,Espolla,395,199,196
17,Girona,65,Esponellà,432,212,220
17,Girona,5,Far d'Empordà (El),448,231,217
17,Girona,66,Figueres,38884,19160,19724
17,Girona,67,Flaçà,983,496,487
17,Girona,68,Foixà,329,169,160
17,Girona,69,Fontanals de Cerdanya,436,219,217
17,Girona,70,Fontanilles,164,93,71
17,Girona,71,Fontcoberta,1137,553,584
17,Girona,902,Forallac,1745,863,882
17,Girona,73,Fornells de la Selva,1884,912,972
17,Girona,74,Fortià,572,291,281
17,Girona,75,Garrigàs,332,181,151
17,Girona,76,Garrigoles,156,84,72
17,Girona,77,Garriguella,735,390,345
17,Girona,78,Ger,433,225,208
17,Girona,79,Girona,86672,41998,44674
17,Girona,80,Gombrèn,229,110,119
17,Girona,81,Gualta,359,212,147
17,Girona,82,Guils de Cerdanya,392,206,186
17,Girona,83,Hostalric,3459,1768,1691
17,Girona,84,Isòvol,231,134,97
17,Girona,85,Jafre,377,211,166
17,Girona,86,Jonquera (La),3016,1556,1460
17,Girona,87,Juià,298,161,137
17,Girona,88,Lladó,562,285,277
17,Girona,89,Llagostera,6764,3497,3267
17,Girona,90,Llambilles,585,294,291
17,Girona,91,Llanars,546,290,256
17,Girona,92,Llançà,4371,2173,2198
17,Girona,93,Llers,1145,581,564
17,Girona,94,Llívia,1252,670,582
17,Girona,95,Lloret de Mar,29445,15374,14071
17,Girona,96,Llosses (Les),261,140,121
17,Girona,102,Maçanet de Cabrenys,734,381,353
17,Girona,103,Maçanet de la Selva,5354,2765,2589
17,Girona,97,Madremanya,222,101,121
17,Girona,98,Maià de Montcal,374,193,181
17,Girona,100,Masarac,263,130,133
17,Girona,101,Massanes,624,329,295
17,Girona,99,Meranges,88,54,34
17,Girona,105,Mieres,352,183,169
17,Girona,106,Mollet de Peralada,175,87,88
17,Girona,107,Molló,336,174,162
17,Girona,109,Montagut i Oix,875,455,420
17,Girona,110,Mont-ras,1826,961,865
17,Girona,111,Navata,882,433,449
17,Girona,112,Ogassa,262,150,112
17,Girona,114,Olot,31271,15605,15666
17,Girona,115,Ordis,347,181,166
17,Girona,116,Osor,409,210,199
17,Girona,117,Palafrugell,20509,10501,10008
17,Girona,118,Palamós,16817,8312,8505
17,Girona,119,Palau de Santa Eulàlia,88,52,36
17,Girona,121,Palau-sator,283,152,131
17,Girona,120,Palau-saverdera,1178,581,597
17,Girona,123,Palol de Revardit,425,224,201
17,Girona,124,Pals,2335,1187,1148
17,Girona,125,Pardines,162,85,77
17,Girona,126,Parlavà,341,182,159
17,Girona,128,Pau,473,247,226
17,Girona,129,Pedret i Marzà,158,77,81
17,Girona,130,Pera (La),427,216,211
17,Girona,132,Peralada,1558,799,759
17,Girona,133,Planes d'Hostoles (Les),1754,885,869
17,Girona,134,Planoles,313,167,146
17,Girona,135,Pont de Molins,450,240,210
17,Girona,136,Pontós,229,124,105
17,Girona,137,Porqueres,4060,1995,2065
17,Girona,140,Port de la Selva (El),921,461,460
17,Girona,138,Portbou,1374,678,696
17,Girona,139,Preses (Les),1657,812,845
17,Girona,141,Puigcerdà,8845,4670,4175
17,Girona,142,Quart,2629,1349,1280
17,Girona,43,Queralbs,202,117,85
17,Girona,143,Rabós,177,85,92
17,Girona,144,Regencós,297,164,133
17,Girona,145,Ribes de Freser,2044,1011,1033
17,Girona,146,Riells i Viabrea,3035,1594,1441
17,Girona,147,Ripoll,10762,5303,5459
17,Girona,148,Riudarenes,1679,876,803
17,Girona,149,Riudaura,426,215,211
17,Girona,150,Riudellots de la Selva,1775,923,852
17,Girona,151,Riumors,154,78,76
17,Girona,152,Roses,15535,7820,7715
17,Girona,153,Rupià,201,109,92
17,Girona,154,Sales de Llierca,117,58,59
17,Girona,155,Salt,27370,14527,12843
17,Girona,157,Sant Andreu Salou,154,72,82
17,Girona,183,Sant Aniol de Finestres,286,155,131
17,Girona,158,Sant Climent Sescebes,474,244,230
17,Girona,159,Sant Feliu de Buixalleu,769,414,355
17,Girona,160,Sant Feliu de Guíxols,20318,10059,10259
17,Girona,161,Sant Feliu de Pallerols,1223,608,615
17,Girona,162,Sant Ferriol,206,111,95
17,Girona,163,Sant Gregori,2844,1461,1383
17,Girona,164,Sant Hilari Sacalm,5474,2862,2612
17,Girona,165,Sant Jaume de Llierca,785,397,388
17,Girona,167,Sant Joan de les Abadesses,3621,1810,1811
17,Girona,168,Sant Joan de Mollet,475,237,238
17,Girona,185,Sant Joan les Fonts,2631,1317,1314
17,Girona,166,Sant Jordi Desvalls,631,318,313
17,Girona,169,Sant Julià de Ramis,2495,1275,1220
17,Girona,903,Sant Julià del Llor i Bonmatí,1007,514,493
17,Girona,171,Sant Llorenç de la Muga,202,101,101
17,Girona,172,Sant Martí de Llémena,526,276,250
17,Girona,173,Sant Martí Vell,185,101,84
17,Girona,174,Sant Miquel de Campmajor,197,110,87
17,Girona,175,Sant Miquel de Fluvià,671,350,321
17,Girona,176,Sant Mori,167,80,87
17,Girona,177,Sant Pau de Segúries,669,338,331
17,Girona,178,Sant Pere Pescador,1775,989,786
17,Girona,180,Santa Coloma de Farners,10557,5443,5114
17,Girona,181,Santa Cristina d'Aro,3983,2063,1920
17,Girona,182,Santa Llogaia d'Àlguema,311,168,143
17,Girona,184,Santa Pau,1541,787,754
17,Girona,186,Sarrià de Ter,4036,1997,2039
17,Girona,187,Saus,733,360,373
17,Girona,188,Selva de Mar (La),216,111,105
17,Girona,190,Serinyà,998,517,481
17,Girona,191,Serra de Daró,177,99,78
17,Girona,192,Setcases,180,94,86
17,Girona,193,Sils,3947,1981,1966
17,Girona,52,Siurana,175,89,86
17,Girona,194,Susqueda,113,64,49
17,Girona,195,Tallada d'Empordà (La),346,190,156
17,Girona,196,Terrades,155,77,78
17,Girona,197,Torrent,188,101,87
17,Girona,198,Torroella de Fluvià,437,251,186
17,Girona,199,Torroella de Montgrí,10228,5270,4958
17,Girona,200,Tortellà,714,358,356
17,Girona,201,Toses,163,99,64
17,Girona,202,Tossa de Mar,5260,2678,2582
17,Girona,204,Ullà,946,516,430
17,Girona,205,Ullastret,226,113,113
17,Girona,203,Ultramort,203,117,86
17,Girona,206,Urús,205,105,100
17,Girona,14,Vajol (La),96,53,43
17,Girona,208,Vall de Bianya (La),1228,618,610
17,Girona,207,Vall d'en Bas (La),2616,1325,1291
17,Girona,170,Vallfogona de Ripollès,221,116,105
17,Girona,209,Vall-llobrega,655,319,336
17,Girona,210,Ventalló,710,375,335
17,Girona,211,Verges,1173,574,599
17,Girona,212,Vidrà,172,85,87
17,Girona,213,Vidreres,6215,3258,2957
17,Girona,214,Vilabertran,831,423,408
17,Girona,215,Vilablareix,2189,1101,1088
17,Girona,217,Viladamat,422,214,208
17,Girona,216,Viladasens,182,92,90
17,Girona,218,Vilademuls,787,409,378
17,Girona,220,Viladrau,982,512,470
17,Girona,221,Vilafant,4852,2423,2429
17,Girona,223,Vilajuïga,1059,517,542
17,Girona,224,Vilallonga de Ter,437,241,196
17,Girona,225,Vilamacolum,292,153,139
17,Girona,226,Vilamalla,947,499,448
17,Girona,227,Vilamaniscle,168,93,75
17,Girona,228,Vilanant,336,166,170
17,Girona,230,Vila-sacra,509,253,256
17,Girona,222,Vilaür,140,69,71
17,Girona,233,Vilobí d'Onyar,2664,1444,1220
17,Girona,232,Vilopriu,181,94,87
18,Granada,1,Agrón,301,158,143
18,Granada,2,Alamedilla,811,409,402
18,Granada,3,Albolote,15563,7838,7725
18,Granada,4,Albondón,929,493,436
18,Granada,5,Albuñán,462,233,229
18,Granada,6,Albuñol,6215,3232,2983
18,Granada,7,Albuñuelas,1102,569,533
18,Granada,10,Aldeire,735,373,362
18,Granada,11,Alfacar,5107,2605,2502
18,Granada,12,Algarinejo,4184,2144,2040
18,Granada,13,Alhama de Granada,6184,3266,2918
18,Granada,14,Alhendín,5200,2665,2535
18,Granada,15,Alicún de Ortega,563,298,265
18,Granada,16,Almegíjar,435,216,219
18,Granada,17,Almuñécar,24713,12174,12539
18,Granada,904,Alpujarra de la Sierra,1174,605,569
18,Granada,18,Alquife,780,389,391
18,Granada,20,Arenas del Rey,2157,1138,1019
18,Granada,21,Armilla,18385,9290,9095
18,Granada,22,Atarfe,12919,6423,6496
18,Granada,23,Baza,22220,11043,11177
18,Granada,24,Beas de Granada,1069,565,504
18,Granada,25,Beas de Guadix,377,189,188
18,Granada,27,Benalúa,3288,1632,1656
18,Granada,28,Benalúa de las Villas,1391,708,683
18,Granada,29,Benamaurel,2323,1172,1151
18,Granada,30,Bérchules,807,428,379
18,Granada,32,Bubión,355,186,169
18,Granada,33,Busquístar,364,199,165
18,Granada,34,Cacín,697,348,349
18,Granada,35,Cádiar,1601,814,787
18,Granada,36,Cájar,4051,1982,2069
18,Granada,114,Calahorra (La),798,411,387
18,Granada,37,Calicasas,568,288,280
18,Granada,38,Campotéjar,1441,758,683
18,Granada,39,Caniles,4849,2436,2413
18,Granada,40,Cáñar,366,192,174
18,Granada,42,Capileira,582,287,295
18,Granada,43,Carataunas,198,99,99
18,Granada,44,Cástaras,251,131,120
18,Granada,45,Castilléjar,1606,790,816
18,Granada,46,Castril,2565,1310,1255
18,Granada,47,Cenes de la Vega,6372,3292,3080
18,Granada,59,Chauchina,4365,2201,2164
18,Granada,61,Chimeneas,1485,767,718
18,Granada,62,Churriana de la Vega,8679,4295,4384
18,Granada,48,Cijuela,2009,1028,981
18,Granada,49,Cogollos de Guadix,741,391,350
18,Granada,50,Cogollos de la Vega,2076,1075,1001
18,Granada,51,Colomera,1498,774,724
18,Granada,53,Cortes de Baza,2335,1180,1155
18,Granada,54,Cortes y Graena,1081,543,538
18,Granada,912,Cuevas del Campo,2097,1060,1037
18,Granada,56,Cúllar,4898,2439,2459
18,Granada,57,Cúllar Vega,5556,2804,2752
18,Granada,63,Darro,1488,746,742
18,Granada,64,Dehesas de Guadix,556,275,281
18,Granada,66,Deifontes,2439,1254,1185
18,Granada,67,Diezma,860,453,407
18,Granada,68,Dílar,1620,803,817
18,Granada,69,Dólar,592,300,292
18,Granada,70,Dúdar,299,160,139
18,Granada,71,Dúrcal,6551,3303,3248
18,Granada,72,Escúzar,785,389,396
18,Granada,74,Ferreira,323,166,157
18,Granada,76,Fonelas,1165,581,584
18,Granada,78,Freila,1039,510,529
18,Granada,79,Fuente Vaqueros,4024,2002,2022
18,Granada,905,Gabias (Las),12280,6429,5851
18,Granada,82,Galera,1127,556,571
18,Granada,83,Gobernador,317,152,165
18,Granada,84,Gójar,4813,2502,2311
18,Granada,85,Gor,997,511,486
18,Granada,86,Gorafe,540,267,273
18,Granada,87,Granada,236982,110041,126941
18,Granada,88,Guadahortuna,2261,1151,1110
18,Granada,89,Guadix,20136,9878,10258
18,Granada,906,Guajares (Los),1274,693,581
18,Granada,93,Gualchos,2538,1307,1231
18,Granada,94,Güejar Sierra,2878,1542,1336
18,Granada,95,Güevéjar,2018,1018,1000
18,Granada,96,Huélago,455,242,213
18,Granada,97,Huéneja,1231,625,606
18,Granada,98,Huéscar,8225,4141,4084
18,Granada,99,Huétor de Santillán,1750,926,824
18,Granada,100,Huétor Tájar,9154,4619,4535
18,Granada,101,Huétor Vega,10545,5315,5230
18,Granada,102,Illora,10210,5118,5092
18,Granada,103,Itrabo,1116,548,568
18,Granada,105,Iznalloz,6978,3532,3446
18,Granada,107,Jayena,1237,644,593
18,Granada,108,Jerez del Marquesado,1092,553,539
18,Granada,109,Jete,800,409,391
18,Granada,111,Jun,2161,1096,1065
18,Granada,112,Juviles,175,91,84
18,Granada,115,Láchar,2732,1398,1334
18,Granada,116,Lanjarón,3756,1853,1903
18,Granada,117,Lanteira,488,248,240
18,Granada,119,Lecrín,2309,1179,1130
18,Granada,120,Lentegí,342,178,164
18,Granada,121,Lobras,126,62,64
18,Granada,122,Loja,20888,10404,10484
18,Granada,123,Lugros,361,181,180
18,Granada,124,Lújar,505,270,235
18,Granada,126,Malahá (La),1679,863,816
18,Granada,127,Maracena,18819,9372,9447
18,Granada,128,Marchal,404,187,217
18,Granada,132,Moclín,4220,2114,2106
18,Granada,133,Molvízar,2795,1381,1414
18,Granada,134,Monachil,6034,3077,2957
18,Granada,135,Montefrío,6520,3256,3264
18,Granada,136,Montejícar,2615,1306,1309
18,Granada,137,Montillana,1318,690,628
18,Granada,138,Moraleda de Zafayona,3043,1552,1491
18,Granada,909,Morelábor,847,445,402
18,Granada,140,Motril,56605,28057,28548
18,Granada,141,Murtas,741,425,316
18,Granada,903,Nevada,1220,642,578
18,Granada,143,Nigüelas,941,466,475
18,Granada,144,Nívar,681,351,330
18,Granada,145,Ogíjares,11877,6062,5815
18,Granada,146,Orce,1397,713,684
18,Granada,147,Órgiva,5370,2705,2665
18,Granada,148,Otívar,1109,565,544
18,Granada,149,Otura,5439,2760,2679
18,Granada,150,Padul,7373,3681,3692
18,Granada,151,Pampaneira,355,182,173
18,Granada,152,Pedro Martínez,1254,626,628
18,Granada,153,Peligros,10037,5129,4908
18,Granada,154,Peza (La),1381,734,647
18,Granada,910,Pinar (El),1125,566,559
18,Granada,157,Pinos Genil,1262,658,604
18,Granada,158,Pinos Puente,13319,6800,6519
18,Granada,159,Píñar,1368,724,644
18,Granada,161,Polícar,233,115,118
18,Granada,162,Polopos,1625,915,710
18,Granada,163,Pórtugos,408,197,211
18,Granada,164,Puebla de Don Fadrique,2621,1341,1280
18,Granada,165,Pulianas,4842,2433,2409
18,Granada,167,Purullena,2307,1161,1146
18,Granada,168,Quéntar,1054,548,506
18,Granada,170,Rubite,488,264,224
18,Granada,171,Salar,2768,1402,1366
18,Granada,173,Salobreña,11750,5878,5872
18,Granada,174,Santa Cruz del Comercio,544,287,257
18,Granada,175,Santa Fe,14301,7076,7225
18,Granada,176,Soportújar,274,144,130
18,Granada,177,Sorvilán,701,373,328
18,Granada,901,Taha (La),769,386,383
18,Granada,178,Torre-Cardela,1103,533,570
18,Granada,179,Torvizcón,795,404,391
18,Granada,180,Trevélez,837,434,403
18,Granada,181,Turón,339,196,143
18,Granada,182,Ugíjar,2524,1290,1234
18,Granada,902,Valle (El),1139,541,598
18,Granada,907,Valle del Zalabí,2326,1155,1171
18,Granada,183,Válor,736,373,363
18,Granada,911,Vegas del Genil,5795,3021,2774
18,Granada,184,Vélez de Benaudalla,2803,1429,1374
18,Granada,185,Ventas de Huelma,704,368,336
18,Granada,908,Villamena,1010,499,511
18,Granada,187,Villanueva de las Torres,789,428,361
18,Granada,188,Villanueva Mesía,2127,1089,1038
18,Granada,189,Víznar,789,421,368
18,Granada,192,Zafarraya,2200,1210,990
18,Granada,913,Zagra,1068,521,547
18,Granada,193,Zubia (La),15819,7823,7996
18,Granada,194,Zújar,2746,1418,1328
19,Guadalajara,1,Abánades,98,54,44
19,Guadalajara,2,Ablanque,128,65,63
19,Guadalajara,3,Adobes,70,33,37
19,Guadalajara,4,Alaminos,82,43,39
19,Guadalajara,5,Alarilla,126,75,51
19,Guadalajara,6,Albalate de Zorita,929,512,417
19,Guadalajara,7,Albares,491,253,238
19,Guadalajara,8,Albendiego,38,28,10
19,Guadalajara,9,Alcocer,324,160,164
19,Guadalajara,10,Alcolea de las Peñas,24,13,11
19,Guadalajara,11,Alcolea del Pinar,396,208,188
19,Guadalajara,13,Alcoroches,165,92,73
19,Guadalajara,15,Aldeanueva de Guadalajara,116,58,58
19,Guadalajara,16,Algar de Mesa,70,37,33
19,Guadalajara,17,Algora,106,61,45
19,Guadalajara,18,Alhóndiga,253,137,116
19,Guadalajara,19,Alique,36,14,22
19,Guadalajara,20,Almadrones,100,61,39
19,Guadalajara,21,Almoguera,1457,779,678
19,Guadalajara,22,Almonacid de Zorita,799,390,409
19,Guadalajara,23,Alocén,174,82,92
19,Guadalajara,24,Alovera,7234,3739,3495
19,Guadalajara,27,Alustante,261,151,110
19,Guadalajara,31,Angón,33,19,14
19,Guadalajara,32,Anguita,236,126,110
19,Guadalajara,33,Anquela del Ducado,85,42,43
19,Guadalajara,34,Anquela del Pedregal,25,17,8
19,Guadalajara,36,Aranzueque,385,189,196
19,Guadalajara,37,Arbancón,184,105,79
19,Guadalajara,38,Arbeteta,53,28,25
19,Guadalajara,39,Argecilla,94,53,41
19,Guadalajara,40,Armallones,56,33,23
19,Guadalajara,41,Armuña de Tajuña,127,68,59
19,Guadalajara,42,Arroyo de las Fraguas,44,24,20
19,Guadalajara,43,Atanzón,101,62,39
19,Guadalajara,44,Atienza,450,243,207
19,Guadalajara,45,Auñón,248,133,115
19,Guadalajara,46,Azuqueca de Henares,24097,12304,11793
19,Guadalajara,47,Baides,59,29,30
19,Guadalajara,48,Baños de Tajo,26,18,8
19,Guadalajara,49,Bañuelos,29,17,12
19,Guadalajara,50,Barriopedro,32,15,17
19,Guadalajara,51,Berninches,120,70,50
19,Guadalajara,52,Bodera (La),42,24,18
19,Guadalajara,53,Brihuega,2847,1491,1356
19,Guadalajara,54,Budia,266,140,126
19,Guadalajara,55,Bujalaro,83,41,42
19,Guadalajara,57,Bustares,94,57,37
19,Guadalajara,58,Cabanillas del Campo,7189,3605,3584
19,Guadalajara,59,Campillo de Dueñas,111,59,52
19,Guadalajara,60,Campillo de Ranas,184,99,85
19,Guadalajara,61,Campisábalos,64,33,31
19,Guadalajara,64,Canredondo,108,58,50
19,Guadalajara,65,Cantalojas,143,82,61
19,Guadalajara,66,Cañizar,111,52,59
19,Guadalajara,67,Cardoso de la Sierra (El),73,50,23
19,Guadalajara,70,Casa de Uceda,109,59,50
19,Guadalajara,71,Casar (El),6525,3411,3114
19,Guadalajara,73,Casas de San Galindo,32,17,15
19,Guadalajara,74,Caspueñas,95,56,39
19,Guadalajara,75,Castejón de Henares,107,60,47
19,Guadalajara,76,Castellar de la Muela,40,21,19
19,Guadalajara,78,Castilforte,62,38,24
19,Guadalajara,79,Castilnuevo,9,5,4
19,Guadalajara,80,Cendejas de Enmedio,122,66,56
19,Guadalajara,81,Cendejas de la Torre,65,41,24
19,Guadalajara,82,Centenera,84,45,39
19,Guadalajara,103,Checa,359,198,161
19,Guadalajara,104,Chequilla,16,8,8
19,Guadalajara,106,Chillarón del Rey,116,64,52
19,Guadalajara,105,Chiloeches,1875,989,886
19,Guadalajara,86,Cifuentes,2021,1035,986
19,Guadalajara,87,Cincovillas,35,17,18
19,Guadalajara,88,Ciruelas,97,51,46
19,Guadalajara,89,Ciruelos del Pinar,41,23,18
19,Guadalajara,90,Cobeta,105,49,56
19,Guadalajara,91,Cogollor,37,20,17
19,Guadalajara,92,Cogolludo,633,363,270
19,Guadalajara,95,Condemios de Abajo,33,20,13
19,Guadalajara,96,Condemios de Arriba,171,84,87
19,Guadalajara,97,Congostrina,45,25,20
19,Guadalajara,98,Copernal,24,15,9
19,Guadalajara,99,Corduente,425,241,184
19,Guadalajara,102,Cubillo de Uceda (El),131,63,68
19,Guadalajara,107,Driebes,373,191,182
19,Guadalajara,108,Durón,155,77,78
19,Guadalajara,109,Embid,59,32,27
19,Guadalajara,110,Escamilla,108,47,61
19,Guadalajara,111,Escariche,214,116,98
19,Guadalajara,112,Escopete,61,32,29
19,Guadalajara,113,Espinosa de Henares,655,343,312
19,Guadalajara,114,Esplegares,55,33,22
19,Guadalajara,115,Establés,53,31,22
19,Guadalajara,116,Estriégana,25,15,10
19,Guadalajara,117,Fontanar,1362,718,644
19,Guadalajara,118,Fuembellida,13,9,4
19,Guadalajara,119,Fuencemillán,112,54,58
19,Guadalajara,120,Fuentelahiguera de Albatages,158,88,70
19,Guadalajara,121,Fuentelencina,240,125,115
19,Guadalajara,122,Fuentelsaz,121,59,62
19,Guadalajara,123,Fuentelviejo,61,32,29
19,Guadalajara,124,Fuentenovilla,369,209,160
19,Guadalajara,125,Gajanejos,63,36,27
19,Guadalajara,126,Galápagos,941,522,419
19,Guadalajara,127,Galve de Sorbe,134,69,65
19,Guadalajara,129,Gascueña de Bornova,61,37,24
19,Guadalajara,130,Guadalajara,73719,36032,37687
19,Guadalajara,132,Henche,107,55,52
19,Guadalajara,133,Heras de Ayuso,163,93,70
19,Guadalajara,134,Herrería,31,16,15
19,Guadalajara,135,Hiendelaencina,124,67,57
19,Guadalajara,136,Hijes,25,12,13
19,Guadalajara,138,Hita,331,181,150
19,Guadalajara,139,Hombrados,38,21,17
19,Guadalajara,142,Hontoba,244,127,117
19,Guadalajara,143,Horche,1871,989,882
19,Guadalajara,145,Hortezuela de Océn,74,39,35
19,Guadalajara,146,Huerce (La),44,28,16
19,Guadalajara,147,Huérmeces del Cerro,52,34,18
19,Guadalajara,148,Huertahernando,67,39,28
19,Guadalajara,150,Hueva,134,66,68
19,Guadalajara,151,Humanes,1354,683,671
19,Guadalajara,152,Illana,752,399,353
19,Guadalajara,153,Iniéstola,15,12,3
19,Guadalajara,154,Inviernas (Las),105,60,45
19,Guadalajara,155,Irueste,66,37,29
19,Guadalajara,156,Jadraque,1426,747,679
19,Guadalajara,157,Jirueque,78,49,29
19,Guadalajara,159,Ledanca,122,67,55
19,Guadalajara,160,Loranca de Tajuña,827,468,359
19,Guadalajara,161,Lupiana,242,128,114
19,Guadalajara,162,Luzaga,105,53,52
19,Guadalajara,163,Luzón,70,34,36
19,Guadalajara,165,Majaelrayo,75,47,28
19,Guadalajara,166,Málaga del Fresno,206,119,87
19,Guadalajara,167,Malaguilla,133,71,62
19,Guadalajara,168,Mandayona,393,194,199
19,Guadalajara,169,Mantiel,73,41,32
19,Guadalajara,170,Maranchón,252,139,113
19,Guadalajara,171,Marchamalo,4700,2453,2247
19,Guadalajara,172,Masegoso de Tajuña,99,54,45
19,Guadalajara,173,Matarrubia,55,33,22
19,Guadalajara,174,Matillas,185,96,89
19,Guadalajara,175,Mazarete,67,27,40
19,Guadalajara,176,Mazuecos,376,194,182
19,Guadalajara,177,Medranda,126,67,59
19,Guadalajara,178,Megina,57,28,29
19,Guadalajara,179,Membrillera,116,56,60
19,Guadalajara,181,Miedes de Atienza,94,50,44
19,Guadalajara,182,Mierla (La),22,16,6
19,Guadalajara,184,Millana,160,82,78
19,Guadalajara,183,Milmarcos,108,61,47
19,Guadalajara,185,Miñosa (La),50,30,20
19,Guadalajara,186,Mirabueno,107,63,44
19,Guadalajara,187,Miralrío,85,52,33
19,Guadalajara,188,Mochales,81,38,43
19,Guadalajara,189,Mohernando,165,89,76
19,Guadalajara,190,Molina de Aragón,3662,1869,1793
19,Guadalajara,191,Monasterio,24,11,13
19,Guadalajara,192,Mondéjar,2629,1370,1259
19,Guadalajara,193,Montarrón,46,25,21
19,Guadalajara,194,Moratilla de los Meleros,114,67,47
19,Guadalajara,195,Morenilla,46,26,20
19,Guadalajara,196,Muduex,122,64,58
19,Guadalajara,197,Navas de Jadraque (Las),33,17,16
19,Guadalajara,198,Negredo,22,13,9
19,Guadalajara,199,Ocentejo,40,20,20
19,Guadalajara,200,Olivar (El),124,75,49
19,Guadalajara,201,Olmeda de Cobeta,108,52,56
19,Guadalajara,202,Olmeda de Jadraque (La),19,9,10
19,Guadalajara,203,Ordial (El),46,23,23
19,Guadalajara,204,Orea,248,153,95
19,Guadalajara,208,Pálmaces de Jadraque,69,40,29
19,Guadalajara,209,Pardos,68,34,34
19,Guadalajara,210,Paredes de Sigüenza,42,24,18
19,Guadalajara,211,Pareja,473,249,224
19,Guadalajara,212,Pastrana,1064,521,543
19,Guadalajara,213,Pedregal (El),103,57,46
19,Guadalajara,214,Peñalén,120,69,51
19,Guadalajara,215,Peñalver,223,131,92
19,Guadalajara,216,Peralejos de las Truchas,178,96,82
19,Guadalajara,217,Peralveche,107,68,39
19,Guadalajara,218,Pinilla de Jadraque,77,35,42
19,Guadalajara,219,Pinilla de Molina,27,17,10
19,Guadalajara,220,Pioz,1071,608,463
19,Guadalajara,221,Piqueras,58,35,23
19,Guadalajara,222,Pobo de Dueñas (El),151,82,69
19,Guadalajara,223,Poveda de la Sierra,162,92,70
19,Guadalajara,224,Pozo de Almoguera,156,85,71
19,Guadalajara,225,Pozo de Guadalajara,838,443,395
19,Guadalajara,226,Prádena de Atienza,51,33,18
19,Guadalajara,227,Prados Redondos,113,66,47
19,Guadalajara,228,Puebla de Beleña,49,32,17
19,Guadalajara,229,Puebla de Valles,87,48,39
19,Guadalajara,230,Quer,544,299,245
19,Guadalajara,231,Rebollosa de Jadraque,32,20,12
19,Guadalajara,232,Recuenco (El),91,48,43
19,Guadalajara,233,Renera,73,38,35
19,Guadalajara,234,Retiendas,48,23,25
19,Guadalajara,235,Riba de Saelices,170,96,74
19,Guadalajara,237,Rillo de Gallo,67,39,28
19,Guadalajara,238,Riofrío del Llano,58,33,25
19,Guadalajara,239,Robledillo de Mohernando,129,65,64
19,Guadalajara,240,Robledo de Corpes,96,52,44
19,Guadalajara,241,Romanillos de Atienza,57,35,22
19,Guadalajara,242,Romanones,132,71,61
19,Guadalajara,243,Rueda de la Sierra,51,28,23
19,Guadalajara,244,Sacecorbo,165,99,66
19,Guadalajara,245,Sacedón,1700,886,814
19,Guadalajara,246,Saelices de la Sal,61,32,29
19,Guadalajara,247,Salmerón,216,114,102
19,Guadalajara,248,San Andrés del Congosto,73,41,32
19,Guadalajara,249,San Andrés del Rey,46,17,29
19,Guadalajara,250,Santiuste,25,15,10
19,Guadalajara,251,Saúca,68,36,32
19,Guadalajara,252,Sayatón,126,70,56
19,Guadalajara,254,Selas,62,30,32
19,Guadalajara,901,Semillas,50,30,20
19,Guadalajara,255,Setiles,141,79,62
19,Guadalajara,256,Sienes,82,47,35
19,Guadalajara,257,Sigüenza,4817,2462,2355
19,Guadalajara,258,Solanillos del Extremo,133,70,63
19,Guadalajara,259,Somolinos,37,17,20
19,Guadalajara,260,Sotillo (El),50,29,21
19,Guadalajara,261,Sotodosos,70,30,40
19,Guadalajara,262,Tamajón,215,111,104
19,Guadalajara,263,Taragudo,33,20,13
19,Guadalajara,264,Taravilla,67,36,31
19,Guadalajara,265,Tartanedo,164,88,76
19,Guadalajara,266,Tendilla,354,187,167
19,Guadalajara,267,Terzaga,28,16,12
19,Guadalajara,268,Tierzo,50,29,21
19,Guadalajara,269,Toba (La),110,61,49
19,Guadalajara,271,Tordellego,61,31,30
19,Guadalajara,270,Tordelrábano,9,3,6
19,Guadalajara,272,Tordesilos,142,78,64
19,Guadalajara,274,Torija,582,275,307
19,Guadalajara,279,Torre del Burgo,143,82,61
19,Guadalajara,277,Torrecuadrada de Molina,20,12,8
19,Guadalajara,278,Torrecuadradilla,55,31,24
19,Guadalajara,280,Torrejón del Rey,2790,1494,1296
19,Guadalajara,281,Torremocha de Jadraque,19,13,6
19,Guadalajara,282,Torremocha del Campo,263,145,118
19,Guadalajara,283,Torremocha del Pinar,56,25,31
19,Guadalajara,284,Torremochuela,18,11,7
19,Guadalajara,285,Torrubia,38,21,17
19,Guadalajara,286,Tórtola de Henares,511,276,235
19,Guadalajara,287,Tortuera,217,113,104
19,Guadalajara,288,Tortuero,38,21,17
19,Guadalajara,289,Traíd,58,27,31
19,Guadalajara,290,Trijueque,1053,579,474
19,Guadalajara,291,Trillo,1354,693,661
19,Guadalajara,293,Uceda,1752,902,850
19,Guadalajara,294,Ujados,33,17,16
19,Guadalajara,296,Utande,51,35,16
19,Guadalajara,297,Valdarachas,26,12,14
19,Guadalajara,298,Valdearenas,104,68,36
19,Guadalajara,299,Valdeavellano,116,71,45
19,Guadalajara,300,Valdeaveruelo,577,306,271
19,Guadalajara,301,Valdeconcha,43,24,19
19,Guadalajara,302,Valdegrudas,63,39,24
19,Guadalajara,303,Valdelcubo,65,37,28
19,Guadalajara,304,Valdenuño Fernández,230,126,104
19,Guadalajara,305,Valdepeñas de la Sierra,201,107,94
19,Guadalajara,306,Valderrebollo,40,20,20
19,Guadalajara,307,Valdesotos,27,14,13
19,Guadalajara,308,Valfermoso de Tajuña,86,47,39
19,Guadalajara,309,Valhermoso,44,24,20
19,Guadalajara,310,Valtablado del Río,15,10,5
19,Guadalajara,311,Valverde de los Arroyos,105,58,47
19,Guadalajara,314,Viana de Jadraque,44,27,17
19,Guadalajara,317,Villanueva de Alcorón,251,133,118
19,Guadalajara,318,Villanueva de Argecilla,43,25,18
19,Guadalajara,319,Villanueva de la Torre,4779,2479,2300
19,Guadalajara,321,Villares de Jadraque,53,32,21
19,Guadalajara,322,Villaseca de Henares,55,32,23
19,Guadalajara,323,Villaseca de Uceda,75,42,33
19,Guadalajara,324,Villel de Mesa,223,117,106
19,Guadalajara,325,Viñuelas,118,68,50
19,Guadalajara,326,Yebes,214,144,70
19,Guadalajara,327,Yebra,515,267,248
19,Guadalajara,329,Yélamos de Abajo,79,39,40
19,Guadalajara,330,Yélamos de Arriba,133,73,60
19,Guadalajara,331,Yunquera de Henares,2550,1317,1233
19,Guadalajara,332,Yunta (La),137,68,69
19,Guadalajara,333,Zaorejas,201,118,83
19,Guadalajara,334,Zarzuela de Jadraque,50,23,27
19,Guadalajara,335,Zorita de los Canes,97,47,50
20,Guipúzcoa,1,Abaltzisketa,284,160,124
20,Guipúzcoa,2,Aduna,352,194,158
20,Guipúzcoa,16,Aia,1750,975,775
20,Guipúzcoa,3,Aizarnazabal,629,353,276
20,Guipúzcoa,4,Albiztur,298,160,138
20,Guipúzcoa,5,Alegia,1646,842,804
20,Guipúzcoa,6,Alkiza,301,170,131
20,Guipúzcoa,906,Altzaga,154,77,77
20,Guipúzcoa,7,Altzo,359,190,169
20,Guipúzcoa,8,Amezketa,969,495,474
20,Guipúzcoa,9,Andoain,13993,6977,7016
20,Guipúzcoa,10,Anoeta,1784,922,862
20,Guipúzcoa,11,Antzuola,2041,1044,997
20,Guipúzcoa,12,Arama,164,80,84
20,Guipúzcoa,13,Aretxabaleta,6320,3203,3117
20,Guipúzcoa,55,Arrasate/Mondragón,22611,11316,11295
20,Guipúzcoa,14,Asteasu,1394,746,648
20,Guipúzcoa,903,Astigarraga,4151,2105,2046
20,Guipúzcoa,15,Ataun,1531,804,727
20,Guipúzcoa,17,Azkoitia,10492,5230,5262
20,Guipúzcoa,18,Azpeitia,13884,6967,6917
20,Guipúzcoa,904,Baliarrain,96,51,45
20,Guipúzcoa,19,Beasain,12586,6308,6278
20,Guipúzcoa,20,Beizama,173,101,72
20,Guipúzcoa,21,Belauntza,289,160,129
20,Guipúzcoa,22,Berastegi,995,540,455
20,Guipúzcoa,74,Bergara,14879,7456,7423
20,Guipúzcoa,23,Berrobi,560,295,265
20,Guipúzcoa,24,Bidegoian,457,253,204
20,Guipúzcoa,29,Deba,5274,2680,2594
20,Guipúzcoa,69,Donostia-San Sebastián,182930,86108,96822
20,Guipúzcoa,30,Eibar,27784,13576,14208
20,Guipúzcoa,31,Elduain,212,111,101
20,Guipúzcoa,33,Elgeta,1027,528,499
20,Guipúzcoa,32,Elgoibar,10538,5267,5271
20,Guipúzcoa,67,Errenteria,37873,18578,19295
20,Guipúzcoa,66,Errezil,607,320,287
20,Guipúzcoa,34,Eskoriatza,3894,1994,1900
20,Guipúzcoa,35,Ezkio-Itsaso,572,299,273
20,Guipúzcoa,38,Gabiria,420,225,195
20,Guipúzcoa,37,Gaintza,122,73,49
20,Guipúzcoa,907,Gaztelu,151,88,63
20,Guipúzcoa,39,Getaria,2546,1273,1273
20,Guipúzcoa,40,Hernani,18827,9297,9530
20,Guipúzcoa,41,Hernialde,326,163,163
20,Guipúzcoa,36,Hondarribia,15940,8044,7896
20,Guipúzcoa,42,Ibarra,4306,2218,2088
20,Guipúzcoa,43,Idiazabal,2162,1091,1071
20,Guipúzcoa,44,Ikaztegieta,394,204,190
20,Guipúzcoa,45,Irun,59508,29226,30282
20,Guipúzcoa,46,Irura,1113,586,527
20,Guipúzcoa,47,Itsasondo,565,295,270
20,Guipúzcoa,48,Larraul,177,96,81
20,Guipúzcoa,902,Lasarte-Oria,17646,8802,8844
20,Guipúzcoa,49,Lazkao,5113,2627,2486
20,Guipúzcoa,50,Leaburu,364,199,165
20,Guipúzcoa,51,Legazpi,8665,4414,4251
20,Guipúzcoa,52,Legorreta,1375,709,666
20,Guipúzcoa,68,Leintz-Gatzaga,250,137,113
20,Guipúzcoa,53,Lezo,5911,2946,2965
20,Guipúzcoa,54,Lizartza,613,323,290
20,Guipúzcoa,901,Mendaro,1679,879,800
20,Guipúzcoa,57,Mutiloa,168,90,78
20,Guipúzcoa,56,Mutriku,4752,2374,2378
20,Guipúzcoa,63,Oiartzun,9730,4876,4854
20,Guipúzcoa,58,Olaberria,918,465,453
20,Guipúzcoa,59,Oñati,10711,5342,5369
20,Guipúzcoa,76,Ordizia,9025,4399,4626
20,Guipúzcoa,905,Orendain,165,89,76
20,Guipúzcoa,60,Orexa,89,51,38
20,Guipúzcoa,61,Orio,4640,2343,2297
20,Guipúzcoa,62,Ormaiztegi,1249,665,584
20,Guipúzcoa,64,Pasaia,16116,7853,8263
20,Guipúzcoa,70,Segura,1230,612,618
20,Guipúzcoa,65,Soraluze/Placencia de las Armas,4148,2053,2095
20,Guipúzcoa,71,Tolosa,17829,8619,9210
20,Guipúzcoa,72,Urnieta,5847,2987,2860
20,Guipúzcoa,77,Urretxu,6723,3407,3316
20,Guipúzcoa,73,Usurbil,5661,2916,2745
20,Guipúzcoa,75,Villabona,5745,2915,2830
20,Guipúzcoa,78,Zaldibia,1477,766,711
20,Guipúzcoa,79,Zarautz,22056,10915,11141
20,Guipúzcoa,25,Zegama,1303,670,633
20,Guipúzcoa,26,Zerain,243,124,119
20,Guipúzcoa,27,Zestoa,3220,1659,1561
20,Guipúzcoa,28,Zizurkil,2828,1450,1378
20,Guipúzcoa,81,Zumaia,8739,4364,4375
20,Guipúzcoa,80,Zumarraga,10070,5051,5019
21,Huelva,1,Alájar,771,402,369
21,Huelva,2,Aljaraque,14846,7458,7388
21,Huelva,3,Almendro (El),831,436,395
21,Huelva,4,Almonaster la Real,1805,899,906
21,Huelva,5,Almonte,19641,9989,9652
21,Huelva,6,Alosno,4514,2178,2336
21,Huelva,7,Aracena,7152,3497,3655
21,Huelva,8,Aroche,3319,1634,1685
21,Huelva,9,Arroyomolinos de León,1078,549,529
21,Huelva,10,Ayamonte,18001,8927,9074
21,Huelva,11,Beas,4162,2081,2081
21,Huelva,12,Berrocal,371,180,191
21,Huelva,13,Bollullos Par del Condado,13335,6670,6665
21,Huelva,14,Bonares,5310,2728,2582
21,Huelva,15,Cabezas Rubias,873,458,415
21,Huelva,16,Cala,1324,674,650
21,Huelva,17,Calañas,4478,2216,2262
21,Huelva,18,Campillo (El),2318,1121,1197
21,Huelva,19,Campofrío,810,401,409
21,Huelva,20,Cañaveral de León,419,202,217
21,Huelva,21,Cartaya,15480,8052,7428
21,Huelva,22,Castaño del Robledo,205,111,94
21,Huelva,23,Cerro de Andévalo (El),2636,1270,1366
21,Huelva,30,Chucena,2044,1028,1016
21,Huelva,24,Corteconcepción,620,312,308
21,Huelva,25,Cortegana,4952,2459,2493
21,Huelva,26,Cortelazor,289,142,147
21,Huelva,27,Cumbres de Enmedio,47,28,19
21,Huelva,28,Cumbres de San Bartolomé,500,242,258
21,Huelva,29,Cumbres Mayores,2022,1005,1017
21,Huelva,31,Encinasola,1686,833,853
21,Huelva,32,Escacena del Campo,2182,1080,1102
21,Huelva,33,Fuenteheridos,630,321,309
21,Huelva,34,Galaroza,1642,809,833
21,Huelva,35,Gibraleón,11202,5651,5551
21,Huelva,36,Granada de Río-Tinto (La),228,120,108
21,Huelva,37,Granado (El),624,345,279
21,Huelva,38,Higuera de la Sierra,1348,674,674
21,Huelva,39,Hinojales,381,196,185
21,Huelva,40,Hinojos,3726,1878,1848
21,Huelva,41,Huelva,145150,70442,74708
21,Huelva,42,Isla Cristina,19875,9990,9885
21,Huelva,43,Jabugo,2475,1226,1249
21,Huelva,44,Lepe,22709,11729,10980
21,Huelva,45,Linares de la Sierra,295,140,155
21,Huelva,46,Lucena del Puerto,2283,1191,1092
21,Huelva,47,Manzanilla,2384,1194,1190
21,Huelva,48,Marines (Los),329,162,167
21,Huelva,49,Minas de Riotinto,4478,2159,2319
21,Huelva,50,Moguer,16961,8845,8116
21,Huelva,51,Nava (La),275,145,130
21,Huelva,52,Nerva,5936,2864,3072
21,Huelva,53,Niebla,3953,1997,1956
21,Huelva,54,Palma del Condado (La),9925,4943,4982
21,Huelva,55,Palos de la Frontera,8181,4257,3924
21,Huelva,56,Paterna del Campo,3729,1894,1835
21,Huelva,57,Paymogo,1290,637,653
21,Huelva,58,Puebla de Guzmán,3109,1586,1523
21,Huelva,59,Puerto Moral,262,137,125
21,Huelva,60,Punta Umbría,13736,6991,6745
21,Huelva,61,Rociana del Condado,6533,3366,3167
21,Huelva,62,Rosal de la Frontera,1817,889,928
21,Huelva,63,San Bartolomé de la Torre,3030,1536,1494
21,Huelva,64,San Juan del Puerto,6881,3452,3429
21,Huelva,66,San Silvestre de Guzmán,626,325,301
21,Huelva,65,Sanlúcar de Guadiana,379,189,190
21,Huelva,67,Santa Ana la Real,502,233,269
21,Huelva,68,Santa Bárbara de Casa,1203,603,600
21,Huelva,69,Santa Olalla del Cala,2143,1081,1062
21,Huelva,70,Trigueros,7260,3638,3622
21,Huelva,71,Valdelarco,241,118,123
21,Huelva,72,Valverde del Camino,12554,6105,6449
21,Huelva,73,Villablanca,2324,1229,1095
21,Huelva,74,Villalba del Alcor,3422,1707,1715
21,Huelva,75,Villanueva de las Cruces,410,192,218
21,Huelva,76,Villanueva de los Castillejos,2720,1372,1348
21,Huelva,77,Villarrasa,2095,1059,1036
21,Huelva,78,Zalamea la Real,3547,1756,1791
21,Huelva,79,Zufre,968,507,461
22,Huesca,1,Abiego,277,150,127
22,Huesca,2,Abizanda,128,60,68
22,Huesca,3,Adahuesca,162,83,79
22,Huesca,4,Agüero,165,87,78
22,Huesca,907,Aínsa-Sobrarbe,1826,958,868
22,Huesca,6,Aisa,411,231,180
22,Huesca,7,Albalate de Cinca,1189,639,550
22,Huesca,8,Albalatillo,265,135,130
22,Huesca,9,Albelda,877,450,427
22,Huesca,11,Albero Alto,122,66,56
22,Huesca,12,Albero Bajo,96,51,45
22,Huesca,13,Alberuela de Tubo,370,189,181
22,Huesca,14,Alcalá de Gurrea,282,140,142
22,Huesca,15,Alcalá del Obispo,364,193,171
22,Huesca,16,Alcampell,846,415,431
22,Huesca,17,Alcolea de Cinca,1252,661,591
22,Huesca,18,Alcubierre,437,238,199
22,Huesca,19,Alerre,228,114,114
22,Huesca,20,Alfántega,120,62,58
22,Huesca,21,Almudévar,2395,1239,1156
22,Huesca,22,Almunia de San Juan,650,333,317
22,Huesca,23,Almuniente,570,286,284
22,Huesca,24,Alquézar,312,165,147
22,Huesca,25,Altorricón,1462,787,675
22,Huesca,27,Angüés,417,227,190
22,Huesca,28,Ansó,525,257,268
22,Huesca,29,Antillón,163,81,82
22,Huesca,32,Aragüés del Puerto,150,83,67
22,Huesca,35,Arén,353,178,175
22,Huesca,36,Argavieso,135,74,61
22,Huesca,37,Arguis,80,42,38
22,Huesca,39,Ayerbe,1097,559,538
22,Huesca,40,Azanuy-Alins,180,89,91
22,Huesca,41,Azara,197,99,98
22,Huesca,42,Azlor,150,77,73
22,Huesca,43,Baélls,128,74,54
22,Huesca,44,Bailo,246,146,100
22,Huesca,45,Baldellou,130,70,60
22,Huesca,46,Ballobar,1008,510,498
22,Huesca,47,Banastás,241,126,115
22,Huesca,48,Barbastro,15778,7762,8016
22,Huesca,49,Barbués,109,57,52
22,Huesca,50,Barbuñales,112,55,57
22,Huesca,51,Bárcabo,104,59,45
22,Huesca,52,Belver de Cinca,1386,745,641
22,Huesca,53,Benabarre,1114,593,521
22,Huesca,54,Benasque,2088,1128,960
22,Huesca,55,Berbegal,466,235,231
22,Huesca,57,Bielsa,499,260,239
22,Huesca,58,Bierge,244,137,107
22,Huesca,59,Biescas,1485,807,678
22,Huesca,60,Binaced,1625,889,736
22,Huesca,61,Binéfar,8890,4625,4265
22,Huesca,62,Bisaurri,248,132,116
22,Huesca,63,Biscarrués,215,110,105
22,Huesca,64,Blecua y Torres,191,111,80
22,Huesca,66,Boltaña,917,484,433
22,Huesca,67,Bonansa,105,56,49
22,Huesca,68,Borau,72,41,31
22,Huesca,69,Broto,528,272,256
22,Huesca,72,Caldearenas,252,147,105
22,Huesca,74,Campo,291,137,154
22,Huesca,75,Camporrélls,233,127,106
22,Huesca,76,Canal de Berdún,414,228,186
22,Huesca,77,Candasnos,459,241,218
22,Huesca,78,Canfranc,611,346,265
22,Huesca,79,Capdesaso,157,75,82
22,Huesca,80,Capella,399,205,194
22,Huesca,81,Casbas de Huesca,294,155,139
22,Huesca,83,Castejón de Monegros,656,334,322
22,Huesca,84,Castejón de Sos,755,407,348
22,Huesca,82,Castejón del Puente,423,222,201
22,Huesca,85,Castelflorite,131,66,65
22,Huesca,86,Castiello de Jaca,219,122,97
22,Huesca,87,Castigaleu,115,66,49
22,Huesca,88,Castillazuelo,227,107,120
22,Huesca,89,Castillonroy,406,193,213
22,Huesca,94,Chalamera,147,81,66
22,Huesca,95,Chía,118,62,56
22,Huesca,96,Chimillas,304,156,148
22,Huesca,90,Colungo,135,68,67
22,Huesca,99,Esplús,750,375,375
22,Huesca,102,Estada,212,117,95
22,Huesca,103,Estadilla,877,432,445
22,Huesca,105,Estopiñán del Castillo,210,115,95
22,Huesca,106,Fago,37,21,16
22,Huesca,107,Fanlo,171,105,66
22,Huesca,109,Fiscal,272,155,117
22,Huesca,110,Fonz,1082,543,539
22,Huesca,111,Foradada del Toscar,220,112,108
22,Huesca,112,Fraga,13284,6916,6368
22,Huesca,113,Fueva (La),614,315,299
22,Huesca,114,Gistaín,160,88,72
22,Huesca,115,Grado (El),517,276,241
22,Huesca,116,Grañén,1990,1026,964
22,Huesca,117,Graus,3424,1757,1667
22,Huesca,119,Gurrea de Gállego,1761,915,846
22,Huesca,122,Hoz de Jaca,74,36,38
22,Huesca,908,Hoz y Costean,233,129,104
22,Huesca,124,Huerto,249,134,115
22,Huesca,125,Huesca,48530,23485,25045
22,Huesca,126,Ibieca,114,60,54
22,Huesca,127,Igriés,415,215,200
22,Huesca,128,Ilche,263,141,122
22,Huesca,129,Isábena,281,145,136
22,Huesca,130,Jaca,12553,6257,6296
22,Huesca,131,Jasa,124,73,51
22,Huesca,133,Labuerda,171,95,76
22,Huesca,135,Laluenga,247,135,112
22,Huesca,136,Lalueza,1142,592,550
22,Huesca,137,Lanaja,1478,772,706
22,Huesca,139,Laperdiguera,105,55,50
22,Huesca,141,Lascellas-Ponzano,166,87,79
22,Huesca,142,Lascuarre,147,74,73
22,Huesca,143,Laspaúles,282,160,122
22,Huesca,144,Laspuña,276,143,133
22,Huesca,149,Loarre,393,210,183
22,Huesca,150,Loporzano,528,292,236
22,Huesca,151,Loscorrales,114,63,51
22,Huesca,905,Lupiñén-Ortilla,343,189,154
22,Huesca,155,Monesma y Cajigar,109,58,51
22,Huesca,156,Monflorite-Lascasas,229,130,99
22,Huesca,157,Montanuy,308,179,129
22,Huesca,158,Monzón,15806,8060,7746
22,Huesca,160,Naval,302,148,154
22,Huesca,162,Novales,191,99,92
22,Huesca,163,Nueno,433,244,189
22,Huesca,164,Olvena,67,32,35
22,Huesca,165,Ontiñena,621,315,306
22,Huesca,167,Osso de Cinca,758,428,330
22,Huesca,168,Palo,37,24,13
22,Huesca,170,Panticosa,731,370,361
22,Huesca,172,Peñalba,727,370,357
22,Huesca,173,Peñas de Riglos (Las),297,173,124
22,Huesca,174,Peralta de Alcofea,667,333,334
22,Huesca,175,Peralta de Calasanz,265,151,114
22,Huesca,176,Peraltilla,177,97,80
22,Huesca,177,Perarrúa,117,58,59
22,Huesca,178,Pertusa,131,72,59
22,Huesca,181,Piracés,106,66,40
22,Huesca,182,Plan,319,163,156
22,Huesca,184,Poleñino,246,126,120
22,Huesca,186,Pozán de Vero,257,126,131
22,Huesca,187,Puebla de Castro (La),373,194,179
22,Huesca,188,Puente de Montañana,99,49,50
22,Huesca,902,Puente la Reina de Jaca,239,126,113
22,Huesca,189,Puértolas,230,129,101
22,Huesca,190,Pueyo de Araguás (El),160,96,64
22,Huesca,193,Pueyo de Santa Cruz,334,170,164
22,Huesca,195,Quicena,228,117,111
22,Huesca,197,Robres,659,344,315
22,Huesca,199,Sabiñánigo,9023,4551,4472
22,Huesca,200,Sahún,233,124,109
22,Huesca,201,Salas Altas,349,185,164
22,Huesca,202,Salas Bajas,151,69,82
22,Huesca,203,Salillas,120,63,57
22,Huesca,204,Sallent de Gállego,1316,668,648
22,Huesca,205,San Esteban de Litera,541,273,268
22,Huesca,207,San Juan de Plan,149,80,69
22,Huesca,903,San Miguel del Cinca,878,455,423
22,Huesca,206,Sangarrén,263,129,134
22,Huesca,208,Santa Cilia,189,105,84
22,Huesca,209,Santa Cruz de la Serós,151,90,61
22,Huesca,906,Santa María de Dulcis,214,109,105
22,Huesca,212,Santaliestra y San Quílez,114,59,55
22,Huesca,213,Sariñena,4021,2065,1956
22,Huesca,214,Secastilla,142,64,78
22,Huesca,215,Seira,173,87,86
22,Huesca,217,Sena,552,311,241
22,Huesca,218,Senés de Alcubierre,50,27,23
22,Huesca,220,Sesa,241,128,113
22,Huesca,221,Sesué,124,72,52
22,Huesca,222,Siétamo,551,304,247
22,Huesca,223,Sopeira,98,50,48
22,Huesca,904,Sotonera (La),1085,575,510
22,Huesca,225,Tamarite de Litera,3655,1841,1814
22,Huesca,226,Tardienta,1069,562,507
22,Huesca,227,Tella-Sin,272,138,134
22,Huesca,228,Tierz,403,196,207
22,Huesca,229,Tolva,183,96,87
22,Huesca,230,Torla,318,170,148
22,Huesca,232,Torralba de Aragón,122,65,57
22,Huesca,233,Torre la Ribera,119,67,52
22,Huesca,234,Torrente de Cinca,1047,547,500
22,Huesca,235,Torres de Alcanadre,124,66,58
22,Huesca,236,Torres de Barbués,321,158,163
22,Huesca,239,Tramaced,107,62,45
22,Huesca,242,Valfarta,100,56,44
22,Huesca,243,Valle de Bardají,54,29,25
22,Huesca,901,Valle de Hecho,973,506,467
22,Huesca,244,Valle de Lierp,49,26,23
22,Huesca,245,Velilla de Cinca,456,234,222
22,Huesca,909,Vencillón,435,232,203
22,Huesca,246,Veracruz,112,61,51
22,Huesca,247,Viacamp y Litera,26,17,9
22,Huesca,248,Vicién,113,62,51
22,Huesca,249,Villanova,122,58,64
22,Huesca,250,Villanúa,435,248,187
22,Huesca,251,Villanueva de Sigena,526,264,262
22,Huesca,252,Yebra de Basa,160,94,66
22,Huesca,253,Yésero,80,49,31
22,Huesca,254,Zaidín,1795,938,857
23,Jaén,1,Albanchez de Mágina,1358,704,654
23,Jaén,2,Alcalá la Real,22038,10919,11119
23,Jaén,3,Alcaudete,11143,5521,5622
23,Jaén,4,Aldeaquemada,545,289,256
23,Jaén,5,Andújar,38539,18977,19562
23,Jaén,6,Arjona,5759,2876,2883
23,Jaén,7,Arjonilla,3926,1952,1974
23,Jaén,8,Arquillos,1981,993,988
23,Jaén,905,Arroyo del Ojanco,2533,1302,1231
23,Jaén,9,Baeza,15880,7882,7998
23,Jaén,10,Bailén,18202,9303,8899
23,Jaén,11,Baños de la Encina,2738,1427,1311
23,Jaén,12,Beas de Segura,5456,2805,2651
23,Jaén,902,Bedmar y Garcíez,3210,1625,1585
23,Jaén,14,Begíjar,3109,1580,1529
23,Jaén,15,Bélmez de la Moraleda,1937,1009,928
23,Jaén,16,Benatae,596,342,254
23,Jaén,17,Cabra del Santo Cristo,2246,1184,1062
23,Jaén,18,Cambil,3024,1578,1446
23,Jaén,19,Campillo de Arenas,2026,1032,994
23,Jaén,20,Canena,2092,1015,1077
23,Jaén,21,Carboneros,680,353,327
23,Jaén,901,Cárcheles,1479,753,726
23,Jaén,24,Carolina (La),15545,7654,7891
23,Jaén,25,Castellar,3773,1952,1821
23,Jaén,26,Castillo de Locubín,5004,2481,2523
23,Jaén,27,Cazalilla,833,434,399
23,Jaén,28,Cazorla,8190,4010,4180
23,Jaén,29,Chiclana de Segura,1194,592,602
23,Jaén,30,Chilluévar,1676,823,853
23,Jaén,31,Escañuela,956,475,481
23,Jaén,32,Espelúy,769,387,382
23,Jaén,33,Frailes,1801,912,889
23,Jaén,34,Fuensanta de Martos,3312,1661,1651
23,Jaén,35,Fuerte del Rey,1259,630,629
23,Jaén,37,Génave,579,302,277
23,Jaén,38,Guardia de Jaén (La),2811,1471,1340
23,Jaén,39,Guarromán,2909,1437,1472
23,Jaén,41,Higuera de Calatrava,702,367,335
23,Jaén,42,Hinojares,467,226,241
23,Jaén,43,Hornos,657,330,327
23,Jaén,44,Huelma,6180,3170,3010
23,Jaén,45,Huesa,2727,1371,1356
23,Jaén,46,Ibros,3148,1584,1564
23,Jaén,47,Iruela (La),1894,951,943
23,Jaén,48,Iznatoraf,1188,625,563
23,Jaén,49,Jabalquinto,2420,1220,1200
23,Jaén,50,Jaén,116540,56330,60210
23,Jaén,51,Jamilena,3429,1732,1697
23,Jaén,52,Jimena,1478,715,763
23,Jaén,53,Jódar,12153,6058,6095
23,Jaén,40,Lahiguera,1890,940,950
23,Jaén,54,Larva,474,245,229
23,Jaén,55,Linares,60807,29789,31018
23,Jaén,56,Lopera,3976,1956,2020
23,Jaén,57,Lupión,1012,494,518
23,Jaén,58,Mancha Real,10187,5206,4981
23,Jaén,59,Marmolejo,7605,3828,3777
23,Jaén,60,Martos,23804,11669,12135
23,Jaén,61,Mengíbar,9048,4579,4469
23,Jaén,62,Montizón,1989,1023,966
23,Jaén,63,Navas de San Juan,5083,2530,2553
23,Jaén,64,Noalejo,2155,1080,1075
23,Jaén,65,Orcera,2117,1060,1057
23,Jaén,66,Peal de Becerro,5470,2745,2725
23,Jaén,67,Pegalajar,3136,1607,1529
23,Jaén,69,Porcuna,6915,3461,3454
23,Jaén,70,Pozo Alcón,5437,2791,2646
23,Jaén,71,Puente de Génave,2119,1053,1066
23,Jaén,72,Puerta de Segura (La),2646,1333,1313
23,Jaén,73,Quesada,5964,2947,3017
23,Jaén,74,Rus,3784,1929,1855
23,Jaén,75,Sabiote,4131,2104,2027
23,Jaén,76,Santa Elena,1008,537,471
23,Jaén,77,Santiago de Calatrava,862,440,422
23,Jaén,904,Santiago-Pontones,4131,2107,2024
23,Jaén,79,Santisteban del Puerto,4840,2505,2335
23,Jaén,80,Santo Tomé,2287,1167,1120
23,Jaén,81,Segura de la Sierra,1771,887,884
23,Jaén,82,Siles,2477,1253,1224
23,Jaén,84,Sorihuela del Guadalimar,1258,679,579
23,Jaén,86,Torre del Campo,13961,7044,6917
23,Jaén,85,Torreblascopedro,2866,1431,1435
23,Jaén,87,Torredonjimeno,13957,6868,7089
23,Jaén,88,Torreperogil,6813,3350,3463
23,Jaén,90,Torres,1725,896,829
23,Jaén,91,Torres de Albánchez,923,464,459
23,Jaén,92,Úbeda,33993,16663,17330
23,Jaén,93,Valdepeñas de Jaén,4315,2151,2164
23,Jaén,94,Vilches,4940,2501,2439
23,Jaén,95,Villacarrillo,10902,5509,5393
23,Jaén,96,Villanueva de la Reina,3352,1676,1676
23,Jaén,97,Villanueva del Arzobispo,8768,4497,4271
23,Jaén,98,Villardompardo,1172,594,578
23,Jaén,99,Villares (Los),5289,2638,2651
23,Jaén,101,Villarrodrigo,510,254,256
23,Jaén,903,Villatorres,4324,2240,2084
24,León,1,Acebedo,273,153,120
24,León,2,Algadefe,323,158,165
24,León,3,Alija del Infantado,883,448,435
24,León,4,Almanza,642,356,286
24,León,5,Antigua (La),547,297,250
24,León,6,Ardón,666,360,306
24,León,7,Arganza,853,434,419
24,León,8,Astorga,12275,5816,6459
24,León,9,Balboa,393,209,184
24,León,10,Bañeza (La),10123,4922,5201
24,León,11,Barjas,343,184,159
24,León,12,Barrios de Luna (Los),326,164,162
24,León,14,Bembibre,10059,4969,5090
24,León,15,Benavides,2921,1474,1447
24,León,16,Benuza,707,366,341
24,León,17,Bercianos del Páramo,783,400,383
24,León,18,Bercianos del Real Camino,215,105,110
24,León,19,Berlanga del Bierzo,409,194,215
24,León,20,Boca de Huérgano,566,315,251
24,León,21,Boñar,2319,1133,1186
24,León,22,Borrenes,459,229,230
24,León,23,Brazuelo,356,187,169
24,León,24,Burgo Ranero (El),900,472,428
24,León,25,Burón,379,204,175
24,León,26,Bustillo del Páramo,1624,830,794
24,León,27,Cabañas Raras,1255,646,609
24,León,28,Cabreros del Río,522,277,245
24,León,29,Cabrillanes,986,505,481
24,León,30,Cacabelos,5215,2626,2589
24,León,31,Calzada del Coto,289,161,128
24,León,32,Campazas,166,87,79
24,León,33,Campo de Villavidel,280,141,139
24,León,34,Camponaraya,3664,1801,1863
24,León,36,Candín,381,205,176
24,León,37,Cármenes,401,210,191
24,León,38,Carracedelo,3548,1729,1819
24,León,39,Carrizo,2695,1348,1347
24,León,40,Carrocera,580,278,302
24,León,41,Carucedo,644,314,330
24,León,42,Castilfalé,84,45,39
24,León,43,Castrillo de Cabrera,162,80,82
24,León,44,Castrillo de la Valduerna,205,91,114
24,León,46,Castrocalbón,1227,636,591
24,León,47,Castrocontrigo,1048,516,532
24,León,49,Castropodame,1848,935,913
24,León,50,Castrotierra de Valmadrigal,132,65,67
24,León,51,Cea,646,342,304
24,León,52,Cebanico,220,121,99
24,León,53,Cebrones del Río,643,333,310
24,León,65,Chozas de Abajo,2114,1065,1049
24,León,54,Cimanes de la Vega,599,302,297
24,León,55,Cimanes del Tejar,885,438,447
24,León,56,Cistierna,3863,1884,1979
24,León,57,Congosto,1743,838,905
24,León,58,Corbillos de los Oteros,281,145,136
24,León,59,Corullón,1120,569,551
24,León,60,Crémenes,740,372,368
24,León,61,Cuadros,1835,900,935
24,León,62,Cubillas de los Oteros,203,109,94
24,León,63,Cubillas de Rueda,564,291,273
24,León,64,Cubillos del Sil,1462,762,700
24,León,66,Destriana,705,330,375
24,León,67,Encinedo,948,486,462
24,León,68,Ercina (La),650,325,325
24,León,69,Escobar de Campos,71,42,29
24,León,70,Fabero,5282,2610,2672
24,León,71,Folgoso de la Ribera,1294,618,676
24,León,73,Fresno de la Vega,611,312,299
24,León,74,Fuentes de Carbajal,129,69,60
24,León,76,Garrafe de Torío,1183,610,573
24,León,77,Gordaliza del Pino,321,163,158
24,León,78,Gordoncillo,560,268,292
24,León,79,Gradefes,1166,585,581
24,León,80,Grajal de Campos,288,124,164
24,León,81,Gusendos de los Oteros,178,94,84
24,León,82,Hospital de Órbigo,1051,516,535
24,León,83,Igüeña,1636,851,785
24,León,84,Izagre,235,112,123
24,León,86,Joarilla de las Matas,393,207,186
24,León,87,Laguna Dalga,859,442,417
24,León,88,Laguna de Negrillos,1335,671,664
24,León,89,León,136414,63124,73290
24,León,92,Llamas de la Ribera,1088,549,539
24,León,90,Lucillo,474,238,236
24,León,91,Luyego,848,411,437
24,León,93,Magaz de Cepeda,457,223,234
24,León,94,Mansilla de las Mulas,1888,919,969
24,León,95,Mansilla Mayor,383,193,190
24,León,96,Maraña,163,86,77
24,León,97,Matadeón de los Oteros,285,154,131
24,León,98,Matallana de Torío,1491,751,740
24,León,99,Matanza,263,133,130
24,León,100,Molinaseca,762,401,361
24,León,101,Murias de Paredes,574,266,308
24,León,102,Noceda del Bierzo,834,412,422
24,León,103,Oencia,486,257,229
24,León,104,Omañas (Las),359,187,172
24,León,105,Onzonilla,1588,810,778
24,León,106,Oseja de Sajambre,300,169,131
24,León,107,Pajares de los Oteros,362,198,164
24,León,108,Palacios de la Valduerna,495,235,260
24,León,109,Palacios del Sil,1339,692,647
24,León,110,Páramo del Sil,1534,789,745
24,León,112,Peranzanes,316,183,133
24,León,113,Pobladura de Pelayo García,521,266,255
24,León,114,Pola de Gordón (La),4333,2139,2194
24,León,115,Ponferrada,65984,31934,34050
24,León,116,Posada de Valdeón,536,307,229
24,León,117,Pozuelo del Páramo,540,274,266
24,León,118,Prado de la Guzpeña,136,72,64
24,León,119,Priaranza del Bierzo,903,436,467
24,León,120,Prioro,433,230,203
24,León,121,Puebla de Lillo,661,346,315
24,León,122,Puente de Domingo Flórez,1869,991,878
24,León,123,Quintana del Castillo,1006,526,480
24,León,124,Quintana del Marco,505,258,247
24,León,125,Quintana y Congosto,678,350,328
24,León,127,Regueras de Arriba,369,192,177
24,León,129,Reyero,137,70,67
24,León,130,Riaño,539,314,225
24,León,131,Riego de la Vega,1006,497,509
24,León,132,Riello,821,425,396
24,León,133,Rioseco de Tapia,486,253,233
24,León,134,Robla (La),4723,2321,2402
24,León,136,Roperuelos del Páramo,749,373,376
24,León,137,Sabero,1548,749,799
24,León,139,Sahagún,2937,1438,1499
24,León,141,San Adrián del Valle,131,61,70
24,León,142,San Andrés del Rabanedo,27850,13567,14283
24,León,144,San Cristóbal de la Polantera,953,467,486
24,León,145,San Emiliano,752,395,357
24,León,146,San Esteban de Nogales,334,162,172
24,León,148,San Justo de la Vega,2113,1075,1038
24,León,149,San Millán de los Caballeros,174,87,87
24,León,150,San Pedro Bercianos,338,173,165
24,León,143,Sancedo,564,285,279
24,León,151,Santa Colomba de Curueño,633,312,321
24,León,152,Santa Colomba de Somoza,495,251,244
24,León,153,Santa Cristina de Valmadrigal,325,176,149
24,León,154,Santa Elena de Jamuz,1350,686,664
24,León,155,Santa María de la Isla,640,331,309
24,León,158,Santa María de Ordás,368,183,185
24,León,156,Santa María del Monte de Cea,333,169,164
24,León,157,Santa María del Páramo,3158,1557,1601
24,León,159,Santa Marina del Rey,2295,1140,1155
24,León,160,Santas Martas,921,465,456
24,León,161,Santiago Millas,339,177,162
24,León,162,Santovenia de la Valdoncina,1845,927,918
24,León,163,Sariegos,3570,1814,1756
24,León,164,Sena de Luna,440,214,226
24,León,165,Sobrado,470,236,234
24,León,166,Soto de la Vega,1942,990,952
24,León,167,Soto y Amío,1011,494,517
24,León,168,Toral de los Guzmanes,675,353,322
24,León,169,Toreno,3793,1881,1912
24,León,170,Torre del Bierzo,2778,1386,1392
24,León,171,Trabadelo,523,277,246
24,León,172,Truchas,648,304,344
24,León,173,Turcia,1223,599,624
24,León,174,Urdiales del Páramo,586,301,285
24,León,185,Val de San Lorenzo,672,335,337
24,León,175,Valdefresno,1936,1010,926
24,León,176,Valdefuentes del Páramo,380,201,179
24,León,177,Valdelugueros,460,259,201
24,León,178,Valdemora,95,42,53
24,León,179,Valdepiélago,421,212,209
24,León,180,Valdepolo,1463,763,700
24,León,181,Valderas,2079,1050,1029
24,León,182,Valderrey,564,273,291
24,León,183,Valderrueda,1113,580,533
24,León,184,Valdesamario,222,113,109
24,León,187,Valdevimbre,1156,591,565
24,León,188,Valencia de Don Juan,4357,2144,2213
24,León,191,Vallecillo,140,76,64
24,León,189,Valverde de la Virgen,5034,2516,2518
24,León,190,Valverde-Enrique,212,114,98
24,León,193,Vecilla (La),439,231,208
24,León,196,Vega de Espinareda,2704,1354,1350
24,León,197,Vega de Infanzones,884,440,444
24,León,198,Vega de Valcarce,766,385,381
24,León,194,Vegacervera,309,165,144
24,León,199,Vegaquemada,483,245,238
24,León,201,Vegas del Condado,1335,707,628
24,León,202,Villablino,11904,5929,5975
24,León,203,Villabraz,143,76,67
24,León,205,Villadangos del Páramo,1024,514,510
24,León,206,Villadecanes,2184,1077,1107
24,León,207,Villademor de la Vega,437,229,208
24,León,209,Villafranca del Bierzo,3710,1821,1889
24,León,210,Villagatón,719,361,358
24,León,211,Villamandos,362,178,184
24,León,901,Villamanín,1161,587,574
24,León,212,Villamañán,1287,633,654
24,León,213,Villamartín de Don Sancho,161,87,74
24,León,214,Villamejil,889,449,440
24,León,215,Villamol,220,111,109
24,León,216,Villamontán de la Valduerna,991,514,477
24,León,217,Villamoratiel de las Matas,173,101,72
24,León,218,Villanueva de las Manzanas,553,270,283
24,León,219,Villaobispo de Otero,675,337,338
24,León,902,Villaornate y Castro,471,251,220
24,León,221,Villaquejida,1058,553,505
24,León,222,Villaquilambre,12797,6357,6440
24,León,223,Villarejo de Órbigo,3239,1587,1652
24,León,224,Villares de Órbigo,852,440,412
24,León,225,Villasabariego,1255,631,624
24,León,226,Villaselán,273,153,120
24,León,227,Villaturiel,1791,939,852
24,León,228,Villazala,942,489,453
24,León,229,Villazanzo de Valderaduey,634,346,288
24,León,230,Zotes del Páramo,591,313,278
25,Lleida,1,Abella de la Conca,183,99,84
25,Lleida,2,Àger,485,268,217
25,Lleida,3,Agramunt,5355,2833,2522
25,Lleida,38,Aitona,2322,1211,1111
25,Lleida,4,Alamús (Els),734,384,350
25,Lleida,5,Alàs i Cerc,406,225,181
25,Lleida,6,Albagés (L'),491,263,228
25,Lleida,7,Albatàrrec,1444,776,668
25,Lleida,8,Albesa,1561,785,776
25,Lleida,9,Albi (L'),837,433,404
25,Lleida,10,Alcanó,251,127,124
25,Lleida,11,Alcarràs,5241,2641,2600
25,Lleida,12,Alcoletge,2093,1112,981
25,Lleida,13,Alfarràs,3260,1705,1555
25,Lleida,14,Alfés,318,171,147
25,Lleida,15,Algerri,482,241,241
25,Lleida,16,Alguaire,3023,1580,1443
25,Lleida,17,Alins,248,126,122
25,Lleida,19,Almacelles,6056,3173,2883
25,Lleida,20,Almatret,450,239,211
25,Lleida,21,Almenar,3599,1890,1709
25,Lleida,22,Alòs de Balaguer,179,103,76
25,Lleida,23,Alpicat,4984,2486,2498
25,Lleida,24,Alt Àneu,454,258,196
25,Lleida,27,Anglesola,1290,656,634
25,Lleida,29,Arbeca,2484,1265,1219
25,Lleida,31,Arres,67,39,28
25,Lleida,32,Arsèguel,92,46,46
25,Lleida,33,Artesa de Lleida,1414,744,670
25,Lleida,34,Artesa de Segre,3696,1940,1756
25,Lleida,36,Aspa,263,130,133
25,Lleida,37,Avellanes i Santa Linya (Les),467,260,207
25,Lleida,39,Baix Pallars,380,213,167
25,Lleida,40,Balaguer,15281,7686,7595
25,Lleida,41,Barbens,832,458,374
25,Lleida,42,Baronia de Rialb (La),277,150,127
25,Lleida,44,Bassella,261,134,127
25,Lleida,45,Bausen,52,33,19
25,Lleida,46,Belianes,615,319,296
25,Lleida,170,Bellaguarda,360,189,171
25,Lleida,47,Bellcaire d'Urgell,1274,611,663
25,Lleida,48,Bell-lloc d'Urgell,2255,1120,1135
25,Lleida,49,Bellmunt d'Urgell,228,108,120
25,Lleida,50,Bellpuig,4376,2259,2117
25,Lleida,51,Bellver de Cerdanya,1809,953,856
25,Lleida,52,Bellvís,2294,1184,1110
25,Lleida,53,Benavent de Segrià,1217,629,588
25,Lleida,55,Biosca,235,120,115
25,Lleida,57,Bòrdes (Es),235,117,118
25,Lleida,58,Borges Blanques (Les),5519,2799,2720
25,Lleida,59,Bossòst,1021,533,488
25,Lleida,56,Bovera,377,191,186
25,Lleida,60,Cabanabona,122,57,65
25,Lleida,61,Cabó,108,61,47
25,Lleida,62,Camarasa,926,474,452
25,Lleida,63,Canejan,107,56,51
25,Lleida,904,Castell de Mur,173,91,82
25,Lleida,64,Castellar de la Ribera,158,76,82
25,Lleida,67,Castelldans,991,533,458
25,Lleida,68,Castellnou de Seana,737,385,352
25,Lleida,69,Castelló de Farfanya,583,300,283
25,Lleida,70,Castellserà,1128,577,551
25,Lleida,71,Cava,60,36,24
25,Lleida,72,Cervera,8942,4659,4283
25,Lleida,73,Cervià de les Garrigues,864,450,414
25,Lleida,74,Ciutadilla,235,129,106
25,Lleida,75,Clariana de Cardener,149,78,71
25,Lleida,76,Cogul (El),220,117,103
25,Lleida,77,Coll de Nargó,600,315,285
25,Lleida,163,Coma i la Pedra (La),270,160,110
25,Lleida,161,Conca de Dalt,439,227,212
25,Lleida,78,Corbins,1311,710,601
25,Lleida,79,Cubells,395,201,194
25,Lleida,81,Espluga Calba (L'),448,238,210
25,Lleida,82,Espot,374,207,167
25,Lleida,88,Estamariu,119,64,55
25,Lleida,85,Estaràs,181,100,81
25,Lleida,86,Esterri d'Àneu,773,379,394
25,Lleida,87,Esterri de Cardós,70,33,37
25,Lleida,89,Farrera,105,60,45
25,Lleida,908,Fígols i Alinyà,273,151,122
25,Lleida,92,Floresta (La),184,100,84
25,Lleida,93,Fondarella,786,392,394
25,Lleida,94,Foradada,213,126,87
25,Lleida,96,Fuliola (La),1204,606,598
25,Lleida,97,Fulleda,121,63,58
25,Lleida,98,Gavet de la Conca,313,147,166
25,Lleida,912,Gimenells i el Pla de la Font,1110,581,529
25,Lleida,99,Golmés,1508,749,759
25,Lleida,100,Gósol,223,118,105
25,Lleida,101,Granadella (La),790,408,382
25,Lleida,102,Granja d'Escarp (La),1056,565,491
25,Lleida,103,Granyanella,139,75,64
25,Lleida,105,Granyena de les Garrigues,170,95,75
25,Lleida,104,Granyena de Segarra,138,73,65
25,Lleida,109,Guimerà,360,184,176
25,Lleida,903,Guingueta d'Àneu (La),354,187,167
25,Lleida,110,Guissona,4874,2650,2224
25,Lleida,111,Guixers,144,86,58
25,Lleida,115,Isona i Conca Dellà,1149,630,519
25,Lleida,112,Ivars de Noguera,353,187,166
25,Lleida,113,Ivars d'Urgell,1848,986,862
25,Lleida,114,Ivorra,148,69,79
25,Lleida,910,Josa i Tuixén,170,87,83
25,Lleida,118,Juncosa,551,306,245
25,Lleida,119,Juneda,3222,1674,1548
25,Lleida,121,Les,829,411,418
25,Lleida,122,Linyola,2587,1330,1257
25,Lleida,123,Lladorre,224,114,110
25,Lleida,124,Lladurs,215,112,103
25,Lleida,125,Llardecans,570,295,275
25,Lleida,126,Llavorsí,334,170,164
25,Lleida,120,Lleida,124709,61796,62913
25,Lleida,127,Lles de Cerdanya,237,139,98
25,Lleida,128,Llimiana,168,92,76
25,Lleida,129,Llobera,224,118,106
25,Lleida,133,Maials,961,480,481
25,Lleida,130,Maldà,293,156,137
25,Lleida,131,Massalcoreig,625,337,288
25,Lleida,132,Massoteres,205,113,92
25,Lleida,134,Menàrguens,845,438,407
25,Lleida,135,Miralcamp,1275,635,640
25,Lleida,137,Mollerussa,11829,6130,5699
25,Lleida,136,Molsosa (La),130,63,67
25,Lleida,139,Montellà i Martinet,541,284,257
25,Lleida,140,Montferrer i Castellbò,856,457,399
25,Lleida,138,Montgai,780,395,385
25,Lleida,142,Montoliu de Lleida,491,248,243
25,Lleida,141,Montoliu de Segarra,188,107,81
25,Lleida,143,Montornès de Segarra,107,50,57
25,Lleida,145,Nalec,90,45,45
25,Lleida,25,Naut Aran,1713,913,800
25,Lleida,146,Navès,263,126,137
25,Lleida,148,Odèn,265,150,115
25,Lleida,149,Oliana,1932,985,947
25,Lleida,150,Oliola,254,143,111
25,Lleida,151,Olius,615,314,301
25,Lleida,152,Oluges (Les),178,94,84
25,Lleida,153,Omellons (Els),260,135,125
25,Lleida,154,Omells de na Gaia (Els),161,97,64
25,Lleida,155,Organyà,960,477,483
25,Lleida,156,Os de Balaguer,885,474,411
25,Lleida,157,Ossó de Sió,225,113,112
25,Lleida,158,Palau d'Anglesola (El),1816,925,891
25,Lleida,164,Penelles,523,290,233
25,Lleida,165,Peramola,373,207,166
25,Lleida,166,Pinell de Solsonès,205,110,95
25,Lleida,167,Pinós,313,172,141
25,Lleida,911,Plans de Sió (Els),547,284,263
25,Lleida,168,Poal (El),657,349,308
25,Lleida,169,Pobla de Cérvoles (La),250,136,114
25,Lleida,171,Pobla de Segur (La),3043,1537,1506
25,Lleida,30,Pont de Bar (El),158,83,75
25,Lleida,173,Pont de Suert (El),2307,1191,1116
25,Lleida,172,Ponts,2378,1179,1199
25,Lleida,174,Portella (La),815,460,355
25,Lleida,175,Prats i Sansor,219,129,90
25,Lleida,176,Preixana,427,218,209
25,Lleida,177,Preixens,498,249,249
25,Lleida,179,Prullans,231,119,112
25,Lleida,180,Puiggròs,300,159,141
25,Lleida,181,Puigverd d'Agramunt,260,139,121
25,Lleida,182,Puigverd de Lleida,1195,609,586
25,Lleida,183,Rialp,631,321,310
25,Lleida,905,Ribera d'Ondara,465,245,220
25,Lleida,185,Ribera d'Urgellet,935,499,436
25,Lleida,186,Riner,273,137,136
25,Lleida,913,Riu de Cerdanya,96,49,47
25,Lleida,189,Rosselló,2268,1162,1106
25,Lleida,190,Salàs de Pallars,334,172,162
25,Lleida,191,Sanaüja,464,239,225
25,Lleida,196,Sant Esteve de la Sarga,144,92,52
25,Lleida,192,Sant Guim de Freixenet,1063,534,529
25,Lleida,197,Sant Guim de la Plana,198,106,92
25,Lleida,193,Sant Llorenç de Morunys,969,503,466
25,Lleida,902,Sant Martí de Riucorb,704,372,332
25,Lleida,194,Sant Ramon,561,293,268
25,Lleida,201,Sarroca de Bellera,145,80,65
25,Lleida,200,Sarroca de Lleida,430,218,212
25,Lleida,202,Senterada,113,62,51
25,Lleida,35,Sentiu de Sió (La),486,234,252
25,Lleida,204,Seròs,1900,1080,820
25,Lleida,203,Seu d'Urgell (La),12317,6042,6275
25,Lleida,205,Sidamon,690,356,334
25,Lleida,206,Soleràs (El),403,220,183
25,Lleida,207,Solsona,8571,4387,4184
25,Lleida,208,Soriguera,336,185,151
25,Lleida,209,Sort,2113,1080,1033
25,Lleida,210,Soses,1635,891,744
25,Lleida,211,Sudanell,762,408,354
25,Lleida,212,Sunyer,284,147,137
25,Lleida,215,Talarn,344,171,173
25,Lleida,216,Talavera,282,150,132
25,Lleida,217,Tàrrega,14810,7495,7315
25,Lleida,218,Tarrés,116,56,60
25,Lleida,219,Tarroja de Segarra,169,86,83
25,Lleida,220,Térmens,1503,746,757
25,Lleida,221,Tírvia,124,65,59
25,Lleida,222,Tiurana,46,27,19
25,Lleida,223,Torà,1274,658,616
25,Lleida,224,Torms (Els),193,106,87
25,Lleida,225,Tornabous,793,422,371
25,Lleida,227,Torre de Cabdella (La),732,368,364
25,Lleida,226,Torrebesses,297,150,147
25,Lleida,228,Torrefarrera,2650,1364,1286
25,Lleida,907,Torrefeta i Florejacs,638,323,315
25,Lleida,230,Torregrossa,2311,1168,1143
25,Lleida,231,Torrelameu,590,326,264
25,Lleida,232,Torres de Segre,2007,1041,966
25,Lleida,233,Torre-serona,353,186,167
25,Lleida,234,Tremp,5286,2601,2685
25,Lleida,43,Vall de Boí (La),1053,577,476
25,Lleida,901,Vall de Cardós,363,198,165
25,Lleida,238,Vallbona de les Monges,256,131,125
25,Lleida,240,Vallfogona de Balaguer,1577,791,786
25,Lleida,906,Valls d'Aguilar (Les),315,173,142
25,Lleida,239,Valls de Valira (Les),810,438,372
25,Lleida,909,Vansa i Fórnols (La),191,103,88
25,Lleida,242,Verdú,1072,517,555
25,Lleida,243,Vielha e Mijaran,5020,2659,2361
25,Lleida,244,Vilagrassa,463,235,228
25,Lleida,245,Vilaller,644,365,279
25,Lleida,247,Vilamòs,175,94,81
25,Lleida,248,Vilanova de Bellpuig,1112,560,552
25,Lleida,254,Vilanova de la Barca,1050,535,515
25,Lleida,249,Vilanova de l'Aguda,242,120,122
25,Lleida,250,Vilanova de Meià,436,226,210
25,Lleida,251,Vilanova de Segrià,806,416,390
25,Lleida,252,Vila-sana,568,276,292
25,Lleida,253,Vilosell (El),216,107,109
25,Lleida,255,Vinaixa,607,310,297
26,Rioja (La),1,Ábalos,341,197,144
26,Rioja (La),2,Agoncillo,1007,539,468
26,Rioja (La),3,Aguilar del Río Alhama,668,339,329
26,Rioja (La),4,Ajamil,81,59,22
26,Rioja (La),5,Albelda de Iregua,2702,1367,1335
26,Rioja (La),6,Alberite,2273,1167,1106
26,Rioja (La),7,Alcanadre,730,383,347
26,Rioja (La),8,Aldeanueva de Ebro,2560,1338,1222
26,Rioja (La),9,Alesanco,490,258,232
26,Rioja (La),10,Alesón,119,65,54
26,Rioja (La),11,Alfaro,9545,4888,4657
26,Rioja (La),12,Almarza de Cameros,29,18,11
26,Rioja (La),13,Anguciana,349,192,157
26,Rioja (La),14,Anguiano,550,308,242
26,Rioja (La),15,Arenzana de Abajo,252,125,127
26,Rioja (La),16,Arenzana de Arriba,40,25,15
26,Rioja (La),17,Arnedillo,480,232,248
26,Rioja (La),18,Arnedo,14092,7090,7002
26,Rioja (La),19,Arrúbal,475,245,230
26,Rioja (La),20,Ausejo,887,528,359
26,Rioja (La),21,Autol,4031,2156,1875
26,Rioja (La),22,Azofra,278,152,126
26,Rioja (La),23,Badarán,682,349,333
26,Rioja (La),24,Bañares,349,172,177
26,Rioja (La),26,Baños de Río Tobía,1711,870,841
26,Rioja (La),25,Baños de Rioja,91,54,37
26,Rioja (La),27,Berceo,205,127,78
26,Rioja (La),28,Bergasa,144,82,62
26,Rioja (La),29,Bergasillas Bajera,29,15,14
26,Rioja (La),30,Bezares,21,13,8
26,Rioja (La),31,Bobadilla,130,71,59
26,Rioja (La),32,Brieva de Cameros,62,36,26
26,Rioja (La),33,Briñas,223,118,105
26,Rioja (La),34,Briones,871,472,399
26,Rioja (La),35,Cabezón de Cameros,24,19,5
26,Rioja (La),36,Calahorra,23171,11488,11683
26,Rioja (La),37,Camprovín,196,110,86
26,Rioja (La),38,Canales de la Sierra,85,52,33
26,Rioja (La),39,Canillas de Río Tuerto,46,22,24
26,Rioja (La),40,Cañas,123,67,56
26,Rioja (La),41,Cárdenas,202,94,108
26,Rioja (La),42,Casalarreina,1257,705,552
26,Rioja (La),43,Castañares de Rioja,406,196,210
26,Rioja (La),44,Castroviejo,51,29,22
26,Rioja (La),45,Cellorigo,20,9,11
26,Rioja (La),46,Cenicero,2052,1054,998
26,Rioja (La),47,Cervera del Río Alhama,3013,1565,1448
26,Rioja (La),48,Cidamón,30,17,13
26,Rioja (La),49,Cihuri,170,91,79
26,Rioja (La),50,Cirueña,120,71,49
26,Rioja (La),51,Clavijo,253,135,118
26,Rioja (La),52,Cordovín,223,124,99
26,Rioja (La),53,Corera,263,138,125
26,Rioja (La),54,Cornago,524,287,237
26,Rioja (La),55,Corporales,48,26,22
26,Rioja (La),56,Cuzcurrita de Río Tirón,398,214,184
26,Rioja (La),57,Daroca de Rioja,51,28,23
26,Rioja (La),58,Enciso,164,102,62
26,Rioja (La),59,Entrena,1240,674,566
26,Rioja (La),60,Estollo,128,73,55
26,Rioja (La),61,Ezcaray,2048,1115,933
26,Rioja (La),62,Foncea,105,57,48
26,Rioja (La),63,Fonzaleche,164,104,60
26,Rioja (La),64,Fuenmayor,2953,1521,1432
26,Rioja (La),65,Galbárruli,65,39,26
26,Rioja (La),66,Galilea,315,160,155
26,Rioja (La),67,Gallinero de Cameros,24,15,9
26,Rioja (La),68,Gimileo,146,88,58
26,Rioja (La),69,Grañón,372,201,171
26,Rioja (La),70,Grávalos,242,128,114
26,Rioja (La),71,Haro,10647,5398,5249
26,Rioja (La),72,Herce,382,202,180
26,Rioja (La),73,Herramélluri,124,67,57
26,Rioja (La),74,Hervías,132,68,64
26,Rioja (La),75,Hormilla,446,231,215
26,Rioja (La),76,Hormilleja,170,91,79
26,Rioja (La),77,Hornillos de Cameros,15,6,9
26,Rioja (La),78,Hornos de Moncalvillo,86,45,41
26,Rioja (La),79,Huércanos,915,484,431
26,Rioja (La),80,Igea,699,388,311
26,Rioja (La),81,Jalón de Cameros,39,25,14
26,Rioja (La),82,Laguna de Cameros,154,93,61
26,Rioja (La),83,Lagunilla del Jubera,411,228,183
26,Rioja (La),84,Lardero,6286,3193,3093
26,Rioja (La),86,Ledesma de la Cogolla,22,15,7
26,Rioja (La),87,Leiva,275,140,135
26,Rioja (La),88,Leza de Río Leza,45,26,19
26,Rioja (La),89,Logroño,144935,70542,74393
26,Rioja (La),91,Lumbreras,134,78,56
26,Rioja (La),92,Manjarrés,133,75,58
26,Rioja (La),93,Mansilla de la Sierra,76,52,24
26,Rioja (La),94,Manzanares de Rioja,97,55,42
26,Rioja (La),95,Matute,162,82,80
26,Rioja (La),96,Medrano,203,101,102
26,Rioja (La),98,Munilla,116,58,58
26,Rioja (La),99,Murillo de Río Leza,1236,623,613
26,Rioja (La),100,Muro de Aguas,67,40,27
26,Rioja (La),101,Muro en Cameros,35,21,14
26,Rioja (La),102,Nájera,7776,3920,3856
26,Rioja (La),103,Nalda,1004,556,448
26,Rioja (La),104,Navajún,17,13,4
26,Rioja (La),105,Navarrete,2613,1375,1238
26,Rioja (La),106,Nestares,78,44,34
26,Rioja (La),107,Nieva de Cameros,124,72,52
26,Rioja (La),109,Ochánduri,79,45,34
26,Rioja (La),108,Ocón,338,206,132
26,Rioja (La),110,Ojacastro,216,127,89
26,Rioja (La),111,Ollauri,308,170,138
26,Rioja (La),112,Ortigosa de Cameros,302,167,135
26,Rioja (La),113,Pazuengos,44,28,16
26,Rioja (La),114,Pedroso,98,55,43
26,Rioja (La),115,Pinillos,21,11,10
26,Rioja (La),117,Pradejón,3628,1989,1639
26,Rioja (La),118,Pradillo,65,34,31
26,Rioja (La),119,Préjano,209,104,105
26,Rioja (La),120,Quel,2023,1077,946
26,Rioja (La),121,Rabanera,45,33,12
26,Rioja (La),122,Rasillo de Cameros (El),136,65,71
26,Rioja (La),123,Redal (El),197,107,90
26,Rioja (La),124,Ribafrecha,1017,550,467
26,Rioja (La),125,Rincón de Soto,3591,1917,1674
26,Rioja (La),126,Robres del Castillo,34,19,15
26,Rioja (La),127,Rodezno,318,182,136
26,Rioja (La),128,Sajazarra,127,63,64
26,Rioja (La),129,San Asensio,1316,693,623
26,Rioja (La),130,San Millán de la Cogolla,298,184,114
26,Rioja (La),131,San Millán de Yécora,65,43,22
26,Rioja (La),132,San Román de Cameros,171,95,76
26,Rioja (La),139,San Torcuato,105,61,44
26,Rioja (La),142,San Vicente de la Sonsierra,1183,658,525
26,Rioja (La),134,Santa Coloma,123,74,49
26,Rioja (La),135,Santa Engracia del Jubera,183,106,77
26,Rioja (La),136,Santa Eulalia Bajera,121,65,56
26,Rioja (La),138,Santo Domingo de la Calzada,6245,3232,3013
26,Rioja (La),140,Santurde de Rioja,340,178,162
26,Rioja (La),141,Santurdejo,181,100,81
26,Rioja (La),143,Sojuela,106,61,45
26,Rioja (La),144,Sorzano,244,128,116
26,Rioja (La),145,Sotés,262,150,112
26,Rioja (La),146,Soto en Cameros,180,98,82
26,Rioja (La),147,Terroba,30,18,12
26,Rioja (La),148,Tirgo,247,141,106
26,Rioja (La),149,Tobía,76,43,33
26,Rioja (La),150,Tormantos,196,117,79
26,Rioja (La),153,Torre en Cameros,17,14,3
26,Rioja (La),151,Torrecilla en Cameros,557,293,264
26,Rioja (La),152,Torrecilla sobre Alesanco,48,24,24
26,Rioja (La),154,Torremontalbo,21,9,12
26,Rioja (La),155,Treviana,236,132,104
26,Rioja (La),157,Tricio,437,223,214
26,Rioja (La),158,Tudelilla,406,225,181
26,Rioja (La),160,Uruñuela,790,414,376
26,Rioja (La),161,Valdemadera,10,7,3
26,Rioja (La),162,Valgañón,155,85,70
26,Rioja (La),163,Ventosa,139,78,61
26,Rioja (La),164,Ventrosa,76,43,33
26,Rioja (La),165,Viguera,393,233,160
26,Rioja (La),166,Villalba de Rioja,158,93,65
26,Rioja (La),167,Villalobar de Rioja,91,56,35
26,Rioja (La),168,Villamediana de Iregua,3982,2078,1904
26,Rioja (La),169,Villanueva de Cameros,106,62,44
26,Rioja (La),170,Villar de Arnedo (El),651,338,313
26,Rioja (La),171,Villar de Torre,264,139,125
26,Rioja (La),172,Villarejo,39,25,14
26,Rioja (La),173,Villarroya,11,5,6
26,Rioja (La),174,Villarta-Quintana,171,87,84
26,Rioja (La),175,Villavelayo,74,46,28
26,Rioja (La),176,Villaverde de Rioja,75,44,31
26,Rioja (La),177,Villoslada de Cameros,389,238,151
26,Rioja (La),178,Viniegra de Abajo,106,57,49
26,Rioja (La),179,Viniegra de Arriba,46,30,16
26,Rioja (La),180,Zarratón,252,138,114
26,Rioja (La),181,Zarzosa,14,10,4
26,Rioja (La),183,Zorraquín,59,35,24
27,Lugo,1,Abadín,3201,1538,1663
27,Lugo,2,Alfoz,2266,1101,1165
27,Lugo,3,Antas de Ulla,2602,1247,1355
27,Lugo,4,Baleira,1729,899,830
27,Lugo,901,Baralla,3134,1587,1547
27,Lugo,5,Barreiros,3294,1569,1725
27,Lugo,6,Becerreá,3389,1711,1678
27,Lugo,7,Begonte,3616,1794,1822
27,Lugo,8,Bóveda,1824,903,921
27,Lugo,902,Burela,8621,4294,4327
27,Lugo,9,Carballedo,3010,1482,1528
27,Lugo,10,Castro de Rei,5779,2873,2906
27,Lugo,11,Castroverde,3236,1661,1575
27,Lugo,12,Cervantes,1973,1093,880
27,Lugo,13,Cervo,4949,2456,2493
27,Lugo,16,Chantada,9366,4563,4803
27,Lugo,14,Corgo (O),4236,2111,2125
27,Lugo,15,Cospeito,5500,2683,2817
27,Lugo,17,Folgoso do Courel,1346,686,660
27,Lugo,18,Fonsagrada (A),4949,2605,2344
27,Lugo,19,Foz,9664,4644,5020
27,Lugo,20,Friol,4533,2252,2281
27,Lugo,22,Guitiriz,6041,2964,3077
27,Lugo,23,Guntín,3307,1673,1634
27,Lugo,24,Incio (O),2297,1108,1189
27,Lugo,26,Láncara,3091,1562,1529
27,Lugo,27,Lourenzá,2677,1313,1364
27,Lugo,28,Lugo,92271,43177,49094
27,Lugo,29,Meira,1780,868,912
27,Lugo,30,Mondoñedo,4863,2242,2621
27,Lugo,31,Monforte de Lemos,19472,9242,10230
27,Lugo,32,Monterroso,4209,2102,2107
27,Lugo,33,Muras,941,473,468
27,Lugo,34,Navia de Suarna,1680,900,780
27,Lugo,35,Negueira de Muñiz,230,120,110
27,Lugo,37,Nogais (As),1477,759,718
27,Lugo,38,Ourol,1324,648,676
27,Lugo,39,Outeiro de Rei,4645,2375,2270
27,Lugo,40,Palas de Rei,3824,1867,1957
27,Lugo,41,Pantón,3178,1498,1680
27,Lugo,42,Paradela,2367,1183,1184
27,Lugo,43,Páramo (O),1858,940,918
27,Lugo,44,Pastoriza (A),3787,1891,1896
27,Lugo,45,Pedrafita do Cebreiro,1456,784,672
27,Lugo,47,Pobra do Brollón (A),2369,1159,1210
27,Lugo,46,Pol,1980,969,1011
27,Lugo,48,Pontenova (A),3063,1494,1569
27,Lugo,49,Portomarín,1918,943,975
27,Lugo,50,Quiroga,4144,1990,2154
27,Lugo,56,Rábade,1668,827,841
27,Lugo,51,Ribadeo,9407,4403,5004
27,Lugo,52,Ribas de Sil,1310,632,678
27,Lugo,53,Ribeira de Piquín,785,397,388
27,Lugo,54,Riotorto,1669,817,852
27,Lugo,55,Samos,1897,993,904
27,Lugo,57,Sarria,13155,6457,6698
27,Lugo,58,Saviñao (O),4826,2365,2461
27,Lugo,59,Sober,2972,1402,1570
27,Lugo,60,Taboada,3768,1800,1968
27,Lugo,61,Trabada,1504,728,776
27,Lugo,62,Triacastela,820,413,407
27,Lugo,63,Valadouro (O),2268,1118,1150
27,Lugo,64,Vicedo (O),2146,1040,1106
27,Lugo,65,Vilalba,15409,7540,7869
27,Lugo,66,Viveiro,15505,7477,8028
27,Lugo,21,Xermade,2414,1183,1231
27,Lugo,25,Xove,3636,1811,1825
28,Madrid,1,Acebeda (La),60,30,30
28,Madrid,2,Ajalvir,3062,1618,1444
28,Madrid,3,Alameda del Valle,241,145,96
28,Madrid,4,Álamo (El),6613,3580,3033
28,Madrid,5,Alcalá de Henares,197804,99435,98369
28,Madrid,6,Alcobendas,103149,50379,52770
28,Madrid,7,Alcorcón,162524,80436,82088
28,Madrid,8,Aldea del Fresno,2031,1098,933
28,Madrid,9,Algete,17558,8755,8803
28,Madrid,10,Alpedrete,10989,5527,5462
28,Madrid,11,Ambite,382,202,180
28,Madrid,12,Anchuelo,777,409,368
28,Madrid,13,Aranjuez,43926,21431,22495
28,Madrid,14,Arganda del Rey,41411,21402,20009
28,Madrid,15,Arroyomolinos,8246,4262,3984
28,Madrid,16,Atazar (El),113,63,50
28,Madrid,17,Batres,1373,709,664
28,Madrid,18,Becerril de la Sierra,4596,2362,2234
28,Madrid,19,Belmonte de Tajo,1196,602,594
28,Madrid,21,Berrueco (El),532,283,249
28,Madrid,20,Berzosa del Lozoya,181,95,86
28,Madrid,22,Boadilla del Monte,35588,17675,17913
28,Madrid,23,Boalo (El),5204,2714,2490
28,Madrid,24,Braojos,187,103,84
28,Madrid,25,Brea de Tajo,460,238,222
28,Madrid,26,Brunete,8096,4063,4033
28,Madrid,27,Buitrago del Lozoya,1856,938,918
28,Madrid,28,Bustarviejo,1810,923,887
28,Madrid,29,Cabanillas de la Sierra,631,335,296
28,Madrid,30,Cabrera (La),2218,1133,1085
28,Madrid,31,Cadalso de los Vidrios,2689,1411,1278
28,Madrid,32,Camarma de Esteruelas,4816,2453,2363
28,Madrid,33,Campo Real,3769,1909,1860
28,Madrid,34,Canencia,454,249,205
28,Madrid,35,Carabaña,1481,753,728
28,Madrid,36,Casarrubuelos,2141,1096,1045
28,Madrid,37,Cenicientos,1944,961,983
28,Madrid,38,Cercedilla,6698,3350,3348
28,Madrid,39,Cervera de Buitrago,134,76,58
28,Madrid,51,Chapinería,1790,917,873
28,Madrid,52,Chinchón,4868,2452,2416
28,Madrid,40,Ciempozuelos,17769,9091,8678
28,Madrid,41,Cobeña,4018,1986,2032
28,Madrid,46,Collado Mediano,5832,2947,2885
28,Madrid,47,Collado Villalba,52445,26162,26283
28,Madrid,43,Colmenar de Oreja,6898,3476,3422
28,Madrid,42,Colmenar del Arroyo,1167,594,573
28,Madrid,45,Colmenar Viejo,39579,19821,19758
28,Madrid,44,Colmenarejo,7048,3547,3501
28,Madrid,48,Corpa,500,268,232
28,Madrid,49,Coslada,82894,41415,41479
28,Madrid,50,Cubas de la Sagra,2851,1422,1429
28,Madrid,53,Daganzo de Arriba,6889,3508,3381
28,Madrid,54,Escorial (El),13768,6866,6902
28,Madrid,55,Estremera,1280,679,601
28,Madrid,56,Fresnedillas de la Oliva,1144,597,547
28,Madrid,57,Fresno de Torote,1483,808,675
28,Madrid,58,Fuenlabrada,195131,98856,96275
28,Madrid,59,Fuente el Saz de Jarama,5605,2899,2706
28,Madrid,60,Fuentidueña de Tajo,1765,890,875
28,Madrid,61,Galapagar,29218,14693,14525
28,Madrid,62,Garganta de los Montes,400,211,189
28,Madrid,63,Gargantilla del Lozoya y Pinilla de Buitrago,346,201,145
28,Madrid,64,Gascones,151,84,67
28,Madrid,65,Getafe,157397,78343,79054
28,Madrid,66,Griñón,7664,3925,3739
28,Madrid,67,Guadalix de la Sierra,4963,2589,2374
28,Madrid,68,Guadarrama,13032,6547,6485
28,Madrid,69,Hiruela (La),79,44,35
28,Madrid,70,Horcajo de la Sierra,167,86,81
28,Madrid,71,Horcajuelo de la Sierra,112,51,61
28,Madrid,72,Hoyo de Manzanares,7166,3579,3587
28,Madrid,73,Humanes de Madrid,14406,7507,6899
28,Madrid,74,Leganés,181248,90211,91037
28,Madrid,75,Loeches,4793,2398,2395
28,Madrid,76,Lozoya,602,319,283
28,Madrid,901,Lozoyuela-Navas-Sieteiglesias,918,473,445
28,Madrid,78,Madarcos,38,23,15
28,Madrid,79,Madrid,3155359,1482874,1672485
28,Madrid,80,Majadahonda,61788,29428,32360
28,Madrid,82,Manzanares el Real,6140,3157,2983
28,Madrid,83,Meco,10774,5577,5197
28,Madrid,84,Mejorada del Campo,20245,10229,10016
28,Madrid,85,Miraflores de la Sierra,5055,2552,2503
28,Madrid,86,Molar (El),5133,2700,2433
28,Madrid,87,Molinos (Los),4215,2178,2037
28,Madrid,88,Montejo de la Sierra,322,161,161
28,Madrid,89,Moraleja de Enmedio,4231,2123,2108
28,Madrid,90,Moralzarzal,9973,5070,4903
28,Madrid,91,Morata de Tajuña,6231,3126,3105
28,Madrid,92,Móstoles,204463,102044,102419
28,Madrid,93,Navacerrada,2381,1183,1198
28,Madrid,94,Navalafuente,768,424,344
28,Madrid,95,Navalagamella,1816,965,851
28,Madrid,96,Navalcarnero,17183,8703,8480
28,Madrid,97,Navarredonda y San Mamés,138,75,63
28,Madrid,99,Navas del Rey,2315,1251,1064
28,Madrid,100,Nuevo Baztán,5439,2765,2674
28,Madrid,101,Olmeda de las Fuentes,205,118,87
28,Madrid,102,Orusco de Tajuña,738,382,356
28,Madrid,104,Paracuellos de Jarama,7568,3929,3639
28,Madrid,106,Parla,91024,46615,44409
28,Madrid,107,Patones,430,215,215
28,Madrid,108,Pedrezuela,2589,1345,1244
28,Madrid,109,Pelayos de la Presa,2075,1083,992
28,Madrid,110,Perales de Tajuña,2472,1243,1229
28,Madrid,111,Pezuela de las Torres,516,274,242
28,Madrid,112,Pinilla del Valle,153,85,68
28,Madrid,113,Pinto,37559,18909,18650
28,Madrid,114,Piñuécar-Gandullas,182,88,94
28,Madrid,115,Pozuelo de Alarcón,78083,37619,40464
28,Madrid,116,Pozuelo del Rey,324,173,151
28,Madrid,117,Prádena del Rincón,105,59,46
28,Madrid,118,Puebla de la Sierra,104,57,47
28,Madrid,902,Puentes Viejas,447,257,190
28,Madrid,119,Quijorna,2067,1091,976
28,Madrid,120,Rascafría,1557,835,722
28,Madrid,121,Redueña,219,121,98
28,Madrid,122,Ribatejada,446,243,203
28,Madrid,123,Rivas-Vaciamadrid,49696,25015,24681
28,Madrid,124,Robledillo de la Jara,120,59,61
28,Madrid,125,Robledo de Chavela,3199,1612,1587
28,Madrid,126,Robregordo,69,35,34
28,Madrid,127,Rozas de Madrid (Las),71937,34980,36957
28,Madrid,128,Rozas de Puerto Real,357,198,159
28,Madrid,129,San Agustín del Guadalix,8240,4118,4122
28,Madrid,130,San Fernando de Henares,39966,20106,19860
28,Madrid,131,San Lorenzo de El Escorial,15364,7422,7942
28,Madrid,132,San Martín de la Vega,15069,7907,7162
28,Madrid,133,San Martín de Valdeiglesias,7059,3547,3512
28,Madrid,134,San Sebastián de los Reyes,65767,32580,33187
28,Madrid,135,Santa María de la Alameda,958,514,444
28,Madrid,136,Santorcaz,715,379,336
28,Madrid,137,Santos de la Humosa (Los),1400,716,684
28,Madrid,138,Serna del Monte (La),111,61,50
28,Madrid,140,Serranillos del Valle,2787,1385,1402
28,Madrid,141,Sevilla la Nueva,6357,3281,3076
28,Madrid,143,Somosierra,116,61,55
28,Madrid,144,Soto del Real,7615,3795,3820
28,Madrid,145,Talamanca de Jarama,2027,1034,993
28,Madrid,146,Tielmes,2433,1251,1182
28,Madrid,147,Titulcia,948,481,467
28,Madrid,148,Torrejón de Ardoz,109483,54224,55259
28,Madrid,149,Torrejón de la Calzada,5505,2748,2757
28,Madrid,150,Torrejón de Velasco,3167,1668,1499
28,Madrid,151,Torrelaguna,3921,2011,1910
28,Madrid,152,Torrelodones,19399,9379,10020
28,Madrid,153,Torremocha de Jarama,560,292,268
28,Madrid,154,Torres de la Alameda,5900,3013,2887
28,Madrid,903,Tres Cantos,39198,19280,19918
28,Madrid,155,Valdaracete,619,303,316
28,Madrid,156,Valdeavero,806,422,384
28,Madrid,157,Valdelaguna,734,395,339
28,Madrid,158,Valdemanco,783,433,350
28,Madrid,159,Valdemaqueda,785,402,383
28,Madrid,160,Valdemorillo,9301,4861,4440
28,Madrid,161,Valdemoro,44136,22225,21911
28,Madrid,162,Valdeolmos-Alalpardo,2240,1166,1074
28,Madrid,163,Valdepiélagos,392,206,186
28,Madrid,164,Valdetorres de Jarama,3135,1629,1506
28,Madrid,165,Valdilecha,2355,1220,1135
28,Madrid,166,Valverde de Alcalá,374,199,175
28,Madrid,167,Velilla de San Antonio,9332,4755,4577
28,Madrid,168,Vellón (El),1285,673,612
28,Madrid,169,Venturada,1304,678,626
28,Madrid,171,Villa del Prado,5450,2870,2580
28,Madrid,170,Villaconejos,2979,1531,1448
28,Madrid,172,Villalbilla,7546,3848,3698
28,Madrid,173,Villamanrique de Tajo,711,374,337
28,Madrid,174,Villamanta,2033,1061,972
28,Madrid,175,Villamantilla,543,273,270
28,Madrid,176,Villanueva de la Cañada,14084,6829,7255
28,Madrid,178,Villanueva de Perales,1024,561,463
28,Madrid,177,Villanueva del Pardillo,10721,5350,5371
28,Madrid,179,Villar del Olmo,1849,970,879
28,Madrid,180,Villarejo de Salvanés,6479,3258,3221
28,Madrid,181,Villaviciosa de Odón,24963,12242,12721
28,Madrid,182,Villavieja del Lozoya,193,100,93
28,Madrid,183,Zarzalejo,1348,718,630
29,Málaga,1,Alameda,5245,2610,2635
29,Málaga,2,Alcaucín,1917,984,933
29,Málaga,3,Alfarnate,1398,717,681
29,Málaga,4,Alfarnatejo,404,211,193
29,Málaga,5,Algarrobo,5275,2648,2627
29,Málaga,6,Algatocín,951,490,461
29,Málaga,7,Alhaurín de la Torre,28509,14262,14247
29,Málaga,8,Alhaurín el Grande,20074,10104,9970
29,Málaga,9,Almáchar,1898,980,918
29,Málaga,10,Almargen,2106,1046,1060
29,Málaga,11,Almogía,4313,2206,2107
29,Málaga,12,Álora,13013,6525,6488
29,Málaga,13,Alozaina,2269,1174,1095
29,Málaga,14,Alpandeire,291,144,147
29,Málaga,15,Antequera,43206,21247,21959
29,Málaga,16,Árchez,399,201,198
29,Málaga,17,Archidona,8583,4245,4338
29,Málaga,18,Ardales,2553,1266,1287
29,Málaga,19,Arenas,1285,699,586
29,Málaga,20,Arriate,3860,1901,1959
29,Málaga,21,Atajate,167,87,80
29,Málaga,22,Benadalid,259,136,123
29,Málaga,23,Benahavís,2649,1356,1293
29,Málaga,24,Benalauría,474,243,231
29,Málaga,25,Benalmádena,45686,22574,23112
29,Málaga,26,Benamargosa,1585,806,779
29,Málaga,27,Benamocarra,2887,1462,1425
29,Málaga,28,Benaoján,1627,816,811
29,Málaga,29,Benarrabá,560,300,260
29,Málaga,30,Borge (El),988,512,476
29,Málaga,31,Burgo (El),2067,1032,1035
29,Málaga,32,Campillos,8066,4022,4044
29,Málaga,33,Canillas de Aceituno,2242,1128,1114
29,Málaga,34,Canillas de Albaida,775,406,369
29,Málaga,35,Cañete la Real,2069,1067,1002
29,Málaga,36,Carratraca,871,427,444
29,Málaga,37,Cartajima,243,125,118
29,Málaga,38,Cártama,16692,8500,8192
29,Málaga,39,Casabermeja,3240,1678,1562
29,Málaga,40,Casarabonela,2605,1342,1263
29,Málaga,41,Casares,4051,2139,1912
29,Málaga,42,Coín,20116,10434,9682
29,Málaga,43,Colmenar,3287,1631,1656
29,Málaga,44,Comares,1485,792,693
29,Málaga,45,Cómpeta,3418,1782,1636
29,Málaga,46,Cortes de la Frontera,3686,1872,1814
29,Málaga,47,Cuevas Bajas,1462,740,722
29,Málaga,49,Cuevas de San Marcos,3973,1963,2010
29,Málaga,48,Cuevas del Becerro,1853,922,931
29,Málaga,50,Cútar,639,312,327
29,Málaga,51,Estepona,54709,27464,27245
29,Málaga,52,Faraján,252,115,137
29,Málaga,53,Frigiliana,2576,1280,1296
29,Málaga,54,Fuengirola,62915,31154,31761
29,Málaga,55,Fuente de Piedra,2146,1061,1085
29,Málaga,56,Gaucín,1842,965,877
29,Málaga,57,Genalguacil,519,266,253
29,Málaga,58,Guaro,2096,1066,1030
29,Málaga,59,Humilladero,2929,1470,1459
29,Málaga,60,Igualeja,977,486,491
29,Málaga,61,Istán,1422,717,705
29,Málaga,62,Iznate,855,439,416
29,Málaga,63,Jimera de Líbar,435,221,214
29,Málaga,64,Jubrique,754,380,374
29,Málaga,65,Júzcar,185,103,82
29,Málaga,66,Macharaviaya,362,196,166
29,Málaga,67,Málaga,558287,269479,288808
29,Málaga,68,Manilva,9624,5078,4546
29,Málaga,69,Marbella,124333,61388,62945
29,Málaga,70,Mijas,56838,28611,28227
29,Málaga,71,Moclinejo,1194,611,583
29,Málaga,72,Mollina,4151,2067,2084
29,Málaga,73,Monda,2059,1066,993
29,Málaga,74,Montejaque,1018,504,514
29,Málaga,75,Nerja,19496,9673,9823
29,Málaga,76,Ojén,2446,1250,1196
29,Málaga,77,Parauta,236,123,113
29,Málaga,79,Periana,3447,1772,1675
29,Málaga,80,Pizarra,7555,3755,3800
29,Málaga,81,Pujerra,333,183,150
29,Málaga,82,Rincón de la Victoria,31996,15945,16051
29,Málaga,83,Riogordo,2947,1518,1429
29,Málaga,84,Ronda,35512,17725,17787
29,Málaga,85,Salares,205,108,97
29,Málaga,86,Sayalonga,1401,713,688
29,Málaga,87,Sedella,581,319,262
29,Málaga,88,Sierra de Yeguas,3367,1691,1676
29,Málaga,89,Teba,4304,2178,2126
29,Málaga,90,Tolox,2317,1175,1142
29,Málaga,901,Torremolinos,55479,27998,27481
29,Málaga,91,Torrox,13964,6968,6996
29,Málaga,92,Totalán,699,367,332
29,Málaga,93,Valle de Abdalajís,2948,1435,1513
29,Málaga,94,Vélez-Málaga,64919,32371,32548
29,Málaga,95,Villanueva de Algaidas,4444,2249,2195
29,Málaga,98,Villanueva de Tapia,1667,852,815
29,Málaga,96,Villanueva del Rosario,3392,1675,1717
29,Málaga,97,Villanueva del Trabuco,5113,2582,2531
29,Málaga,99,Viñuela,1622,799,823
29,Málaga,100,Yunquera,3270,1695,1575
30,Murcia,1,Abanilla,6265,3171,3094
30,Murcia,2,Abarán,12917,6512,6405
30,Murcia,3,Águilas,31218,15619,15599
30,Murcia,4,Albudeite,1403,716,687
30,Murcia,5,Alcantarilla,37439,18697,18742
30,Murcia,902,Alcázares (Los),12264,6359,5905
30,Murcia,6,Aledo,1058,541,517
30,Murcia,7,Alguazas,7832,3999,3833
30,Murcia,8,Alhama de Murcia,18331,9409,8922
30,Murcia,9,Archena,16277,8304,7973
30,Murcia,10,Beniel,9814,5161,4653
30,Murcia,11,Blanca,6073,3068,3005
30,Murcia,12,Bullas,11641,5900,5741
30,Murcia,13,Calasparra,9862,4977,4885
30,Murcia,14,Campos del Río,2061,1016,1045
30,Murcia,15,Caravaca de la Cruz,24664,12341,12323
30,Murcia,16,Cartagena,203945,103600,100345
30,Murcia,17,Cehegín,15254,7673,7581
30,Murcia,18,Ceutí,8670,4464,4206
30,Murcia,19,Cieza,34318,17195,17123
30,Murcia,20,Fortuna,8108,4248,3860
30,Murcia,21,Fuente Álamo de Murcia,13942,7515,6427
30,Murcia,22,Jumilla,24188,12496,11692
30,Murcia,23,Librilla,4160,2100,2060
30,Murcia,24,Lorca,87153,45517,41636
30,Murcia,25,Lorquí,6277,3218,3059
30,Murcia,26,Mazarrón,28889,15508,13381
30,Murcia,27,Molina de Segura,54673,27541,27132
30,Murcia,28,Moratalla,8473,4333,4140
30,Murcia,29,Mula,16004,8233,7771
30,Murcia,30,Murcia,409810,203474,206336
30,Murcia,31,Ojós,571,292,279
30,Murcia,32,Pliego,3622,1897,1725
30,Murcia,33,Puerto Lumbreras,12487,6274,6213
30,Murcia,34,Ricote,1538,761,777
30,Murcia,35,San Javier,26337,13660,12677
30,Murcia,36,San Pedro del Pinatar,19666,9923,9743
30,Murcia,901,Santomera,13417,6812,6605
30,Murcia,37,Torre-Pacheco,27400,14658,12742
30,Murcia,38,Torres de Cotillas (Las),18134,9266,8868
30,Murcia,39,Totana,27714,14360,13354
30,Murcia,40,Ulea,968,497,471
30,Murcia,41,Unión (La),15599,7840,7759
30,Murcia,42,Villanueva del Río Segura,1803,872,931
30,Murcia,43,Yecla,33553,17032,16521
31,Navarra,1,Abáigar,103,57,46
31,Navarra,2,Abárzuza,534,272,262
31,Navarra,3,Abaurregaina/Abaurrea Alta,150,94,56
31,Navarra,4,Abaurrepea/Abaurrea Baja,41,29,12
31,Navarra,5,Aberin,328,175,153
31,Navarra,6,Ablitas,2425,1244,1181
31,Navarra,7,Adiós,170,94,76
31,Navarra,8,Aguilar de Codés,109,57,52
31,Navarra,9,Aibar/Oibar,939,495,444
31,Navarra,11,Allín,815,422,393
31,Navarra,12,Allo,1072,542,530
31,Navarra,10,Altsasu/Alsasua,7455,3813,3642
31,Navarra,13,Améscoa Baja,851,453,398
31,Navarra,14,Ancín,387,224,163
31,Navarra,15,Andosilla,2722,1401,1321
31,Navarra,16,Ansoáin,9862,4983,4879
31,Navarra,17,Anue,402,235,167
31,Navarra,18,Añorbe,520,283,237
31,Navarra,19,Aoiz/Agoitz,2109,1053,1056
31,Navarra,20,Araitz,577,341,236
31,Navarra,25,Arakil,862,469,393
31,Navarra,21,Aranarache,80,44,36
31,Navarra,23,Aranguren,5762,2952,2810
31,Navarra,24,Arano,143,73,70
31,Navarra,22,Arantza,625,355,270
31,Navarra,26,Aras,217,115,102
31,Navarra,27,Arbizu,982,513,469
31,Navarra,28,Arce/Artzi,273,165,108
31,Navarra,29,Arcos (Los),1298,646,652
31,Navarra,30,Arellano,186,102,84
31,Navarra,31,Areso,291,162,129
31,Navarra,32,Arguedas,2355,1190,1165
31,Navarra,33,Aria,67,41,26
31,Navarra,34,Aribe,62,33,29
31,Navarra,35,Armañanzas,78,40,38
31,Navarra,36,Arróniz,1154,616,538
31,Navarra,37,Arruazu,106,58,48
31,Navarra,38,Artajona,1700,881,819
31,Navarra,39,Artazu,108,58,50
31,Navarra,40,Atez,236,140,96
31,Navarra,58,Auritz/Burguete,315,149,166
31,Navarra,41,Ayegui,1388,743,645
31,Navarra,42,Azagra,3785,1932,1853
31,Navarra,43,Azuelo,43,23,20
31,Navarra,44,Bakaiku,338,183,155
31,Navarra,901,Barañain,22295,11012,11283
31,Navarra,45,Barásoain,544,277,267
31,Navarra,46,Barbarin,85,42,43
31,Navarra,47,Bargota,364,179,185
31,Navarra,48,Barillas,198,103,95
31,Navarra,49,Basaburua,714,408,306
31,Navarra,50,Baztan,7798,3993,3805
31,Navarra,137,Beintza-Labaien,268,158,110
31,Navarra,51,Beire,312,151,161
31,Navarra,52,Belascoáin,120,59,61
31,Navarra,250,Bera/Vera de Bidasoa,3666,1845,1821
31,Navarra,53,Berbinzana,715,368,347
31,Navarra,905,Beriáin,3073,1543,1530
31,Navarra,902,Berrioplano,1629,844,785
31,Navarra,903,Berriozar,8244,4237,4007
31,Navarra,54,Bertizarana,678,346,332
31,Navarra,55,Betelu,346,188,158
31,Navarra,253,Bidaurreta,120,71,49
31,Navarra,56,Biurrun-Olcoz,185,109,76
31,Navarra,57,Buñuel,2432,1222,1210
31,Navarra,59,Burgui/Burgi,235,136,99
31,Navarra,60,Burlada/Burlata,18316,9022,9294
31,Navarra,61,Busto (El),85,47,38
31,Navarra,62,Cabanillas,1586,845,741
31,Navarra,63,Cabredo,103,55,48
31,Navarra,64,Cadreita,2132,1129,1003
31,Navarra,65,Caparroso,2531,1259,1272
31,Navarra,66,Cárcar,1232,611,621
31,Navarra,67,Carcastillo,2648,1389,1259
31,Navarra,68,Cascante,3989,2019,1970
31,Navarra,69,Cáseda,1037,521,516
31,Navarra,70,Castejón,3698,1910,1788
31,Navarra,71,Castillonuevo,19,11,8
31,Navarra,72,Cintruénigo,6725,3414,3311
31,Navarra,74,Cirauqui,482,267,215
31,Navarra,75,Ciriza,81,36,45
31,Navarra,76,Cizur,1977,1012,965
31,Navarra,77,Corella,7621,3896,3725
31,Navarra,78,Cortes,3329,1748,1581
31,Navarra,79,Desojo,119,62,57
31,Navarra,80,Dicastillo,696,362,334
31,Navarra,81,Donamaria,414,204,210
31,Navarra,221,Doneztebe/Santesteban,1504,765,739
31,Navarra,83,Echarri,66,38,28
31,Navarra,86,Egüés,4912,2495,2417
31,Navarra,87,Elgorriaga,223,116,107
31,Navarra,89,Enériz,242,124,118
31,Navarra,90,Eratsun,178,116,62
31,Navarra,91,Ergoiena,445,243,202
31,Navarra,92,Erro,747,419,328
31,Navarra,94,Eslava,158,81,77
31,Navarra,95,Esparza de Salazar,100,51,49
31,Navarra,96,Espronceda,158,90,68
31,Navarra,97,Estella/Lizarra,13708,6678,7030
31,Navarra,98,Esteribar,1591,859,732
31,Navarra,99,Etayo,94,48,46
31,Navarra,82,Etxalar,801,423,378
31,Navarra,84,Etxarri-Aranatz,2454,1261,1193
31,Navarra,85,Etxauri,486,262,224
31,Navarra,100,Eulate,349,182,167
31,Navarra,101,Ezcabarte,1490,819,671
31,Navarra,93,Ezcároz/Ezkaroze,363,188,175
31,Navarra,102,Ezkurra,200,125,75
31,Navarra,103,Ezprogui,62,32,30
31,Navarra,104,Falces,2603,1309,1294
31,Navarra,105,Fitero,2222,1123,1099
31,Navarra,106,Fontellas,828,434,394
31,Navarra,107,Funes,2358,1243,1115
31,Navarra,108,Fustiñana,2506,1263,1243
31,Navarra,109,Galar,1408,733,675
31,Navarra,110,Gallipienzo,156,80,76
31,Navarra,111,Gallués/Galoze,118,75,43
31,Navarra,112,Garaioa,123,68,55
31,Navarra,113,Garde,185,106,79
31,Navarra,114,Garínoain,464,255,209
31,Navarra,115,Garralda,193,95,98
31,Navarra,116,Genevilla,112,64,48
31,Navarra,117,Goizueta,814,446,368
31,Navarra,118,Goñi,197,121,76
31,Navarra,119,Güesa/Gorza,65,37,28
31,Navarra,120,Guesálaz,465,274,191
31,Navarra,121,Guirguillano,94,49,45
31,Navarra,256,Hiriberri/Villanueva de Aezkoa,135,79,56
31,Navarra,122,Huarte/Uharte,4247,2160,2087
31,Navarra,124,Ibargoiti,228,136,92
31,Navarra,259,Igantzi,617,321,296
31,Navarra,125,Igúzquiza,357,175,182
31,Navarra,126,Imotz,418,229,189
31,Navarra,127,Irañeta,158,88,70
31,Navarra,904,Irurtzun,2209,1154,1055
31,Navarra,128,Isaba/Izaba,481,238,243
31,Navarra,129,Ituren,473,238,235
31,Navarra,130,Iturmendi,380,200,180
31,Navarra,131,Iza,839,448,391
31,Navarra,132,Izagaondoa,176,106,70
31,Navarra,133,Izalzu/Itzaltzu,46,28,18
31,Navarra,134,Jaurrieta,225,121,104
31,Navarra,135,Javier,77,34,43
31,Navarra,136,Juslapeña,502,275,227
31,Navarra,138,Lakuntza,1103,570,533
31,Navarra,139,Lana,213,124,89
31,Navarra,140,Lantz,119,75,44
31,Navarra,141,Lapoblación,163,98,65
31,Navarra,142,Larraga,2007,1131,876
31,Navarra,143,Larraona,136,68,68
31,Navarra,144,Larraun,1081,605,476
31,Navarra,145,Lazagurría,207,106,101
31,Navarra,146,Leache,45,27,18
31,Navarra,147,Legarda,112,62,50
31,Navarra,148,Legaria,118,55,63
31,Navarra,149,Leitza,2953,1567,1386
31,Navarra,908,Lekunberri,1050,532,518
31,Navarra,150,Leoz,270,172,98
31,Navarra,151,Lerga,76,43,33
31,Navarra,152,Lerín,1851,940,911
31,Navarra,153,Lesaka,2680,1382,1298
31,Navarra,154,Lezáun,259,155,104
31,Navarra,155,Liédena,339,161,178
31,Navarra,156,Lizoáin,273,167,106
31,Navarra,157,Lodosa,4726,2424,2302
31,Navarra,158,Lónguida/Longida,324,175,149
31,Navarra,159,Lumbier,1409,750,659
31,Navarra,160,Luquin,139,73,66
31,Navarra,248,Luzaide/Valcarlos,435,213,222
31,Navarra,161,Mañeru,374,192,182
31,Navarra,162,Marañón,59,31,28
31,Navarra,163,Marcilla,2674,1369,1305
31,Navarra,164,Mélida,762,375,387
31,Navarra,165,Mendavia,3757,1919,1838
31,Navarra,166,Mendaza,340,161,179
31,Navarra,167,Mendigorría,1055,542,513
31,Navarra,168,Metauten,287,164,123
31,Navarra,169,Milagro,3061,1581,1480
31,Navarra,170,Mirafuentes,53,27,26
31,Navarra,171,Miranda de Arga,997,511,486
31,Navarra,172,Monreal,389,203,186
31,Navarra,173,Monteagudo,1132,564,568
31,Navarra,174,Morentin,157,80,77
31,Navarra,175,Mues,101,56,45
31,Navarra,176,Murchante,3321,1656,1665
31,Navarra,177,Murieta,282,161,121
31,Navarra,178,Murillo el Cuende,666,354,312
31,Navarra,179,Murillo el Fruto,746,384,362
31,Navarra,180,Muruzábal,296,140,156
31,Navarra,181,Navascués,208,128,80
31,Navarra,182,Nazar,56,35,21
31,Navarra,88,Noáin (Valle de Elorz)/Noain (Elortzibar),4496,2253,2243
31,Navarra,183,Obanos,885,432,453
31,Navarra,185,Ochagavía,651,336,315
31,Navarra,184,Oco,76,45,31
31,Navarra,186,Odieta,336,183,153
31,Navarra,187,Oitz,147,89,58
31,Navarra,188,Olaibar,198,102,96
31,Navarra,189,Olazti/Olazagutía,1730,903,827
31,Navarra,190,Olejua,54,24,30
31,Navarra,191,Olite,3435,1740,1695
31,Navarra,194,Ollo,308,174,134
31,Navarra,192,Olóriz,193,115,78
31,Navarra,193,Olza,1322,687,635
31,Navarra,195,Orbaitzeta,219,115,104
31,Navarra,196,Orbara,56,27,29
31,Navarra,906,Orcoyen,2109,1111,998
31,Navarra,197,Orísoain,87,46,41
31,Navarra,198,Oronz,55,31,24
31,Navarra,199,Oroz-Betelu,201,104,97
31,Navarra,211,Orreaga/Roncesvalles,24,12,12
31,Navarra,200,Oteiza,933,494,439
31,Navarra,201,Pamplona/Iruña,193328,92487,100841
31,Navarra,202,Peralta,5741,2908,2833
31,Navarra,203,Petilla de Aragón,33,20,13
31,Navarra,204,Piedramillera,60,39,21
31,Navarra,205,Pitillas,584,286,298
31,Navarra,206,Puente la Reina/Gares,2611,1306,1305
31,Navarra,207,Pueyo,334,183,151
31,Navarra,208,Ribaforada,3437,1760,1677
31,Navarra,209,Romanzado,151,85,66
31,Navarra,210,Roncal/Erronkari,303,166,137
31,Navarra,212,Sada,215,117,98
31,Navarra,213,Saldías,122,74,48
31,Navarra,214,Salinas de Oro,114,64,50
31,Navarra,215,San Adrián,5968,2947,3021
31,Navarra,217,San Martín de Unx,438,232,206
31,Navarra,216,Sangüesa/Zangoza,5041,2577,2464
31,Navarra,219,Sansol,113,56,57
31,Navarra,220,Santacara,1009,509,500
31,Navarra,222,Sarriés/Sartze,81,51,30
31,Navarra,223,Sartaguda,1340,685,655
31,Navarra,224,Sesma,1360,675,685
31,Navarra,225,Sorlada,40,20,20
31,Navarra,226,Sunbilla,670,348,322
31,Navarra,227,Tafalla,10924,5416,5508
31,Navarra,228,Tiebas-Muruarte de Reta,501,263,238
31,Navarra,229,Tirapu,60,37,23
31,Navarra,230,Torralba del Río,131,68,63
31,Navarra,231,Torres del Río,171,83,88
31,Navarra,232,Tudela,32345,16224,16121
31,Navarra,233,Tulebras,102,36,66
31,Navarra,234,Ucar,157,90,67
31,Navarra,123,Uharte-Arakil,799,434,365
31,Navarra,235,Ujué,227,119,108
31,Navarra,236,Ultzama,1613,792,821
31,Navarra,237,Unciti,223,130,93
31,Navarra,238,Unzué,144,86,58
31,Navarra,239,Urdazubi/Urdax,367,180,187
31,Navarra,240,Urdiain,620,320,300
31,Navarra,241,Urraul Alto,173,105,68
31,Navarra,242,Urraul Bajo,289,128,161
31,Navarra,244,Urrotz,184,111,73
31,Navarra,243,Urroz,379,195,184
31,Navarra,245,Urzainqui,106,59,47
31,Navarra,246,Uterga,170,91,79
31,Navarra,247,Uztárroz/Uztarroze,220,102,118
31,Navarra,249,Valtierra,2415,1188,1227
31,Navarra,251,Viana,3596,1865,1731
31,Navarra,252,Vidángoz/Bidankoze,114,60,54
31,Navarra,254,Villafranca,2802,1423,1379
31,Navarra,255,Villamayor de Monjardín,140,70,70
31,Navarra,257,Villatuerta,990,499,491
31,Navarra,258,Villava/Atarrabia,10236,5073,5163
31,Navarra,260,Yerri,1557,820,737
31,Navarra,261,Yesa,263,144,119
31,Navarra,262,Zabalza,186,93,93
31,Navarra,73,Ziordia,361,171,190
31,Navarra,907,Zizur Mayor/Zizur Nagusia,13052,6512,6540
31,Navarra,263,Zubieta,299,166,133
31,Navarra,264,Zugarramurdi,233,121,112
31,Navarra,265,Zúñiga,178,107,71
32,Ourense,1,Allariz,5351,2584,2767
32,Ourense,2,Amoeiro,2356,1170,1186
32,Ourense,3,Arnoia (A),1220,585,635
32,Ourense,4,Avión,2780,1251,1529
32,Ourense,5,Baltar,1177,588,589
32,Ourense,6,Bande,2285,1050,1235
32,Ourense,7,Baños de Molgas,2014,989,1025
32,Ourense,8,Barbadás,7939,3876,4063
32,Ourense,9,Barco de Valdeorras (O),13700,6818,6882
32,Ourense,10,Beade,559,274,285
32,Ourense,11,Beariz,1397,651,746
32,Ourense,12,Blancos (Os),1104,554,550
32,Ourense,13,Boborás,3200,1482,1718
32,Ourense,14,Bola (A),1525,722,803
32,Ourense,15,Bolo (O),1246,619,627
32,Ourense,16,Calvos de Randín,1195,596,599
32,Ourense,18,Carballeda de Avia,1591,762,829
32,Ourense,17,Carballeda de Valdeorras,2041,1010,1031
32,Ourense,19,Carballiño (O),13465,6342,7123
32,Ourense,20,Cartelle,3552,1707,1845
32,Ourense,22,Castrelo de Miño,2036,1003,1033
32,Ourense,21,Castrelo do Val,1247,619,628
32,Ourense,23,Castro Caldelas,1769,896,873
32,Ourense,24,Celanova,6150,2915,3235
32,Ourense,25,Cenlle,1560,748,812
32,Ourense,29,Chandrexa de Queixa,807,442,365
32,Ourense,26,Coles,3263,1607,1656
32,Ourense,27,Cortegada,1401,675,726
32,Ourense,28,Cualedro,2234,1108,1126
32,Ourense,30,Entrimo,1377,637,740
32,Ourense,31,Esgos,1312,654,658
32,Ourense,33,Gomesende,1101,529,572
32,Ourense,34,Gudiña (A),1623,812,811
32,Ourense,35,Irixo (O),2014,947,1067
32,Ourense,38,Larouco,569,274,295
32,Ourense,39,Laza,1762,859,903
32,Ourense,40,Leiro,1931,926,1005
32,Ourense,41,Lobeira,1160,559,601
32,Ourense,42,Lobios,2420,1160,1260
32,Ourense,43,Maceda,3218,1581,1637
32,Ourense,44,Manzaneda,1113,571,542
32,Ourense,45,Maside,3077,1449,1628
32,Ourense,46,Melón,1582,704,878
32,Ourense,47,Merca (A),2312,1093,1219
32,Ourense,48,Mezquita (A),1387,710,677
32,Ourense,49,Montederramo,1137,583,554
32,Ourense,50,Monterrei,3128,1562,1566
32,Ourense,51,Muíños,2003,967,1036
32,Ourense,52,Nogueira de Ramuín,2551,1225,1326
32,Ourense,53,Oímbra,1963,980,983
32,Ourense,54,Ourense,108358,50562,57796
32,Ourense,55,Paderne de Allariz,1619,784,835
32,Ourense,56,Padrenda,2474,1184,1290
32,Ourense,57,Parada de Sil,761,366,395
32,Ourense,58,Pereiro de Aguiar (O),5487,2777,2710
32,Ourense,59,Peroxa (A),2438,1153,1285
32,Ourense,60,Petín,1088,526,562
32,Ourense,61,Piñor,1476,725,751
32,Ourense,63,Pobra de Trives (A),2686,1344,1342
32,Ourense,64,Pontedeva,626,294,332
32,Ourense,62,Porqueira,1102,547,555
32,Ourense,65,Punxín,942,433,509
32,Ourense,66,Quintela de Leirado,814,374,440
32,Ourense,67,Rairiz de Veiga,1780,869,911
32,Ourense,68,Ramirás,2054,958,1096
32,Ourense,69,Ribadavia,5494,2628,2866
32,Ourense,71,Riós,2088,1028,1060
32,Ourense,72,Rúa (A),4996,2424,2572
32,Ourense,73,Rubiá,1663,816,847
32,Ourense,74,San Amaro,1355,667,688
32,Ourense,75,San Cibrao das Viñas,3973,1944,2029
32,Ourense,76,San Cristovo de Cea,2926,1435,1491
32,Ourense,70,San Xoán de Río,867,412,455
32,Ourense,77,Sandiás,1554,717,837
32,Ourense,78,Sarreaus,1800,887,913
32,Ourense,79,Taboadela,1690,838,852
32,Ourense,80,Teixeira (A),536,258,278
32,Ourense,81,Toén,2594,1310,1284
32,Ourense,82,Trasmiras,1778,866,912
32,Ourense,83,Veiga (A),1273,630,643
32,Ourense,84,Verea,1355,657,698
32,Ourense,85,Verín,13706,6667,7039
32,Ourense,86,Viana do Bolo,3575,1777,1798
32,Ourense,87,Vilamarín,2321,1138,1183
32,Ourense,88,Vilamartín de Valdeorras,2408,1166,1242
32,Ourense,89,Vilar de Barrio,1835,897,938
32,Ourense,90,Vilar de Santos,1011,490,521
32,Ourense,91,Vilardevós,2569,1283,1286
32,Ourense,92,Vilariño de Conso,731,406,325
32,Ourense,32,Xinzo de Limia,9930,4914,5016
32,Ourense,36,Xunqueira de Ambía,1901,953,948
32,Ourense,37,Xunqueira de Espadanedo,1017,483,534
33,Asturias,1,Allande,2228,1131,1097
33,Asturias,2,Aller,13702,6720,6982
33,Asturias,3,Amieva,868,467,401
33,Asturias,4,Avilés,83855,40203,43652
33,Asturias,5,Belmonte de Miranda,2019,1044,975
33,Asturias,6,Bimenes,1941,906,1035
33,Asturias,7,Boal,2180,1081,1099
33,Asturias,8,Cabrales,2249,1133,1116
33,Asturias,9,Cabranes,1093,552,541
33,Asturias,10,Candamo,2351,1155,1196
33,Asturias,12,Cangas de Onís,6574,3221,3353
33,Asturias,11,Cangas del Narcea,15672,7865,7807
33,Asturias,13,Caravia,555,276,279
33,Asturias,14,Carreño,10716,5248,5468
33,Asturias,15,Caso,1997,1072,925
33,Asturias,16,Castrillón,22932,11158,11774
33,Asturias,17,Castropol,3998,1882,2116
33,Asturias,18,Coaña,3522,1717,1805
33,Asturias,19,Colunga,3882,1916,1966
33,Asturias,20,Corvera de Asturias,15769,7726,8043
33,Asturias,21,Cudillero,5976,2914,3062
33,Asturias,22,Degaña,1350,709,641
33,Asturias,23,Franco (El),4101,2008,2093
33,Asturias,24,Gijón,273931,130064,143867
33,Asturias,25,Gozón,10674,5201,5473
33,Asturias,26,Grado,11128,5387,5741
33,Asturias,27,Grandas de Salime,1186,613,573
33,Asturias,28,Ibias,1903,1015,888
33,Asturias,29,Illano,552,292,260
33,Asturias,30,Illas,1036,547,489
33,Asturias,31,Langreo,46558,22187,24371
33,Asturias,32,Laviana,14419,6981,7438
33,Asturias,33,Lena,13276,6418,6858
33,Asturias,35,Llanera,13283,6594,6689
33,Asturias,36,Llanes,13169,6362,6807
33,Asturias,37,Mieres,45943,21907,24036
33,Asturias,38,Morcín,3016,1492,1524
33,Asturias,39,Muros de Nalón,2017,940,1077
33,Asturias,40,Nava,5455,2673,2782
33,Asturias,41,Navia,9058,4368,4690
33,Asturias,42,Noreña,4763,2302,2461
33,Asturias,43,Onís,846,430,416
33,Asturias,44,Oviedo,212174,98846,113328
33,Asturias,45,Parres,5736,2813,2923
33,Asturias,46,Peñamellera Alta,670,333,337
33,Asturias,47,Peñamellera Baja,1470,734,736
33,Asturias,48,Pesoz,218,99,119
33,Asturias,49,Piloña,8440,4125,4315
33,Asturias,50,Ponga,699,414,285
33,Asturias,51,Pravia,9200,4464,4736
33,Asturias,52,Proaza,810,426,384
33,Asturias,53,Quirós,1465,778,687
33,Asturias,54,Regueras (Las),2088,1042,1046
33,Asturias,55,Ribadedeva,1901,933,968
33,Asturias,56,Ribadesella,6205,2941,3264
33,Asturias,57,Ribera de Arriba,1968,987,981
33,Asturias,58,Riosa,2362,1213,1149
33,Asturias,59,Salas,6310,3078,3232
33,Asturias,61,San Martín de Oscos,469,242,227
33,Asturias,60,San Martín del Rey Aurelio,19698,9499,10199
33,Asturias,63,San Tirso de Abres,620,307,313
33,Asturias,62,Santa Eulalia de Oscos,550,284,266
33,Asturias,64,Santo Adriano,280,134,146
33,Asturias,65,Sariego,1364,662,702
33,Asturias,66,Siero,48991,23771,25220
33,Asturias,67,Sobrescobio,873,467,406
33,Asturias,68,Somiedo,1570,861,709
33,Asturias,69,Soto del Barco,4162,2028,2134
33,Asturias,70,Tapia de Casariego,4290,2059,2231
33,Asturias,71,Taramundi,828,407,421
33,Asturias,72,Teverga,2035,1058,977
33,Asturias,73,Tineo,12071,6156,5915
33,Asturias,34,Valdés,14205,6932,7273
33,Asturias,74,Vegadeo,4438,2120,2318
33,Asturias,75,Villanueva de Oscos,404,205,199
33,Asturias,76,Villaviciosa,14360,7051,7309
33,Asturias,77,Villayón,1771,884,887
33,Asturias,78,Yernes y Tameza,197,99,98
34,Palencia,1,Abarca de Campos,46,26,20
34,Palencia,3,Abia de las Torres,182,94,88
34,Palencia,4,Aguilar de Campoo,7308,3554,3754
34,Palencia,5,Alar del Rey,1152,558,594
34,Palencia,6,Alba de Cerrato,99,51,48
34,Palencia,9,Amayuelas de Arriba,41,25,16
34,Palencia,10,Ampudia,685,358,327
34,Palencia,11,Amusco,500,273,227
34,Palencia,12,Antigüedad,406,218,188
34,Palencia,15,Arconada,50,27,23
34,Palencia,17,Astudillo,1196,622,574
34,Palencia,18,Autilla del Pino,229,125,104
34,Palencia,19,Autillo de Campos,184,87,97
34,Palencia,20,Ayuela,68,41,27
34,Palencia,22,Baltanás,1420,735,685
34,Palencia,24,Baquerín de Campos,24,12,12
34,Palencia,25,Bárcena de Campos,62,28,34
34,Palencia,27,Barruelo de Santullán,1569,754,815
34,Palencia,28,Báscones de Ojeda,198,105,93
34,Palencia,29,Becerril de Campos,1007,507,500
34,Palencia,31,Belmonte de Campos,34,15,19
34,Palencia,32,Berzosilla,63,27,36
34,Palencia,33,Boada de Campos,21,12,9
34,Palencia,35,Boadilla de Rioseco,149,76,73
34,Palencia,34,Boadilla del Camino,158,85,73
34,Palencia,36,Brañosera,291,156,135
34,Palencia,37,Buenavista de Valdavia,424,211,213
34,Palencia,38,Bustillo de la Vega,348,185,163
34,Palencia,39,Bustillo del Páramo de Carrión,79,47,32
34,Palencia,41,Calahorra de Boedo,124,66,58
34,Palencia,42,Calzada de los Molinos,371,202,169
34,Palencia,45,Capillas,105,53,52
34,Palencia,46,Cardeñosa de Volpejera,46,23,23
34,Palencia,47,Carrión de los Condes,2340,1117,1223
34,Palencia,48,Castil de Vela,83,39,44
34,Palencia,49,Castrejón de la Peña,561,288,273
34,Palencia,50,Castrillo de Don Juan,299,163,136
34,Palencia,51,Castrillo de Onielo,146,72,74
34,Palencia,52,Castrillo de Villavega,244,127,117
34,Palencia,53,Castromocho,246,130,116
34,Palencia,55,Cervatos de la Cueza,330,180,150
34,Palencia,56,Cervera de Pisuerga,2676,1341,1335
34,Palencia,57,Cevico de la Torre,582,286,296
34,Palencia,58,Cevico Navero,246,129,117
34,Palencia,59,Cisneros,530,265,265
34,Palencia,60,Cobos de Cerrato,210,111,99
34,Palencia,61,Collazos de Boedo,153,81,72
34,Palencia,62,Congosto de Valdavia,234,131,103
34,Palencia,63,Cordovilla la Real,117,63,54
34,Palencia,66,Cubillas de Cerrato,78,40,38
34,Palencia,67,Dehesa de Montejo,182,98,84
34,Palencia,68,Dehesa de Romanos,43,28,15
34,Palencia,69,Dueñas,3055,1603,1452
34,Palencia,70,Espinosa de Cerrato,223,113,110
34,Palencia,71,Espinosa de Villagonzalo,221,112,109
34,Palencia,72,Frechilla,254,127,127
34,Palencia,73,Fresno del Río,185,98,87
34,Palencia,74,Frómista,896,455,441
34,Palencia,76,Fuentes de Nava,776,402,374
34,Palencia,77,Fuentes de Valdepero,232,131,101
34,Palencia,79,Grijota,1103,554,549
34,Palencia,80,Guardo,7941,3969,3972
34,Palencia,81,Guaza de Campos,66,32,34
34,Palencia,82,Hérmedes de Cerrato,121,59,62
34,Palencia,83,Herrera de Pisuerga,2408,1170,1238
34,Palencia,84,Herrera de Valdecañas,178,93,85
34,Palencia,86,Hontoria de Cerrato,110,58,52
34,Palencia,87,Hornillos de Cerrato,122,61,61
34,Palencia,88,Husillos,215,125,90
34,Palencia,89,Itero de la Vega,207,109,98
34,Palencia,91,Lagartos,148,82,66
34,Palencia,92,Lantadilla,434,211,223
34,Palencia,94,Ledigos,89,48,41
34,Palencia,903,Loma de Ucieza,295,161,134
34,Palencia,96,Lomas,53,24,29
34,Palencia,98,Magaz de Pisuerga,771,400,371
34,Palencia,99,Manquillos,70,37,33
34,Palencia,100,Mantinos,168,90,78
34,Palencia,101,Marcilla de Campos,57,24,33
34,Palencia,102,Mazariegos,265,144,121
34,Palencia,103,Mazuecos de Valdeginate,117,58,59
34,Palencia,104,Melgar de Yuso,344,193,151
34,Palencia,106,Meneses de Campos,146,74,72
34,Palencia,107,Micieces de Ojeda,103,58,45
34,Palencia,108,Monzón de Campos,676,356,320
34,Palencia,109,Moratinos,76,41,35
34,Palencia,110,Mudá,100,49,51
34,Palencia,112,Nogal de las Huertas,60,33,27
34,Palencia,113,Olea de Boedo,44,19,25
34,Palencia,114,Olmos de Ojeda,294,166,128
34,Palencia,116,Osornillo,81,43,38
34,Palencia,901,Osorno la Mayor,1547,805,742
34,Palencia,120,Palencia,81439,38576,42863
34,Palencia,121,Palenzuela,268,144,124
34,Palencia,122,Páramo de Boedo,106,56,50
34,Palencia,123,Paredes de Nava,2259,1126,1133
34,Palencia,124,Payo de Ojeda,82,48,34
34,Palencia,125,Pedraza de Campos,114,59,55
34,Palencia,126,Pedrosa de la Vega,364,193,171
34,Palencia,127,Perales,108,56,52
34,Palencia,904,Pernía (La),432,240,192
34,Palencia,129,Pino del Río,254,150,104
34,Palencia,130,Piña de Campos,272,143,129
34,Palencia,131,Población de Arroyo,86,46,40
34,Palencia,132,Población de Campos,172,90,82
34,Palencia,133,Población de Cerrato,130,70,60
34,Palencia,134,Polentinos,71,36,35
34,Palencia,135,Pomar de Valdivia,520,271,249
34,Palencia,136,Poza de la Vega,263,148,115
34,Palencia,137,Pozo de Urama,41,22,19
34,Palencia,139,Prádanos de Ojeda,218,114,104
34,Palencia,140,Puebla de Valdavia (La),144,73,71
34,Palencia,141,Quintana del Puente,234,122,112
34,Palencia,143,Quintanilla de Onsoña,211,115,96
34,Palencia,146,Reinoso de Cerrato,71,40,31
34,Palencia,147,Renedo de la Vega,254,145,109
34,Palencia,149,Requena de Campos,39,17,22
34,Palencia,151,Respenda de la Peña,222,123,99
34,Palencia,152,Revenga de Campos,175,87,88
34,Palencia,154,Revilla de Collazos,78,43,35
34,Palencia,155,Ribas de Campos,185,95,90
34,Palencia,156,Riberos de la Cueza,86,50,36
34,Palencia,157,Saldaña,3115,1591,1524
34,Palencia,158,Salinas de Pisuerga,336,169,167
34,Palencia,159,San Cebrián de Campos,471,267,204
34,Palencia,160,San Cebrián de Mudá,181,90,91
34,Palencia,161,San Cristóbal de Boedo,35,21,14
34,Palencia,163,San Mamés de Campos,86,36,50
34,Palencia,165,San Román de la Cuba,112,55,57
34,Palencia,167,Santa Cecilia del Alcor,150,86,64
34,Palencia,168,Santa Cruz de Boedo,52,31,21
34,Palencia,169,Santervás de la Vega,519,285,234
34,Palencia,170,Santibáñez de Ecla,91,43,48
34,Palencia,171,Santibáñez de la Peña,1372,679,693
34,Palencia,174,Santoyo,253,126,127
34,Palencia,175,Serna (La),118,68,50
34,Palencia,177,Soto de Cerrato,201,106,95
34,Palencia,176,Sotobañado y Priorato,177,98,79
34,Palencia,178,Tabanera de Cerrato,145,80,65
34,Palencia,179,Tabanera de Valdavia,47,20,27
34,Palencia,180,Támara de Campos,90,43,47
34,Palencia,181,Tariego de Cerrato,532,273,259
34,Palencia,182,Torquemada,1111,579,532
34,Palencia,184,Torremormojón,72,39,33
34,Palencia,185,Triollo,83,45,38
34,Palencia,186,Valbuena de Pisuerga,65,38,27
34,Palencia,189,Valdeolmillos,81,42,39
34,Palencia,190,Valderrábano,64,36,28
34,Palencia,192,Valde-Ucieza,112,60,52
34,Palencia,196,Valle de Cerrato,112,63,49
34,Palencia,902,Valle del Retortillo,184,93,91
34,Palencia,199,Velilla del Río Carrión,1587,804,783
34,Palencia,23,Venta de Baños,5965,2910,3055
34,Palencia,201,Vertavillo,213,114,99
34,Palencia,93,Vid de Ojeda (La),133,81,52
34,Palencia,202,Villabasta de Valdavia,37,15,22
34,Palencia,204,Villacidaler,68,34,34
34,Palencia,205,Villaconancio,82,49,33
34,Palencia,206,Villada,1159,579,580
34,Palencia,208,Villaeles de Valdavia,72,38,34
34,Palencia,210,Villahán,117,62,55
34,Palencia,211,Villaherreros,248,120,128
34,Palencia,213,Villalaco,71,28,43
34,Palencia,214,Villalba de Guardo,219,120,99
34,Palencia,215,Villalcázar de Sirga,220,101,119
34,Palencia,216,Villalcón,81,40,41
34,Palencia,217,Villalobón,699,355,344
34,Palencia,218,Villaluenga de la Vega,631,360,271
34,Palencia,220,Villamartín de Campos,141,74,67
34,Palencia,221,Villamediana,217,117,100
34,Palencia,222,Villameriel,134,79,55
34,Palencia,223,Villamoronta,312,179,133
34,Palencia,224,Villamuera de la Cueza,60,33,27
34,Palencia,225,Villamuriel de Cerrato,5421,2793,2628
34,Palencia,227,Villanueva del Rebollar,101,53,48
34,Palencia,228,Villanuño de Valdavia,113,64,49
34,Palencia,229,Villaprovedo,81,52,29
34,Palencia,230,Villarmentero de Campos,15,11,4
34,Palencia,231,Villarrabé,246,128,118
34,Palencia,232,Villarramiel,1003,517,486
34,Palencia,233,Villasarracino,218,118,100
34,Palencia,234,Villasila de Valdavia,93,57,36
34,Palencia,236,Villaturde,221,111,110
34,Palencia,237,Villaumbrales,791,412,379
34,Palencia,238,Villaviudas,423,204,219
34,Palencia,240,Villerías de Campos,120,65,55
34,Palencia,241,Villodre,35,24,11
34,Palencia,242,Villodrigo,126,60,66
34,Palencia,243,Villoldo,437,227,210
34,Palencia,245,Villota del Páramo,402,233,169
34,Palencia,246,Villovieco,104,53,51
35,Palmas (Las),1,Agaete,5606,2858,2748
35,Palmas (Las),2,Agüimes,25541,13165,12376
35,Palmas (Las),3,Antigua,7578,4257,3321
35,Palmas (Las),4,Arrecife,53920,27724,26196
35,Palmas (Las),5,Artenara,1386,728,658
35,Palmas (Las),6,Arucas,34245,17226,17019
35,Palmas (Las),7,Betancuria,738,372,366
35,Palmas (Las),8,Firgas,7179,3676,3503
35,Palmas (Las),9,Gáldar,23201,11658,11543
35,Palmas (Las),10,Haría,4894,2563,2331
35,Palmas (Las),11,Ingenio,27308,13896,13412
35,Palmas (Las),12,Mogán,15953,8525,7428
35,Palmas (Las),13,Moya,7801,3944,3857
35,Palmas (Las),14,Oliva (La),17273,9419,7854
35,Palmas (Las),15,Pájara,18173,10211,7962
35,Palmas (Las),16,Palmas de Gran Canaria (Las),378628,185494,193134
35,Palmas (Las),17,Puerto del Rosario,30363,15961,14402
35,Palmas (Las),18,San Bartolomé,17452,9042,8410
35,Palmas (Las),19,San Bartolomé de Tirajana,46428,24249,22179
35,Palmas (Las),20,San Nicolás de Tolentino,8299,4260,4039
35,Palmas (Las),21,Santa Brígida,18806,9384,9422
35,Palmas (Las),22,Santa Lucía de Tirajana,56268,28714,27554
35,Palmas (Las),23,Santa María de Guía de Gran Canaria,14086,7024,7062
35,Palmas (Las),24,Teguise,15824,8088,7736
35,Palmas (Las),25,Tejeda,2341,1226,1115
35,Palmas (Las),26,Telde,96547,48397,48150
35,Palmas (Las),27,Teror,12189,6164,6025
35,Palmas (Las),28,Tías,16850,8775,8075
35,Palmas (Las),29,Tinajo,5258,2784,2474
35,Palmas (Las),30,Tuineje,12517,6671,5846
35,Palmas (Las),32,Valleseco,4055,2135,1920
35,Palmas (Las),31,Valsequillo de Gran Canaria,8659,4429,4230
35,Palmas (Las),33,Vega de San Mateo,7721,4016,3705
35,Palmas (Las),34,Yaiza,8841,4952,3889
36,Pontevedra,20,Agolada,3414,1672,1742
36,Pontevedra,1,Arbo,3973,1974,1999
36,Pontevedra,3,Baiona,11521,5703,5818
36,Pontevedra,2,Barro,3408,1656,1752
36,Pontevedra,4,Bueu,12528,6158,6370
36,Pontevedra,5,Caldas de Reis,9673,4674,4999
36,Pontevedra,6,Cambados,13581,6585,6996
36,Pontevedra,7,Campo Lameiro,2166,1033,1133
36,Pontevedra,8,Cangas,24849,12330,12519
36,Pontevedra,9,Cañiza (A),6747,3235,3512
36,Pontevedra,10,Catoira,3502,1715,1787
36,Pontevedra,11,Cerdedo,2333,1053,1280
36,Pontevedra,12,Cotobade,4658,2148,2510
36,Pontevedra,13,Covelo,3652,1740,1912
36,Pontevedra,14,Crecente,2748,1267,1481
36,Pontevedra,15,Cuntis,5340,2500,2840
36,Pontevedra,16,Dozón,1980,962,1018
36,Pontevedra,17,Estrada (A),22102,10449,11653
36,Pontevedra,18,Forcarei,4576,2142,2434
36,Pontevedra,19,Fornelos de Montes,2057,952,1105
36,Pontevedra,21,Gondomar,12685,6280,6405
36,Pontevedra,22,Grove (O),11218,5556,5662
36,Pontevedra,23,Guarda (A),10209,4983,5226
36,Pontevedra,901,Illa de Arousa (A),4884,2434,2450
36,Pontevedra,24,Lalín,20732,9995,10737
36,Pontevedra,25,Lama (A),3026,1386,1640
36,Pontevedra,26,Marín,26103,13055,13048
36,Pontevedra,27,Meaño,5478,2638,2840
36,Pontevedra,28,Meis,5011,2370,2641
36,Pontevedra,29,Moaña,18415,8959,9456
36,Pontevedra,30,Mondariz,5343,2521,2822
36,Pontevedra,31,Mondariz-Balneario,719,352,367
36,Pontevedra,32,Moraña,4313,2051,2262
36,Pontevedra,33,Mos,13996,6837,7159
36,Pontevedra,34,Neves (As),4377,2124,2253
36,Pontevedra,35,Nigrán,17281,8577,8704
36,Pontevedra,36,Oia,3038,1534,1504
36,Pontevedra,37,Pazos de Borbén,3160,1484,1676
36,Pontevedra,41,Poio,14889,7328,7561
36,Pontevedra,43,Ponte Caldelas,6515,3185,3330
36,Pontevedra,42,Ponteareas,21378,10411,10967
36,Pontevedra,44,Pontecesures,3101,1534,1567
36,Pontevedra,38,Pontevedra,79372,37737,41635
36,Pontevedra,39,Porriño (O),16576,8005,8571
36,Pontevedra,40,Portas,3171,1491,1680
36,Pontevedra,45,Redondela,29863,14559,15304
36,Pontevedra,46,Ribadumia,4317,2079,2238
36,Pontevedra,47,Rodeiro,3385,1720,1665
36,Pontevedra,48,Rosal (O),6183,3019,3164
36,Pontevedra,49,Salceda de Caselas,7176,3645,3531
36,Pontevedra,50,Salvaterra de Miño,8375,4105,4270
36,Pontevedra,51,Sanxenxo,16598,8148,8450
36,Pontevedra,52,Silleda,9097,4393,4704
36,Pontevedra,53,Soutomaior,5956,2931,3025
36,Pontevedra,54,Tomiño,11932,5908,6024
36,Pontevedra,55,Tui,16680,7980,8700
36,Pontevedra,56,Valga,6108,2996,3112
36,Pontevedra,57,Vigo,293725,140119,153606
36,Pontevedra,59,Vila de Cruces,6720,3362,3358
36,Pontevedra,58,Vilaboa,5947,2929,3018
36,Pontevedra,60,Vilagarcía de Arousa,35954,17348,18606
36,Pontevedra,61,Vilanova de Arousa,10497,5087,5410
37,Salamanca,1,Abusejo,256,131,125
37,Salamanca,2,Agallas,185,98,87
37,Salamanca,3,Ahigal de los Aceiteros,171,85,86
37,Salamanca,4,Ahigal de Villarino,42,20,22
37,Salamanca,5,Alameda de Gardón (La),130,60,70
37,Salamanca,6,Alamedilla (La),201,105,96
37,Salamanca,7,Alaraz,622,317,305
37,Salamanca,8,Alba de Tormes,4953,2457,2496
37,Salamanca,9,Alba de Yeltes,265,132,133
37,Salamanca,10,Alberca (La),1118,571,547
37,Salamanca,11,Alberguería de Argañán (La),182,97,85
37,Salamanca,12,Alconada,200,106,94
37,Salamanca,15,Aldea del Obispo,366,196,170
37,Salamanca,13,Aldeacipreste,180,100,80
37,Salamanca,14,Aldeadávila de la Ribera,1492,756,736
37,Salamanca,16,Aldealengua,557,287,270
37,Salamanca,17,Aldeanueva de Figueroa,317,161,156
37,Salamanca,18,Aldeanueva de la Sierra,114,63,51
37,Salamanca,19,Aldearrodrigo,183,100,83
37,Salamanca,20,Aldearrubia,517,280,237
37,Salamanca,21,Aldeaseca de Alba,109,50,59
37,Salamanca,22,Aldeaseca de la Frontera,331,169,162
37,Salamanca,23,Aldeatejada,864,437,427
37,Salamanca,24,Aldeavieja de Tormes,125,65,60
37,Salamanca,25,Aldehuela de la Bóveda,329,168,161
37,Salamanca,26,Aldehuela de Yeltes,263,137,126
37,Salamanca,27,Almenara de Tormes,253,128,125
37,Salamanca,28,Almendra,207,103,104
37,Salamanca,29,Anaya de Alba,271,146,125
37,Salamanca,30,Añover de Tormes,105,57,48
37,Salamanca,31,Arabayona de Mógica,476,255,221
37,Salamanca,32,Arapiles,489,243,246
37,Salamanca,33,Arcediano,100,53,47
37,Salamanca,34,Arco (El),114,63,51
37,Salamanca,35,Armenteros,439,228,211
37,Salamanca,37,Atalaya (La),140,77,63
37,Salamanca,38,Babilafuente,983,528,455
37,Salamanca,39,Bañobárez,350,186,164
37,Salamanca,40,Barbadillo,516,260,256
37,Salamanca,41,Barbalos,106,57,49
37,Salamanca,42,Barceo,55,27,28
37,Salamanca,44,Barruecopardo,534,274,260
37,Salamanca,45,Bastida (La),34,19,15
37,Salamanca,46,Béjar,15063,7159,7904
37,Salamanca,47,Beleña,156,78,78
37,Salamanca,49,Bermellar,194,97,97
37,Salamanca,50,Berrocal de Huebra,104,54,50
37,Salamanca,51,Berrocal de Salvatierra,113,53,60
37,Salamanca,52,Boada,360,178,182
37,Salamanca,54,Bodón (El),306,155,151
37,Salamanca,55,Bogajo,190,99,91
37,Salamanca,56,Bouza (La),67,35,32
37,Salamanca,57,Bóveda del Río Almar,288,151,137
37,Salamanca,58,Brincones,87,42,45
37,Salamanca,59,Buenamadre,158,89,69
37,Salamanca,60,Buenavista,150,77,73
37,Salamanca,61,Cabaco (El),303,159,144
37,Salamanca,63,Cabeza de Béjar (La),90,45,45
37,Salamanca,65,Cabeza del Caballo,450,232,218
37,Salamanca,62,Cabezabellosa de la Calzada,119,64,55
37,Salamanca,67,Cabrerizos,3064,1552,1512
37,Salamanca,68,Cabrillas,480,237,243
37,Salamanca,69,Calvarrasa de Abajo,1021,501,520
37,Salamanca,70,Calvarrasa de Arriba,673,351,322
37,Salamanca,71,Calzada de Béjar (La),103,51,52
37,Salamanca,72,Calzada de Don Diego,218,110,108
37,Salamanca,73,Calzada de Valdunciel,665,340,325
37,Salamanca,74,Campillo de Azaba,241,120,121
37,Salamanca,77,Campo de Peñaranda (El),335,178,157
37,Salamanca,78,Candelario,1023,516,507
37,Salamanca,79,Canillas de Abajo,99,60,39
37,Salamanca,80,Cantagallo,252,122,130
37,Salamanca,81,Cantalapiedra,1227,609,618
37,Salamanca,82,Cantalpino,1031,570,461
37,Salamanca,83,Cantaracillo,242,130,112
37,Salamanca,85,Carbajosa de la Sagrada,3547,1800,1747
37,Salamanca,86,Carpio de Azaba,111,60,51
37,Salamanca,87,Carrascal de Barregas,569,294,275
37,Salamanca,88,Carrascal del Obispo,232,118,114
37,Salamanca,89,Casafranca,85,41,44
37,Salamanca,90,Casas del Conde (Las),79,41,38
37,Salamanca,91,Casillas de Flores,220,111,109
37,Salamanca,92,Castellanos de Moriscos,508,247,261
37,Salamanca,185,Castellanos de Villiquera,574,303,271
37,Salamanca,96,Castillejo de Martín Viejo,306,165,141
37,Salamanca,97,Castraz,55,30,25
37,Salamanca,98,Cepeda,465,228,237
37,Salamanca,99,Cereceda de la Sierra,90,42,48
37,Salamanca,100,Cerezal de Peñahorcada,114,65,49
37,Salamanca,101,Cerralbo,238,124,114
37,Salamanca,102,Cerro (El),515,272,243
37,Salamanca,103,Cespedosa de Tormes,596,321,275
37,Salamanca,114,Chagarcía Medianero,119,66,53
37,Salamanca,104,Cilleros de la Bastida,44,24,20
37,Salamanca,106,Cipérez,377,183,194
37,Salamanca,107,Ciudad Rodrigo,14129,6835,7294
37,Salamanca,108,Coca de Alba,129,58,71
37,Salamanca,109,Colmenar de Montemayor,249,138,111
37,Salamanca,110,Cordovilla,137,80,57
37,Salamanca,112,Cristóbal,207,105,102
37,Salamanca,113,Cubo de Don Sancho (El),535,276,259
37,Salamanca,115,Dios le Guarde,175,94,81
37,Salamanca,116,Doñinos de Ledesma,97,51,46
37,Salamanca,117,Doñinos de Salamanca,803,413,390
37,Salamanca,118,Ejeme,161,85,76
37,Salamanca,119,Encina (La),151,82,69
37,Salamanca,120,Encina de San Silvestre,129,64,65
37,Salamanca,121,Encinas de Abajo,640,332,308
37,Salamanca,122,Encinas de Arriba,276,132,144
37,Salamanca,123,Encinasola de los Comendadores,257,132,125
37,Salamanca,124,Endrinal,290,162,128
37,Salamanca,125,Escurial de la Sierra,286,152,134
37,Salamanca,126,Espadaña,44,24,20
37,Salamanca,127,Espeja,291,150,141
37,Salamanca,128,Espino de la Orbada,319,164,155
37,Salamanca,129,Florida de Liébana,276,143,133
37,Salamanca,130,Forfoleda,233,122,111
37,Salamanca,131,Frades de la Sierra,248,131,117
37,Salamanca,132,Fregeneda (La),490,241,249
37,Salamanca,133,Fresnedoso,125,66,59
37,Salamanca,134,Fresno Alhándiga,281,148,133
37,Salamanca,135,Fuente de San Esteban (La),1442,737,705
37,Salamanca,136,Fuenteguinaldo,860,443,417
37,Salamanca,137,Fuenteliante,119,55,64
37,Salamanca,138,Fuenterroble de Salvatierra,264,134,130
37,Salamanca,139,Fuentes de Béjar,281,126,155
37,Salamanca,140,Fuentes de Oñoro,1482,751,731
37,Salamanca,141,Gajates,192,90,102
37,Salamanca,142,Galindo y Perahuy,507,286,221
37,Salamanca,143,Galinduste,537,264,273
37,Salamanca,144,Galisancho,475,264,211
37,Salamanca,145,Gallegos de Argañán,367,192,175
37,Salamanca,146,Gallegos de Solmirón,165,76,89
37,Salamanca,147,Garcibuey,232,129,103
37,Salamanca,148,Garcihernández,590,300,290
37,Salamanca,149,Garcirrey,93,49,44
37,Salamanca,150,Gejuelo del Barro,50,29,21
37,Salamanca,151,Golpejas,187,95,92
37,Salamanca,152,Gomecello,528,280,248
37,Salamanca,154,Guadramiro,186,107,79
37,Salamanca,155,Guijo de Ávila,107,68,39
37,Salamanca,156,Guijuelo,5368,2712,2656
37,Salamanca,157,Herguijuela de Ciudad Rodrigo,138,74,64
37,Salamanca,158,Herguijuela de la Sierra,312,159,153
37,Salamanca,159,Herguijuela del Campo,119,54,65
37,Salamanca,160,Hinojosa de Duero,774,389,385
37,Salamanca,161,Horcajo de Montemayor,194,100,94
37,Salamanca,162,Horcajo Medianero,326,166,160
37,Salamanca,163,Hoya (La),30,21,9
37,Salamanca,164,Huerta,294,163,131
37,Salamanca,165,Iruelos,48,20,28
37,Salamanca,166,Ituero de Azaba,270,150,120
37,Salamanca,167,Juzbado,178,89,89
37,Salamanca,168,Lagunilla,560,300,260
37,Salamanca,169,Larrodrigo,270,145,125
37,Salamanca,170,Ledesma,1881,950,931
37,Salamanca,171,Ledrada,564,283,281
37,Salamanca,172,Linares de Riofrío,1012,510,502
37,Salamanca,173,Lumbrales,2034,983,1051
37,Salamanca,175,Machacón,526,269,257
37,Salamanca,174,Macotera,1513,780,733
37,Salamanca,176,Madroñal,159,84,75
37,Salamanca,177,Maíllo (El),368,195,173
37,Salamanca,178,Malpartida,133,75,58
37,Salamanca,179,Mancera de Abajo,313,160,153
37,Salamanca,180,Manzano (El),98,54,44
37,Salamanca,181,Martiago,361,186,175
37,Salamanca,183,Martín de Yeltes,509,264,245
37,Salamanca,182,Martinamor,76,38,38
37,Salamanca,184,Masueco,407,210,197
37,Salamanca,186,Mata de Ledesma (La),136,74,62
37,Salamanca,187,Matilla de los Caños del Río,683,349,334
37,Salamanca,188,Maya (La),262,144,118
37,Salamanca,189,Membribe de la Sierra,111,69,42
37,Salamanca,190,Mieza,323,165,158
37,Salamanca,191,Milano (El),156,86,70
37,Salamanca,192,Miranda de Azán,386,194,192
37,Salamanca,193,Miranda del Castañar,575,297,278
37,Salamanca,194,Mogarraz,323,165,158
37,Salamanca,195,Molinillo,68,35,33
37,Salamanca,196,Monforte de la Sierra,96,57,39
37,Salamanca,197,Monleón,119,66,53
37,Salamanca,198,Monleras,275,133,142
37,Salamanca,199,Monsagro,196,107,89
37,Salamanca,200,Montejo,225,116,109
37,Salamanca,201,Montemayor del Río,329,175,154
37,Salamanca,202,Monterrubio de Armuña,706,385,321
37,Salamanca,203,Monterrubio de la Sierra,154,83,71
37,Salamanca,204,Morasverdes,382,188,194
37,Salamanca,205,Morille,225,116,109
37,Salamanca,206,Moríñigo,127,64,63
37,Salamanca,207,Moriscos,135,63,72
37,Salamanca,208,Moronta,124,63,61
37,Salamanca,209,Mozárbez,410,219,191
37,Salamanca,211,Narros de Matalayegua,268,139,129
37,Salamanca,213,Nava de Béjar,115,60,55
37,Salamanca,214,Nava de Francia,152,79,73
37,Salamanca,215,Nava de Sotrobal,200,111,89
37,Salamanca,212,Navacarros,143,81,62
37,Salamanca,216,Navales,362,206,156
37,Salamanca,217,Navalmoral de Béjar,60,26,34
37,Salamanca,218,Navamorales,128,73,55
37,Salamanca,219,Navarredonda de la Rinconada,261,127,134
37,Salamanca,221,Navasfrías,629,323,306
37,Salamanca,222,Negrilla de Palencia,123,67,56
37,Salamanca,223,Olmedo de Camaces,141,68,73
37,Salamanca,224,Orbada (La),280,144,136
37,Salamanca,225,Pajares de la Laguna,151,76,75
37,Salamanca,226,Palacios del Arzobispo,199,101,98
37,Salamanca,228,Palaciosrubios,494,265,229
37,Salamanca,229,Palencia de Negrilla,174,93,81
37,Salamanca,230,Parada de Arriba,237,124,113
37,Salamanca,231,Parada de Rubiales,323,167,156
37,Salamanca,232,Paradinas de San Juan,560,308,252
37,Salamanca,233,Pastores,53,30,23
37,Salamanca,234,Payo (El),448,224,224
37,Salamanca,235,Pedraza de Alba,289,146,143
37,Salamanca,236,Pedrosillo de Alba,211,108,103
37,Salamanca,237,Pedrosillo de los Aires,405,223,182
37,Salamanca,238,Pedrosillo el Ralo,129,64,65
37,Salamanca,239,Pedroso de la Armuña (El),276,132,144
37,Salamanca,240,Pelabravo,903,465,438
37,Salamanca,241,Pelarrodríguez,199,116,83
37,Salamanca,242,Pelayos,111,57,54
37,Salamanca,243,Peña (La),132,59,73
37,Salamanca,244,Peñacaballera,184,91,93
37,Salamanca,245,Peñaparda,438,235,203
37,Salamanca,246,Peñaranda de Bracamonte,6419,3135,3284
37,Salamanca,247,Peñarandilla,255,132,123
37,Salamanca,248,Peralejos de Abajo,182,93,89
37,Salamanca,249,Peralejos de Arriba,61,37,24
37,Salamanca,250,Pereña de la Ribera,498,263,235
37,Salamanca,251,Peromingo,146,68,78
37,Salamanca,252,Pinedas,172,91,81
37,Salamanca,253,Pino de Tormes (El),176,93,83
37,Salamanca,254,Pitiegua,239,126,113
37,Salamanca,255,Pizarral,80,43,37
37,Salamanca,256,Poveda de las Cintas,308,170,138
37,Salamanca,257,Pozos de Hinojo,65,34,31
37,Salamanca,258,Puebla de Azaba,247,130,117
37,Salamanca,259,Puebla de San Medel,55,30,25
37,Salamanca,260,Puebla de Yeltes,211,108,103
37,Salamanca,261,Puente del Congosto,279,142,137
37,Salamanca,262,Puertas,91,53,38
37,Salamanca,263,Puerto de Béjar,445,212,233
37,Salamanca,264,Puerto Seguro,98,52,46
37,Salamanca,265,Rágama,282,145,137
37,Salamanca,266,Redonda (La),99,52,47
37,Salamanca,267,Retortillo,262,125,137
37,Salamanca,268,Rinconada de la Sierra (La),163,91,72
37,Salamanca,269,Robleda,539,280,259
37,Salamanca,270,Robliza de Cojos,231,122,109
37,Salamanca,271,Rollán,543,268,275
37,Salamanca,272,Saelices el Chico,157,78,79
37,Salamanca,273,Sagrada (La),158,78,80
37,Salamanca,303,Sahugo (El),258,134,124
37,Salamanca,274,Salamanca,160331,74755,85576
37,Salamanca,275,Saldeana,155,87,68
37,Salamanca,276,Salmoral,263,144,119
37,Salamanca,277,Salvatierra de Tormes,60,30,30
37,Salamanca,278,San Cristóbal de la Cuesta,569,302,267
37,Salamanca,284,San Esteban de la Sierra,401,207,194
37,Salamanca,285,San Felices de los Gallegos,574,295,279
37,Salamanca,286,San Martín del Castañar,269,139,130
37,Salamanca,287,San Miguel de Valero,379,198,181
37,Salamanca,36,San Miguel del Robledo,96,44,52
37,Salamanca,288,San Morales,240,132,108
37,Salamanca,289,San Muñoz,311,164,147
37,Salamanca,291,San Pedro de Rozados,348,179,169
37,Salamanca,290,San Pedro del Valle,137,73,64
37,Salamanca,292,San Pelayo de Guareña,120,62,58
37,Salamanca,280,Sanchón de la Ribera,110,58,52
37,Salamanca,281,Sanchón de la Sagrada,47,27,20
37,Salamanca,282,Sanchotello,272,139,133
37,Salamanca,279,Sancti-Spíritus,989,503,486
37,Salamanca,283,Sando,189,103,86
37,Salamanca,293,Santa María de Sando,150,76,74
37,Salamanca,294,Santa Marta de Tormes,13175,6545,6630
37,Salamanca,296,Santiago de la Puebla,470,236,234
37,Salamanca,297,Santibáñez de Béjar,609,307,302
37,Salamanca,298,Santibáñez de la Sierra,250,130,120
37,Salamanca,299,Santiz,279,141,138
37,Salamanca,300,Santos (Los),703,358,345
37,Salamanca,301,Sardón de los Frailes,87,48,39
37,Salamanca,302,Saucelle,404,206,198
37,Salamanca,304,Sepulcro-Hilario,236,124,112
37,Salamanca,305,Sequeros,246,113,133
37,Salamanca,306,Serradilla del Arroyo,421,215,206
37,Salamanca,307,Serradilla del Llano,218,104,114
37,Salamanca,309,Sierpe (La),53,33,20
37,Salamanca,310,Sieteiglesias de Tormes,158,79,79
37,Salamanca,311,Sobradillo,325,163,162
37,Salamanca,312,Sorihuela,358,180,178
37,Salamanca,313,Sotoserrano,693,362,331
37,Salamanca,314,Tabera de Abajo,104,56,48
37,Salamanca,315,Tala (La),116,62,54
37,Salamanca,316,Tamames,984,500,484
37,Salamanca,317,Tarazona de Guareña,396,215,181
37,Salamanca,318,Tardáguila,240,125,115
37,Salamanca,319,Tejado (El),149,78,71
37,Salamanca,320,Tejeda y Segoyuela,126,62,64
37,Salamanca,321,Tenebrón,207,104,103
37,Salamanca,322,Terradillos,3206,1648,1558
37,Salamanca,323,Topas,696,357,339
37,Salamanca,324,Tordillos,520,270,250
37,Salamanca,325,Tornadizo (El),122,66,56
37,Salamanca,327,Torresmenudas,214,111,103
37,Salamanca,328,Trabanca,258,137,121
37,Salamanca,329,Tremedal de Tormes,35,18,17
37,Salamanca,330,Valdecarros,408,206,202
37,Salamanca,331,Valdefuentes de Sangusín,289,151,138
37,Salamanca,332,Valdehijaderos,103,55,48
37,Salamanca,333,Valdelacasa,320,175,145
37,Salamanca,334,Valdelageve,102,55,47
37,Salamanca,335,Valdelosa,548,259,289
37,Salamanca,336,Valdemierque,49,25,24
37,Salamanca,337,Valderrodrigo,179,87,92
37,Salamanca,338,Valdunciel,100,49,51
37,Salamanca,339,Valero,423,216,207
37,Salamanca,343,Vallejera de Riofrío,66,35,31
37,Salamanca,340,Valsalabroso,193,106,87
37,Salamanca,341,Valverde de Valdelacasa,63,34,29
37,Salamanca,342,Valverdón,279,142,137
37,Salamanca,344,Vecinos,309,154,155
37,Salamanca,345,Vega de Tirados,237,117,120
37,Salamanca,346,Veguillas (Las),295,145,150
37,Salamanca,347,Vellés (La),411,216,195
37,Salamanca,348,Ventosa del Río Almar,129,65,64
37,Salamanca,349,Vídola (La),149,71,78
37,Salamanca,351,Villaflores,390,197,193
37,Salamanca,352,Villagonzalo de Tormes,222,118,104
37,Salamanca,353,Villalba de los Llanos,181,103,78
37,Salamanca,354,Villamayor,4807,2475,2332
37,Salamanca,355,Villanueva del Conde,217,114,103
37,Salamanca,356,Villar de Argañán,98,47,51
37,Salamanca,357,Villar de Ciervo,349,180,169
37,Salamanca,358,Villar de Gallimazo,188,91,97
37,Salamanca,359,Villar de la Yegua,259,123,136
37,Salamanca,360,Villar de Peralonso,316,147,169
37,Salamanca,361,Villar de Samaniego,116,59,57
37,Salamanca,362,Villares de la Reina,4199,2087,2112
37,Salamanca,363,Villares de Yeltes,158,79,79
37,Salamanca,364,Villarino de los Aires,1040,523,517
37,Salamanca,365,Villarmayor,216,114,102
37,Salamanca,366,Villarmuerto,52,32,20
37,Salamanca,367,Villasbuenas,275,147,128
37,Salamanca,368,Villasdardo,22,9,13
37,Salamanca,369,Villaseco de los Gamitos,194,109,85
37,Salamanca,370,Villaseco de los Reyes,412,229,183
37,Salamanca,371,Villasrubias,291,161,130
37,Salamanca,372,Villaverde de Guareña,187,95,92
37,Salamanca,373,Villavieja de Yeltes,1022,511,511
37,Salamanca,374,Villoria,1423,711,712
37,Salamanca,375,Villoruela,985,496,489
37,Salamanca,350,Vilvestre,532,259,273
37,Salamanca,376,Vitigudino,2942,1455,1487
37,Salamanca,377,Yecla de Yeltes,328,170,158
37,Salamanca,378,Zamarra,141,75,66
37,Salamanca,379,Zamayón,188,104,84
37,Salamanca,380,Zarapicos,81,42,39
37,Salamanca,381,Zarza de Pumareda (La),163,92,71
37,Salamanca,382,Zorita de la Frontera,260,132,128
38,Santa Cruz de Tenerife,1,Adeje,33722,17711,16011
38,Santa Cruz de Tenerife,2,Agulo,1207,589,618
38,Santa Cruz de Tenerife,3,Alajeró,1954,1042,912
38,Santa Cruz de Tenerife,4,Arafo,5276,2558,2718
38,Santa Cruz de Tenerife,5,Arico,7159,3705,3454
38,Santa Cruz de Tenerife,6,Arona,65550,34305,31245
38,Santa Cruz de Tenerife,7,Barlovento,2507,1274,1233
38,Santa Cruz de Tenerife,8,Breña Alta,7039,3483,3556
38,Santa Cruz de Tenerife,9,Breña Baja,4355,2184,2171
38,Santa Cruz de Tenerife,10,Buenavista del Norte,5300,2720,2580
38,Santa Cruz de Tenerife,11,Candelaria,20628,10283,10345
38,Santa Cruz de Tenerife,12,Fasnia,2671,1364,1307
38,Santa Cruz de Tenerife,13,Frontera,5570,2810,2760
38,Santa Cruz de Tenerife,14,Fuencaliente de la Palma,1913,980,933
38,Santa Cruz de Tenerife,15,Garachico,5682,2808,2874
38,Santa Cruz de Tenerife,16,Garafía,1924,987,937
38,Santa Cruz de Tenerife,17,Granadilla de Abona,33207,17219,15988
38,Santa Cruz de Tenerife,18,Guancha (La),5388,2640,2748
38,Santa Cruz de Tenerife,19,Guía de Isora,18722,9497,9225
38,Santa Cruz de Tenerife,20,Güímar,16489,8148,8341
38,Santa Cruz de Tenerife,21,Hermigua,2142,1087,1055
38,Santa Cruz de Tenerife,22,Icod de los Vinos,24290,12062,12228
38,Santa Cruz de Tenerife,24,Llanos de Aridane (Los),19878,9833,10045
38,Santa Cruz de Tenerife,25,Matanza de Acentejo (La),7806,3961,3845
38,Santa Cruz de Tenerife,26,Orotava (La),40355,19914,20441
38,Santa Cruz de Tenerife,27,Paso (El),7404,3763,3641
38,Santa Cruz de Tenerife,28,Puerto de la Cruz,30613,14832,15781
38,Santa Cruz de Tenerife,29,Puntagorda,1795,907,888
38,Santa Cruz de Tenerife,30,Puntallana,2424,1202,1222
38,Santa Cruz de Tenerife,31,Realejos (Los),36243,17998,18245
38,Santa Cruz de Tenerife,32,Rosario (El),16024,8387,7637
38,Santa Cruz de Tenerife,33,San Andrés y Sauces,5086,2588,2498
38,Santa Cruz de Tenerife,23,San Cristóbal de La Laguna,141627,69858,71769
38,Santa Cruz de Tenerife,34,San Juan de la Rambla,5081,2520,2561
38,Santa Cruz de Tenerife,35,San Miguel de Abona,11737,6016,5721
38,Santa Cruz de Tenerife,36,San Sebastián de la Gomera,8445,4284,4161
38,Santa Cruz de Tenerife,37,Santa Cruz de la Palma,17788,8721,9067
38,Santa Cruz de Tenerife,38,Santa Cruz de Tenerife,221567,106896,114671
38,Santa Cruz de Tenerife,39,Santa Úrsula,12632,6331,6301
38,Santa Cruz de Tenerife,40,Santiago del Teide,11212,5663,5549
38,Santa Cruz de Tenerife,41,Sauzal (El),8317,4146,4171
38,Santa Cruz de Tenerife,42,Silos (Los),5497,2749,2748
38,Santa Cruz de Tenerife,43,Tacoronte,22384,11222,11162
38,Santa Cruz de Tenerife,44,Tanque (El),3096,1550,1546
38,Santa Cruz de Tenerife,45,Tazacorte,5835,2933,2902
38,Santa Cruz de Tenerife,46,Tegueste,10279,5089,5190
38,Santa Cruz de Tenerife,47,Tijarafe,2713,1379,1334
38,Santa Cruz de Tenerife,49,Valle Gran Rey,4857,2464,2393
38,Santa Cruz de Tenerife,50,Vallehermoso,3141,1603,1538
38,Santa Cruz de Tenerife,48,Valverde,4907,2490,2417
38,Santa Cruz de Tenerife,51,Victoria de Acentejo (La),8393,4182,4211
38,Santa Cruz de Tenerife,52,Vilaflor,1930,987,943
38,Santa Cruz de Tenerife,53,Villa de Mazo,4591,2319,2272
39,Cantabria,1,Alfoz de Lloredo,2600,1327,1273
39,Cantabria,2,Ampuero,3682,1857,1825
39,Cantabria,3,Anievas,381,188,193
39,Cantabria,4,Arenas de Iguña,1897,982,915
39,Cantabria,5,Argoños,1355,708,647
39,Cantabria,6,Arnuero,1956,989,967
39,Cantabria,7,Arredondo,558,314,244
39,Cantabria,8,Astillero (El),15635,7595,8040
39,Cantabria,9,Bárcena de Cicero,2935,1501,1434
39,Cantabria,10,Bárcena de Pie de Concha,805,389,416
39,Cantabria,11,Bareyo,1883,971,912
39,Cantabria,12,Cabezón de la Sal,7971,3936,4035
39,Cantabria,13,Cabezón de Liébana,700,391,309
39,Cantabria,14,Cabuérniga,1112,580,532
39,Cantabria,15,Camaleño,1109,577,532
39,Cantabria,16,Camargo,28429,14113,14316
39,Cantabria,27,Campoo de Enmedio,3967,2036,1931
39,Cantabria,17,Campoo de Yuso,727,375,352
39,Cantabria,18,Cartes,3982,2035,1947
39,Cantabria,19,Castañeda,1724,865,859
39,Cantabria,20,Castro-Urdiales,27220,13727,13493
39,Cantabria,21,Cieza,664,328,336
39,Cantabria,22,Cillorigo de Liébana,1179,622,557
39,Cantabria,23,Colindres,7235,3604,3631
39,Cantabria,24,Comillas,2431,1147,1284
39,Cantabria,25,Corrales de Buelna (Los),10958,5449,5509
39,Cantabria,26,Corvera de Toranzo,2221,1114,1107
39,Cantabria,28,Entrambasaguas,2692,1353,1339
39,Cantabria,29,Escalante,789,416,373
39,Cantabria,30,Guriezo,1979,1032,947
39,Cantabria,31,Hazas de Cesto,1285,651,634
39,Cantabria,32,Hermandad de Campoo de Suso,1944,1071,873
39,Cantabria,33,Herrerías,715,405,310
39,Cantabria,34,Lamasón,338,199,139
39,Cantabria,35,Laredo,13115,6369,6746
39,Cantabria,36,Liendo,995,515,480
39,Cantabria,37,Liérganes,2391,1201,1190
39,Cantabria,38,Limpias,1497,755,742
39,Cantabria,39,Luena,831,446,385
39,Cantabria,40,Marina de Cudeyo,5000,2535,2465
39,Cantabria,41,Mazcuerras,1997,1038,959
39,Cantabria,42,Medio Cudeyo,6925,3406,3519
39,Cantabria,43,Meruelo,1372,690,682
39,Cantabria,44,Miengo,3867,1934,1933
39,Cantabria,45,Miera,475,245,230
39,Cantabria,46,Molledo,1836,904,932
39,Cantabria,47,Noja,2337,1197,1140
39,Cantabria,48,Penagos,1698,855,843
39,Cantabria,49,Peñarrubia,374,190,184
39,Cantabria,50,Pesaguero,371,204,167
39,Cantabria,51,Pesquera,79,43,36
39,Cantabria,52,Piélagos,15748,7931,7817
39,Cantabria,53,Polaciones,257,170,87
39,Cantabria,54,Polanco,3910,1932,1978
39,Cantabria,55,Potes,1584,792,792
39,Cantabria,56,Puente Viesgo,2464,1252,1212
39,Cantabria,57,Ramales de la Victoria,2312,1193,1119
39,Cantabria,58,Rasines,968,519,449
39,Cantabria,59,Reinosa,10523,4988,5535
39,Cantabria,60,Reocín,7434,3680,3754
39,Cantabria,61,Ribamontán al Mar,4045,2056,1989
39,Cantabria,62,Ribamontán al Monte,2032,1053,979
39,Cantabria,63,Rionansa,1262,715,547
39,Cantabria,64,Riotuerto,1522,738,784
39,Cantabria,65,Rozas de Valdearroyo (Las),301,165,136
39,Cantabria,66,Ruente,1003,547,456
39,Cantabria,67,Ruesga,1127,584,543
39,Cantabria,68,Ruiloba,756,389,367
39,Cantabria,69,San Felices de Buelna,2241,1113,1128
39,Cantabria,70,San Miguel de Aguayo,144,75,69
39,Cantabria,71,San Pedro del Romeral,573,304,269
39,Cantabria,72,San Roque de Riomiera,454,261,193
39,Cantabria,80,San Vicente de la Barquera,4461,2265,2196
39,Cantabria,73,Santa Cruz de Bezana,10012,4946,5066
39,Cantabria,74,Santa María de Cayón,7107,3590,3517
39,Cantabria,75,Santander,183955,85834,98121
39,Cantabria,76,Santillana del Mar,4022,1966,2056
39,Cantabria,77,Santiurde de Reinosa,342,190,152
39,Cantabria,78,Santiurde de Toranzo,1366,678,688
39,Cantabria,79,Santoña,11592,5735,5857
39,Cantabria,81,Saro,512,266,246
39,Cantabria,82,Selaya,1982,1014,968
39,Cantabria,83,Soba,1494,785,709
39,Cantabria,84,Solórzano,1053,562,491
39,Cantabria,85,Suances,7117,3540,3577
39,Cantabria,86,Tojos (Los),409,233,176
39,Cantabria,87,Torrelavega,56230,27078,29152
39,Cantabria,88,Tresviso,69,39,30
39,Cantabria,89,Tudanca,215,131,84
39,Cantabria,90,Udías,829,430,399
39,Cantabria,95,Val de San Vicente,2650,1373,1277
39,Cantabria,91,Valdáliga,2430,1273,1157
39,Cantabria,92,Valdeolea,1293,660,633
39,Cantabria,93,Valdeprado del Río,315,174,141
39,Cantabria,94,Valderredible,1148,613,535
39,Cantabria,96,Vega de Liébana,944,505,439
39,Cantabria,97,Vega de Pas,955,507,448
39,Cantabria,98,Villacarriedo,1699,898,801
39,Cantabria,99,Villaescusa,3437,1721,1716
39,Cantabria,100,Villafufre,1115,571,544
39,Cantabria,101,Villaverde de Trucíos,388,203,185
39,Cantabria,102,Voto,2290,1186,1104
40,Segovia,1,Abades,896,456,440
40,Segovia,2,Adrada de Pirón,46,23,23
40,Segovia,3,Adrados,207,111,96
40,Segovia,4,Aguilafuente,758,374,384
40,Segovia,5,Alconada de Maderuelo,53,33,20
40,Segovia,12,Aldea Real,385,204,181
40,Segovia,6,Aldealcorvo,19,9,10
40,Segovia,7,Aldealengua de Pedraza,96,55,41
40,Segovia,8,Aldealengua de Santa María,78,44,34
40,Segovia,9,Aldeanueva de la Serrezuela,53,31,22
40,Segovia,10,Aldeanueva del Codonal,191,102,89
40,Segovia,13,Aldeasoña,92,48,44
40,Segovia,14,Aldehorno,59,29,30
40,Segovia,15,Aldehuela del Codonal,42,23,19
40,Segovia,16,Aldeonte,93,46,47
40,Segovia,17,Anaya,142,76,66
40,Segovia,18,Añe,119,66,53
40,Segovia,19,Arahuetes,56,31,25
40,Segovia,20,Arcones,260,139,121
40,Segovia,21,Arevalillo de Cega,46,22,24
40,Segovia,22,Armuña,247,133,114
40,Segovia,24,Ayllón,1261,634,627
40,Segovia,25,Barbolla,205,110,95
40,Segovia,26,Basardilla,141,67,74
40,Segovia,28,Bercial,124,62,62
40,Segovia,29,Bercimuel,81,39,42
40,Segovia,30,Bernardos,672,356,316
40,Segovia,31,Bernuy de Porreros,453,240,213
40,Segovia,32,Boceguillas,672,340,332
40,Segovia,33,Brieva,79,50,29
40,Segovia,34,Caballar,103,50,53
40,Segovia,35,Cabañas de Polendos,120,63,57
40,Segovia,36,Cabezuela,716,377,339
40,Segovia,37,Calabazas de Fuentidueña,61,30,31
40,Segovia,39,Campo de San Pedro,376,217,159
40,Segovia,40,Cantalejo,3658,1854,1804
40,Segovia,41,Cantimpalos,1313,685,628
40,Segovia,43,Carbonero el Mayor,2520,1289,1231
40,Segovia,44,Carrascal del Río,201,104,97
40,Segovia,45,Casla,162,83,79
40,Segovia,46,Castillejo de Mesleón,153,84,69
40,Segovia,47,Castro de Fuentidueña,68,36,32
40,Segovia,48,Castrojimeno,41,24,17
40,Segovia,49,Castroserna de Abajo,49,24,25
40,Segovia,51,Castroserracín,48,30,18
40,Segovia,52,Cedillo de la Torre,112,53,59
40,Segovia,53,Cerezo de Abajo,185,89,96
40,Segovia,54,Cerezo de Arriba,212,122,90
40,Segovia,65,Chañe,712,378,334
40,Segovia,55,Cilleruelo de San Mamés,44,21,23
40,Segovia,56,Cobos de Fuentidueña,57,24,33
40,Segovia,57,Coca,2080,996,1084
40,Segovia,58,Codorniz,435,213,222
40,Segovia,59,Collado Hermoso,159,81,78
40,Segovia,60,Condado de Castilnovo,133,72,61
40,Segovia,61,Corral de Ayllón,93,51,42
40,Segovia,902,Cozuelos de Fuentidueña,162,90,72
40,Segovia,62,Cubillo,58,36,22
40,Segovia,63,Cuéllar,9483,4844,4639
40,Segovia,905,Cuevas de Provanco,173,89,84
40,Segovia,68,Domingo García,45,23,22
40,Segovia,69,Donhierro,109,58,51
40,Segovia,70,Duruelo,140,76,64
40,Segovia,71,Encinas,61,30,31
40,Segovia,72,Encinillas,86,48,38
40,Segovia,73,Escalona del Prado,634,336,298
40,Segovia,74,Escarabajosa de Cabezas,358,203,155
40,Segovia,75,Escobar de Polendos,245,128,117
40,Segovia,76,Espinar (El),7746,4004,3742
40,Segovia,77,Espirdo,422,224,198
40,Segovia,78,Fresneda de Cuéllar,218,118,100
40,Segovia,79,Fresno de Cantespino,298,163,135
40,Segovia,80,Fresno de la Fuente,91,49,42
40,Segovia,81,Frumales,193,94,99
40,Segovia,82,Fuente de Santa Cruz,172,83,89
40,Segovia,83,Fuente el Olmo de Fuentidueña,114,60,54
40,Segovia,84,Fuente el Olmo de Íscar,90,49,41
40,Segovia,86,Fuentepelayo,966,497,469
40,Segovia,87,Fuentepiñel,142,71,71
40,Segovia,88,Fuenterrebollo,386,199,187
40,Segovia,89,Fuentesaúco de Fuentidueña,316,164,152
40,Segovia,91,Fuentesoto,159,87,72
40,Segovia,92,Fuentidueña,149,80,69
40,Segovia,93,Gallegos,97,49,48
40,Segovia,94,Garcillán,393,208,185
40,Segovia,95,Gomezserracín,744,385,359
40,Segovia,97,Grajera,108,59,49
40,Segovia,99,Honrubia de la Cuesta,89,50,39
40,Segovia,100,Hontalbilla,378,202,176
40,Segovia,101,Hontanares de Eresma,306,177,129
40,Segovia,103,Huertos (Los),141,72,69
40,Segovia,104,Ituero y Lama,109,62,47
40,Segovia,105,Juarros de Riomoros,73,43,30
40,Segovia,106,Juarros de Voltoya,290,142,148
40,Segovia,107,Labajos,143,81,62
40,Segovia,108,Laguna de Contreras,153,87,66
40,Segovia,109,Languilla,119,67,52
40,Segovia,110,Lastras de Cuéllar,477,249,228
40,Segovia,111,Lastras del Pozo,83,40,43
40,Segovia,112,Lastrilla (La),2456,1260,1196
40,Segovia,113,Losa (La),486,254,232
40,Segovia,115,Maderuelo,140,73,67
40,Segovia,903,Marazoleja,133,77,56
40,Segovia,118,Marazuela,59,31,28
40,Segovia,119,Martín Miguel,183,100,83
40,Segovia,120,Martín Muñoz de la Dehesa,185,98,87
40,Segovia,121,Martín Muñoz de las Posadas,417,196,221
40,Segovia,122,Marugán,498,278,220
40,Segovia,124,Mata de Cuéllar,309,165,144
40,Segovia,123,Matabuena,218,113,105
40,Segovia,125,Matilla (La),113,62,51
40,Segovia,126,Melque de Cercos,108,54,54
40,Segovia,127,Membibre de la Hoz,54,27,27
40,Segovia,128,Migueláñez,171,75,96
40,Segovia,129,Montejo de Arévalo,256,139,117
40,Segovia,130,Montejo de la Vega de la Serrezuela,184,102,82
40,Segovia,131,Monterrubio,72,41,31
40,Segovia,132,Moral de Hornuez,90,49,41
40,Segovia,134,Mozoncillo,1020,523,497
40,Segovia,135,Muñopedro,364,191,173
40,Segovia,136,Muñoveros,195,106,89
40,Segovia,138,Nava de la Asunción,2774,1403,1371
40,Segovia,139,Navafría,336,175,161
40,Segovia,140,Navalilla,133,69,64
40,Segovia,141,Navalmanzano,1181,605,576
40,Segovia,142,Navares de Ayuso,72,41,31
40,Segovia,143,Navares de Enmedio,127,71,56
40,Segovia,144,Navares de las Cuevas,35,22,13
40,Segovia,145,Navas de Oro,1415,730,685
40,Segovia,904,Navas de Riofrío,366,173,193
40,Segovia,146,Navas de San Antonio,325,169,156
40,Segovia,148,Nieva,349,184,165
40,Segovia,149,Olombrada,763,414,349
40,Segovia,150,Orejana,84,52,32
40,Segovia,151,Ortigosa de Pestaño,109,59,50
40,Segovia,901,Ortigosa del Monte,435,224,211
40,Segovia,152,Otero de Herreros,882,443,439
40,Segovia,154,Pajarejos,43,22,21
40,Segovia,155,Palazuelos de Eresma,2771,1471,1300
40,Segovia,156,Pedraza,472,261,211
40,Segovia,157,Pelayos del Arroyo,54,29,25
40,Segovia,158,Perosillo,24,15,9
40,Segovia,159,Pinarejos,162,94,68
40,Segovia,160,Pinarnegrillo,159,89,70
40,Segovia,161,Pradales,63,31,32
40,Segovia,162,Prádena,565,315,250
40,Segovia,163,Puebla de Pedraza,93,48,45
40,Segovia,164,Rapariegos,254,132,122
40,Segovia,165,Rebollo,127,69,58
40,Segovia,166,Remondo,340,165,175
40,Segovia,168,Riaguas de San Bartolomé,73,40,33
40,Segovia,170,Riaza,2125,1161,964
40,Segovia,171,Ribota,41,24,17
40,Segovia,172,Riofrío de Riaza,49,23,26
40,Segovia,173,Roda de Eresma,138,79,59
40,Segovia,174,Sacramenia,545,283,262
40,Segovia,176,Samboal,558,288,270
40,Segovia,177,San Cristóbal de Cuéllar,201,103,98
40,Segovia,178,San Cristóbal de la Vega,142,69,73
40,Segovia,906,San Cristóbal de Segovia,2455,1255,1200
40,Segovia,181,San Ildefonso,5498,2695,2803
40,Segovia,182,San Martín y Mudrián,265,132,133
40,Segovia,183,San Miguel de Bernuy,205,103,102
40,Segovia,184,San Pedro de Gaíllos,355,180,175
40,Segovia,179,Sanchonuño,851,421,430
40,Segovia,180,Sangarcía,456,235,221
40,Segovia,185,Santa María la Real de Nieva,1310,687,623
40,Segovia,186,Santa Marta del Cerro,52,27,25
40,Segovia,188,Santiuste de Pedraza,118,63,55
40,Segovia,189,Santiuste de San Juan Bautista,719,380,339
40,Segovia,190,Santo Domingo de Pirón,64,30,34
40,Segovia,191,Santo Tomé del Puerto,355,197,158
40,Segovia,192,Sauquillo de Cabezas,231,123,108
40,Segovia,193,Sebúlcor,281,154,127
40,Segovia,194,Segovia,55942,26808,29134
40,Segovia,195,Sepúlveda,1322,675,647
40,Segovia,196,Sequera de Fresno,54,32,22
40,Segovia,198,Sotillo,39,19,20
40,Segovia,199,Sotosalbos,114,64,50
40,Segovia,200,Tabanera la Luenga,62,33,29
40,Segovia,201,Tolocirio,57,27,30
40,Segovia,206,Torre Val de San Pedro,196,107,89
40,Segovia,202,Torreadrada,109,45,64
40,Segovia,203,Torrecaballeros,812,412,400
40,Segovia,204,Torrecilla del Pinar,273,136,137
40,Segovia,205,Torreiglesias,382,199,183
40,Segovia,207,Trescasas,519,273,246
40,Segovia,208,Turégano,1147,582,565
40,Segovia,210,Urueñas,114,62,52
40,Segovia,211,Valdeprados,117,55,62
40,Segovia,212,Valdevacas de Montejo,29,17,12
40,Segovia,213,Valdevacas y Guijar,145,77,68
40,Segovia,218,Valle de Tabladillo,152,82,70
40,Segovia,219,Vallelado,837,437,400
40,Segovia,220,Valleruela de Pedraza,75,37,38
40,Segovia,221,Valleruela de Sepúlveda,69,32,37
40,Segovia,214,Valseca,305,160,145
40,Segovia,215,Valtiendas,168,96,72
40,Segovia,216,Valverde del Majano,622,322,300
40,Segovia,222,Veganzones,316,168,148
40,Segovia,223,Vegas de Matute,275,161,114
40,Segovia,224,Ventosilla y Tejadilla,46,29,17
40,Segovia,225,Villacastín,1586,814,772
40,Segovia,228,Villaverde de Íscar,687,349,338
40,Segovia,229,Villaverde de Montejo,61,38,23
40,Segovia,230,Villeguillo,130,69,61
40,Segovia,231,Yanguas de Eresma,203,105,98
40,Segovia,233,Zarzuela del Monte,528,275,253
40,Segovia,234,Zarzuela del Pinar,557,291,266
41,Sevilla,1,Aguadulce,1993,1006,987
41,Sevilla,2,Alanís,1937,971,966
41,Sevilla,3,Albaida del Aljarafe,2231,1140,1091
41,Sevilla,4,Alcalá de Guadaíra,63237,31479,31758
41,Sevilla,5,Alcalá del Río,9317,4735,4582
41,Sevilla,6,Alcolea del Río,3331,1639,1692
41,Sevilla,7,Algaba (La),13623,6821,6802
41,Sevilla,8,Algámitas,1337,689,648
41,Sevilla,9,Almadén de la Plata,1696,867,829
41,Sevilla,10,Almensilla,4534,2298,2236
41,Sevilla,11,Arahal,18655,9245,9410
41,Sevilla,12,Aznalcázar,3692,1867,1825
41,Sevilla,13,Aznalcóllar,5988,3067,2921
41,Sevilla,14,Badolatosa,3198,1638,1560
41,Sevilla,15,Benacazón,5754,2938,2816
41,Sevilla,16,Bollullos de la Mitación,6639,3292,3347
41,Sevilla,17,Bormujos,14585,7288,7297
41,Sevilla,18,Brenes,11412,5740,5672
41,Sevilla,19,Burguillos,4142,2096,2046
41,Sevilla,20,Cabezas de San Juan (Las),16055,8203,7852
41,Sevilla,21,Camas,25768,12617,13151
41,Sevilla,22,Campana (La),5236,2627,2609
41,Sevilla,23,Cantillana,9411,4787,4624
41,Sevilla,901,Cañada Rosal,3085,1524,1561
41,Sevilla,24,Carmona,26926,13577,13349
41,Sevilla,25,Carrión de los Céspedes,2274,1089,1185
41,Sevilla,26,Casariche,5395,2717,2678
41,Sevilla,27,Castilblanco de los Arroyos,4773,2401,2372
41,Sevilla,28,Castilleja de Guzmán,2409,1239,1170
41,Sevilla,29,Castilleja de la Cuesta,16819,8278,8541
41,Sevilla,30,Castilleja del Campo,638,317,321
41,Sevilla,31,Castillo de las Guardas (El),1619,824,795
41,Sevilla,32,Cazalla de la Sierra,5161,2566,2595
41,Sevilla,33,Constantina,6826,3346,3480
41,Sevilla,34,Coria del Río,25735,12906,12829
41,Sevilla,35,Coripe,1429,733,696
41,Sevilla,36,Coronil (El),5044,2549,2495
41,Sevilla,37,Corrales (Los),4095,2095,2000
41,Sevilla,903,Cuervo de Sevilla (El),8130,4150,3980
41,Sevilla,38,Dos Hermanas,112273,55717,56556
41,Sevilla,39,Écija,38911,19148,19763
41,Sevilla,40,Espartinas,7958,3993,3965
41,Sevilla,41,Estepa,12153,6015,6138
41,Sevilla,42,Fuentes de Andalucía,7378,3673,3705
41,Sevilla,43,Garrobo (El),808,418,390
41,Sevilla,44,Gelves,7958,3981,3977
41,Sevilla,45,Gerena,5827,2911,2916
41,Sevilla,46,Gilena,3848,1932,1916
41,Sevilla,47,Gines,12177,6003,6174
41,Sevilla,48,Guadalcanal,2927,1458,1469
41,Sevilla,49,Guillena,9035,4565,4470
41,Sevilla,50,Herrera,6302,3130,3172
41,Sevilla,51,Huévar del Aljarafe,2457,1276,1181
41,Sevilla,902,Isla Mayor,5853,2949,2904
41,Sevilla,52,Lantejuela (La),3777,1938,1839
41,Sevilla,53,Lebrija,24866,12545,12321
41,Sevilla,54,Lora de Estepa,828,414,414
41,Sevilla,55,Lora del Río,18861,9357,9504
41,Sevilla,56,Luisiana (La),4495,2278,2217
41,Sevilla,57,Madroño (El),367,189,178
41,Sevilla,58,Mairena del Alcor,18075,9021,9054
41,Sevilla,59,Mairena del Aljarafe,38770,19460,19310
41,Sevilla,60,Marchena,18719,9329,9390
41,Sevilla,61,Marinaleda,2655,1345,1310
41,Sevilla,62,Martín de la Jara,2748,1426,1322
41,Sevilla,63,Molares (Los),2874,1471,1403
41,Sevilla,64,Montellano,6913,3481,3432
41,Sevilla,65,Morón de la Frontera,28117,13983,14134
41,Sevilla,66,Navas de la Concepción (Las),1831,911,920
41,Sevilla,67,Olivares,8729,4391,4338
41,Sevilla,68,Osuna,17431,8594,8837
41,Sevilla,69,Palacios y Villafranca (Los),34648,17531,17117
41,Sevilla,70,Palomares del Río,4728,2377,2351
41,Sevilla,71,Paradas,7048,3534,3514
41,Sevilla,72,Pedrera,5143,2551,2592
41,Sevilla,73,Pedroso (El),2291,1126,1165
41,Sevilla,74,Peñaflor,3674,1864,1810
41,Sevilla,75,Pilas,11918,5966,5952
41,Sevilla,76,Pruna,3060,1573,1487
41,Sevilla,77,Puebla de Cazalla (La),10729,5350,5379
41,Sevilla,78,Puebla de los Infantes (La),3263,1630,1633
41,Sevilla,79,Puebla del Río (La),11326,5648,5678
41,Sevilla,80,Real de la Jara (El),1614,771,843
41,Sevilla,81,Rinconada (La),32525,16398,16127
41,Sevilla,82,Roda de Andalucía (La),4322,2164,2158
41,Sevilla,83,Ronquillo (El),1381,699,682
41,Sevilla,84,Rubio (El),3584,1778,1806
41,Sevilla,85,Salteras,4142,2047,2095
41,Sevilla,86,San Juan de Aznalfarache,20170,9831,10339
41,Sevilla,88,San Nicolás del Puerto,693,345,348
41,Sevilla,87,Sanlúcar la Mayor,11762,5847,5915
41,Sevilla,89,Santiponce,7558,3785,3773
41,Sevilla,90,Saucejo (El),4334,2165,2169
41,Sevilla,91,Sevilla,704154,335993,368161
41,Sevilla,92,Tocina,9114,4518,4596
41,Sevilla,93,Tomares,20127,10037,10090
41,Sevilla,94,Umbrete,5797,2906,2891
41,Sevilla,95,Utrera,47429,23925,23504
41,Sevilla,96,Valencina de la Concepción,7431,3716,3715
41,Sevilla,97,Villamanrique de la Condesa,3826,1864,1962
41,Sevilla,100,Villanueva de San Juan,1440,720,720
41,Sevilla,98,Villanueva del Ariscal,5511,2692,2819
41,Sevilla,99,Villanueva del Río y Minas,5237,2539,2698
41,Sevilla,101,Villaverde del Río,6685,3400,3285
41,Sevilla,102,Viso del Alcor (El),17194,8674,8520
42,Soria,1,Abejar,392,205,187
42,Soria,3,Adradas,82,45,37
42,Soria,4,Ágreda,3216,1617,1599
42,Soria,6,Alconaba,171,102,69
42,Soria,7,Alcubilla de Avellaneda,183,90,93
42,Soria,8,Alcubilla de las Peñas,72,37,35
42,Soria,9,Aldealafuente,124,66,58
42,Soria,10,Aldealices,28,12,16
42,Soria,11,Aldealpozo,27,13,14
42,Soria,12,Aldealseñor,43,25,18
42,Soria,13,Aldehuela de Periáñez,48,25,23
42,Soria,14,Aldehuelas (Las),98,51,47
42,Soria,15,Alentisque,42,19,23
42,Soria,16,Aliud,28,15,13
42,Soria,17,Almajano,224,125,99
42,Soria,18,Almaluez,243,128,115
42,Soria,19,Almarza,667,373,294
42,Soria,20,Almazán,5727,2852,2875
42,Soria,21,Almazul,131,70,61
42,Soria,22,Almenar de Soria,335,177,158
42,Soria,23,Alpanseque,93,49,44
42,Soria,24,Arancón,110,63,47
42,Soria,25,Arcos de Jalón,1871,956,915
42,Soria,26,Arenillas,30,19,11
42,Soria,27,Arévalo de la Sierra,83,51,32
42,Soria,28,Ausejo de la Sierra,64,32,32
42,Soria,29,Baraona,202,106,96
42,Soria,30,Barca,115,71,44
42,Soria,31,Barcones,42,25,17
42,Soria,32,Bayubas de Abajo,246,132,114
42,Soria,33,Bayubas de Arriba,67,35,32
42,Soria,34,Beratón,46,30,16
42,Soria,35,Berlanga de Duero,1085,546,539
42,Soria,36,Blacos,67,36,31
42,Soria,37,Bliecos,45,28,17
42,Soria,38,Borjabad,54,31,23
42,Soria,39,Borobia,339,175,164
42,Soria,41,Buberos,45,24,21
42,Soria,42,Buitrago,56,27,29
42,Soria,43,Burgo de Osma-Ciudad de Osma,5068,2516,2552
42,Soria,44,Cabrejas del Campo,78,41,37
42,Soria,45,Cabrejas del Pinar,461,249,212
42,Soria,46,Calatañazor,64,37,27
42,Soria,48,Caltojar,108,60,48
42,Soria,49,Candilichera,196,101,95
42,Soria,50,Cañamaque,38,23,15
42,Soria,51,Carabantes,29,15,14
42,Soria,52,Caracena,19,14,5
42,Soria,53,Carrascosa de Abajo,33,19,14
42,Soria,54,Carrascosa de la Sierra,12,7,5
42,Soria,55,Casarejos,252,130,122
42,Soria,56,Castilfrío de la Sierra,28,18,10
42,Soria,58,Castillejo de Robledo,161,89,72
42,Soria,57,Castilruiz,278,143,135
42,Soria,59,Centenera de Andaluz,25,9,16
42,Soria,60,Cerbón,42,24,18
42,Soria,61,Cidones,351,197,154
42,Soria,62,Cigudosa,55,33,22
42,Soria,63,Cihuela,82,40,42
42,Soria,64,Ciria,106,52,54
42,Soria,65,Cirujales del Río,34,18,16
42,Soria,68,Coscurita,129,70,59
42,Soria,69,Covaleda,2020,1031,989
42,Soria,70,Cubilla,61,32,29
42,Soria,71,Cubo de la Solana,231,124,107
42,Soria,73,Cueva de Ágreda,93,49,44
42,Soria,75,Dévanos,114,60,54
42,Soria,76,Deza,338,165,173
42,Soria,78,Duruelo de la Sierra,1383,690,693
42,Soria,79,Escobosa de Almazán,37,22,15
42,Soria,80,Espeja de San Marcelino,232,133,99
42,Soria,81,Espejón,205,108,97
42,Soria,82,Estepa de San Juan,10,5,5
42,Soria,83,Frechilla de Almazán,33,17,16
42,Soria,84,Fresno de Caracena,32,18,14
42,Soria,85,Fuentearmegil,281,149,132
42,Soria,86,Fuentecambrón,60,33,27
42,Soria,87,Fuentecantos,56,28,28
42,Soria,88,Fuentelmonge,110,61,49
42,Soria,89,Fuentelsaz de Soria,57,23,34
42,Soria,90,Fuentepinilla,138,77,61
42,Soria,92,Fuentes de Magaña,77,39,38
42,Soria,93,Fuentestrún,67,41,26
42,Soria,94,Garray,490,278,212
42,Soria,95,Golmayo,1402,753,649
42,Soria,96,Gómara,424,226,198
42,Soria,97,Gormaz,18,7,11
42,Soria,98,Herrera de Soria,19,12,7
42,Soria,100,Hinojosa del Campo,40,26,14
42,Soria,103,Langa de Duero,848,466,382
42,Soria,105,Liceras,56,28,28
42,Soria,106,Losilla (La),13,9,4
42,Soria,107,Magaña,104,54,50
42,Soria,108,Maján,15,8,7
42,Soria,110,Matalebreras,117,61,56
42,Soria,111,Matamala de Almazán,372,198,174
42,Soria,113,Medinaceli,694,349,345
42,Soria,115,Miño de Medinaceli,99,49,50
42,Soria,116,Miño de San Esteban,75,43,32
42,Soria,117,Molinos de Duero,188,101,87
42,Soria,118,Momblona,36,21,15
42,Soria,119,Monteagudo de las Vicarías,257,135,122
42,Soria,120,Montejo de Tiermes,245,139,106
42,Soria,121,Montenegro de Cameros,100,60,40
42,Soria,123,Morón de Almazán,234,110,124
42,Soria,124,Muriel de la Fuente,82,47,35
42,Soria,125,Muriel Viejo,67,32,35
42,Soria,127,Nafría de Ucero,79,41,38
42,Soria,128,Narros,50,25,25
42,Soria,129,Navaleno,974,497,477
42,Soria,130,Nepas,81,48,33
42,Soria,131,Nolay,85,46,39
42,Soria,132,Noviercas,215,111,104
42,Soria,134,Ólvega,3369,1736,1633
42,Soria,135,Oncala,105,62,43
42,Soria,139,Pinilla del Campo,21,12,9
42,Soria,140,Portillo de Soria,19,11,8
42,Soria,141,Póveda de Soria (La),124,65,59
42,Soria,142,Pozalmuro,100,53,47
42,Soria,144,Quintana Redonda,562,299,263
42,Soria,145,Quintanas de Gormaz,184,99,85
42,Soria,148,Quiñonería,15,5,10
42,Soria,149,Rábanos (Los),467,279,188
42,Soria,151,Rebollar,54,27,27
42,Soria,152,Recuerda,105,58,47
42,Soria,153,Rello,33,17,16
42,Soria,154,Renieblas,126,69,57
42,Soria,155,Retortillo de Soria,227,120,107
42,Soria,156,Reznos,38,25,13
42,Soria,157,Riba de Escalote (La),25,14,11
42,Soria,158,Rioseco de Soria,137,71,66
42,Soria,159,Rollamienta,48,30,18
42,Soria,160,Royo (El),313,168,145
42,Soria,161,Salduero,186,98,88
42,Soria,162,San Esteban de Gormaz,3158,1629,1529
42,Soria,163,San Felices,74,36,38
42,Soria,164,San Leonardo de Yagüe,2300,1187,1113
42,Soria,165,San Pedro Manrique,572,313,259
42,Soria,166,Santa Cruz de Yanguas,65,37,28
42,Soria,167,Santa María de Huerta,407,223,184
42,Soria,168,Santa María de las Hoyas,188,99,89
42,Soria,171,Serón de Nágima,229,119,110
42,Soria,172,Soliedra,39,20,19
42,Soria,173,Soria,37200,17799,19401
42,Soria,174,Sotillo del Rincón,215,111,104
42,Soria,175,Suellacabras,31,20,11
42,Soria,176,Tajahuerce,37,17,20
42,Soria,177,Tajueco,105,57,48
42,Soria,178,Talveila,179,95,84
42,Soria,181,Tardelcuende,580,284,296
42,Soria,182,Taroda,72,36,36
42,Soria,183,Tejado,179,91,88
42,Soria,184,Torlengua,94,49,45
42,Soria,185,Torreblacos,33,18,15
42,Soria,187,Torrubia de Soria,80,47,33
42,Soria,188,Trévago,75,28,47
42,Soria,189,Ucero,94,48,46
42,Soria,190,Vadillo,141,69,72
42,Soria,191,Valdeavellano de Tera,234,121,113
42,Soria,192,Valdegeña,54,34,20
42,Soria,193,Valdelagua del Cerro,17,9,8
42,Soria,194,Valdemaluque,244,124,120
42,Soria,195,Valdenebro,153,78,75
42,Soria,196,Valdeprado,20,11,9
42,Soria,197,Valderrodilla,101,53,48
42,Soria,198,Valtajeros,27,17,10
42,Soria,200,Velamazán,122,72,50
42,Soria,201,Velilla de la Sierra,34,18,16
42,Soria,202,Velilla de los Ajos,40,23,17
42,Soria,204,Viana de Duero,73,44,29
42,Soria,205,Villaciervos,121,68,53
42,Soria,206,Villanueva de Gormaz,22,13,9
42,Soria,207,Villar del Ala,60,30,30
42,Soria,208,Villar del Campo,31,18,13
42,Soria,209,Villar del Río,187,102,85
42,Soria,211,Villares de Soria (Los),109,56,53
42,Soria,212,Villasayas,91,59,32
42,Soria,213,Villaseca de Arciel,38,21,17
42,Soria,215,Vinuesa,1025,548,477
42,Soria,216,Vizmanos,34,22,12
42,Soria,217,Vozmediano,45,26,19
42,Soria,218,Yanguas,127,72,55
42,Soria,219,Yelo,55,31,24
43,Tarragona,1,Aiguamúrcia,719,392,327
43,Tarragona,2,Albinyana,2036,1041,995
43,Tarragona,3,Albiol (L'),333,173,160
43,Tarragona,4,Alcanar,9311,4793,4518
43,Tarragona,5,Alcover,4405,2273,2132
43,Tarragona,904,Aldea (L'),3693,1916,1777
43,Tarragona,6,Aldover,833,405,428
43,Tarragona,7,Aleixar (L'),767,390,377
43,Tarragona,8,Alfara de Carles,360,189,171
43,Tarragona,9,Alforja,1488,770,718
43,Tarragona,10,Alió,384,194,190
43,Tarragona,11,Almoster,1140,586,554
43,Tarragona,12,Altafulla,3993,2011,1982
43,Tarragona,13,Ametlla de Mar (L'),6438,3318,3120
43,Tarragona,906,Ampolla (L'),2518,1278,1240
43,Tarragona,14,Amposta,18719,9463,9256
43,Tarragona,16,Arboç (L'),4562,2464,2098
43,Tarragona,15,Arbolí,112,61,51
43,Tarragona,17,Argentera (L'),161,94,67
43,Tarragona,18,Arnes,514,268,246
43,Tarragona,19,Ascó,1601,806,795
43,Tarragona,20,Banyeres del Penedès,2303,1211,1092
43,Tarragona,21,Barberà de la Conca,488,252,236
43,Tarragona,22,Batea,2094,1068,1026
43,Tarragona,23,Bellmunt del Priorat,320,162,158
43,Tarragona,24,Bellvei,1643,883,760
43,Tarragona,25,Benifallet,810,401,409
43,Tarragona,26,Benissanet,1169,617,552
43,Tarragona,27,Bisbal de Falset (La),254,136,118
43,Tarragona,28,Bisbal del Penedès (La),2680,1427,1253
43,Tarragona,29,Blancafort,421,222,199
43,Tarragona,30,Bonastre,494,265,229
43,Tarragona,31,Borges del Camp (Les),1855,932,923
43,Tarragona,32,Bot,783,396,387
43,Tarragona,33,Botarell,933,497,436
43,Tarragona,34,Bràfim,636,331,305
43,Tarragona,35,Cabacés,340,180,160
43,Tarragona,36,Cabra del Camp,859,461,398
43,Tarragona,37,Calafell,18905,9628,9277
43,Tarragona,903,Camarles,3279,1685,1594
43,Tarragona,38,Cambrils,26209,13123,13086
43,Tarragona,39,Capafonts,110,60,50
43,Tarragona,40,Capçanes,400,195,205
43,Tarragona,41,Caseres,318,154,164
43,Tarragona,42,Castellvell del Camp,2340,1166,1174
43,Tarragona,43,Catllar (El),3221,1664,1557
43,Tarragona,45,Colldejou,193,108,85
43,Tarragona,46,Conesa,133,75,58
43,Tarragona,47,Constantí,5608,2981,2627
43,Tarragona,48,Corbera d'Ebre,1117,598,519
43,Tarragona,49,Cornudella de Montsant,948,488,460
43,Tarragona,50,Creixell,2441,1258,1183
43,Tarragona,51,Cunit,9017,4660,4357
43,Tarragona,901,Deltebre,10943,5548,5395
43,Tarragona,53,Duesaigües,205,126,79
43,Tarragona,54,Espluga de Francolí (L'),3814,1906,1908
43,Tarragona,55,Falset,2658,1335,1323
43,Tarragona,56,Fatarella (La),1180,599,581
43,Tarragona,57,Febró (La),58,35,23
43,Tarragona,58,Figuera (La),190,100,90
43,Tarragona,59,Figuerola del Camp,318,148,170
43,Tarragona,60,Flix,4029,2061,1968
43,Tarragona,61,Forès,62,34,28
43,Tarragona,62,Freginals,406,209,197
43,Tarragona,63,Galera (La),818,411,407
43,Tarragona,64,Gandesa,3028,1567,1461
43,Tarragona,65,Garcia,498,260,238
43,Tarragona,66,Garidells (Els),189,101,88
43,Tarragona,67,Ginestar,950,502,448
43,Tarragona,68,Godall,749,391,358
43,Tarragona,69,Gratallops,223,122,101
43,Tarragona,70,Guiamets (Els),327,177,150
43,Tarragona,71,Horta de Sant Joan,1241,670,571
43,Tarragona,72,Lloar (El),126,70,56
43,Tarragona,73,Llorac,114,56,58
43,Tarragona,74,Llorenç del Penedès,1997,975,1022
43,Tarragona,76,Marçà,621,306,315
43,Tarragona,75,Margalef,125,69,56
43,Tarragona,77,Mas de Barberans,683,343,340
43,Tarragona,78,Masdenverge,1052,550,502
43,Tarragona,79,Masllorenç,463,239,224
43,Tarragona,80,Masó (La),285,140,145
43,Tarragona,81,Maspujols,520,267,253
43,Tarragona,82,Masroig (El),539,275,264
43,Tarragona,83,Milà (El),177,82,95
43,Tarragona,84,Miravet,799,419,380
43,Tarragona,85,Molar (El),286,155,131
43,Tarragona,86,Montblanc,6632,3314,3318
43,Tarragona,88,Montbrió del Camp,1683,864,819
43,Tarragona,89,Montferri,225,121,104
43,Tarragona,90,Montmell (El),1065,574,491
43,Tarragona,91,Mont-ral,180,99,81
43,Tarragona,92,Mont-roig del Camp,8896,4585,4311
43,Tarragona,93,Móra d'Ebre,5012,2484,2528
43,Tarragona,94,Móra la Nova,3214,1674,1540
43,Tarragona,95,Morell (El),2606,1350,1256
43,Tarragona,96,Morera de Montsant (La),168,96,72
43,Tarragona,97,Nou de Gaià (La),440,223,217
43,Tarragona,98,Nulles,369,185,184
43,Tarragona,100,Pallaresos (Els),3144,1628,1516
43,Tarragona,99,Palma d'Ebre (La),403,194,209
43,Tarragona,101,Passanant,205,110,95
43,Tarragona,102,Paüls,609,303,306
43,Tarragona,103,Perafort,802,425,377
43,Tarragona,104,Perelló (El),2355,1261,1094
43,Tarragona,105,Piles (Les),191,109,82
43,Tarragona,106,Pinell de Brai (El),1099,564,535
43,Tarragona,107,Pira,478,235,243
43,Tarragona,108,Pla de Santa Maria (El),1903,1006,897
43,Tarragona,109,Pobla de Mafumet (La),1389,694,695
43,Tarragona,110,Pobla de Massaluca (La),433,231,202
43,Tarragona,111,Pobla de Montornès (La),2123,1134,989
43,Tarragona,112,Poboleda,353,191,162
43,Tarragona,113,Pont d'Armentera (El),596,309,287
43,Tarragona,141,Pontils,142,74,68
43,Tarragona,114,Porrera,498,272,226
43,Tarragona,115,Pradell de la Teixeta,192,93,99
43,Tarragona,116,Prades,612,316,296
43,Tarragona,117,Prat de Comte,191,95,96
43,Tarragona,118,Pratdip,692,368,324
43,Tarragona,119,Puigpelat,789,409,380
43,Tarragona,120,Querol,359,196,163
43,Tarragona,121,Rasquera,898,460,438
43,Tarragona,122,Renau,88,44,44
43,Tarragona,123,Reus,99505,49434,50071
43,Tarragona,124,Riba (La),679,371,308
43,Tarragona,125,Riba-roja d'Ebre,1357,704,653
43,Tarragona,126,Riera de Gaià (La),1277,657,620
43,Tarragona,127,Riudecanyes,845,434,411
43,Tarragona,128,Riudecols,1097,569,528
43,Tarragona,129,Riudoms,5763,2955,2808
43,Tarragona,130,Rocafort de Queralt,264,140,124
43,Tarragona,131,Roda de Barà,4547,2410,2137
43,Tarragona,132,Rodonyà,462,244,218
43,Tarragona,133,Roquetes,7232,3758,3474
43,Tarragona,134,Rourell (El),313,159,154
43,Tarragona,135,Salomó,432,220,212
43,Tarragona,905,Salou,20139,10668,9471
43,Tarragona,136,Sant Carles de la Ràpita,13181,6589,6592
43,Tarragona,137,Sant Jaume dels Domenys,1877,986,891
43,Tarragona,902,Sant Jaume d'Enveja,3355,1698,1657
43,Tarragona,138,Santa Bàrbara,3613,1838,1775
43,Tarragona,139,Santa Coloma de Queralt,2991,1498,1493
43,Tarragona,140,Santa Oliva,2700,1425,1275
43,Tarragona,142,Sarral,1503,787,716
43,Tarragona,143,Savallà del Comtat,73,39,34
43,Tarragona,144,Secuita (La),1240,634,606
43,Tarragona,145,Selva del Camp (La),4821,2447,2374
43,Tarragona,146,Senan,39,28,11
43,Tarragona,44,Sénia (La),5969,3139,2830
43,Tarragona,147,Solivella,567,276,291
43,Tarragona,148,Tarragona,128152,63091,65061
43,Tarragona,149,Tivenys,912,464,448
43,Tarragona,150,Tivissa,1789,900,889
43,Tarragona,151,Torre de Fontaubella (La),135,67,68
43,Tarragona,152,Torre de l'Espanyol (La),740,391,349
43,Tarragona,153,Torredembarra,13280,6709,6571
43,Tarragona,154,Torroja del Priorat,150,89,61
43,Tarragona,155,Tortosa,33705,17139,16566
43,Tarragona,156,Ulldecona,6325,3281,3044
43,Tarragona,157,Ulldemolins,490,264,226
43,Tarragona,158,Vallclara,117,66,51
43,Tarragona,159,Vallfogona de Riucorb,177,90,87
43,Tarragona,160,Vallmoll,1413,743,670
43,Tarragona,161,Valls,22851,11445,11406
43,Tarragona,162,Vandellòs i l'Hospitalet de l'Infant,5008,2542,2466
43,Tarragona,163,Vendrell (El),30225,15243,14982
43,Tarragona,164,Vespella de Gaià,298,169,129
43,Tarragona,165,Vilabella,789,405,384
43,Tarragona,175,Vilalba dels Arcs,726,378,348
43,Tarragona,166,Vilallonga del Camp,1425,709,716
43,Tarragona,168,Vilanova de Prades,155,83,72
43,Tarragona,167,Vilanova d'Escornalbou,477,254,223
43,Tarragona,169,Vilaplana,568,293,275
43,Tarragona,170,Vila-rodona,1117,611,506
43,Tarragona,171,Vila-seca,15875,8007,7868
43,Tarragona,172,Vilaverd,437,224,213
43,Tarragona,173,Vilella Alta (La),132,70,62
43,Tarragona,174,Vilella Baixa (La),190,103,87
43,Tarragona,176,Vimbodí,1054,587,467
43,Tarragona,177,Vinebre,466,243,223
43,Tarragona,178,Vinyols i els Arcs,1498,784,714
43,Tarragona,52,Xerta,1275,639,636
44,Teruel,1,Ababuj,84,49,35
44,Teruel,2,Abejuela,65,37,28
44,Teruel,3,Aguatón,23,9,14
44,Teruel,4,Aguaviva,701,356,345
44,Teruel,5,Aguilar del Alfambra,79,45,34
44,Teruel,6,Alacón,422,210,212
44,Teruel,7,Alba,247,124,123
44,Teruel,8,Albalate del Arzobispo,2179,1104,1075
44,Teruel,9,Albarracín,1054,540,514
44,Teruel,10,Albentosa,299,166,133
44,Teruel,11,Alcaine,80,50,30
44,Teruel,12,Alcalá de la Selva,499,274,225
44,Teruel,13,Alcañiz,15130,7618,7512
44,Teruel,14,Alcorisa,3582,1842,1740
44,Teruel,16,Alfambra,682,348,334
44,Teruel,17,Aliaga,399,220,179
44,Teruel,21,Allepuz,137,68,69
44,Teruel,22,Alloza,692,340,352
44,Teruel,23,Allueva,11,10,1
44,Teruel,18,Almohaja,30,20,10
44,Teruel,19,Alobras,82,47,35
44,Teruel,20,Alpeñés,27,18,9
44,Teruel,24,Anadón,16,10,6
44,Teruel,25,Andorra,7993,4140,3853
44,Teruel,26,Arcos de las Salinas,127,64,63
44,Teruel,27,Arens de Lledó,225,104,121
44,Teruel,28,Argente,244,120,124
44,Teruel,29,Ariño,856,442,414
44,Teruel,31,Azaila,162,94,68
44,Teruel,32,Bádenas,21,13,8
44,Teruel,33,Báguena,422,228,194
44,Teruel,34,Bañón,174,99,75
44,Teruel,35,Barrachina,157,87,70
44,Teruel,36,Bea,37,20,17
44,Teruel,37,Beceite,603,310,293
44,Teruel,39,Bello,334,159,175
44,Teruel,38,Belmonte de San José,144,73,71
44,Teruel,40,Berge,244,122,122
44,Teruel,41,Bezas,74,44,30
44,Teruel,42,Blancas,174,100,74
44,Teruel,43,Blesa,135,84,51
44,Teruel,44,Bordón,144,84,60
44,Teruel,45,Bronchales,446,247,199
44,Teruel,46,Bueña,77,43,34
44,Teruel,47,Burbáguena,301,142,159
44,Teruel,48,Cabra de Mora,115,65,50
44,Teruel,49,Calaceite,1147,601,546
44,Teruel,50,Calamocha,4389,2240,2149
44,Teruel,51,Calanda,3644,1864,1780
44,Teruel,52,Calomarde,73,43,30
44,Teruel,53,Camañas,138,82,56
44,Teruel,54,Camarena de la Sierra,159,92,67
44,Teruel,55,Camarillas,107,64,43
44,Teruel,56,Caminreal,755,392,363
44,Teruel,59,Cantavieja,747,416,331
44,Teruel,60,Cañada de Benatanduz,59,35,24
44,Teruel,61,Cañada de Verich (La),109,58,51
44,Teruel,62,Cañada Vellida,45,32,13
44,Teruel,63,Cañizar del Olivar,107,57,50
44,Teruel,64,Cascante del Río,106,60,46
44,Teruel,65,Castejón de Tornos,85,49,36
44,Teruel,66,Castel de Cabra,140,72,68
44,Teruel,70,Castellar (El),77,45,32
44,Teruel,71,Castellote,787,412,375
44,Teruel,67,Castelnou,120,63,57
44,Teruel,68,Castelserás,827,443,384
44,Teruel,74,Cedrillas,542,282,260
44,Teruel,75,Celadas,430,237,193
44,Teruel,76,Cella,2896,1547,1349
44,Teruel,77,Cerollera (La),125,66,59
44,Teruel,80,Codoñera (La),337,180,157
44,Teruel,82,Corbalán,84,49,35
44,Teruel,84,Cortes de Aragón,105,58,47
44,Teruel,85,Cosa,88,43,45
44,Teruel,86,Cretas,618,318,300
44,Teruel,87,Crivillén,110,59,51
44,Teruel,88,Cuba (La),56,28,28
44,Teruel,89,Cubla,45,27,18
44,Teruel,90,Cucalón,95,56,39
44,Teruel,92,Cuervo (El),111,57,54
44,Teruel,93,Cuevas de Almudén,118,67,51
44,Teruel,94,Cuevas Labradas,152,80,72
44,Teruel,96,Ejulve,225,110,115
44,Teruel,97,Escorihuela,197,101,96
44,Teruel,99,Escucha,1097,609,488
44,Teruel,100,Estercuel,292,156,136
44,Teruel,101,Ferreruela de Huerva,73,42,31
44,Teruel,102,Fonfría,26,15,11
44,Teruel,103,Formiche Alto,202,103,99
44,Teruel,105,Fórnoles,101,48,53
44,Teruel,106,Fortanete,208,117,91
44,Teruel,107,Foz-Calanda,289,156,133
44,Teruel,108,Fresneda (La),477,269,208
44,Teruel,109,Frías de Albarracín,157,87,70
44,Teruel,110,Fuenferrada,43,23,20
44,Teruel,111,Fuentes Calientes,127,68,59
44,Teruel,112,Fuentes Claras,608,318,290
44,Teruel,113,Fuentes de Rubielos,117,63,54
44,Teruel,114,Fuentespalda,384,195,189
44,Teruel,115,Galve,153,82,71
44,Teruel,116,Gargallo,103,51,52
44,Teruel,117,Gea de Albarracín,424,217,207
44,Teruel,118,Ginebrosa (La),234,132,102
44,Teruel,119,Griegos,135,82,53
44,Teruel,120,Guadalaviar,274,142,132
44,Teruel,121,Gúdar,100,58,42
44,Teruel,122,Híjar,1912,965,947
44,Teruel,123,Hinojosa de Jarque,162,87,75
44,Teruel,124,Hoz de la Vieja (La),106,57,49
44,Teruel,125,Huesa del Común,111,68,43
44,Teruel,126,Iglesuela del Cid (La),492,266,226
44,Teruel,127,Jabaloyas,87,47,40
44,Teruel,128,Jarque de la Val,99,55,44
44,Teruel,129,Jatiel,61,30,31
44,Teruel,130,Jorcas,39,24,15
44,Teruel,131,Josa,38,23,15
44,Teruel,132,Lagueruela,56,27,29
44,Teruel,133,Lanzuela,29,22,7
44,Teruel,135,Libros,146,77,69
44,Teruel,136,Lidón,72,34,38
44,Teruel,137,Linares de Mora,320,191,129
44,Teruel,141,Lledó,186,101,85
44,Teruel,138,Loscos,191,108,83
44,Teruel,142,Maicas,39,20,19
44,Teruel,143,Manzanera,516,289,227
44,Teruel,144,Martín del Río,475,238,237
44,Teruel,145,Mas de las Matas,1440,745,695
44,Teruel,146,Mata de los Olmos (La),266,135,131
44,Teruel,147,Mazaleón,585,304,281
44,Teruel,148,Mezquita de Jarque,124,67,57
44,Teruel,149,Mirambel,139,77,62
44,Teruel,150,Miravete de la Sierra,44,26,18
44,Teruel,151,Molinos,311,171,140
44,Teruel,152,Monforte de Moyuela,76,50,26
44,Teruel,153,Monreal del Campo,2480,1256,1224
44,Teruel,154,Monroyo,314,168,146
44,Teruel,155,Montalbán,1487,762,725
44,Teruel,156,Monteagudo del Castillo,65,40,25
44,Teruel,157,Monterde de Albarracín,57,27,30
44,Teruel,158,Mora de Rubielos,1553,823,730
44,Teruel,159,Moscardón,54,31,23
44,Teruel,160,Mosqueruela,703,389,314
44,Teruel,161,Muniesa,709,369,340
44,Teruel,163,Noguera de Albarracín,155,79,76
44,Teruel,164,Nogueras,29,22,7
44,Teruel,165,Nogueruelas,223,123,100
44,Teruel,167,Obón,72,40,32
44,Teruel,168,Odón,257,125,132
44,Teruel,169,Ojos Negros,516,266,250
44,Teruel,171,Olba,233,123,110
44,Teruel,172,Oliete,465,238,227
44,Teruel,173,Olmos (Los),142,74,68
44,Teruel,174,Orihuela del Tremedal,605,309,296
44,Teruel,175,Orrios,175,88,87
44,Teruel,176,Palomar de Arroyos,222,126,96
44,Teruel,177,Pancrudo,124,68,56
44,Teruel,178,Parras de Castellote (Las),81,42,39
44,Teruel,179,Peñarroya de Tastavins,526,272,254
44,Teruel,180,Peracense,114,69,45
44,Teruel,181,Peralejos,83,45,38
44,Teruel,182,Perales del Alfambra,296,160,136
44,Teruel,183,Pitarque,114,52,62
44,Teruel,184,Plou,55,32,23
44,Teruel,185,Pobo (El),135,78,57
44,Teruel,187,Portellada (La),272,147,125
44,Teruel,189,Pozondón,88,43,45
44,Teruel,190,Pozuel del Campo,103,55,48
44,Teruel,191,Puebla de Híjar (La),1015,500,515
44,Teruel,192,Puebla de Valverde (La),551,305,246
44,Teruel,193,Puertomingalvo,190,113,77
44,Teruel,194,Ráfales,172,90,82
44,Teruel,195,Rillo,115,64,51
44,Teruel,196,Riodeva,182,86,96
44,Teruel,197,Ródenas,87,49,38
44,Teruel,198,Royuela,221,119,102
44,Teruel,199,Rubiales,54,29,25
44,Teruel,200,Rubielos de la Cérida,55,27,28
44,Teruel,201,Rubielos de Mora,699,352,347
44,Teruel,203,Salcedillo,7,4,3
44,Teruel,204,Saldón,32,17,15
44,Teruel,205,Samper de Calanda,974,479,495
44,Teruel,206,San Agustín,142,85,57
44,Teruel,207,San Martín del Río,243,119,124
44,Teruel,208,Santa Cruz de Nogueras,36,21,15
44,Teruel,209,Santa Eulalia,1164,564,600
44,Teruel,210,Sarrión,1072,575,497
44,Teruel,211,Segura de los Baños,36,22,14
44,Teruel,212,Seno,51,28,23
44,Teruel,213,Singra,91,48,43
44,Teruel,215,Terriente,177,106,71
44,Teruel,216,Teruel,33238,16091,17147
44,Teruel,217,Toril y Masegoso,31,20,11
44,Teruel,218,Tormón,35,21,14
44,Teruel,219,Tornos,242,124,118
44,Teruel,220,Torralba de los Sisones,218,119,99
44,Teruel,223,Torre de Arcas,96,48,48
44,Teruel,224,Torre de las Arcas,36,20,16
44,Teruel,225,Torre del Compte,171,87,84
44,Teruel,227,Torre los Negros,107,51,56
44,Teruel,221,Torrecilla de Alcañiz,468,250,218
44,Teruel,222,Torrecilla del Rebollar,173,89,84
44,Teruel,226,Torrelacárcel,240,127,113
44,Teruel,228,Torremocha de Jiloca,158,84,74
44,Teruel,229,Torres de Albarracín,146,80,66
44,Teruel,230,Torrevelilla,200,100,100
44,Teruel,231,Torrijas,86,40,46
44,Teruel,232,Torrijo del Campo,529,272,257
44,Teruel,234,Tramacastiel,116,68,48
44,Teruel,235,Tramacastilla,130,65,65
44,Teruel,236,Tronchón,101,56,45
44,Teruel,237,Urrea de Gaén,582,292,290
44,Teruel,238,Utrillas,3271,1698,1573
44,Teruel,239,Valacloche,24,15,9
44,Teruel,240,Valbona,216,118,98
44,Teruel,241,Valdealgorfa,708,345,363
44,Teruel,243,Valdecuenca,39,22,17
44,Teruel,244,Valdelinares,134,77,57
44,Teruel,245,Valdeltormo,346,187,159
44,Teruel,246,Valderrobres,2083,1118,965
44,Teruel,247,Valjunquera,424,218,206
44,Teruel,249,Vallecillo (El),59,33,26
44,Teruel,250,Veguillas de la Sierra,23,14,9
44,Teruel,251,Villafranca del Campo,368,193,175
44,Teruel,252,Villahermosa del Campo,102,55,47
44,Teruel,256,Villanueva del Rebollar de la Sierra,50,27,23
44,Teruel,257,Villar del Cobo,213,108,105
44,Teruel,258,Villar del Salz,98,57,41
44,Teruel,260,Villarluengo,212,122,90
44,Teruel,261,Villarquemado,916,475,441
44,Teruel,262,Villarroya de los Pinares,188,103,85
44,Teruel,263,Villastar,333,174,159
44,Teruel,264,Villel,322,183,139
44,Teruel,265,Vinaceite,271,138,133
44,Teruel,266,Visiedo,174,78,96
44,Teruel,267,Vivel del Río Martín,84,44,40
44,Teruel,268,Zoma (La),27,13,14
45,Toledo,1,Ajofrín,2226,1151,1075
45,Toledo,2,Alameda de la Sagra,3120,1653,1467
45,Toledo,3,Albarreal de Tajo,662,333,329
45,Toledo,4,Alcabón,685,345,340
45,Toledo,5,Alcañizo,318,173,145
45,Toledo,6,Alcaudete de la Jara,1977,989,988
45,Toledo,7,Alcolea de Tajo,822,409,413
45,Toledo,8,Aldea en Cabo,193,107,86
45,Toledo,9,Aldeanueva de Barbarroya,726,365,361
45,Toledo,10,Aldeanueva de San Bartolomé,517,248,269
45,Toledo,11,Almendral de la Cañada,384,198,186
45,Toledo,12,Almonacid de Toledo,796,414,382
45,Toledo,13,Almorox,2351,1244,1107
45,Toledo,14,Añover de Tajo,5118,2636,2482
45,Toledo,15,Arcicóllar,670,337,333
45,Toledo,16,Argés,3763,1902,1861
45,Toledo,17,Azután,322,162,160
45,Toledo,18,Barcience,95,50,45
45,Toledo,19,Bargas,7726,3917,3809
45,Toledo,20,Belvís de la Jara,1744,882,862
45,Toledo,21,Borox,2527,1295,1232
45,Toledo,22,Buenaventura,516,259,257
45,Toledo,23,Burguillos de Toledo,1695,880,815
45,Toledo,24,Burujón,1372,725,647
45,Toledo,25,Cabañas de la Sagra,1729,898,831
45,Toledo,26,Cabañas de Yepes,274,138,136
45,Toledo,27,Cabezamesada,494,260,234
45,Toledo,28,Calera y Chozas,4071,2075,1996
45,Toledo,29,Caleruela,296,149,147
45,Toledo,30,Calzada de Oropesa,585,298,287
45,Toledo,31,Camarena,2726,1414,1312
45,Toledo,32,Camarenilla,544,282,262
45,Toledo,33,Campillo de la Jara (El),435,228,207
45,Toledo,34,Camuñas,1805,911,894
45,Toledo,35,Cardiel de los Montes,245,133,112
45,Toledo,36,Carmena,860,451,409
45,Toledo,37,Carpio de Tajo (El),2157,1055,1102
45,Toledo,38,Carranque,2517,1289,1228
45,Toledo,39,Carriches,296,150,146
45,Toledo,40,Casar de Escalona (El),1386,718,668
45,Toledo,41,Casarrubios del Monte,4006,2128,1878
45,Toledo,42,Casasbuenas,223,111,112
45,Toledo,43,Castillo de Bayuela,1060,543,517
45,Toledo,45,Cazalegas,1453,756,697
45,Toledo,46,Cebolla,3308,1678,1630
45,Toledo,47,Cedillo del Condado,2102,1074,1028
45,Toledo,48,Cerralbos (Los),418,220,198
45,Toledo,49,Cervera de los Montes,337,176,161
45,Toledo,56,Chozas de Canales,1764,916,848
45,Toledo,57,Chueca,261,137,124
45,Toledo,50,Ciruelos,423,230,193
45,Toledo,51,Cobeja,1994,1017,977
45,Toledo,52,Cobisa,2902,1499,1403
45,Toledo,53,Consuegra,10497,5278,5219
45,Toledo,54,Corral de Almaguer,5904,3022,2882
45,Toledo,55,Cuerva,1359,690,669
45,Toledo,58,Domingo Pérez,493,247,246
45,Toledo,59,Dosbarrios,2219,1133,1086
45,Toledo,60,Erustes,211,104,107
45,Toledo,61,Escalona,2779,1416,1363
45,Toledo,62,Escalonilla,1470,740,730
45,Toledo,63,Espinoso del Rey,605,317,288
45,Toledo,64,Esquivias,4577,2318,2259
45,Toledo,65,Estrella (La),348,181,167
45,Toledo,66,Fuensalida,8951,4553,4398
45,Toledo,67,Gálvez,3332,1684,1648
45,Toledo,68,Garciotum,153,74,79
45,Toledo,69,Gerindote,2123,1087,1036
45,Toledo,70,Guadamur,1746,883,863
45,Toledo,71,Guardia (La),2330,1166,1164
45,Toledo,72,Herencias (Las),744,401,343
45,Toledo,73,Herreruela de Oropesa,461,229,232
45,Toledo,74,Hinojosa de San Vicente,477,260,217
45,Toledo,75,Hontanar,141,82,59
45,Toledo,76,Hormigos,505,273,232
45,Toledo,77,Huecas,524,273,251
45,Toledo,78,Huerta de Valdecarábanos,1763,873,890
45,Toledo,79,Iglesuela (La),419,213,206
45,Toledo,80,Illán de Vacas,7,4,3
45,Toledo,81,Illescas,14771,7489,7282
45,Toledo,82,Lagartera,1621,805,816
45,Toledo,83,Layos,354,168,186
45,Toledo,84,Lillo,2704,1376,1328
45,Toledo,85,Lominchar,1423,749,674
45,Toledo,86,Lucillos,498,251,247
45,Toledo,87,Madridejos,10987,5530,5457
45,Toledo,88,Magán,1662,865,797
45,Toledo,89,Malpica de Tajo,1985,1011,974
45,Toledo,90,Manzaneque,482,238,244
45,Toledo,91,Maqueda,552,287,265
45,Toledo,92,Marjaliza,308,155,153
45,Toledo,93,Marrupe,160,85,75
45,Toledo,94,Mascaraque,491,240,251
45,Toledo,95,Mata (La),962,491,471
45,Toledo,96,Mazarambroz,1317,673,644
45,Toledo,97,Mejorada,1300,668,632
45,Toledo,98,Menasalbas,3017,1611,1406
45,Toledo,99,Méntrida,3212,1691,1521
45,Toledo,100,Mesegar de Tajo,243,121,122
45,Toledo,101,Miguel Esteban,5238,2668,2570
45,Toledo,102,Mocejón,4503,2323,2180
45,Toledo,103,Mohedas de la Jara,539,285,254
45,Toledo,104,Montearagón,507,267,240
45,Toledo,105,Montesclaros,409,211,198
45,Toledo,106,Mora,9884,4979,4905
45,Toledo,107,Nambroca,2898,1510,1388
45,Toledo,108,Nava de Ricomalillo (La),693,356,337
45,Toledo,109,Navahermosa,4261,2229,2032
45,Toledo,110,Navalcán,2201,1148,1053
45,Toledo,111,Navalmoralejo,66,32,34
45,Toledo,112,Navalmorales (Los),2745,1426,1319
45,Toledo,113,Navalucillos (Los),2727,1378,1349
45,Toledo,114,Navamorcuende,703,359,344
45,Toledo,115,Noblejas,3287,1711,1576
45,Toledo,116,Noez,800,404,396
45,Toledo,117,Nombela,994,517,477
45,Toledo,118,Novés,1760,906,854
45,Toledo,119,Numancia de la Sagra,3697,1975,1722
45,Toledo,120,Nuño Gómez,208,103,105
45,Toledo,121,Ocaña,6923,3488,3435
45,Toledo,122,Olías del Rey,5600,2883,2717
45,Toledo,123,Ontígola,2115,1128,987
45,Toledo,124,Orgaz,2762,1385,1377
45,Toledo,125,Oropesa,2869,1392,1477
45,Toledo,126,Otero,238,110,128
45,Toledo,127,Palomeque,674,355,319
45,Toledo,128,Pantoja,3065,1558,1507
45,Toledo,129,Paredes de Escalona,124,53,71
45,Toledo,130,Parrillas,423,213,210
45,Toledo,131,Pelahustán,371,203,168
45,Toledo,132,Pepino,1643,859,784
45,Toledo,133,Polán,3703,1859,1844
45,Toledo,134,Portillo de Toledo,2129,1103,1026
45,Toledo,135,Puebla de Almoradiel (La),5715,2919,2796
45,Toledo,136,Puebla de Montalbán (La),7765,3950,3815
45,Toledo,137,Pueblanueva (La),2126,1080,1046
45,Toledo,138,Puente del Arzobispo (El),1447,700,747
45,Toledo,139,Puerto de San Vicente,255,132,123
45,Toledo,140,Pulgar,1420,746,674
45,Toledo,141,Quero,1269,649,620
45,Toledo,142,Quintanar de la Orden,10581,5346,5235
45,Toledo,143,Quismondo,1482,736,746
45,Toledo,144,Real de San Vicente (El),1068,551,517
45,Toledo,145,Recas,3073,1702,1371
45,Toledo,146,Retamoso de la Jara,135,73,62
45,Toledo,147,Rielves,601,300,301
45,Toledo,148,Robledo del Mazo,420,215,205
45,Toledo,149,Romeral (El),819,410,409
45,Toledo,150,San Bartolomé de las Abiertas,464,241,223
45,Toledo,151,San Martín de Montalbán,730,354,376
45,Toledo,152,San Martín de Pusa,810,424,386
45,Toledo,153,San Pablo de los Montes,2259,1146,1113
45,Toledo,154,San Román de los Montes,1187,641,546
45,Toledo,155,Santa Ana de Pusa,407,211,196
45,Toledo,156,Santa Cruz de la Zarza,4764,2435,2329
45,Toledo,157,Santa Cruz del Retamar,2324,1198,1126
45,Toledo,158,Santa Olalla,2973,1528,1445
45,Toledo,901,Santo Domingo-Caudilla,790,401,389
45,Toledo,159,Sartajada,122,70,52
45,Toledo,160,Segurilla,1081,551,530
45,Toledo,161,Seseña,9290,4852,4438
45,Toledo,162,Sevilleja de la Jara,933,502,431
45,Toledo,163,Sonseca,10132,5128,5004
45,Toledo,164,Sotillo de las Palomas,218,106,112
45,Toledo,165,Talavera de la Reina,82975,40517,42458
45,Toledo,166,Tembleque,2227,1124,1103
45,Toledo,167,Toboso (El),2134,1063,1071
45,Toledo,168,Toledo,75533,36259,39274
45,Toledo,169,Torralba de Oropesa,276,135,141
45,Toledo,171,Torre de Esteban Hambrán (La),1683,890,793
45,Toledo,170,Torrecilla de la Jara,311,159,152
45,Toledo,172,Torrico,851,451,400
45,Toledo,173,Torrijos,11285,5572,5713
45,Toledo,174,Totanés,409,208,201
45,Toledo,175,Turleque,949,462,487
45,Toledo,176,Ugena,3267,1722,1545
45,Toledo,177,Urda,3129,1573,1556
45,Toledo,179,Valdeverdeja,735,337,398
45,Toledo,180,Valmojado,3024,1573,1451
45,Toledo,181,Velada,2491,1292,1199
45,Toledo,182,Ventas con Peña Aguilera (Las),1405,724,681
45,Toledo,183,Ventas de Retamosa (Las),1546,819,727
45,Toledo,184,Ventas de San Julián (Las),254,109,145
45,Toledo,186,Villa de Don Fadrique (La),4159,2090,2069
45,Toledo,185,Villacañas,10090,5026,5064
45,Toledo,187,Villafranca de los Caballeros,5236,2598,2638
45,Toledo,188,Villaluenga de la Sagra,3049,1529,1520
45,Toledo,189,Villamiel de Toledo,704,361,343
45,Toledo,190,Villaminaya,594,300,294
45,Toledo,191,Villamuelas,756,384,372
45,Toledo,192,Villanueva de Alcardete,3726,1961,1765
45,Toledo,193,Villanueva de Bogas,810,420,390
45,Toledo,194,Villarejo de Montalbán,77,42,35
45,Toledo,195,Villarrubia de Santiago,2868,1445,1423
45,Toledo,196,Villaseca de la Sagra,1614,799,815
45,Toledo,197,Villasequilla,2500,1298,1202
45,Toledo,198,Villatobas,2443,1240,1203
45,Toledo,199,Viso de San Juan (El),2092,1130,962
45,Toledo,200,Yébenes (Los),6298,3224,3074
45,Toledo,201,Yeles,2766,1526,1240
45,Toledo,202,Yepes,4661,2386,2275
45,Toledo,203,Yuncler,2464,1257,1207
45,Toledo,204,Yunclillos,671,351,320
45,Toledo,205,Yuncos,5592,2921,2671
46,Valencia/València,1,Ademuz,1157,600,557
46,Valencia/València,2,Ador,1385,708,677
46,Valencia/València,4,Agullent,2319,1134,1185
46,Valencia/València,42,Aielo de Malferit,4387,2160,2227
46,Valencia/València,43,Aielo de Rugat,209,113,96
46,Valencia/València,5,Alaquàs,29695,14856,14839
46,Valencia/València,6,Albaida,6264,3109,3155
46,Valencia/València,7,Albal,14061,7062,6999
46,Valencia/València,8,Albalat de la Ribera,3382,1690,1692
46,Valencia/València,9,Albalat dels Sorells,3486,1714,1772
46,Valencia/València,10,Albalat dels Tarongers,804,422,382
46,Valencia/València,11,Alberic,10081,5035,5046
46,Valencia/València,12,Alborache,989,505,484
46,Valencia/València,13,Alboraya,20514,10257,10257
46,Valencia/València,14,Albuixech,3478,1728,1750
46,Valencia/València,16,Alcàntera de Xúquer,1374,677,697
46,Valencia/València,15,Alcàsser,8351,4255,4096
46,Valencia/València,18,Alcublas,796,410,386
46,Valencia/València,19,Alcúdia (l'),10838,5352,5486
46,Valencia/València,20,Alcúdia de Crespins (l'),4933,2546,2387
46,Valencia/València,21,Aldaia,27028,13525,13503
46,Valencia/València,22,Alfafar,19877,9903,9974
46,Valencia/València,24,Alfara de Algimia,498,242,256
46,Valencia/València,25,Alfara del Patriarca,2801,1398,1403
46,Valencia/València,26,Alfarp,1369,686,683
46,Valencia/València,27,Alfarrasí,1281,623,658
46,Valencia/València,23,Alfauir,402,207,195
46,Valencia/València,28,Algar de Palancia,503,259,244
46,Valencia/València,29,Algemesí,26740,13333,13407
46,Valencia/València,30,Algimia de Alfara,980,499,481
46,Valencia/València,31,Alginet,12820,6539,6281
46,Valencia/València,32,Almàssera,6737,3265,3472
46,Valencia/València,33,Almiserà,284,143,141
46,Valencia/València,34,Almoines,1716,847,869
46,Valencia/València,35,Almussafes,7640,3820,3820
46,Valencia/València,36,Alpuente,864,472,392
46,Valencia/València,37,Alqueria de la Comtessa (l'),1486,725,761
46,Valencia/València,17,Alzira,42543,20856,21687
46,Valencia/València,38,Andilla,348,209,139
46,Valencia/València,39,Anna,2741,1379,1362
46,Valencia/València,40,Antella,1500,753,747
46,Valencia/València,41,Aras de los Olmos,391,213,178
46,Valencia/València,3,Atzeneta d'Albaida,1334,698,636
46,Valencia/València,44,Ayora,5513,2805,2708
46,Valencia/València,46,Barx,1379,684,695
46,Valencia/València,45,Barxeta,1623,846,777
46,Valencia/València,47,Bèlgida,708,347,361
46,Valencia/València,48,Bellreguard,3991,1993,1998
46,Valencia/València,49,Bellús,385,191,194
46,Valencia/València,50,Benagéber,166,78,88
46,Valencia/València,51,Benaguasil,9850,5023,4827
46,Valencia/València,52,Benavites,636,313,323
46,Valencia/València,53,Beneixida,636,306,330
46,Valencia/València,54,Benetússer,14032,6974,7058
46,Valencia/València,55,Beniarjó,1476,733,743
46,Valencia/València,56,Beniatjar,235,116,119
46,Valencia/València,57,Benicolet,539,281,258
46,Valencia/València,904,Benicull de Xúquer,831,412,419
46,Valencia/València,60,Benifaió,12208,6070,6138
46,Valencia/València,59,Benifairó de la Valldigna,1708,854,854
46,Valencia/València,58,Benifairó de les Valls,1909,939,970
46,Valencia/València,61,Beniflá,265,139,126
46,Valencia/València,62,Benigánim,5813,2944,2869
46,Valencia/València,63,Benimodo,2050,1068,982
46,Valencia/València,64,Benimuslem,584,297,287
46,Valencia/València,65,Beniparrell,1808,936,872
46,Valencia/València,66,Benirredrà,1539,729,810
46,Valencia/València,67,Benisanó,1964,1008,956
46,Valencia/València,68,Benissoda,327,178,149
46,Valencia/València,69,Benisuera,206,101,105
46,Valencia/València,70,Bétera,18177,9074,9103
46,Valencia/València,71,Bicorp,643,321,322
46,Valencia/València,72,Bocairent,4376,2172,2204
46,Valencia/València,73,Bolbaite,1452,753,699
46,Valencia/València,74,Bonrepòs i Mirambell,2732,1350,1382
46,Valencia/València,75,Bufali,199,100,99
46,Valencia/València,76,Bugarra,852,435,417
46,Valencia/València,77,Buñol,9404,4688,4716
46,Valencia/València,78,Burjassot,37394,18309,19085
46,Valencia/València,79,Calles,390,222,168
46,Valencia/València,80,Camporrobles,1373,697,676
46,Valencia/València,81,Canals,13635,6858,6777
46,Valencia/València,82,Canet d'En Berenguer,4327,2216,2111
46,Valencia/València,83,Carcaixent,21299,10571,10728
46,Valencia/València,84,Càrcer,2040,987,1053
46,Valencia/València,85,Carlet,14812,7428,7384
46,Valencia/València,86,Carrícola,81,39,42
46,Valencia/València,87,Casas Altas,159,80,79
46,Valencia/València,88,Casas Bajas,237,132,105
46,Valencia/València,89,Casinos,2408,1231,1177
46,Valencia/València,257,Castelló de la Ribera,7280,3610,3670
46,Valencia/València,90,Castelló de Rugat,2350,1198,1152
46,Valencia/València,91,Castellonet de la Conquesta,168,96,72
46,Valencia/València,92,Castielfabib,276,149,127
46,Valencia/València,93,Catadau,2525,1282,1243
46,Valencia/València,94,Catarroja,23895,11933,11962
46,Valencia/València,95,Caudete de las Fuentes,783,396,387
46,Valencia/València,96,Cerdà,304,160,144
46,Valencia/València,107,Chella,2666,1335,1331
46,Valencia/València,106,Chelva,1938,999,939
46,Valencia/València,108,Chera,499,254,245
46,Valencia/València,109,Cheste,7319,3775,3544
46,Valencia/València,111,Chiva,11815,6039,5776
46,Valencia/València,112,Chulilla,799,410,389
46,Valencia/València,97,Cofrentes,951,470,481
46,Valencia/València,98,Corbera,3077,1505,1572
46,Valencia/València,99,Cortes de Pallás,1014,516,498
46,Valencia/València,100,Cotes,358,168,190
46,Valencia/València,105,Cullera,23261,11807,11454
46,Valencia/València,113,Daimús,2353,1202,1151
46,Valencia/València,114,Domeño,569,295,274
46,Valencia/València,115,Dos Aguas,406,228,178
46,Valencia/València,116,Eliana (l'),15666,7786,7880
46,Valencia/València,117,Emperador,295,154,141
46,Valencia/València,118,Enguera,5646,2967,2679
46,Valencia/València,119,Ènova (l'),995,501,494
46,Valencia/València,120,Estivella,1199,567,632
46,Valencia/València,121,Estubeny,166,85,81
46,Valencia/València,122,Faura,2959,1495,1464
46,Valencia/València,123,Favara,1903,945,958
46,Valencia/València,126,Foios,6193,3047,3146
46,Valencia/València,128,Font de la Figuera (la),2121,1083,1038
46,Valencia/València,127,Font d'En Carròs (la),3576,1783,1793
46,Valencia/València,124,Fontanars dels Alforins,988,509,479
46,Valencia/València,125,Fortaleny,997,497,500
46,Valencia/València,129,Fuenterrobles,752,395,357
46,Valencia/València,131,Gandia,71429,35872,35557
46,Valencia/València,902,Gátova,451,206,245
46,Valencia/València,130,Gavarda,1171,580,591
46,Valencia/València,132,Genovés,2631,1336,1295
46,Valencia/València,133,Gestalgar,699,357,342
46,Valencia/València,134,Gilet,2290,1181,1109
46,Valencia/València,135,Godella,12581,6186,6395
46,Valencia/València,136,Godelleta,2728,1398,1330
46,Valencia/València,137,Granja de la Costera (la),351,177,174
46,Valencia/València,138,Guadasequies,386,197,189
46,Valencia/València,139,Guadassuar,5703,2850,2853
46,Valencia/València,140,Guardamar de la Safor,249,137,112
46,Valencia/València,141,Higueruelas,522,269,253
46,Valencia/València,142,Jalance,997,502,495
46,Valencia/València,144,Jarafuel,871,451,420
46,Valencia/València,154,Llanera de Ranes,1056,545,511
46,Valencia/València,155,Llaurí,1229,618,611
46,Valencia/València,147,Llíria,20224,10257,9967
46,Valencia/València,153,Llocnou de Sant Jeroni,577,279,298
46,Valencia/València,151,Llocnou d'En Fenollet,832,425,407
46,Valencia/València,156,Llombai,2329,1205,1124
46,Valencia/València,157,Llosa de Ranes (la),3712,1918,1794
46,Valencia/València,150,Llutxent,2526,1291,1235
46,Valencia/València,148,Loriguilla,1202,631,571
46,Valencia/València,149,Losa del Obispo,504,255,249
46,Valencia/València,152,Lugar Nuevo de la Corona,79,39,40
46,Valencia/València,158,Macastre,1162,598,564
46,Valencia/València,159,Manises,28866,14392,14474
46,Valencia/València,160,Manuel,2506,1228,1278
46,Valencia/València,161,Marines,1498,770,728
46,Valencia/València,162,Masalavés,1563,815,748
46,Valencia/València,163,Massalfassar,1321,645,676
46,Valencia/València,164,Massamagrell,14144,7044,7100
46,Valencia/València,165,Massanassa,7919,3933,3986
46,Valencia/València,166,Meliana,9512,4725,4787
46,Valencia/València,167,Millares,546,264,282
46,Valencia/València,168,Miramar,1781,901,880
46,Valencia/València,169,Mislata,42927,21091,21836
46,Valencia/València,170,Mogente/Moixent,4542,2305,2237
46,Valencia/València,171,Moncada,20581,10249,10332
46,Valencia/València,172,Monserrat,4523,2424,2099
46,Valencia/València,173,Montaverner,1763,883,880
46,Valencia/València,174,Montesa,1414,726,688
46,Valencia/València,175,Montichelvo,660,331,329
46,Valencia/València,176,Montroy,1915,1002,913
46,Valencia/València,177,Museros,4567,2282,2285
46,Valencia/València,178,Náquera,4143,2150,1993
46,Valencia/València,179,Navarrés,2969,1530,1439
46,Valencia/València,180,Novelé/Novetlè,715,336,379
46,Valencia/València,181,Oliva,25318,12708,12610
46,Valencia/València,183,Olleria (l'),7887,4011,3876
46,Valencia/València,182,Olocau,1195,614,581
46,Valencia/València,184,Ontinyent,35517,17828,17689
46,Valencia/València,185,Otos,515,269,246
46,Valencia/València,186,Paiporta,21341,10810,10531
46,Valencia/València,187,Palma de Gandía,1675,851,824
46,Valencia/València,188,Palmera,656,321,335
46,Valencia/València,189,Palomar (el),523,254,269
46,Valencia/València,190,Paterna,54560,27206,27354
46,Valencia/València,191,Pedralba,2492,1344,1148
46,Valencia/València,192,Petrés,891,441,450
46,Valencia/València,193,Picanya,10057,5021,5036
46,Valencia/València,194,Picassent,17375,8832,8543
46,Valencia/València,195,Piles,2446,1240,1206
46,Valencia/València,196,Pinet,185,96,89
46,Valencia/València,199,Pobla de Farnals (la),6191,3172,3019
46,Valencia/València,202,Pobla de Vallbona (la),17114,8727,8387
46,Valencia/València,200,Pobla del Duc (la),2645,1306,1339
46,Valencia/València,203,Pobla Llarga (la),4451,2206,2245
46,Valencia/València,197,Polinyà de Xúquer,2244,1132,1112
46,Valencia/València,198,Potríes,921,445,476
46,Valencia/València,205,Puçol,16531,8216,8315
46,Valencia/València,201,Puebla de San Miguel,69,38,31
46,Valencia/València,204,Puig,7889,3909,3980
46,Valencia/València,101,Quart de les Valls,1092,525,567
46,Valencia/València,102,Quart de Poblet,25509,12576,12933
46,Valencia/València,103,Quartell,1410,689,721
46,Valencia/València,104,Quatretonda,2540,1294,1246
46,Valencia/València,206,Quesa,741,383,358
46,Valencia/València,207,Rafelbuñol/Rafelbunyol,6580,3261,3319
46,Valencia/València,208,Rafelcofer,1405,675,730
46,Valencia/València,209,Rafelguaraf,2413,1185,1228
46,Valencia/València,210,Ráfol de Salem,391,194,197
46,Valencia/València,211,Real de Gandía,1968,959,1009
46,Valencia/València,212,Real de Montroi,2114,1127,987
46,Valencia/València,213,Requena,20046,10112,9934
46,Valencia/València,214,Riba-roja de Túria,17251,8720,8531
46,Valencia/València,215,Riola,1734,865,869
46,Valencia/València,216,Rocafort,6088,2990,3098
46,Valencia/València,217,Rotglà i Corberà,1018,512,506
46,Valencia/València,218,Rótova,1275,647,628
46,Valencia/València,219,Rugat,186,93,93
46,Valencia/València,220,Sagunto/Sagunt,61823,30462,31361
46,Valencia/València,221,Salem,478,243,235
46,Valencia/València,903,San Antonio de Benagéber,4356,2179,2177
46,Valencia/València,222,San Juan de Énova,396,184,212
46,Valencia/València,223,Sedaví,8991,4434,4557
46,Valencia/València,224,Segart,156,72,84
46,Valencia/València,225,Sellent,484,249,235
46,Valencia/València,226,Sempere,38,18,20
46,Valencia/València,227,Senyera,1045,502,543
46,Valencia/València,228,Serra,2478,1289,1189
46,Valencia/València,229,Siete Aguas,1239,656,583
46,Valencia/València,230,Silla,17546,8870,8676
46,Valencia/València,231,Simat de la Valldigna,3228,1665,1563
46,Valencia/València,232,Sinarcas,1234,633,601
46,Valencia/València,233,Sollana,4519,2215,2304
46,Valencia/València,234,Sot de Chera,392,194,198
46,Valencia/València,235,Sueca,27253,13521,13732
46,Valencia/València,236,Sumacàrcer,1300,667,633
46,Valencia/València,237,Tavernes Blanques,9186,4526,4660
46,Valencia/València,238,Tavernes de la Valldigna,17675,8896,8779
46,Valencia/València,239,Teresa de Cofrentes,672,346,326
46,Valencia/València,240,Terrateig,348,189,159
46,Valencia/València,241,Titaguas,522,271,251
46,Valencia/València,242,Torrebaja,427,224,203
46,Valencia/València,243,Torrella,165,87,78
46,Valencia/València,244,Torrent,72660,36312,36348
46,Valencia/València,245,Torres Torres,509,270,239
46,Valencia/València,246,Tous,1116,554,562
46,Valencia/València,247,Tuéjar,1225,640,585
46,Valencia/València,248,Turís,5556,2913,2643
46,Valencia/València,249,Utiel,11899,5935,5964
46,Valencia/València,250,Valencia,796549,382489,414060
46,Valencia/València,251,Vallada,3329,1707,1622
46,Valencia/València,252,Vallanca,180,91,89
46,Valencia/València,253,Vallés,92,52,40
46,Valencia/València,254,Venta del Moro,1413,734,679
46,Valencia/València,256,Vilamarxant,7152,3698,3454
46,Valencia/València,255,Villalonga,3999,2009,1990
46,Valencia/València,258,Villar del Arzobispo,3673,1861,1812
46,Valencia/València,259,Villargordo del Cabriel,699,364,335
46,Valencia/València,260,Vinalesa,2592,1258,1334
46,Valencia/València,145,Xàtiva,28222,13942,14280
46,Valencia/València,143,Xeraco,5643,2858,2785
46,Valencia/València,146,Xeresa,2002,1012,990
46,Valencia/València,110,Xirivella,29311,14661,14650
46,Valencia/València,261,Yátova,1999,1042,957
46,Valencia/València,262,Yesa (La),251,132,119
46,Valencia/València,263,Zarra,472,257,215
47,Valladolid,1,Adalia,68,36,32
47,Valladolid,2,Aguasal,28,17,11
47,Valladolid,3,Aguilar de Campos,337,179,158
47,Valladolid,4,Alaejos,1651,845,806
47,Valladolid,5,Alcazarén,689,363,326
47,Valladolid,6,Aldea de San Miguel,217,110,107
47,Valladolid,7,Aldeamayor de San Martín,1962,979,983
47,Valladolid,8,Almenara de Adaja,35,21,14
47,Valladolid,9,Amusquillo,153,86,67
47,Valladolid,10,Arroyo de la Encomienda,6587,3403,3184
47,Valladolid,11,Ataquines,805,429,376
47,Valladolid,12,Bahabón,191,92,99
47,Valladolid,13,Barcial de la Loma,149,76,73
47,Valladolid,14,Barruelo del Valle,72,43,29
47,Valladolid,15,Becilla de Valderaduey,370,202,168
47,Valladolid,16,Benafarces,106,56,50
47,Valladolid,17,Bercero,234,131,103
47,Valladolid,18,Berceruelo,39,22,17
47,Valladolid,19,Berrueces,110,60,50
47,Valladolid,20,Bobadilla del Campo,373,198,175
47,Valladolid,21,Bocigas,127,62,65
47,Valladolid,22,Bocos de Duero,71,31,40
47,Valladolid,23,Boecillo,2510,1275,1235
47,Valladolid,24,Bolaños de Campos,395,200,195
47,Valladolid,25,Brahojos de Medina,161,85,76
47,Valladolid,26,Bustillo de Chaves,94,47,47
47,Valladolid,27,Cabezón de Pisuerga,2542,1301,1241
47,Valladolid,28,Cabezón de Valderaduey,59,35,24
47,Valladolid,29,Cabreros del Monte,80,43,37
47,Valladolid,30,Campaspero,1443,769,674
47,Valladolid,31,Campillo (El),223,125,98
47,Valladolid,32,Camporredondo,193,108,85
47,Valladolid,33,Canalejas de Peñafiel,329,164,165
47,Valladolid,34,Canillas de Esgueva,112,62,50
47,Valladolid,35,Carpio,1046,565,481
47,Valladolid,36,Casasola de Arión,342,193,149
47,Valladolid,37,Castrejón de Trabancos,243,126,117
47,Valladolid,38,Castrillo de Duero,166,82,84
47,Valladolid,39,Castrillo-Tejeriego,218,118,100
47,Valladolid,40,Castrobol,98,46,52
47,Valladolid,41,Castrodeza,210,116,94
47,Valladolid,42,Castromembibre,79,43,36
47,Valladolid,43,Castromonte,376,193,183
47,Valladolid,44,Castronuevo de Esgueva,365,199,166
47,Valladolid,45,Castronuño,1040,517,523
47,Valladolid,46,Castroponce,166,92,74
47,Valladolid,47,Castroverde de Cerrato,256,153,103
47,Valladolid,48,Ceinos de Campos,282,149,133
47,Valladolid,49,Cervillego de la Cruz,133,64,69
47,Valladolid,50,Cigales,3467,1745,1722
47,Valladolid,51,Ciguñuela,375,198,177
47,Valladolid,52,Cistérniga,6063,3093,2970
47,Valladolid,53,Cogeces de Íscar,147,79,68
47,Valladolid,54,Cogeces del Monte,876,484,392
47,Valladolid,55,Corcos,259,140,119
47,Valladolid,56,Corrales de Duero,117,71,46
47,Valladolid,57,Cubillas de Santa Marta,289,161,128
47,Valladolid,58,Cuenca de Campos,266,133,133
47,Valladolid,59,Curiel de Duero,95,55,40
47,Valladolid,60,Encinas de Esgueva,337,184,153
47,Valladolid,61,Esguevillas de Esgueva,348,178,170
47,Valladolid,62,Fombellida,227,120,107
47,Valladolid,63,Fompedraza,156,90,66
47,Valladolid,64,Fontihoyuelo,40,25,15
47,Valladolid,65,Fresno el Viejo,1159,601,558
47,Valladolid,66,Fuensaldaña,1226,605,621
47,Valladolid,67,Fuente el Sol,273,143,130
47,Valladolid,68,Fuente-Olmedo,53,29,24
47,Valladolid,69,Gallegos de Hornija,143,69,74
47,Valladolid,70,Gatón de Campos,38,22,16
47,Valladolid,71,Geria,480,258,222
47,Valladolid,73,Herrín de Campos,191,93,98
47,Valladolid,74,Hornillos de Eresma,186,96,90
47,Valladolid,75,Íscar,6611,3352,3259
47,Valladolid,76,Laguna de Duero,20696,10500,10196
47,Valladolid,77,Langayo,381,212,169
47,Valladolid,79,Llano de Olmedo,80,43,37
47,Valladolid,78,Lomoviejo,229,115,114
47,Valladolid,80,Manzanillo,56,30,26
47,Valladolid,81,Marzales,64,32,32
47,Valladolid,82,Matapozuelos,1024,516,508
47,Valladolid,83,Matilla de los Caños,112,64,48
47,Valladolid,84,Mayorga,1972,990,982
47,Valladolid,86,Medina de Rioseco,5024,2489,2535
47,Valladolid,85,Medina del Campo,20683,10114,10569
47,Valladolid,87,Megeces,453,222,231
47,Valladolid,88,Melgar de Abajo,173,98,75
47,Valladolid,89,Melgar de Arriba,279,146,133
47,Valladolid,90,Mojados,3046,1535,1511
47,Valladolid,91,Monasterio de Vega,102,54,48
47,Valladolid,92,Montealegre de Campos,154,87,67
47,Valladolid,93,Montemayor de Pililla,1029,530,499
47,Valladolid,94,Moral de la Reina,238,126,112
47,Valladolid,95,Moraleja de las Panaderas,34,24,10
47,Valladolid,96,Morales de Campos,175,85,90
47,Valladolid,97,Mota del Marqués,425,207,218
47,Valladolid,98,Mucientes,644,334,310
47,Valladolid,99,Mudarra (La),228,124,104
47,Valladolid,100,Muriel,198,99,99
47,Valladolid,101,Nava del Rey,2110,1072,1038
47,Valladolid,102,Nueva Villa de las Torres,389,216,173
47,Valladolid,103,Olivares de Duero,317,173,144
47,Valladolid,104,Olmedo,3576,1732,1844
47,Valladolid,105,Olmos de Esgueva,218,123,95
47,Valladolid,106,Olmos de Peñafiel,76,38,38
47,Valladolid,109,Palazuelo de Vedija,233,121,112
47,Valladolid,110,Parrilla (La),628,310,318
47,Valladolid,111,Pedraja de Portillo (La),1045,536,509
47,Valladolid,112,Pedrajas de San Esteban,3470,1786,1684
47,Valladolid,113,Pedrosa del Rey,203,112,91
47,Valladolid,114,Peñafiel,5401,2724,2677
47,Valladolid,115,Peñaflor de Hornija,414,226,188
47,Valladolid,116,Pesquera de Duero,530,282,248
47,Valladolid,117,Piña de Esgueva,355,173,182
47,Valladolid,118,Piñel de Abajo,191,101,90
47,Valladolid,119,Piñel de Arriba,134,62,72
47,Valladolid,121,Pollos,754,393,361
47,Valladolid,122,Portillo,2581,1326,1255
47,Valladolid,123,Pozal de Gallinas,499,269,230
47,Valladolid,124,Pozaldez,508,256,252
47,Valladolid,125,Pozuelo de la Orden,72,40,32
47,Valladolid,126,Puras,66,31,35
47,Valladolid,127,Quintanilla de Arriba,227,118,109
47,Valladolid,129,Quintanilla de Onésimo,1175,610,565
47,Valladolid,130,Quintanilla de Trigueros,121,61,60
47,Valladolid,128,Quintanilla del Molar,84,39,45
47,Valladolid,131,Rábano,228,119,109
47,Valladolid,132,Ramiro,67,39,28
47,Valladolid,133,Renedo de Esgueva,1532,803,729
47,Valladolid,134,Roales de Campos,240,120,120
47,Valladolid,135,Robladillo,104,48,56
47,Valladolid,137,Roturas,31,16,15
47,Valladolid,138,Rubí de Bracamonte,317,163,154
47,Valladolid,139,Rueda,1425,733,692
47,Valladolid,140,Saelices de Mayorga,183,98,85
47,Valladolid,141,Salvador de Zapardiel,182,103,79
47,Valladolid,142,San Cebrián de Mazote,187,105,82
47,Valladolid,143,San Llorente,177,97,80
47,Valladolid,144,San Martín de Valvení,98,52,46
47,Valladolid,145,San Miguel del Arroyo,777,402,375
47,Valladolid,146,San Miguel del Pino,208,112,96
47,Valladolid,147,San Pablo de la Moraleja,167,88,79
47,Valladolid,148,San Pedro de Latarce,608,325,283
47,Valladolid,149,San Pelayo,47,25,22
47,Valladolid,150,San Román de Hornija,416,194,222
47,Valladolid,151,San Salvador,46,26,20
47,Valladolid,156,San Vicente del Palacio,223,117,106
47,Valladolid,152,Santa Eufemia del Arroyo,131,65,66
47,Valladolid,153,Santervás de Campos,150,84,66
47,Valladolid,154,Santibáñez de Valcorba,191,95,96
47,Valladolid,155,Santovenia de Pisuerga,2908,1474,1434
47,Valladolid,157,Sardón de Duero,659,330,329
47,Valladolid,158,Seca (La),1057,544,513
47,Valladolid,159,Serrada,1128,589,539
47,Valladolid,160,Siete Iglesias de Trabancos,571,303,268
47,Valladolid,161,Simancas,4618,2382,2236
47,Valladolid,162,Tamariz de Campos,103,58,45
47,Valladolid,163,Tiedra,393,195,198
47,Valladolid,164,Tordehumos,503,249,254
47,Valladolid,165,Tordesillas,8643,4394,4249
47,Valladolid,169,Torre de Esgueva,92,45,47
47,Valladolid,170,Torre de Peñafiel,47,26,21
47,Valladolid,166,Torrecilla de la Abadesa,335,174,161
47,Valladolid,167,Torrecilla de la Orden,321,157,164
47,Valladolid,168,Torrecilla de la Torre,32,21,11
47,Valladolid,171,Torrelobatón,552,270,282
47,Valladolid,172,Torrescárcela,163,85,78
47,Valladolid,173,Traspinedo,960,514,446
47,Valladolid,174,Trigueros del Valle,335,184,151
47,Valladolid,175,Tudela de Duero,6338,3268,3070
47,Valladolid,176,Unión de Campos (La),317,162,155
47,Valladolid,177,Urones de Castroponce,144,80,64
47,Valladolid,178,Urueña,215,113,102
47,Valladolid,179,Valbuena de Duero,488,256,232
47,Valladolid,180,Valdearcos de la Vega,112,59,53
47,Valladolid,181,Valdenebro de los Valles,225,116,109
47,Valladolid,182,Valdestillas,1673,848,825
47,Valladolid,183,Valdunquillo,201,89,112
47,Valladolid,186,Valladolid,321001,153743,167258
47,Valladolid,184,Valoria la Buena,661,356,305
47,Valladolid,185,Valverde de Campos,124,67,57
47,Valladolid,187,Vega de Ruiponce,122,63,59
47,Valladolid,188,Vega de Valdetronco,164,90,74
47,Valladolid,189,Velascálvaro,196,107,89
47,Valladolid,190,Velilla,141,69,72
47,Valladolid,191,Velliza,146,90,56
47,Valladolid,192,Ventosa de la Cuesta,134,74,60
47,Valladolid,193,Viana de Cega,1809,925,884
47,Valladolid,195,Villabáñez,484,268,216
47,Valladolid,196,Villabaruz de Campos,45,24,21
47,Valladolid,197,Villabrágima,1173,627,546
47,Valladolid,198,Villacarralón,93,47,46
47,Valladolid,199,Villacid de Campos,108,62,46
47,Valladolid,200,Villaco,124,73,51
47,Valladolid,203,Villafrades de Campos,90,38,52
47,Valladolid,204,Villafranca de Duero,353,175,178
47,Valladolid,205,Villafrechós,526,270,256
47,Valladolid,206,Villafuerte,143,74,69
47,Valladolid,207,Villagarcía de Campos,401,217,184
47,Valladolid,208,Villagómez la Nueva,81,42,39
47,Valladolid,209,Villalán de Campos,53,28,25
47,Valladolid,210,Villalar de los Comuneros,444,213,231
47,Valladolid,211,Villalba de la Loma,52,30,22
47,Valladolid,212,Villalba de los Alcores,531,277,254
47,Valladolid,213,Villalbarba,149,74,75
47,Valladolid,214,Villalón de Campos,2024,999,1025
47,Valladolid,215,Villamuriel de Campos,78,36,42
47,Valladolid,216,Villán de Tordesillas,172,86,86
47,Valladolid,217,Villanubla,1448,777,671
47,Valladolid,218,Villanueva de Duero,1105,566,539
47,Valladolid,219,Villanueva de la Condesa,47,27,20
47,Valladolid,220,Villanueva de los Caballeros,241,119,122
47,Valladolid,221,Villanueva de los Infantes,130,74,56
47,Valladolid,222,Villanueva de San Mancio,125,68,57
47,Valladolid,223,Villardefrades,212,112,100
47,Valladolid,224,Villarmentero de Esgueva,130,63,67
47,Valladolid,225,Villasexmir,110,56,54
47,Valladolid,226,Villavaquerín,195,104,91
47,Valladolid,227,Villavellid,83,46,37
47,Valladolid,228,Villaverde de Medina,568,304,264
47,Valladolid,229,Villavicencio de los Caballeros,281,135,146
47,Valladolid,194,Viloria,402,219,183
47,Valladolid,230,Wamba,365,195,170
47,Valladolid,231,Zaratán,2752,1438,1314
47,Valladolid,232,Zarza (La),157,87,70
48,Vizcaya,1,Abadiño,7129,3595,3534
48,Vizcaya,2,Abanto y Ciérvana-Abanto Zierbena,9503,4717,4786
48,Vizcaya,911,Ajangiz,438,212,226
48,Vizcaya,912,Alonsotegi,2745,1342,1403
48,Vizcaya,3,Amorebieta-Etxano,16800,8340,8460
48,Vizcaya,4,Amoroto,387,200,187
48,Vizcaya,5,Arakaldo,90,54,36
48,Vizcaya,6,Arantzazu,289,147,142
48,Vizcaya,93,Areatza,1036,478,558
48,Vizcaya,9,Arrankudiaga,802,388,414
48,Vizcaya,914,Arratzu,346,173,173
48,Vizcaya,10,Arrieta,529,269,260
48,Vizcaya,11,Arrigorriaga,12134,6020,6114
48,Vizcaya,23,Artea,678,338,340
48,Vizcaya,8,Artzentales,677,365,312
48,Vizcaya,91,Atxondo,1431,723,708
48,Vizcaya,70,Aulesti,668,338,330
48,Vizcaya,12,Bakio,2024,1022,1002
48,Vizcaya,90,Balmaseda,7090,3437,3653
48,Vizcaya,13,Barakaldo,95260,46353,48907
48,Vizcaya,14,Barrika,1337,674,663
48,Vizcaya,15,Basauri,44052,21738,22314
48,Vizcaya,92,Bedia,983,486,497
48,Vizcaya,16,Berango,5904,2940,2964
48,Vizcaya,17,Bermeo,16932,8334,8598
48,Vizcaya,18,Berriatua,1140,612,528
48,Vizcaya,19,Berriz,4540,2339,2201
48,Vizcaya,20,Bilbao,353173,167314,185859
48,Vizcaya,21,Busturia,1713,867,846
48,Vizcaya,901,Derio,5030,2507,2523
48,Vizcaya,26,Dima,1143,592,551
48,Vizcaya,27,Durango,26511,12962,13549
48,Vizcaya,28,Ea,797,406,391
48,Vizcaya,31,Elantxobe,456,208,248
48,Vizcaya,32,Elorrio,7094,3539,3555
48,Vizcaya,902,Erandio,23338,11504,11834
48,Vizcaya,33,Ereño,262,132,130
48,Vizcaya,34,Ermua,16449,8344,8105
48,Vizcaya,79,Errigoiti,500,280,220
48,Vizcaya,29,"Etxebarri, Anteiglesia de San Esteban-Etxebarri Doneztebeko Elizatea",7707,3960,3747
48,Vizcaya,30,Etxebarria,811,428,383
48,Vizcaya,906,Forua,993,504,489
48,Vizcaya,35,Fruiz,379,196,183
48,Vizcaya,36,Galdakao,29594,14631,14963
48,Vizcaya,37,Galdames,824,438,386
48,Vizcaya,38,Gamiz-Fika,1264,652,612
48,Vizcaya,39,Garai,283,142,141
48,Vizcaya,40,Gatika,1365,693,672
48,Vizcaya,41,Gautegiz Arteaga,869,437,432
48,Vizcaya,46,Gernika-Lumo,15855,7719,8136
48,Vizcaya,44,Getxo,82687,39303,43384
48,Vizcaya,47,Gizaburuaga,147,74,73
48,Vizcaya,42,Gordexola,1571,783,788
48,Vizcaya,43,Gorliz,4882,2433,2449
48,Vizcaya,45,Güeñes,6119,3026,3093
48,Vizcaya,48,Ibarrangelu,570,283,287
48,Vizcaya,94,Igorre,4066,2031,2035
48,Vizcaya,49,Ispaster,619,331,288
48,Vizcaya,910,Iurreta,4027,2008,2019
48,Vizcaya,50,Izurtza,253,133,120
48,Vizcaya,22,Karrantza Harana/Valle de Carranza,2850,1481,1369
48,Vizcaya,907,Kortezubi,387,197,190
48,Vizcaya,51,Lanestosa,279,138,141
48,Vizcaya,52,Larrabetzu,1647,803,844
48,Vizcaya,53,Laukiz,986,506,480
48,Vizcaya,54,Leioa,28858,14118,14740
48,Vizcaya,57,Lekeitio,7293,3600,3693
48,Vizcaya,55,Lemoa,2831,1403,1428
48,Vizcaya,56,Lemoiz,925,485,440
48,Vizcaya,81,Lezama,2287,1156,1131
48,Vizcaya,903,Loiu,2205,1159,1046
48,Vizcaya,58,Mallabia,1132,595,537
48,Vizcaya,59,Mañaria,458,238,220
48,Vizcaya,60,Markina-Xemein,4823,2473,2350
48,Vizcaya,61,Maruri-Jatabe,807,403,404
48,Vizcaya,62,Mendata,346,175,171
48,Vizcaya,63,Mendexa,378,203,175
48,Vizcaya,64,Meñaka,584,297,287
48,Vizcaya,66,Morga,405,226,179
48,Vizcaya,68,Mundaka,1852,919,933
48,Vizcaya,69,Mungia,14882,7285,7597
48,Vizcaya,7,Munitibar-Arbatzegi Gerrikaitz,377,202,175
48,Vizcaya,908,Murueta,281,144,137
48,Vizcaya,71,Muskiz,6682,3305,3377
48,Vizcaya,67,Muxika,1295,658,637
48,Vizcaya,909,Nabarniz,229,117,112
48,Vizcaya,73,Ondarroa,9435,4790,4645
48,Vizcaya,75,Orozko,2302,1167,1135
48,Vizcaya,83,Ortuella,8554,4151,4403
48,Vizcaya,72,Otxandio,1060,551,509
48,Vizcaya,77,Plentzia,3949,1916,2033
48,Vizcaya,78,Portugalete,49788,24168,25620
48,Vizcaya,82,Santurtzi,47155,23034,24121
48,Vizcaya,84,Sestao,30350,14780,15570
48,Vizcaya,904,Sondika,4300,2081,2219
48,Vizcaya,85,Sopelana,11469,5686,5783
48,Vizcaya,86,Sopuerta,2308,1164,1144
48,Vizcaya,76,Sukarrieta,355,185,170
48,Vizcaya,87,Trucios-Turtzioz,524,266,258
48,Vizcaya,88,Ubide,159,80,79
48,Vizcaya,65,Ugao-Miraballes,4060,2060,2000
48,Vizcaya,89,Urduliz,3241,1620,1621
48,Vizcaya,74,Urduña-Orduña,4057,2095,1962
48,Vizcaya,80,Valle de Trápaga-Trapagaran,12580,6185,6395
48,Vizcaya,95,Zaldibar,2875,1410,1465
48,Vizcaya,96,Zalla,7973,3895,4078
48,Vizcaya,905,Zamudio,3176,1583,1593
48,Vizcaya,97,Zaratamo,1624,802,822
48,Vizcaya,24,Zeanuri,1203,627,576
48,Vizcaya,25,Zeberio,1027,533,494
48,Vizcaya,913,Zierbena,1283,688,595
49,Zamora,2,Abezames,94,51,43
49,Zamora,3,Alcañices,1079,535,544
49,Zamora,4,Alcubilla de Nogales,168,84,84
49,Zamora,5,Alfaraz de Sayago,195,107,88
49,Zamora,6,Algodre,175,91,84
49,Zamora,7,Almaraz de Duero,451,222,229
49,Zamora,8,Almeida de Sayago,608,307,301
49,Zamora,9,Andavías,449,220,229
49,Zamora,10,Arcenillas,316,160,156
49,Zamora,11,Arcos de la Polvorosa,276,148,128
49,Zamora,12,Argañín,86,41,45
49,Zamora,13,Argujillo,349,183,166
49,Zamora,14,Arquillinos,163,89,74
49,Zamora,15,Arrabalde,343,160,183
49,Zamora,16,Aspariegos,315,158,157
49,Zamora,17,Asturianos,304,153,151
49,Zamora,18,Ayoó de Vidriales,410,209,201
49,Zamora,19,Barcial del Barco,305,169,136
49,Zamora,20,Belver de los Montes,415,228,187
49,Zamora,21,Benavente,18199,8908,9291
49,Zamora,22,Benegiles,398,209,189
49,Zamora,23,Bermillo de Sayago,1296,692,604
49,Zamora,24,Bóveda de Toro (La),881,448,433
49,Zamora,25,Bretó,226,120,106
49,Zamora,26,Bretocino,295,157,138
49,Zamora,27,Brime de Sog,212,98,114
49,Zamora,28,Brime de Urz,146,77,69
49,Zamora,29,Burganes de Valverde,839,439,400
49,Zamora,30,Bustillo del Oro,131,66,65
49,Zamora,31,Cabañas de Sayago,190,94,96
49,Zamora,32,Calzadilla de Tera,449,217,232
49,Zamora,33,Camarzana de Tera,1011,491,520
49,Zamora,34,Cañizal,586,316,270
49,Zamora,35,Cañizo,306,160,146
49,Zamora,36,Carbajales de Alba,695,357,338
49,Zamora,37,Carbellino,244,127,117
49,Zamora,38,Casaseca de Campeán,129,73,56
49,Zamora,39,Casaseca de las Chanas,358,182,176
49,Zamora,40,Castrillo de la Guareña,150,77,73
49,Zamora,41,Castrogonzalo,527,289,238
49,Zamora,42,Castronuevo,337,170,167
49,Zamora,43,Castroverde de Campos,391,207,184
49,Zamora,44,Cazurra,86,46,40
49,Zamora,46,Cerecinos de Campos,396,206,190
49,Zamora,47,Cerecinos del Carrizal,144,83,61
49,Zamora,48,Cernadilla,174,84,90
49,Zamora,50,Cobreros,654,326,328
49,Zamora,52,Coomonte,292,149,143
49,Zamora,53,Coreses,1143,587,556
49,Zamora,54,Corrales,1041,497,544
49,Zamora,55,Cotanes del Monte,145,77,68
49,Zamora,56,Cubillos,385,197,188
49,Zamora,57,Cubo de Benavente,150,80,70
49,Zamora,58,Cubo de Tierra del Vino (El),443,238,205
49,Zamora,59,Cuelgamures,131,78,53
49,Zamora,61,Entrala,162,84,78
49,Zamora,62,Espadañedo,184,91,93
49,Zamora,63,Faramontanos de Tábara,488,254,234
49,Zamora,64,Fariza,665,331,334
49,Zamora,65,Fermoselle,1523,772,751
49,Zamora,66,Ferreras de Abajo,646,316,330
49,Zamora,67,Ferreras de Arriba,511,257,254
49,Zamora,68,Ferreruela,579,304,275
49,Zamora,69,Figueruela de Arriba,473,219,254
49,Zamora,71,Fonfría,1068,543,525
49,Zamora,75,Fresno de la Polvorosa,192,91,101
49,Zamora,76,Fresno de la Ribera,401,223,178
49,Zamora,77,Fresno de Sayago,233,117,116
49,Zamora,78,Friera de Valverde,249,126,123
49,Zamora,79,Fuente Encalada,132,67,65
49,Zamora,80,Fuentelapeña,919,467,452
49,Zamora,82,Fuentes de Ropel,574,304,270
49,Zamora,81,Fuentesaúco,1902,984,918
49,Zamora,83,Fuentesecas,86,41,45
49,Zamora,84,Fuentespreadas,368,195,173
49,Zamora,85,Galende,1372,689,683
49,Zamora,86,Gallegos del Pan,154,79,75
49,Zamora,87,Gallegos del Río,735,395,340
49,Zamora,88,Gamones,98,54,44
49,Zamora,90,Gema,262,130,132
49,Zamora,91,Granja de Moreruela,331,166,165
49,Zamora,92,Granucillo,213,109,104
49,Zamora,93,Guarrate,362,190,172
49,Zamora,94,Hermisende,371,203,168
49,Zamora,95,Hiniesta (La),360,177,183
49,Zamora,96,Jambrina,213,103,110
49,Zamora,97,Justel,146,82,64
49,Zamora,98,Losacino,297,159,138
49,Zamora,99,Losacio,118,60,58
49,Zamora,100,Lubián,352,177,175
49,Zamora,101,Luelmo,230,113,117
49,Zamora,102,Maderal (El),283,153,130
49,Zamora,103,Madridanos,531,266,265
49,Zamora,104,Mahide,482,252,230
49,Zamora,105,Maire de Castroponce,213,107,106
49,Zamora,107,Malva,197,102,95
49,Zamora,108,Manganeses de la Lampreana,689,345,344
49,Zamora,109,Manganeses de la Polvorosa,799,387,412
49,Zamora,110,Manzanal de Arriba,427,224,203
49,Zamora,112,Manzanal de los Infantes,173,91,82
49,Zamora,111,Manzanal del Barco,188,97,91
49,Zamora,113,Matilla de Arzón,236,128,108
49,Zamora,114,Matilla la Seca,64,29,35
49,Zamora,115,Mayalde,237,119,118
49,Zamora,116,Melgar de Tera,505,250,255
49,Zamora,117,Micereces de Tera,595,306,289
49,Zamora,118,Milles de la Polvorosa,262,134,128
49,Zamora,119,Molacillos,295,156,139
49,Zamora,120,Molezuelas de la Carballeda,78,36,42
49,Zamora,121,Mombuey,435,223,212
49,Zamora,122,Monfarracinos,782,404,378
49,Zamora,123,Montamarta,621,318,303
49,Zamora,124,Moral de Sayago,344,186,158
49,Zamora,126,Moraleja de Sayago,292,153,139
49,Zamora,125,Moraleja del Vino,1345,713,632
49,Zamora,128,Morales de Rey,715,359,356
49,Zamora,129,Morales de Toro,1077,538,539
49,Zamora,130,Morales de Valverde,268,133,135
49,Zamora,127,Morales del Vino,2129,1103,1026
49,Zamora,131,Moralina,346,172,174
49,Zamora,132,Moreruela de los Infanzones,430,223,207
49,Zamora,133,Moreruela de Tábara,473,251,222
49,Zamora,134,Muelas de los Caballeros,243,141,102
49,Zamora,135,Muelas del Pan,833,420,413
49,Zamora,136,Muga de Sayago,459,216,243
49,Zamora,137,Navianos de Valverde,241,125,116
49,Zamora,138,Olmillos de Castro,373,199,174
49,Zamora,139,Otero de Bodas,223,120,103
49,Zamora,141,Pajares de la Lampreana,483,241,242
49,Zamora,143,Palacios de Sanabria,300,149,151
49,Zamora,142,Palacios del Pan,230,104,126
49,Zamora,145,Pedralba de la Pradería,288,139,149
49,Zamora,146,Pego (El),404,207,197
49,Zamora,147,Peleagonzalo,374,188,186
49,Zamora,148,Peleas de Abajo,248,115,133
49,Zamora,149,Peñausende,485,240,245
49,Zamora,150,Peque,178,84,94
49,Zamora,151,Perdigón (El),771,400,371
49,Zamora,152,Pereruela,683,354,329
49,Zamora,153,Perilla de Castro,216,106,110
49,Zamora,154,Pías,200,102,98
49,Zamora,155,Piedrahita de Castro,129,75,54
49,Zamora,156,Pinilla de Toro,326,164,162
49,Zamora,157,Pino del Oro,216,112,104
49,Zamora,158,Piñero (El),270,139,131
49,Zamora,160,Pobladura de Valderaduey,66,34,32
49,Zamora,159,Pobladura del Valle,334,167,167
49,Zamora,162,Porto,288,153,135
49,Zamora,163,Pozoantiguo,293,151,142
49,Zamora,164,Pozuelo de Tábara,205,101,104
49,Zamora,165,Prado,96,50,46
49,Zamora,166,Puebla de Sanabria,1593,755,838
49,Zamora,167,Pueblica de Valverde,272,139,133
49,Zamora,170,Quintanilla de Urz,142,69,73
49,Zamora,168,Quintanilla del Monte,133,64,69
49,Zamora,169,Quintanilla del Olmo,47,24,23
49,Zamora,171,Quiruelas de Vidriales,903,434,469
49,Zamora,172,Rabanales,746,384,362
49,Zamora,173,Rábano de Aliste,443,227,216
49,Zamora,174,Requejo,164,80,84
49,Zamora,175,Revellinos,299,161,138
49,Zamora,176,Riofrío de Aliste,1005,530,475
49,Zamora,177,Rionegro del Puente,371,187,184
49,Zamora,178,Roales,508,257,251
49,Zamora,179,Robleda-Cervantes,438,218,220
49,Zamora,180,Roelos de Sayago,147,76,71
49,Zamora,181,Rosinos de la Requejada,477,229,248
49,Zamora,183,Salce,124,66,58
49,Zamora,184,Samir de los Caños,221,119,102
49,Zamora,185,San Agustín del Pozo,211,112,99
49,Zamora,186,San Cebrián de Castro,330,159,171
49,Zamora,187,San Cristóbal de Entreviñas,1646,851,795
49,Zamora,188,San Esteban del Molar,169,90,79
49,Zamora,189,San Justo,316,162,154
49,Zamora,190,San Martín de Valderaduey,87,43,44
49,Zamora,191,San Miguel de la Ribera,378,192,186
49,Zamora,192,San Miguel del Valle,201,98,103
49,Zamora,193,San Pedro de Ceque,646,321,325
49,Zamora,194,San Pedro de la Nave-Almendra,460,228,232
49,Zamora,208,San Vicente de la Cabeza,537,278,259
49,Zamora,209,San Vitero,670,361,309
49,Zamora,197,Santa Clara de Avedillo,239,117,122
49,Zamora,199,Santa Colomba de las Monjas,318,159,159
49,Zamora,200,Santa Cristina de la Polvorosa,1224,620,604
49,Zamora,201,Santa Croya de Tera,422,214,208
49,Zamora,202,Santa Eufemia del Barco,273,148,125
49,Zamora,203,Santa María de la Vega,460,239,221
49,Zamora,204,Santa María de Valverde,91,44,47
49,Zamora,205,Santibáñez de Tera,584,287,297
49,Zamora,206,Santibáñez de Vidriales,1250,630,620
49,Zamora,207,Santovenia,351,165,186
49,Zamora,210,Sanzoles,641,327,314
49,Zamora,214,Tábara,935,487,448
49,Zamora,216,Tapioles,215,118,97
49,Zamora,219,Toro,9466,4644,4822
49,Zamora,220,Torre del Valle (La),183,101,82
49,Zamora,221,Torregamones,326,169,157
49,Zamora,222,Torres del Carrizal,491,256,235
49,Zamora,223,Trabazos,957,483,474
49,Zamora,224,Trefacio,228,112,116
49,Zamora,225,Uña de Quintana,213,110,103
49,Zamora,226,Vadillo de la Guareña,351,187,164
49,Zamora,227,Valcabado,334,168,166
49,Zamora,228,Valdefinjas,85,50,35
49,Zamora,229,Valdescorriel,195,102,93
49,Zamora,230,Vallesa de la Guareña,159,84,75
49,Zamora,231,Vega de Tera,459,222,237
49,Zamora,232,Vega de Villalobos,144,65,79
49,Zamora,233,Vegalatrave,146,80,66
49,Zamora,234,Venialbo,504,273,231
49,Zamora,235,Vezdemarbán,625,303,322
49,Zamora,236,Vidayanes,108,53,55
49,Zamora,237,Videmala,197,95,102
49,Zamora,238,Villabrázaro,352,176,176
49,Zamora,239,Villabuena del Puente,889,471,418
49,Zamora,240,Villadepera,271,136,135
49,Zamora,241,Villaescusa,348,174,174
49,Zamora,242,Villafáfila,619,318,301
49,Zamora,243,Villaferrueña,146,75,71
49,Zamora,244,Villageriz,55,29,26
49,Zamora,245,Villalazán,362,176,186
49,Zamora,246,Villalba de la Lampreana,289,150,139
49,Zamora,247,Villalcampo,619,322,297
49,Zamora,248,Villalobos,309,152,157
49,Zamora,249,Villalonso,113,60,53
49,Zamora,250,Villalpando,1623,795,828
49,Zamora,251,Villalube,237,121,116
49,Zamora,252,Villamayor de Campos,483,244,239
49,Zamora,255,Villamor de los Escuderos,534,270,264
49,Zamora,256,Villanázar,364,175,189
49,Zamora,257,Villanueva de Azoague,327,171,156
49,Zamora,258,Villanueva de Campeán,158,78,80
49,Zamora,259,Villanueva de las Peras,163,83,80
49,Zamora,260,Villanueva del Campo,1046,521,525
49,Zamora,263,Villar de Fallaves,92,50,42
49,Zamora,264,Villar del Buey,787,427,360
49,Zamora,261,Villaralbo,1697,847,850
49,Zamora,262,Villardeciervos,506,254,252
49,Zamora,265,Villardiegua de la Ribera,159,78,81
49,Zamora,266,Villárdiga,99,49,50
49,Zamora,267,Villardondiego,123,69,54
49,Zamora,268,Villarrín de Campos,574,303,271
49,Zamora,269,Villaseco del Pan,274,126,148
49,Zamora,270,Villavendimio,195,111,84
49,Zamora,272,Villaveza de Valverde,121,59,62
49,Zamora,271,Villaveza del Agua,261,134,127
49,Zamora,273,Viñas,253,130,123
49,Zamora,275,Zamora,66123,31218,34905
50,Zaragoza,1,Abanto,150,80,70
50,Zaragoza,2,Acered,223,124,99
50,Zaragoza,3,Agón,176,94,82
50,Zaragoza,4,Aguarón,776,389,387
50,Zaragoza,5,Aguilón,280,139,141
50,Zaragoza,6,Ainzón,1267,658,609
50,Zaragoza,7,Aladrén,64,39,25
50,Zaragoza,8,Alagón,6187,3090,3097
50,Zaragoza,9,Alarba,157,88,69
50,Zaragoza,10,Alberite de San Juan,104,63,41
50,Zaragoza,11,Albeta,144,72,72
50,Zaragoza,12,Alborge,133,70,63
50,Zaragoza,13,Alcalá de Ebro,299,144,155
50,Zaragoza,14,Alcalá de Moncayo,139,73,66
50,Zaragoza,15,Alconchel de Ariza,121,69,52
50,Zaragoza,16,Aldehuela de Liestos,38,23,15
50,Zaragoza,17,Alfajarín,1816,926,890
50,Zaragoza,18,Alfamén,1589,947,642
50,Zaragoza,19,Alforque,84,46,38
50,Zaragoza,20,Alhama de Aragón,1146,590,556
50,Zaragoza,21,Almochuel,42,22,20
50,Zaragoza,22,Almolda (La),653,329,324
50,Zaragoza,23,Almonacid de la Cuba,297,151,146
50,Zaragoza,24,Almonacid de la Sierra,877,480,397
50,Zaragoza,25,Almunia de Doña Godina (La),6779,3543,3236
50,Zaragoza,26,Alpartir,584,305,279
50,Zaragoza,27,Ambel,323,146,177
50,Zaragoza,28,Anento,176,115,61
50,Zaragoza,29,Aniñón,831,447,384
50,Zaragoza,30,Añón de Moncayo,249,149,100
50,Zaragoza,31,Aranda de Moncayo,220,124,96
50,Zaragoza,32,Arándiga,446,227,219
50,Zaragoza,33,Ardisa,82,48,34
50,Zaragoza,34,Ariza,1276,652,624
50,Zaragoza,35,Artieda,108,65,43
50,Zaragoza,36,Asín,113,58,55
50,Zaragoza,37,Atea,172,100,72
50,Zaragoza,38,Ateca,2059,1030,1029
50,Zaragoza,39,Azuara,643,340,303
50,Zaragoza,40,Badules,101,52,49
50,Zaragoza,41,Bagüés,37,21,16
50,Zaragoza,42,Balconchán,14,4,10
50,Zaragoza,43,Bárboles,310,166,144
50,Zaragoza,44,Bardallur,281,134,147
50,Zaragoza,45,Belchite,1621,837,784
50,Zaragoza,46,Belmonte de Gracián,241,128,113
50,Zaragoza,47,Berdejo,79,44,35
50,Zaragoza,48,Berrueco,38,20,18
50,Zaragoza,901,Biel,211,119,92
50,Zaragoza,50,Bijuesca,117,70,47
50,Zaragoza,51,Biota,1143,584,559
50,Zaragoza,52,Bisimbre,117,55,62
50,Zaragoza,53,Boquiñeni,1052,544,508
50,Zaragoza,54,Bordalba,95,56,39
50,Zaragoza,55,Borja,4444,2202,2242
50,Zaragoza,56,Botorrita,481,261,220
50,Zaragoza,57,Brea de Aragón,1973,1015,958
50,Zaragoza,58,Bubierca,89,45,44
50,Zaragoza,59,Bujaraloz,1020,534,486
50,Zaragoza,60,Bulbuente,249,129,120
50,Zaragoza,61,Bureta,303,159,144
50,Zaragoza,62,Burgo de Ebro (El),1894,985,909
50,Zaragoza,63,Buste (El),91,45,46
50,Zaragoza,64,Cabañas de Ebro,519,269,250
50,Zaragoza,65,Cabolafuente,63,34,29
50,Zaragoza,66,Cadrete,2303,1220,1083
50,Zaragoza,67,Calatayud,20263,10095,10168
50,Zaragoza,68,Calatorao,2994,1635,1359
50,Zaragoza,69,Calcena,66,35,31
50,Zaragoza,70,Calmarza,75,42,33
50,Zaragoza,71,Campillo de Aragón,175,96,79
50,Zaragoza,72,Carenas,223,110,113
50,Zaragoza,73,Cariñena,3536,1928,1608
50,Zaragoza,74,Caspe,8206,4132,4074
50,Zaragoza,75,Castejón de Alarba,99,52,47
50,Zaragoza,76,Castejón de las Armas,95,51,44
50,Zaragoza,77,Castejón de Valdejasa,302,156,146
50,Zaragoza,78,Castiliscar,385,201,184
50,Zaragoza,79,Cervera de la Cañada,332,168,164
50,Zaragoza,80,Cerveruela,34,23,11
50,Zaragoza,81,Cetina,711,348,363
50,Zaragoza,92,Chiprana,353,176,177
50,Zaragoza,93,Chodes,148,75,73
50,Zaragoza,82,Cimballa,141,73,68
50,Zaragoza,83,Cinco Olivas,115,57,58
50,Zaragoza,84,Clarés de Ribota,106,57,49
50,Zaragoza,85,Codo,224,113,111
50,Zaragoza,86,Codos,275,168,107
50,Zaragoza,87,Contamina,46,28,18
50,Zaragoza,88,Cosuenda,380,198,182
50,Zaragoza,89,Cuarte de Huerva,3078,1605,1473
50,Zaragoza,90,Cubel,215,105,110
50,Zaragoza,91,Cuerlas (Las),92,45,47
50,Zaragoza,94,Daroca,2226,1145,1081
50,Zaragoza,95,Ejea de los Caballeros,16941,8864,8077
50,Zaragoza,96,Embid de Ariza,71,38,33
50,Zaragoza,98,Encinacorba,293,161,132
50,Zaragoza,99,Épila,4164,2187,1977
50,Zaragoza,100,Erla,429,210,219
50,Zaragoza,101,Escatrón,1160,561,599
50,Zaragoza,102,Fabara,1173,625,548
50,Zaragoza,104,Farlete,443,220,223
50,Zaragoza,105,Fayón,394,198,196
50,Zaragoza,106,Fayos (Los),174,86,88
50,Zaragoza,107,Figueruelas,1133,580,553
50,Zaragoza,108,Fombuena,50,30,20
50,Zaragoza,109,Frago (El),125,74,51
50,Zaragoza,110,Frasno (El),505,267,238
50,Zaragoza,111,Fréscano,241,126,115
50,Zaragoza,113,Fuendejalón,750,385,365
50,Zaragoza,114,Fuendetodos,173,90,83
50,Zaragoza,115,Fuentes de Ebro,4086,2157,1929
50,Zaragoza,116,Fuentes de Jiloca,300,156,144
50,Zaragoza,117,Gallocanta,157,83,74
50,Zaragoza,118,Gallur,2921,1493,1428
50,Zaragoza,119,Gelsa,1221,616,605
50,Zaragoza,120,Godojos,59,28,31
50,Zaragoza,121,Gotor,390,202,188
50,Zaragoza,122,Grisel,70,45,25
50,Zaragoza,123,Grisén,484,248,236
50,Zaragoza,124,Herrera de los Navarros,647,339,308
50,Zaragoza,125,Ibdes,534,274,260
50,Zaragoza,126,Illueca,3332,1634,1698
50,Zaragoza,128,Isuerre,53,35,18
50,Zaragoza,129,Jaraba,314,165,149
50,Zaragoza,130,Jarque,553,297,256
50,Zaragoza,131,Jaulín,308,158,150
50,Zaragoza,132,Joyosa (La),697,356,341
50,Zaragoza,133,Lagata,141,83,58
50,Zaragoza,134,Langa del Castillo,164,82,82
50,Zaragoza,135,Layana,123,63,60
50,Zaragoza,136,Lécera,776,394,382
50,Zaragoza,138,Lechón,58,33,25
50,Zaragoza,137,Leciñena,1284,646,638
50,Zaragoza,139,Letux,413,213,200
50,Zaragoza,140,Litago,192,104,88
50,Zaragoza,141,Lituénigo,124,61,63
50,Zaragoza,142,Lobera de Onsella,62,38,24
50,Zaragoza,143,Longares,914,520,394
50,Zaragoza,144,Longás,50,30,20
50,Zaragoza,146,Lucena de Jalón,267,143,124
50,Zaragoza,147,Luceni,1058,536,522
50,Zaragoza,148,Luesia,376,206,170
50,Zaragoza,149,Luesma,35,20,15
50,Zaragoza,150,Lumpiaque,984,520,464
50,Zaragoza,151,Luna,873,459,414
50,Zaragoza,152,Maella,2056,1091,965
50,Zaragoza,153,Magallón,1158,615,543
50,Zaragoza,154,Mainar,150,82,68
50,Zaragoza,155,Malanquilla,139,75,64
50,Zaragoza,156,Maleján,286,142,144
50,Zaragoza,160,Mallén,3385,1820,1565
50,Zaragoza,157,Malón,421,217,204
50,Zaragoza,159,Maluenda,1033,506,527
50,Zaragoza,161,Manchones,145,76,69
50,Zaragoza,162,Mara,210,105,105
50,Zaragoza,163,María de Huerva,2498,1324,1174
50,Zaragoza,902,Marracos,112,57,55
50,Zaragoza,164,Mediana de Aragón,495,251,244
50,Zaragoza,165,Mequinenza,2485,1255,1230
50,Zaragoza,166,Mesones de Isuela,329,161,168
50,Zaragoza,167,Mezalocha,271,153,118
50,Zaragoza,168,Mianos,46,25,21
50,Zaragoza,169,Miedes de Aragón,487,249,238
50,Zaragoza,170,Monegrillo,506,277,229
50,Zaragoza,171,Moneva,103,56,47
50,Zaragoza,172,Monreal de Ariza,244,131,113
50,Zaragoza,173,Monterde,229,125,104
50,Zaragoza,174,Montón,148,79,69
50,Zaragoza,175,Morata de Jalón,1417,701,716
50,Zaragoza,176,Morata de Jiloca,295,159,136
50,Zaragoza,177,Morés,407,213,194
50,Zaragoza,178,Moros,506,259,247
50,Zaragoza,179,Moyuela,301,159,142
50,Zaragoza,180,Mozota,129,65,64
50,Zaragoza,181,Muel,1180,596,584
50,Zaragoza,182,Muela (La),3265,1690,1575
50,Zaragoza,183,Munébrega,437,235,202
50,Zaragoza,184,Murero,138,75,63
50,Zaragoza,185,Murillo de Gállego,179,102,77
50,Zaragoza,186,Navardún,53,30,23
50,Zaragoza,187,Nigüella,90,47,43
50,Zaragoza,188,Nombrevilla,46,25,21
50,Zaragoza,189,Nonaspe,1059,551,508
50,Zaragoza,190,Novallas,806,413,393
50,Zaragoza,191,Novillas,660,341,319
50,Zaragoza,192,Nuévalos,374,198,176
50,Zaragoza,193,Nuez de Ebro,646,329,317
50,Zaragoza,194,Olvés,126,68,58
50,Zaragoza,195,Orcajo,37,20,17
50,Zaragoza,196,Orera,135,71,64
50,Zaragoza,197,Orés,109,60,49
50,Zaragoza,198,Oseja,46,26,20
50,Zaragoza,199,Osera de Ebro,387,197,190
50,Zaragoza,200,Paniza,748,403,345
50,Zaragoza,201,Paracuellos de Jiloca,515,257,258
50,Zaragoza,202,Paracuellos de la Ribera,225,108,117
50,Zaragoza,203,Pastriz,1259,615,644
50,Zaragoza,204,Pedrola,3065,1591,1474
50,Zaragoza,205,Pedrosas (Las),94,53,41
50,Zaragoza,206,Perdiguera,617,319,298
50,Zaragoza,207,Piedratajada,170,85,85
50,Zaragoza,208,Pina de Ebro,2384,1221,1163
50,Zaragoza,209,Pinseque,2479,1262,1217
50,Zaragoza,210,Pintanos (Los),94,57,37
50,Zaragoza,211,Plasencia de Jalón,367,209,158
50,Zaragoza,212,Pleitas,58,33,25
50,Zaragoza,213,Plenas,117,60,57
50,Zaragoza,214,Pomer,41,24,17
50,Zaragoza,215,Pozuel de Ariza,27,17,10
50,Zaragoza,216,Pozuelo de Aragón,338,185,153
50,Zaragoza,217,Pradilla de Ebro,633,329,304
50,Zaragoza,218,Puebla de Albortón,154,94,60
50,Zaragoza,219,Puebla de Alfindén (La),3559,1801,1758
50,Zaragoza,220,Puendeluna,61,37,24
50,Zaragoza,221,Purujosa,48,37,11
50,Zaragoza,222,Quinto,2034,1018,1016
50,Zaragoza,223,Remolinos,1216,616,600
50,Zaragoza,224,Retascón,95,53,42
50,Zaragoza,225,Ricla,2721,1515,1206
50,Zaragoza,227,Romanos,130,73,57
50,Zaragoza,228,Rueda de Jalón,360,186,174
50,Zaragoza,229,Ruesca,86,45,41
50,Zaragoza,241,Sabiñán,795,388,407
50,Zaragoza,230,Sádaba,1820,929,891
50,Zaragoza,231,Salillas de Jalón,350,186,164
50,Zaragoza,232,Salvatierra de Esca,260,126,134
50,Zaragoza,233,Samper del Salz,124,65,59
50,Zaragoza,234,San Martín de la Virgen de Moncayo,290,158,132
50,Zaragoza,235,San Mateo de Gállego,2447,1280,1167
50,Zaragoza,236,Santa Cruz de Grío,197,105,92
50,Zaragoza,237,Santa Cruz de Moncayo,120,63,57
50,Zaragoza,238,Santa Eulalia de Gállego,129,68,61
50,Zaragoza,239,Santed,76,38,38
50,Zaragoza,240,Sástago,1288,649,639
50,Zaragoza,242,Sediles,91,47,44
50,Zaragoza,243,Sestrica,447,237,210
50,Zaragoza,244,Sierra de Luna,277,145,132
50,Zaragoza,245,Sigüés,167,86,81
50,Zaragoza,246,Sisamón,56,38,18
50,Zaragoza,247,Sobradiel,813,430,383
50,Zaragoza,248,Sos del Rey Católico,722,366,356
50,Zaragoza,249,Tabuenca,454,253,201
50,Zaragoza,250,Talamantes,61,33,28
50,Zaragoza,251,Tarazona,10875,5280,5595
50,Zaragoza,252,Tauste,7412,3716,3696
50,Zaragoza,253,Terrer,569,284,285
50,Zaragoza,254,Tierga,212,116,96
50,Zaragoza,255,Tobed,252,129,123
50,Zaragoza,256,Torralba de los Frailes,82,43,39
50,Zaragoza,257,Torralba de Ribota,192,103,89
50,Zaragoza,258,Torralbilla,71,37,34
50,Zaragoza,259,Torrehermosa,99,52,47
50,Zaragoza,260,Torrelapaja,36,21,15
50,Zaragoza,261,Torrellas,311,174,137
50,Zaragoza,262,Torres de Berrellén,1430,736,694
50,Zaragoza,263,Torrijo de la Cañada,339,184,155
50,Zaragoza,264,Tosos,221,117,104
50,Zaragoza,265,Trasmoz,69,36,33
50,Zaragoza,266,Trasobares,176,102,74
50,Zaragoza,267,Uncastillo,849,420,429
50,Zaragoza,268,Undués de Lerda,62,37,25
50,Zaragoza,269,Urrea de Jalón,329,161,168
50,Zaragoza,270,Urriés,55,35,20
50,Zaragoza,271,Used,363,202,161
50,Zaragoza,272,Utebo,14037,7207,6830
50,Zaragoza,274,Val de San Martín,84,43,41
50,Zaragoza,273,Valdehorna,46,24,22
50,Zaragoza,275,Valmadrid,92,59,33
50,Zaragoza,276,Valpalmas,166,83,83
50,Zaragoza,277,Valtorres,110,55,55
50,Zaragoza,278,Velilla de Ebro,255,127,128
50,Zaragoza,279,Velilla de Jiloca,109,55,54
50,Zaragoza,280,Vera de Moncayo,438,229,209
50,Zaragoza,281,Vierlas,98,48,50
50,Zaragoza,283,Villadoz,98,57,41
50,Zaragoza,284,Villafeliche,220,112,108
50,Zaragoza,285,Villafranca de Ebro,734,361,373
50,Zaragoza,286,Villalba de Perejil,123,64,59
50,Zaragoza,287,Villalengua,396,201,195
50,Zaragoza,288,Villanueva de Gállego,3790,1917,1873
50,Zaragoza,290,Villanueva de Huerva,574,305,269
50,Zaragoza,289,Villanueva de Jiloca,82,42,40
50,Zaragoza,291,Villar de los Navarros,142,72,70
50,Zaragoza,292,Villarreal de Huerva,208,120,88
50,Zaragoza,293,Villarroya de la Sierra,624,317,307
50,Zaragoza,294,Villarroya del Campo,78,43,35
50,Zaragoza,282,Vilueña (La),109,52,57
50,Zaragoza,295,Vistabella,35,23,12
50,Zaragoza,296,Zaida (La),549,278,271
50,Zaragoza,297,Zaragoza,647373,313588,333785
50,Zaragoza,298,Zuera,6212,3201,3011
51,Ceuta,1,Ceuta,75276,38315,36961
52,Melilla,1,Melilla,65488,33322,32166
