CPRO,PROVINCIA,CMUN,NOMBRE,AMBOS  SEXOS,VARONES,MUJERES
1,Álava,1,Alegría-Dulantzi,2714,1395,1319
1,Álava,2,Amurrio,10050,5047,5003
1,Álava,49,Añana,175,92,83
1,Álava,3,Aramaio,1497,790,707
1,Álava,6,Armiñón,225,112,113
1,Álava,37,Arraia-Maeztu,708,399,309
1,Álava,8,Arrazua-Ubarrundia,913,485,428
1,Álava,4,Artziniega,1818,909,909
1,Álava,9,Asparrena,1680,844,836
1,Álava,10,Ayala/Aiara,2827,1425,1402
1,Álava,11,Baños de Ebro/Mañueta,329,181,148
1,Álava,13,Barrundia,910,503,407
1,Álava,14,Berantevilla,499,263,236
1,Álava,16,Bernedo,575,326,249
1,Álava,17,Campezo/Kanpezu,1126,589,537
1,Álava,21,Elburgo/Burgelu,589,309,280
1,Álava,22,Elciego,1051,517,534
1,Álava,23,Elvillar/Bilar,367,184,183
1,Álava,46,Erriberagoitia/Ribera Alta,750,428,322
1,Álava,56,Harana/Valle de Arana,296,173,123
1,Álava,901,Iruña Oka/Iruña de Oca,2973,1529,1444
1,Álava,27,Iruraiz-Gauna,511,282,229
1,Álava,19,Kripan,195,105,90
1,Álava,20,Kuartango,355,202,153
1,Álava,28,Labastida/Bastida,1471,780,691
1,Álava,30,Lagrán,178,92,86
1,Álava,31,Laguardia,1512,778,734
1,Álava,32,Lanciego/Lantziego,696,375,321
1,Álava,902,Lantarón,957,530,427
1,Álava,33,Lapuebla de Labarca,866,445,421
1,Álava,36,Laudio/Llodio,18420,9123,9297
1,Álava,58,Legutiano,1644,865,779
1,Álava,34,Leza,236,131,105
1,Álava,39,Moreda de Álava,249,125,124
1,Álava,41,Navaridas,211,111,100
1,Álava,42,Okondo,1116,591,525
1,Álava,43,Oyón-Oion,3246,1655,1591
1,Álava,44,Peñacerrada-Urizaharra,296,173,123
1,Álava,47,Ribera Baja/Erribera Beitia,1303,702,601
1,Álava,51,Salvatierra/Agurain,4867,2470,2397
1,Álava,52,Samaniego,329,176,153
1,Álava,53,San Millán/Donemiliaga,725,405,320
1,Álava,54,Urkabustaiz,1271,677,594
1,Álava,55,Valdegovía/Gaubea,1106,606,500
1,Álava,57,Villabuena de Álava/Eskuernaga,316,159,157
1,Álava,59,Vitoria-Gasteiz,238247,117654,120593
1,Álava,60,Yécora/Iekora,286,152,134
1,Álava,61,Zalduondo,193,106,87
1,Álava,62,Zambrana,383,209,174
1,Álava,18,Zigoitia,1694,904,790
1,Álava,63,Zuia,2401,1239,1162
2,Albacete,1,Abengibre,932,475,457
2,Albacete,2,Alatoz,599,331,268
2,Albacete,3,Albacete,170475,84051,86424
2,Albacete,4,Albatana,812,416,396
2,Albacete,5,Alborea,883,451,432
2,Albacete,6,Alcadozo,737,384,353
2,Albacete,7,Alcalá del Júcar,1381,736,645
2,Albacete,8,Alcaraz,1642,818,824
2,Albacete,9,Almansa,25654,12726,12928
2,Albacete,10,Alpera,2414,1239,1175
2,Albacete,11,Ayna,808,433,375
2,Albacete,12,Balazote,2448,1262,1186
2,Albacete,14,Ballestero (El),479,241,238
2,Albacete,13,Balsa de Ves,209,104,105
2,Albacete,15,Barrax,2053,1057,996
2,Albacete,16,Bienservida,743,379,364
2,Albacete,17,Bogarra,1015,528,487
2,Albacete,18,Bonete,1217,617,600
2,Albacete,19,Bonillo (El),3052,1547,1505
2,Albacete,20,Carcelén,645,337,308
2,Albacete,21,Casas de Juan Núñez,1410,724,686
2,Albacete,22,Casas de Lázaro,453,248,205
2,Albacete,23,Casas de Ves,787,419,368
2,Albacete,24,Casas-Ibáñez,4761,2472,2289
2,Albacete,25,Caudete,10450,5308,5142
2,Albacete,26,Cenizate,1316,692,624
2,Albacete,29,Chinchilla de Monte-Aragón,3924,2061,1863
2,Albacete,27,Corral-Rubio,409,205,204
2,Albacete,28,Cotillas,161,86,75
2,Albacete,30,Elche de la Sierra,3944,1969,1975
2,Albacete,31,Férez,755,373,382
2,Albacete,32,Fuensanta,366,201,165
2,Albacete,33,Fuente-Álamo,2673,1408,1265
2,Albacete,34,Fuentealbilla,2067,1057,1010
2,Albacete,35,Gineta (La),2494,1291,1203
2,Albacete,36,Golosalvo,123,60,63
2,Albacete,37,Hellín,31109,15593,15516
2,Albacete,38,Herrera (La),346,177,169
2,Albacete,39,Higueruela,1284,652,632
2,Albacete,40,Hoya-Gonzalo,710,364,346
2,Albacete,41,Jorquera,457,237,220
2,Albacete,42,Letur,1076,531,545
2,Albacete,43,Lezuza,1620,816,804
2,Albacete,44,Liétor,1440,732,708
2,Albacete,45,Madrigueras,4917,2512,2405
2,Albacete,46,Mahora,1412,707,705
2,Albacete,47,Masegoso,90,49,41
2,Albacete,48,Minaya,1725,883,842
2,Albacete,49,Molinicos,1060,539,521
2,Albacete,50,Montalvos,132,71,61
2,Albacete,51,Montealegre del Castillo,2301,1190,1111
2,Albacete,52,Motilleja,573,287,286
2,Albacete,53,Munera,3814,1923,1891
2,Albacete,54,Navas de Jorquera,551,287,264
2,Albacete,55,Nerpio,1499,812,687
2,Albacete,56,Ontur,2318,1154,1164
2,Albacete,57,Ossa de Montiel,2666,1327,1339
2,Albacete,58,Paterna del Madera,462,242,220
2,Albacete,60,Peñas de San Pedro,1311,735,576
2,Albacete,59,Peñascosa,384,194,190
2,Albacete,61,Pétrola,777,404,373
2,Albacete,62,Povedilla,581,310,271
2,Albacete,901,Pozo Cañada,2885,1455,1430
2,Albacete,63,Pozohondo,1792,946,846
2,Albacete,64,Pozo-Lorente,469,240,229
2,Albacete,65,Pozuelo,587,308,279
2,Albacete,66,Recueja (La),309,156,153
2,Albacete,67,Riópar,1486,759,727
2,Albacete,68,Robledo,476,243,233
2,Albacete,69,Roda (La),16299,8289,8010
2,Albacete,70,Salobre,607,320,287
2,Albacete,71,San Pedro,1272,658,614
2,Albacete,72,Socovos,2001,1025,976
2,Albacete,73,Tarazona de la Mancha,6746,3408,3338
2,Albacete,74,Tobarra,8207,4161,4046
2,Albacete,75,Valdeganga,1933,982,951
2,Albacete,76,Vianos,412,206,206
2,Albacete,77,Villa de Ves,58,29,29
2,Albacete,78,Villalgordo del Júcar,1276,665,611
2,Albacete,79,Villamalea,4024,2045,1979
2,Albacete,80,Villapalacios,706,364,342
2,Albacete,81,Villarrobledo,26686,13358,13328
2,Albacete,82,Villatoya,135,69,66
2,Albacete,83,Villavaliente,269,149,120
2,Albacete,84,Villaverde de Guadalimar,425,226,199
2,Albacete,85,Viveros,385,198,187
2,Albacete,86,Yeste,3331,1703,1628
3,Alicante/Alacant,1,Adsubia,695,358,337
3,Alicante/Alacant,2,Agost,4818,2435,2383
3,Alicante/Alacant,3,Agres,599,315,284
3,Alicante/Alacant,4,Aigües,1084,562,522
3,Alicante/Alacant,5,Albatera,11821,6080,5741
3,Alicante/Alacant,6,Alcalalí,1524,772,752
3,Alicante/Alacant,7,Alcocer de Planes,230,109,121
3,Alicante/Alacant,8,Alcoleja,201,103,98
3,Alicante/Alacant,9,Alcoy/Alcoi,61417,29832,31585
3,Alicante/Alacant,10,Alfafara,419,208,211
3,Alicante/Alacant,11,Alfàs del Pi (l'),21332,10666,10666
3,Alicante/Alacant,12,Algorfa,4537,2248,2289
3,Alicante/Alacant,13,Algueña,1530,770,760
3,Alicante/Alacant,14,Alicante/Alacant,334418,162467,171951
3,Alicante/Alacant,15,Almoradí,19598,9979,9619
3,Alicante/Alacant,16,Almudaina,132,70,62
3,Alicante/Alacant,17,Alqueria d'Asnar (l'),494,228,266
3,Alicante/Alacant,18,Altea,24006,11939,12067
3,Alicante/Alacant,19,Aspe,20360,10288,10072
3,Alicante/Alacant,20,Balones,156,77,79
3,Alicante/Alacant,21,Banyeres de Mariola,7229,3608,3621
3,Alicante/Alacant,22,Benasau,171,83,88
3,Alicante/Alacant,23,Beneixama,1820,918,902
3,Alicante/Alacant,24,Benejúzar,5474,2727,2747
3,Alicante/Alacant,25,Benferri,1892,986,906
3,Alicante/Alacant,26,Beniarbeig,1888,942,946
3,Alicante/Alacant,27,Beniardá,230,124,106
3,Alicante/Alacant,28,Beniarrés,1317,657,660
3,Alicante/Alacant,30,Benidoleig,1261,615,646
3,Alicante/Alacant,31,Benidorm,71198,35855,35343
3,Alicante/Alacant,32,Benifallim,114,58,56
3,Alicante/Alacant,33,Benifato,199,104,95
3,Alicante/Alacant,29,Benigembla,580,295,285
3,Alicante/Alacant,34,Benijófar,4004,1982,2022
3,Alicante/Alacant,35,Benilloba,821,406,415
3,Alicante/Alacant,36,Benillup,98,44,54
3,Alicante/Alacant,37,Benimantell,514,246,268
3,Alicante/Alacant,38,Benimarfull,414,210,204
3,Alicante/Alacant,39,Benimassot,129,72,57
3,Alicante/Alacant,40,Benimeli,413,203,210
3,Alicante/Alacant,41,Benissa,13369,6719,6650
3,Alicante/Alacant,42,Benitachell/Poble Nou de Benitatxell (el),5488,2751,2737
3,Alicante/Alacant,43,Biar,3703,1813,1890
3,Alicante/Alacant,44,Bigastro,6757,3454,3303
3,Alicante/Alacant,45,Bolulla,423,219,204
3,Alicante/Alacant,46,Busot,3257,1628,1629
3,Alicante/Alacant,49,Callosa de Segura,18008,9126,8882
3,Alicante/Alacant,48,Callosa d'En Sarrià,7888,4076,3812
3,Alicante/Alacant,47,Calp,29909,15246,14663
3,Alicante/Alacant,50,Campello (el),26941,13381,13560
3,Alicante/Alacant,51,Campo de Mirra/Camp de Mirra (el),420,209,211
3,Alicante/Alacant,52,Cañada,1238,606,632
3,Alicante/Alacant,53,Castalla,10513,5314,5199
3,Alicante/Alacant,54,Castell de Castells,493,246,247
3,Alicante/Alacant,75,Castell de Guadalest (el),246,125,121
3,Alicante/Alacant,55,Catral,8926,4551,4375
3,Alicante/Alacant,56,Cocentaina,11534,5796,5738
3,Alicante/Alacant,57,Confrides,276,159,117
3,Alicante/Alacant,58,Cox,6957,3563,3394
3,Alicante/Alacant,59,Crevillent,28738,14719,14019
3,Alicante/Alacant,61,Daya Nueva,1938,976,962
3,Alicante/Alacant,62,Daya Vieja,696,352,344
3,Alicante/Alacant,63,Dénia,44498,22060,22438
3,Alicante/Alacant,64,Dolores,7392,3680,3712
3,Alicante/Alacant,65,Elche/Elx,230822,115537,115285
3,Alicante/Alacant,66,Elda,54815,26881,27934
3,Alicante/Alacant,67,Facheca,107,55,52
3,Alicante/Alacant,68,Famorca,38,17,21
3,Alicante/Alacant,69,Finestrat,6386,3253,3133
3,Alicante/Alacant,77,Fondó de les Neus (el)/Hondón de las Nieves,2948,1517,1431
3,Alicante/Alacant,70,Formentera del Segura,4364,2247,2117
3,Alicante/Alacant,72,Gaianes,443,226,217
3,Alicante/Alacant,71,Gata de Gorgos,6292,3213,3079
3,Alicante/Alacant,73,Gorga,256,137,119
3,Alicante/Alacant,74,Granja de Rocamora,2372,1241,1131
3,Alicante/Alacant,76,Guardamar del Segura,16423,8269,8154
3,Alicante/Alacant,78,Hondón de los Frailes,1202,631,571
3,Alicante/Alacant,79,Ibi,23861,11984,11877
3,Alicante/Alacant,80,Jacarilla,2100,1048,1052
3,Alicante/Alacant,82,Jávea/Xàbia,31909,15989,15920
3,Alicante/Alacant,83,Jijona/Xixona,7407,3590,3817
3,Alicante/Alacant,85,Llíber,1056,527,529
3,Alicante/Alacant,84,Lorcha/Orxa (l'),715,358,357
3,Alicante/Alacant,86,Millena,209,105,104
3,Alicante/Alacant,88,Monforte del Cid,7606,3998,3608
3,Alicante/Alacant,89,Monóvar/Monòver,12928,6436,6492
3,Alicante/Alacant,903,Montesinos (Los),5147,2600,2547
3,Alicante/Alacant,91,Murla,629,301,328
3,Alicante/Alacant,92,Muro de Alcoy,8961,4460,4501
3,Alicante/Alacant,90,Mutxamel,23066,11597,11469
3,Alicante/Alacant,93,Novelda,27104,13535,13569
3,Alicante/Alacant,94,Nucia (la),18225,9270,8955
3,Alicante/Alacant,95,Ondara,6570,3284,3286
3,Alicante/Alacant,96,Onil,7723,3896,3827
3,Alicante/Alacant,97,Orba,2629,1309,1320
3,Alicante/Alacant,99,Orihuela,87113,43833,43280
3,Alicante/Alacant,98,Orxeta,875,446,429
3,Alicante/Alacant,100,Parcent,1085,535,550
3,Alicante/Alacant,101,Pedreguer,7603,3777,3826
3,Alicante/Alacant,102,Pego,11208,5734,5474
3,Alicante/Alacant,103,Penàguila,324,172,152
3,Alicante/Alacant,104,Petrer,34634,17281,17353
3,Alicante/Alacant,902,Pilar de la Horadada,22555,11684,10871
3,Alicante/Alacant,105,Pinós (el)/Pinoso,7909,4028,3881
3,Alicante/Alacant,106,Planes,850,436,414
3,Alicante/Alacant,901,Poblets (els),3310,1588,1722
3,Alicante/Alacant,107,Polop,4294,2193,2101
3,Alicante/Alacant,60,Quatretondeta,122,59,63
3,Alicante/Alacant,109,Rafal,4181,2136,2045
3,Alicante/Alacant,110,"Ràfol d'Almúnia, el",726,357,369
3,Alicante/Alacant,111,Redován,7467,3847,3620
3,Alicante/Alacant,112,Relleu,1279,648,631
3,Alicante/Alacant,113,Rojales,20953,10723,10230
3,Alicante/Alacant,114,Romana (la),2602,1356,1246
3,Alicante/Alacant,115,Sagra,465,240,225
3,Alicante/Alacant,116,Salinas,1549,796,753
3,Alicante/Alacant,118,San Fulgencio,12144,6139,6005
3,Alicante/Alacant,904,San Isidro,1874,966,908
3,Alicante/Alacant,120,San Miguel de Salinas,8057,4068,3989
3,Alicante/Alacant,122,San Vicente del Raspeig/Sant Vicent del Raspeig,54088,26900,27188
3,Alicante/Alacant,117,Sanet y Negrals,727,355,372
3,Alicante/Alacant,119,Sant Joan d'Alacant,22138,10774,11364
3,Alicante/Alacant,121,Santa Pola,32507,16476,16031
3,Alicante/Alacant,123,Sax,10099,5106,4993
3,Alicante/Alacant,124,Sella,649,343,306
3,Alicante/Alacant,125,Senija,661,340,321
3,Alicante/Alacant,127,Tàrbena,801,412,389
3,Alicante/Alacant,128,Teulada,14778,7471,7307
3,Alicante/Alacant,129,Tibi,1745,914,831
3,Alicante/Alacant,130,Tollos,57,26,31
3,Alicante/Alacant,131,Tormos,380,193,187
3,Alicante/Alacant,132,Torremanzanas/Torre de les Maçanes (la),788,412,376
3,Alicante/Alacant,133,Torrevieja,101091,51161,49930
3,Alicante/Alacant,134,Vall d'Alcalà (la),185,95,90
3,Alicante/Alacant,136,Vall de Gallinera,662,345,317
3,Alicante/Alacant,137,Vall de Laguar (la),981,464,517
3,Alicante/Alacant,135,Vall d'Ebo (la),272,139,133
3,Alicante/Alacant,138,Verger (el),4858,2501,2357
3,Alicante/Alacant,139,Villajoyosa/Vila Joiosa (la),34344,17240,17104
3,Alicante/Alacant,140,Villena,34968,17449,17519
3,Alicante/Alacant,81,Xaló,3269,1654,1615
4,Almería,1,Abla,1463,760,703
4,Almería,2,Abrucena,1367,699,668
4,Almería,3,Adra,24512,12420,12092
4,Almería,4,Albánchez,814,421,393
4,Almería,5,Alboloduy,667,332,335
4,Almería,6,Albox,11042,5627,5415
4,Almería,7,Alcolea,902,487,415
4,Almería,8,Alcóntar,598,318,280
4,Almería,9,Alcudia de Monteagud,144,70,74
4,Almería,10,Alhabia,718,366,352
4,Almería,11,Alhama de Almería,3824,1931,1893
4,Almería,12,Alicún,253,133,120
4,Almería,13,Almería,190013,92733,97280
4,Almería,14,Almócita,185,93,92
4,Almería,15,Alsodux,149,80,69
4,Almería,16,Antas,3389,1706,1683
4,Almería,17,Arboleas,4731,2369,2362
4,Almería,18,Armuña de Almanzora,339,169,170
4,Almería,19,Bacares,274,145,129
4,Almería,20,Bayárcal,358,193,165
4,Almería,21,Bayarque,233,116,117
4,Almería,22,Bédar,1039,533,506
4,Almería,23,Beires,121,60,61
4,Almería,24,Benahadux,4059,2044,2015
4,Almería,26,Benitagla,84,47,37
4,Almería,27,Benizalón,286,143,143
4,Almería,28,Bentarique,280,156,124
4,Almería,29,Berja,15325,7740,7585
4,Almería,30,Canjáyar,1490,761,729
4,Almería,31,Cantoria,4001,2051,1950
4,Almería,32,Carboneras,8123,4213,3910
4,Almería,33,Castro de Filabres,154,78,76
4,Almería,36,Chercos,287,145,142
4,Almería,37,Chirivel,1852,942,910
4,Almería,34,Cóbdar,165,87,78
4,Almería,35,Cuevas del Almanzora,12891,6751,6140
4,Almería,38,Dalías,3983,1975,2008
4,Almería,902,Ejido (El),85389,47403,37986
4,Almería,41,Enix,469,263,206
4,Almería,43,Felix,643,345,298
4,Almería,44,Fines,2434,1300,1134
4,Almería,45,Fiñana,2432,1221,1211
4,Almería,46,Fondón,989,513,476
4,Almería,47,Gádor,3225,1678,1547
4,Almería,48,Gallardos (Los),3828,1983,1845
4,Almería,49,Garrucha,8441,4389,4052
4,Almería,50,Gérgal,1099,568,531
4,Almería,51,Huécija,543,267,276
4,Almería,52,Huércal de Almería,15628,7997,7631
4,Almería,53,Huércal-Overa,18278,9123,9155
4,Almería,54,Illar,421,225,196
4,Almería,55,Instinción,485,229,256
4,Almería,56,Laroya,164,89,75
4,Almería,57,Láujar de Andarax,1799,895,904
4,Almería,58,Líjar,514,274,240
4,Almería,59,Lubrín,1764,869,895
4,Almería,60,Lucainena de las Torres,671,364,307
4,Almería,61,Lúcar,885,442,443
4,Almería,62,Macael,6120,3156,2964
4,Almería,63,María,1455,740,715
4,Almería,64,Mojácar,7745,3884,3861
4,Almería,903,Mojonera (La),8540,4725,3815
4,Almería,65,Nacimiento,486,257,229
4,Almería,66,Níjar,28242,15694,12548
4,Almería,67,Ohanes,761,377,384
4,Almería,68,Olula de Castro,209,106,103
4,Almería,69,Olula del Río,6733,3487,3246
4,Almería,70,Oria,2888,1507,1381
4,Almería,71,Padules,502,257,245
4,Almería,72,Partaloa,898,449,449
4,Almería,73,Paterna del Río,449,250,199
4,Almería,74,Pechina,3720,1882,1838
4,Almería,75,Pulpí,8429,4468,3961
4,Almería,76,Purchena,1772,901,871
4,Almería,77,Rágol,356,186,170
4,Almería,78,Rioja,1361,689,672
4,Almería,79,Roquetas de Mar,85808,45037,40771
4,Almería,80,Santa Cruz de Marchena,240,125,115
4,Almería,81,Santa Fe de Mondújar,489,250,239
4,Almería,82,Senés,338,174,164
4,Almería,83,Serón,2385,1193,1192
4,Almería,84,Sierro,460,230,230
4,Almería,85,Somontín,525,265,260
4,Almería,86,Sorbas,2905,1542,1363
4,Almería,87,Suflí,262,135,127
4,Almería,88,Tabernas,3626,1884,1742
4,Almería,89,Taberno,1149,569,580
4,Almería,90,Tahal,431,223,208
4,Almería,91,Terque,464,231,233
4,Almería,92,Tíjola,3955,1992,1963
4,Almería,901,Tres Villas (Las),655,344,311
4,Almería,93,Turre,3791,1963,1828
4,Almería,94,Turrillas,233,130,103
4,Almería,95,Uleila del Campo,1015,532,483
4,Almería,96,Urrácal,348,167,181
4,Almería,97,Velefique,295,161,134
4,Almería,98,Vélez-Blanco,2282,1203,1079
4,Almería,99,Vélez-Rubio,7138,3475,3663
4,Almería,100,Vera,14371,7376,6995
4,Almería,101,Viator,5043,2549,2494
4,Almería,102,Vícar,23410,12494,10916
4,Almería,103,Zurgena,3060,1522,1538
33,Asturias,1,Allande,2031,1035,996
33,Asturias,2,Aller,12582,6190,6392
33,Asturias,3,Amieva,805,426,379
33,Asturias,4,Avilés,84202,40352,43850
33,Asturias,5,Belmonte de Miranda,1751,894,857
33,Asturias,6,Bimenes,1894,903,991
33,Asturias,7,Boal,1928,957,971
33,Asturias,8,Cabrales,2253,1154,1099
33,Asturias,9,Cabranes,1080,556,524
33,Asturias,10,Candamo,2160,1062,1098
33,Asturias,12,Cangas de Onís,6756,3321,3435
33,Asturias,11,Cangas del Narcea,14445,7219,7226
33,Asturias,13,Caravia,533,270,263
33,Asturias,14,Carreño,11000,5370,5630
33,Asturias,15,Caso,1848,1019,829
33,Asturias,16,Castrillón,22832,11150,11682
33,Asturias,17,Castropol,3807,1827,1980
33,Asturias,18,Coaña,3464,1677,1787
33,Asturias,19,Colunga,3778,1855,1923
33,Asturias,20,Corvera de Asturias,16109,7969,8140
33,Asturias,21,Cudillero,5763,2834,2929
33,Asturias,22,Degaña,1223,644,579
33,Asturias,23,Franco (El),4046,2012,2034
33,Asturias,24,Gijón,277198,131217,145981
33,Asturias,25,Gozón,10788,5272,5516
33,Asturias,26,Grado,11003,5339,5664
33,Asturias,27,Grandas de Salime,1036,534,502
33,Asturias,28,Ibias,1698,914,784
33,Asturias,29,Illano,465,246,219
33,Asturias,30,Illas,1004,518,486
33,Asturias,31,Langreo,45397,21661,23736
33,Asturias,32,Laviana,14160,6851,7309
33,Asturias,33,Lena,12705,6173,6532
33,Asturias,35,Llanera,13919,6884,7035
33,Asturias,36,Llanes,13950,6789,7161
33,Asturias,37,Mieres,43688,20761,22927
33,Asturias,38,Morcín,2921,1458,1463
33,Asturias,39,Muros de Nalón,1959,927,1032
33,Asturias,40,Nava,5635,2785,2850
33,Asturias,41,Navia,9085,4443,4642
33,Asturias,42,Noreña,5470,2666,2804
33,Asturias,43,Onís,797,413,384
33,Asturias,44,Oviedo,225155,105251,119904
33,Asturias,45,Parres,5804,2847,2957
33,Asturias,46,Peñamellera Alta,607,307,300
33,Asturias,47,Peñamellera Baja,1326,660,666
33,Asturias,48,Pesoz,184,88,96
33,Asturias,49,Piloña,7994,3923,4071
33,Asturias,50,Ponga,678,404,274
33,Asturias,51,Pravia,9012,4382,4630
33,Asturias,52,Proaza,814,450,364
33,Asturias,53,Quirós,1341,749,592
33,Asturias,54,Regueras (Las),2003,997,1006
33,Asturias,55,Ribadedeva,1865,917,948
33,Asturias,56,Ribadesella,6301,3001,3300
33,Asturias,57,Ribera de Arriba,1989,1020,969
33,Asturias,58,Riosa,2187,1102,1085
33,Asturias,59,Salas,5886,2936,2950
33,Asturias,61,San Martín de Oscos,433,215,218
33,Asturias,60,San Martín del Rey Aurelio,18549,8952,9597
33,Asturias,63,San Tirso de Abres,542,259,283
33,Asturias,62,Santa Eulalia de Oscos,501,261,240
33,Asturias,64,Santo Adriano,248,129,119
33,Asturias,65,Sariego,1322,632,690
33,Asturias,66,Siero,51730,25286,26444
33,Asturias,67,Sobrescobio,898,465,433
33,Asturias,68,Somiedo,1410,788,622
33,Asturias,69,Soto del Barco,4056,1985,2071
33,Asturias,70,Tapia de Casariego,4121,1990,2131
33,Asturias,71,Taramundi,733,359,374
33,Asturias,72,Teverga,1932,1012,920
33,Asturias,73,Tineo,11018,5557,5461
33,Asturias,34,Valdés,13371,6517,6854
33,Asturias,74,Vegadeo,4222,2060,2162
33,Asturias,75,Villanueva de Oscos,388,194,194
33,Asturias,76,Villaviciosa,14840,7294,7546
33,Asturias,77,Villayón,1543,777,766
33,Asturias,78,Yernes y Tameza,170,89,81
5,Ávila,1,Adanero,283,145,138
5,Ávila,2,Adrada (La),2702,1408,1294
5,Ávila,5,Albornos,235,126,109
5,Ávila,7,Aldeanueva de Santa Cruz,146,83,63
5,Ávila,8,Aldeaseca,251,119,132
5,Ávila,10,Aldehuela (La),199,96,103
5,Ávila,12,Amavida,177,88,89
5,Ávila,13,Arenal (El),1017,511,506
5,Ávila,14,Arenas de San Pedro,6816,3331,3485
5,Ávila,15,Arevalillo,117,57,60
5,Ávila,16,Arévalo,8114,3945,4169
5,Ávila,17,Aveinte,100,55,45
5,Ávila,18,Avellaneda,26,14,12
5,Ávila,19,Ávila,58245,28077,30168
5,Ávila,21,Barco de Ávila (El),2771,1350,1421
5,Ávila,22,Barraco (El),2101,1070,1031
5,Ávila,23,Barromán,217,114,103
5,Ávila,24,Becedas,286,149,137
5,Ávila,25,Becedillas,122,65,57
5,Ávila,26,Bercial de Zapardiel,254,126,128
5,Ávila,27,Berlanas (Las),369,189,180
5,Ávila,29,Bernuy-Zapardiel,145,84,61
5,Ávila,30,Berrocalejo de Aragona,50,28,22
5,Ávila,33,Blascomillán,223,112,111
5,Ávila,34,Blasconuño de Matacabras,18,10,8
5,Ávila,35,Blascosancho,124,59,65
5,Ávila,36,Bohodón (El),152,81,71
5,Ávila,37,Bohoyo,339,177,162
5,Ávila,38,Bonilla de la Sierra,132,73,59
5,Ávila,39,Brabos,58,32,26
5,Ávila,40,Bularros,85,50,35
5,Ávila,41,Burgohondo,1279,666,613
5,Ávila,42,Cabezas de Alambre,182,94,88
5,Ávila,43,Cabezas del Pozo,95,50,45
5,Ávila,44,Cabezas del Villar,342,191,151
5,Ávila,45,Cabizuela,117,58,59
5,Ávila,46,Canales,53,29,24
5,Ávila,47,Candeleda,5221,2696,2525
5,Ávila,48,Cantiveros,146,75,71
5,Ávila,49,Cardeñosa,525,274,251
5,Ávila,51,Carrera (La),212,113,99
5,Ávila,52,Casas del Puerto,115,58,57
5,Ávila,53,Casasola,101,51,50
5,Ávila,54,Casavieja,1568,796,772
5,Ávila,55,Casillas,850,446,404
5,Ávila,56,Castellanos de Zapardiel,103,54,49
5,Ávila,57,Cebreros,3444,1772,1672
5,Ávila,58,Cepeda la Mora,96,47,49
5,Ávila,67,Chamartín,89,52,37
5,Ávila,59,Cillán,119,71,48
5,Ávila,60,Cisla,150,74,76
5,Ávila,61,Colilla (La),325,164,161
5,Ávila,62,Collado de Contreras,215,114,101
5,Ávila,63,Collado del Mirón,43,23,20
5,Ávila,64,Constanzana,123,73,50
5,Ávila,65,Crespos,571,306,265
5,Ávila,66,Cuevas del Valle,537,293,244
5,Ávila,903,Diego del Carpio,185,102,83
5,Ávila,69,Donjimeno,103,60,43
5,Ávila,70,Donvidas,44,25,19
5,Ávila,72,Espinosa de los Caballeros,111,65,46
5,Ávila,73,Flores de Ávila,362,195,167
5,Ávila,74,Fontiveros,856,452,404
5,Ávila,75,Fresnedilla,116,56,60
5,Ávila,76,Fresno (El),546,281,265
5,Ávila,77,Fuente el Saúz,252,134,118
5,Ávila,78,Fuentes de Año,153,85,68
5,Ávila,79,Gallegos de Altamiros,61,39,22
5,Ávila,80,Gallegos de Sobrinos,77,36,41
5,Ávila,81,Garganta del Villar,49,32,17
5,Ávila,82,Gavilanes,629,330,299
5,Ávila,83,Gemuño,166,80,86
5,Ávila,85,Gil García,39,20,19
5,Ávila,84,Gilbuena,88,53,35
5,Ávila,86,Gimialcón,97,55,42
5,Ávila,87,Gotarrendura,174,64,110
5,Ávila,88,Grandes y San Martín,36,21,15
5,Ávila,89,Guisando,596,302,294
5,Ávila,90,Gutierre-Muñoz,94,48,46
5,Ávila,92,Hernansancho,202,109,93
5,Ávila,93,Herradón de Pinares,549,305,244
5,Ávila,94,Herreros de Suso,171,89,82
5,Ávila,95,Higuera de las Dueñas,329,185,144
5,Ávila,96,Hija de Dios (La),75,42,33
5,Ávila,97,Horcajada (La),581,298,283
5,Ávila,99,Horcajo de las Torres,619,350,269
5,Ávila,100,Hornillo (El),355,188,167
5,Ávila,102,Hoyo de Pinares (El),2326,1228,1098
5,Ávila,101,Hoyocasero,332,176,156
5,Ávila,103,Hoyorredondo,87,51,36
5,Ávila,106,Hoyos de Miguel Muñoz,40,20,20
5,Ávila,104,Hoyos del Collado,37,22,15
5,Ávila,105,Hoyos del Espino,452,250,202
5,Ávila,107,Hurtumpascual,79,49,30
5,Ávila,108,Junciana,76,42,34
5,Ávila,109,Langa,539,270,269
5,Ávila,110,Lanzahíta,946,510,436
5,Ávila,113,Llanos de Tormes (Los),88,45,43
5,Ávila,112,Losar del Barco (El),131,68,63
5,Ávila,114,Madrigal de las Altas Torres,1680,853,827
5,Ávila,115,Maello,714,369,345
5,Ávila,116,Malpartida de Corneja,142,70,72
5,Ávila,117,Mamblas,228,122,106
5,Ávila,118,Mancera de Arriba,100,53,47
5,Ávila,119,Manjabálago,43,25,18
5,Ávila,120,Marlín,39,22,17
5,Ávila,121,Martiherrero,297,149,148
5,Ávila,122,Martínez,162,86,76
5,Ávila,123,Mediana de Voltoya,109,53,56
5,Ávila,124,Medinilla,144,69,75
5,Ávila,125,Mengamuñoz,66,30,36
5,Ávila,126,Mesegar de Corneja,78,43,35
5,Ávila,127,Mijares,818,435,383
5,Ávila,128,Mingorría,437,224,213
5,Ávila,129,Mirón (El),166,100,66
5,Ávila,130,Mironcillo,112,62,50
5,Ávila,131,Mirueña de los Infanzones,125,66,59
5,Ávila,132,Mombeltrán,1161,589,572
5,Ávila,133,Monsalupe,58,29,29
5,Ávila,134,Moraleja de Matacabras,50,26,24
5,Ávila,135,Muñana,511,266,245
5,Ávila,136,Muñico,123,62,61
5,Ávila,138,Muñogalindo,400,218,182
5,Ávila,139,Muñogrande,77,41,36
5,Ávila,140,Muñomer del Peco,147,78,69
5,Ávila,141,Muñopepe,101,60,41
5,Ávila,142,Muñosancho,121,61,60
5,Ávila,143,Muñotello,89,49,40
5,Ávila,144,Narrillos del Álamo,101,53,48
5,Ávila,145,Narrillos del Rebollar,51,28,23
5,Ávila,149,Narros de Saldueña,138,76,62
5,Ávila,147,Narros del Castillo,181,99,82
5,Ávila,148,Narros del Puerto,41,23,18
5,Ávila,152,Nava de Arévalo,870,464,406
5,Ávila,153,Nava del Barco,121,62,59
5,Ávila,151,Navacepedilla de Corneja,106,56,50
5,Ávila,154,Navadijos,57,37,20
5,Ávila,155,Navaescurial,59,36,23
5,Ávila,156,Navahondilla,325,188,137
5,Ávila,157,Navalacruz,272,136,136
5,Ávila,158,Navalmoral,438,228,210
5,Ávila,159,Navalonguilla,316,166,150
5,Ávila,160,Navalosa,376,206,170
5,Ávila,161,Navalperal de Pinares,1048,551,497
5,Ávila,162,Navalperal de Tormes,113,63,50
5,Ávila,163,Navaluenga,2207,1117,1090
5,Ávila,164,Navaquesera,32,15,17
5,Ávila,165,Navarredonda de Gredos,485,249,236
5,Ávila,166,Navarredondilla,253,129,124
5,Ávila,167,Navarrevisca,333,184,149
5,Ávila,168,Navas del Marqués (Las),5770,2960,2810
5,Ávila,169,Navatalgordo,266,137,129
5,Ávila,170,Navatejares,80,35,45
5,Ávila,171,Neila de San Miguel,90,47,43
5,Ávila,172,Niharra,154,79,75
5,Ávila,173,Ojos-Albos,59,35,24
5,Ávila,174,Orbita,101,53,48
5,Ávila,175,Oso (El),212,122,90
5,Ávila,176,Padiernos,256,135,121
5,Ávila,177,Pajares de Adaja,194,97,97
5,Ávila,178,Palacios de Goda,449,232,217
5,Ávila,179,Papatrigo,269,140,129
5,Ávila,180,Parral (El),115,64,51
5,Ávila,181,Pascualcobo,40,19,21
5,Ávila,182,Pedro Bernardo,1013,540,473
5,Ávila,183,Pedro-Rodríguez,211,104,107
5,Ávila,184,Peguerinos,323,175,148
5,Ávila,185,Peñalba de Ávila,127,73,54
5,Ávila,186,Piedrahíta,2073,991,1082
5,Ávila,187,Piedralaves,2194,1133,1061
5,Ávila,188,Poveda,66,40,26
5,Ávila,189,Poyales del Hoyo,620,334,286
5,Ávila,190,Pozanco,65,40,25
5,Ávila,191,Pradosegar,157,86,71
5,Ávila,192,Puerto Castilla,113,68,45
5,Ávila,193,Rasueros,250,143,107
5,Ávila,194,Riocabado,184,101,83
5,Ávila,195,Riofrío,252,146,106
5,Ávila,196,Rivilla de Barajas,78,33,45
5,Ávila,197,Salobral,124,62,62
5,Ávila,198,Salvadiós,93,48,45
5,Ávila,199,San Bartolomé de Béjar,45,23,22
5,Ávila,200,San Bartolomé de Corneja,65,32,33
5,Ávila,201,San Bartolomé de Pinares,634,331,303
5,Ávila,206,San Esteban de los Patos,26,13,13
5,Ávila,208,San Esteban de Zapardiel,57,32,25
5,Ávila,207,San Esteban del Valle,846,440,406
5,Ávila,209,San García de Ingelmos,113,64,49
5,Ávila,901,San Juan de Gredos,354,199,155
5,Ávila,210,San Juan de la Encinilla,102,52,50
5,Ávila,211,San Juan de la Nava,513,266,247
5,Ávila,212,San Juan del Molinillo,300,166,134
5,Ávila,213,San Juan del Olmo,126,78,48
5,Ávila,214,San Lorenzo de Tormes,59,31,28
5,Ávila,215,San Martín de la Vega del Alberche,210,123,87
5,Ávila,216,San Martín del Pimpollar,235,134,101
5,Ávila,217,San Miguel de Corneja,81,40,41
5,Ávila,218,San Miguel de Serrezuela,162,90,72
5,Ávila,219,San Pascual,49,32,17
5,Ávila,220,San Pedro del Arroyo,509,271,238
5,Ávila,231,San Vicente de Arévalo,203,108,95
5,Ávila,204,Sanchidrián,856,438,418
5,Ávila,205,Sanchorreja,100,45,55
5,Ávila,222,Santa Cruz de Pinares,184,100,84
5,Ávila,221,Santa Cruz del Valle,469,242,227
5,Ávila,226,Santa María de los Caballeros,98,53,45
5,Ávila,224,Santa María del Arroyo,105,57,48
5,Ávila,225,Santa María del Berrocal,482,243,239
5,Ávila,902,Santa María del Cubillo,340,197,143
5,Ávila,227,Santa María del Tiétar,619,331,288
5,Ávila,228,Santiago del Collado,209,131,78
5,Ávila,904,Santiago del Tormes,162,87,75
5,Ávila,229,Santo Domingo de las Posadas,101,51,50
5,Ávila,230,Santo Tomé de Zabarcos,104,56,48
5,Ávila,232,Serrada (La),126,65,61
5,Ávila,233,Serranillos,288,160,128
5,Ávila,234,Sigeres,62,31,31
5,Ávila,235,Sinlabajos,147,76,71
5,Ávila,236,Solana de Ávila,145,78,67
5,Ávila,237,Solana de Rioalmar,230,122,108
5,Ávila,238,Solosancho,953,495,458
5,Ávila,239,Sotalbo,262,142,120
5,Ávila,240,Sotillo de la Adrada,4775,2423,2352
5,Ávila,241,Tiemblo (El),4302,2203,2099
5,Ávila,242,Tiñosillos,841,428,413
5,Ávila,243,Tolbaños,123,63,60
5,Ávila,244,Tormellas,71,37,34
5,Ávila,245,Tornadizos de Ávila,414,204,210
5,Ávila,247,Torre (La),279,153,126
5,Ávila,246,Tórtoles,82,44,38
5,Ávila,249,Umbrías,132,66,66
5,Ávila,251,Vadillo de la Sierra,89,49,40
5,Ávila,252,Valdecasa,75,42,33
5,Ávila,253,Vega de Santa María,98,50,48
5,Ávila,254,Velayos,243,122,121
5,Ávila,256,Villaflor,134,69,65
5,Ávila,257,Villafranca de la Sierra,152,85,67
5,Ávila,905,Villanueva de Ávila,250,120,130
5,Ávila,258,Villanueva de Gómez,151,78,73
5,Ávila,259,Villanueva del Aceral,159,75,84
5,Ávila,260,Villanueva del Campillo,123,68,55
5,Ávila,261,Villar de Corneja,50,27,23
5,Ávila,262,Villarejo del Valle,448,224,224
5,Ávila,263,Villatoro,202,111,91
5,Ávila,264,Viñegra de Moraña,63,36,27
5,Ávila,265,Vita,98,62,36
5,Ávila,266,Zapardiel de la Cañada,120,56,64
5,Ávila,267,Zapardiel de la Ribera,129,64,65
6,Badajoz,1,Acedera,818,423,395
6,Badajoz,2,Aceuchal,5723,2862,2861
6,Badajoz,3,Ahillones,1032,516,516
6,Badajoz,4,Alange,2013,1031,982
6,Badajoz,5,Albuera (La),2030,1042,988
6,Badajoz,6,Alburquerque,5678,2881,2797
6,Badajoz,7,Alconchel,1932,962,970
6,Badajoz,8,Alconera,728,359,369
6,Badajoz,9,Aljucén,242,132,110
6,Badajoz,10,Almendral,1312,641,671
6,Badajoz,11,Almendralejo,33975,17173,16802
6,Badajoz,12,Arroyo de San Serván,4274,2196,2078
6,Badajoz,13,Atalaya,330,170,160
6,Badajoz,14,Azuaga,8303,4122,4181
6,Badajoz,15,Badajoz,150376,73064,77312
6,Badajoz,16,Barcarrota,3709,1888,1821
6,Badajoz,17,Baterno,355,185,170
6,Badajoz,18,Benquerencia de la Serena,938,459,479
6,Badajoz,19,Berlanga,2486,1231,1255
6,Badajoz,20,Bienvenida,2332,1207,1125
6,Badajoz,21,Bodonal de la Sierra,1162,591,571
6,Badajoz,22,Burguillos del Cerro,3314,1644,1670
6,Badajoz,23,Cabeza del Buey,5395,2660,2735
6,Badajoz,24,Cabeza la Vaca,1463,750,713
6,Badajoz,25,Calamonte,6284,3132,3152
6,Badajoz,26,Calera de León,1053,521,532
6,Badajoz,27,Calzadilla de los Barros,845,422,423
6,Badajoz,28,Campanario,5354,2633,2721
6,Badajoz,29,Campillo de Llerena,1485,750,735
6,Badajoz,30,Capilla,179,92,87
6,Badajoz,31,Carmonita,573,291,282
6,Badajoz,32,Carrascalejo (El),93,49,44
6,Badajoz,33,Casas de Don Pedro,1674,850,824
6,Badajoz,34,Casas de Reina,208,98,110
6,Badajoz,35,Castilblanco,1156,575,581
6,Badajoz,36,Castuera,6521,3214,3307
6,Badajoz,42,Cheles,1261,599,662
6,Badajoz,37,Codosera (La),2320,1216,1104
6,Badajoz,38,Cordobilla de Lácara,997,497,500
6,Badajoz,39,Coronada (La),2231,1104,1127
6,Badajoz,40,Corte de Peleas,1316,665,651
6,Badajoz,41,Cristina,561,297,264
6,Badajoz,43,Don Álvaro,766,398,368
6,Badajoz,44,Don Benito,36227,17894,18333
6,Badajoz,45,Entrín Bajo,608,307,301
6,Badajoz,46,Esparragalejo,1573,768,805
6,Badajoz,47,Esparragosa de la Serena,1075,551,524
6,Badajoz,48,Esparragosa de Lares,1031,497,534
6,Badajoz,49,Feria,1320,650,670
6,Badajoz,50,Fregenal de la Sierra,5203,2546,2657
6,Badajoz,51,Fuenlabrada de los Montes,1947,945,1002
6,Badajoz,52,Fuente de Cantos,5048,2480,2568
6,Badajoz,53,Fuente del Arco,763,384,379
6,Badajoz,54,Fuente del Maestre,6946,3482,3464
6,Badajoz,55,Fuentes de León,2542,1261,1281
6,Badajoz,56,Garbayuela,549,293,256
6,Badajoz,57,Garlitos,656,338,318
6,Badajoz,58,Garrovilla (La),2490,1241,1249
6,Badajoz,59,Granja de Torrehermosa,2352,1174,1178
6,Badajoz,60,Guareña,7300,3702,3598
6,Badajoz,61,Haba (La),1351,687,664
6,Badajoz,62,Helechosa de los Montes,721,398,323
6,Badajoz,63,Herrera del Duque,3681,1873,1808
6,Badajoz,64,Higuera de la Serena,1036,538,498
6,Badajoz,65,Higuera de Llerena,365,186,179
6,Badajoz,66,Higuera de Vargas,2128,1081,1047
6,Badajoz,67,Higuera la Real,2483,1254,1229
6,Badajoz,68,Hinojosa del Valle,547,271,276
6,Badajoz,69,Hornachos,3875,1943,1932
6,Badajoz,70,Jerez de los Caballeros,9980,5010,4970
6,Badajoz,71,Lapa (La),295,151,144
6,Badajoz,73,Llera,938,484,454
6,Badajoz,74,Llerena,5982,2975,3007
6,Badajoz,72,Lobón,2797,1447,1350
6,Badajoz,75,Magacela,596,311,285
6,Badajoz,76,Maguilla,1074,534,540
6,Badajoz,77,Malcocinado,449,238,211
6,Badajoz,78,Malpartida de la Serena,662,340,322
6,Badajoz,79,Manchita,760,388,372
6,Badajoz,80,Medellín,2343,1183,1160
6,Badajoz,81,Medina de las Torres,1330,672,658
6,Badajoz,82,Mengabril,475,240,235
6,Badajoz,83,Mérida,57127,27848,29279
6,Badajoz,84,Mirandilla,1376,698,678
6,Badajoz,85,Monesterio,4414,2265,2149
6,Badajoz,86,Montemolín,1511,729,782
6,Badajoz,87,Monterrubio de la Serena,2707,1306,1401
6,Badajoz,88,Montijo,16279,8091,8188
6,Badajoz,89,Morera (La),746,369,377
6,Badajoz,90,Nava de Santiago (La),1072,534,538
6,Badajoz,91,Navalvillar de Pela,4860,2469,2391
6,Badajoz,92,Nogales,719,354,365
6,Badajoz,93,Oliva de la Frontera,5573,2796,2777
6,Badajoz,94,Oliva de Mérida,1850,944,906
6,Badajoz,95,Olivenza,11906,5962,5944
6,Badajoz,96,Orellana de la Sierra,292,162,130
6,Badajoz,97,Orellana la Vieja,3010,1554,1456
6,Badajoz,98,Palomas,692,344,348
6,Badajoz,99,Parra (La),1393,711,682
6,Badajoz,100,Peñalsordo,1180,575,605
6,Badajoz,101,Peraleda del Zaucejo,606,316,290
6,Badajoz,102,Puebla de Alcocer,1261,631,630
6,Badajoz,103,Puebla de la Calzada,5963,2960,3003
6,Badajoz,104,Puebla de la Reina,859,435,424
6,Badajoz,107,Puebla de Obando,1971,989,982
6,Badajoz,108,Puebla de Sancho Pérez,2910,1468,1442
6,Badajoz,105,Puebla del Maestre,775,389,386
6,Badajoz,106,Puebla del Prior,540,274,266
6,Badajoz,902,Pueblonuevo del Guadiana,2047,1042,1005
6,Badajoz,109,Quintana de la Serena,5037,2550,2487
6,Badajoz,110,Reina,205,98,107
6,Badajoz,111,Rena,661,329,332
6,Badajoz,112,Retamal de Llerena,499,266,233
6,Badajoz,113,Ribera del Fresno,3508,1743,1765
6,Badajoz,114,Risco,171,86,85
6,Badajoz,115,Roca de la Sierra (La),1518,742,776
6,Badajoz,116,Salvaleón,2039,1007,1032
6,Badajoz,117,Salvatierra de los Barros,1772,876,896
6,Badajoz,119,San Pedro de Mérida,871,439,432
6,Badajoz,123,San Vicente de Alcántara,5768,2911,2857
6,Badajoz,118,Sancti-Spíritus,240,130,110
6,Badajoz,120,Santa Amalia,4338,2180,2158
6,Badajoz,121,Santa Marta,4319,2173,2146
6,Badajoz,122,Santos de Maimona (Los),8242,4171,4071
6,Badajoz,124,Segura de León,2115,1053,1062
6,Badajoz,125,Siruela,2199,1099,1100
6,Badajoz,126,Solana de los Barros,2795,1399,1396
6,Badajoz,127,Talarrubias,3617,1787,1830
6,Badajoz,128,Talavera la Real,5509,2777,2732
6,Badajoz,129,Táliga,792,394,398
6,Badajoz,130,Tamurejo,258,130,128
6,Badajoz,131,Torre de Miguel Sesmero,1261,641,620
6,Badajoz,132,Torremayor,1011,480,531
6,Badajoz,133,Torremejía,2217,1138,1079
6,Badajoz,134,Trasierra,680,364,316
6,Badajoz,135,Trujillanos,1433,760,673
6,Badajoz,136,Usagre,1963,977,986
6,Badajoz,137,Valdecaballeros,1209,600,609
6,Badajoz,901,Valdelacalzada,2838,1469,1369
6,Badajoz,138,Valdetorres,1292,646,646
6,Badajoz,139,Valencia de las Torres,695,364,331
6,Badajoz,140,Valencia del Mombuey,809,416,393
6,Badajoz,141,Valencia del Ventoso,2230,1124,1106
6,Badajoz,146,Valle de la Serena,1414,706,708
6,Badajoz,147,Valle de Matamoros,440,215,225
6,Badajoz,148,Valle de Santa Ana,1182,591,591
6,Badajoz,142,Valverde de Burguillos,322,164,158
6,Badajoz,143,Valverde de Leganés,4179,2110,2069
6,Badajoz,144,Valverde de Llerena,706,350,356
6,Badajoz,145,Valverde de Mérida,1153,586,567
6,Badajoz,149,Villafranca de los Barros,13266,6550,6716
6,Badajoz,150,Villagarcía de la Torre,981,516,465
6,Badajoz,151,Villagonzalo,1351,659,692
6,Badajoz,152,Villalba de los Barros,1638,827,811
6,Badajoz,153,Villanueva de la Serena,26111,12790,13321
6,Badajoz,154,Villanueva del Fresno,3663,1811,1852
6,Badajoz,156,Villar de Rena,1455,750,705
6,Badajoz,155,Villar del Rey,2387,1258,1129
6,Badajoz,157,Villarta de los Montes,592,290,302
6,Badajoz,158,Zafra,16433,7934,8499
6,Badajoz,159,Zahínos,2888,1437,1451
6,Badajoz,160,Zalamea de la Serena,3917,1939,1978
6,Badajoz,162,Zarza (La),3621,1842,1779
6,Badajoz,161,Zarza-Capilla,393,195,198
7,Balears (Illes),2,Alaior,9399,4690,4709
7,Balears (Illes),1,Alaró,5401,2644,2757
7,Balears (Illes),3,Alcúdia,19112,9710,9402
7,Balears (Illes),4,Algaida,5116,2679,2437
7,Balears (Illes),5,Andratx,11682,5918,5764
7,Balears (Illes),901,Ariany,876,471,405
7,Balears (Illes),6,Artà,7549,3799,3750
7,Balears (Illes),7,Banyalbufar,593,326,267
7,Balears (Illes),8,Binissalem,7379,3658,3721
7,Balears (Illes),9,Búger,1040,532,508
7,Balears (Illes),10,Bunyola,6172,3056,3116
7,Balears (Illes),11,Calvià,51462,25942,25520
7,Balears (Illes),12,Campanet,2619,1279,1340
7,Balears (Illes),13,Campos,9784,4970,4814
7,Balears (Illes),14,Capdepera,11929,6067,5862
7,Balears (Illes),64,Castell (Es),7926,4075,3851
7,Balears (Illes),15,Ciutadella de Menorca,29247,14630,14617
7,Balears (Illes),16,Consell,3677,1871,1806
7,Balears (Illes),17,Costitx,1116,564,552
7,Balears (Illes),18,Deyá,773,400,373
7,Balears (Illes),26,Eivissa,49516,25479,24037
7,Balears (Illes),19,Escorca,276,158,118
7,Balears (Illes),20,Esporles,4900,2416,2484
7,Balears (Illes),21,Estellencs,378,202,176
7,Balears (Illes),22,Felanitx,18225,9369,8856
7,Balears (Illes),23,Ferreries,4620,2347,2273
7,Balears (Illes),24,Formentera,9962,5237,4725
7,Balears (Illes),25,Fornalutx,703,354,349
7,Balears (Illes),27,Inca,29321,14773,14548
7,Balears (Illes),28,Lloret de Vistalegre,1295,662,633
7,Balears (Illes),29,Lloseta,5750,2931,2819
7,Balears (Illes),30,Llubí,2302,1139,1163
7,Balears (Illes),31,Llucmajor,36681,18644,18037
7,Balears (Illes),33,Manacor,40859,20583,20276
7,Balears (Illes),34,Mancor de la Vall,1285,650,635
7,Balears (Illes),32,Maó,29050,14323,14727
7,Balears (Illes),35,Maria de la Salut,2187,1126,1061
7,Balears (Illes),36,Marratxí,33883,17090,16793
7,Balears (Illes),37,Mercadal (Es),5398,2768,2630
7,Balears (Illes),902,Migjorn Gran (Es),1539,753,786
7,Balears (Illes),38,Montuïri,2817,1425,1392
7,Balears (Illes),39,Muro,7001,3582,3419
7,Balears (Illes),40,Palma,404681,198840,205841
7,Balears (Illes),41,Petra,2928,1454,1474
7,Balears (Illes),44,Pobla (Sa),12831,6609,6222
7,Balears (Illes),42,Pollença,16981,8553,8428
7,Balears (Illes),43,Porreres,5531,2926,2605
7,Balears (Illes),45,Puigpunyent,1938,977,961
7,Balears (Illes),59,Salines (Ses),5234,2707,2527
7,Balears (Illes),46,Sant Antoni de Portmany,22136,11621,10515
7,Balears (Illes),49,Sant Joan,1958,971,987
7,Balears (Illes),50,Sant Joan de Labritja,5477,2848,2629
7,Balears (Illes),48,Sant Josep de sa Talaia,22871,12000,10871
7,Balears (Illes),51,Sant Llorenç des Cardassar,8841,4504,4337
7,Balears (Illes),52,Sant Lluís,7204,3639,3565
7,Balears (Illes),53,Santa Eugènia,1595,822,773
7,Balears (Illes),54,Santa Eulalia del Río,32637,16701,15936
7,Balears (Illes),55,Santa Margalida,11626,5998,5628
7,Balears (Illes),56,Santa María del Camí,6176,3106,3070
7,Balears (Illes),57,Santanyí,12823,6566,6257
7,Balears (Illes),58,Selva,3620,1839,1781
7,Balears (Illes),47,Sencelles,3155,1606,1549
7,Balears (Illes),60,Sineu,3619,1779,1840
7,Balears (Illes),61,Sóller,14075,7105,6970
7,Balears (Illes),62,Son Servera,12286,6192,6094
7,Balears (Illes),63,Valldemossa,2037,1045,992
7,Balears (Illes),65,Vilafranca de Bonany,2989,1504,1485
8,Barcelona,1,Abrera,11469,5905,5564
8,Barcelona,2,Aguilar de Segarra,253,133,120
8,Barcelona,14,Aiguafreda,2505,1207,1298
8,Barcelona,3,Alella,9557,4702,4855
8,Barcelona,4,Alpens,303,164,139
8,Barcelona,5,Ametlla del Vallès (L'),8112,4073,4039
8,Barcelona,6,Arenys de Mar,14688,7202,7486
8,Barcelona,7,Arenys de Munt,8335,4181,4154
8,Barcelona,8,Argençola,245,142,103
8,Barcelona,9,Argentona,11718,5805,5913
8,Barcelona,10,Artés,5515,2769,2746
8,Barcelona,11,Avià,2223,1107,1116
8,Barcelona,12,Avinyó,2336,1173,1163
8,Barcelona,13,Avinyonet del Penedès,1685,907,778
8,Barcelona,15,Badalona,218886,109460,109426
8,Barcelona,904,Badia del Vallès,13703,6746,6957
8,Barcelona,16,Bagà,2361,1176,1185
8,Barcelona,17,Balenyà,3702,1850,1852
8,Barcelona,18,Balsareny,3485,1758,1727
8,Barcelona,252,Barberà del Vallès,31688,15771,15917
8,Barcelona,19,Barcelona,1619337,770044,849293
8,Barcelona,20,Begues,6348,3161,3187
8,Barcelona,21,Bellprat,97,54,43
8,Barcelona,22,Berga,17161,8533,8628
8,Barcelona,23,Bigues i Riells,8664,4446,4218
8,Barcelona,24,Borredà,604,325,279
8,Barcelona,25,Bruc (El),1956,1053,903
8,Barcelona,26,Brull (El),255,138,117
8,Barcelona,27,Cabanyes (Les),902,453,449
8,Barcelona,28,Cabrera d'Anoia,1343,720,623
8,Barcelona,29,Cabrera de Mar,4504,2264,2240
8,Barcelona,30,Cabrils,7108,3490,3618
8,Barcelona,31,Calaf,3611,1918,1693
8,Barcelona,34,Calders,934,480,454
8,Barcelona,33,Caldes de Montbui,17019,8535,8484
8,Barcelona,32,Caldes d'Estrac,2783,1355,1428
8,Barcelona,35,Calella,18625,9244,9381
8,Barcelona,37,Calldetenes,2425,1241,1184
8,Barcelona,38,Callús,1845,896,949
8,Barcelona,36,Calonge de Segarra,194,103,91
8,Barcelona,39,Campins,413,210,203
8,Barcelona,40,Canet de Mar,13915,6860,7055
8,Barcelona,41,Canovelles,16076,8402,7674
8,Barcelona,42,Cànoves i Samalús,2809,1444,1365
8,Barcelona,43,Canyelles,4196,2135,2061
8,Barcelona,44,Capellades,5498,2720,2778
8,Barcelona,45,Capolat,82,37,45
8,Barcelona,46,Cardedeu,16897,8325,8572
8,Barcelona,47,Cardona,5182,2551,2631
8,Barcelona,48,Carme,828,434,394
8,Barcelona,49,Casserres,1583,789,794
8,Barcelona,57,Castell de l'Areny,75,42,33
8,Barcelona,52,Castellar de n'Hug,187,102,85
8,Barcelona,50,Castellar del Riu,163,86,77
8,Barcelona,51,Castellar del Vallès,23129,11489,11640
8,Barcelona,53,Castellbell i el Vilar,3731,1895,1836
8,Barcelona,54,Castellbisbal,12223,6278,5945
8,Barcelona,55,Castellcir,664,351,313
8,Barcelona,56,Castelldefels,62250,31087,31163
8,Barcelona,58,Castellet i la Gornal,2240,1148,1092
8,Barcelona,60,Castellfollit de Riubregós,197,104,93
8,Barcelona,59,Castellfollit del Boix,410,202,208
8,Barcelona,61,Castellgalí,1958,1027,931
8,Barcelona,62,Castellnou de Bages,1069,553,516
8,Barcelona,63,Castellolí,519,252,267
8,Barcelona,64,Castellterçol,2387,1182,1205
8,Barcelona,65,Castellví de la Marca,1635,817,818
8,Barcelona,66,Castellví de Rosanes,1755,884,871
8,Barcelona,67,Centelles,7259,3559,3700
8,Barcelona,268,Cercs,1326,672,654
8,Barcelona,266,Cerdanyola del Vallès,58407,28867,29540
8,Barcelona,68,Cervelló,8566,4322,4244
8,Barcelona,69,Collbató,4114,2146,1968
8,Barcelona,70,Collsuspina,347,185,162
8,Barcelona,71,Copons,320,156,164
8,Barcelona,72,Corbera de Llobregat,14000,7040,6960
8,Barcelona,73,Cornellà de Llobregat,87240,43355,43885
8,Barcelona,74,Cubelles,13995,7100,6895
8,Barcelona,75,Dosrius,5010,2530,2480
8,Barcelona,76,Esparreguera,22042,11269,10773
8,Barcelona,77,Esplugues de Llobregat,46649,22769,23880
8,Barcelona,78,Espunyola (L'),262,132,130
8,Barcelona,79,Estany (L'),389,194,195
8,Barcelona,134,Figaró-Montmany,1083,543,540
8,Barcelona,80,Fígols,54,31,23
8,Barcelona,82,Fogars de la Selva,1513,792,721
8,Barcelona,81,Fogars de Montclús,455,242,213
8,Barcelona,83,Folgueroles,2216,1126,1090
8,Barcelona,84,Fonollosa,1401,720,681
8,Barcelona,85,Font-rubí,1466,771,695
8,Barcelona,86,Franqueses del Vallès (Les),18114,9315,8799
8,Barcelona,90,Gaià,177,95,82
8,Barcelona,87,Gallifa,215,114,101
8,Barcelona,88,Garriga (La),15069,7319,7750
8,Barcelona,89,Gavà,46383,23021,23362
8,Barcelona,91,Gelida,6945,3517,3428
8,Barcelona,92,Gironella,5067,2519,2548
8,Barcelona,93,Gisclareny,33,19,14
8,Barcelona,94,Granada (La),1963,1001,962
8,Barcelona,95,Granera,79,50,29
8,Barcelona,96,Granollers,59691,29747,29944
8,Barcelona,97,Gualba,1235,627,608
8,Barcelona,99,Guardiola de Berguedà,1024,547,477
8,Barcelona,100,Gurb,2526,1298,1228
8,Barcelona,101,Hospitalet de Llobregat (L'),258642,127125,131517
8,Barcelona,162,Hostalets de Pierola (Els),2743,1422,1321
8,Barcelona,102,Igualada,39149,19335,19814
8,Barcelona,103,Jorba,823,407,416
8,Barcelona,104,Llacuna (La),937,507,430
8,Barcelona,105,Llagosta (La),13713,6884,6829
8,Barcelona,107,Lliçà d'Amunt,14356,7310,7046
8,Barcelona,108,Lliçà de Vall,6365,3249,3116
8,Barcelona,106,Llinars del Vallès,9170,4536,4634
8,Barcelona,109,Lluçà,265,140,125
8,Barcelona,110,Malgrat de Mar,18596,9288,9308
8,Barcelona,111,Malla,255,127,128
8,Barcelona,112,Manlleu,20450,10324,10126
8,Barcelona,113,Manresa,76209,37529,38680
8,Barcelona,242,Marganell,317,153,164
8,Barcelona,114,Martorell,26815,13887,12928
8,Barcelona,115,Martorelles,4900,2460,2440
8,Barcelona,116,Masies de Roda (Les),758,374,384
8,Barcelona,117,Masies de Voltregà (Les),3226,1605,1621
8,Barcelona,118,Masnou (El),22536,10830,11706
8,Barcelona,119,Masquefa,8295,4199,4096
8,Barcelona,120,Matadepera,8606,4319,4287
8,Barcelona,121,Mataró,122905,61528,61377
8,Barcelona,122,Mediona,2363,1214,1149
8,Barcelona,138,Moià,5713,2886,2827
8,Barcelona,123,Molins de Rei,24236,11831,12405
8,Barcelona,124,Mollet del Vallès,52459,26336,26123
8,Barcelona,128,Monistrol de Calders,690,353,337
8,Barcelona,127,Monistrol de Montserrat,3027,1549,1478
8,Barcelona,125,Montcada i Reixac,33656,16762,16894
8,Barcelona,130,Montclar,112,54,58
8,Barcelona,131,Montesquiu,897,452,445
8,Barcelona,126,Montgat,10584,5217,5367
8,Barcelona,132,Montmajor,483,256,227
8,Barcelona,133,Montmaneu,184,102,82
8,Barcelona,135,Montmeló,9001,4469,4532
8,Barcelona,136,Montornès del Vallès,15790,8093,7697
8,Barcelona,137,Montseny,312,163,149
8,Barcelona,129,Muntanyola,587,296,291
8,Barcelona,139,Mura,233,122,111
8,Barcelona,140,Navarcles,5964,2912,3052
8,Barcelona,141,Navàs,6194,3079,3115
8,Barcelona,142,Nou de Berguedà (La),155,82,73
8,Barcelona,143,Òdena,3442,1742,1700
8,Barcelona,145,Olèrdola,3533,1830,1703
8,Barcelona,146,Olesa de Bonesvalls,1702,889,813
8,Barcelona,147,Olesa de Montserrat,23646,11943,11703
8,Barcelona,148,Olivella,3405,1794,1611
8,Barcelona,149,Olost,1202,598,604
8,Barcelona,144,Olvan,902,449,453
8,Barcelona,150,Orís,296,150,146
8,Barcelona,151,Oristà,583,290,293
8,Barcelona,152,Orpí,179,96,83
8,Barcelona,153,Òrrius,654,331,323
8,Barcelona,154,Pacs del Penedès,881,447,434
8,Barcelona,155,Palafolls,8773,4404,4369
8,Barcelona,156,Palau-solità i Plegamans,14190,7152,7038
8,Barcelona,157,Pallejà,11263,5697,5566
8,Barcelona,905,Palma de Cervelló (La),3035,1506,1529
8,Barcelona,158,Papiol (El),3937,1952,1985
8,Barcelona,159,Parets del Vallès,17805,9056,8749
8,Barcelona,160,Perafita,396,200,196
8,Barcelona,161,Piera,14576,7459,7117
8,Barcelona,163,Pineda de Mar,25893,13112,12781
8,Barcelona,164,Pla del Penedès (El),1103,558,545
8,Barcelona,165,Pobla de Claramunt (La),2295,1178,1117
8,Barcelona,166,Pobla de Lillet (La),1303,648,655
8,Barcelona,167,Polinyà,7798,3989,3809
8,Barcelona,182,Pont de Vilomara i Rocafort (El),3760,1943,1817
8,Barcelona,168,Pontons,539,293,246
8,Barcelona,169,Prat de Llobregat (El),63434,31469,31965
8,Barcelona,171,Prats de Lluçanès,2739,1355,1384
8,Barcelona,170,Prats de Rei (Els),549,288,261
8,Barcelona,230,Premià de Dalt,10064,5050,5014
8,Barcelona,172,Premià de Mar,27802,13707,14095
8,Barcelona,174,Puigdàlber,522,252,270
8,Barcelona,175,Puig-reig,4333,2127,2206
8,Barcelona,176,Pujalt,205,104,101
8,Barcelona,177,Quar (La),59,36,23
8,Barcelona,178,Rajadell,514,271,243
8,Barcelona,179,Rellinars,727,370,357
8,Barcelona,180,Ripollet,37151,18671,18480
8,Barcelona,181,Roca del Vallès (La),10291,5191,5100
8,Barcelona,183,Roda de Ter,6118,3006,3112
8,Barcelona,184,Rubí,73591,36945,36646
8,Barcelona,185,Rubió,218,116,102
8,Barcelona,901,Rupit i Pruit,312,157,155
8,Barcelona,187,Sabadell,207338,101462,105876
8,Barcelona,188,Sagàs,141,73,68
8,Barcelona,190,Saldes,340,197,143
8,Barcelona,191,Sallent,7029,3394,3635
8,Barcelona,194,Sant Adrià de Besòs,34104,16859,17245
8,Barcelona,195,Sant Agustí de Lluçanès,101,52,49
8,Barcelona,196,Sant Andreu de la Barca,26682,13506,13176
8,Barcelona,197,Sant Andreu de Llavaneres,10303,5134,5169
8,Barcelona,198,Sant Antoni de Vilamajor,5479,2749,2730
8,Barcelona,199,Sant Bartomeu del Grau,967,503,464
8,Barcelona,200,Sant Boi de Llobregat,82411,40910,41501
8,Barcelona,201,Sant Boi de Lluçanès,564,282,282
8,Barcelona,203,Sant Cebrià de Vallalta,3388,1761,1627
8,Barcelona,202,Sant Celoni,16905,8451,8454
8,Barcelona,204,Sant Climent de Llobregat,3819,1923,1896
8,Barcelona,205,Sant Cugat del Vallès,81745,39965,41780
8,Barcelona,206,Sant Cugat Sesgarrigues,973,499,474
8,Barcelona,207,Sant Esteve de Palautordera,2500,1231,1269
8,Barcelona,208,Sant Esteve Sesrovires,7329,3727,3602
8,Barcelona,210,Sant Feliu de Codines,5836,2980,2856
8,Barcelona,211,Sant Feliu de Llobregat,43112,21051,22061
8,Barcelona,212,Sant Feliu Sasserra,661,334,327
8,Barcelona,209,Sant Fost de Campsentelles,8292,4150,4142
8,Barcelona,213,Sant Fruitós de Bages,8184,4122,4062
8,Barcelona,215,Sant Hipòlit de Voltregà,3512,1761,1751
8,Barcelona,193,Sant Iscle de Vallalta,1280,669,611
8,Barcelona,216,Sant Jaume de Frontanyà,24,13,11
8,Barcelona,218,Sant Joan de Vilatorrada,10856,5478,5378
8,Barcelona,217,Sant Joan Despí,32338,15851,16487
8,Barcelona,903,Sant Julià de Cerdanyola,267,143,124
8,Barcelona,220,Sant Julià de Vilatorta,2974,1449,1525
8,Barcelona,221,Sant Just Desvern,15923,7598,8325
8,Barcelona,222,Sant Llorenç d'Hortons,2416,1214,1202
8,Barcelona,223,Sant Llorenç Savall,2402,1208,1194
8,Barcelona,225,Sant Martí d'Albars,107,56,51
8,Barcelona,224,Sant Martí de Centelles,1034,541,493
8,Barcelona,226,Sant Martí de Tous,1164,586,578
8,Barcelona,227,Sant Martí Sarroca,3161,1579,1582
8,Barcelona,228,Sant Martí Sesgueioles,381,190,191
8,Barcelona,229,Sant Mateu de Bages,663,349,314
8,Barcelona,231,Sant Pere de Ribes,28399,14385,14014
8,Barcelona,232,Sant Pere de Riudebitlles,2381,1199,1182
8,Barcelona,233,Sant Pere de Torelló,2417,1228,1189
8,Barcelona,234,Sant Pere de Vilamajor,4147,2078,2069
8,Barcelona,189,Sant Pere Sallavinera,168,88,80
8,Barcelona,235,Sant Pol de Mar,5076,2563,2513
8,Barcelona,236,Sant Quintí de Mediona,2188,1123,1065
8,Barcelona,237,Sant Quirze de Besora,2240,1108,1132
8,Barcelona,238,Sant Quirze del Vallès,18702,9221,9481
8,Barcelona,239,Sant Quirze Safaja,640,330,310
8,Barcelona,240,Sant Sadurní d'Anoia,12323,6076,6247
8,Barcelona,241,Sant Sadurní d'Osormort,94,52,42
8,Barcelona,98,Sant Salvador de Guardiola,3078,1567,1511
8,Barcelona,262,Sant Vicenç de Castellet,8688,4318,4370
8,Barcelona,264,Sant Vicenç de Montalt,5776,2934,2842
8,Barcelona,265,Sant Vicenç de Torelló,2028,999,1029
8,Barcelona,263,Sant Vicenç dels Horts,28024,14071,13953
8,Barcelona,243,Santa Cecília de Voltregà,183,92,91
8,Barcelona,244,Santa Coloma de Cervelló,7845,3872,3973
8,Barcelona,245,Santa Coloma de Gramenet,120060,60779,59281
8,Barcelona,246,Santa Eugènia de Berga,2261,1174,1087
8,Barcelona,247,Santa Eulàlia de Riuprimer,1079,557,522
8,Barcelona,248,Santa Eulàlia de Ronçana,6829,3407,3422
8,Barcelona,249,Santa Fe del Penedès,384,193,191
8,Barcelona,250,Santa Margarida de Montbui,9811,4933,4878
8,Barcelona,251,Santa Margarida i els Monjos,6933,3553,3380
8,Barcelona,253,Santa Maria de Besora,168,84,84
8,Barcelona,254,Santa Maria de Corcó,2262,1147,1115
8,Barcelona,256,Santa Maria de Martorelles,839,430,409
8,Barcelona,255,Santa Maria de Merlès,162,78,84
8,Barcelona,257,Santa Maria de Miralles,133,65,68
8,Barcelona,259,Santa Maria de Palautordera,9040,4645,4395
8,Barcelona,258,Santa Maria d'Oló,1079,549,530
8,Barcelona,260,Santa Perpètua de Mogoda,25191,12958,12233
8,Barcelona,261,Santa Susanna,3308,1688,1620
8,Barcelona,192,Santpedor,7071,3535,3536
8,Barcelona,267,Sentmenat,8112,4112,4000
8,Barcelona,269,Seva,3418,1760,1658
8,Barcelona,270,Sitges,28130,14066,14064
8,Barcelona,271,Sobremunt,95,46,49
8,Barcelona,272,Sora,190,105,85
8,Barcelona,273,Subirats,3076,1546,1530
8,Barcelona,274,Súria,6359,3118,3241
8,Barcelona,276,Tagamanent,306,163,143
8,Barcelona,277,Talamanca,143,80,63
8,Barcelona,278,Taradell,6098,3086,3012
8,Barcelona,275,Tavèrnoles,304,153,151
8,Barcelona,280,Tavertet,148,80,68
8,Barcelona,281,Teià,6081,3028,3053
8,Barcelona,279,Terrassa,212724,105690,107034
8,Barcelona,282,Tiana,7774,3788,3986
8,Barcelona,283,Tona,7984,4001,3983
8,Barcelona,284,Tordera,15641,8022,7619
8,Barcelona,285,Torelló,13944,6913,7031
8,Barcelona,286,Torre de Claramunt (La),3757,1961,1796
8,Barcelona,287,Torrelavit,1383,749,634
8,Barcelona,288,Torrelles de Foix,2545,1331,1214
8,Barcelona,289,Torrelles de Llobregat,5526,2762,2764
8,Barcelona,290,Ullastrell,1892,968,924
8,Barcelona,291,Vacarisses,6017,3112,2905
8,Barcelona,292,Vallbona d'Anoia,1423,731,692
8,Barcelona,293,Vallcebre,268,156,112
8,Barcelona,294,Vallgorguina,2591,1332,1259
8,Barcelona,295,Vallirana,14200,7097,7103
8,Barcelona,296,Vallromanes,2367,1200,1167
8,Barcelona,297,Veciana,173,94,79
8,Barcelona,298,Vic,40422,20134,20288
8,Barcelona,299,Vilada,516,261,255
8,Barcelona,301,Viladecans,64077,32104,31973
8,Barcelona,300,Viladecavalls,7323,3641,3682
8,Barcelona,305,Vilafranca del Penedès,38218,18941,19277
8,Barcelona,306,Vilalba Sasserra,689,354,335
8,Barcelona,303,Vilanova de Sau,330,160,170
8,Barcelona,302,Vilanova del Camí,12644,6387,6257
8,Barcelona,902,Vilanova del Vallès,4797,2460,2337
8,Barcelona,307,Vilanova i la Geltrú,66532,32739,33793
8,Barcelona,214,Vilassar de Dalt,8746,4302,4444
8,Barcelona,219,Vilassar de Mar,19574,9421,10153
8,Barcelona,304,Vilobí del Penedès,1129,586,543
8,Barcelona,308,Viver i Serrateix,188,98,90
9,Burgos,1,Abajas,26,16,10
9,Burgos,3,Adrada de Haza,266,146,120
9,Burgos,6,Aguas Cándidas,60,37,23
9,Burgos,7,Aguilar de Bureba,65,39,26
9,Burgos,9,Albillos,217,112,105
9,Burgos,10,Alcocero de Mola,40,24,16
9,Burgos,11,Alfoz de Bricia,96,50,46
9,Burgos,907,Alfoz de Quintanadueñas,1889,1020,869
9,Burgos,12,Alfoz de Santa Gadea,113,66,47
9,Burgos,13,Altable,64,34,30
9,Burgos,14,Altos (Los),197,112,85
9,Burgos,16,Ameyugo,99,53,46
9,Burgos,17,Anguix,152,89,63
9,Burgos,18,Aranda de Duero,33154,16462,16692
9,Burgos,19,Arandilla,184,111,73
9,Burgos,20,Arauzo de Miel,339,186,153
9,Burgos,21,Arauzo de Salce,68,37,31
9,Burgos,22,Arauzo de Torre,91,52,39
9,Burgos,23,Arcos,1215,668,547
9,Burgos,24,Arenillas de Riopisuerga,182,105,77
9,Burgos,25,Arija,181,92,89
9,Burgos,26,Arlanzón,424,245,179
9,Burgos,27,Arraya de Oca,50,27,23
9,Burgos,29,Atapuerca,208,121,87
9,Burgos,30,Ausines (Los),145,82,63
9,Burgos,32,Avellanosa de Muñó,127,66,61
9,Burgos,33,Bahabón de Esgueva,120,70,50
9,Burgos,34,Balbases (Los),349,193,156
9,Burgos,35,Baños de Valdearados,391,234,157
9,Burgos,36,Bañuelos de Bureba,32,21,11
9,Burgos,37,Barbadillo de Herreros,122,71,51
9,Burgos,38,Barbadillo del Mercado,156,88,68
9,Burgos,39,Barbadillo del Pez,82,54,28
9,Burgos,41,Barrio de Muñó,35,19,16
9,Burgos,43,Barrios de Bureba (Los),226,135,91
9,Burgos,44,Barrios de Colina,64,30,34
9,Burgos,45,Basconcillos del Tozo,332,188,144
9,Burgos,46,Bascuñana,42,28,14
9,Burgos,47,Belbimbre,79,42,37
9,Burgos,48,Belorado,2140,1112,1028
9,Burgos,50,Berberana,71,37,34
9,Burgos,51,Berlangas de Roa,196,103,93
9,Burgos,52,Berzosa de Bureba,40,26,14
9,Burgos,54,Bozoó,110,59,51
9,Burgos,55,Brazacorta,68,37,31
9,Burgos,56,Briviesca,7843,4035,3808
9,Burgos,57,Bugedo,185,116,69
9,Burgos,58,Buniel,443,245,198
9,Burgos,59,Burgos,178574,85992,92582
9,Burgos,60,Busto de Bureba,195,111,84
9,Burgos,61,Cabañes de Esgueva,215,113,102
9,Burgos,62,Cabezón de la Sierra,58,25,33
9,Burgos,64,Caleruega,491,242,249
9,Burgos,65,Campillo de Aranda,200,116,84
9,Burgos,66,Campolara,66,42,24
9,Burgos,67,Canicosa de la Sierra,571,309,262
9,Burgos,68,Cantabrana,29,17,12
9,Burgos,70,Carazo,46,29,17
9,Burgos,71,Carcedo de Bureba,42,22,20
9,Burgos,72,Carcedo de Burgos,337,195,142
9,Burgos,73,Cardeñadijo,1123,627,496
9,Burgos,74,Cardeñajimeno,941,527,414
9,Burgos,75,Cardeñuela Riopico,133,82,51
9,Burgos,76,Carrias,28,22,6
9,Burgos,77,Cascajares de Bureba,37,22,15
9,Burgos,78,Cascajares de la Sierra,33,15,18
9,Burgos,79,Castellanos de Castro,52,31,21
9,Burgos,83,Castil de Peones,28,16,12
9,Burgos,82,Castildelgado,56,29,27
9,Burgos,84,Castrillo de la Reina,223,145,78
9,Burgos,85,Castrillo de la Vega,667,350,317
9,Burgos,88,Castrillo de Riopisuerga,66,40,26
9,Burgos,86,Castrillo del Val,732,416,316
9,Burgos,90,Castrillo Matajudíos,66,34,32
9,Burgos,91,Castrojeriz,882,447,435
9,Burgos,63,Cavia,286,161,125
9,Burgos,93,Cayuela,184,98,86
9,Burgos,94,Cebrecos,53,32,21
9,Burgos,95,Celada del Camino,95,50,45
9,Burgos,98,Cerezo de Río Tirón,630,344,286
9,Burgos,100,Cerratón de Juarros,57,36,21
9,Burgos,101,Ciadoncha,76,48,28
9,Burgos,102,Cillaperlata,40,27,13
9,Burgos,103,Cilleruelo de Abajo,279,147,132
9,Burgos,104,Cilleruelo de Arriba,61,33,28
9,Burgos,105,Ciruelos de Cervera,107,57,50
9,Burgos,108,Cogollos,494,279,215
9,Burgos,109,Condado de Treviño,1460,833,627
9,Burgos,110,Contreras,92,56,36
9,Burgos,112,Coruña del Conde,132,77,55
9,Burgos,113,Covarrubias,638,342,296
9,Burgos,114,Cubillo del Campo,100,53,47
9,Burgos,115,Cubo de Bureba,101,57,44
9,Burgos,117,Cueva de Roa (La),105,58,47
9,Burgos,119,Cuevas de San Clemente,50,21,29
9,Burgos,120,Encío,47,29,18
9,Burgos,122,Espinosa de Cervera,102,63,39
9,Burgos,124,Espinosa de los Monteros,2094,1163,931
9,Burgos,123,Espinosa del Camino,36,20,16
9,Burgos,125,Estépar,736,436,300
9,Burgos,127,Fontioso,58,30,28
9,Burgos,128,Frandovínez,106,58,48
9,Burgos,129,Fresneda de la Sierra Tirón,126,82,44
9,Burgos,130,Fresneña,103,54,49
9,Burgos,131,Fresnillo de las Dueñas,466,247,219
9,Burgos,132,Fresno de Río Tirón,199,114,85
9,Burgos,133,Fresno de Rodilla,48,30,18
9,Burgos,134,Frías,275,147,128
9,Burgos,135,Fuentebureba,49,23,26
9,Burgos,136,Fuentecén,235,136,99
9,Burgos,137,Fuentelcésped,211,103,108
9,Burgos,138,Fuentelisendo,101,60,41
9,Burgos,139,Fuentemolinos,107,67,40
9,Burgos,140,Fuentenebro,159,96,63
9,Burgos,141,Fuentespina,728,389,339
9,Burgos,143,Galbarros,27,21,6
9,Burgos,144,Gallega (La),67,39,28
9,Burgos,148,Grijalba,127,59,68
9,Burgos,149,Grisaleña,43,29,14
9,Burgos,151,Gumiel de Izán,636,357,279
9,Burgos,152,Gumiel de Mercado,401,223,178
9,Burgos,154,Hacinas,185,98,87
9,Burgos,155,Haza,33,20,13
9,Burgos,159,Hontanas,60,37,23
9,Burgos,160,Hontangas,123,75,48
9,Burgos,162,Hontoria de la Cantera,122,66,56
9,Burgos,164,Hontoria de Valdearados,237,147,90
9,Burgos,163,Hontoria del Pinar,777,438,339
9,Burgos,166,Hormazas (Las),116,65,51
9,Burgos,167,Hornillos del Camino,61,34,27
9,Burgos,168,Horra (La),391,202,189
9,Burgos,169,Hortigüela,105,65,40
9,Burgos,170,Hoyales de Roa,250,130,120
9,Burgos,172,Huérmeces,127,63,64
9,Burgos,173,Huerta de Arriba,150,83,67
9,Burgos,174,Huerta de Rey,1088,581,507
9,Burgos,175,Humada,144,90,54
9,Burgos,176,Hurones,76,46,30
9,Burgos,177,Ibeas de Juarros,1398,766,632
9,Burgos,178,Ibrillos,68,41,27
9,Burgos,179,Iglesiarrubia,50,29,21
9,Burgos,180,Iglesias,150,86,64
9,Burgos,181,Isar,385,192,193
9,Burgos,182,Itero del Castillo,99,51,48
9,Burgos,183,Jaramillo de la Fuente,46,29,17
9,Burgos,184,Jaramillo Quemado,6,4,2
9,Burgos,189,Junta de Traslaloma,158,79,79
9,Burgos,190,Junta de Villalba de Losa,114,60,54
9,Burgos,191,Jurisdicción de Lara,48,26,22
9,Burgos,192,Jurisdicción de San Zadornil,81,43,38
9,Burgos,194,Lerma,2798,1400,1398
9,Burgos,195,Llano de Bureba,71,38,33
9,Burgos,196,Madrigal del Monte,178,106,72
9,Burgos,197,Madrigalejo del Monte,183,114,69
9,Burgos,198,Mahamud,154,87,67
9,Burgos,199,Mambrilla de Castrejón,117,61,56
9,Burgos,200,Mambrillas de Lara,53,29,24
9,Burgos,201,Mamolar,37,21,16
9,Burgos,202,Manciles,30,19,11
9,Burgos,206,Mazuela,71,39,32
9,Burgos,208,Mecerreyes,304,161,143
9,Burgos,209,Medina de Pomar,6311,3310,3001
9,Burgos,211,Melgar de Fernamental,1872,994,878
9,Burgos,213,Merindad de Cuesta-Urria,435,231,204
9,Burgos,214,Merindad de Montija,854,489,365
9,Burgos,906,Merindad de Río Ubierna,1393,765,628
9,Burgos,215,Merindad de Sotoscueva,477,269,208
9,Burgos,216,Merindad de Valdeporres,461,242,219
9,Burgos,217,Merindad de Valdivielso,433,249,184
9,Burgos,218,Milagros,500,271,229
9,Burgos,219,Miranda de Ebro,39038,19681,19357
9,Burgos,220,Miraveche,93,56,37
9,Burgos,221,Modúbar de la Emparedada,535,298,237
9,Burgos,223,Monasterio de la Sierra,47,29,18
9,Burgos,224,Monasterio de Rodilla,200,111,89
9,Burgos,225,Moncalvillo,103,62,41
9,Burgos,226,Monterrubio de la Demanda,71,41,30
9,Burgos,227,Montorio,191,106,85
9,Burgos,228,Moradillo de Roa,192,105,87
9,Burgos,229,Nava de Roa,244,127,117
9,Burgos,230,Navas de Bureba,44,20,24
9,Burgos,231,Nebreda,81,54,27
9,Burgos,232,Neila,205,115,90
9,Burgos,235,Olmedillo de Roa,193,101,92
9,Burgos,236,Olmillos de Muñó,44,26,18
9,Burgos,238,Oña,1224,634,590
9,Burgos,239,Oquillas,61,33,28
9,Burgos,241,Orbaneja Riopico,244,137,107
9,Burgos,242,Padilla de Abajo,93,54,39
9,Burgos,243,Padilla de Arriba,84,53,31
9,Burgos,244,Padrones de Bureba,46,28,18
9,Burgos,246,Palacios de la Sierra,826,415,411
9,Burgos,247,Palacios de Riopisuerga,35,16,19
9,Burgos,248,Palazuelos de la Sierra,70,44,26
9,Burgos,249,Palazuelos de Muñó,60,32,28
9,Burgos,250,Pampliega,373,197,176
9,Burgos,251,Pancorbo,534,291,243
9,Burgos,253,Pardilla,123,73,50
9,Burgos,255,Partido de la Sierra en Tobalina,87,54,33
9,Burgos,256,Pedrosa de Duero,501,286,215
9,Burgos,259,Pedrosa de Río Úrbel,253,152,101
9,Burgos,257,Pedrosa del Páramo,99,57,42
9,Burgos,258,Pedrosa del Príncipe,172,89,83
9,Burgos,261,Peñaranda de Duero,587,301,286
9,Burgos,262,Peral de Arlanza,159,87,72
9,Burgos,265,Piérnigas,51,31,20
9,Burgos,266,Pineda de la Sierra,107,62,45
9,Burgos,267,Pineda Trasmonte,143,86,57
9,Burgos,268,Pinilla de los Barruecos,106,60,46
9,Burgos,269,Pinilla de los Moros,42,27,15
9,Burgos,270,Pinilla Trasmonte,195,111,84
9,Burgos,272,Poza de la Sal,341,165,176
9,Burgos,273,Prádanos de Bureba,57,37,20
9,Burgos,274,Pradoluengo,1443,715,728
9,Burgos,275,Presencio,204,115,89
9,Burgos,276,Puebla de Arganzón (La),514,283,231
9,Burgos,277,Puentedura,123,76,47
9,Burgos,279,Quemada,249,145,104
9,Burgos,281,Quintana del Pidio,183,95,88
9,Burgos,280,Quintanabureba,36,20,16
9,Burgos,283,Quintanaélez,71,39,32
9,Burgos,287,Quintanaortuño,256,138,118
9,Burgos,288,Quintanapalla,112,63,49
9,Burgos,289,Quintanar de la Sierra,2048,1063,985
9,Burgos,292,Quintanavides,106,56,50
9,Burgos,294,Quintanilla de la Mata,143,80,63
9,Burgos,901,Quintanilla del Agua y Tordueles,527,272,255
9,Burgos,295,Quintanilla del Coco,86,46,40
9,Burgos,298,Quintanilla San García,115,64,51
9,Burgos,301,Quintanilla Vivar,771,401,370
9,Burgos,297,Quintanillas (Las),399,222,177
9,Burgos,302,Rabanera del Pinar,131,70,61
9,Burgos,303,Rábanos,87,48,39
9,Burgos,304,Rabé de las Calzadas,221,111,110
9,Burgos,306,Rebolledo de la Torre,142,75,67
9,Burgos,307,Redecilla del Camino,127,73,54
9,Burgos,308,Redecilla del Campo,76,43,33
9,Burgos,309,Regumiel de la Sierra,411,207,204
9,Burgos,310,Reinoso,15,11,4
9,Burgos,311,Retuerta,71,42,29
9,Burgos,314,Revilla del Campo,119,66,53
9,Burgos,316,Revilla Vallejera,83,53,30
9,Burgos,312,Revilla y Ahedo (La),128,72,56
9,Burgos,315,Revillarruz,462,239,223
9,Burgos,317,Rezmondo,17,7,10
9,Burgos,318,Riocavado de la Sierra,59,35,24
9,Burgos,321,Roa,2458,1273,1185
9,Burgos,323,Rojas,81,52,29
9,Burgos,325,Royuela de Río Franco,237,137,100
9,Burgos,326,Rubena,192,110,82
9,Burgos,327,Rublacedo de Abajo,35,21,14
9,Burgos,328,Rucandio,81,41,40
9,Burgos,329,Salas de Bureba,144,83,61
9,Burgos,330,Salas de los Infantes,2171,1126,1045
9,Burgos,332,Saldaña de Burgos,183,105,78
9,Burgos,334,Salinillas de Bureba,54,36,18
9,Burgos,335,San Adrián de Juarros,61,35,26
9,Burgos,337,San Juan del Monte,153,83,70
9,Burgos,338,San Mamés de Burgos,297,164,133
9,Burgos,339,San Martín de Rubiales,174,103,71
9,Burgos,340,San Millán de Lara,74,53,21
9,Burgos,360,San Vicente del Valle,38,23,15
9,Burgos,343,Santa Cecilia,101,62,39
9,Burgos,345,Santa Cruz de la Salceda,177,100,77
9,Burgos,346,Santa Cruz del Valle Urbión,104,62,42
9,Burgos,347,Santa Gadea del Cid,160,87,73
9,Burgos,348,Santa Inés,149,82,67
9,Burgos,350,Santa María del Campo,652,350,302
9,Burgos,351,Santa María del Invierno,63,44,19
9,Burgos,352,Santa María del Mercadillo,144,86,58
9,Burgos,353,Santa María Rivarredonda,99,60,39
9,Burgos,354,Santa Olalla de Bureba,37,25,12
9,Burgos,355,Santibáñez de Esgueva,123,65,58
9,Burgos,356,Santibáñez del Val,64,37,27
9,Burgos,358,Santo Domingo de Silos,326,197,129
9,Burgos,361,Sargentes de la Lora,149,86,63
9,Burgos,362,Sarracín,287,157,130
9,Burgos,363,Sasamón,1196,668,528
9,Burgos,365,Sequera de Haza (La),49,28,21
9,Burgos,366,Solarana,104,56,48
9,Burgos,368,Sordillos,32,20,12
9,Burgos,369,Sotillo de la Ribera,572,318,254
9,Burgos,372,Sotragero,261,143,118
9,Burgos,373,Sotresgudo,530,307,223
9,Burgos,374,Susinos del Páramo,123,76,47
9,Burgos,375,Tamarón,48,27,21
9,Burgos,377,Tardajos,844,443,401
9,Burgos,378,Tejada,37,24,13
9,Burgos,380,Terradillos de Esgueva,112,58,54
9,Burgos,381,Tinieblas de la Sierra,41,25,16
9,Burgos,382,Tobar,32,20,12
9,Burgos,384,Tordómar,380,214,166
9,Burgos,386,Torrecilla del Monte,77,41,36
9,Burgos,387,Torregalindo,143,85,58
9,Burgos,388,Torrelara,28,17,11
9,Burgos,389,Torrepadre,83,53,30
9,Burgos,390,Torresandino,732,397,335
9,Burgos,391,Tórtoles de Esgueva,490,256,234
9,Burgos,392,Tosantos,49,28,21
9,Burgos,394,Trespaderne,1099,590,509
9,Burgos,395,Tubilla del Agua,173,104,69
9,Burgos,396,Tubilla del Lago,151,88,63
9,Burgos,398,Úrbel del Castillo,100,63,37
9,Burgos,400,Vadocondes,416,225,191
9,Burgos,403,Valdeande,114,69,45
9,Burgos,405,Valdezate,157,80,77
9,Burgos,406,Valdorros,295,166,129
9,Burgos,408,Vallarta de Bureba,51,30,21
9,Burgos,904,Valle de las Navas,628,347,281
9,Burgos,908,Valle de Losa,600,348,252
9,Burgos,409,Valle de Manzanedo,137,74,63
9,Burgos,410,Valle de Mena,3921,2004,1917
9,Burgos,411,Valle de Oca,190,107,83
9,Burgos,902,Valle de Santibáñez,555,310,245
9,Burgos,905,Valle de Sedano,483,278,205
9,Burgos,412,Valle de Tobalina,1026,550,476
9,Burgos,413,Valle de Valdebezana,592,322,270
9,Burgos,414,Valle de Valdelaguna,204,125,79
9,Burgos,415,Valle de Valdelucio,347,183,164
9,Burgos,416,Valle de Zamanzas,67,39,28
9,Burgos,417,Vallejera,47,29,18
9,Burgos,418,Valles de Palenzuela,87,47,40
9,Burgos,419,Valluércanes,89,54,35
9,Burgos,407,Valmala,33,14,19
9,Burgos,422,Vid de Bureba (La),28,14,14
9,Burgos,421,Vid y Barrios (La),281,164,117
9,Burgos,423,Vileña,34,20,14
9,Burgos,427,Villadiego,1763,954,809
9,Burgos,428,Villaescusa de Roa,146,81,65
9,Burgos,429,Villaescusa la Sombría,63,45,18
9,Burgos,430,Villaespasa,18,9,9
9,Burgos,431,Villafranca Montes de Oca,136,78,58
9,Burgos,432,Villafruela,255,144,111
9,Burgos,433,Villagalijo,74,49,25
9,Burgos,434,Villagonzalo Pedernales,1584,834,750
9,Burgos,437,Villahoz,362,196,166
9,Burgos,438,Villalba de Duero,689,362,327
9,Burgos,439,Villalbilla de Burgos,1003,550,453
9,Burgos,440,Villalbilla de Gumiel,105,65,40
9,Burgos,441,Villaldemiro,75,40,35
9,Burgos,442,Villalmanzo,482,254,228
9,Burgos,443,Villamayor de los Montes,216,112,104
9,Burgos,444,Villamayor de Treviño,101,55,46
9,Burgos,445,Villambistia,52,32,20
9,Burgos,446,Villamedianilla,16,9,7
9,Burgos,447,Villamiel de la Sierra,34,21,13
9,Burgos,448,Villangómez,258,155,103
9,Burgos,449,Villanueva de Argaño,113,66,47
9,Burgos,450,Villanueva de Carazo,30,18,12
9,Burgos,451,Villanueva de Gumiel,292,155,137
9,Burgos,454,Villanueva de Teba,48,32,16
9,Burgos,455,Villaquirán de la Puebla,48,28,20
9,Burgos,456,Villaquirán de los Infantes,162,84,78
9,Burgos,903,Villarcayo de Merindad de Castilla la Vieja,4855,2576,2279
9,Burgos,458,Villariezo,529,300,229
9,Burgos,460,Villasandino,221,126,95
9,Burgos,463,Villasur de Herreros,290,166,124
9,Burgos,464,Villatuelda,52,30,22
9,Burgos,466,Villaverde del Monte,163,93,70
9,Burgos,467,Villaverde-Mogina,83,54,29
9,Burgos,471,Villayerno Morquillas,226,132,94
9,Burgos,472,Villazopeque,66,40,26
9,Burgos,473,Villegas,94,56,38
9,Burgos,476,Villoruebo,61,42,19
9,Burgos,424,Viloria de Rioja,46,26,20
9,Burgos,425,Vilviestre del Pinar,698,377,321
9,Burgos,478,Vizcaínos,49,30,19
9,Burgos,480,Zael,116,63,53
9,Burgos,482,Zarzosa de Río Pisuerga,36,23,13
9,Burgos,483,Zazuar,256,140,116
9,Burgos,485,Zuñeda,59,34,25
10,Cáceres,1,Abadía,326,176,150
10,Cáceres,2,Abertura,459,237,222
10,Cáceres,3,Acebo,674,351,323
10,Cáceres,4,Acehúche,842,410,432
10,Cáceres,5,Aceituna,625,324,301
10,Cáceres,6,Ahigal,1451,747,704
10,Cáceres,903,Alagón del Río,879,438,441
10,Cáceres,7,Albalá,795,402,393
10,Cáceres,8,Alcántara,1630,806,824
10,Cáceres,9,Alcollarín,260,122,138
10,Cáceres,10,Alcuéscar,2974,1543,1431
10,Cáceres,12,Aldea del Cano,727,351,376
10,Cáceres,13,Aldea del Obispo (La),349,181,168
10,Cáceres,11,Aldeacentenera,754,391,363
10,Cáceres,14,Aldeanueva de la Vera,2229,1075,1154
10,Cáceres,15,Aldeanueva del Camino,797,390,407
10,Cáceres,16,Aldehuela de Jerte,382,206,176
10,Cáceres,17,Alía,998,504,494
10,Cáceres,18,Aliseda,1994,1008,986
10,Cáceres,19,Almaraz,1426,729,697
10,Cáceres,20,Almoharín,2020,988,1032
10,Cáceres,21,Arroyo de la Luz,6467,3206,3261
10,Cáceres,23,Arroyomolinos,978,509,469
10,Cáceres,22,Arroyomolinos de la Vera,493,248,245
10,Cáceres,24,Baños de Montemayor,751,360,391
10,Cáceres,25,Barrado,473,242,231
10,Cáceres,26,Belvís de Monroy,665,336,329
10,Cáceres,27,Benquerencia,92,53,39
10,Cáceres,28,Berrocalejo,127,66,61
10,Cáceres,29,Berzocana,520,258,262
10,Cáceres,30,Bohonal de Ibor,558,292,266
10,Cáceres,31,Botija,211,108,103
10,Cáceres,32,Brozas,2112,1060,1052
10,Cáceres,33,Cabañas del Castillo,394,203,191
10,Cáceres,34,Cabezabellosa,414,204,210
10,Cáceres,35,Cabezuela del Valle,2255,1168,1087
10,Cáceres,36,Cabrero,369,197,172
10,Cáceres,37,Cáceres,94179,45286,48893
10,Cáceres,38,Cachorrilla,101,53,48
10,Cáceres,39,Cadalso,508,250,258
10,Cáceres,40,Calzadilla,478,242,236
10,Cáceres,41,Caminomorisco,1232,635,597
10,Cáceres,42,Campillo de Deleitosa,76,31,45
10,Cáceres,43,Campo Lugar,1019,512,507
10,Cáceres,44,Cañamero,1783,919,864
10,Cáceres,45,Cañaveral,1287,629,658
10,Cáceres,46,Carbajo,233,118,115
10,Cáceres,47,Carcaboso,1118,574,544
10,Cáceres,48,Carrascalejo,321,164,157
10,Cáceres,49,Casar de Cáceres,4841,2411,2430
10,Cáceres,50,Casar de Palomero,1392,695,697
10,Cáceres,51,Casares de las Hurdes,522,258,264
10,Cáceres,52,Casas de Don Antonio,200,93,107
10,Cáceres,53,Casas de Don Gómez,336,178,158
10,Cáceres,56,Casas de Millán,691,344,347
10,Cáceres,57,Casas de Miravete,139,79,60
10,Cáceres,54,Casas del Castañar,627,301,326
10,Cáceres,55,Casas del Monte,808,416,392
10,Cáceres,58,Casatejada,1433,744,689
10,Cáceres,59,Casillas de Coria,467,226,241
10,Cáceres,60,Castañar de Ibor,1198,627,571
10,Cáceres,61,Ceclavín,2038,1019,1019
10,Cáceres,62,Cedillo,490,251,239
10,Cáceres,63,Cerezo,193,95,98
10,Cáceres,64,Cilleros,1859,949,910
10,Cáceres,65,Collado,198,101,97
10,Cáceres,66,Conquista de la Sierra,212,120,92
10,Cáceres,67,Coria,12962,6405,6557
10,Cáceres,68,Cuacos de Yuste,908,464,444
10,Cáceres,69,Cumbre (La),970,475,495
10,Cáceres,70,Deleitosa,834,427,407
10,Cáceres,71,Descargamaría,195,100,95
10,Cáceres,72,Eljas,1013,517,496
10,Cáceres,73,Escurial,833,434,399
10,Cáceres,75,Fresnedoso de Ibor,331,166,165
10,Cáceres,76,Galisteo,1095,548,547
10,Cáceres,77,Garciaz,829,425,404
10,Cáceres,78,Garganta (La),505,275,230
10,Cáceres,79,Garganta la Olla,1038,551,487
10,Cáceres,80,Gargantilla,432,223,209
10,Cáceres,81,Gargüera,127,69,58
10,Cáceres,82,Garrovillas de Alconétar,2247,1099,1148
10,Cáceres,83,Garvín,97,52,45
10,Cáceres,84,Gata,1654,838,816
10,Cáceres,85,Gordo (El),373,190,183
10,Cáceres,86,Granja (La),366,194,172
10,Cáceres,87,Guadalupe,2090,1041,1049
10,Cáceres,88,Guijo de Coria,234,120,114
10,Cáceres,89,Guijo de Galisteo,1676,859,817
10,Cáceres,90,Guijo de Granadilla,620,306,314
10,Cáceres,91,Guijo de Santa Bárbara,416,218,198
10,Cáceres,92,Herguijuela,379,190,189
10,Cáceres,93,Hernán-Pérez,515,266,249
10,Cáceres,94,Herrera de Alcántara,277,138,139
10,Cáceres,95,Herreruela,378,187,191
10,Cáceres,96,Hervás,4156,2051,2105
10,Cáceres,97,Higuera,94,51,43
10,Cáceres,98,Hinojal,448,226,222
10,Cáceres,99,Holguera,765,390,375
10,Cáceres,100,Hoyos,981,494,487
10,Cáceres,101,Huélaga,197,100,97
10,Cáceres,102,Ibahernando,472,232,240
10,Cáceres,103,Jaraicejo,591,279,312
10,Cáceres,104,Jaraíz de la Vera,6863,3448,3415
10,Cáceres,105,Jarandilla de la Vera,3116,1546,1570
10,Cáceres,106,Jarilla,153,72,81
10,Cáceres,107,Jerte,1324,677,647
10,Cáceres,108,Ladrillar,225,116,109
10,Cáceres,109,Logrosán,2094,1073,1021
10,Cáceres,110,Losar de la Vera,2973,1514,1459
10,Cáceres,111,Madrigal de la Vera,1806,956,850
10,Cáceres,112,Madrigalejo,1932,963,969
10,Cáceres,113,Madroñera,2874,1426,1448
10,Cáceres,114,Majadas,1309,669,640
10,Cáceres,115,Malpartida de Cáceres,4433,2236,2197
10,Cáceres,116,Malpartida de Plasencia,4696,2346,2350
10,Cáceres,117,Marchagaz,246,124,122
10,Cáceres,118,Mata de Alcántara,328,168,160
10,Cáceres,119,Membrío,805,385,420
10,Cáceres,120,Mesas de Ibor,180,94,86
10,Cáceres,121,Miajadas,10323,5113,5210
10,Cáceres,122,Millanes,254,127,127
10,Cáceres,123,Mirabel,715,365,350
10,Cáceres,124,Mohedas de Granadilla,990,497,493
10,Cáceres,125,Monroy,984,514,470
10,Cáceres,126,Montánchez,1979,985,994
10,Cáceres,127,Montehermoso,5830,2985,2845
10,Cáceres,128,Moraleja,7185,3573,3612
10,Cáceres,129,Morcillo,423,203,220
10,Cáceres,130,Navaconcejo,2046,1021,1025
10,Cáceres,131,Navalmoral de la Mata,17309,8489,8820
10,Cáceres,132,Navalvillar de Ibor,504,256,248
10,Cáceres,133,Navas del Madroño,1441,721,720
10,Cáceres,134,Navezuelas,697,357,340
10,Cáceres,135,Nuñomoral,1436,774,662
10,Cáceres,136,Oliva de Plasencia,262,142,120
10,Cáceres,137,Palomero,450,231,219
10,Cáceres,138,Pasarón de la Vera,676,328,348
10,Cáceres,139,Pedroso de Acim,108,57,51
10,Cáceres,140,Peraleda de la Mata,1469,753,716
10,Cáceres,141,Peraleda de San Román,283,143,140
10,Cáceres,142,Perales del Puerto,984,493,491
10,Cáceres,143,Pescueza,160,76,84
10,Cáceres,144,Pesga (La),1124,584,540
10,Cáceres,145,Piedras Albas,194,105,89
10,Cáceres,146,Pinofranqueado,1654,889,765
10,Cáceres,147,Piornal,1525,760,765
10,Cáceres,148,Plasencia,41447,20216,21231
10,Cáceres,149,Plasenzuela,518,262,256
10,Cáceres,150,Portaje,419,212,207
10,Cáceres,151,Portezuelo,262,134,128
10,Cáceres,152,Pozuelo de Zarzón,568,278,290
10,Cáceres,153,Puerto de Santa Cruz,401,202,199
10,Cáceres,154,Rebollar,243,120,123
10,Cáceres,155,Riolobos,1386,732,654
10,Cáceres,156,Robledillo de Gata,119,65,54
10,Cáceres,157,Robledillo de la Vera,300,154,146
10,Cáceres,158,Robledillo de Trujillo,424,227,197
10,Cáceres,159,Robledollano,386,216,170
10,Cáceres,160,Romangordo,236,100,136
10,Cáceres,901,Rosalejo,1311,684,627
10,Cáceres,161,Ruanes,67,39,28
10,Cáceres,162,Salorino,687,353,334
10,Cáceres,163,Salvatierra de Santiago,289,139,150
10,Cáceres,164,San Martín de Trevejo,907,450,457
10,Cáceres,165,Santa Ana,291,152,139
10,Cáceres,166,Santa Cruz de la Sierra,269,133,136
10,Cáceres,167,Santa Cruz de Paniagua,307,168,139
10,Cáceres,168,Santa Marta de Magasca,309,151,158
10,Cáceres,169,Santiago de Alcántara,654,320,334
10,Cáceres,170,Santiago del Campo,306,156,150
10,Cáceres,171,Santibáñez el Alto,424,216,208
10,Cáceres,172,Santibáñez el Bajo,823,429,394
10,Cáceres,173,Saucedilla,857,444,413
10,Cáceres,174,Segura de Toro,192,90,102
10,Cáceres,175,Serradilla,1729,884,845
10,Cáceres,176,Serrejón,460,226,234
10,Cáceres,177,Sierra de Fuentes,2081,1068,1013
10,Cáceres,178,Talaván,922,469,453
10,Cáceres,179,Talaveruela de la Vera,341,169,172
10,Cáceres,180,Talayuela,9250,4974,4276
10,Cáceres,181,Tejeda de Tiétar,883,479,404
10,Cáceres,182,Toril,178,108,70
10,Cáceres,183,Tornavacas,1173,621,552
10,Cáceres,184,Torno (El),983,530,453
10,Cáceres,187,Torre de Don Miguel,552,292,260
10,Cáceres,188,Torre de Santa María,629,320,309
10,Cáceres,185,Torrecilla de los Ángeles,665,341,324
10,Cáceres,186,Torrecillas de la Tiesa,1189,601,588
10,Cáceres,190,Torrejón el Rubio,616,317,299
10,Cáceres,189,Torrejoncillo,3307,1607,1700
10,Cáceres,191,Torremenga,656,348,308
10,Cáceres,192,Torremocha,1022,493,529
10,Cáceres,193,Torreorgaz,1769,866,903
10,Cáceres,194,Torrequemada,622,294,328
10,Cáceres,195,Trujillo,9692,4742,4950
10,Cáceres,196,Valdastillas,368,196,172
10,Cáceres,197,Valdecañas de Tajo,113,67,46
10,Cáceres,198,Valdefuentes,1387,681,706
10,Cáceres,199,Valdehúncar,209,112,97
10,Cáceres,200,Valdelacasa de Tajo,446,216,230
10,Cáceres,201,Valdemorales,233,117,116
10,Cáceres,202,Valdeobispo,749,373,376
10,Cáceres,203,Valencia de Alcántara,6188,3081,3107
10,Cáceres,204,Valverde de la Vera,584,301,283
10,Cáceres,205,Valverde del Fresno,2481,1265,1216
10,Cáceres,902,Vegaviana,853,434,419
10,Cáceres,206,Viandar de la Vera,266,130,136
10,Cáceres,207,Villa del Campo,548,267,281
10,Cáceres,208,Villa del Rey,153,78,75
10,Cáceres,209,Villamesías,297,149,148
10,Cáceres,210,Villamiel,680,340,340
10,Cáceres,211,Villanueva de la Sierra,490,246,244
10,Cáceres,212,Villanueva de la Vera,2104,1065,1039
10,Cáceres,214,Villar de Plasencia,227,116,111
10,Cáceres,213,Villar del Pedroso,671,345,326
10,Cáceres,215,Villasbuenas de Gata,463,241,222
10,Cáceres,216,Zarza de Granadilla,1873,976,897
10,Cáceres,217,Zarza de Montánchez,605,294,311
10,Cáceres,218,Zarza la Mayor,1405,709,696
10,Cáceres,219,Zorita,1660,805,855
11,Cádiz,1,Alcalá de los Gazules,5592,2851,2741
11,Cádiz,2,Alcalá del Valle,5319,2691,2628
11,Cádiz,3,Algar,1538,801,737
11,Cádiz,4,Algeciras,116417,57625,58792
11,Cádiz,5,Algodonales,5743,2925,2818
11,Cádiz,6,Arcos de la Frontera,31449,15780,15669
11,Cádiz,7,Barbate,22977,11493,11484
11,Cádiz,8,Barrios (Los),22587,11384,11203
11,Cádiz,901,Benalup-Casas Viejas,7183,3642,3541
11,Cádiz,9,Benaocaz,754,392,362
11,Cádiz,10,Bornos,8109,4029,4080
11,Cádiz,11,Bosque (El),2098,1080,1018
11,Cádiz,12,Cádiz,125826,59731,66095
11,Cádiz,13,Castellar de la Frontera,3175,1600,1575
11,Cádiz,15,Chiclana de la Frontera,78591,39654,38937
11,Cádiz,16,Chipiona,18722,9395,9327
11,Cádiz,14,Conil de la Frontera,21331,10784,10547
11,Cádiz,17,Espera,3969,1985,1984
11,Cádiz,18,Gastor (El),1851,965,886
11,Cádiz,19,Grazalema,2203,1123,1080
11,Cádiz,20,Jerez de la Frontera,208896,102315,106581
11,Cádiz,21,Jimena de la Frontera,10440,5395,5045
11,Cádiz,22,Línea de la Concepción (La),64645,31933,32712
11,Cádiz,23,Medina-Sidonia,11741,6026,5715
11,Cádiz,24,Olvera,8570,4242,4328
11,Cádiz,25,Paterna de Rivera,5680,2919,2761
11,Cádiz,26,Prado del Rey,5948,2953,2995
11,Cádiz,27,Puerto de Santa María (El),88503,43631,44872
11,Cádiz,28,Puerto Real,40667,20548,20119
11,Cádiz,29,Puerto Serrano,7116,3609,3507
11,Cádiz,30,Rota,28904,14518,14386
11,Cádiz,31,San Fernando,96689,47714,48975
11,Cádiz,902,San José del Valle,4416,2250,2166
11,Cádiz,33,San Roque,29588,14927,14661
11,Cádiz,32,Sanlúcar de Barrameda,66541,33251,33290
11,Cádiz,34,Setenil de las Bodegas,2967,1515,1452
11,Cádiz,35,Tarifa,17768,9070,8698
11,Cádiz,36,Torre Alháquime,833,429,404
11,Cádiz,37,Trebujena,7034,3552,3482
11,Cádiz,38,Ubrique,16915,8312,8603
11,Cádiz,39,Vejer de la Frontera,12876,6489,6387
11,Cádiz,40,Villaluenga del Rosario,479,252,227
11,Cádiz,41,Villamartín,12570,6282,6288
11,Cádiz,42,Zahara,1519,771,748
39,Cantabria,1,Alfoz de Lloredo,2493,1260,1233
39,Cantabria,2,Ampuero,4183,2133,2050
39,Cantabria,3,Anievas,363,178,185
39,Cantabria,4,Arenas de Iguña,1814,930,884
39,Cantabria,5,Argoños,1663,866,797
39,Cantabria,6,Arnuero,2117,1072,1045
39,Cantabria,7,Arredondo,517,296,221
39,Cantabria,8,Astillero (El),17545,8624,8921
39,Cantabria,9,Bárcena de Cicero,3988,2074,1914
39,Cantabria,10,Bárcena de Pie de Concha,788,391,397
39,Cantabria,11,Bareyo,2053,1036,1017
39,Cantabria,12,Cabezón de la Sal,8322,4092,4230
39,Cantabria,13,Cabezón de Liébana,690,415,275
39,Cantabria,14,Cabuérniga,1086,567,519
39,Cantabria,15,Camaleño,1050,568,482
39,Cantabria,16,Camargo,31552,15653,15899
39,Cantabria,27,Campoo de Enmedio,3813,1978,1835
39,Cantabria,17,Campoo de Yuso,706,386,320
39,Cantabria,18,Cartes,5279,2704,2575
39,Cantabria,19,Castañeda,2293,1159,1134
39,Cantabria,20,Castro-Urdiales,32258,16341,15917
39,Cantabria,21,Cieza,615,309,306
39,Cantabria,22,Cillorigo de Liébana,1345,734,611
39,Cantabria,23,Colindres,7872,3930,3942
39,Cantabria,24,Comillas,2462,1171,1291
39,Cantabria,25,Corrales de Buelna (Los),11622,5784,5838
39,Cantabria,26,Corvera de Toranzo,2194,1111,1083
39,Cantabria,28,Entrambasaguas,4253,2199,2054
39,Cantabria,29,Escalante,755,398,357
39,Cantabria,30,Guriezo,2383,1244,1139
39,Cantabria,31,Hazas de Cesto,1484,755,729
39,Cantabria,32,Hermandad de Campoo de Suso,1809,991,818
39,Cantabria,33,Herrerías,649,364,285
39,Cantabria,34,Lamasón,310,197,113
39,Cantabria,35,Laredo,12378,5981,6397
39,Cantabria,36,Liendo,1246,640,606
39,Cantabria,37,Liérganes,2462,1238,1224
39,Cantabria,38,Limpias,1802,918,884
39,Cantabria,39,Luena,710,389,321
39,Cantabria,40,Marina de Cudeyo,5285,2677,2608
39,Cantabria,41,Mazcuerras,2118,1093,1025
39,Cantabria,42,Medio Cudeyo,7597,3717,3880
39,Cantabria,43,Meruelo,1709,880,829
39,Cantabria,44,Miengo,4540,2290,2250
39,Cantabria,45,Miera,442,232,210
39,Cantabria,46,Molledo,1655,814,841
39,Cantabria,47,Noja,2613,1316,1297
39,Cantabria,48,Penagos,1833,931,902
39,Cantabria,49,Peñarrubia,366,191,175
39,Cantabria,50,Pesaguero,345,197,148
39,Cantabria,51,Pesquera,72,40,32
39,Cantabria,52,Piélagos,21268,10675,10593
39,Cantabria,53,Polaciones,247,160,87
39,Cantabria,54,Polanco,5065,2530,2535
39,Cantabria,55,Potes,1511,751,760
39,Cantabria,56,Puente Viesgo,2807,1431,1376
39,Cantabria,57,Ramales de la Victoria,2650,1361,1289
39,Cantabria,58,Rasines,1058,578,480
39,Cantabria,59,Reinosa,10277,4864,5413
39,Cantabria,60,Reocín,8194,4054,4140
39,Cantabria,61,Ribamontán al Mar,4450,2260,2190
39,Cantabria,62,Ribamontán al Monte,2142,1110,1032
39,Cantabria,63,Rionansa,1113,637,476
39,Cantabria,64,Riotuerto,1617,801,816
39,Cantabria,65,Rozas de Valdearroyo (Las),271,154,117
39,Cantabria,66,Ruente,1048,565,483
39,Cantabria,67,Ruesga,1041,546,495
39,Cantabria,68,Ruiloba,790,404,386
39,Cantabria,69,San Felices de Buelna,2312,1153,1159
39,Cantabria,70,San Miguel de Aguayo,159,81,78
39,Cantabria,71,San Pedro del Romeral,522,282,240
39,Cantabria,72,San Roque de Riomiera,438,250,188
39,Cantabria,80,San Vicente de la Barquera,4508,2273,2235
39,Cantabria,73,Santa Cruz de Bezana,11607,5690,5917
39,Cantabria,74,Santa María de Cayón,8814,4554,4260
39,Cantabria,75,Santander,181589,84335,97254
39,Cantabria,76,Santillana del Mar,4040,1958,2082
39,Cantabria,77,Santiurde de Reinosa,293,170,123
39,Cantabria,78,Santiurde de Toranzo,1552,783,769
39,Cantabria,79,Santoña,11584,5739,5845
39,Cantabria,81,Saro,507,260,247
39,Cantabria,82,Selaya,2026,1012,1014
39,Cantabria,83,Soba,1367,733,634
39,Cantabria,84,Solórzano,1055,559,496
39,Cantabria,85,Suances,8365,4162,4203
39,Cantabria,86,Tojos (Los),449,257,192
39,Cantabria,87,Torrelavega,55888,26823,29065
39,Cantabria,88,Tresviso,78,49,29
39,Cantabria,89,Tudanca,185,126,59
39,Cantabria,90,Udías,869,449,420
39,Cantabria,95,Val de San Vicente,2814,1444,1370
39,Cantabria,91,Valdáliga,2314,1204,1110
39,Cantabria,92,Valdeolea,1176,608,568
39,Cantabria,93,Valdeprado del Río,306,172,134
39,Cantabria,94,Valderredible,1098,626,472
39,Cantabria,101,Valle de Villaverde,375,192,183
39,Cantabria,96,Vega de Liébana,846,452,394
39,Cantabria,97,Vega de Pas,860,442,418
39,Cantabria,98,Villacarriedo,1753,912,841
39,Cantabria,99,Villaescusa,3601,1814,1787
39,Cantabria,100,Villafufre,1140,588,552
39,Cantabria,102,Voto,2712,1444,1268
12,Castellón/Castelló,2,Aín,140,70,70
12,Castellón/Castelló,3,Albocàsser,1439,719,720
12,Castellón/Castelló,4,Alcalà de Xivert,7860,4013,3847
12,Castellón/Castelló,5,Alcora (l'),11029,5608,5421
12,Castellón/Castelló,6,Alcudia de Veo,225,112,113
12,Castellón/Castelló,7,Alfondeguilla,874,433,441
12,Castellón/Castelló,8,Algimia de Almonacid,326,185,141
12,Castellón/Castelló,9,Almazora/Almassora,25628,12968,12660
12,Castellón/Castelló,10,Almedíjar,267,132,135
12,Castellón/Castelló,11,Almenara,6007,3018,2989
12,Castellón/Castelló,901,Alquerías del Niño Perdido,4353,2141,2212
12,Castellón/Castelló,12,Altura,3949,2032,1917
12,Castellón/Castelló,13,Arañuel,200,96,104
12,Castellón/Castelló,14,Ares del Maestrat,206,111,95
12,Castellón/Castelló,15,Argelita,106,57,49
12,Castellón/Castelló,16,Artana,1971,1012,959
12,Castellón/Castelló,1,Atzeneta del Maestrat,1409,728,681
12,Castellón/Castelló,17,Ayódar,220,112,108
12,Castellón/Castelló,18,Azuébar,345,179,166
12,Castellón/Castelló,20,Barracas,190,101,89
12,Castellón/Castelló,22,Bejís,426,247,179
12,Castellón/Castelló,24,Benafer,179,94,85
12,Castellón/Castelló,25,Benafigos,158,88,70
12,Castellón/Castelló,26,Benasal,1297,657,640
12,Castellón/Castelló,27,Benicarló,26616,13455,13161
12,Castellón/Castelló,28,Benicasim/Benicàssim,18206,9204,9002
12,Castellón/Castelló,29,Benlloch,1181,627,554
12,Castellón/Castelló,21,Betxí,5938,2987,2951
12,Castellón/Castelló,32,Borriana/Burriana,34896,17494,17402
12,Castellón/Castelló,31,Borriol,5075,2562,2513
12,Castellón/Castelló,33,Cabanes,3089,1575,1514
12,Castellón/Castelló,34,Càlig,2217,1136,1081
12,Castellón/Castelló,36,Canet lo Roig,870,434,436
12,Castellón/Castelló,37,Castell de Cabres,16,8,8
12,Castellón/Castelló,38,Castellfort,240,126,114
12,Castellón/Castelló,39,Castellnovo,1071,538,533
12,Castellón/Castelló,40,Castellón de la Plana/Castelló de la Plana,180690,89006,91684
12,Castellón/Castelló,41,Castillo de Villamalefa,102,54,48
12,Castellón/Castelló,42,Catí,863,442,421
12,Castellón/Castelló,43,Caudiel,766,388,378
12,Castellón/Castelló,44,Cervera del Maestre,717,352,365
12,Castellón/Castelló,52,Chert/Xert,897,451,446
12,Castellón/Castelló,53,Chilches/Xilxes,2894,1501,1393
12,Castellón/Castelló,55,Chodos/Xodos,126,66,60
12,Castellón/Castelló,56,Chóvar,349,181,168
12,Castellón/Castelló,45,Cinctorres,493,240,253
12,Castellón/Castelló,46,Cirat,257,146,111
12,Castellón/Castelló,48,Cortes de Arenoso,349,184,165
12,Castellón/Castelló,49,Costur,588,304,284
12,Castellón/Castelló,50,Coves de Vinromà (les),2038,1023,1015
12,Castellón/Castelló,51,Culla,633,329,304
12,Castellón/Castelló,57,Eslida,907,449,458
12,Castellón/Castelló,58,Espadilla,85,37,48
12,Castellón/Castelló,59,Fanzara,370,187,183
12,Castellón/Castelló,60,Figueroles,590,297,293
12,Castellón/Castelló,61,Forcall,538,264,274
12,Castellón/Castelló,63,Fuente la Reina,49,25,24
12,Castellón/Castelló,64,Fuentes de Ayódar,142,77,65
12,Castellón/Castelló,65,Gaibiel,199,107,92
12,Castellón/Castelló,67,Geldo,708,364,344
12,Castellón/Castelló,68,Herbés,56,32,24
12,Castellón/Castelló,69,Higueras,50,26,24
12,Castellón/Castelló,70,Jana (la),799,407,392
12,Castellón/Castelló,71,Jérica,1690,847,843
12,Castellón/Castelló,74,Llosa (la),983,499,484
12,Castellón/Castelló,72,Lucena del Cid,1532,772,760
12,Castellón/Castelló,73,Ludiente,197,102,95
12,Castellón/Castelló,75,Mata de Morella (la),195,101,94
12,Castellón/Castelló,76,Matet,114,59,55
12,Castellón/Castelló,77,Moncofa,6107,3117,2990
12,Castellón/Castelló,78,Montán,443,216,227
12,Castellón/Castelló,79,Montanejos,618,305,313
12,Castellón/Castelló,80,Morella,2834,1416,1418
12,Castellón/Castelló,81,Navajas,813,415,398
12,Castellón/Castelló,82,Nules,13750,6908,6842
12,Castellón/Castelló,83,Olocau del Rey,144,77,67
12,Castellón/Castelló,84,Onda,25778,13142,12636
12,Castellón/Castelló,85,Oropesa del Mar/Orpesa,10787,5845,4942
12,Castellón/Castelló,87,Palanques,34,19,15
12,Castellón/Castelló,88,Pavías,62,33,29
12,Castellón/Castelló,89,Peníscola/Peñíscola,8051,4138,3913
12,Castellón/Castelló,90,Pina de Montalgrao,148,78,70
12,Castellón/Castelló,93,Pobla de Benifassà (la),283,145,138
12,Castellón/Castelló,94,Pobla Tornesa (la),1156,597,559
12,Castellón/Castelló,91,Portell de Morella,244,119,125
12,Castellón/Castelló,92,Puebla de Arenoso,201,118,83
12,Castellón/Castelló,95,Ribesalbes,1359,682,677
12,Castellón/Castelló,96,Rossell,1189,638,551
12,Castellón/Castelló,97,Sacañet,78,46,32
12,Castellón/Castelló,98,Salzadella (la),850,421,429
12,Castellón/Castelló,101,San Rafael del Río,550,282,268
12,Castellón/Castelló,902,Sant Joan de Moró,2910,1534,1376
12,Castellón/Castelló,99,Sant Jordi/San Jorge,1078,562,516
12,Castellón/Castelló,100,Sant Mateu,2169,1132,1037
12,Castellón/Castelló,102,Santa Magdalena de Pulpis,841,448,393
12,Castellón/Castelló,103,Sarratella,102,54,48
12,Castellón/Castelló,104,Segorbe,9267,4560,4707
12,Castellón/Castelló,105,Sierra Engarcerán,1032,551,481
12,Castellón/Castelló,106,Soneja,1542,768,774
12,Castellón/Castelló,107,Sot de Ferrer,460,239,221
12,Castellón/Castelló,108,Sueras/Suera,680,343,337
12,Castellón/Castelló,109,Tales,893,447,446
12,Castellón/Castelló,110,Teresa,288,147,141
12,Castellón/Castelló,111,Tírig,557,294,263
12,Castellón/Castelló,112,Todolella,137,79,58
12,Castellón/Castelló,113,Toga,113,55,58
12,Castellón/Castelló,114,Torás,253,135,118
12,Castellón/Castelló,115,Toro (El),297,168,129
12,Castellón/Castelló,116,Torralba del Pinar,64,34,30
12,Castellón/Castelló,119,Torre d'En Besora (la),182,101,81
12,Castellón/Castelló,120,Torre d'en Doménec (la),247,123,124
12,Castellón/Castelló,117,Torreblanca,5767,2990,2777
12,Castellón/Castelló,118,Torrechiva,96,57,39
12,Castellón/Castelló,121,Traiguera,1701,886,815
12,Castellón/Castelló,122,Useras/Useres (les),995,521,474
12,Castellón/Castelló,124,Vall d'Alba,2954,1543,1411
12,Castellón/Castelló,125,Vall de Almonacid,278,150,128
12,Castellón/Castelló,126,Vall d'Uixó (la),32983,16352,16631
12,Castellón/Castelló,123,Vallat,76,39,37
12,Castellón/Castelló,127,Vallibona,100,50,50
12,Castellón/Castelló,128,Vilafamés,1984,1043,941
12,Castellón/Castelló,132,Vilanova d'Alcolea,698,364,334
12,Castellón/Castelló,134,Vilar de Canes,181,97,84
12,Castellón/Castelló,135,Vila-real,51367,25812,25555
12,Castellón/Castelló,136,Vilavella (la),3357,1683,1674
12,Castellón/Castelló,129,Villafranca del Cid/Vilafranca,2540,1246,1294
12,Castellón/Castelló,130,Villahermosa del Río,456,241,215
12,Castellón/Castelló,131,Villamalur,102,53,49
12,Castellón/Castelló,133,Villanueva de Viver,69,38,31
12,Castellón/Castelló,137,Villores,51,29,22
12,Castellón/Castelló,138,Vinaròs,28291,14116,14175
12,Castellón/Castelló,139,Vistabella del Maestrazgo,421,219,202
12,Castellón/Castelló,140,Viver,1695,879,816
12,Castellón/Castelló,141,Zorita del Maestrazgo,150,71,79
12,Castellón/Castelló,142,Zucaina,186,102,84
13,Ciudad Real,1,Abenójar,1598,818,780
13,Ciudad Real,2,Agudo,1871,946,925
13,Ciudad Real,3,Alamillo,535,266,269
13,Ciudad Real,4,Albaladejo,1506,786,720
13,Ciudad Real,5,Alcázar de San Juan,31120,15413,15707
13,Ciudad Real,6,Alcoba,717,365,352
13,Ciudad Real,7,Alcolea de Calatrava,1627,826,801
13,Ciudad Real,8,Alcubillas,582,299,283
13,Ciudad Real,9,Aldea del Rey,2003,1024,979
13,Ciudad Real,10,Alhambra,1114,564,550
13,Ciudad Real,11,Almadén,6175,2981,3194
13,Ciudad Real,12,Almadenejos,468,241,227
13,Ciudad Real,13,Almagro,8855,4362,4493
13,Ciudad Real,14,Almedina,692,351,341
13,Ciudad Real,15,Almodóvar del Campo,6775,3385,3390
13,Ciudad Real,16,Almuradiel,891,432,459
13,Ciudad Real,17,Anchuras,359,205,154
13,Ciudad Real,903,Arenales de San Gregorio,712,364,348
13,Ciudad Real,18,Arenas de San Juan,1044,538,506
13,Ciudad Real,19,Argamasilla de Alba,7415,3785,3630
13,Ciudad Real,20,Argamasilla de Calatrava,5928,3029,2899
13,Ciudad Real,21,Arroba de los Montes,523,277,246
13,Ciudad Real,22,Ballesteros de Calatrava,491,248,243
13,Ciudad Real,23,Bolaños de Calatrava,12236,6270,5966
13,Ciudad Real,24,Brazatortas,1119,581,538
13,Ciudad Real,25,Cabezarados,350,182,168
13,Ciudad Real,26,Cabezarrubias del Puerto,561,289,272
13,Ciudad Real,27,Calzada de Calatrava,4458,2233,2225
13,Ciudad Real,28,Campo de Criptana,15048,7710,7338
13,Ciudad Real,29,Cañada de Calatrava,123,70,53
13,Ciudad Real,30,Caracuel de Calatrava,169,88,81
13,Ciudad Real,31,Carrión de Calatrava,2937,1483,1454
13,Ciudad Real,32,Carrizosa,1466,735,731
13,Ciudad Real,33,Castellar de Santiago,2223,1110,1113
13,Ciudad Real,38,Chillón,2030,988,1042
13,Ciudad Real,34,Ciudad Real,74345,35282,39063
13,Ciudad Real,35,Corral de Calatrava,1221,611,610
13,Ciudad Real,36,Cortijos (Los),985,509,476
13,Ciudad Real,37,Cózar,1238,623,615
13,Ciudad Real,39,Daimiel,18656,9289,9367
13,Ciudad Real,40,Fernán Caballero,1148,564,584
13,Ciudad Real,41,Fontanarejo,307,164,143
13,Ciudad Real,42,Fuencaliente,1126,597,529
13,Ciudad Real,43,Fuenllana,301,152,149
13,Ciudad Real,44,Fuente el Fresno,3622,1869,1753
13,Ciudad Real,45,Granátula de Calatrava,926,448,478
13,Ciudad Real,46,Guadalmez,866,440,426
13,Ciudad Real,47,Herencia,9215,4757,4458
13,Ciudad Real,48,Hinojosas de Calatrava,568,289,279
13,Ciudad Real,49,Horcajo de los Montes,1022,513,509
13,Ciudad Real,50,Labores (Las),659,336,323
13,Ciudad Real,904,Llanos del Caudillo,724,371,353
13,Ciudad Real,51,Luciana,419,216,203
13,Ciudad Real,52,Malagón,8731,4392,4339
13,Ciudad Real,53,Manzanares,19242,9568,9674
13,Ciudad Real,54,Membrilla,6362,3217,3145
13,Ciudad Real,55,Mestanza,796,377,419
13,Ciudad Real,56,Miguelturra,14312,7267,7045
13,Ciudad Real,57,Montiel,1570,819,751
13,Ciudad Real,58,Moral de Calatrava,5701,2845,2856
13,Ciudad Real,59,Navalpino,268,133,135
13,Ciudad Real,60,Navas de Estena,355,203,152
13,Ciudad Real,61,Pedro Muñoz,8684,4585,4099
13,Ciudad Real,62,Picón,695,359,336
13,Ciudad Real,63,Piedrabuena,4809,2461,2348
13,Ciudad Real,64,Poblete,1850,959,891
13,Ciudad Real,65,Porzuna,4065,2081,1984
13,Ciudad Real,66,Pozuelo de Calatrava,3064,1553,1511
13,Ciudad Real,67,Pozuelos de Calatrava (Los),443,220,223
13,Ciudad Real,68,Puebla de Don Rodrigo,1253,679,574
13,Ciudad Real,69,Puebla del Príncipe,853,425,428
13,Ciudad Real,70,Puerto Lápice,1022,506,516
13,Ciudad Real,71,Puertollano,52300,25577,26723
13,Ciudad Real,72,Retuerta del Bullaque,1173,661,512
13,Ciudad Real,901,Robledo (El),1314,691,623
13,Ciudad Real,902,Ruidera,588,299,289
13,Ciudad Real,73,Saceruela,652,338,314
13,Ciudad Real,74,San Carlos del Valle,1201,613,588
13,Ciudad Real,75,San Lorenzo de Calatrava,266,138,128
13,Ciudad Real,76,Santa Cruz de los Cáñamos,593,297,296
13,Ciudad Real,77,Santa Cruz de Mudela,4614,2288,2326
13,Ciudad Real,78,Socuéllamos,13651,7016,6635
13,Ciudad Real,79,Solana (La),16324,8315,8009
13,Ciudad Real,80,Solana del Pino,414,211,203
13,Ciudad Real,81,Terrinches,925,511,414
13,Ciudad Real,82,Tomelloso,38641,19556,19085
13,Ciudad Real,83,Torralba de Calatrava,3104,1515,1589
13,Ciudad Real,84,Torre de Juan Abad,1240,595,645
13,Ciudad Real,85,Torrenueva,2991,1503,1488
13,Ciudad Real,86,Valdemanco del Esteras,241,125,116
13,Ciudad Real,87,Valdepeñas,31370,15512,15858
13,Ciudad Real,88,Valenzuela de Calatrava,782,367,415
13,Ciudad Real,89,Villahermosa,2202,1042,1160
13,Ciudad Real,90,Villamanrique,1383,688,695
13,Ciudad Real,91,Villamayor de Calatrava,618,312,306
13,Ciudad Real,92,Villanueva de la Fuente,2490,1267,1223
13,Ciudad Real,93,Villanueva de los Infantes,5772,2888,2884
13,Ciudad Real,94,Villanueva de San Carlos,373,198,175
13,Ciudad Real,95,Villar del Pozo,103,52,51
13,Ciudad Real,96,Villarrubia de los Ojos,11119,5618,5501
13,Ciudad Real,97,Villarta de San Juan,3061,1568,1493
13,Ciudad Real,98,Viso del Marqués,2804,1414,1390
14,Córdoba,1,Adamuz,4414,2273,2141
14,Córdoba,2,Aguilar de la Frontera,13693,6855,6838
14,Córdoba,3,Alcaracejos,1548,767,781
14,Córdoba,4,Almedinilla,2524,1282,1242
14,Córdoba,5,Almodóvar del Río,7916,3955,3961
14,Córdoba,6,Añora,1540,761,779
14,Córdoba,7,Baena,20862,10527,10335
14,Córdoba,8,Belalcázar,3458,1658,1800
14,Córdoba,9,Belmez,3207,1569,1638
14,Córdoba,10,Benamejí,5184,2595,2589
14,Córdoba,11,Blázquez (Los),728,384,344
14,Córdoba,12,Bujalance,7910,3932,3978
14,Córdoba,13,Cabra,21266,10447,10819
14,Córdoba,14,Cañete de las Torres,3133,1598,1535
14,Córdoba,15,Carcabuey,2685,1349,1336
14,Córdoba,16,Cardeña,1732,875,857
14,Córdoba,17,Carlota (La),13469,6765,6704
14,Córdoba,18,Carpio (El),4596,2268,2328
14,Córdoba,19,Castro del Río,8095,4029,4066
14,Córdoba,20,Conquista,470,227,243
14,Córdoba,21,Córdoba,328547,158082,170465
14,Córdoba,22,Doña Mencía,5029,2475,2554
14,Córdoba,23,Dos Torres,2563,1268,1295
14,Córdoba,24,Encinas Reales,2419,1188,1231
14,Córdoba,25,Espejo,3622,1820,1802
14,Córdoba,26,Espiel,2484,1252,1232
14,Córdoba,27,Fernán-Núñez,9736,4876,4860
14,Córdoba,28,Fuente la Lancha,374,191,183
14,Córdoba,29,Fuente Obejuna,5225,2664,2561
14,Córdoba,30,Fuente Palmera,10865,5481,5384
14,Córdoba,31,Fuente-Tójar,772,367,405
14,Córdoba,32,Granjuela (La),522,266,256
14,Córdoba,33,Guadalcázar,1593,792,801
14,Córdoba,34,Guijo (El),429,218,211
14,Córdoba,35,Hinojosa del Duque,7366,3563,3803
14,Córdoba,36,Hornachuelos,4696,2385,2311
14,Córdoba,37,Iznájar,4714,2356,2358
14,Córdoba,38,Lucena,42308,21095,21213
14,Córdoba,39,Luque,3379,1709,1670
14,Córdoba,40,Montalbán de Córdoba,4542,2297,2245
14,Córdoba,41,Montemayor,4114,2056,2058
14,Córdoba,42,Montilla,23907,11848,12059
14,Córdoba,43,Montoro,9915,4906,5009
14,Córdoba,44,Monturque,2009,1004,1005
14,Córdoba,45,Moriles,3950,1958,1992
14,Córdoba,46,Nueva Carteya,5679,2870,2809
14,Córdoba,47,Obejo,1876,967,909
14,Córdoba,48,Palenciana,1607,803,804
14,Córdoba,49,Palma del Río,21605,10816,10789
14,Córdoba,50,Pedro Abad,2983,1509,1474
14,Córdoba,51,Pedroche,1660,821,839
14,Córdoba,52,Peñarroya-Pueblonuevo,11814,5714,6100
14,Córdoba,53,Posadas,7590,3789,3801
14,Córdoba,54,Pozoblanco,17796,8726,9070
14,Córdoba,55,Priego de Córdoba,23563,11590,11973
14,Córdoba,56,Puente Genil,30245,15048,15197
14,Córdoba,57,Rambla (La),7600,3831,3769
14,Córdoba,58,Rute,10563,5257,5306
14,Córdoba,59,San Sebastián de los Ballesteros,832,426,406
14,Córdoba,61,Santa Eufemia,960,495,465
14,Córdoba,60,Santaella,6182,3128,3054
14,Córdoba,62,Torrecampo,1291,625,666
14,Córdoba,63,Valenzuela,1317,647,670
14,Córdoba,64,Valsequillo,401,197,204
14,Córdoba,65,Victoria (La),2278,1129,1149
14,Córdoba,66,Villa del Río,7451,3755,3696
14,Córdoba,67,Villafranca de Córdoba,4660,2387,2273
14,Córdoba,68,Villaharta,762,385,377
14,Córdoba,69,Villanueva de Córdoba,9599,4772,4827
14,Córdoba,70,Villanueva del Duque,1618,802,816
14,Córdoba,71,Villanueva del Rey,1206,611,595
14,Córdoba,72,Villaralto,1315,645,670
14,Córdoba,73,Villaviciosa de Córdoba,3556,1809,1747
14,Córdoba,74,Viso (El),2822,1396,1426
14,Córdoba,75,Zuheros,767,387,380
15,Coruña (A),1,Abegondo,5765,2861,2904
15,Coruña (A),2,Ames,27900,13527,14373
15,Coruña (A),3,Aranga,2126,1072,1054
15,Coruña (A),4,Ares,5705,2811,2894
15,Coruña (A),5,Arteixo,30255,15144,15111
15,Coruña (A),6,Arzúa,6409,3191,3218
15,Coruña (A),7,Baña (A),4320,2053,2267
15,Coruña (A),8,Bergondo,6758,3258,3500
15,Coruña (A),9,Betanzos,13673,6535,7138
15,Coruña (A),10,Boimorto,2271,1150,1121
15,Coruña (A),11,Boiro,19076,9304,9772
15,Coruña (A),12,Boqueixón,4444,2190,2254
15,Coruña (A),13,Brión,7347,3574,3773
15,Coruña (A),14,Cabana de Bergantiños,4909,2404,2505
15,Coruña (A),15,Cabanas,3375,1676,1699
15,Coruña (A),16,Camariñas,6226,3087,3139
15,Coruña (A),17,Cambre,23621,11599,12022
15,Coruña (A),18,Capela (A),1399,698,701
15,Coruña (A),19,Carballo,31149,15217,15932
15,Coruña (A),901,Cariño,4530,2223,2307
15,Coruña (A),20,Carnota,4904,2354,2550
15,Coruña (A),21,Carral,5945,2913,3032
15,Coruña (A),22,Cedeira,7412,3720,3692
15,Coruña (A),23,Cee,7818,3769,4049
15,Coruña (A),24,Cerceda,5486,2657,2829
15,Coruña (A),25,Cerdido,1361,664,697
15,Coruña (A),26,Cesuras,2209,1086,1123
15,Coruña (A),27,Coirós,1722,842,880
15,Coruña (A),28,Corcubión,1803,876,927
15,Coruña (A),29,Coristanco,7165,3482,3683
15,Coruña (A),30,Coruña (A),246047,114407,131640
15,Coruña (A),31,Culleredo,28737,14009,14728
15,Coruña (A),32,Curtis,4228,2106,2122
15,Coruña (A),33,Dodro,3017,1462,1555
15,Coruña (A),34,Dumbría,3705,1776,1929
15,Coruña (A),35,Fene,14092,6780,7312
15,Coruña (A),36,Ferrol,73638,34585,39053
15,Coruña (A),37,Fisterra,4995,2531,2464
15,Coruña (A),38,Frades,2648,1316,1332
15,Coruña (A),39,Irixoa,1501,753,748
15,Coruña (A),41,Laracha (A),11213,5476,5737
15,Coruña (A),40,Laxe,3417,1706,1711
15,Coruña (A),42,Lousame,3699,1759,1940
15,Coruña (A),43,Malpica de Bergantiños,6178,2990,3188
15,Coruña (A),44,Mañón,1602,787,815
15,Coruña (A),45,Mazaricos,4854,2339,2515
15,Coruña (A),46,Melide,7838,3869,3969
15,Coruña (A),47,Mesía,2918,1473,1445
15,Coruña (A),48,Miño,5628,2770,2858
15,Coruña (A),49,Moeche,1401,659,742
15,Coruña (A),50,Monfero,2239,1135,1104
15,Coruña (A),51,Mugardos,5536,2698,2838
15,Coruña (A),53,Muros,9704,4702,5002
15,Coruña (A),52,Muxía,5423,2637,2786
15,Coruña (A),54,Narón,38285,18614,19671
15,Coruña (A),55,Neda,5489,2671,2818
15,Coruña (A),56,Negreira,7029,3390,3639
15,Coruña (A),57,Noia,14947,7158,7789
15,Coruña (A),58,Oleiros,33550,16338,17212
15,Coruña (A),59,Ordes,12868,6317,6551
15,Coruña (A),60,Oroso,7050,3521,3529
15,Coruña (A),61,Ortigueira,6871,3295,3576
15,Coruña (A),62,Outes,7313,3506,3807
15,Coruña (A),63,Oza dos Ríos,3198,1588,1610
15,Coruña (A),64,Paderne,2653,1303,1350
15,Coruña (A),65,Padrón,8985,4312,4673
15,Coruña (A),66,Pino (O),4718,2336,2382
15,Coruña (A),67,Pobra do Caramiñal (A),9858,4784,5074
15,Coruña (A),68,Ponteceso,6215,3116,3099
15,Coruña (A),69,Pontedeume,8370,4039,4331
15,Coruña (A),70,Pontes de García Rodríguez (As),11336,5657,5679
15,Coruña (A),71,Porto do Son,9873,4936,4937
15,Coruña (A),72,Rianxo,11826,5801,6025
15,Coruña (A),73,Ribeira,27504,13634,13870
15,Coruña (A),74,Rois,4936,2337,2599
15,Coruña (A),75,Sada,14734,7268,7466
15,Coruña (A),76,San Sadurniño,3098,1536,1562
15,Coruña (A),77,Santa Comba,10408,5014,5394
15,Coruña (A),78,Santiago de Compostela,94824,44162,50662
15,Coruña (A),79,Santiso,1930,1001,929
15,Coruña (A),80,Sobrado,2139,1082,1057
15,Coruña (A),81,Somozas (As),1342,686,656
15,Coruña (A),82,Teo,17940,8821,9119
15,Coruña (A),83,Toques,1387,722,665
15,Coruña (A),84,Tordoia,4268,1998,2270
15,Coruña (A),85,Touro,4151,2053,2098
15,Coruña (A),86,Trazo,3496,1718,1778
15,Coruña (A),88,Val do Dubra,4386,2124,2262
15,Coruña (A),87,Valdoviño,6982,3414,3568
15,Coruña (A),89,Vedra,5052,2447,2605
15,Coruña (A),91,Vilarmaior,1277,658,619
15,Coruña (A),90,Vilasantar,1406,730,676
15,Coruña (A),92,Vimianzo,8128,3972,4156
15,Coruña (A),93,Zas,5295,2597,2698
16,Cuenca,1,Abia de la Obispalía,73,47,26
16,Cuenca,2,Acebrón (El),286,148,138
16,Cuenca,3,Alarcón,177,81,96
16,Cuenca,4,Albaladejo del Cuende,336,176,160
16,Cuenca,5,Albalate de las Nogueras,302,174,128
16,Cuenca,6,Albendea,164,78,86
16,Cuenca,7,Alberca de Záncara (La),1976,1027,949
16,Cuenca,8,Alcalá de la Vega,139,73,66
16,Cuenca,9,Alcantud,89,47,42
16,Cuenca,10,Alcázar del Rey,208,105,103
16,Cuenca,11,Alcohujate,41,24,17
16,Cuenca,12,Alconchel de la Estrella,137,77,60
16,Cuenca,13,Algarra,24,16,8
16,Cuenca,14,Aliaguilla,782,402,380
16,Cuenca,15,Almarcha (La),533,286,247
16,Cuenca,16,Almendros,295,157,138
16,Cuenca,17,Almodóvar del Pinar,465,245,220
16,Cuenca,18,Almonacid del Marquesado,486,254,232
16,Cuenca,19,Altarejos,248,125,123
16,Cuenca,20,Arandilla del Arroyo,25,17,8
16,Cuenca,905,Arcas del Villar,1354,688,666
16,Cuenca,22,Arcos de la Sierra,107,56,51
16,Cuenca,24,Arguisuelas,157,87,70
16,Cuenca,25,Arrancacepas,33,18,15
16,Cuenca,26,Atalaya del Cañavate,115,59,56
16,Cuenca,27,Barajas de Melo,1065,552,513
16,Cuenca,29,Barchín del Hoyo,88,48,40
16,Cuenca,30,Bascuñana de San Pedro,27,17,10
16,Cuenca,31,Beamud,72,37,35
16,Cuenca,32,Belinchón,363,188,175
16,Cuenca,33,Belmonte,2234,1110,1124
16,Cuenca,34,Belmontejo,208,107,101
16,Cuenca,35,Beteta,327,159,168
16,Cuenca,36,Boniches,151,71,80
16,Cuenca,38,Buciegas,54,27,27
16,Cuenca,39,Buenache de Alarcón,639,342,297
16,Cuenca,40,Buenache de la Sierra,111,68,43
16,Cuenca,41,Buendía,485,254,231
16,Cuenca,42,Campillo de Altobuey,1576,774,802
16,Cuenca,43,Campillos-Paravientos,127,67,60
16,Cuenca,44,Campillos-Sierra,61,30,31
16,Cuenca,901,Campos del Paraíso,964,479,485
16,Cuenca,45,Canalejas del Arroyo,323,171,152
16,Cuenca,46,Cañada del Hoyo,313,162,151
16,Cuenca,47,Cañada Juncosa,303,169,134
16,Cuenca,48,Cañamares,549,310,239
16,Cuenca,49,Cañavate (El),161,82,79
16,Cuenca,50,Cañaveras,368,194,174
16,Cuenca,51,Cañaveruelas,181,95,86
16,Cuenca,52,Cañete,960,492,468
16,Cuenca,53,Cañizares,549,290,259
16,Cuenca,55,Carboneras de Guadazaón,835,432,403
16,Cuenca,56,Cardenete,623,327,296
16,Cuenca,57,Carrascosa,107,68,39
16,Cuenca,58,Carrascosa de Haro,132,66,66
16,Cuenca,60,Casas de Benítez,1055,515,540
16,Cuenca,61,Casas de Fernando Alonso,1503,801,702
16,Cuenca,62,Casas de Garcimolina,32,18,14
16,Cuenca,63,Casas de Guijarro,153,84,69
16,Cuenca,64,Casas de Haro,888,465,423
16,Cuenca,65,Casas de los Pinos,531,253,278
16,Cuenca,66,Casasimarro,3361,1749,1612
16,Cuenca,67,Castejón,200,96,104
16,Cuenca,68,Castillejo de Iniesta,184,100,84
16,Cuenca,70,Castillejo-Sierra,36,20,16
16,Cuenca,72,Castillo de Garcimuñoz,179,99,80
16,Cuenca,71,Castillo-Albaráñez,22,10,12
16,Cuenca,73,Cervera del Llano,271,145,126
16,Cuenca,23,Chillarón de Cuenca,547,285,262
16,Cuenca,81,Chumillas,68,39,29
16,Cuenca,74,Cierva (La),53,32,21
16,Cuenca,78,Cuenca,56189,27136,29053
16,Cuenca,79,Cueva del Hierro,41,27,14
16,Cuenca,82,Enguídanos,426,225,201
16,Cuenca,83,Fresneda de Altarejos,67,35,32
16,Cuenca,84,Fresneda de la Sierra,57,28,29
16,Cuenca,85,Frontera (La),185,99,86
16,Cuenca,86,Fuente de Pedro Naharro,1330,694,636
16,Cuenca,87,Fuentelespino de Haro,282,146,136
16,Cuenca,88,Fuentelespino de Moya,148,78,70
16,Cuenca,904,Fuentenava de Jábaga,556,296,260
16,Cuenca,89,Fuentes,514,274,240
16,Cuenca,91,Fuertescusa,88,47,41
16,Cuenca,92,Gabaldón,201,113,88
16,Cuenca,93,Garaballa,110,61,49
16,Cuenca,94,Gascueña,188,96,92
16,Cuenca,95,Graja de Campalbo,120,61,59
16,Cuenca,96,Graja de Iniesta,461,231,230
16,Cuenca,97,Henarejos,207,100,107
16,Cuenca,98,Herrumblar (El),756,383,373
16,Cuenca,99,Hinojosa (La),263,135,128
16,Cuenca,100,Hinojosos (Los),1001,495,506
16,Cuenca,101,Hito (El),187,98,89
16,Cuenca,102,Honrubia,1761,897,864
16,Cuenca,103,Hontanaya,373,202,171
16,Cuenca,104,Hontecillas,77,38,39
16,Cuenca,106,Horcajo de Santiago,4162,2188,1974
16,Cuenca,107,Huélamo,122,68,54
16,Cuenca,108,Huelves,78,40,38
16,Cuenca,109,Huérguina,60,31,29
16,Cuenca,110,Huerta de la Obispalía,127,71,56
16,Cuenca,111,Huerta del Marquesado,217,131,86
16,Cuenca,112,Huete,2034,1035,999
16,Cuenca,113,Iniesta,4694,2355,2339
16,Cuenca,115,Laguna del Marquesado,68,35,33
16,Cuenca,116,Lagunaseca,87,44,43
16,Cuenca,117,Landete,1376,709,667
16,Cuenca,118,Ledaña,1931,955,976
16,Cuenca,119,Leganiel,224,118,106
16,Cuenca,121,Majadas (Las),320,161,159
16,Cuenca,122,Mariana,282,134,148
16,Cuenca,123,Masegosa,101,56,45
16,Cuenca,124,Mesas (Las),2563,1327,1236
16,Cuenca,125,Minglanilla,2669,1409,1260
16,Cuenca,126,Mira,847,431,416
16,Cuenca,128,Monreal del Llano,79,41,38
16,Cuenca,129,Montalbanejo,139,67,72
16,Cuenca,130,Montalbo,754,396,358
16,Cuenca,131,Monteagudo de las Salinas,159,93,66
16,Cuenca,132,Mota de Altarejos,44,27,17
16,Cuenca,133,Mota del Cuervo,6304,3200,3104
16,Cuenca,134,Motilla del Palancar,6195,3154,3041
16,Cuenca,135,Moya,194,104,90
16,Cuenca,137,Narboneta,55,33,22
16,Cuenca,139,Olivares de Júcar,410,214,196
16,Cuenca,140,Olmeda de la Cuesta,37,16,21
16,Cuenca,141,Olmeda del Rey,168,84,84
16,Cuenca,142,Olmedilla de Alarcón,154,88,66
16,Cuenca,143,Olmedilla de Eliz,23,11,12
16,Cuenca,145,Osa de la Vega,616,318,298
16,Cuenca,146,Pajarón,95,49,46
16,Cuenca,147,Pajaroncillo,84,45,39
16,Cuenca,148,Palomares del Campo,789,406,383
16,Cuenca,149,Palomera,194,102,92
16,Cuenca,150,Paracuellos,132,62,70
16,Cuenca,151,Paredes,90,52,38
16,Cuenca,152,Parra de las Vegas (La),36,21,15
16,Cuenca,153,Pedernoso (El),1304,668,636
16,Cuenca,154,Pedroñeras (Las),7228,3840,3388
16,Cuenca,155,Peral (El),822,465,357
16,Cuenca,156,Peraleja (La),127,67,60
16,Cuenca,157,Pesquera (La),242,130,112
16,Cuenca,158,Picazo (El),771,389,382
16,Cuenca,159,Pinarejo,306,154,152
16,Cuenca,160,Pineda de Gigüela,85,42,43
16,Cuenca,161,Piqueras del Castillo,73,36,37
16,Cuenca,162,Portalrubio de Guadamejud,40,21,19
16,Cuenca,163,Portilla,81,38,43
16,Cuenca,165,Poyatos,93,56,37
16,Cuenca,166,Pozoamargo,382,194,188
16,Cuenca,908,Pozorrubielos de la Mancha,334,166,168
16,Cuenca,167,Pozorrubio,387,189,198
16,Cuenca,169,Pozuelo (El),92,48,44
16,Cuenca,170,Priego,1124,572,552
16,Cuenca,171,Provencio (El),2771,1377,1394
16,Cuenca,172,Puebla de Almenara,456,235,221
16,Cuenca,173,Puebla de Don Francisco,326,181,145
16,Cuenca,174,Puebla del Salvador,265,147,118
16,Cuenca,175,Quintanar del Rey,7910,4148,3762
16,Cuenca,176,Rada de Haro,63,31,32
16,Cuenca,177,Reíllo,116,63,53
16,Cuenca,181,Rozalén del Monte,70,30,40
16,Cuenca,185,Saceda-Trasierra,70,39,31
16,Cuenca,186,Saelices,651,335,316
16,Cuenca,187,Salinas del Manzano,105,61,44
16,Cuenca,188,Salmeroncillos,163,87,76
16,Cuenca,189,Salvacañete,316,162,154
16,Cuenca,190,San Clemente,7204,3666,3538
16,Cuenca,191,San Lorenzo de la Parrilla,1288,652,636
16,Cuenca,192,San Martín de Boniches,59,33,26
16,Cuenca,193,San Pedro Palmiches,86,47,39
16,Cuenca,194,Santa Cruz de Moya,290,153,137
16,Cuenca,196,Santa María de los Llanos,731,380,351
16,Cuenca,195,Santa María del Campo Rus,706,358,348
16,Cuenca,197,Santa María del Val,82,46,36
16,Cuenca,198,Sisante,1960,995,965
16,Cuenca,199,Solera de Gabaldón,31,12,19
16,Cuenca,909,Sotorribas,864,437,427
16,Cuenca,202,Talayuelas,1049,541,508
16,Cuenca,203,Tarancón,15732,7896,7836
16,Cuenca,204,Tébar,375,196,179
16,Cuenca,205,Tejadillos,139,67,72
16,Cuenca,206,Tinajas,330,177,153
16,Cuenca,209,Torralba,164,93,71
16,Cuenca,211,Torrejoncillo del Rey,571,289,282
16,Cuenca,212,Torrubia del Campo,332,168,164
16,Cuenca,213,Torrubia del Castillo,42,25,17
16,Cuenca,215,Tragacete,349,188,161
16,Cuenca,216,Tresjuncos,386,201,185
16,Cuenca,217,Tribaldos,118,54,64
16,Cuenca,218,Uclés,246,123,123
16,Cuenca,219,Uña,122,61,61
16,Cuenca,906,Valdecolmenas (Los),99,57,42
16,Cuenca,224,Valdemeca,110,56,54
16,Cuenca,225,Valdemorillo de la Sierra,78,44,34
16,Cuenca,227,Valdemoro-Sierra,142,84,58
16,Cuenca,228,Valdeolivas,259,155,104
16,Cuenca,902,Valdetórtola,164,94,70
16,Cuenca,903,Valeras (Las),1671,904,767
16,Cuenca,231,Valhermoso de la Fuente,50,23,27
16,Cuenca,234,Valsalobre,60,35,25
16,Cuenca,236,Valverde de Júcar,1280,641,639
16,Cuenca,237,Valverdejo,111,57,54
16,Cuenca,238,Vara de Rey,631,327,304
16,Cuenca,239,Vega del Codorno,172,92,80
16,Cuenca,240,Vellisca,149,82,67
16,Cuenca,242,Villaconejos de Trabaque,466,231,235
16,Cuenca,243,Villaescusa de Haro,574,289,285
16,Cuenca,244,Villagarcía del Llano,848,432,416
16,Cuenca,245,Villalba de la Sierra,568,286,282
16,Cuenca,246,Villalba del Rey,594,318,276
16,Cuenca,247,Villalgordo del Marquesado,100,53,47
16,Cuenca,248,Villalpardo,1143,561,582
16,Cuenca,249,Villamayor de Santiago,3068,1583,1485
16,Cuenca,250,Villanueva de Guadamejud,110,63,47
16,Cuenca,251,Villanueva de la Jara,2231,1128,1103
16,Cuenca,253,Villar de Cañas,436,238,198
16,Cuenca,254,Villar de Domingo García,225,118,107
16,Cuenca,255,Villar de la Encina,171,83,88
16,Cuenca,263,Villar de Olalla,1202,630,572
16,Cuenca,258,Villar del Humo,266,144,122
16,Cuenca,259,Villar del Infantado,47,30,17
16,Cuenca,910,Villar y Velasco,109,62,47
16,Cuenca,264,Villarejo de Fuentes,692,370,322
16,Cuenca,265,Villarejo de la Peñuela,21,9,12
16,Cuenca,266,Villarejo-Periesteban,439,212,227
16,Cuenca,269,Villares del Saz,633,324,309
16,Cuenca,270,Villarrubio,255,140,115
16,Cuenca,271,Villarta,965,496,469
16,Cuenca,272,Villas de la Ventosa,296,154,142
16,Cuenca,273,Villaverde y Pasaconsol,371,191,180
16,Cuenca,274,Víllora,148,70,78
16,Cuenca,275,Vindel,16,10,6
16,Cuenca,276,Yémeda,28,17,11
16,Cuenca,277,Zafra de Záncara,147,78,69
16,Cuenca,278,Zafrilla,90,40,50
16,Cuenca,279,Zarza de Tajo,330,175,155
16,Cuenca,280,Zarzuela,230,127,103
17,Girona,1,Agullana,840,438,402
17,Girona,2,Aiguaviva,727,368,359
17,Girona,3,Albanyà,149,83,66
17,Girona,4,Albons,710,369,341
17,Girona,6,Alp,1733,928,805
17,Girona,7,Amer,2306,1144,1162
17,Girona,8,Anglès,5560,2801,2759
17,Girona,9,Arbúcies,6647,3515,3132
17,Girona,10,Argelaguer,425,227,198
17,Girona,11,Armentera (L'),865,420,445
17,Girona,12,Avinyonet de Puigventós,1517,768,749
17,Girona,15,Banyoles,18780,9410,9370
17,Girona,16,Bàscara,963,505,458
17,Girona,13,Begur,4209,2143,2066
17,Girona,18,Bellcaire d'Empordà,673,333,340
17,Girona,19,Besalú,2360,1133,1227
17,Girona,20,Bescanó,4555,2269,2286
17,Girona,21,Beuda,161,83,78
17,Girona,22,Bisbal d'Empordà (La),10397,5259,5138
17,Girona,234,Biure,242,124,118
17,Girona,23,Blanes,40010,20184,19826
17,Girona,29,Boadella i les Escaules,255,126,129
17,Girona,24,Bolvir,395,209,186
17,Girona,25,Bordils,1715,860,855
17,Girona,26,Borrassà,684,354,330
17,Girona,27,Breda,3771,1914,1857
17,Girona,28,Brunyola,367,183,184
17,Girona,31,Cabanelles,237,136,101
17,Girona,30,Cabanes,915,481,434
17,Girona,32,Cadaqués,2892,1432,1460
17,Girona,33,Caldes de Malavella,6920,3431,3489
17,Girona,34,Calonge,10789,5433,5356
17,Girona,35,Camós,681,349,332
17,Girona,36,Campdevànol,3499,1731,1768
17,Girona,37,Campelles,127,65,62
17,Girona,38,Campllong,467,241,226
17,Girona,39,Camprodon,2479,1226,1253
17,Girona,40,Canet d'Adri,618,314,304
17,Girona,41,Cantallops,319,163,156
17,Girona,42,Capmany,620,333,287
17,Girona,44,Cassà de la Selva,9637,4981,4656
17,Girona,46,Castellfollit de la Roca,1048,530,518
17,Girona,47,Castelló d'Empúries,12220,6300,5920
17,Girona,48,Castell-Platja d'Aro,10445,5280,5165
17,Girona,189,Cellera de Ter (La),2141,1076,1065
17,Girona,49,Celrà,4638,2301,2337
17,Girona,50,Cervià de Ter,895,450,445
17,Girona,51,Cistella,251,125,126
17,Girona,54,Colera,576,298,278
17,Girona,55,Colomers,201,98,103
17,Girona,57,Corçà,1296,640,656
17,Girona,56,Cornellà del Terri,2210,1130,1080
17,Girona,58,Crespià,253,127,126
17,Girona,901,"Cruïlles, Monells i Sant Sadurní de l'Heura",1250,636,614
17,Girona,60,Darnius,529,269,260
17,Girona,61,Das,224,125,99
17,Girona,62,Escala (L'),10387,5324,5063
17,Girona,63,Espinelves,192,95,97
17,Girona,64,Espolla,408,201,207
17,Girona,65,Esponellà,461,225,236
17,Girona,5,Far d'Empordà (El),545,269,276
17,Girona,66,Figueres,44255,22093,22162
17,Girona,67,Flaçà,1070,528,542
17,Girona,68,Foixà,327,173,154
17,Girona,69,Fontanals de Cerdanya,457,218,239
17,Girona,70,Fontanilles,160,94,66
17,Girona,71,Fontcoberta,1280,612,668
17,Girona,902,Forallac,1749,863,886
17,Girona,73,Fornells de la Selva,2343,1143,1200
17,Girona,74,Fortià,642,328,314
17,Girona,75,Garrigàs,382,205,177
17,Girona,76,Garrigoles,157,87,70
17,Girona,77,Garriguella,858,428,430
17,Girona,78,Ger,461,254,207
17,Girona,79,Girona,96236,46883,49353
17,Girona,80,Gombrèn,224,102,122
17,Girona,81,Gualta,365,202,163
17,Girona,82,Guils de Cerdanya,519,273,246
17,Girona,83,Hostalric,3998,2038,1960
17,Girona,84,Isòvol,309,179,130
17,Girona,85,Jafre,432,232,200
17,Girona,86,Jonquera (La),3106,1566,1540
17,Girona,87,Juià,325,181,144
17,Girona,88,Lladó,697,353,344
17,Girona,89,Llagostera,7915,4075,3840
17,Girona,90,Llambilles,690,358,332
17,Girona,91,Llanars,571,297,274
17,Girona,92,Llançà,5214,2611,2603
17,Girona,93,Llers,1172,597,575
17,Girona,94,Llívia,1608,868,740
17,Girona,95,Lloret de Mar,39794,20968,18826
17,Girona,96,Llosses (Les),221,126,95
17,Girona,102,Maçanet de Cabrenys,728,369,359
17,Girona,103,Maçanet de la Selva,7020,3619,3401
17,Girona,97,Madremanya,250,120,130
17,Girona,98,Maià de Montcal,433,225,208
17,Girona,100,Masarac,276,150,126
17,Girona,101,Massanes,726,381,345
17,Girona,99,Meranges,89,50,39
17,Girona,105,Mieres,330,171,159
17,Girona,106,Mollet de Peralada,170,86,84
17,Girona,107,Molló,354,176,178
17,Girona,109,Montagut i Oix,989,513,476
17,Girona,110,Mont-ras,1821,933,888
17,Girona,111,Navata,1158,575,583
17,Girona,112,Ogassa,256,149,107
17,Girona,114,Olot,33589,16820,16769
17,Girona,115,Ordis,385,201,184
17,Girona,116,Osor,426,214,212
17,Girona,117,Palafrugell,22622,11385,11237
17,Girona,118,Palamós,18057,8910,9147
17,Girona,119,Palau de Santa Eulàlia,105,61,44
17,Girona,121,Palau-sator,290,153,137
17,Girona,120,Palau-saverdera,1475,737,738
17,Girona,123,Palol de Revardit,482,247,235
17,Girona,124,Pals,2745,1394,1351
17,Girona,125,Pardines,164,94,70
17,Girona,126,Parlavà,402,207,195
17,Girona,128,Pau,563,283,280
17,Girona,129,Pedret i Marzà,173,93,80
17,Girona,130,Pera (La),446,227,219
17,Girona,132,Peralada,1826,928,898
17,Girona,133,Planes d'Hostoles (Les),1727,882,845
17,Girona,134,Planoles,288,158,130
17,Girona,135,Pont de Molins,498,262,236
17,Girona,136,Pontós,242,131,111
17,Girona,137,Porqueres,4400,2182,2218
17,Girona,140,Port de la Selva (El),993,526,467
17,Girona,138,Portbou,1302,652,650
17,Girona,139,Preses (Les),1724,833,891
17,Girona,141,Puigcerdà,8746,4421,4325
17,Girona,142,Quart,2983,1499,1484
17,Girona,43,Queralbs,190,109,81
17,Girona,143,Rabós,192,100,92
17,Girona,144,Regencós,315,175,140
17,Girona,145,Ribes de Freser,1930,951,979
17,Girona,146,Riells i Viabrea,3868,2000,1868
17,Girona,147,Ripoll,10991,5437,5554
17,Girona,148,Riudarenes,2123,1093,1030
17,Girona,149,Riudaura,441,217,224
17,Girona,150,Riudellots de la Selva,1975,1015,960
17,Girona,151,Riumors,224,114,110
17,Girona,152,Roses,20418,10377,10041
17,Girona,153,Rupià,243,122,121
17,Girona,154,Sales de Llierca,136,73,63
17,Girona,155,Salt,30304,16159,14145
17,Girona,157,Sant Andreu Salou,155,75,80
17,Girona,183,Sant Aniol de Finestres,342,184,158
17,Girona,158,Sant Climent Sescebes,521,280,241
17,Girona,159,Sant Feliu de Buixalleu,793,417,376
17,Girona,160,Sant Feliu de Guíxols,21975,10923,11052
17,Girona,161,Sant Feliu de Pallerols,1363,666,697
17,Girona,162,Sant Ferriol,236,138,98
17,Girona,163,Sant Gregori,3243,1647,1596
17,Girona,164,Sant Hilari Sacalm,5729,2959,2770
17,Girona,165,Sant Jaume de Llierca,780,393,387
17,Girona,167,Sant Joan de les Abadesses,3529,1759,1770
17,Girona,168,Sant Joan de Mollet,513,255,258
17,Girona,185,Sant Joan les Fonts,2831,1434,1397
17,Girona,166,Sant Jordi Desvalls,653,317,336
17,Girona,169,Sant Julià de Ramis,3281,1649,1632
17,Girona,903,Sant Julià del Llor i Bonmatí,1291,646,645
17,Girona,171,Sant Llorenç de la Muga,222,110,112
17,Girona,172,Sant Martí de Llémena,566,292,274
17,Girona,173,Sant Martí Vell,265,141,124
17,Girona,174,Sant Miquel de Campmajor,243,126,117
17,Girona,175,Sant Miquel de Fluvià,765,396,369
17,Girona,176,Sant Mori,166,83,83
17,Girona,177,Sant Pau de Segúries,710,359,351
17,Girona,178,Sant Pere Pescador,2033,1091,942
17,Girona,180,Santa Coloma de Farners,11948,6111,5837
17,Girona,181,Santa Cristina d'Aro,5067,2603,2464
17,Girona,182,Santa Llogaia d'Àlguema,325,172,153
17,Girona,184,Santa Pau,1600,809,791
17,Girona,186,Sarrià de Ter,4596,2289,2307
17,Girona,187,"Saus, Camallera i Llampaies",765,369,396
17,Girona,188,Selva de Mar (La),220,115,105
17,Girona,190,Serinyà,1104,557,547
17,Girona,191,Serra de Daró,209,114,95
17,Girona,192,Setcases,181,96,85
17,Girona,193,Sils,5356,2725,2631
17,Girona,52,Siurana,190,100,90
17,Girona,194,Susqueda,118,68,50
17,Girona,195,Tallada d'Empordà (La),435,227,208
17,Girona,196,Terrades,317,157,160
17,Girona,197,Torrent,190,98,92
17,Girona,198,Torroella de Fluvià,686,349,337
17,Girona,199,Torroella de Montgrí,11522,5857,5665
17,Girona,200,Tortellà,771,387,384
17,Girona,201,Toses,155,96,59
17,Girona,202,Tossa de Mar,5976,3064,2912
17,Girona,204,Ullà,1019,571,448
17,Girona,205,Ullastret,250,125,125
17,Girona,203,Ultramort,213,118,95
17,Girona,206,Urús,208,105,103
17,Girona,14,Vajol (La),98,59,39
17,Girona,208,Vall de Bianya (La),1320,667,653
17,Girona,207,Vall d'en Bas (La),2833,1422,1411
17,Girona,170,Vallfogona de Ripollès,234,130,104
17,Girona,209,Vall-llobrega,866,443,423
17,Girona,210,Ventalló,792,412,380
17,Girona,211,Verges,1166,574,592
17,Girona,212,Vidrà,168,88,80
17,Girona,213,Vidreres,7629,3941,3688
17,Girona,214,Vilabertran,907,480,427
17,Girona,215,Vilablareix,2297,1133,1164
17,Girona,217,Viladamat,458,240,218
17,Girona,216,Viladasens,216,111,105
17,Girona,218,Vilademuls,766,401,365
17,Girona,220,Viladrau,1098,562,536
17,Girona,221,Vilafant,5429,2687,2742
17,Girona,223,Vilajuïga,1155,565,590
17,Girona,224,Vilallonga de Ter,477,259,218
17,Girona,225,Vilamacolum,328,177,151
17,Girona,226,Vilamalla,1100,585,515
17,Girona,227,Vilamaniscle,181,99,82
17,Girona,228,Vilanant,363,177,186
17,Girona,230,Vila-sacra,627,301,326
17,Girona,222,Vilaür,146,71,75
17,Girona,233,Vilobí d'Onyar,3032,1596,1436
17,Girona,232,Vilopriu,208,112,96
18,Granada,1,Agrón,340,178,162
18,Granada,2,Alamedilla,699,359,340
18,Granada,3,Albolote,17637,8846,8791
18,Granada,4,Albondón,883,493,390
18,Granada,5,Albuñán,429,224,205
18,Granada,6,Albuñol,6704,3508,3196
18,Granada,7,Albuñuelas,982,501,481
18,Granada,10,Aldeire,696,357,339
18,Granada,11,Alfacar,5444,2776,2668
18,Granada,12,Algarinejo,3552,1792,1760
18,Granada,13,Alhama de Granada,6097,3197,2900
18,Granada,14,Alhendín,6934,3587,3347
18,Granada,15,Alicún de Ortega,520,283,237
18,Granada,16,Almegíjar,401,211,190
18,Granada,17,Almuñécar,27703,13681,14022
18,Granada,904,Alpujarra de la Sierra,1119,590,529
18,Granada,18,Alquife,692,337,355
18,Granada,20,Arenas del Rey,2029,1069,960
18,Granada,21,Armilla,21895,11018,10877
18,Granada,22,Atarfe,15945,8007,7938
18,Granada,23,Baza,21982,11031,10951
18,Granada,24,Beas de Granada,1035,557,478
18,Granada,25,Beas de Guadix,396,205,191
18,Granada,27,Benalúa,3368,1681,1687
18,Granada,28,Benalúa de las Villas,1414,783,631
18,Granada,29,Benamaurel,2458,1234,1224
18,Granada,30,Bérchules,822,442,380
18,Granada,32,Bubión,350,181,169
18,Granada,33,Busquístar,298,163,135
18,Granada,34,Cacín,618,307,311
18,Granada,35,Cádiar,1637,865,772
18,Granada,36,Cájar,4690,2265,2425
18,Granada,114,Calahorra (La),806,413,393
18,Granada,37,Calicasas,555,281,274
18,Granada,38,Campotéjar,1418,725,693
18,Granada,39,Caniles,4905,2476,2429
18,Granada,40,Cáñar,412,214,198
18,Granada,42,Capileira,541,276,265
18,Granada,43,Carataunas,195,97,98
18,Granada,44,Cástaras,282,157,125
18,Granada,45,Castilléjar,1580,784,796
18,Granada,46,Castril,2451,1249,1202
18,Granada,47,Cenes de la Vega,7085,3642,3443
18,Granada,59,Chauchina,4760,2369,2391
18,Granada,61,Chimeneas,1520,799,721
18,Granada,62,Churriana de la Vega,12448,6243,6205
18,Granada,48,Cijuela,2993,1529,1464
18,Granada,49,Cogollos de Guadix,716,387,329
18,Granada,50,Cogollos de la Vega,2068,1050,1018
18,Granada,51,Colomera,1545,815,730
18,Granada,53,Cortes de Baza,2259,1127,1132
18,Granada,54,Cortes y Graena,1033,511,522
18,Granada,912,Cuevas del Campo,2054,1032,1022
18,Granada,56,Cúllar,4703,2376,2327
18,Granada,57,Cúllar Vega,6914,3507,3407
18,Granada,63,Darro,1462,723,739
18,Granada,64,Dehesas de Guadix,433,214,219
18,Granada,66,Deifontes,2528,1272,1256
18,Granada,67,Diezma,786,409,377
18,Granada,68,Dílar,1727,873,854
18,Granada,69,Dólar,618,321,297
18,Granada,70,Dúdar,335,178,157
18,Granada,71,Dúrcal,7302,3669,3633
18,Granada,72,Escúzar,804,414,390
18,Granada,74,Ferreira,338,174,164
18,Granada,76,Fonelas,1094,554,540
18,Granada,78,Freila,1132,566,566
18,Granada,79,Fuente Vaqueros,4353,2164,2189
18,Granada,905,Gabias (Las),17415,8937,8478
18,Granada,82,Galera,1057,524,533
18,Granada,83,Gobernador,286,140,146
18,Granada,84,Gójar,5297,2740,2557
18,Granada,85,Gor,917,465,452
18,Granada,86,Gorafe,474,234,240
18,Granada,87,Granada,239154,111042,128112
18,Granada,88,Guadahortuna,1999,1032,967
18,Granada,89,Guadix,20407,10113,10294
18,Granada,906,Guajares (Los),1191,652,539
18,Granada,93,Gualchos,4330,2270,2060
18,Granada,94,Güejar Sierra,2988,1579,1409
18,Granada,95,Güevéjar,2455,1267,1188
18,Granada,96,Huélago,358,187,171
18,Granada,97,Huéneja,1214,623,591
18,Granada,98,Huéscar,8178,4056,4122
18,Granada,99,Huétor de Santillán,1891,967,924
18,Granada,100,Huétor Tájar,9998,5039,4959
18,Granada,101,Huétor Vega,11551,5818,5733
18,Granada,102,Illora,10386,5196,5190
18,Granada,103,Itrabo,1152,589,563
18,Granada,105,Iznalloz,7019,3602,3417
18,Granada,107,Jayena,1209,617,592
18,Granada,108,Jerez del Marquesado,1083,552,531
18,Granada,109,Jete,890,477,413
18,Granada,111,Jun,3355,1719,1636
18,Granada,112,Juviles,170,86,84
18,Granada,115,Láchar,3115,1561,1554
18,Granada,116,Lanjarón,3861,1916,1945
18,Granada,117,Lanteira,582,303,279
18,Granada,119,Lecrín,2304,1168,1136
18,Granada,120,Lentegí,340,176,164
18,Granada,121,Lobras,146,75,71
18,Granada,122,Loja,21688,10888,10800
18,Granada,123,Lugros,350,189,161
18,Granada,124,Lújar,462,243,219
18,Granada,126,Malahá (La),1840,951,889
18,Granada,127,Maracena,21097,10432,10665
18,Granada,128,Marchal,373,170,203
18,Granada,132,Moclín,4237,2109,2128
18,Granada,133,Molvízar,3269,1672,1597
18,Granada,134,Monachil,7294,3733,3561
18,Granada,135,Montefrío,6229,3123,3106
18,Granada,136,Montejícar,2464,1245,1219
18,Granada,137,Montillana,1360,711,649
18,Granada,138,Moraleda de Zafayona,3076,1566,1510
18,Granada,909,Morelábor,737,386,351
18,Granada,140,Motril,60884,30244,30640
18,Granada,141,Murtas,658,382,276
18,Granada,903,Nevada,1179,598,581
18,Granada,143,Nigüelas,1169,579,590
18,Granada,144,Nívar,872,463,409
18,Granada,145,Ogíjares,13255,6642,6613
18,Granada,146,Orce,1321,682,639
18,Granada,147,Órgiva,5789,2917,2872
18,Granada,148,Otívar,1136,584,552
18,Granada,149,Otura,6598,3355,3243
18,Granada,150,Padul,8270,4149,4121
18,Granada,151,Pampaneira,356,182,174
18,Granada,152,Pedro Martínez,1293,645,648
18,Granada,153,Peligros,11000,5557,5443
18,Granada,154,Peza (La),1341,715,626
18,Granada,910,Pinar (El),1011,504,507
18,Granada,157,Pinos Genil,1289,684,605
18,Granada,158,Pinos Puente,13421,6788,6633
18,Granada,159,Píñar,1314,714,600
18,Granada,161,Polícar,227,116,111
18,Granada,162,Polopos,1856,1008,848
18,Granada,163,Pórtugos,401,211,190
18,Granada,164,Puebla de Don Fadrique,2474,1275,1199
18,Granada,165,Pulianas,5187,2607,2580
18,Granada,167,Purullena,2262,1142,1120
18,Granada,168,Quéntar,1045,543,502
18,Granada,170,Rubite,450,256,194
18,Granada,171,Salar,2831,1436,1395
18,Granada,173,Salobreña,12821,6393,6428
18,Granada,174,Santa Cruz del Comercio,597,314,283
18,Granada,175,Santa Fe,15428,7634,7794
18,Granada,176,Soportújar,250,132,118
18,Granada,177,Sorvilán,614,312,302
18,Granada,901,Taha (La),776,394,382
18,Granada,178,Torre-Cardela,955,474,481
18,Granada,179,Torvizcón,788,415,373
18,Granada,180,Trevélez,842,435,407
18,Granada,181,Turón,297,173,124
18,Granada,182,Ugíjar,2681,1350,1331
18,Granada,902,Valle (El),1130,560,570
18,Granada,907,Valle del Zalabí,2304,1165,1139
18,Granada,183,Válor,702,360,342
18,Granada,911,Vegas del Genil,9102,4662,4440
18,Granada,184,Vélez de Benaudalla,2928,1474,1454
18,Granada,185,Ventas de Huelma,704,372,332
18,Granada,908,Villamena,1031,522,509
18,Granada,187,Villanueva de las Torres,708,384,324
18,Granada,188,Villanueva Mesía,2158,1093,1065
18,Granada,189,Víznar,845,436,409
18,Granada,192,Zafarraya,2129,1166,963
18,Granada,913,Zagra,961,475,486
18,Granada,193,Zubia (La),18240,9014,9226
18,Granada,194,Zújar,3020,1589,1431
19,Guadalajara,1,Abánades,75,37,38
19,Guadalajara,2,Ablanque,107,61,46
19,Guadalajara,3,Adobes,54,26,28
19,Guadalajara,4,Alaminos,67,36,31
19,Guadalajara,5,Alarilla,133,81,52
19,Guadalajara,6,Albalate de Zorita,1049,576,473
19,Guadalajara,7,Albares,578,307,271
19,Guadalajara,8,Albendiego,39,27,12
19,Guadalajara,9,Alcocer,328,167,161
19,Guadalajara,10,Alcolea de las Peñas,17,11,6
19,Guadalajara,11,Alcolea del Pinar,410,223,187
19,Guadalajara,13,Alcoroches,173,105,68
19,Guadalajara,15,Aldeanueva de Guadalajara,108,57,51
19,Guadalajara,16,Algar de Mesa,54,31,23
19,Guadalajara,17,Algora,112,68,44
19,Guadalajara,18,Alhóndiga,209,111,98
19,Guadalajara,19,Alique,28,11,17
19,Guadalajara,20,Almadrones,93,62,31
19,Guadalajara,21,Almoguera,1492,797,695
19,Guadalajara,22,Almonacid de Zorita,814,391,423
19,Guadalajara,23,Alocén,184,98,86
19,Guadalajara,24,Alovera,11306,5801,5505
19,Guadalajara,27,Alustante,228,138,90
19,Guadalajara,31,Angón,20,13,7
19,Guadalajara,32,Anguita,231,125,106
19,Guadalajara,33,Anquela del Ducado,75,44,31
19,Guadalajara,34,Anquela del Pedregal,24,18,6
19,Guadalajara,36,Aranzueque,458,240,218
19,Guadalajara,37,Arbancón,188,107,81
19,Guadalajara,38,Arbeteta,36,19,17
19,Guadalajara,39,Argecilla,77,46,31
19,Guadalajara,40,Armallones,52,31,21
19,Guadalajara,41,Armuña de Tajuña,231,123,108
19,Guadalajara,42,Arroyo de las Fraguas,37,22,15
19,Guadalajara,43,Atanzón,101,61,40
19,Guadalajara,44,Atienza,472,262,210
19,Guadalajara,45,Auñón,204,117,87
19,Guadalajara,46,Azuqueca de Henares,33735,17417,16318
19,Guadalajara,47,Baides,88,46,42
19,Guadalajara,48,Baños de Tajo,20,15,5
19,Guadalajara,49,Bañuelos,25,16,9
19,Guadalajara,50,Barriopedro,27,15,12
19,Guadalajara,51,Berninches,93,54,39
19,Guadalajara,52,Bodera (La),37,24,13
19,Guadalajara,53,Brihuega,2835,1471,1364
19,Guadalajara,54,Budia,229,121,108
19,Guadalajara,55,Bujalaro,71,40,31
19,Guadalajara,57,Bustares,84,50,34
19,Guadalajara,58,Cabanillas del Campo,9450,4734,4716
19,Guadalajara,59,Campillo de Dueñas,99,54,45
19,Guadalajara,60,Campillo de Ranas,198,117,81
19,Guadalajara,61,Campisábalos,91,57,34
19,Guadalajara,64,Canredondo,90,50,40
19,Guadalajara,65,Cantalojas,151,82,69
19,Guadalajara,66,Cañizar,83,43,40
19,Guadalajara,67,Cardoso de la Sierra (El),80,54,26
19,Guadalajara,70,Casa de Uceda,117,61,56
19,Guadalajara,71,Casar (El),10543,5414,5129
19,Guadalajara,73,Casas de San Galindo,32,18,14
19,Guadalajara,74,Caspueñas,111,68,43
19,Guadalajara,75,Castejón de Henares,102,54,48
19,Guadalajara,76,Castellar de la Muela,38,18,20
19,Guadalajara,78,Castilforte,70,45,25
19,Guadalajara,79,Castilnuevo,13,8,5
19,Guadalajara,80,Cendejas de Enmedio,104,54,50
19,Guadalajara,81,Cendejas de la Torre,45,29,16
19,Guadalajara,82,Centenera,111,55,56
19,Guadalajara,103,Checa,341,200,141
19,Guadalajara,104,Chequilla,19,10,9
19,Guadalajara,106,Chillarón del Rey,128,67,61
19,Guadalajara,105,Chiloeches,2961,1567,1394
19,Guadalajara,86,Cifuentes,2109,1092,1017
19,Guadalajara,87,Cincovillas,25,14,11
19,Guadalajara,88,Ciruelas,117,63,54
19,Guadalajara,89,Ciruelos del Pinar,42,25,17
19,Guadalajara,90,Cobeta,124,56,68
19,Guadalajara,91,Cogollor,37,22,15
19,Guadalajara,92,Cogolludo,690,393,297
19,Guadalajara,95,Condemios de Abajo,26,18,8
19,Guadalajara,96,Condemios de Arriba,155,82,73
19,Guadalajara,97,Congostrina,44,28,16
19,Guadalajara,98,Copernal,42,28,14
19,Guadalajara,99,Corduente,409,220,189
19,Guadalajara,102,Cubillo de Uceda (El),179,89,90
19,Guadalajara,107,Driebes,465,244,221
19,Guadalajara,108,Durón,122,60,62
19,Guadalajara,109,Embid,54,31,23
19,Guadalajara,110,Escamilla,93,49,44
19,Guadalajara,111,Escariche,220,122,98
19,Guadalajara,112,Escopete,76,37,39
19,Guadalajara,113,Espinosa de Henares,828,441,387
19,Guadalajara,114,Esplegares,44,28,16
19,Guadalajara,115,Establés,46,25,21
19,Guadalajara,116,Estriégana,17,10,7
19,Guadalajara,117,Fontanar,2156,1134,1022
19,Guadalajara,118,Fuembellida,17,11,6
19,Guadalajara,119,Fuencemillán,137,83,54
19,Guadalajara,120,Fuentelahiguera de Albatages,131,75,56
19,Guadalajara,121,Fuentelencina,334,184,150
19,Guadalajara,122,Fuentelsaz,113,54,59
19,Guadalajara,123,Fuentelviejo,50,29,21
19,Guadalajara,124,Fuentenovilla,610,331,279
19,Guadalajara,125,Gajanejos,60,37,23
19,Guadalajara,126,Galápagos,2108,1112,996
19,Guadalajara,127,Galve de Sorbe,131,71,60
19,Guadalajara,129,Gascueña de Bornova,69,44,25
19,Guadalajara,130,Guadalajara,83789,41208,42581
19,Guadalajara,132,Henche,98,48,50
19,Guadalajara,133,Heras de Ayuso,243,143,100
19,Guadalajara,134,Herrería,22,14,8
19,Guadalajara,135,Hiendelaencina,150,77,73
19,Guadalajara,136,Hijes,25,13,12
19,Guadalajara,138,Hita,420,232,188
19,Guadalajara,139,Hombrados,32,20,12
19,Guadalajara,142,Hontoba,350,189,161
19,Guadalajara,143,Horche,2384,1245,1139
19,Guadalajara,145,Hortezuela de Océn,69,38,31
19,Guadalajara,146,Huerce (La),60,37,23
19,Guadalajara,147,Huérmeces del Cerro,68,39,29
19,Guadalajara,148,Huertahernando,61,38,23
19,Guadalajara,150,Hueva,137,74,63
19,Guadalajara,151,Humanes,1513,764,749
19,Guadalajara,152,Illana,909,518,391
19,Guadalajara,153,Iniéstola,17,13,4
19,Guadalajara,154,Inviernas (Las),89,51,38
19,Guadalajara,155,Irueste,69,43,26
19,Guadalajara,156,Jadraque,1639,842,797
19,Guadalajara,157,Jirueque,68,46,22
19,Guadalajara,159,Ledanca,119,61,58
19,Guadalajara,160,Loranca de Tajuña,1431,795,636
19,Guadalajara,161,Lupiana,222,120,102
19,Guadalajara,162,Luzaga,90,48,42
19,Guadalajara,163,Luzón,79,39,40
19,Guadalajara,165,Majaelrayo,63,39,24
19,Guadalajara,166,Málaga del Fresno,220,126,94
19,Guadalajara,167,Malaguilla,136,80,56
19,Guadalajara,168,Mandayona,400,201,199
19,Guadalajara,169,Mantiel,75,41,34
19,Guadalajara,170,Maranchón,265,148,117
19,Guadalajara,171,Marchamalo,5553,2892,2661
19,Guadalajara,172,Masegoso de Tajuña,90,52,38
19,Guadalajara,173,Matarrubia,66,45,21
19,Guadalajara,174,Matillas,162,76,86
19,Guadalajara,175,Mazarete,58,30,28
19,Guadalajara,176,Mazuecos,350,184,166
19,Guadalajara,177,Medranda,104,56,48
19,Guadalajara,178,Megina,56,36,20
19,Guadalajara,179,Membrillera,127,63,64
19,Guadalajara,181,Miedes de Atienza,85,49,36
19,Guadalajara,182,Mierla (La),30,22,8
19,Guadalajara,184,Millana,158,88,70
19,Guadalajara,183,Milmarcos,109,61,48
19,Guadalajara,185,Miñosa (La),38,24,14
19,Guadalajara,186,Mirabueno,102,60,42
19,Guadalajara,187,Miralrío,84,46,38
19,Guadalajara,188,Mochales,74,40,34
19,Guadalajara,189,Mohernando,207,105,102
19,Guadalajara,190,Molina de Aragón,3646,1847,1799
19,Guadalajara,191,Monasterio,20,7,13
19,Guadalajara,192,Mondéjar,2688,1395,1293
19,Guadalajara,193,Montarrón,37,21,16
19,Guadalajara,194,Moratilla de los Meleros,129,73,56
19,Guadalajara,195,Morenilla,48,29,19
19,Guadalajara,196,Muduex,110,56,54
19,Guadalajara,197,Navas de Jadraque (Las),28,17,11
19,Guadalajara,198,Negredo,22,11,11
19,Guadalajara,199,Ocentejo,25,15,10
19,Guadalajara,200,Olivar (El),119,73,46
19,Guadalajara,201,Olmeda de Cobeta,78,37,41
19,Guadalajara,202,Olmeda de Jadraque (La),21,10,11
19,Guadalajara,203,Ordial (El),39,17,22
19,Guadalajara,204,Orea,250,156,94
19,Guadalajara,208,Pálmaces de Jadraque,74,41,33
19,Guadalajara,209,Pardos,62,32,30
19,Guadalajara,210,Paredes de Sigüenza,35,20,15
19,Guadalajara,211,Pareja,536,296,240
19,Guadalajara,212,Pastrana,1106,569,537
19,Guadalajara,213,Pedregal (El),81,48,33
19,Guadalajara,214,Peñalén,107,61,46
19,Guadalajara,215,Peñalver,240,144,96
19,Guadalajara,216,Peralejos de las Truchas,172,98,74
19,Guadalajara,217,Peralveche,95,58,37
19,Guadalajara,218,Pinilla de Jadraque,64,35,29
19,Guadalajara,219,Pinilla de Molina,27,14,13
19,Guadalajara,220,Pioz,3103,1680,1423
19,Guadalajara,221,Piqueras,54,37,17
19,Guadalajara,222,Pobo de Dueñas (El),158,84,74
19,Guadalajara,223,Poveda de la Sierra,150,88,62
19,Guadalajara,224,Pozo de Almoguera,131,74,57
19,Guadalajara,225,Pozo de Guadalajara,1362,716,646
19,Guadalajara,226,Prádena de Atienza,42,28,14
19,Guadalajara,227,Prados Redondos,109,61,48
19,Guadalajara,228,Puebla de Beleña,53,31,22
19,Guadalajara,229,Puebla de Valles,85,46,39
19,Guadalajara,230,Quer,639,334,305
19,Guadalajara,231,Rebollosa de Jadraque,22,13,9
19,Guadalajara,232,Recuenco (El),97,54,43
19,Guadalajara,233,Renera,120,69,51
19,Guadalajara,234,Retiendas,43,25,18
19,Guadalajara,235,Riba de Saelices,136,83,53
19,Guadalajara,237,Rillo de Gallo,67,39,28
19,Guadalajara,238,Riofrío del Llano,52,29,23
19,Guadalajara,239,Robledillo de Mohernando,135,71,64
19,Guadalajara,240,Robledo de Corpes,66,35,31
19,Guadalajara,241,Romanillos de Atienza,48,30,18
19,Guadalajara,242,Romanones,130,72,58
19,Guadalajara,243,Rueda de la Sierra,57,33,24
19,Guadalajara,244,Sacecorbo,121,72,49
19,Guadalajara,245,Sacedón,1839,978,861
19,Guadalajara,246,Saelices de la Sal,60,33,27
19,Guadalajara,247,Salmerón,200,106,94
19,Guadalajara,248,San Andrés del Congosto,91,61,30
19,Guadalajara,249,San Andrés del Rey,42,18,24
19,Guadalajara,250,Santiuste,22,14,8
19,Guadalajara,251,Saúca,53,26,27
19,Guadalajara,252,Sayatón,111,64,47
19,Guadalajara,254,Selas,74,40,34
19,Guadalajara,901,Semillas,43,26,17
19,Guadalajara,255,Setiles,111,66,45
19,Guadalajara,256,Sienes,70,41,29
19,Guadalajara,257,Sigüenza,4960,2514,2446
19,Guadalajara,258,Solanillos del Extremo,116,68,48
19,Guadalajara,259,Somolinos,34,14,20
19,Guadalajara,260,Sotillo (El),51,27,24
19,Guadalajara,261,Sotodosos,55,24,31
19,Guadalajara,262,Tamajón,188,100,88
19,Guadalajara,263,Taragudo,41,21,20
19,Guadalajara,264,Taravilla,53,30,23
19,Guadalajara,265,Tartanedo,165,90,75
19,Guadalajara,266,Tendilla,414,221,193
19,Guadalajara,267,Terzaga,26,16,10
19,Guadalajara,268,Tierzo,40,25,15
19,Guadalajara,269,Toba (La),107,62,45
19,Guadalajara,271,Tordellego,64,33,31
19,Guadalajara,270,Tordelrábano,17,9,8
19,Guadalajara,272,Tordesilos,122,66,56
19,Guadalajara,274,Torija,1424,768,656
19,Guadalajara,279,Torre del Burgo,195,107,88
19,Guadalajara,277,Torrecuadrada de Molina,19,10,9
19,Guadalajara,278,Torrecuadradilla,39,23,16
19,Guadalajara,280,Torrejón del Rey,5065,2680,2385
19,Guadalajara,281,Torremocha de Jadraque,24,17,7
19,Guadalajara,282,Torremocha del Campo,257,140,117
19,Guadalajara,283,Torremocha del Pinar,55,24,31
19,Guadalajara,284,Torremochuela,12,7,5
19,Guadalajara,285,Torrubia,27,16,11
19,Guadalajara,286,Tórtola de Henares,896,473,423
19,Guadalajara,287,Tortuera,229,121,108
19,Guadalajara,288,Tortuero,21,13,8
19,Guadalajara,289,Traíd,40,20,20
19,Guadalajara,290,Trijueque,1420,761,659
19,Guadalajara,291,Trillo,1418,715,703
19,Guadalajara,293,Uceda,2519,1306,1213
19,Guadalajara,294,Ujados,30,17,13
19,Guadalajara,296,Utande,47,32,15
19,Guadalajara,297,Valdarachas,40,21,19
19,Guadalajara,298,Valdearenas,109,64,45
19,Guadalajara,299,Valdeavellano,107,64,43
19,Guadalajara,300,Valdeaveruelo,1034,543,491
19,Guadalajara,301,Valdeconcha,48,30,18
19,Guadalajara,302,Valdegrudas,65,43,22
19,Guadalajara,303,Valdelcubo,71,43,28
19,Guadalajara,304,Valdenuño Fernández,294,162,132
19,Guadalajara,305,Valdepeñas de la Sierra,201,113,88
19,Guadalajara,306,Valderrebollo,51,25,26
19,Guadalajara,307,Valdesotos,28,14,14
19,Guadalajara,308,Valfermoso de Tajuña,64,35,29
19,Guadalajara,309,Valhermoso,39,24,15
19,Guadalajara,310,Valtablado del Río,15,11,4
19,Guadalajara,311,Valverde de los Arroyos,96,55,41
19,Guadalajara,314,Viana de Jadraque,47,31,16
19,Guadalajara,317,Villanueva de Alcorón,189,100,89
19,Guadalajara,318,Villanueva de Argecilla,40,24,16
19,Guadalajara,319,Villanueva de la Torre,6176,3143,3033
19,Guadalajara,321,Villares de Jadraque,67,42,25
19,Guadalajara,322,Villaseca de Henares,49,27,22
19,Guadalajara,323,Villaseca de Uceda,64,38,26
19,Guadalajara,324,Villel de Mesa,169,90,79
19,Guadalajara,325,Viñuelas,128,71,57
19,Guadalajara,326,Yebes,1157,623,534
19,Guadalajara,327,Yebra,541,277,264
19,Guadalajara,329,Yélamos de Abajo,62,31,31
19,Guadalajara,330,Yélamos de Arriba,125,73,52
19,Guadalajara,331,Yunquera de Henares,3586,1842,1744
19,Guadalajara,332,Yunta (La),123,67,56
19,Guadalajara,333,Zaorejas,155,95,60
19,Guadalajara,334,Zarzuela de Jadraque,47,30,17
19,Guadalajara,335,Zorita de los Canes,101,53,48
20,Guipúzcoa,1,Abaltzisketa,326,180,146
20,Guipúzcoa,2,Aduna,429,237,192
20,Guipúzcoa,16,Aia,2007,1098,909
20,Guipúzcoa,3,Aizarnazabal,708,373,335
20,Guipúzcoa,4,Albiztur,315,164,151
20,Guipúzcoa,5,Alegia,1750,895,855
20,Guipúzcoa,6,Alkiza,353,191,162
20,Guipúzcoa,906,Altzaga,159,83,76
20,Guipúzcoa,7,Altzo,398,213,185
20,Guipúzcoa,8,Amezketa,994,537,457
20,Guipúzcoa,9,Andoain,14662,7352,7310
20,Guipúzcoa,10,Anoeta,1850,956,894
20,Guipúzcoa,11,Antzuola,2161,1083,1078
20,Guipúzcoa,12,Arama,218,115,103
20,Guipúzcoa,13,Aretxabaleta,6700,3418,3282
20,Guipúzcoa,55,Arrasate/Mondragón,22011,10933,11078
20,Guipúzcoa,14,Asteasu,1473,790,683
20,Guipúzcoa,903,Astigarraga,4709,2412,2297
20,Guipúzcoa,15,Ataun,1670,887,783
20,Guipúzcoa,17,Azkoitia,11351,5711,5640
20,Guipúzcoa,18,Azpeitia,14305,7184,7121
20,Guipúzcoa,904,Baliarrain,120,64,56
20,Guipúzcoa,19,Beasain,13680,6901,6779
20,Guipúzcoa,20,Beizama,183,112,71
20,Guipúzcoa,21,Belauntza,296,165,131
20,Guipúzcoa,22,Berastegi,1051,563,488
20,Guipúzcoa,74,Bergara,14637,7273,7364
20,Guipúzcoa,23,Berrobi,576,305,271
20,Guipúzcoa,24,Bidegoian,531,292,239
20,Guipúzcoa,29,Deba,5384,2710,2674
20,Guipúzcoa,69,Donostia-San Sebastián,185506,87043,98463
20,Guipúzcoa,30,Eibar,27378,13279,14099
20,Guipúzcoa,31,Elduain,235,121,114
20,Guipúzcoa,33,Elgeta,1079,552,527
20,Guipúzcoa,32,Elgoibar,11324,5657,5667
20,Guipúzcoa,67,Errenteria,39020,19069,19951
20,Guipúzcoa,66,Errezil,616,324,292
20,Guipúzcoa,34,Eskoriatza,4055,2074,1981
20,Guipúzcoa,35,Ezkio-Itsaso,608,315,293
20,Guipúzcoa,38,Gabiria,492,269,223
20,Guipúzcoa,37,Gaintza,128,73,55
20,Guipúzcoa,907,Gaztelu,166,95,71
20,Guipúzcoa,39,Getaria,2675,1340,1335
20,Guipúzcoa,40,Hernani,19285,9490,9795
20,Guipúzcoa,41,Hernialde,348,186,162
20,Guipúzcoa,36,Hondarribia,16464,8260,8204
20,Guipúzcoa,42,Ibarra,4345,2249,2096
20,Guipúzcoa,43,Idiazabal,2261,1146,1115
20,Guipúzcoa,44,Ikaztegieta,470,250,220
20,Guipúzcoa,45,Irun,60938,29804,31134
20,Guipúzcoa,46,Irura,1577,821,756
20,Guipúzcoa,47,Itsasondo,661,328,333
20,Guipúzcoa,48,Larraul,253,134,119
20,Guipúzcoa,902,Lasarte-Oria,17856,8822,9034
20,Guipúzcoa,49,Lazkao,5348,2741,2607
20,Guipúzcoa,50,Leaburu,395,205,190
20,Guipúzcoa,51,Legazpi,8718,4496,4222
20,Guipúzcoa,52,Legorreta,1496,767,729
20,Guipúzcoa,68,Leintz-Gatzaga,262,147,115
20,Guipúzcoa,53,Lezo,5988,2980,3008
20,Guipúzcoa,54,Lizartza,661,354,307
20,Guipúzcoa,901,Mendaro,1898,982,916
20,Guipúzcoa,57,Mutiloa,248,135,113
20,Guipúzcoa,56,Mutriku,5021,2529,2492
20,Guipúzcoa,63,Oiartzun,9947,4991,4956
20,Guipúzcoa,58,Olaberria,948,489,459
20,Guipúzcoa,59,Oñati,10957,5460,5497
20,Guipúzcoa,76,Ordizia,9758,4858,4900
20,Guipúzcoa,905,Orendain,191,99,92
20,Guipúzcoa,60,Orexa,123,71,52
20,Guipúzcoa,61,Orio,5147,2607,2540
20,Guipúzcoa,62,Ormaiztegi,1319,681,638
20,Guipúzcoa,64,Pasaia,15977,7690,8287
20,Guipúzcoa,70,Segura,1455,728,727
20,Guipúzcoa,65,Soraluze/Placencia de las Armas,4002,2008,1994
20,Guipúzcoa,71,Tolosa,18095,8720,9375
20,Guipúzcoa,72,Urnieta,6145,3100,3045
20,Guipúzcoa,77,Urretxu,6957,3497,3460
20,Guipúzcoa,73,Usurbil,6013,3080,2933
20,Guipúzcoa,75,Villabona,5822,2948,2874
20,Guipúzcoa,78,Zaldibia,1504,802,702
20,Guipúzcoa,79,Zarautz,22658,11137,11521
20,Guipúzcoa,25,Zegama,1530,794,736
20,Guipúzcoa,26,Zerain,249,120,129
20,Guipúzcoa,27,Zestoa,3544,1856,1688
20,Guipúzcoa,28,Zizurkil,2766,1401,1365
20,Guipúzcoa,81,Zumaia,9337,4648,4689
20,Guipúzcoa,80,Zumarraga,10037,5008,5029
21,Huelva,1,Alájar,806,402,404
21,Huelva,2,Aljaraque,18443,9220,9223
21,Huelva,3,Almendro (El),879,466,413
21,Huelva,4,Almonaster la Real,1833,916,917
21,Huelva,5,Almonte,22204,11131,11073
21,Huelva,6,Alosno,4386,2127,2259
21,Huelva,7,Aracena,7739,3845,3894
21,Huelva,8,Aroche,3206,1596,1610
21,Huelva,9,Arroyomolinos de León,1055,539,516
21,Huelva,10,Ayamonte,20597,10384,10213
21,Huelva,11,Beas,4336,2174,2162
21,Huelva,12,Berrocal,358,169,189
21,Huelva,13,Bollullos Par del Condado,13959,6959,7000
21,Huelva,14,Bonares,6145,3092,3053
21,Huelva,15,Cabezas Rubias,869,467,402
21,Huelva,16,Cala,1326,664,662
21,Huelva,17,Calañas,4284,2121,2163
21,Huelva,18,Campillo (El),2194,1056,1138
21,Huelva,19,Campofrío,773,387,386
21,Huelva,20,Cañaveral de León,412,201,211
21,Huelva,21,Cartaya,18415,9508,8907
21,Huelva,22,Castaño del Robledo,215,117,98
21,Huelva,23,Cerro de Andévalo (El),2483,1203,1280
21,Huelva,30,Chucena,2130,1075,1055
21,Huelva,24,Corteconcepción,607,308,299
21,Huelva,25,Cortegana,4939,2487,2452
21,Huelva,26,Cortelazor,300,152,148
21,Huelva,27,Cumbres de Enmedio,50,31,19
21,Huelva,28,Cumbres de San Bartolomé,459,225,234
21,Huelva,29,Cumbres Mayores,1954,980,974
21,Huelva,31,Encinasola,1582,810,772
21,Huelva,32,Escacena del Campo,1996,990,1006
21,Huelva,33,Fuenteheridos,599,307,292
21,Huelva,34,Galaroza,1606,796,810
21,Huelva,35,Gibraleón,12392,6232,6160
21,Huelva,36,Granada de Río-Tinto (La),209,106,103
21,Huelva,37,Granado (El),572,314,258
21,Huelva,38,Higuera de la Sierra,1409,698,711
21,Huelva,39,Hinojales,370,193,177
21,Huelva,40,Hinojos,3926,1979,1947
21,Huelva,41,Huelva,149310,72236,77074
21,Huelva,42,Isla Cristina,21719,10872,10847
21,Huelva,43,Jabugo,2388,1193,1195
21,Huelva,44,Lepe,26763,13819,12944
21,Huelva,45,Linares de la Sierra,295,148,147
21,Huelva,46,Lucena del Puerto,2659,1328,1331
21,Huelva,47,Manzanilla,2347,1196,1151
21,Huelva,48,Marines (Los),355,177,178
21,Huelva,49,Minas de Riotinto,4209,2032,2177
21,Huelva,50,Moguer,20040,10106,9934
21,Huelva,51,Nava (La),327,166,161
21,Huelva,52,Nerva,5945,2864,3081
21,Huelva,53,Niebla,4214,2144,2070
21,Huelva,54,Palma del Condado (La),10475,5236,5239
21,Huelva,55,Palos de la Frontera,9167,4602,4565
21,Huelva,56,Paterna del Campo,3745,1914,1831
21,Huelva,57,Paymogo,1306,655,651
21,Huelva,58,Puebla de Guzmán,3114,1602,1512
21,Huelva,59,Puerto Moral,270,137,133
21,Huelva,60,Punta Umbría,14714,7501,7213
21,Huelva,61,Rociana del Condado,7362,3712,3650
21,Huelva,62,Rosal de la Frontera,1911,960,951
21,Huelva,63,San Bartolomé de la Torre,3530,1775,1755
21,Huelva,64,San Juan del Puerto,8190,4124,4066
21,Huelva,66,San Silvestre de Guzmán,755,411,344
21,Huelva,65,Sanlúcar de Guadiana,408,209,199
21,Huelva,67,Santa Ana la Real,493,224,269
21,Huelva,68,Santa Bárbara de Casa,1162,576,586
21,Huelva,69,Santa Olalla del Cala,2177,1117,1060
21,Huelva,70,Trigueros,7729,3853,3876
21,Huelva,71,Valdelarco,254,118,136
21,Huelva,72,Valverde del Camino,12746,6247,6499
21,Huelva,73,Villablanca,2800,1476,1324
21,Huelva,74,Villalba del Alcor,3465,1704,1761
21,Huelva,75,Villanueva de las Cruces,413,196,217
21,Huelva,76,Villanueva de los Castillejos,2790,1397,1393
21,Huelva,77,Villarrasa,2170,1083,1087
21,Huelva,78,Zalamea la Real,3407,1696,1711
21,Huelva,79,Zufre,940,483,457
22,Huesca,1,Abiego,281,148,133
22,Huesca,2,Abizanda,132,68,64
22,Huesca,3,Adahuesca,166,79,87
22,Huesca,4,Agüero,164,94,70
22,Huesca,907,Aínsa-Sobrarbe,2180,1126,1054
22,Huesca,6,Aisa,362,206,156
22,Huesca,7,Albalate de Cinca,1237,647,590
22,Huesca,8,Albalatillo,243,124,119
22,Huesca,9,Albelda,847,450,397
22,Huesca,11,Albero Alto,132,76,56
22,Huesca,12,Albero Bajo,96,51,45
22,Huesca,13,Alberuela de Tubo,355,182,173
22,Huesca,14,Alcalá de Gurrea,278,139,139
22,Huesca,15,Alcalá del Obispo,491,321,170
22,Huesca,16,Alcampell,782,400,382
22,Huesca,17,Alcolea de Cinca,1164,619,545
22,Huesca,18,Alcubierre,433,227,206
22,Huesca,19,Alerre,223,114,109
22,Huesca,20,Alfántega,125,61,64
22,Huesca,21,Almudévar,2554,1311,1243
22,Huesca,22,Almunia de San Juan,664,349,315
22,Huesca,23,Almuniente,559,286,273
22,Huesca,24,Alquézar,313,172,141
22,Huesca,25,Altorricón,1506,823,683
22,Huesca,27,Angüés,429,226,203
22,Huesca,28,Ansó,491,248,243
22,Huesca,29,Antillón,150,81,69
22,Huesca,32,Aragüés del Puerto,128,66,62
22,Huesca,35,Arén,363,195,168
22,Huesca,36,Argavieso,119,72,47
22,Huesca,37,Arguis,118,66,52
22,Huesca,39,Ayerbe,1119,565,554
22,Huesca,40,Azanuy-Alins,174,88,86
22,Huesca,41,Azara,200,99,101
22,Huesca,42,Azlor,135,66,69
22,Huesca,43,Baélls,120,69,51
22,Huesca,44,Bailo,296,179,117
22,Huesca,45,Baldellou,117,66,51
22,Huesca,46,Ballobar,981,494,487
22,Huesca,47,Banastás,270,144,126
22,Huesca,48,Barbastro,17080,8361,8719
22,Huesca,49,Barbués,98,53,45
22,Huesca,50,Barbuñales,109,57,52
22,Huesca,51,Bárcabo,129,76,53
22,Huesca,52,Belver de Cinca,1362,729,633
22,Huesca,53,Benabarre,1177,623,554
22,Huesca,54,Benasque,2219,1157,1062
22,Huesca,55,Berbegal,441,229,212
22,Huesca,57,Bielsa,511,258,253
22,Huesca,58,Bierge,258,145,113
22,Huesca,59,Biescas,1634,891,743
22,Huesca,60,Binaced,1494,767,727
22,Huesca,61,Binéfar,9407,4938,4469
22,Huesca,62,Bisaurri,208,105,103
22,Huesca,63,Biscarrués,228,120,108
22,Huesca,64,Blecua y Torres,208,115,93
22,Huesca,66,Boltaña,1051,576,475
22,Huesca,67,Bonansa,102,55,47
22,Huesca,68,Borau,81,47,34
22,Huesca,69,Broto,542,288,254
22,Huesca,72,Caldearenas,246,139,107
22,Huesca,74,Campo,355,178,177
22,Huesca,75,Camporrélls,193,105,88
22,Huesca,76,Canal de Berdún,396,215,181
22,Huesca,77,Candasnos,409,213,196
22,Huesca,78,Canfranc,624,343,281
22,Huesca,79,Capdesaso,163,73,90
22,Huesca,80,Capella,366,190,176
22,Huesca,81,Casbas de Huesca,299,159,140
22,Huesca,83,Castejón de Monegros,661,346,315
22,Huesca,84,Castejón de Sos,788,421,367
22,Huesca,82,Castejón del Puente,399,208,191
22,Huesca,85,Castelflorite,130,68,62
22,Huesca,86,Castiello de Jaca,256,139,117
22,Huesca,87,Castigaleu,119,63,56
22,Huesca,88,Castillazuelo,193,92,101
22,Huesca,89,Castillonroy,378,181,197
22,Huesca,94,Chalamera,128,67,61
22,Huesca,95,Chía,105,61,44
22,Huesca,96,Chimillas,359,173,186
22,Huesca,90,Colungo,147,83,64
22,Huesca,99,Esplús,677,344,333
22,Huesca,102,Estada,236,135,101
22,Huesca,103,Estadilla,860,419,441
22,Huesca,105,Estopiñán del Castillo,177,97,80
22,Huesca,106,Fago,26,15,11
22,Huesca,107,Fanlo,138,85,53
22,Huesca,109,Fiscal,317,179,138
22,Huesca,110,Fonz,1035,526,509
22,Huesca,111,Foradada del Toscar,215,114,101
22,Huesca,112,Fraga,14539,7509,7030
22,Huesca,113,Fueva (La),619,324,295
22,Huesca,114,Gistaín,145,80,65
22,Huesca,115,Grado (El),493,257,236
22,Huesca,116,Grañén,1930,995,935
22,Huesca,117,Graus,3700,1910,1790
22,Huesca,119,Gurrea de Gállego,1664,862,802
22,Huesca,122,Hoz de Jaca,71,34,37
22,Huesca,908,Hoz y Costean,205,113,92
22,Huesca,124,Huerto,272,140,132
22,Huesca,125,Huesca,52347,25444,26903
22,Huesca,126,Ibieca,108,61,47
22,Huesca,127,Igriés,627,325,302
22,Huesca,128,Ilche,246,130,116
22,Huesca,129,Isábena,313,168,145
22,Huesca,130,Jaca,13374,6651,6723
22,Huesca,131,Jasa,116,70,46
22,Huesca,133,Labuerda,167,88,79
22,Huesca,135,Laluenga,220,121,99
22,Huesca,136,Lalueza,1101,575,526
22,Huesca,137,Lanaja,1417,743,674
22,Huesca,139,Laperdiguera,102,53,49
22,Huesca,141,Lascellas-Ponzano,154,84,70
22,Huesca,142,Lascuarre,157,85,72
22,Huesca,143,Laspaúles,297,170,127
22,Huesca,144,Laspuña,289,157,132
22,Huesca,149,Loarre,371,206,165
22,Huesca,150,Loporzano,540,301,239
22,Huesca,151,Loscorrales,108,53,55
22,Huesca,905,Lupiñén-Ortilla,397,205,192
22,Huesca,155,Monesma y Cajigar,106,56,50
22,Huesca,156,Monflorite-Lascasas,312,167,145
22,Huesca,157,Montanuy,285,167,118
22,Huesca,158,Monzón,17115,8835,8280
22,Huesca,160,Naval,265,133,132
22,Huesca,162,Novales,181,89,92
22,Huesca,163,Nueno,557,312,245
22,Huesca,164,Olvena,58,27,31
22,Huesca,165,Ontiñena,586,297,289
22,Huesca,167,Osso de Cinca,735,378,357
22,Huesca,168,Palo,24,14,10
22,Huesca,170,Panticosa,819,412,407
22,Huesca,172,Peñalba,761,393,368
22,Huesca,173,Peñas de Riglos (Las),268,162,106
22,Huesca,174,Peralta de Alcofea,618,314,304
22,Huesca,175,Peralta de Calasanz,235,132,103
22,Huesca,176,Peraltilla,200,105,95
22,Huesca,177,Perarrúa,112,56,56
22,Huesca,178,Pertusa,113,66,47
22,Huesca,181,Piracés,104,61,43
22,Huesca,182,Plan,336,175,161
22,Huesca,184,Poleñino,226,123,103
22,Huesca,186,Pozán de Vero,244,121,123
22,Huesca,187,Puebla de Castro (La),433,219,214
22,Huesca,188,Puente de Montañana,148,65,83
22,Huesca,902,Puente la Reina de Jaca,215,118,97
22,Huesca,189,Puértolas,241,133,108
22,Huesca,190,Pueyo de Araguás (El),150,89,61
22,Huesca,193,Pueyo de Santa Cruz,369,188,181
22,Huesca,195,Quicena,302,156,146
22,Huesca,197,Robres,630,327,303
22,Huesca,199,Sabiñánigo,10383,5304,5079
22,Huesca,200,Sahún,360,193,167
22,Huesca,201,Salas Altas,311,164,147
22,Huesca,202,Salas Bajas,149,66,83
22,Huesca,203,Salillas,110,60,50
22,Huesca,204,Sallent de Gállego,1542,786,756
22,Huesca,205,San Esteban de Litera,526,272,254
22,Huesca,207,San Juan de Plan,153,84,69
22,Huesca,903,San Miguel del Cinca,848,433,415
22,Huesca,206,Sangarrén,242,124,118
22,Huesca,208,Santa Cilia,209,114,95
22,Huesca,209,Santa Cruz de la Serós,136,84,52
22,Huesca,906,Santa María de Dulcis,221,121,100
22,Huesca,212,Santaliestra y San Quílez,106,56,50
22,Huesca,213,Sariñena,4428,2305,2123
22,Huesca,214,Secastilla,150,65,85
22,Huesca,215,Seira,156,83,73
22,Huesca,217,Sena,548,299,249
22,Huesca,218,Senés de Alcubierre,68,34,34
22,Huesca,220,Sesa,225,122,103
22,Huesca,221,Sesué,127,73,54
22,Huesca,222,Siétamo,665,359,306
22,Huesca,223,Sopeira,120,67,53
22,Huesca,904,Sotonera (La),1061,562,499
22,Huesca,225,Tamarite de Litera,3730,1893,1837
22,Huesca,226,Tardienta,1007,509,498
22,Huesca,227,Tella-Sin,266,149,117
22,Huesca,228,Tierz,691,356,335
22,Huesca,229,Tolva,171,96,75
22,Huesca,230,Torla,328,173,155
22,Huesca,232,Torralba de Aragón,111,58,53
22,Huesca,233,Torre la Ribera,117,62,55
22,Huesca,234,Torrente de Cinca,1276,662,614
22,Huesca,235,Torres de Alcanadre,106,58,48
22,Huesca,236,Torres de Barbués,303,150,153
22,Huesca,239,Tramaced,100,60,40
22,Huesca,242,Valfarta,87,48,39
22,Huesca,243,Valle de Bardají,50,27,23
22,Huesca,901,Valle de Hecho,960,492,468
22,Huesca,244,Valle de Lierp,65,36,29
22,Huesca,245,Velilla de Cinca,450,234,216
22,Huesca,909,Vencillón,469,247,222
22,Huesca,246,Veracruz,104,61,43
22,Huesca,247,Viacamp y Litera,48,32,16
22,Huesca,248,Vicién,122,68,54
22,Huesca,249,Villanova,154,72,82
22,Huesca,250,Villanúa,492,267,225
22,Huesca,251,Villanueva de Sigena,512,253,259
22,Huesca,252,Yebra de Basa,155,88,67
22,Huesca,253,Yésero,71,43,28
22,Huesca,254,Zaidín,1709,878,831
23,Jaén,1,Albanchez de Mágina,1230,617,613
23,Jaén,2,Alcalá la Real,22759,11325,11434
23,Jaén,3,Alcaudete,11135,5555,5580
23,Jaén,4,Aldeaquemada,541,278,263
23,Jaén,5,Andújar,39171,19318,19853
23,Jaén,6,Arjona,5807,2889,2918
23,Jaén,7,Arjonilla,3840,1905,1935
23,Jaén,8,Arquillos,1944,966,978
23,Jaén,905,Arroyo del Ojanco,2509,1288,1221
23,Jaén,9,Baeza,16360,8111,8249
23,Jaén,10,Bailén,18763,9447,9316
23,Jaén,11,Baños de la Encina,2733,1419,1314
23,Jaén,12,Beas de Segura,5674,2951,2723
23,Jaén,902,Bedmar y Garcíez,3132,1567,1565
23,Jaén,14,Begíjar,3174,1586,1588
23,Jaén,15,Bélmez de la Moraleda,1795,888,907
23,Jaén,16,Benatae,548,284,264
23,Jaén,17,Cabra del Santo Cristo,2070,1093,977
23,Jaén,18,Cambil,2940,1523,1417
23,Jaén,19,Campillo de Arenas,2084,1098,986
23,Jaén,20,Canena,2092,1061,1031
23,Jaén,21,Carboneros,670,352,318
23,Jaén,901,Cárcheles,1504,784,720
23,Jaén,24,Carolina (La),15901,7837,8064
23,Jaén,25,Castellar,3593,1839,1754
23,Jaén,26,Castillo de Locubín,4692,2314,2378
23,Jaén,27,Cazalilla,878,432,446
23,Jaén,28,Cazorla,8104,3925,4179
23,Jaén,29,Chiclana de Segura,1195,615,580
23,Jaén,30,Chilluévar,1603,785,818
23,Jaén,31,Escañuela,988,490,498
23,Jaén,32,Espelúy,753,383,370
23,Jaén,33,Frailes,1768,891,877
23,Jaén,34,Fuensanta de Martos,3267,1600,1667
23,Jaén,35,Fuerte del Rey,1388,713,675
23,Jaén,37,Génave,637,339,298
23,Jaén,38,Guardia de Jaén (La),4232,2197,2035
23,Jaén,39,Guarromán,2909,1462,1447
23,Jaén,41,Higuera de Calatrava,657,347,310
23,Jaén,42,Hinojares,414,216,198
23,Jaén,43,Hornos,683,340,343
23,Jaén,44,Huelma,6208,3087,3121
23,Jaén,45,Huesa,2667,1350,1317
23,Jaén,46,Ibros,3144,1581,1563
23,Jaén,47,Iruela (La),2011,1019,992
23,Jaén,48,Iznatoraf,1079,563,516
23,Jaén,49,Jabalquinto,2337,1186,1151
23,Jaén,50,Jaén,116790,56373,60417
23,Jaén,51,Jamilena,3521,1792,1729
23,Jaén,52,Jimena,1435,697,738
23,Jaén,53,Jódar,12117,6010,6107
23,Jaén,40,Lahiguera,1878,932,946
23,Jaén,54,Larva,502,259,243
23,Jaén,55,Linares,61306,29989,31317
23,Jaén,56,Lopera,3986,1971,2015
23,Jaén,57,Lupión,966,478,488
23,Jaén,58,Mancha Real,11088,5579,5509
23,Jaén,59,Marmolejo,7485,3766,3719
23,Jaén,60,Martos,24707,12140,12567
23,Jaén,61,Mengíbar,9797,4946,4851
23,Jaén,62,Montizón,1921,990,931
23,Jaén,63,Navas de San Juan,5021,2496,2525
23,Jaén,64,Noalejo,2005,1013,992
23,Jaén,65,Orcera,2037,1026,1011
23,Jaén,66,Peal de Becerro,5523,2773,2750
23,Jaén,67,Pegalajar,3116,1561,1555
23,Jaén,69,Porcuna,6825,3463,3362
23,Jaén,70,Pozo Alcón,5413,2791,2622
23,Jaén,71,Puente de Génave,2298,1138,1160
23,Jaén,72,Puerta de Segura (La),2653,1321,1332
23,Jaén,73,Quesada,5898,2944,2954
23,Jaén,74,Rus,3796,1942,1854
23,Jaén,75,Sabiote,4279,2148,2131
23,Jaén,76,Santa Elena,1007,530,477
23,Jaén,77,Santiago de Calatrava,857,446,411
23,Jaén,904,Santiago-Pontones,3702,1898,1804
23,Jaén,79,Santisteban del Puerto,4837,2483,2354
23,Jaén,80,Santo Tomé,2486,1292,1194
23,Jaén,81,Segura de la Sierra,2026,1023,1003
23,Jaén,82,Siles,2454,1242,1212
23,Jaén,84,Sorihuela del Guadalimar,1349,696,653
23,Jaén,86,Torre del Campo,14657,7389,7268
23,Jaén,85,Torreblascopedro,2859,1452,1407
23,Jaén,87,Torredonjimeno,14112,6948,7164
23,Jaén,88,Torreperogil,7516,3711,3805
23,Jaén,90,Torres,1656,832,824
23,Jaén,91,Torres de Albánchez,978,502,476
23,Jaén,92,Úbeda,36025,17674,18351
23,Jaén,93,Valdepeñas de Jaén,4137,2058,2079
23,Jaén,94,Vilches,4892,2470,2422
23,Jaén,95,Villacarrillo,11278,5694,5584
23,Jaén,96,Villanueva de la Reina,3403,1725,1678
23,Jaén,97,Villanueva del Arzobispo,8755,4545,4210
23,Jaén,98,Villardompardo,1122,563,559
23,Jaén,99,Villares (Los),5819,2888,2931
23,Jaén,101,Villarrodrigo,450,230,220
23,Jaén,903,Villatorres,4438,2255,2183
24,León,1,Acebedo,264,161,103
24,León,2,Algadefe,315,161,154
24,León,3,Alija del Infantado,843,423,420
24,León,4,Almanza,609,336,273
24,León,5,Antigua (La),483,268,215
24,León,6,Ardón,613,324,289
24,León,7,Arganza,944,488,456
24,León,8,Astorga,12015,5715,6300
24,León,9,Balboa,398,216,182
24,León,10,Bañeza (La),11050,5354,5696
24,León,11,Barjas,261,140,121
24,León,12,Barrios de Luna (Los),309,168,141
24,León,14,Bembibre,10097,5010,5087
24,León,15,Benavides,2838,1410,1428
24,León,16,Benuza,601,326,275
24,León,17,Bercianos del Páramo,713,362,351
24,León,18,Bercianos del Real Camino,202,103,99
24,León,19,Berlanga del Bierzo,389,181,208
24,León,20,Boca de Huérgano,531,307,224
24,León,21,Boñar,2085,1045,1040
24,León,22,Borrenes,402,199,203
24,León,23,Brazuelo,321,170,151
24,León,24,Burgo Ranero (El),841,463,378
24,León,25,Burón,358,208,150
24,León,26,Bustillo del Páramo,1484,764,720
24,León,27,Cabañas Raras,1329,683,646
24,León,28,Cabreros del Río,481,255,226
24,León,29,Cabrillanes,964,489,475
24,León,30,Cacabelos,5498,2751,2747
24,León,31,Calzada del Coto,260,149,111
24,León,32,Campazas,154,75,79
24,León,33,Campo de Villavidel,227,122,105
24,León,34,Camponaraya,4230,2135,2095
24,León,36,Candín,310,161,149
24,León,37,Cármenes,397,220,177
24,León,38,Carracedelo,3658,1815,1843
24,León,39,Carrizo,2537,1281,1256
24,León,40,Carrocera,555,281,274
24,León,41,Carucedo,642,327,315
24,León,42,Castilfalé,91,49,42
24,León,43,Castrillo de Cabrera,152,78,74
24,León,44,Castrillo de la Valduerna,190,87,103
24,León,46,Castrocalbón,1081,564,517
24,León,47,Castrocontrigo,917,470,447
24,León,49,Castropodame,1812,922,890
24,León,50,Castrotierra de Valmadrigal,124,66,58
24,León,51,Cea,530,271,259
24,León,52,Cebanico,195,112,83
24,León,53,Cebrones del Río,560,298,262
24,León,65,Chozas de Abajo,2424,1276,1148
24,León,54,Cimanes de la Vega,569,292,277
24,León,55,Cimanes del Tejar,825,435,390
24,León,56,Cistierna,3720,1810,1910
24,León,57,Congosto,1731,845,886
24,León,58,Corbillos de los Oteros,247,132,115
24,León,59,Corullón,1122,573,549
24,León,60,Crémenes,660,336,324
24,León,61,Cuadros,1980,990,990
24,León,62,Cubillas de los Oteros,167,88,79
24,León,63,Cubillas de Rueda,501,263,238
24,León,64,Cubillos del Sil,1771,931,840
24,León,66,Destriana,615,290,325
24,León,67,Encinedo,870,452,418
24,León,68,Ercina (La),561,286,275
24,León,69,Escobar de Campos,56,35,21
24,León,70,Fabero,5298,2605,2693
24,León,71,Folgoso de la Ribera,1233,598,635
24,León,73,Fresno de la Vega,629,317,312
24,León,74,Fuentes de Carbajal,121,62,59
24,León,76,Garrafe de Torío,1267,679,588
24,León,77,Gordaliza del Pino,304,150,154
24,León,78,Gordoncillo,499,256,243
24,León,79,Gradefes,1076,554,522
24,León,80,Grajal de Campos,246,117,129
24,León,81,Gusendos de los Oteros,139,80,59
24,León,82,Hospital de Órbigo,1031,496,535
24,León,83,Igüeña,1424,728,696
24,León,84,Izagre,214,114,100
24,León,86,Joarilla de las Matas,366,196,170
24,León,87,Laguna Dalga,741,389,352
24,León,88,Laguna de Negrillos,1164,593,571
24,León,89,León,134012,61685,72327
24,León,92,Llamas de la Ribera,970,488,482
24,León,90,Lucillo,406,214,192
24,León,91,Luyego,780,388,392
24,León,93,Magaz de Cepeda,412,201,211
24,León,94,Mansilla de las Mulas,1913,962,951
24,León,95,Mansilla Mayor,351,182,169
24,León,96,Maraña,147,86,61
24,León,97,Matadeón de los Oteros,285,151,134
24,León,98,Matallana de Torío,1435,730,705
24,León,99,Matanza,242,127,115
24,León,100,Molinaseca,818,430,388
24,León,101,Murias de Paredes,498,232,266
24,León,102,Noceda del Bierzo,774,385,389
24,León,103,Oencia,373,214,159
24,León,104,Omañas (Las),314,165,149
24,León,105,Onzonilla,1749,913,836
24,León,106,Oseja de Sajambre,275,154,121
24,León,107,Pajares de los Oteros,350,210,140
24,León,108,Palacios de la Valduerna,452,221,231
24,León,109,Palacios del Sil,1193,645,548
24,León,110,Páramo del Sil,1499,749,750
24,León,112,Peranzanes,316,184,132
24,León,113,Pobladura de Pelayo García,457,231,226
24,León,114,Pola de Gordón (La),3969,2009,1960
24,León,115,Ponferrada,68767,33241,35526
24,León,116,Posada de Valdeón,487,281,206
24,León,117,Pozuelo del Páramo,519,258,261
24,León,118,Prado de la Guzpeña,131,70,61
24,León,119,Priaranza del Bierzo,858,430,428
24,León,120,Prioro,418,227,191
24,León,121,Puebla de Lillo,682,381,301
24,León,122,Puente de Domingo Flórez,1697,885,812
24,León,123,Quintana del Castillo,909,486,423
24,León,124,Quintana del Marco,444,235,209
24,León,125,Quintana y Congosto,540,265,275
24,León,127,Regueras de Arriba,339,180,159
24,León,129,Reyero,127,66,61
24,León,130,Riaño,532,305,227
24,León,131,Riego de la Vega,924,462,462
24,León,132,Riello,733,399,334
24,León,133,Rioseco de Tapia,419,222,197
24,León,134,Robla (La),4606,2351,2255
24,León,136,Roperuelos del Páramo,664,341,323
24,León,137,Sabero,1406,691,715
24,León,139,Sahagún,2817,1380,1437
24,León,141,San Adrián del Valle,133,66,67
24,León,142,San Andrés del Rabanedo,31306,15220,16086
24,León,144,San Cristóbal de la Polantera,866,435,431
24,León,145,San Emiliano,656,346,310
24,León,146,San Esteban de Nogales,301,150,151
24,León,148,San Justo de la Vega,2054,1049,1005
24,León,149,San Millán de los Caballeros,188,96,92
24,León,150,San Pedro Bercianos,292,156,136
24,León,143,Sancedo,566,286,280
24,León,151,Santa Colomba de Curueño,564,285,279
24,León,152,Santa Colomba de Somoza,463,244,219
24,León,153,Santa Cristina de Valmadrigal,309,164,145
24,León,154,Santa Elena de Jamuz,1230,635,595
24,León,155,Santa María de la Isla,573,299,274
24,León,158,Santa María de Ordás,329,164,165
24,León,156,Santa María del Monte de Cea,279,143,136
24,León,157,Santa María del Páramo,3179,1576,1603
24,León,159,Santa Marina del Rey,2169,1088,1081
24,León,160,Santas Martas,898,475,423
24,León,161,Santiago Millas,347,180,167
24,León,162,Santovenia de la Valdoncina,1969,996,973
24,León,163,Sariegos,4416,2262,2154
24,León,164,Sena de Luna,397,190,207
24,León,165,Sobrado,395,201,194
24,León,166,Soto de la Vega,1785,923,862
24,León,167,Soto y Amío,938,456,482
24,León,168,Toral de los Guzmanes,603,322,281
24,León,169,Toreno,3739,1838,1901
24,León,170,Torre del Bierzo,2588,1300,1288
24,León,171,Trabadelo,447,246,201
24,León,172,Truchas,504,245,259
24,León,173,Turcia,1152,572,580
24,León,174,Urdiales del Páramo,576,301,275
24,León,185,Val de San Lorenzo,584,295,289
24,León,175,Valdefresno,2056,1060,996
24,León,176,Valdefuentes del Páramo,377,204,173
24,León,177,Valdelugueros,458,267,191
24,León,178,Valdemora,85,38,47
24,León,179,Valdepiélago,405,217,188
24,León,180,Valdepolo,1312,685,627
24,León,181,Valderas,2014,1025,989
24,León,182,Valderrey,502,238,264
24,León,183,Valderrueda,1004,511,493
24,León,184,Valdesamario,221,119,102
24,León,187,Valdevimbre,1063,557,506
24,León,188,Valencia de Don Juan,5079,2508,2571
24,León,191,Vallecillo,130,72,58
24,León,189,Valverde de la Virgen,6581,3333,3248
24,León,190,Valverde-Enrique,195,103,92
24,León,193,Vecilla (La),441,224,217
24,León,196,Vega de Espinareda,2494,1259,1235
24,León,197,Vega de Infanzones,911,455,456
24,León,198,Vega de Valcarce,712,363,349
24,León,194,Vegacervera,356,187,169
24,León,199,Vegaquemada,469,240,229
24,León,201,Vegas del Condado,1240,675,565
24,León,202,Villablino,10553,5212,5341
24,León,203,Villabraz,125,70,55
24,León,205,Villadangos del Páramo,1165,598,567
24,León,206,Villadecanes,2216,1102,1114
24,León,207,Villademor de la Vega,395,210,185
24,León,209,Villafranca del Bierzo,3516,1710,1806
24,León,210,Villagatón,648,327,321
24,León,211,Villamandos,333,173,160
24,León,901,Villamanín,1109,564,545
24,León,212,Villamañán,1282,628,654
24,León,213,Villamartín de Don Sancho,152,85,67
24,León,214,Villamejil,800,409,391
24,León,215,Villamol,193,96,97
24,León,216,Villamontán de la Valduerna,893,458,435
24,León,217,Villamoratiel de las Matas,160,92,68
24,León,218,Villanueva de las Manzanas,545,273,272
24,León,219,Villaobispo de Otero,651,353,298
24,León,902,Villaornate y Castro,400,211,189
24,León,221,Villaquejida,984,506,478
24,León,222,Villaquilambre,17631,8785,8846
24,León,223,Villarejo de Órbigo,3244,1595,1649
24,León,224,Villares de Órbigo,732,378,354
24,León,225,Villasabariego,1228,641,587
24,León,226,Villaselán,245,138,107
24,León,227,Villaturiel,1887,992,895
24,León,228,Villazala,829,433,396
24,León,229,Villazanzo de Valderaduey,537,298,239
24,León,230,Zotes del Páramo,491,275,216
25,Lleida,1,Abella de la Conca,181,104,77
25,Lleida,2,Àger,584,313,271
25,Lleida,3,Agramunt,5618,2868,2750
25,Lleida,38,Aitona,2393,1258,1135
25,Lleida,4,Alamús (Els),739,384,355
25,Lleida,5,Alàs i Cerc,386,208,178
25,Lleida,6,Albagés (L'),462,250,212
25,Lleida,7,Albatàrrec,1979,1040,939
25,Lleida,8,Albesa,1679,891,788
25,Lleida,9,Albi (L'),847,437,410
25,Lleida,10,Alcanó,235,113,122
25,Lleida,11,Alcarràs,8029,4165,3864
25,Lleida,12,Alcoletge,2816,1467,1349
25,Lleida,13,Alfarràs,3158,1639,1519
25,Lleida,14,Alfés,337,178,159
25,Lleida,15,Algerri,462,241,221
25,Lleida,16,Alguaire,3140,1659,1481
25,Lleida,17,Alins,313,166,147
25,Lleida,19,Almacelles,6577,3451,3126
25,Lleida,20,Almatret,399,211,188
25,Lleida,21,Almenar,3631,1914,1717
25,Lleida,22,Alòs de Balaguer,144,85,59
25,Lleida,23,Alpicat,6116,3052,3064
25,Lleida,24,Alt Àneu,446,255,191
25,Lleida,27,Anglesola,1355,682,673
25,Lleida,29,Arbeca,2469,1275,1194
25,Lleida,31,Arres,63,41,22
25,Lleida,32,Arsèguel,103,57,46
25,Lleida,33,Artesa de Lleida,1525,800,725
25,Lleida,34,Artesa de Segre,3839,1966,1873
25,Lleida,36,Aspa,242,127,115
25,Lleida,37,Avellanes i Santa Linya (Les),463,259,204
25,Lleida,39,Baix Pallars,406,215,191
25,Lleida,40,Balaguer,16766,8535,8231
25,Lleida,41,Barbens,887,479,408
25,Lleida,42,Baronia de Rialb (La),261,138,123
25,Lleida,44,Bassella,259,137,122
25,Lleida,45,Bausen,61,35,26
25,Lleida,46,Belianes,584,299,285
25,Lleida,170,Bellaguarda,334,178,156
25,Lleida,47,Bellcaire d'Urgell,1341,671,670
25,Lleida,48,Bell-lloc d'Urgell,2448,1204,1244
25,Lleida,49,Bellmunt d'Urgell,211,98,113
25,Lleida,50,Bellpuig,4942,2573,2369
25,Lleida,51,Bellver de Cerdanya,2260,1181,1079
25,Lleida,52,Bellvís,2506,1289,1217
25,Lleida,53,Benavent de Segrià,1522,784,738
25,Lleida,55,Biosca,216,122,94
25,Lleida,57,Bòrdes (Es),245,131,114
25,Lleida,58,Borges Blanques (Les),6049,3087,2962
25,Lleida,59,Bossòst,1184,608,576
25,Lleida,56,Bovera,341,177,164
25,Lleida,60,Cabanabona,110,49,61
25,Lleida,61,Cabó,95,51,44
25,Lleida,62,Camarasa,979,509,470
25,Lleida,63,Canejan,103,56,47
25,Lleida,904,Castell de Mur,182,95,87
25,Lleida,64,Castellar de la Ribera,156,78,78
25,Lleida,67,Castelldans,1009,548,461
25,Lleida,68,Castellnou de Seana,735,377,358
25,Lleida,69,Castelló de Farfanya,564,306,258
25,Lleida,70,Castellserà,1114,573,541
25,Lleida,71,Cava,57,34,23
25,Lleida,72,Cervera,9361,4787,4574
25,Lleida,73,Cervià de les Garrigues,816,423,393
25,Lleida,74,Ciutadilla,220,120,100
25,Lleida,75,Clariana de Cardener,150,78,72
25,Lleida,76,Cogul (El),193,106,87
25,Lleida,77,Coll de Nargó,619,312,307
25,Lleida,163,Coma i la Pedra (La),271,165,106
25,Lleida,161,Conca de Dalt,407,204,203
25,Lleida,78,Corbins,1380,739,641
25,Lleida,79,Cubells,407,213,194
25,Lleida,81,Espluga Calba (L'),427,222,205
25,Lleida,82,Espot,360,191,169
25,Lleida,88,Estamariu,118,67,51
25,Lleida,85,Estaràs,177,96,81
25,Lleida,86,Esterri d'Àneu,946,519,427
25,Lleida,87,Esterri de Cardós,75,36,39
25,Lleida,89,Farrera,133,78,55
25,Lleida,908,Fígols i Alinyà,282,155,127
25,Lleida,92,Floresta (La),179,100,79
25,Lleida,93,Fondarella,830,423,407
25,Lleida,94,Foradada,188,109,79
25,Lleida,96,Fuliola (La),1270,634,636
25,Lleida,97,Fulleda,102,53,49
25,Lleida,98,Gavet de la Conca,309,154,155
25,Lleida,912,Gimenells i el Pla de la Font,1183,601,582
25,Lleida,99,Golmés,1685,839,846
25,Lleida,100,Gósol,225,122,103
25,Lleida,101,Granadella (La),772,412,360
25,Lleida,102,Granja d'Escarp (La),986,525,461
25,Lleida,103,Granyanella,156,80,76
25,Lleida,105,Granyena de les Garrigues,177,102,75
25,Lleida,104,Granyena de Segarra,139,69,70
25,Lleida,109,Guimerà,330,178,152
25,Lleida,903,Guingueta d'Àneu (La),356,192,164
25,Lleida,110,Guissona,6267,3358,2909
25,Lleida,111,Guixers,135,78,57
25,Lleida,115,Isona i Conca Dellà,1150,612,538
25,Lleida,112,Ivars de Noguera,360,196,164
25,Lleida,113,Ivars d'Urgell,1716,922,794
25,Lleida,114,Ivorra,122,65,57
25,Lleida,910,Josa i Tuixén,141,78,63
25,Lleida,118,Juncosa,479,253,226
25,Lleida,119,Juneda,3487,1836,1651
25,Lleida,121,Les,983,493,490
25,Lleida,122,Linyola,2774,1446,1328
25,Lleida,123,Lladorre,232,115,117
25,Lleida,124,Lladurs,193,109,84
25,Lleida,125,Llardecans,521,268,253
25,Lleida,126,Llavorsí,380,199,181
25,Lleida,120,Lleida,137387,68290,69097
25,Lleida,127,Lles de Cerdanya,268,163,105
25,Lleida,128,Llimiana,173,96,77
25,Lleida,129,Llobera,209,112,97
25,Lleida,133,Maials,1006,522,484
25,Lleida,130,Maldà,258,136,122
25,Lleida,131,Massalcoreig,590,304,286
25,Lleida,132,Massoteres,212,114,98
25,Lleida,134,Menàrguens,867,467,400
25,Lleida,135,Miralcamp,1424,719,705
25,Lleida,137,Mollerussa,14733,7645,7088
25,Lleida,136,Molsosa (La),117,60,57
25,Lleida,139,Montellà i Martinet,671,348,323
25,Lleida,140,Montferrer i Castellbò,1086,587,499
25,Lleida,138,Montgai,718,367,351
25,Lleida,142,Montoliu de Lleida,495,250,245
25,Lleida,141,Montoliu de Segarra,197,117,80
25,Lleida,143,Montornès de Segarra,104,53,51
25,Lleida,145,Nalec,98,52,46
25,Lleida,25,Naut Aran,1729,883,846
25,Lleida,146,Navès,276,137,139
25,Lleida,148,Odèn,264,160,104
25,Lleida,149,Oliana,1945,980,965
25,Lleida,150,Oliola,232,133,99
25,Lleida,151,Olius,841,440,401
25,Lleida,152,Oluges (Les),176,98,78
25,Lleida,153,Omellons (Els),254,137,117
25,Lleida,154,Omells de na Gaia (Els),144,76,68
25,Lleida,155,Organyà,942,463,479
25,Lleida,156,Os de Balaguer,987,518,469
25,Lleida,157,Ossó de Sió,226,114,112
25,Lleida,158,Palau d'Anglesola (El),2120,1053,1067
25,Lleida,164,Penelles,502,288,214
25,Lleida,165,Peramola,387,203,184
25,Lleida,166,Pinell de Solsonès,215,116,99
25,Lleida,167,Pinós,315,172,143
25,Lleida,911,Plans de Sió (Els),571,302,269
25,Lleida,168,Poal (El),622,323,299
25,Lleida,169,Pobla de Cérvoles (La),240,129,111
25,Lleida,171,Pobla de Segur (La),3266,1619,1647
25,Lleida,30,Pont de Bar (El),194,111,83
25,Lleida,173,Pont de Suert (El),2506,1300,1206
25,Lleida,172,Ponts,2744,1391,1353
25,Lleida,174,Portella (La),773,427,346
25,Lleida,175,Prats i Sansor,245,139,106
25,Lleida,176,Preixana,437,225,212
25,Lleida,177,Preixens,478,237,241
25,Lleida,179,Prullans,245,118,127
25,Lleida,180,Puiggròs,311,165,146
25,Lleida,181,Puigverd d'Agramunt,275,155,120
25,Lleida,182,Puigverd de Lleida,1390,716,674
25,Lleida,183,Rialp,654,347,307
25,Lleida,905,Ribera d'Ondara,454,232,222
25,Lleida,185,Ribera d'Urgellet,982,517,465
25,Lleida,186,Riner,292,141,151
25,Lleida,913,Riu de Cerdanya,111,63,48
25,Lleida,189,Rosselló,2950,1507,1443
25,Lleida,190,Salàs de Pallars,334,169,165
25,Lleida,191,Sanaüja,458,240,218
25,Lleida,196,Sant Esteve de la Sarga,144,86,58
25,Lleida,192,Sant Guim de Freixenet,1114,560,554
25,Lleida,197,Sant Guim de la Plana,192,103,89
25,Lleida,193,Sant Llorenç de Morunys,1077,551,526
25,Lleida,902,Sant Martí de Riucorb,685,356,329
25,Lleida,194,Sant Ramon,569,310,259
25,Lleida,201,Sarroca de Bellera,136,79,57
25,Lleida,200,Sarroca de Lleida,433,231,202
25,Lleida,202,Senterada,142,77,65
25,Lleida,35,Sentiu de Sió (La),502,249,253
25,Lleida,204,Seròs,1867,1038,829
25,Lleida,203,Seu d'Urgell (La),13060,6432,6628
25,Lleida,205,Sidamon,758,384,374
25,Lleida,206,Soleràs (El),376,201,175
25,Lleida,207,Solsona,9219,4668,4551
25,Lleida,208,Soriguera,377,204,173
25,Lleida,209,Sort,2387,1211,1176
25,Lleida,210,Soses,1763,926,837
25,Lleida,211,Sudanell,878,487,391
25,Lleida,212,Sunyer,307,163,144
25,Lleida,215,Talarn,395,190,205
25,Lleida,216,Talavera,302,170,132
25,Lleida,217,Tàrrega,17189,8694,8495
25,Lleida,218,Tarrés,109,55,54
25,Lleida,219,Tarroja de Segarra,169,87,82
25,Lleida,220,Térmens,1528,786,742
25,Lleida,221,Tírvia,159,83,76
25,Lleida,222,Tiurana,81,39,42
25,Lleida,223,Torà,1367,698,669
25,Lleida,224,Torms (Els),171,94,77
25,Lleida,225,Tornabous,863,461,402
25,Lleida,227,Torre de Cabdella (La),791,401,390
25,Lleida,226,Torrebesses,299,156,143
25,Lleida,228,Torrefarrera,4151,2100,2051
25,Lleida,907,Torrefeta i Florejacs,617,319,298
25,Lleida,230,Torregrossa,2251,1144,1107
25,Lleida,231,Torrelameu,690,393,297
25,Lleida,232,Torres de Segre,2080,1078,1002
25,Lleida,233,Torre-serona,350,180,170
25,Lleida,234,Tremp,6368,3161,3207
25,Lleida,43,Vall de Boí (La),1076,584,492
25,Lleida,901,Vall de Cardós,422,223,199
25,Lleida,238,Vallbona de les Monges,251,134,117
25,Lleida,240,Vallfogona de Balaguer,1788,893,895
25,Lleida,906,Valls d'Aguilar (Les),304,169,135
25,Lleida,239,Valls de Valira (Les),826,444,382
25,Lleida,909,Vansa i Fórnols (La),219,121,98
25,Lleida,242,Verdú,1005,482,523
25,Lleida,243,Vielha e Mijaran,5636,2942,2694
25,Lleida,244,Vilagrassa,458,233,225
25,Lleida,245,Vilaller,696,405,291
25,Lleida,247,Vilamòs,202,108,94
25,Lleida,248,Vilanova de Bellpuig,1194,623,571
25,Lleida,254,Vilanova de la Barca,1235,636,599
25,Lleida,249,Vilanova de l'Aguda,235,117,118
25,Lleida,250,Vilanova de Meià,420,218,202
25,Lleida,251,Vilanova de Segrià,862,454,408
25,Lleida,252,Vila-sana,688,343,345
25,Lleida,253,Vilosell (El),200,102,98
25,Lleida,255,Vinaixa,609,310,299
27,Lugo,1,Abadín,2858,1391,1467
27,Lugo,2,Alfoz,2078,1012,1066
27,Lugo,3,Antas de Ulla,2346,1152,1194
27,Lugo,4,Baleira,1533,800,733
27,Lugo,901,Baralla,2916,1512,1404
27,Lugo,5,Barreiros,3203,1536,1667
27,Lugo,6,Becerreá,3181,1612,1569
27,Lugo,7,Begonte,3413,1702,1711
27,Lugo,8,Bóveda,1650,813,837
27,Lugo,902,Burela,9536,4793,4743
27,Lugo,9,Carballedo,2664,1320,1344
27,Lugo,10,Castro de Rei,5566,2763,2803
27,Lugo,11,Castroverde,3012,1552,1460
27,Lugo,12,Cervantes,1695,954,741
27,Lugo,13,Cervo,4595,2299,2296
27,Lugo,16,Chantada,8951,4342,4609
27,Lugo,14,Corgo (O),3938,1990,1948
27,Lugo,15,Cospeito,5170,2526,2644
27,Lugo,17,Folgoso do Courel,1196,631,565
27,Lugo,18,Fonsagrada (A),4412,2306,2106
27,Lugo,19,Foz,9990,4853,5137
27,Lugo,20,Friol,4246,2101,2145
27,Lugo,22,Guitiriz,5821,2903,2918
27,Lugo,23,Guntín,3075,1544,1531
27,Lugo,24,Incio (O),2016,980,1036
27,Lugo,26,Láncara,2930,1483,1447
27,Lugo,27,Lourenzá,2506,1223,1283
27,Lugo,28,Lugo,97635,45593,52042
27,Lugo,29,Meira,1787,885,902
27,Lugo,30,Mondoñedo,4406,2048,2358
27,Lugo,31,Monforte de Lemos,19638,9391,10247
27,Lugo,32,Monterroso,4167,2141,2026
27,Lugo,33,Muras,787,390,397
27,Lugo,34,Navia de Suarna,1421,772,649
27,Lugo,35,Negueira de Muñiz,207,111,96
27,Lugo,37,Nogais (As),1361,699,662
27,Lugo,38,Ourol,1175,572,603
27,Lugo,39,Outeiro de Rei,4936,2544,2392
27,Lugo,40,Palas de Rei,3643,1784,1859
27,Lugo,41,Pantón,2938,1408,1530
27,Lugo,42,Paradela,2091,1038,1053
27,Lugo,43,Páramo (O),1632,822,810
27,Lugo,44,Pastoriza (A),3496,1734,1762
27,Lugo,45,Pedrafita do Cebreiro,1263,678,585
27,Lugo,47,Pobra do Brollón (A),2066,1020,1046
27,Lugo,46,Pol,1797,894,903
27,Lugo,48,Pontenova (A),2785,1370,1415
27,Lugo,49,Portomarín,1763,901,862
27,Lugo,50,Quiroga,3766,1815,1951
27,Lugo,56,Rábade,1723,867,856
27,Lugo,51,Ribadeo,9988,4752,5236
27,Lugo,52,Ribas de Sil,1135,565,570
27,Lugo,53,Ribeira de Piquín,664,342,322
27,Lugo,54,Riotorto,1500,735,765
27,Lugo,55,Samos,1646,853,793
27,Lugo,57,Sarria,13611,6677,6934
27,Lugo,58,Saviñao (O),4460,2220,2240
27,Lugo,59,Sober,2599,1251,1348
27,Lugo,60,Taboada,3404,1645,1759
27,Lugo,61,Trabada,1346,666,680
27,Lugo,62,Triacastela,771,378,393
27,Lugo,63,Valadouro (O),2185,1082,1103
27,Lugo,64,Vicedo (O),1973,966,1007
27,Lugo,65,Vilalba,15327,7482,7845
27,Lugo,66,Viveiro,16211,7974,8237
27,Lugo,21,Xermade,2204,1078,1126
27,Lugo,25,Xove,3500,1747,1753
28,Madrid,1,Acebeda (La),59,30,29
28,Madrid,2,Ajalvir,3909,2046,1863
28,Madrid,3,Alameda del Valle,239,136,103
28,Madrid,4,Álamo (El),8079,4019,4060
28,Madrid,5,Alcalá de Henares,204120,101964,102156
28,Madrid,6,Alcobendas,110080,53421,56659
28,Madrid,7,Alcorcón,168299,82722,85577
28,Madrid,8,Aldea del Fresno,2483,1327,1156
28,Madrid,9,Algete,20481,10252,10229
28,Madrid,10,Alpedrete,13163,6543,6620
28,Madrid,11,Ambite,556,287,269
28,Madrid,12,Anchuelo,1083,571,512
28,Madrid,13,Aranjuez,55054,27023,28031
28,Madrid,14,Arganda del Rey,53135,27298,25837
28,Madrid,15,Arroyomolinos,16207,8290,7917
28,Madrid,16,Atazar (El),102,54,48
28,Madrid,17,Batres,1488,755,733
28,Madrid,18,Becerril de la Sierra,5159,2547,2612
28,Madrid,19,Belmonte de Tajo,1488,755,733
28,Madrid,21,Berrueco (El),605,318,287
28,Madrid,20,Berzosa del Lozoya,208,113,95
28,Madrid,22,Boadilla del Monte,44709,21892,22817
28,Madrid,23,Boalo (El),6638,3464,3174
28,Madrid,24,Braojos,191,105,86
28,Madrid,25,Brea de Tajo,556,311,245
28,Madrid,26,Brunete,9814,4911,4903
28,Madrid,27,Buitrago del Lozoya,2068,1039,1029
28,Madrid,28,Bustarviejo,2125,1080,1045
28,Madrid,29,Cabanillas de la Sierra,743,404,339
28,Madrid,30,Cabrera (La),2490,1267,1223
28,Madrid,31,Cadalso de los Vidrios,2944,1530,1414
28,Madrid,32,Camarma de Esteruelas,6610,3400,3210
28,Madrid,33,Campo Real,5278,2718,2560
28,Madrid,34,Canencia,504,271,233
28,Madrid,35,Carabaña,1991,999,992
28,Madrid,36,Casarrubuelos,3150,1618,1532
28,Madrid,37,Cenicientos,2102,1030,1072
28,Madrid,38,Cercedilla,7089,3487,3602
28,Madrid,39,Cervera de Buitrago,181,107,74
28,Madrid,51,Chapinería,2134,1087,1047
28,Madrid,52,Chinchón,5344,2720,2624
28,Madrid,40,Ciempozuelos,22656,11500,11156
28,Madrid,41,Cobeña,6164,3038,3126
28,Madrid,46,Collado Mediano,6527,3320,3207
28,Madrid,47,Collado Villalba,59900,29594,30306
28,Madrid,43,Colmenar de Oreja,8397,4274,4123
28,Madrid,42,Colmenar del Arroyo,1446,729,717
28,Madrid,45,Colmenar Viejo,44437,22065,22372
28,Madrid,44,Colmenarejo,8525,4223,4302
28,Madrid,48,Corpa,593,315,278
28,Madrid,49,Coslada,91218,45770,45448
28,Madrid,50,Cubas de la Sagra,4743,2359,2384
28,Madrid,53,Daganzo de Arriba,8989,4543,4446
28,Madrid,54,Escorial (El),15108,7449,7659
28,Madrid,55,Estremera,1508,756,752
28,Madrid,56,Fresnedillas de la Oliva,1507,785,722
28,Madrid,57,Fresno de Torote,2063,1089,974
28,Madrid,58,Fuenlabrada,198973,100089,98884
28,Madrid,59,Fuente el Saz de Jarama,6320,3216,3104
28,Madrid,60,Fuentidueña de Tajo,2095,1070,1025
28,Madrid,61,Galapagar,32393,16174,16219
28,Madrid,62,Garganta de los Montes,386,199,187
28,Madrid,63,Gargantilla del Lozoya y Pinilla de Buitrago,393,220,173
28,Madrid,64,Gascones,163,95,68
28,Madrid,65,Getafe,169130,83743,85387
28,Madrid,66,Griñón,9546,4789,4757
28,Madrid,67,Guadalix de la Sierra,5877,2990,2887
28,Madrid,68,Guadarrama,15155,7466,7689
28,Madrid,69,Hiruela (La),66,41,25
28,Madrid,70,Horcajo de la Sierra-Aoslos,171,100,71
28,Madrid,71,Horcajuelo de la Sierra,95,45,50
28,Madrid,72,Hoyo de Manzanares,7600,3771,3829
28,Madrid,73,Humanes de Madrid,18541,9481,9060
28,Madrid,74,Leganés,187227,92425,94802
28,Madrid,75,Loeches,7267,3641,3626
28,Madrid,76,Lozoya,670,354,316
28,Madrid,901,Lozoyuela-Navas-Sieteiglesias,1082,583,499
28,Madrid,78,Madarcos,49,30,19
28,Madrid,79,Madrid,3273049,1537890,1735159
28,Madrid,80,Majadahonda,69439,33154,36285
28,Madrid,82,Manzanares el Real,7450,3837,3613
28,Madrid,83,Meco,12580,6437,6143
28,Madrid,84,Mejorada del Campo,22812,11451,11361
28,Madrid,85,Miraflores de la Sierra,5934,3000,2934
28,Madrid,86,Molar (El),7645,3946,3699
28,Madrid,87,Molinos (Los),4565,2304,2261
28,Madrid,88,Montejo de la Sierra,364,193,171
28,Madrid,89,Moraleja de Enmedio,4852,2448,2404
28,Madrid,90,Moralzarzal,11801,5929,5872
28,Madrid,91,Morata de Tajuña,7382,3758,3624
28,Madrid,92,Móstoles,206015,102180,103835
28,Madrid,93,Navacerrada,2765,1358,1407
28,Madrid,94,Navalafuente,1169,627,542
28,Madrid,95,Navalagamella,2383,1268,1115
28,Madrid,96,Navalcarnero,23115,11569,11546
28,Madrid,97,Navarredonda y San Mamés,140,80,60
28,Madrid,99,Navas del Rey,2609,1371,1238
28,Madrid,100,Nuevo Baztán,6286,3205,3081
28,Madrid,101,Olmeda de las Fuentes,308,161,147
28,Madrid,102,Orusco de Tajuña,1198,604,594
28,Madrid,104,Paracuellos de Jarama,16219,8274,7945
28,Madrid,106,Parla,120182,61473,58709
28,Madrid,107,Patones,494,236,258
28,Madrid,108,Pedrezuela,4482,2330,2152
28,Madrid,109,Pelayos de la Presa,2544,1284,1260
28,Madrid,110,Perales de Tajuña,2894,1453,1441
28,Madrid,111,Pezuela de las Torres,813,421,392
28,Madrid,112,Pinilla del Valle,209,116,93
28,Madrid,113,Pinto,44524,22311,22213
28,Madrid,114,Piñuécar-Gandullas,176,91,85
28,Madrid,115,Pozuelo de Alarcón,82804,39752,43052
28,Madrid,116,Pozuelo del Rey,895,477,418
28,Madrid,117,Prádena del Rincón,127,73,54
28,Madrid,118,Puebla de la Sierra,111,63,48
28,Madrid,902,Puentes Viejas,649,381,268
28,Madrid,119,Quijorna,2850,1462,1388
28,Madrid,120,Rascafría,2004,1092,912
28,Madrid,121,Redueña,278,146,132
28,Madrid,122,Ribatejada,656,339,317
28,Madrid,123,Rivas-Vaciamadrid,70840,35502,35338
28,Madrid,124,Robledillo de la Jara,94,46,48
28,Madrid,125,Robledo de Chavela,3876,1992,1884
28,Madrid,126,Robregordo,61,35,26
28,Madrid,127,Rozas de Madrid (Las),88065,42769,45296
28,Madrid,128,Rozas de Puerto Real,446,255,191
28,Madrid,129,San Agustín del Guadalix,11885,5934,5951
28,Madrid,130,San Fernando de Henares,41384,20639,20745
28,Madrid,131,San Lorenzo de El Escorial,18352,8760,9592
28,Madrid,132,San Martín de la Vega,18863,9816,9047
28,Madrid,133,San Martín de Valdeiglesias,8190,4103,4087
28,Madrid,134,San Sebastián de los Reyes,78157,38288,39869
28,Madrid,135,Santa María de la Alameda,1164,629,535
28,Madrid,136,Santorcaz,822,429,393
28,Madrid,137,Santos de la Humosa (Los),2165,1125,1040
28,Madrid,138,Serna del Monte (La),99,52,47
28,Madrid,140,Serranillos del Valle,3440,1717,1723
28,Madrid,141,Sevilla la Nueva,8578,4264,4314
28,Madrid,143,Somosierra,105,62,43
28,Madrid,144,Soto del Real,8434,4176,4258
28,Madrid,145,Talamanca de Jarama,2927,1487,1440
28,Madrid,146,Tielmes,2581,1336,1245
28,Madrid,147,Titulcia,1179,617,562
28,Madrid,148,Torrejón de Ardoz,118441,59637,58804
28,Madrid,149,Torrejón de la Calzada,6904,3435,3469
28,Madrid,150,Torrejón de Velasco,4091,2080,2011
28,Madrid,151,Torrelaguna,4928,2574,2354
28,Madrid,152,Torrelodones,22117,10721,11396
28,Madrid,153,Torremocha de Jarama,795,389,406
28,Madrid,154,Torres de la Alameda,7896,4047,3849
28,Madrid,903,Tres Cantos,41147,20020,21127
28,Madrid,155,Valdaracete,686,339,347
28,Madrid,156,Valdeavero,1319,697,622
28,Madrid,157,Valdelaguna,887,453,434
28,Madrid,158,Valdemanco,952,510,442
28,Madrid,159,Valdemaqueda,856,424,432
28,Madrid,160,Valdemorillo,11210,5770,5440
28,Madrid,161,Valdemoro,65922,33096,32826
28,Madrid,162,Valdeolmos-Alalpardo,3176,1636,1540
28,Madrid,163,Valdepiélagos,503,259,244
28,Madrid,164,Valdetorres de Jarama,4042,2092,1950
28,Madrid,165,Valdilecha,2828,1456,1372
28,Madrid,166,Valverde de Alcalá,449,244,205
28,Madrid,167,Velilla de San Antonio,11668,5958,5710
28,Madrid,168,Vellón (El),1702,888,814
28,Madrid,169,Venturada,1741,900,841
28,Madrid,171,Villa del Prado,6462,3392,3070
28,Madrid,170,Villaconejos,3482,1781,1701
28,Madrid,172,Villalbilla,9819,5020,4799
28,Madrid,173,Villamanrique de Tajo,795,417,378
28,Madrid,174,Villamanta,2480,1253,1227
28,Madrid,175,Villamantilla,952,469,483
28,Madrid,176,Villanueva de la Cañada,17271,8380,8891
28,Madrid,178,Villanueva de Perales,1403,724,679
28,Madrid,177,Villanueva del Pardillo,15609,7665,7944
28,Madrid,179,Villar del Olmo,2150,1118,1032
28,Madrid,180,Villarejo de Salvanés,7394,3758,3636
28,Madrid,181,Villaviciosa de Odón,26725,13087,13638
28,Madrid,182,Villavieja del Lozoya,254,133,121
28,Madrid,183,Zarzalejo,1511,797,714
29,Málaga,1,Alameda,5486,2736,2750
29,Málaga,2,Alcaucín,2668,1344,1324
29,Málaga,3,Alfarnate,1338,691,647
29,Málaga,4,Alfarnatejo,543,274,269
29,Málaga,5,Algarrobo,6350,3182,3168
29,Málaga,6,Algatocín,937,475,462
29,Málaga,7,Alhaurín de la Torre,35832,17939,17893
29,Málaga,8,Alhaurín el Grande,23675,11913,11762
29,Málaga,9,Almáchar,1899,970,929
29,Málaga,10,Almargen,2137,1067,1070
29,Málaga,11,Almogía,4257,2183,2074
29,Málaga,12,Álora,13474,6773,6701
29,Málaga,13,Alozaina,2244,1148,1096
29,Málaga,14,Alpandeire,270,135,135
29,Málaga,15,Antequera,45234,22256,22978
29,Málaga,16,Árchez,446,231,215
29,Málaga,17,Archidona,8837,4408,4429
29,Málaga,18,Ardales,2660,1329,1331
29,Málaga,19,Arenas,1411,742,669
29,Málaga,20,Arriate,4137,2033,2104
29,Málaga,21,Atajate,127,70,57
29,Málaga,22,Benadalid,265,122,143
29,Málaga,23,Benahavís,4932,2552,2380
29,Málaga,24,Benalauría,506,269,237
29,Málaga,25,Benalmádena,61383,30299,31084
29,Málaga,26,Benamargosa,1610,815,795
29,Málaga,27,Benamocarra,3035,1553,1482
29,Málaga,28,Benaoján,1602,827,775
29,Málaga,29,Benarrabá,567,292,275
29,Málaga,30,Borge (El),1015,526,489
29,Málaga,31,Burgo (El),1981,996,985
29,Málaga,32,Campillos,8641,4315,4326
29,Málaga,33,Canillas de Aceituno,2285,1181,1104
29,Málaga,34,Canillas de Albaida,924,468,456
29,Málaga,35,Cañete la Real,1990,1005,985
29,Málaga,36,Carratraca,886,450,436
29,Málaga,37,Cartajima,266,136,130
29,Málaga,38,Cártama,22173,11341,10832
29,Málaga,39,Casabermeja,3554,1875,1679
29,Málaga,40,Casarabonela,2723,1426,1297
29,Málaga,41,Casares,5182,2697,2485
29,Málaga,42,Coín,22030,11294,10736
29,Málaga,43,Colmenar,3681,1875,1806
29,Málaga,44,Comares,1615,854,761
29,Málaga,45,Cómpeta,3862,1982,1880
29,Málaga,46,Cortes de la Frontera,3642,1846,1796
29,Málaga,47,Cuevas Bajas,1459,737,722
29,Málaga,49,Cuevas de San Marcos,4107,2071,2036
29,Málaga,48,Cuevas del Becerro,1771,874,897
29,Málaga,50,Cútar,671,341,330
29,Málaga,51,Estepona,66150,33137,33013
29,Málaga,52,Faraján,252,117,135
29,Málaga,53,Frigiliana,3171,1568,1603
29,Málaga,54,Fuengirola,71783,35455,36328
29,Málaga,55,Fuente de Piedra,2795,1423,1372
29,Málaga,56,Gaucín,1845,962,883
29,Málaga,57,Genalguacil,491,259,232
29,Málaga,58,Guaro,2285,1145,1140
29,Málaga,59,Humilladero,3324,1647,1677
29,Málaga,60,Igualeja,908,448,460
29,Málaga,61,Istán,1486,767,719
29,Málaga,62,Iznate,923,481,442
29,Málaga,63,Jimera de Líbar,473,244,229
29,Málaga,64,Jubrique,751,373,378
29,Málaga,65,Júzcar,221,124,97
29,Málaga,66,Macharaviaya,519,276,243
29,Málaga,67,Málaga,568507,273958,294549
29,Málaga,68,Manilva,14168,7351,6817
29,Málaga,69,Marbella,136322,66444,69878
29,Málaga,70,Mijas,76362,38323,38039
29,Málaga,71,Moclinejo,1274,652,622
29,Málaga,72,Mollina,5274,2688,2586
29,Málaga,73,Monda,2470,1266,1204
29,Málaga,74,Montejaque,1017,492,525
29,Málaga,75,Nerja,21957,10876,11081
29,Málaga,76,Ojén,2949,1523,1426
29,Málaga,77,Parauta,254,120,134
29,Málaga,79,Periana,3602,1868,1734
29,Málaga,80,Pizarra,8990,4598,4392
29,Málaga,81,Pujerra,347,187,160
29,Málaga,82,Rincón de la Victoria,39922,19796,20126
29,Málaga,83,Riogordo,3059,1574,1485
29,Málaga,84,Ronda,36909,18082,18827
29,Málaga,85,Salares,205,109,96
29,Málaga,86,Sayalonga,1555,782,773
29,Málaga,87,Sedella,687,370,317
29,Málaga,88,Sierra de Yeguas,3545,1773,1772
29,Málaga,89,Teba,4184,2109,2075
29,Málaga,90,Tolox,2346,1189,1157
29,Málaga,901,Torremolinos,66957,33618,33339
29,Málaga,91,Torrox,17303,8691,8612
29,Málaga,92,Totalán,737,381,356
29,Málaga,93,Valle de Abdalajís,2802,1383,1419
29,Málaga,94,Vélez-Málaga,75623,37630,37993
29,Málaga,95,Villanueva de Algaidas,4515,2314,2201
29,Málaga,98,Villanueva de Tapia,1675,862,813
29,Málaga,96,Villanueva del Rosario,3698,1827,1871
29,Málaga,97,Villanueva del Trabuco,5447,2740,2707
29,Málaga,99,Viñuela,1993,1014,979
29,Málaga,100,Yunquera,3205,1641,1564
30,Murcia,1,Abanilla,6585,3319,3266
30,Murcia,2,Abarán,12974,6563,6411
30,Murcia,3,Águilas,34900,17587,17313
30,Murcia,4,Albudeite,1350,682,668
30,Murcia,5,Alcantarilla,41326,20553,20773
30,Murcia,902,Alcázares (Los),15993,8285,7708
30,Murcia,6,Aledo,1053,533,520
30,Murcia,7,Alguazas,9146,4747,4399
30,Murcia,8,Alhama de Murcia,20269,10348,9921
30,Murcia,9,Archena,18135,9455,8680
30,Murcia,10,Beniel,11027,5695,5332
30,Murcia,11,Blanca,6456,3280,3176
30,Murcia,12,Bullas,12424,6322,6102
30,Murcia,13,Calasparra,10851,5498,5353
30,Murcia,14,Campos del Río,2169,1048,1121
30,Murcia,15,Caravaca de la Cruz,26449,13282,13167
30,Murcia,16,Cartagena,214165,107774,106391
30,Murcia,17,Cehegín,16299,8248,8051
30,Murcia,18,Ceutí,10448,5298,5150
30,Murcia,19,Cieza,35385,17775,17610
30,Murcia,20,Fortuna,9813,5233,4580
30,Murcia,21,Fuente Álamo de Murcia,15193,8000,7193
30,Murcia,22,Jumilla,26015,13626,12389
30,Murcia,23,Librilla,4614,2321,2293
30,Murcia,24,Lorca,92694,48171,44523
30,Murcia,25,Lorquí,7038,3621,3417
30,Murcia,26,Mazarrón,35464,18614,16850
30,Murcia,27,Molina de Segura,65815,33094,32721
30,Murcia,28,Moratalla,8444,4313,4131
30,Murcia,29,Mula,17076,8742,8334
30,Murcia,30,Murcia,441345,218501,222844
30,Murcia,31,Ojós,582,310,272
30,Murcia,32,Pliego,4045,2099,1946
30,Murcia,33,Puerto Lumbreras,14120,7071,7049
30,Murcia,34,Ricote,1441,742,699
30,Murcia,35,San Javier,31820,16264,15556
30,Murcia,36,San Pedro del Pinatar,23903,12128,11775
30,Murcia,901,Santomera,15481,7872,7609
30,Murcia,37,Torre-Pacheco,32471,17046,15425
30,Murcia,38,Torres de Cotillas (Las),21282,10972,10310
30,Murcia,39,Totana,29333,15123,14210
30,Murcia,40,Ulea,921,475,446
30,Murcia,41,Unión (La),18366,9234,9132
30,Murcia,42,Villanueva del Río Segura,2354,1158,1196
30,Murcia,43,Yecla,34945,17605,17340
31,Navarra,1,Abáigar,102,53,49
31,Navarra,2,Abárzuza,577,290,287
31,Navarra,3,Abaurregaina/Abaurrea Alta,138,81,57
31,Navarra,4,Abaurrepea/Abaurrea Baja,41,28,13
31,Navarra,5,Aberin,365,199,166
31,Navarra,6,Ablitas,2629,1336,1293
31,Navarra,7,Adiós,179,98,81
31,Navarra,8,Aguilar de Codés,108,54,54
31,Navarra,9,Aibar/Oibar,904,500,404
31,Navarra,11,Allín,812,432,380
31,Navarra,12,Allo,1071,534,537
31,Navarra,10,Altsasu/Alsasua,7698,3900,3798
31,Navarra,13,Améscoa Baja,805,430,375
31,Navarra,14,Ancín/Antzin,379,208,171
31,Navarra,15,Andosilla,3039,1587,1452
31,Navarra,16,Ansoáin/Antsoain,10603,5334,5269
31,Navarra,17,Anue,358,214,144
31,Navarra,18,Añorbe,553,304,249
31,Navarra,19,Aoiz/Agoitz,2544,1266,1278
31,Navarra,20,Araitz,576,335,241
31,Navarra,25,Arakil,965,520,445
31,Navarra,21,Aranarache/Aranaratxe,86,46,40
31,Navarra,23,Aranguren,7317,3755,3562
31,Navarra,24,Arano,122,67,55
31,Navarra,22,Arantza,647,360,287
31,Navarra,26,Aras,186,106,80
31,Navarra,27,Arbizu,1082,559,523
31,Navarra,28,Arce/Artzi,254,148,106
31,Navarra,29,Arcos (Los),1263,625,638
31,Navarra,30,Arellano,200,116,84
31,Navarra,31,Areso,277,152,125
31,Navarra,32,Arguedas,2380,1223,1157
31,Navarra,33,Aria,57,33,24
31,Navarra,34,Aribe,47,25,22
31,Navarra,35,Armañanzas,64,32,32
31,Navarra,36,Arróniz,1134,621,513
31,Navarra,37,Arruazu,113,63,50
31,Navarra,38,Artajona,1760,912,848
31,Navarra,39,Artazu,122,61,61
31,Navarra,40,Atez,247,139,108
31,Navarra,58,Auritz/Burguete,298,147,151
31,Navarra,41,Ayegui/Aiegi,1742,900,842
31,Navarra,42,Azagra,3848,1987,1861
31,Navarra,43,Azuelo,41,18,23
31,Navarra,44,Bakaiku,340,184,156
31,Navarra,901,Barañain,21705,10726,10979
31,Navarra,45,Barásoain,656,341,315
31,Navarra,46,Barbarin,72,37,35
31,Navarra,47,Bargota,324,157,167
31,Navarra,48,Barillas,189,103,86
31,Navarra,49,Basaburua,878,498,380
31,Navarra,50,Baztan,8081,4123,3958
31,Navarra,137,Beintza-Labaien,249,147,102
31,Navarra,51,Beire,330,166,164
31,Navarra,52,Belascoáin,127,62,65
31,Navarra,250,Bera,3730,1857,1873
31,Navarra,53,Berbinzana,703,363,340
31,Navarra,905,Beriáin,3655,1797,1858
31,Navarra,902,Berrioplano,4852,2467,2385
31,Navarra,903,Berriozar,9034,4647,4387
31,Navarra,54,Bertizarana,647,324,323
31,Navarra,55,Betelu,339,189,150
31,Navarra,253,Bidaurreta,155,86,69
31,Navarra,56,Biurrun-Olcoz,219,122,97
31,Navarra,57,Buñuel,2385,1194,1191
31,Navarra,59,Burgui/Burgi,235,135,100
31,Navarra,60,Burlada/Burlata,18389,9060,9329
31,Navarra,61,Busto (El),77,40,37
31,Navarra,62,Cabanillas,1488,769,719
31,Navarra,63,Cabredo,102,53,49
31,Navarra,64,Cadreita,2141,1120,1021
31,Navarra,65,Caparroso,2763,1416,1347
31,Navarra,66,Cárcar,1180,593,587
31,Navarra,67,Carcastillo,2629,1363,1266
31,Navarra,68,Cascante,3999,2007,1992
31,Navarra,69,Cáseda,1042,509,533
31,Navarra,70,Castejón,4306,2183,2123
31,Navarra,71,Castillonuevo,17,12,5
31,Navarra,193,Cendea de Olza/Oltza Zendea,1635,820,815
31,Navarra,72,Cintruénigo,7740,4000,3740
31,Navarra,74,Cirauqui/Zirauki,502,276,226
31,Navarra,75,Ciriza,118,61,57
31,Navarra,76,Cizur,3366,1667,1699
31,Navarra,77,Corella,8076,4228,3848
31,Navarra,78,Cortes,3405,1763,1642
31,Navarra,79,Desojo,102,54,48
31,Navarra,80,Dicastillo,691,371,320
31,Navarra,81,Donamaria,438,216,222
31,Navarra,221,Doneztebe/Santesteban,1688,865,823
31,Navarra,83,Echarri,68,38,30
31,Navarra,86,Egüés,14354,7290,7064
31,Navarra,87,Elgorriaga,221,113,108
31,Navarra,89,Enériz/Eneritz,365,188,177
31,Navarra,90,Eratsun,159,104,55
31,Navarra,91,Ergoiena,432,230,202
31,Navarra,92,Erro,786,442,344
31,Navarra,94,Eslava,133,73,60
31,Navarra,95,Esparza de Salazar/Espartza Zaraitzu,91,49,42
31,Navarra,96,Espronceda,133,77,56
31,Navarra,97,Estella/Lizarra,14207,6935,7272
31,Navarra,98,Esteribar,2202,1180,1022
31,Navarra,99,Etayo,92,47,45
31,Navarra,82,Etxalar,827,443,384
31,Navarra,84,Etxarri-Aranatz,2482,1281,1201
31,Navarra,85,Etxauri,595,316,279
31,Navarra,100,Eulate,337,177,160
31,Navarra,101,Ezcabarte,1677,883,794
31,Navarra,93,Ezcároz/Ezkaroze,343,179,164
31,Navarra,102,Ezkurra,163,107,56
31,Navarra,103,Ezprogui,52,27,25
31,Navarra,104,Falces,2650,1347,1303
31,Navarra,105,Fitero,2332,1208,1124
31,Navarra,106,Fontellas,925,466,459
31,Navarra,107,Funes,2447,1316,1131
31,Navarra,108,Fustiñana,2598,1316,1282
31,Navarra,109,Galar,1740,910,830
31,Navarra,110,Gallipienzo,120,64,56
31,Navarra,111,Gallués/Galoze,101,63,38
31,Navarra,112,Garaioa,108,61,47
31,Navarra,113,Garde,172,103,69
31,Navarra,114,Garínoain,520,294,226
31,Navarra,115,Garralda,191,96,95
31,Navarra,116,Genevilla,91,55,36
31,Navarra,117,Goizueta,778,425,353
31,Navarra,118,Goñi,181,111,70
31,Navarra,119,Güesa/Gorza,53,28,25
31,Navarra,120,Guesálaz/Gesalatz,457,274,183
31,Navarra,121,Guirguillano,83,42,41
31,Navarra,256,Hiriberri/Villanueva de Aezkoa,124,72,52
31,Navarra,122,Huarte/Uharte,6095,3087,3008
31,Navarra,124,Ibargoiti,248,150,98
31,Navarra,259,Igantzi,632,338,294
31,Navarra,125,Igúzquiza,348,176,172
31,Navarra,126,Imotz,444,237,207
31,Navarra,127,Irañeta,157,92,65
31,Navarra,904,Irurtzun,2230,1154,1076
31,Navarra,128,Isaba/Izaba,492,245,247
31,Navarra,129,Ituren,502,257,245
31,Navarra,130,Iturmendi,400,203,197
31,Navarra,131,Iza/Itza,1042,556,486
31,Navarra,132,Izagaondoa,175,111,64
31,Navarra,133,Izalzu/Itzaltzu,48,27,21
31,Navarra,134,Jaurrieta,214,117,97
31,Navarra,135,Javier,106,39,67
31,Navarra,136,Juslapeña,588,326,262
31,Navarra,138,Lakuntza,1219,643,576
31,Navarra,139,Lana,199,114,85
31,Navarra,140,Lantz,109,72,37
31,Navarra,141,Lapoblación,154,86,68
31,Navarra,142,Larraga,2137,1155,982
31,Navarra,143,Larraona,112,53,59
31,Navarra,144,Larraun,999,555,444
31,Navarra,145,Lazagurría,210,107,103
31,Navarra,146,Leache,55,32,23
31,Navarra,147,Legarda,119,64,55
31,Navarra,148,Legaria,117,54,63
31,Navarra,149,Leitza,2934,1560,1374
31,Navarra,908,Lekunberri,1432,712,720
31,Navarra,150,Leoz/Leotz,272,176,96
31,Navarra,151,Lerga,83,45,38
31,Navarra,152,Lerín,1890,973,917
31,Navarra,153,Lesaka,2822,1463,1359
31,Navarra,154,Lezáun,267,156,111
31,Navarra,155,Liédena,328,159,169
31,Navarra,156,Lizoáin-Arriasgoiti,308,187,121
31,Navarra,157,Lodosa,4966,2522,2444
31,Navarra,158,Lónguida/Longida,313,162,151
31,Navarra,159,Lumbier,1398,744,654
31,Navarra,160,Luquin,141,72,69
31,Navarra,248,Luzaide/Valcarlos,407,213,194
31,Navarra,161,Mañeru,420,227,193
31,Navarra,162,Marañón,58,30,28
31,Navarra,163,Marcilla,2838,1436,1402
31,Navarra,164,Mélida,769,399,370
31,Navarra,165,Mendavia,3796,1934,1862
31,Navarra,166,Mendaza,333,166,167
31,Navarra,167,Mendigorría,1076,560,516
31,Navarra,168,Metauten,286,167,119
31,Navarra,169,Milagro,3414,1759,1655
31,Navarra,170,Mirafuentes,45,22,23
31,Navarra,171,Miranda de Arga,951,483,468
31,Navarra,172,Monreal,489,263,226
31,Navarra,173,Monteagudo,1145,587,558
31,Navarra,174,Morentin,139,75,64
31,Navarra,175,Mues,95,50,45
31,Navarra,176,Murchante,3753,1877,1876
31,Navarra,177,Murieta,353,192,161
31,Navarra,178,Murillo el Cuende,631,330,301
31,Navarra,179,Murillo el Fruto,714,371,343
31,Navarra,180,Muruzábal,289,134,155
31,Navarra,181,Navascués,182,110,72
31,Navarra,182,Nazar,51,32,19
31,Navarra,88,Noáin (Valle de Elorz)/Noain (Elortzibar),7119,3597,3522
31,Navarra,183,Obanos,946,474,472
31,Navarra,185,Ochagavía/Otsagabia,626,313,313
31,Navarra,184,Oco,69,39,30
31,Navarra,186,Odieta,345,189,156
31,Navarra,187,Oitz,151,89,62
31,Navarra,188,Olaibar,232,119,113
31,Navarra,189,Olazti/Olazagutía,1719,899,820
31,Navarra,190,Olejua,55,27,28
31,Navarra,191,Olite/Erriberri,3722,1883,1839
31,Navarra,194,Ollo,366,199,167
31,Navarra,192,Olóriz/Oloritz,185,105,80
31,Navarra,195,Orbaitzeta,220,115,105
31,Navarra,196,Orbara,48,24,24
31,Navarra,197,Orísoain,86,47,39
31,Navarra,906,Orkoien,3511,1797,1714
31,Navarra,198,Oronz/Orontze,53,27,26
31,Navarra,199,Oroz-Betelu/Orotz-Betelu,169,92,77
31,Navarra,211,Orreaga/Roncesvalles,24,12,12
31,Navarra,200,Oteiza,963,505,458
31,Navarra,201,Pamplona/Iruña,197488,94506,102982
31,Navarra,202,Peralta/Azkoien,6066,3077,2989
31,Navarra,203,Petilla de Aragón,23,15,8
31,Navarra,204,Piedramillera,54,34,20
31,Navarra,205,Pitillas,562,266,296
31,Navarra,206,Puente la Reina/Gares,2867,1488,1379
31,Navarra,207,Pueyo,339,187,152
31,Navarra,208,Ribaforada,3617,1840,1777
31,Navarra,209,Romanzado,158,85,73
31,Navarra,210,Roncal/Erronkari,254,135,119
31,Navarra,212,Sada,179,92,87
31,Navarra,213,Saldías,116,69,47
31,Navarra,214,Salinas de Oro/Jaitz,120,65,55
31,Navarra,215,San Adrián,6293,3135,3158
31,Navarra,217,San Martín de Unx,455,226,229
31,Navarra,216,Sangüesa/Zangoza,5248,2695,2553
31,Navarra,219,Sansol,109,58,51
31,Navarra,220,Santacara,943,484,459
31,Navarra,222,Sarriés/Sartze,68,42,26
31,Navarra,223,Sartaguda,1398,724,674
31,Navarra,224,Sesma,1264,649,615
31,Navarra,225,Sorlada,68,38,30
31,Navarra,226,Sunbilla,670,348,322
31,Navarra,227,Tafalla,11413,5687,5726
31,Navarra,228,Tiebas-Muruarte de Reta,649,337,312
31,Navarra,229,Tirapu,58,36,22
31,Navarra,230,Torralba del Río,131,69,62
31,Navarra,231,Torres del Río,153,72,81
31,Navarra,232,Tudela,35268,17590,17678
31,Navarra,233,Tulebras,124,47,77
31,Navarra,234,Ucar,160,92,68
31,Navarra,123,Uharte-Arakil,866,459,407
31,Navarra,235,Ujué,218,121,97
31,Navarra,236,Ultzama,1694,862,832
31,Navarra,237,Unciti,225,137,88
31,Navarra,238,Unzué,133,76,57
31,Navarra,239,Urdazubi/Urdax,361,180,181
31,Navarra,240,Urdiain,710,378,332
31,Navarra,241,Urraul Alto,157,90,67
31,Navarra,242,Urraul Bajo,295,130,165
31,Navarra,244,Urrotz,190,110,80
31,Navarra,243,Urroz-Villa,393,212,181
31,Navarra,245,Urzainqui/Urzainki,92,55,37
31,Navarra,246,Uterga,187,106,81
31,Navarra,247,Uztárroz/Uztarroze,184,90,94
31,Navarra,260,Valle de Yerri/Deierri,1557,795,762
31,Navarra,249,Valtierra,2562,1262,1300
31,Navarra,251,Viana,3937,1991,1946
31,Navarra,252,Vidángoz/Bidankoze,100,52,48
31,Navarra,254,Villafranca,2997,1508,1489
31,Navarra,255,Villamayor de Monjardín,137,69,68
31,Navarra,257,Villatuerta,1099,554,545
31,Navarra,258,Villava/Atarrabia,10568,5259,5309
31,Navarra,261,Yesa,256,138,118
31,Navarra,262,Zabalza/Zabaltza,266,134,132
31,Navarra,73,Ziordia,392,184,208
31,Navarra,907,Zizur Mayor/Zizur Nagusia,13316,6576,6740
31,Navarra,263,Zubieta,315,174,141
31,Navarra,264,Zugarramurdi,212,107,105
31,Navarra,265,Zúñiga,120,77,43
32,Ourense,1,Allariz,5910,2941,2969
32,Ourense,2,Amoeiro,2300,1118,1182
32,Ourense,3,Arnoia (A),1091,538,553
32,Ourense,4,Avión,2561,1185,1376
32,Ourense,5,Baltar,1114,564,550
32,Ourense,6,Bande,2083,980,1103
32,Ourense,7,Baños de Molgas,1807,900,907
32,Ourense,8,Barbadás,9468,4632,4836
32,Ourense,9,Barco de Valdeorras (O),14134,6952,7182
32,Ourense,10,Beade,515,269,246
32,Ourense,11,Beariz,1285,589,696
32,Ourense,12,Blancos (Os),997,519,478
32,Ourense,13,Boborás,2942,1363,1579
32,Ourense,14,Bola (A),1463,685,778
32,Ourense,15,Bolo (O),1117,552,565
32,Ourense,16,Calvos de Randín,1065,532,533
32,Ourense,18,Carballeda de Avia,1523,731,792
32,Ourense,17,Carballeda de Valdeorras,1866,928,938
32,Ourense,19,Carballiño (O),14136,6642,7494
32,Ourense,20,Cartelle,3344,1639,1705
32,Ourense,22,Castrelo de Miño,1870,927,943
32,Ourense,21,Castrelo do Val,1199,609,590
32,Ourense,23,Castro Caldelas,1572,786,786
32,Ourense,24,Celanova,5949,2815,3134
32,Ourense,25,Cenlle,1396,669,727
32,Ourense,29,Chandrexa de Queixa,639,353,286
32,Ourense,26,Coles,3217,1616,1601
32,Ourense,27,Cortegada,1330,652,678
32,Ourense,28,Cualedro,2041,1031,1010
32,Ourense,30,Entrimo,1372,645,727
32,Ourense,31,Esgos,1212,617,595
32,Ourense,33,Gomesende,968,452,516
32,Ourense,34,Gudiña (A),1562,808,754
32,Ourense,35,Irixo (O),1777,830,947
32,Ourense,38,Larouco,584,281,303
32,Ourense,39,Laza,1570,779,791
32,Ourense,40,Leiro,1833,905,928
32,Ourense,41,Lobeira,994,486,508
32,Ourense,42,Lobios,2246,1124,1122
32,Ourense,43,Maceda,3153,1538,1615
32,Ourense,44,Manzaneda,994,492,502
32,Ourense,45,Maside,3062,1474,1588
32,Ourense,46,Melón,1463,682,781
32,Ourense,47,Merca (A),2244,1087,1157
32,Ourense,48,Mezquita (A),1352,700,652
32,Ourense,49,Montederramo,961,496,465
32,Ourense,50,Monterrei,3002,1495,1507
32,Ourense,51,Muíños,1824,916,908
32,Ourense,52,Nogueira de Ramuín,2432,1192,1240
32,Ourense,53,Oímbra,2032,1051,981
32,Ourense,54,Ourense,108673,50151,58522
32,Ourense,55,Paderne de Allariz,1604,777,827
32,Ourense,56,Padrenda,2297,1111,1186
32,Ourense,57,Parada de Sil,670,334,336
32,Ourense,58,Pereiro de Aguiar (O),6134,3122,3012
32,Ourense,59,Peroxa (A),2227,1072,1155
32,Ourense,60,Petín,1032,501,531
32,Ourense,61,Piñor,1386,689,697
32,Ourense,63,Pobra de Trives (A),2511,1266,1245
32,Ourense,64,Pontedeva,661,315,346
32,Ourense,62,Porqueira,1079,507,572
32,Ourense,65,Punxín,840,407,433
32,Ourense,66,Quintela de Leirado,751,338,413
32,Ourense,67,Rairiz de Veiga,1673,838,835
32,Ourense,68,Ramirás,1897,880,1017
32,Ourense,69,Ribadavia,5490,2636,2854
32,Ourense,71,Riós,1863,928,935
32,Ourense,72,Rúa (A),4754,2324,2430
32,Ourense,73,Rubiá,1583,789,794
32,Ourense,74,San Amaro,1287,629,658
32,Ourense,75,San Cibrao das Viñas,4441,2254,2187
32,Ourense,76,San Cristovo de Cea,2692,1352,1340
32,Ourense,70,San Xoán de Río,734,362,372
32,Ourense,77,Sandiás,1416,649,767
32,Ourense,78,Sarreaus,1552,774,778
32,Ourense,79,Taboadela,1691,850,841
32,Ourense,80,Teixeira (A),447,221,226
32,Ourense,81,Toén,2656,1358,1298
32,Ourense,82,Trasmiras,1619,792,827
32,Ourense,83,Veiga (A),1075,547,528
32,Ourense,84,Verea,1238,589,649
32,Ourense,85,Verín,14633,7244,7389
32,Ourense,86,Viana do Bolo,3323,1647,1676
32,Ourense,87,Vilamarín,2175,1090,1085
32,Ourense,88,Vilamartín de Valdeorras,2072,1040,1032
32,Ourense,89,Vilar de Barrio,1645,820,825
32,Ourense,90,Vilar de Santos,970,471,499
32,Ourense,91,Vilardevós,2256,1147,1109
32,Ourense,92,Vilariño de Conso,675,372,303
32,Ourense,32,Xinzo de Limia,10245,5059,5186
32,Ourense,36,Xunqueira de Ambía,1733,860,873
32,Ourense,37,Xunqueira de Espadanedo,948,467,481
34,Palencia,1,Abarca de Campos,38,22,16
34,Palencia,3,Abia de las Torres,178,99,79
34,Palencia,4,Aguilar de Campoo,7221,3527,3694
34,Palencia,5,Alar del Rey,1046,513,533
34,Palencia,6,Alba de Cerrato,101,55,46
34,Palencia,9,Amayuelas de Arriba,37,23,14
34,Palencia,10,Ampudia,609,323,286
34,Palencia,11,Amusco,448,241,207
34,Palencia,12,Antigüedad,409,222,187
34,Palencia,15,Arconada,47,27,20
34,Palencia,17,Astudillo,1117,571,546
34,Palencia,18,Autilla del Pino,237,134,103
34,Palencia,19,Autillo de Campos,155,78,77
34,Palencia,20,Ayuela,64,39,25
34,Palencia,22,Baltanás,1342,707,635
34,Palencia,24,Baquerín de Campos,35,19,16
34,Palencia,25,Bárcena de Campos,56,26,30
34,Palencia,27,Barruelo de Santullán,1479,713,766
34,Palencia,28,Báscones de Ojeda,173,94,79
34,Palencia,29,Becerril de Campos,959,487,472
34,Palencia,31,Belmonte de Campos,32,15,17
34,Palencia,32,Berzosilla,50,23,27
34,Palencia,33,Boada de Campos,22,14,8
34,Palencia,35,Boadilla de Rioseco,134,77,57
34,Palencia,34,Boadilla del Camino,127,70,57
34,Palencia,36,Brañosera,262,143,119
34,Palencia,37,Buenavista de Valdavia,382,196,186
34,Palencia,38,Bustillo de la Vega,332,178,154
34,Palencia,39,Bustillo del Páramo de Carrión,70,40,30
34,Palencia,41,Calahorra de Boedo,108,59,49
34,Palencia,42,Calzada de los Molinos,355,199,156
34,Palencia,45,Capillas,94,46,48
34,Palencia,46,Cardeñosa de Volpejera,45,24,21
34,Palencia,47,Carrión de los Condes,2279,1114,1165
34,Palencia,48,Castil de Vela,71,33,38
34,Palencia,49,Castrejón de la Peña,483,259,224
34,Palencia,50,Castrillo de Don Juan,266,137,129
34,Palencia,51,Castrillo de Onielo,119,60,59
34,Palencia,52,Castrillo de Villavega,204,106,98
34,Palencia,53,Castromocho,249,135,114
34,Palencia,55,Cervatos de la Cueza,316,178,138
34,Palencia,56,Cervera de Pisuerga,2579,1288,1291
34,Palencia,57,Cevico de la Torre,518,262,256
34,Palencia,58,Cevico Navero,238,123,115
34,Palencia,59,Cisneros,504,256,248
34,Palencia,60,Cobos de Cerrato,169,87,82
34,Palencia,61,Collazos de Boedo,131,70,61
34,Palencia,62,Congosto de Valdavia,190,107,83
34,Palencia,63,Cordovilla la Real,120,63,57
34,Palencia,66,Cubillas de Cerrato,73,37,36
34,Palencia,67,Dehesa de Montejo,157,89,68
34,Palencia,68,Dehesa de Romanos,40,25,15
34,Palencia,69,Dueñas,2922,1517,1405
34,Palencia,70,Espinosa de Cerrato,193,100,93
34,Palencia,71,Espinosa de Villagonzalo,224,119,105
34,Palencia,72,Frechilla,197,99,98
34,Palencia,73,Fresno del Río,194,104,90
34,Palencia,74,Frómista,816,421,395
34,Palencia,76,Fuentes de Nava,732,378,354
34,Palencia,77,Fuentes de Valdepero,295,159,136
34,Palencia,79,Grijota,1703,879,824
34,Palencia,80,Guardo,7297,3639,3658
34,Palencia,81,Guaza de Campos,61,31,30
34,Palencia,82,Hérmedes de Cerrato,102,56,46
34,Palencia,83,Herrera de Pisuerga,2348,1166,1182
34,Palencia,84,Herrera de Valdecañas,154,81,73
34,Palencia,86,Hontoria de Cerrato,109,56,53
34,Palencia,87,Hornillos de Cerrato,111,55,56
34,Palencia,88,Husillos,235,127,108
34,Palencia,89,Itero de la Vega,180,94,86
34,Palencia,91,Lagartos,146,80,66
34,Palencia,92,Lantadilla,363,179,184
34,Palencia,94,Ledigos,76,42,34
34,Palencia,903,Loma de Ucieza,282,158,124
34,Palencia,96,Lomas,51,31,20
34,Palencia,98,Magaz de Pisuerga,1024,578,446
34,Palencia,99,Manquillos,63,34,29
34,Palencia,100,Mantinos,145,77,68
34,Palencia,101,Marcilla de Campos,47,20,27
34,Palencia,102,Mazariegos,253,146,107
34,Palencia,103,Mazuecos de Valdeginate,114,63,51
34,Palencia,104,Melgar de Yuso,304,175,129
34,Palencia,106,Meneses de Campos,126,66,60
34,Palencia,107,Micieces de Ojeda,91,50,41
34,Palencia,108,Monzón de Campos,672,351,321
34,Palencia,109,Moratinos,69,38,31
34,Palencia,110,Mudá,98,49,49
34,Palencia,112,Nogal de las Huertas,47,27,20
34,Palencia,113,Olea de Boedo,41,18,23
34,Palencia,114,Olmos de Ojeda,252,152,100
34,Palencia,116,Osornillo,77,38,39
34,Palencia,901,Osorno la Mayor,1454,759,695
34,Palencia,120,Palencia,82169,38945,43224
34,Palencia,121,Palenzuela,242,132,110
34,Palencia,122,Páramo de Boedo,98,54,44
34,Palencia,123,Paredes de Nava,2096,1062,1034
34,Palencia,124,Payo de Ojeda,75,42,33
34,Palencia,125,Pedraza de Campos,103,51,52
34,Palencia,126,Pedrosa de la Vega,342,190,152
34,Palencia,127,Perales,153,80,73
34,Palencia,904,Pernía (La),392,226,166
34,Palencia,129,Pino del Río,220,132,88
34,Palencia,130,Piña de Campos,255,133,122
34,Palencia,131,Población de Arroyo,74,40,34
34,Palencia,132,Población de Campos,144,77,67
34,Palencia,133,Población de Cerrato,121,67,54
34,Palencia,134,Polentinos,69,36,33
34,Palencia,135,Pomar de Valdivia,513,269,244
34,Palencia,136,Poza de la Vega,234,126,108
34,Palencia,137,Pozo de Urama,32,18,14
34,Palencia,139,Prádanos de Ojeda,214,117,97
34,Palencia,140,Puebla de Valdavia (La),114,57,57
34,Palencia,141,Quintana del Puente,248,128,120
34,Palencia,143,Quintanilla de Onsoña,206,117,89
34,Palencia,146,Reinoso de Cerrato,60,34,26
34,Palencia,147,Renedo de la Vega,232,130,102
34,Palencia,149,Requena de Campos,28,11,17
34,Palencia,151,Respenda de la Peña,202,112,90
34,Palencia,152,Revenga de Campos,154,77,77
34,Palencia,154,Revilla de Collazos,80,44,36
34,Palencia,155,Ribas de Campos,167,86,81
34,Palencia,156,Riberos de la Cueza,69,45,24
34,Palencia,157,Saldaña,3039,1552,1487
34,Palencia,158,Salinas de Pisuerga,376,183,193
34,Palencia,159,San Cebrián de Campos,468,255,213
34,Palencia,160,San Cebrián de Mudá,164,76,88
34,Palencia,161,San Cristóbal de Boedo,27,16,11
34,Palencia,163,San Mamés de Campos,66,28,38
34,Palencia,165,San Román de la Cuba,98,52,46
34,Palencia,167,Santa Cecilia del Alcor,142,82,60
34,Palencia,168,Santa Cruz de Boedo,66,34,32
34,Palencia,169,Santervás de la Vega,517,292,225
34,Palencia,170,Santibáñez de Ecla,81,34,47
34,Palencia,171,Santibáñez de la Peña,1244,619,625
34,Palencia,174,Santoyo,247,128,119
34,Palencia,175,Serna (La),120,74,46
34,Palencia,177,Soto de Cerrato,190,107,83
34,Palencia,176,Sotobañado y Priorato,164,93,71
34,Palencia,178,Tabanera de Cerrato,118,69,49
34,Palencia,179,Tabanera de Valdavia,40,18,22
34,Palencia,180,Támara de Campos,90,48,42
34,Palencia,181,Tariego de Cerrato,538,284,254
34,Palencia,182,Torquemada,1098,581,517
34,Palencia,184,Torremormojón,53,32,21
34,Palencia,185,Triollo,70,40,30
34,Palencia,186,Valbuena de Pisuerga,60,33,27
34,Palencia,189,Valdeolmillos,67,35,32
34,Palencia,190,Valderrábano,56,31,25
34,Palencia,192,Valde-Ucieza,110,62,48
34,Palencia,196,Valle de Cerrato,102,60,42
34,Palencia,902,Valle del Retortillo,174,94,80
34,Palencia,199,Velilla del Río Carrión,1520,782,738
34,Palencia,23,Venta de Baños,6433,3217,3216
34,Palencia,201,Vertavillo,204,108,96
34,Palencia,93,Vid de Ojeda (La),121,72,49
34,Palencia,202,Villabasta de Valdavia,35,17,18
34,Palencia,204,Villacidaler,57,31,26
34,Palencia,205,Villaconancio,72,44,28
34,Palencia,206,Villada,1087,553,534
34,Palencia,208,Villaeles de Valdavia,70,38,32
34,Palencia,210,Villahán,114,60,54
34,Palencia,211,Villaherreros,232,111,121
34,Palencia,213,Villalaco,71,32,39
34,Palencia,214,Villalba de Guardo,207,110,97
34,Palencia,215,Villalcázar de Sirga,178,87,91
34,Palencia,216,Villalcón,70,36,34
34,Palencia,217,Villalobón,1324,680,644
34,Palencia,218,Villaluenga de la Vega,617,354,263
34,Palencia,220,Villamartín de Campos,178,95,83
34,Palencia,221,Villamediana,190,99,91
34,Palencia,222,Villameriel,133,76,57
34,Palencia,223,Villamoronta,286,164,122
34,Palencia,224,Villamuera de la Cueza,57,33,24
34,Palencia,225,Villamuriel de Cerrato,6233,3227,3006
34,Palencia,227,Villanueva del Rebollar,100,53,47
34,Palencia,228,Villanuño de Valdavia,99,55,44
34,Palencia,229,Villaprovedo,75,46,29
34,Palencia,230,Villarmentero de Campos,11,8,3
34,Palencia,231,Villarrabé,248,122,126
34,Palencia,232,Villarramiel,933,495,438
34,Palencia,233,Villasarracino,168,91,77
34,Palencia,234,Villasila de Valdavia,70,51,19
34,Palencia,236,Villaturde,194,97,97
34,Palencia,237,Villaumbrales,772,389,383
34,Palencia,238,Villaviudas,389,186,203
34,Palencia,240,Villerías de Campos,113,61,52
34,Palencia,241,Villodre,22,14,8
34,Palencia,242,Villodrigo,146,79,67
34,Palencia,243,Villoldo,401,221,180
34,Palencia,245,Villota del Páramo,362,206,156
34,Palencia,246,Villovieco,89,48,41
35,Palmas (Las),1,Agaete,5748,2893,2855
35,Palmas (Las),2,Agüimes,29431,15027,14404
35,Palmas (Las),20,Aldea de San Nicolás (La),8623,4365,4258
35,Palmas (Las),3,Antigua,10458,5690,4768
35,Palmas (Las),4,Arrecife,58156,29690,28466
35,Palmas (Las),5,Artenara,1230,666,564
35,Palmas (Las),6,Arucas,36745,18361,18384
35,Palmas (Las),7,Betancuria,823,426,397
35,Palmas (Las),8,Firgas,7564,3872,3692
35,Palmas (Las),9,Gáldar,24473,12319,12154
35,Palmas (Las),10,Haría,5249,2733,2516
35,Palmas (Las),11,Ingenio,29640,15003,14637
35,Palmas (Las),12,Mogán,22638,11817,10821
35,Palmas (Las),13,Moya,8098,4122,3976
35,Palmas (Las),14,Oliva (La),22351,11976,10375
35,Palmas (Las),15,Pájara,20622,11209,9413
35,Palmas (Las),16,Palmas de Gran Canaria (Las),383308,186942,196366
35,Palmas (Las),17,Puerto del Rosario,35702,18399,17303
35,Palmas (Las),18,San Bartolomé,18161,9309,8852
35,Palmas (Las),19,San Bartolomé de Tirajana,53288,27825,25463
35,Palmas (Las),21,Santa Brígida,19135,9498,9637
35,Palmas (Las),22,Santa Lucía de Tirajana,64845,32736,32109
35,Palmas (Las),23,Santa María de Guía de Gran Canaria,14200,7068,7132
35,Palmas (Las),24,Teguise,20105,10239,9866
35,Palmas (Las),25,Tejeda,2133,1135,998
35,Palmas (Las),26,Telde,100900,50225,50675
35,Palmas (Las),27,Teror,12944,6637,6307
35,Palmas (Las),28,Tías,19869,10241,9628
35,Palmas (Las),29,Tinajo,5655,2960,2695
35,Palmas (Las),30,Tuineje,13536,7045,6491
35,Palmas (Las),32,Valleseco,3935,2070,1865
35,Palmas (Las),31,Valsequillo de Gran Canaria,9099,4615,4484
35,Palmas (Las),33,Vega de San Mateo,7699,3938,3761
35,Palmas (Las),34,Yaiza,14242,7648,6594
36,Pontevedra,20,Agolada,2995,1470,1525
36,Pontevedra,1,Arbo,3801,1903,1898
36,Pontevedra,3,Baiona,12154,6037,6117
36,Pontevedra,2,Barro,3642,1801,1841
36,Pontevedra,4,Bueu,12368,6094,6274
36,Pontevedra,5,Caldas de Reis,10045,4892,5153
36,Pontevedra,6,Cambados,13872,6740,7132
36,Pontevedra,7,Campo Lameiro,2046,979,1067
36,Pontevedra,8,Cangas,25913,12864,13049
36,Pontevedra,9,Cañiza (A),6517,3171,3346
36,Pontevedra,10,Catoira,3469,1697,1772
36,Pontevedra,11,Cerdedo,2299,1050,1249
36,Pontevedra,12,Cotobade,4427,2096,2331
36,Pontevedra,13,Covelo,3341,1628,1713
36,Pontevedra,14,Crecente,2540,1220,1320
36,Pontevedra,15,Cuntis,5115,2416,2699
36,Pontevedra,16,Dozón,1781,878,903
36,Pontevedra,17,Estrada (A),21828,10405,11423
36,Pontevedra,18,Forcarei,4108,1939,2169
36,Pontevedra,19,Fornelos de Montes,1966,928,1038
36,Pontevedra,21,Gondomar,13890,6862,7028
36,Pontevedra,22,Grove (O),11297,5557,5740
36,Pontevedra,23,Guarda (A),10472,5102,5370
36,Pontevedra,901,Illa de Arousa (A),5000,2476,2524
36,Pontevedra,24,Lalín,21216,10376,10840
36,Pontevedra,25,Lama (A),2966,1399,1567
36,Pontevedra,26,Marín,25997,13029,12968
36,Pontevedra,27,Meaño,5455,2664,2791
36,Pontevedra,28,Meis,5003,2368,2635
36,Pontevedra,29,Moaña,19231,9424,9807
36,Pontevedra,30,Mondariz,5200,2497,2703
36,Pontevedra,31,Mondariz-Balneario,734,366,368
36,Pontevedra,32,Moraña,4434,2138,2296
36,Pontevedra,33,Mos,14818,7285,7533
36,Pontevedra,34,Neves (As),4429,2164,2265
36,Pontevedra,35,Nigrán,17909,8804,9105
36,Pontevedra,36,Oia,3197,1615,1582
36,Pontevedra,37,Pazos de Borbén,3159,1502,1657
36,Pontevedra,41,Poio,16309,8048,8261
36,Pontevedra,43,Ponte Caldelas,6371,3077,3294
36,Pontevedra,42,Ponteareas,23316,11377,11939
36,Pontevedra,44,Pontecesures,3143,1584,1559
36,Pontevedra,38,Pontevedra,81981,38759,43222
36,Pontevedra,39,Porriño (O),17977,8856,9121
36,Pontevedra,40,Portas,3078,1451,1627
36,Pontevedra,45,Redondela,30067,14709,15358
36,Pontevedra,46,Ribadumia,5028,2423,2605
36,Pontevedra,47,Rodeiro,3092,1557,1535
36,Pontevedra,48,Rosal (O),6595,3261,3334
36,Pontevedra,49,Salceda de Caselas,8448,4269,4179
36,Pontevedra,50,Salvaterra de Miño,9456,4747,4709
36,Pontevedra,51,Sanxenxo,17500,8627,8873
36,Pontevedra,52,Silleda,9248,4538,4710
36,Pontevedra,53,Soutomaior,7144,3515,3629
36,Pontevedra,54,Tomiño,13492,6791,6701
36,Pontevedra,55,Tui,17306,8307,8999
36,Pontevedra,56,Valga,6127,3003,3124
36,Pontevedra,57,Vigo,297124,141647,155477
36,Pontevedra,59,Vila de Cruces,6437,3177,3260
36,Pontevedra,58,Vilaboa,5991,2890,3101
36,Pontevedra,60,Vilagarcía de Arousa,37926,18242,19684
36,Pontevedra,61,Vilanova de Arousa,10682,5209,5473
26,Rioja (La),1,Ábalos,369,231,138
26,Rioja (La),2,Agoncillo,1102,616,486
26,Rioja (La),3,Aguilar del Río Alhama,573,275,298
26,Rioja (La),4,Ajamil de Cameros,61,47,14
26,Rioja (La),5,Albelda de Iregua,3291,1727,1564
26,Rioja (La),6,Alberite,2676,1334,1342
26,Rioja (La),7,Alcanadre,764,404,360
26,Rioja (La),8,Aldeanueva de Ebro,2819,1488,1331
26,Rioja (La),9,Alesanco,509,265,244
26,Rioja (La),10,Alesón,116,63,53
26,Rioja (La),11,Alfaro,9813,4963,4850
26,Rioja (La),12,Almarza de Cameros,25,15,10
26,Rioja (La),13,Anguciana,510,281,229
26,Rioja (La),14,Anguiano,540,301,239
26,Rioja (La),15,Arenzana de Abajo,292,151,141
26,Rioja (La),16,Arenzana de Arriba,36,24,12
26,Rioja (La),17,Arnedillo,482,234,248
26,Rioja (La),18,Arnedo,14425,7211,7214
26,Rioja (La),19,Arrúbal,487,260,227
26,Rioja (La),20,Ausejo,1110,681,429
26,Rioja (La),21,Autol,4385,2260,2125
26,Rioja (La),22,Azofra,263,142,121
26,Rioja (La),23,Badarán,626,330,296
26,Rioja (La),24,Bañares,321,156,165
26,Rioja (La),26,Baños de Río Tobía,1727,868,859
26,Rioja (La),25,Baños de Rioja,83,54,29
26,Rioja (La),27,Berceo,184,111,73
26,Rioja (La),28,Bergasa,164,95,69
26,Rioja (La),29,Bergasillas Bajera,34,15,19
26,Rioja (La),30,Bezares,17,7,10
26,Rioja (La),31,Bobadilla,128,71,57
26,Rioja (La),32,Brieva de Cameros,58,37,21
26,Rioja (La),33,Briñas,252,124,128
26,Rioja (La),34,Briones,867,464,403
26,Rioja (La),35,Cabezón de Cameros,24,17,7
26,Rioja (La),36,Calahorra,24876,12369,12507
26,Rioja (La),37,Camprovín,169,93,76
26,Rioja (La),38,Canales de la Sierra,72,44,28
26,Rioja (La),39,Canillas de Río Tuerto,43,20,23
26,Rioja (La),40,Cañas,93,45,48
26,Rioja (La),41,Cárdenas,178,91,87
26,Rioja (La),42,Casalarreina,1373,744,629
26,Rioja (La),43,Castañares de Rioja,533,255,278
26,Rioja (La),44,Castroviejo,57,33,24
26,Rioja (La),45,Cellorigo,13,6,7
26,Rioja (La),46,Cenicero,2119,1095,1024
26,Rioja (La),47,Cervera del Río Alhama,2826,1473,1353
26,Rioja (La),48,Cidamón,37,19,18
26,Rioja (La),49,Cihuri,215,115,100
26,Rioja (La),50,Cirueña,137,79,58
26,Rioja (La),51,Clavijo,280,161,119
26,Rioja (La),52,Cordovín,189,98,91
26,Rioja (La),53,Corera,275,146,129
26,Rioja (La),54,Cornago,453,254,199
26,Rioja (La),55,Corporales,35,20,15
26,Rioja (La),56,Cuzcurrita de Río Tirón,554,292,262
26,Rioja (La),57,Daroca de Rioja,59,32,27
26,Rioja (La),58,Enciso,162,90,72
26,Rioja (La),59,Entrena,1490,778,712
26,Rioja (La),60,Estollo,96,59,37
26,Rioja (La),61,Ezcaray,2098,1112,986
26,Rioja (La),62,Foncea,109,57,52
26,Rioja (La),63,Fonzaleche,147,98,49
26,Rioja (La),64,Fuenmayor,3219,1644,1575
26,Rioja (La),65,Galbárruli,64,39,25
26,Rioja (La),66,Galilea,394,204,190
26,Rioja (La),67,Gallinero de Cameros,26,18,8
26,Rioja (La),68,Gimileo,171,108,63
26,Rioja (La),69,Grañón,315,178,137
26,Rioja (La),70,Grávalos,237,127,110
26,Rioja (La),71,Haro,11960,6151,5809
26,Rioja (La),72,Herce,370,196,174
26,Rioja (La),73,Herramélluri,89,47,42
26,Rioja (La),74,Hervías,153,78,75
26,Rioja (La),75,Hormilla,453,246,207
26,Rioja (La),76,Hormilleja,170,92,78
26,Rioja (La),77,Hornillos de Cameros,13,5,8
26,Rioja (La),78,Hornos de Moncalvillo,96,54,42
26,Rioja (La),79,Huércanos,927,492,435
26,Rioja (La),80,Igea,744,433,311
26,Rioja (La),81,Jalón de Cameros,29,17,12
26,Rioja (La),82,Laguna de Cameros,139,84,55
26,Rioja (La),83,Lagunilla del Jubera,320,176,144
26,Rioja (La),84,Lardero,8118,4150,3968
26,Rioja (La),86,Ledesma de la Cogolla,21,13,8
26,Rioja (La),87,Leiva,292,152,140
26,Rioja (La),88,Leza de Río Leza,52,31,21
26,Rioja (La),89,Logroño,152650,73891,78759
26,Rioja (La),91,Lumbreras,164,107,57
26,Rioja (La),92,Manjarrés,152,85,67
26,Rioja (La),93,Mansilla de la Sierra,65,44,21
26,Rioja (La),94,Manzanares de Rioja,106,60,46
26,Rioja (La),95,Matute,146,71,75
26,Rioja (La),96,Medrano,302,162,140
26,Rioja (La),98,Munilla,132,63,69
26,Rioja (La),99,Murillo de Río Leza,1828,968,860
26,Rioja (La),100,Muro de Aguas,58,35,23
26,Rioja (La),101,Muro en Cameros,36,23,13
26,Rioja (La),102,Nájera,8404,4195,4209
26,Rioja (La),103,Nalda,1044,577,467
26,Rioja (La),104,Navajún,20,14,6
26,Rioja (La),105,Navarrete,2856,1474,1382
26,Rioja (La),106,Nestares,77,44,33
26,Rioja (La),107,Nieva de Cameros,103,61,42
26,Rioja (La),109,Ochánduri,84,48,36
26,Rioja (La),108,Ocón,341,211,130
26,Rioja (La),110,Ojacastro,209,121,88
26,Rioja (La),111,Ollauri,319,175,144
26,Rioja (La),112,Ortigosa de Cameros,287,167,120
26,Rioja (La),113,Pazuengos,38,25,13
26,Rioja (La),114,Pedroso,99,58,41
26,Rioja (La),115,Pinillos,16,9,7
26,Rioja (La),117,Pradejón,4011,2125,1886
26,Rioja (La),118,Pradillo,68,33,35
26,Rioja (La),119,Préjano,237,128,109
26,Rioja (La),120,Quel,2073,1108,965
26,Rioja (La),121,Rabanera,36,27,9
26,Rioja (La),122,Rasillo de Cameros (El),150,77,73
26,Rioja (La),123,Redal (El),159,87,72
26,Rioja (La),124,Ribafrecha,998,529,469
26,Rioja (La),125,Rincón de Soto,3801,1936,1865
26,Rioja (La),126,Robres del Castillo,30,18,12
26,Rioja (La),127,Rodezno,321,183,138
26,Rioja (La),128,Sajazarra,137,72,65
26,Rioja (La),129,San Asensio,1239,662,577
26,Rioja (La),130,San Millán de la Cogolla,278,183,95
26,Rioja (La),131,San Millán de Yécora,61,42,19
26,Rioja (La),132,San Román de Cameros,168,88,80
26,Rioja (La),139,San Torcuato,72,38,34
26,Rioja (La),142,San Vicente de la Sonsierra,1133,621,512
26,Rioja (La),134,Santa Coloma,133,80,53
26,Rioja (La),135,Santa Engracia del Jubera,180,108,72
26,Rioja (La),136,Santa Eulalia Bajera,134,76,58
26,Rioja (La),138,Santo Domingo de la Calzada,6737,3479,3258
26,Rioja (La),140,Santurde de Rioja,341,183,158
26,Rioja (La),141,Santurdejo,157,92,65
26,Rioja (La),143,Sojuela,227,132,95
26,Rioja (La),144,Sorzano,274,158,116
26,Rioja (La),145,Sotés,295,164,131
26,Rioja (La),146,Soto en Cameros,145,76,69
26,Rioja (La),147,Terroba,40,21,19
26,Rioja (La),148,Tirgo,232,122,110
26,Rioja (La),149,Tobía,80,47,33
26,Rioja (La),150,Tormantos,157,91,66
26,Rioja (La),153,Torre en Cameros,12,10,2
26,Rioja (La),151,Torrecilla en Cameros,520,286,234
26,Rioja (La),152,Torrecilla sobre Alesanco,44,20,24
26,Rioja (La),154,Torremontalbo,15,7,8
26,Rioja (La),155,Treviana,197,108,89
26,Rioja (La),157,Tricio,402,198,204
26,Rioja (La),158,Tudelilla,395,223,172
26,Rioja (La),160,Uruñuela,941,480,461
26,Rioja (La),161,Valdemadera,9,6,3
26,Rioja (La),162,Valgañón,135,80,55
26,Rioja (La),163,Ventosa,173,97,76
26,Rioja (La),164,Ventrosa,59,36,23
26,Rioja (La),165,Viguera,436,240,196
26,Rioja (La),166,Villalba de Rioja,154,95,59
26,Rioja (La),167,Villalobar de Rioja,61,40,21
26,Rioja (La),168,Villamediana de Iregua,6723,3471,3252
26,Rioja (La),169,Villanueva de Cameros,105,61,44
26,Rioja (La),170,Villar de Arnedo (El),665,338,327
26,Rioja (La),171,Villar de Torre,269,146,123
26,Rioja (La),172,Villarejo,35,25,10
26,Rioja (La),173,Villarroya,10,5,5
26,Rioja (La),174,Villarta-Quintana,144,73,71
26,Rioja (La),175,Villavelayo,65,39,26
26,Rioja (La),176,Villaverde de Rioja,76,41,35
26,Rioja (La),177,Villoslada de Cameros,362,215,147
26,Rioja (La),178,Viniegra de Abajo,104,63,41
26,Rioja (La),179,Viniegra de Arriba,47,31,16
26,Rioja (La),180,Zarratón,323,186,137
26,Rioja (La),181,Zarzosa,15,12,3
26,Rioja (La),183,Zorraquín,86,43,43
37,Salamanca,1,Abusejo,254,134,120
37,Salamanca,2,Agallas,157,81,76
37,Salamanca,3,Ahigal de los Aceiteros,150,78,72
37,Salamanca,4,Ahigal de Villarino,41,21,20
37,Salamanca,5,Alameda de Gardón (La),102,49,53
37,Salamanca,6,Alamedilla (La),200,106,94
37,Salamanca,7,Alaraz,547,288,259
37,Salamanca,8,Alba de Tormes,5391,2658,2733
37,Salamanca,9,Alba de Yeltes,237,123,114
37,Salamanca,10,Alberca (La),1209,609,600
37,Salamanca,11,Alberguería de Argañán (La),152,79,73
37,Salamanca,12,Alconada,173,91,82
37,Salamanca,15,Aldea del Obispo,333,182,151
37,Salamanca,13,Aldeacipreste,142,75,67
37,Salamanca,14,Aldeadávila de la Ribera,1389,724,665
37,Salamanca,16,Aldealengua,650,324,326
37,Salamanca,17,Aldeanueva de Figueroa,293,147,146
37,Salamanca,18,Aldeanueva de la Sierra,102,53,49
37,Salamanca,19,Aldearrodrigo,165,87,78
37,Salamanca,20,Aldearrubia,528,280,248
37,Salamanca,21,Aldeaseca de Alba,86,38,48
37,Salamanca,22,Aldeaseca de la Frontera,327,172,155
37,Salamanca,23,Aldeatejada,1336,670,666
37,Salamanca,24,Aldeavieja de Tormes,109,56,53
37,Salamanca,25,Aldehuela de la Bóveda,318,157,161
37,Salamanca,26,Aldehuela de Yeltes,217,117,100
37,Salamanca,27,Almenara de Tormes,303,167,136
37,Salamanca,28,Almendra,188,102,86
37,Salamanca,29,Anaya de Alba,243,136,107
37,Salamanca,30,Añover de Tormes,99,55,44
37,Salamanca,31,Arabayona de Mógica,443,237,206
37,Salamanca,32,Arapiles,577,294,283
37,Salamanca,33,Arcediano,110,57,53
37,Salamanca,34,Arco (El),105,57,48
37,Salamanca,35,Armenteros,467,245,222
37,Salamanca,37,Atalaya (La),138,76,62
37,Salamanca,38,Babilafuente,949,497,452
37,Salamanca,39,Bañobárez,362,186,176
37,Salamanca,40,Barbadillo,467,236,231
37,Salamanca,41,Barbalos,85,48,37
37,Salamanca,42,Barceo,54,29,25
37,Salamanca,44,Barruecopardo,502,259,243
37,Salamanca,45,Bastida (La),29,17,12
37,Salamanca,46,Béjar,14785,7055,7730
37,Salamanca,47,Beleña,208,97,111
37,Salamanca,49,Bermellar,164,81,83
37,Salamanca,50,Berrocal de Huebra,80,42,38
37,Salamanca,51,Berrocal de Salvatierra,105,50,55
37,Salamanca,52,Boada,321,165,156
37,Salamanca,54,Bodón (El),305,156,149
37,Salamanca,55,Bogajo,161,87,74
37,Salamanca,56,Bouza (La),66,36,30
37,Salamanca,57,Bóveda del Río Almar,261,137,124
37,Salamanca,58,Brincones,70,35,35
37,Salamanca,59,Buenamadre,142,78,64
37,Salamanca,60,Buenavista,202,109,93
37,Salamanca,61,Cabaco (El),290,144,146
37,Salamanca,63,Cabeza de Béjar (La),101,58,43
37,Salamanca,65,Cabeza del Caballo,399,211,188
37,Salamanca,62,Cabezabellosa de la Calzada,102,54,48
37,Salamanca,67,Cabrerizos,3918,1961,1957
37,Salamanca,68,Cabrillas,442,220,222
37,Salamanca,69,Calvarrasa de Abajo,1112,580,532
37,Salamanca,70,Calvarrasa de Arriba,647,336,311
37,Salamanca,71,Calzada de Béjar (La),100,53,47
37,Salamanca,72,Calzada de Don Diego,198,105,93
37,Salamanca,73,Calzada de Valdunciel,643,332,311
37,Salamanca,74,Campillo de Azaba,198,104,94
37,Salamanca,77,Campo de Peñaranda (El),315,167,148
37,Salamanca,78,Candelario,1010,515,495
37,Salamanca,79,Canillas de Abajo,88,57,31
37,Salamanca,80,Cantagallo,274,142,132
37,Salamanca,81,Cantalapiedra,1127,571,556
37,Salamanca,82,Cantalpino,1025,563,462
37,Salamanca,83,Cantaracillo,216,114,102
37,Salamanca,85,Carbajosa de la Sagrada,5987,3081,2906
37,Salamanca,86,Carpio de Azaba,115,65,50
37,Salamanca,87,Carrascal de Barregas,929,486,443
37,Salamanca,88,Carrascal del Obispo,231,122,109
37,Salamanca,89,Casafranca,72,38,34
37,Salamanca,90,Casas del Conde (Las),64,35,29
37,Salamanca,91,Casillas de Flores,226,112,114
37,Salamanca,92,Castellanos de Moriscos,1638,849,789
37,Salamanca,185,Castellanos de Villiquera,683,365,318
37,Salamanca,96,Castillejo de Martín Viejo,269,148,121
37,Salamanca,97,Castraz,51,29,22
37,Salamanca,98,Cepeda,401,196,205
37,Salamanca,99,Cereceda de la Sierra,101,48,53
37,Salamanca,100,Cerezal de Peñahorcada,88,51,37
37,Salamanca,101,Cerralbo,228,122,106
37,Salamanca,102,Cerro (El),481,248,233
37,Salamanca,103,Cespedosa de Tormes,579,313,266
37,Salamanca,114,Chagarcía Medianero,104,58,46
37,Salamanca,104,Cilleros de la Bastida,38,22,16
37,Salamanca,106,Cipérez,308,156,152
37,Salamanca,107,Ciudad Rodrigo,13777,6677,7100
37,Salamanca,108,Coca de Alba,119,60,59
37,Salamanca,109,Colmenar de Montemayor,197,109,88
37,Salamanca,110,Cordovilla,127,71,56
37,Salamanca,112,Cristóbal,201,110,91
37,Salamanca,113,Cubo de Don Sancho (El),501,262,239
37,Salamanca,115,Dios le Guarde,153,82,71
37,Salamanca,116,Doñinos de Ledesma,74,33,41
37,Salamanca,117,Doñinos de Salamanca,1657,872,785
37,Salamanca,118,Ejeme,155,86,69
37,Salamanca,119,Encina (La),130,77,53
37,Salamanca,120,Encina de San Silvestre,121,62,59
37,Salamanca,121,Encinas de Abajo,623,320,303
37,Salamanca,122,Encinas de Arriba,255,125,130
37,Salamanca,123,Encinasola de los Comendadores,222,114,108
37,Salamanca,124,Endrinal,255,135,120
37,Salamanca,125,Escurial de la Sierra,273,148,125
37,Salamanca,126,Espadaña,41,22,19
37,Salamanca,127,Espeja,279,140,139
37,Salamanca,128,Espino de la Orbada,293,154,139
37,Salamanca,129,Florida de Liébana,290,153,137
37,Salamanca,130,Forfoleda,202,109,93
37,Salamanca,131,Frades de la Sierra,221,120,101
37,Salamanca,132,Fregeneda (La),445,227,218
37,Salamanca,133,Fresnedoso,115,64,51
37,Salamanca,134,Fresno Alhándiga,277,149,128
37,Salamanca,135,Fuente de San Esteban (La),1453,745,708
37,Salamanca,136,Fuenteguinaldo,790,402,388
37,Salamanca,137,Fuenteliante,126,65,61
37,Salamanca,138,Fuenterroble de Salvatierra,269,137,132
37,Salamanca,139,Fuentes de Béjar,253,125,128
37,Salamanca,140,Fuentes de Oñoro,1375,670,705
37,Salamanca,141,Gajates,173,83,90
37,Salamanca,142,Galindo y Perahuy,725,422,303
37,Salamanca,143,Galinduste,493,246,247
37,Salamanca,144,Galisancho,435,238,197
37,Salamanca,145,Gallegos de Argañán,331,171,160
37,Salamanca,146,Gallegos de Solmirón,149,75,74
37,Salamanca,147,Garcibuey,207,116,91
37,Salamanca,148,Garcihernández,534,271,263
37,Salamanca,149,Garcirrey,86,45,41
37,Salamanca,150,Gejuelo del Barro,44,26,18
37,Salamanca,151,Golpejas,168,89,79
37,Salamanca,152,Gomecello,562,298,264
37,Salamanca,154,Guadramiro,165,95,70
37,Salamanca,155,Guijo de Ávila,101,60,41
37,Salamanca,156,Guijuelo,6046,3095,2951
37,Salamanca,157,Herguijuela de Ciudad Rodrigo,103,58,45
37,Salamanca,158,Herguijuela de la Sierra,300,160,140
37,Salamanca,159,Herguijuela del Campo,106,51,55
37,Salamanca,160,Hinojosa de Duero,736,372,364
37,Salamanca,161,Horcajo de Montemayor,170,88,82
37,Salamanca,162,Horcajo Medianero,263,143,120
37,Salamanca,163,Hoya (La),35,22,13
37,Salamanca,164,Huerta,321,175,146
37,Salamanca,165,Iruelos,41,19,22
37,Salamanca,166,Ituero de Azaba,238,126,112
37,Salamanca,167,Juzbado,176,90,86
37,Salamanca,168,Lagunilla,544,304,240
37,Salamanca,169,Larrodrigo,224,122,102
37,Salamanca,170,Ledesma,1968,989,979
37,Salamanca,171,Ledrada,579,293,286
37,Salamanca,172,Linares de Riofrío,989,517,472
37,Salamanca,173,Lumbrales,1924,955,969
37,Salamanca,175,Machacón,489,255,234
37,Salamanca,174,Macotera,1345,707,638
37,Salamanca,176,Madroñal,157,89,68
37,Salamanca,177,Maíllo (El),340,185,155
37,Salamanca,178,Malpartida,111,66,45
37,Salamanca,179,Mancera de Abajo,263,133,130
37,Salamanca,180,Manzano (El),76,40,36
37,Salamanca,181,Martiago,321,164,157
37,Salamanca,183,Martín de Yeltes,458,239,219
37,Salamanca,182,Martinamor,104,61,43
37,Salamanca,184,Masueco,389,195,194
37,Salamanca,186,Mata de Ledesma (La),118,63,55
37,Salamanca,187,Matilla de los Caños del Río,661,339,322
37,Salamanca,188,Maya (La),208,119,89
37,Salamanca,189,Membribe de la Sierra,141,87,54
37,Salamanca,190,Mieza,261,131,130
37,Salamanca,191,Milano (El),134,76,58
37,Salamanca,192,Miranda de Azán,458,235,223
37,Salamanca,193,Miranda del Castañar,527,275,252
37,Salamanca,194,Mogarraz,308,161,147
37,Salamanca,195,Molinillo,59,33,26
37,Salamanca,196,Monforte de la Sierra,101,59,42
37,Salamanca,197,Monleón,107,63,44
37,Salamanca,198,Monleras,275,128,147
37,Salamanca,199,Monsagro,174,101,73
37,Salamanca,200,Montejo,254,139,115
37,Salamanca,201,Montemayor del Río,305,160,145
37,Salamanca,202,Monterrubio de Armuña,1226,655,571
37,Salamanca,203,Monterrubio de la Sierra,167,96,71
37,Salamanca,204,Morasverdes,328,172,156
37,Salamanca,205,Morille,254,131,123
37,Salamanca,206,Moríñigo,116,59,57
37,Salamanca,207,Moriscos,185,98,87
37,Salamanca,208,Moronta,98,56,42
37,Salamanca,209,Mozárbez,470,254,216
37,Salamanca,211,Narros de Matalayegua,237,125,112
37,Salamanca,213,Nava de Béjar,109,58,51
37,Salamanca,214,Nava de Francia,144,75,69
37,Salamanca,215,Nava de Sotrobal,195,105,90
37,Salamanca,212,Navacarros,131,71,60
37,Salamanca,216,Navales,339,182,157
37,Salamanca,217,Navalmoral de Béjar,56,25,31
37,Salamanca,218,Navamorales,86,50,36
37,Salamanca,219,Navarredonda de la Rinconada,216,112,104
37,Salamanca,221,Navasfrías,517,269,248
37,Salamanca,222,Negrilla de Palencia,139,72,67
37,Salamanca,223,Olmedo de Camaces,134,73,61
37,Salamanca,224,Orbada (La),242,122,120
37,Salamanca,225,Pajares de la Laguna,139,74,65
37,Salamanca,226,Palacios del Arzobispo,193,97,96
37,Salamanca,228,Palaciosrubios,443,235,208
37,Salamanca,229,Palencia de Negrilla,175,98,77
37,Salamanca,230,Parada de Arriba,270,141,129
37,Salamanca,231,Parada de Rubiales,319,169,150
37,Salamanca,232,Paradinas de San Juan,493,274,219
37,Salamanca,233,Pastores,67,37,30
37,Salamanca,234,Payo (El),394,187,207
37,Salamanca,235,Pedraza de Alba,256,132,124
37,Salamanca,236,Pedrosillo de Alba,169,91,78
37,Salamanca,237,Pedrosillo de los Aires,386,215,171
37,Salamanca,238,Pedrosillo el Ralo,135,69,66
37,Salamanca,239,Pedroso de la Armuña (El),258,127,131
37,Salamanca,240,Pelabravo,931,484,447
37,Salamanca,241,Pelarrodríguez,182,105,77
37,Salamanca,242,Pelayos,121,63,58
37,Salamanca,243,Peña (La),129,61,68
37,Salamanca,244,Peñacaballera,162,79,83
37,Salamanca,245,Peñaparda,414,217,197
37,Salamanca,246,Peñaranda de Bracamonte,6744,3341,3403
37,Salamanca,247,Peñarandilla,234,127,107
37,Salamanca,248,Peralejos de Abajo,176,95,81
37,Salamanca,249,Peralejos de Arriba,48,29,19
37,Salamanca,250,Pereña de la Ribera,404,211,193
37,Salamanca,251,Peromingo,147,67,80
37,Salamanca,252,Pinedas,145,77,68
37,Salamanca,253,Pino de Tormes (El),149,78,71
37,Salamanca,254,Pitiegua,212,116,96
37,Salamanca,255,Pizarral,80,42,38
37,Salamanca,256,Poveda de las Cintas,273,153,120
37,Salamanca,257,Pozos de Hinojo,54,29,25
37,Salamanca,258,Puebla de Azaba,218,112,106
37,Salamanca,259,Puebla de San Medel,43,24,19
37,Salamanca,260,Puebla de Yeltes,180,95,85
37,Salamanca,261,Puente del Congosto,265,142,123
37,Salamanca,262,Puertas,85,48,37
37,Salamanca,263,Puerto de Béjar,389,192,197
37,Salamanca,264,Puerto Seguro,79,40,39
37,Salamanca,265,Rágama,257,128,129
37,Salamanca,266,Redonda (La),93,52,41
37,Salamanca,267,Retortillo,243,117,126
37,Salamanca,268,Rinconada de la Sierra (La),142,78,64
37,Salamanca,269,Robleda,509,263,246
37,Salamanca,270,Robliza de Cojos,242,127,115
37,Salamanca,271,Rollán,466,248,218
37,Salamanca,272,Saelices el Chico,163,79,84
37,Salamanca,273,Sagrada (La),140,71,69
37,Salamanca,303,Sahugo (El),236,123,113
37,Salamanca,274,Salamanca,154462,71314,83148
37,Salamanca,275,Saldeana,142,81,61
37,Salamanca,276,Salmoral,228,124,104
37,Salamanca,277,Salvatierra de Tormes,61,27,34
37,Salamanca,278,San Cristóbal de la Cuesta,895,487,408
37,Salamanca,284,San Esteban de la Sierra,355,185,170
37,Salamanca,285,San Felices de los Gallegos,519,268,251
37,Salamanca,286,San Martín del Castañar,283,154,129
37,Salamanca,287,San Miguel de Valero,376,183,193
37,Salamanca,36,San Miguel del Robledo,71,31,40
37,Salamanca,288,San Morales,280,161,119
37,Salamanca,289,San Muñoz,277,146,131
37,Salamanca,291,San Pedro de Rozados,318,161,157
37,Salamanca,290,San Pedro del Valle,147,80,67
37,Salamanca,292,San Pelayo de Guareña,107,58,49
37,Salamanca,280,Sanchón de la Ribera,92,48,44
37,Salamanca,281,Sanchón de la Sagrada,40,21,19
37,Salamanca,282,Sanchotello,232,121,111
37,Salamanca,279,Sancti-Spíritus,918,482,436
37,Salamanca,283,Sando,144,81,63
37,Salamanca,293,Santa María de Sando,131,68,63
37,Salamanca,294,Santa Marta de Tormes,14756,7388,7368
37,Salamanca,296,Santiago de la Puebla,426,226,200
37,Salamanca,297,Santibáñez de Béjar,543,273,270
37,Salamanca,298,Santibáñez de la Sierra,223,112,111
37,Salamanca,299,Santiz,272,139,133
37,Salamanca,300,Santos (Los),662,348,314
37,Salamanca,301,Sardón de los Frailes,92,49,43
37,Salamanca,302,Saucelle,370,188,182
37,Salamanca,304,Sepulcro-Hilario,204,112,92
37,Salamanca,305,Sequeros,236,114,122
37,Salamanca,306,Serradilla del Arroyo,344,177,167
37,Salamanca,307,Serradilla del Llano,183,88,95
37,Salamanca,309,Sierpe (La),44,29,15
37,Salamanca,310,Sieteiglesias de Tormes,183,88,95
37,Salamanca,311,Sobradillo,279,145,134
37,Salamanca,312,Sorihuela,332,167,165
37,Salamanca,313,Sotoserrano,664,347,317
37,Salamanca,314,Tabera de Abajo,110,60,50
37,Salamanca,315,Tala (La),116,64,52
37,Salamanca,316,Tamames,971,500,471
37,Salamanca,317,Tarazona de Guareña,370,201,169
37,Salamanca,318,Tardáguila,229,130,99
37,Salamanca,319,Tejado (El),138,72,66
37,Salamanca,320,Tejeda y Segoyuela,107,60,47
37,Salamanca,321,Tenebrón,176,86,90
37,Salamanca,322,Terradillos,3450,1772,1678
37,Salamanca,323,Topas,628,328,300
37,Salamanca,324,Tordillos,458,245,213
37,Salamanca,325,Tornadizo (El),117,62,55
37,Salamanca,327,Torresmenudas,203,102,101
37,Salamanca,328,Trabanca,248,121,127
37,Salamanca,329,Tremedal de Tormes,37,19,18
37,Salamanca,330,Valdecarros,391,204,187
37,Salamanca,331,Valdefuentes de Sangusín,264,138,126
37,Salamanca,332,Valdehijaderos,101,53,48
37,Salamanca,333,Valdelacasa,278,157,121
37,Salamanca,334,Valdelageve,87,46,41
37,Salamanca,335,Valdelosa,498,236,262
37,Salamanca,336,Valdemierque,62,36,26
37,Salamanca,337,Valderrodrigo,161,81,80
37,Salamanca,338,Valdunciel,101,52,49
37,Salamanca,339,Valero,368,191,177
37,Salamanca,343,Vallejera de Riofrío,69,33,36
37,Salamanca,340,Valsalabroso,165,92,73
37,Salamanca,341,Valverde de Valdelacasa,84,47,37
37,Salamanca,342,Valverdón,266,137,129
37,Salamanca,344,Vecinos,311,162,149
37,Salamanca,345,Vega de Tirados,196,92,104
37,Salamanca,346,Veguillas (Las),294,139,155
37,Salamanca,347,Vellés (La),576,312,264
37,Salamanca,348,Ventosa del Río Almar,130,70,60
37,Salamanca,349,Vídola (La),149,70,79
37,Salamanca,351,Villaflores,336,169,167
37,Salamanca,352,Villagonzalo de Tormes,210,118,92
37,Salamanca,353,Villalba de los Llanos,166,96,70
37,Salamanca,354,Villamayor,6457,3287,3170
37,Salamanca,355,Villanueva del Conde,188,99,89
37,Salamanca,356,Villar de Argañán,94,46,48
37,Salamanca,357,Villar de Ciervo,317,166,151
37,Salamanca,358,Villar de Gallimazo,176,93,83
37,Salamanca,359,Villar de la Yegua,205,106,99
37,Salamanca,360,Villar de Peralonso,289,134,155
37,Salamanca,361,Villar de Samaniego,102,55,47
37,Salamanca,362,Villares de la Reina,5701,2869,2832
37,Salamanca,363,Villares de Yeltes,136,64,72
37,Salamanca,364,Villarino de los Aires,977,505,472
37,Salamanca,365,Villarmayor,219,117,102
37,Salamanca,366,Villarmuerto,43,28,15
37,Salamanca,367,Villasbuenas,236,128,108
37,Salamanca,368,Villasdardo,18,8,10
37,Salamanca,369,Villaseco de los Gamitos,172,94,78
37,Salamanca,370,Villaseco de los Reyes,405,230,175
37,Salamanca,371,Villasrubias,245,140,105
37,Salamanca,372,Villaverde de Guareña,167,85,82
37,Salamanca,373,Villavieja de Yeltes,929,468,461
37,Salamanca,374,Villoria,1478,748,730
37,Salamanca,375,Villoruela,924,474,450
37,Salamanca,350,Vilvestre,487,242,245
37,Salamanca,376,Vitigudino,2907,1446,1461
37,Salamanca,377,Yecla de Yeltes,301,156,145
37,Salamanca,378,Zamarra,120,66,54
37,Salamanca,379,Zamayón,179,98,81
37,Salamanca,380,Zarapicos,67,34,33
37,Salamanca,381,Zarza de Pumareda (La),152,86,66
37,Salamanca,382,Zorita de la Frontera,229,121,108
38,Santa Cruz de Tenerife,1,Adeje,43801,22578,21223
38,Santa Cruz de Tenerife,2,Agulo,1180,593,587
38,Santa Cruz de Tenerife,3,Alajeró,2048,1093,955
38,Santa Cruz de Tenerife,4,Arafo,5543,2731,2812
38,Santa Cruz de Tenerife,5,Arico,7891,4073,3818
38,Santa Cruz de Tenerife,6,Arona,79377,41097,38280
38,Santa Cruz de Tenerife,7,Barlovento,2296,1167,1129
38,Santa Cruz de Tenerife,8,Breña Alta,7347,3640,3707
38,Santa Cruz de Tenerife,9,Breña Baja,5259,2699,2560
38,Santa Cruz de Tenerife,10,Buenavista del Norte,5151,2645,2506
38,Santa Cruz de Tenerife,11,Candelaria,25140,12358,12782
38,Santa Cruz de Tenerife,12,Fasnia,2777,1403,1374
38,Santa Cruz de Tenerife,13,Frontera,4124,2101,2023
38,Santa Cruz de Tenerife,14,Fuencaliente de la Palma,1898,962,936
38,Santa Cruz de Tenerife,15,Garachico,5413,2703,2710
38,Santa Cruz de Tenerife,16,Garafía,1714,889,825
38,Santa Cruz de Tenerife,17,Granadilla de Abona,40862,20931,19931
38,Santa Cruz de Tenerife,18,Guancha (La),5475,2691,2784
38,Santa Cruz de Tenerife,19,Guía de Isora,20535,10338,10197
38,Santa Cruz de Tenerife,20,Güímar,17852,8836,9016
38,Santa Cruz de Tenerife,21,Hermigua,2183,1099,1084
38,Santa Cruz de Tenerife,22,Icod de los Vinos,24231,12060,12171
38,Santa Cruz de Tenerife,24,Llanos de Aridane (Los),20948,10269,10679
38,Santa Cruz de Tenerife,25,Matanza de Acentejo (La),8471,4303,4168
38,Santa Cruz de Tenerife,26,Orotava (La),41427,20444,20983
38,Santa Cruz de Tenerife,27,Paso (El),7837,3957,3880
38,Santa Cruz de Tenerife,901,Pinar de El Hierro (El),1801,927,874
38,Santa Cruz de Tenerife,28,Puerto de la Cruz,32571,15838,16733
38,Santa Cruz de Tenerife,29,Puntagorda,2177,1135,1042
38,Santa Cruz de Tenerife,30,Puntallana,2425,1211,1214
38,Santa Cruz de Tenerife,31,Realejos (Los),37658,18611,19047
38,Santa Cruz de Tenerife,32,Rosario (El),17417,9046,8371
38,Santa Cruz de Tenerife,33,San Andrés y Sauces,4874,2468,2406
38,Santa Cruz de Tenerife,23,San Cristóbal de La Laguna,152222,74453,77769
38,Santa Cruz de Tenerife,34,San Juan de la Rambla,5076,2520,2556
38,Santa Cruz de Tenerife,35,San Miguel de Abona,16707,8494,8213
38,Santa Cruz de Tenerife,36,San Sebastián de la Gomera,9092,4587,4505
38,Santa Cruz de Tenerife,37,Santa Cruz de la Palma,17128,8307,8821
38,Santa Cruz de Tenerife,38,Santa Cruz de Tenerife,222643,106906,115737
38,Santa Cruz de Tenerife,39,Santa Úrsula,14143,7085,7058
38,Santa Cruz de Tenerife,40,Santiago del Teide,12099,6054,6045
38,Santa Cruz de Tenerife,41,Sauzal (El),8930,4431,4499
38,Santa Cruz de Tenerife,42,Silos (Los),5246,2624,2622
38,Santa Cruz de Tenerife,43,Tacoronte,23615,11817,11798
38,Santa Cruz de Tenerife,44,Tanque (El),2965,1465,1500
38,Santa Cruz de Tenerife,45,Tazacorte,5697,2891,2806
38,Santa Cruz de Tenerife,46,Tegueste,10731,5334,5397
38,Santa Cruz de Tenerife,47,Tijarafe,2769,1408,1361
38,Santa Cruz de Tenerife,49,Valle Gran Rey,5150,2580,2570
38,Santa Cruz de Tenerife,50,Vallehermoso,3123,1614,1509
38,Santa Cruz de Tenerife,48,Valverde,5035,2577,2458
38,Santa Cruz de Tenerife,51,Victoria de Acentejo (La),9042,4506,4536
38,Santa Cruz de Tenerife,52,Vilaflor,1843,952,891
38,Santa Cruz de Tenerife,53,Villa de Mazo,4955,2506,2449
40,Segovia,1,Abades,893,460,433
40,Segovia,2,Adrada de Pirón,47,24,23
40,Segovia,3,Adrados,165,90,75
40,Segovia,4,Aguilafuente,707,345,362
40,Segovia,5,Alconada de Maderuelo,37,23,14
40,Segovia,12,Aldea Real,353,186,167
40,Segovia,6,Aldealcorvo,27,18,9
40,Segovia,7,Aldealengua de Pedraza,100,58,42
40,Segovia,8,Aldealengua de Santa María,82,42,40
40,Segovia,9,Aldeanueva de la Serrezuela,57,35,22
40,Segovia,10,Aldeanueva del Codonal,157,85,72
40,Segovia,13,Aldeasoña,74,43,31
40,Segovia,14,Aldehorno,61,31,30
40,Segovia,15,Aldehuela del Codonal,32,17,15
40,Segovia,16,Aldeonte,73,32,41
40,Segovia,17,Anaya,162,78,84
40,Segovia,18,Añe,111,62,49
40,Segovia,19,Arahuetes,49,29,20
40,Segovia,20,Arcones,249,128,121
40,Segovia,21,Arevalillo de Cega,35,18,17
40,Segovia,22,Armuña,235,131,104
40,Segovia,24,Ayllón,1387,725,662
40,Segovia,25,Barbolla,198,109,89
40,Segovia,26,Basardilla,167,79,88
40,Segovia,28,Bercial,111,56,55
40,Segovia,29,Bercimuel,56,29,27
40,Segovia,30,Bernardos,605,321,284
40,Segovia,31,Bernuy de Porreros,649,352,297
40,Segovia,32,Boceguillas,755,394,361
40,Segovia,33,Brieva,74,46,28
40,Segovia,34,Caballar,105,51,54
40,Segovia,35,Cabañas de Polendos,148,78,70
40,Segovia,36,Cabezuela,716,374,342
40,Segovia,37,Calabazas de Fuentidueña,42,23,19
40,Segovia,39,Campo de San Pedro,353,201,152
40,Segovia,40,Cantalejo,3894,1962,1932
40,Segovia,41,Cantimpalos,1421,744,677
40,Segovia,43,Carbonero el Mayor,2586,1317,1269
40,Segovia,44,Carrascal del Río,174,93,81
40,Segovia,45,Casla,162,87,75
40,Segovia,46,Castillejo de Mesleón,158,91,67
40,Segovia,47,Castro de Fuentidueña,54,32,22
40,Segovia,48,Castrojimeno,40,23,17
40,Segovia,49,Castroserna de Abajo,54,26,28
40,Segovia,51,Castroserracín,58,38,20
40,Segovia,52,Cedillo de la Torre,125,64,61
40,Segovia,53,Cerezo de Abajo,166,90,76
40,Segovia,54,Cerezo de Arriba,197,100,97
40,Segovia,65,Chañe,855,410,445
40,Segovia,55,Cilleruelo de San Mamés,42,23,19
40,Segovia,56,Cobos de Fuentidueña,41,18,23
40,Segovia,57,Coca,2112,1043,1069
40,Segovia,58,Codorniz,405,205,200
40,Segovia,59,Collado Hermoso,160,81,79
40,Segovia,60,Condado de Castilnovo,108,59,49
40,Segovia,61,Corral de Ayllón,83,51,32
40,Segovia,902,Cozuelos de Fuentidueña,150,83,67
40,Segovia,62,Cubillo,67,41,26
40,Segovia,63,Cuéllar,9730,4929,4801
40,Segovia,905,Cuevas de Provanco,157,84,73
40,Segovia,68,Domingo García,42,25,17
40,Segovia,69,Donhierro,115,63,52
40,Segovia,70,Duruelo,176,102,74
40,Segovia,71,Encinas,55,32,23
40,Segovia,72,Encinillas,174,98,76
40,Segovia,73,Escalona del Prado,595,312,283
40,Segovia,74,Escarabajosa de Cabezas,344,196,148
40,Segovia,75,Escobar de Polendos,197,103,94
40,Segovia,76,Espinar (El),9755,5039,4716
40,Segovia,77,Espirdo,921,497,424
40,Segovia,78,Fresneda de Cuéllar,195,107,88
40,Segovia,79,Fresno de Cantespino,278,157,121
40,Segovia,80,Fresno de la Fuente,111,58,53
40,Segovia,81,Frumales,177,87,90
40,Segovia,82,Fuente de Santa Cruz,143,70,73
40,Segovia,83,Fuente el Olmo de Fuentidueña,201,71,130
40,Segovia,84,Fuente el Olmo de Íscar,80,42,38
40,Segovia,86,Fuentepelayo,958,495,463
40,Segovia,87,Fuentepiñel,120,63,57
40,Segovia,88,Fuenterrebollo,391,201,190
40,Segovia,89,Fuentesaúco de Fuentidueña,292,154,138
40,Segovia,91,Fuentesoto,167,91,76
40,Segovia,92,Fuentidueña,123,64,59
40,Segovia,93,Gallegos,97,50,47
40,Segovia,94,Garcillán,462,249,213
40,Segovia,95,Gomezserracín,732,372,360
40,Segovia,97,Grajera,214,121,93
40,Segovia,99,Honrubia de la Cuesta,67,40,27
40,Segovia,100,Hontalbilla,351,187,164
40,Segovia,101,Hontanares de Eresma,1020,515,505
40,Segovia,103,Huertos (Los),171,96,75
40,Segovia,104,Ituero y Lama,333,173,160
40,Segovia,105,Juarros de Riomoros,71,41,30
40,Segovia,106,Juarros de Voltoya,276,139,137
40,Segovia,107,Labajos,153,78,75
40,Segovia,108,Laguna de Contreras,129,77,52
40,Segovia,109,Languilla,97,52,45
40,Segovia,110,Lastras de Cuéllar,446,231,215
40,Segovia,111,Lastras del Pozo,94,43,51
40,Segovia,112,Lastrilla (La),3292,1719,1573
40,Segovia,113,Losa (La),544,285,259
40,Segovia,115,Maderuelo,155,87,68
40,Segovia,903,Marazoleja,128,77,51
40,Segovia,118,Marazuela,64,35,29
40,Segovia,119,Martín Miguel,270,153,117
40,Segovia,120,Martín Muñoz de la Dehesa,214,115,99
40,Segovia,121,Martín Muñoz de las Posadas,347,172,175
40,Segovia,122,Marugán,635,337,298
40,Segovia,124,Mata de Cuéllar,300,162,138
40,Segovia,123,Matabuena,254,130,124
40,Segovia,125,Matilla (La),104,59,45
40,Segovia,126,Melque de Cercos,107,57,50
40,Segovia,127,Membibre de la Hoz,46,24,22
40,Segovia,128,Migueláñez,162,76,86
40,Segovia,129,Montejo de Arévalo,231,125,106
40,Segovia,130,Montejo de la Vega de la Serrezuela,165,93,72
40,Segovia,131,Monterrubio,69,37,32
40,Segovia,132,Moral de Hornuez,93,52,41
40,Segovia,134,Mozoncillo,1087,578,509
40,Segovia,135,Muñopedro,332,176,156
40,Segovia,136,Muñoveros,186,93,93
40,Segovia,138,Nava de la Asunción,3024,1535,1489
40,Segovia,139,Navafría,374,199,175
40,Segovia,140,Navalilla,129,66,63
40,Segovia,141,Navalmanzano,1174,607,567
40,Segovia,142,Navares de Ayuso,60,32,28
40,Segovia,143,Navares de Enmedio,113,66,47
40,Segovia,144,Navares de las Cuevas,24,18,6
40,Segovia,145,Navas de Oro,1480,759,721
40,Segovia,904,Navas de Riofrío,403,190,213
40,Segovia,146,Navas de San Antonio,426,240,186
40,Segovia,148,Nieva,340,173,167
40,Segovia,149,Olombrada,707,388,319
40,Segovia,150,Orejana,77,47,30
40,Segovia,151,Ortigosa de Pestaño,96,52,44
40,Segovia,901,Ortigosa del Monte,524,267,257
40,Segovia,152,Otero de Herreros,1004,513,491
40,Segovia,154,Pajarejos,30,18,12
40,Segovia,155,Palazuelos de Eresma,4238,2220,2018
40,Segovia,156,Pedraza,473,263,210
40,Segovia,157,Pelayos del Arroyo,70,38,32
40,Segovia,158,Perosillo,25,17,8
40,Segovia,159,Pinarejos,133,80,53
40,Segovia,160,Pinarnegrillo,139,77,62
40,Segovia,161,Pradales,64,33,31
40,Segovia,162,Prádena,597,321,276
40,Segovia,163,Puebla de Pedraza,70,34,36
40,Segovia,164,Rapariegos,232,117,115
40,Segovia,165,Rebollo,101,57,44
40,Segovia,166,Remondo,348,172,176
40,Segovia,168,Riaguas de San Bartolomé,40,21,19
40,Segovia,170,Riaza,2481,1333,1148
40,Segovia,171,Ribota,36,26,10
40,Segovia,172,Riofrío de Riaza,36,21,15
40,Segovia,173,Roda de Eresma,220,118,102
40,Segovia,174,Sacramenia,503,263,240
40,Segovia,176,Samboal,525,274,251
40,Segovia,177,San Cristóbal de Cuéllar,183,99,84
40,Segovia,178,San Cristóbal de la Vega,133,67,66
40,Segovia,906,San Cristóbal de Segovia,2921,1517,1404
40,Segovia,181,San Ildefonso,5702,2826,2876
40,Segovia,182,San Martín y Mudrián,282,135,147
40,Segovia,183,San Miguel de Bernuy,176,87,89
40,Segovia,184,San Pedro de Gaíllos,326,174,152
40,Segovia,179,Sanchonuño,936,460,476
40,Segovia,180,Sangarcía,429,225,204
40,Segovia,185,Santa María la Real de Nieva,1193,631,562
40,Segovia,186,Santa Marta del Cerro,54,24,30
40,Segovia,188,Santiuste de Pedraza,105,59,46
40,Segovia,189,Santiuste de San Juan Bautista,648,338,310
40,Segovia,190,Santo Domingo de Pirón,64,33,31
40,Segovia,191,Santo Tomé del Puerto,351,193,158
40,Segovia,192,Sauquillo de Cabezas,211,117,94
40,Segovia,193,Sebúlcor,286,152,134
40,Segovia,194,Segovia,55748,26776,28972
40,Segovia,195,Sepúlveda,1255,647,608
40,Segovia,196,Sequera de Fresno,51,28,23
40,Segovia,198,Sotillo,30,17,13
40,Segovia,199,Sotosalbos,131,65,66
40,Segovia,200,Tabanera la Luenga,77,36,41
40,Segovia,201,Tolocirio,54,26,28
40,Segovia,206,Torre Val de San Pedro,194,106,88
40,Segovia,202,Torreadrada,105,47,58
40,Segovia,203,Torrecaballeros,1206,612,594
40,Segovia,204,Torrecilla del Pinar,219,114,105
40,Segovia,205,Torreiglesias,362,183,179
40,Segovia,207,Trescasas,869,450,419
40,Segovia,208,Turégano,1098,550,548
40,Segovia,210,Urueñas,105,62,43
40,Segovia,211,Valdeprados,101,53,48
40,Segovia,212,Valdevacas de Montejo,31,17,14
40,Segovia,213,Valdevacas y Guijar,124,65,59
40,Segovia,218,Valle de Tabladillo,123,68,55
40,Segovia,219,Vallelado,795,425,370
40,Segovia,220,Valleruela de Pedraza,83,43,40
40,Segovia,221,Valleruela de Sepúlveda,64,31,33
40,Segovia,214,Valseca,306,165,141
40,Segovia,215,Valtiendas,143,85,58
40,Segovia,216,Valverde del Majano,1027,517,510
40,Segovia,222,Veganzones,266,144,122
40,Segovia,223,Vegas de Matute,297,178,119
40,Segovia,224,Ventosilla y Tejadilla,38,23,15
40,Segovia,225,Villacastín,1653,851,802
40,Segovia,228,Villaverde de Íscar,727,381,346
40,Segovia,229,Villaverde de Montejo,44,25,19
40,Segovia,230,Villeguillo,170,97,73
40,Segovia,231,Yanguas de Eresma,153,78,75
40,Segovia,233,Zarzuela del Monte,602,310,292
40,Segovia,234,Zarzuela del Pinar,522,267,255
41,Sevilla,1,Aguadulce,2181,1096,1085
41,Sevilla,2,Alanís,1863,926,937
41,Sevilla,3,Albaida del Aljarafe,2898,1466,1432
41,Sevilla,4,Alcalá de Guadaíra,71740,35748,35992
41,Sevilla,5,Alcalá del Río,11004,5572,5432
41,Sevilla,6,Alcolea del Río,3407,1691,1716
41,Sevilla,7,Algaba (La),15255,7608,7647
41,Sevilla,8,Algámitas,1346,694,652
41,Sevilla,9,Almadén de la Plata,1520,765,755
41,Sevilla,10,Almensilla,5732,2913,2819
41,Sevilla,11,Arahal,19335,9557,9778
41,Sevilla,12,Aznalcázar,4128,2089,2039
41,Sevilla,13,Aznalcóllar,6191,3171,3020
41,Sevilla,14,Badolatosa,3238,1674,1564
41,Sevilla,15,Benacazón,6726,3392,3334
41,Sevilla,16,Bollullos de la Mitación,9142,4598,4544
41,Sevilla,17,Bormujos,19110,9515,9595
41,Sevilla,18,Brenes,12580,6303,6277
41,Sevilla,19,Burguillos,6120,3080,3040
41,Sevilla,20,Cabezas de San Juan (Las),16571,8453,8118
41,Sevilla,21,Camas,26086,12774,13312
41,Sevilla,22,Campana (La),5507,2756,2751
41,Sevilla,23,Cantillana,10643,5415,5228
41,Sevilla,901,Cañada Rosal,3242,1626,1616
41,Sevilla,24,Carmona,28576,14446,14130
41,Sevilla,25,Carrión de los Céspedes,2511,1218,1293
41,Sevilla,26,Casariche,5579,2862,2717
41,Sevilla,27,Castilblanco de los Arroyos,5156,2624,2532
41,Sevilla,28,Castilleja de Guzmán,2846,1465,1381
41,Sevilla,29,Castilleja de la Cuesta,17282,8415,8867
41,Sevilla,30,Castilleja del Campo,653,322,331
41,Sevilla,31,Castillo de las Guardas (El),1612,835,777
41,Sevilla,32,Cazalla de la Sierra,5009,2499,2510
41,Sevilla,33,Constantina,6586,3281,3305
41,Sevilla,34,Coria del Río,28654,14438,14216
41,Sevilla,35,Coripe,1446,726,720
41,Sevilla,36,Coronil (El),5042,2534,2508
41,Sevilla,37,Corrales (Los),4063,2070,1993
41,Sevilla,903,Cuervo de Sevilla (El),8673,4408,4265
41,Sevilla,38,Dos Hermanas,125086,61881,63205
41,Sevilla,39,Écija,40534,19996,20538
41,Sevilla,40,Espartinas,13166,6600,6566
41,Sevilla,41,Estepa,12682,6307,6375
41,Sevilla,42,Fuentes de Andalucía,7309,3643,3666
41,Sevilla,43,Garrobo (El),772,396,376
41,Sevilla,44,Gelves,9244,4604,4640
41,Sevilla,45,Gerena,6812,3447,3365
41,Sevilla,46,Gilena,3960,1981,1979
41,Sevilla,47,Gines,13108,6455,6653
41,Sevilla,48,Guadalcanal,2962,1469,1493
41,Sevilla,49,Guillena,11456,5744,5712
41,Sevilla,50,Herrera,6516,3225,3291
41,Sevilla,51,Huévar del Aljarafe,2658,1366,1292
41,Sevilla,902,Isla Mayor,5930,2986,2944
41,Sevilla,52,Lantejuela (La),3882,1971,1911
41,Sevilla,53,Lebrija,26783,13477,13306
41,Sevilla,54,Lora de Estepa,873,441,432
41,Sevilla,55,Lora del Río,19393,9621,9772
41,Sevilla,56,Luisiana (La),4614,2334,2280
41,Sevilla,57,Madroño (El),350,175,175
41,Sevilla,58,Mairena del Alcor,21100,10530,10570
41,Sevilla,59,Mairena del Aljarafe,41510,20496,21014
41,Sevilla,60,Marchena,19861,9919,9942
41,Sevilla,61,Marinaleda,2759,1394,1365
41,Sevilla,62,Martín de la Jara,2782,1434,1348
41,Sevilla,63,Molares (Los),3310,1701,1609
41,Sevilla,64,Montellano,7146,3576,3570
41,Sevilla,65,Morón de la Frontera,28467,14149,14318
41,Sevilla,66,Navas de la Concepción (Las),1743,866,877
41,Sevilla,67,Olivares,9534,4787,4747
41,Sevilla,68,Osuna,17926,8857,9069
41,Sevilla,69,Palacios y Villafranca (Los),37279,18788,18491
41,Sevilla,70,Palomares del Río,7185,3602,3583
41,Sevilla,71,Paradas,7068,3549,3519
41,Sevilla,72,Pedrera,5339,2644,2695
41,Sevilla,73,Pedroso (El),2218,1100,1118
41,Sevilla,74,Peñaflor,3814,1916,1898
41,Sevilla,75,Pilas,13509,6833,6676
41,Sevilla,76,Pruna,2892,1488,1404
41,Sevilla,77,Puebla de Cazalla (La),11434,5719,5715
41,Sevilla,78,Puebla de los Infantes (La),3221,1596,1625
41,Sevilla,79,Puebla del Río (La),12210,6045,6165
41,Sevilla,80,Real de la Jara (El),1607,776,831
41,Sevilla,81,Rinconada (La),36641,18294,18347
41,Sevilla,82,Roda de Andalucía (La),4451,2227,2224
41,Sevilla,83,Ronquillo (El),1432,738,694
41,Sevilla,84,Rubio (El),3549,1767,1782
41,Sevilla,85,Salteras,5177,2532,2645
41,Sevilla,86,San Juan de Aznalfarache,21025,10149,10876
41,Sevilla,88,San Nicolás del Puerto,644,324,320
41,Sevilla,87,Sanlúcar la Mayor,13016,6504,6512
41,Sevilla,89,Santiponce,8238,4119,4119
41,Sevilla,90,Saucejo (El),4459,2235,2224
41,Sevilla,91,Sevilla,704198,335192,369006
41,Sevilla,92,Tocina,9524,4710,4814
41,Sevilla,93,Tomares,23310,11554,11756
41,Sevilla,94,Umbrete,8010,4039,3971
41,Sevilla,95,Utrera,51177,25605,25572
41,Sevilla,96,Valencina de la Concepción,8031,4004,4027
41,Sevilla,97,Villamanrique de la Condesa,4162,2054,2108
41,Sevilla,100,Villanueva de San Juan,1370,672,698
41,Sevilla,98,Villanueva del Ariscal,6078,2957,3121
41,Sevilla,99,Villanueva del Río y Minas,5260,2621,2639
41,Sevilla,101,Villaverde del Río,7447,3799,3648
41,Sevilla,102,Viso del Alcor (El),18641,9411,9230
42,Soria,1,Abejar,380,210,170
42,Soria,3,Adradas,72,39,33
42,Soria,4,Ágreda,3259,1661,1598
42,Soria,6,Alconaba,188,111,77
42,Soria,7,Alcubilla de Avellaneda,161,84,77
42,Soria,8,Alcubilla de las Peñas,76,44,32
42,Soria,9,Aldealafuente,113,60,53
42,Soria,10,Aldealices,24,12,12
42,Soria,11,Aldealpozo,28,14,14
42,Soria,12,Aldealseñor,47,26,21
42,Soria,13,Aldehuela de Periáñez,53,27,26
42,Soria,14,Aldehuelas (Las),96,49,47
42,Soria,15,Alentisque,32,17,15
42,Soria,16,Aliud,27,15,12
42,Soria,17,Almajano,216,116,100
42,Soria,18,Almaluez,195,109,86
42,Soria,19,Almarza,659,376,283
42,Soria,20,Almazán,5965,3052,2913
42,Soria,21,Almazul,102,57,45
42,Soria,22,Almenar de Soria,288,162,126
42,Soria,23,Alpanseque,84,46,38
42,Soria,24,Arancón,102,64,38
42,Soria,25,Arcos de Jalón,1830,983,847
42,Soria,26,Arenillas,27,16,11
42,Soria,27,Arévalo de la Sierra,79,50,29
42,Soria,28,Ausejo de la Sierra,63,34,29
42,Soria,29,Baraona,179,100,79
42,Soria,30,Barca,112,67,45
42,Soria,31,Barcones,30,18,12
42,Soria,32,Bayubas de Abajo,194,102,92
42,Soria,33,Bayubas de Arriba,57,32,25
42,Soria,34,Beratón,36,28,8
42,Soria,35,Berlanga de Duero,1012,511,501
42,Soria,36,Blacos,53,30,23
42,Soria,37,Bliecos,43,25,18
42,Soria,38,Borjabad,43,24,19
42,Soria,39,Borobia,287,152,135
42,Soria,41,Buberos,37,20,17
42,Soria,42,Buitrago,60,32,28
42,Soria,43,Burgo de Osma-Ciudad de Osma,5287,2639,2648
42,Soria,44,Cabrejas del Campo,71,39,32
42,Soria,45,Cabrejas del Pinar,426,239,187
42,Soria,46,Calatañazor,70,38,32
42,Soria,48,Caltojar,76,44,32
42,Soria,49,Candilichera,155,87,68
42,Soria,50,Cañamaque,31,21,10
42,Soria,51,Carabantes,25,12,13
42,Soria,52,Caracena,23,17,6
42,Soria,53,Carrascosa de Abajo,28,17,11
42,Soria,54,Carrascosa de la Sierra,20,12,8
42,Soria,55,Casarejos,211,109,102
42,Soria,56,Castilfrío de la Sierra,37,21,16
42,Soria,58,Castillejo de Robledo,137,78,59
42,Soria,57,Castilruiz,220,112,108
42,Soria,59,Centenera de Andaluz,24,7,17
42,Soria,60,Cerbón,36,23,13
42,Soria,61,Cidones,357,197,160
42,Soria,62,Cigudosa,43,27,16
42,Soria,63,Cihuela,73,42,31
42,Soria,64,Ciria,99,51,48
42,Soria,65,Cirujales del Río,28,16,12
42,Soria,68,Coscurita,112,65,47
42,Soria,69,Covaleda,1891,976,915
42,Soria,70,Cubilla,53,30,23
42,Soria,71,Cubo de la Solana,210,112,98
42,Soria,73,Cueva de Ágreda,85,48,37
42,Soria,75,Dévanos,103,55,48
42,Soria,76,Deza,277,140,137
42,Soria,78,Duruelo de la Sierra,1322,673,649
42,Soria,79,Escobosa de Almazán,32,20,12
42,Soria,80,Espeja de San Marcelino,194,117,77
42,Soria,81,Espejón,200,105,95
42,Soria,82,Estepa de San Juan,9,6,3
42,Soria,83,Frechilla de Almazán,29,15,14
42,Soria,84,Fresno de Caracena,28,16,12
42,Soria,85,Fuentearmegil,237,132,105
42,Soria,86,Fuentecambrón,44,26,18
42,Soria,87,Fuentecantos,53,26,27
42,Soria,88,Fuentelmonge,81,49,32
42,Soria,89,Fuentelsaz de Soria,61,32,29
42,Soria,90,Fuentepinilla,107,64,43
42,Soria,92,Fuentes de Magaña,101,49,52
42,Soria,93,Fuentestrún,55,34,21
42,Soria,94,Garray,608,332,276
42,Soria,95,Golmayo,2065,1079,986
42,Soria,96,Gómara,397,217,180
42,Soria,97,Gormaz,19,10,9
42,Soria,98,Herrera de Soria,14,10,4
42,Soria,100,Hinojosa del Campo,34,22,12
42,Soria,103,Langa de Duero,823,447,376
42,Soria,105,Liceras,58,29,29
42,Soria,106,Losilla (La),12,8,4
42,Soria,107,Magaña,106,60,46
42,Soria,108,Maján,16,9,7
42,Soria,110,Matalebreras,99,53,46
42,Soria,111,Matamala de Almazán,354,198,156
42,Soria,113,Medinaceli,813,406,407
42,Soria,115,Miño de Medinaceli,100,55,45
42,Soria,116,Miño de San Esteban,72,42,30
42,Soria,117,Molinos de Duero,182,98,84
42,Soria,118,Momblona,28,19,9
42,Soria,119,Monteagudo de las Vicarías,238,118,120
42,Soria,120,Montejo de Tiermes,198,126,72
42,Soria,121,Montenegro de Cameros,92,58,34
42,Soria,123,Morón de Almazán,228,112,116
42,Soria,124,Muriel de la Fuente,80,46,34
42,Soria,125,Muriel Viejo,75,42,33
42,Soria,127,Nafría de Ucero,53,31,22
42,Soria,128,Narros,46,25,21
42,Soria,129,Navaleno,900,466,434
42,Soria,130,Nepas,75,43,32
42,Soria,131,Nolay,68,35,33
42,Soria,132,Noviercas,185,98,87
42,Soria,134,Ólvega,3798,1981,1817
42,Soria,135,Oncala,100,62,38
42,Soria,139,Pinilla del Campo,21,12,9
42,Soria,140,Portillo de Soria,18,12,6
42,Soria,141,Póveda de Soria (La),109,57,52
42,Soria,142,Pozalmuro,99,47,52
42,Soria,144,Quintana Redonda,507,276,231
42,Soria,145,Quintanas de Gormaz,152,87,65
42,Soria,148,Quiñonería,13,6,7
42,Soria,149,Rábanos (Los),520,307,213
42,Soria,151,Rebollar,45,22,23
42,Soria,152,Recuerda,90,50,40
42,Soria,153,Rello,25,14,11
42,Soria,154,Renieblas,114,70,44
42,Soria,155,Retortillo de Soria,205,107,98
42,Soria,156,Reznos,35,23,12
42,Soria,157,Riba de Escalote (La),19,12,7
42,Soria,158,Rioseco de Soria,142,78,64
42,Soria,159,Rollamienta,43,26,17
42,Soria,160,Royo (El),314,163,151
42,Soria,161,Salduero,184,98,86
42,Soria,162,San Esteban de Gormaz,3291,1720,1571
42,Soria,163,San Felices,76,42,34
42,Soria,164,San Leonardo de Yagüe,2293,1185,1108
42,Soria,165,San Pedro Manrique,639,359,280
42,Soria,166,Santa Cruz de Yanguas,68,42,26
42,Soria,167,Santa María de Huerta,378,204,174
42,Soria,168,Santa María de las Hoyas,156,87,69
42,Soria,171,Serón de Nágima,191,111,80
42,Soria,172,Soliedra,36,19,17
42,Soria,173,Soria,39838,19056,20782
42,Soria,174,Sotillo del Rincón,206,105,101
42,Soria,175,Suellacabras,30,19,11
42,Soria,176,Tajahuerce,32,17,15
42,Soria,177,Tajueco,89,48,41
42,Soria,178,Talveila,146,85,61
42,Soria,181,Tardelcuende,512,256,256
42,Soria,182,Taroda,60,30,30
42,Soria,183,Tejado,154,86,68
42,Soria,184,Torlengua,89,46,43
42,Soria,185,Torreblacos,30,16,14
42,Soria,187,Torrubia de Soria,72,45,27
42,Soria,188,Trévago,68,31,37
42,Soria,189,Ucero,100,50,50
42,Soria,190,Vadillo,144,86,58
42,Soria,191,Valdeavellano de Tera,220,116,104
42,Soria,192,Valdegeña,45,30,15
42,Soria,193,Valdelagua del Cerro,16,10,6
42,Soria,194,Valdemaluque,250,123,127
42,Soria,195,Valdenebro,122,69,53
42,Soria,196,Valdeprado,18,11,7
42,Soria,197,Valderrodilla,101,56,45
42,Soria,198,Valtajeros,28,16,12
42,Soria,200,Velamazán,108,67,41
42,Soria,201,Velilla de la Sierra,29,18,11
42,Soria,202,Velilla de los Ajos,34,21,13
42,Soria,204,Viana de Duero,64,44,20
42,Soria,205,Villaciervos,103,62,41
42,Soria,206,Villanueva de Gormaz,10,7,3
42,Soria,207,Villar del Ala,55,26,29
42,Soria,208,Villar del Campo,24,16,8
42,Soria,209,Villar del Río,180,108,72
42,Soria,211,Villares de Soria (Los),103,56,47
42,Soria,212,Villasayas,98,61,37
42,Soria,213,Villaseca de Arciel,38,22,16
42,Soria,215,Vinuesa,1001,553,448
42,Soria,216,Vizmanos,26,16,10
42,Soria,217,Vozmediano,43,27,16
42,Soria,218,Yanguas,128,72,56
42,Soria,219,Yelo,55,31,24
43,Tarragona,1,Aiguamúrcia,914,482,432
43,Tarragona,2,Albinyana,2314,1163,1151
43,Tarragona,3,Albiol (L'),418,214,204
43,Tarragona,4,Alcanar,10545,5429,5116
43,Tarragona,5,Alcover,5143,2618,2525
43,Tarragona,904,Aldea (L'),4376,2319,2057
43,Tarragona,6,Aldover,977,486,491
43,Tarragona,7,Aleixar (L'),911,453,458
43,Tarragona,8,Alfara de Carles,398,209,189
43,Tarragona,9,Alforja,1897,984,913
43,Tarragona,10,Alió,386,195,191
43,Tarragona,11,Almoster,1384,692,692
43,Tarragona,12,Altafulla,4711,2355,2356
43,Tarragona,13,Ametlla de Mar (L'),7594,3868,3726
43,Tarragona,906,Ampolla (L'),3540,1839,1701
43,Tarragona,14,Amposta,21365,10855,10510
43,Tarragona,16,Arboç (L'),5469,2861,2608
43,Tarragona,15,Arbolí,113,62,51
43,Tarragona,17,Argentera (L'),135,77,58
43,Tarragona,18,Arnes,505,266,239
43,Tarragona,19,Ascó,1634,845,789
43,Tarragona,20,Banyeres del Penedès,2952,1534,1418
43,Tarragona,21,Barberà de la Conca,537,294,243
43,Tarragona,22,Batea,2174,1117,1057
43,Tarragona,23,Bellmunt del Priorat,350,175,175
43,Tarragona,24,Bellvei,2110,1101,1009
43,Tarragona,25,Benifallet,788,388,400
43,Tarragona,26,Benissanet,1263,669,594
43,Tarragona,27,Bisbal de Falset (La),237,125,112
43,Tarragona,28,Bisbal del Penedès (La),3343,1729,1614
43,Tarragona,29,Blancafort,433,222,211
43,Tarragona,30,Bonastre,640,337,303
43,Tarragona,31,Borges del Camp (Les),2141,1066,1075
43,Tarragona,32,Bot,683,356,327
43,Tarragona,33,Botarell,1085,580,505
43,Tarragona,34,Bràfim,680,337,343
43,Tarragona,35,Cabacés,347,180,167
43,Tarragona,36,Cabra del Camp,1146,616,530
43,Tarragona,37,Calafell,24423,12358,12065
43,Tarragona,903,Camarles,3617,1854,1763
43,Tarragona,38,Cambrils,32422,16174,16248
43,Tarragona,39,Capafonts,126,67,59
43,Tarragona,40,Capçanes,431,217,214
43,Tarragona,41,Caseres,294,144,150
43,Tarragona,42,Castellvell del Camp,2757,1387,1370
43,Tarragona,43,Catllar (El),4124,2109,2015
43,Tarragona,45,Colldejou,181,99,82
43,Tarragona,46,Conesa,120,64,56
43,Tarragona,47,Constantí,6356,3396,2960
43,Tarragona,48,Corbera d'Ebre,1171,629,542
43,Tarragona,49,Cornudella de Montsant,1028,542,486
43,Tarragona,50,Creixell,3319,1712,1607
43,Tarragona,51,Cunit,12464,6299,6165
43,Tarragona,901,Deltebre,12098,6154,5944
43,Tarragona,53,Duesaigües,240,138,102
43,Tarragona,54,Espluga de Francolí (L'),3949,1944,2005
43,Tarragona,55,Falset,2935,1482,1453
43,Tarragona,56,Fatarella (La),1130,568,562
43,Tarragona,57,Febró (La),42,28,14
43,Tarragona,58,Figuera (La),135,75,60
43,Tarragona,59,Figuerola del Camp,346,167,179
43,Tarragona,60,Flix,4061,2065,1996
43,Tarragona,61,Forès,43,24,19
43,Tarragona,62,Freginals,414,222,192
43,Tarragona,63,Galera (La),897,464,433
43,Tarragona,64,Gandesa,3222,1655,1567
43,Tarragona,65,Garcia,594,294,300
43,Tarragona,66,Garidells (Els),201,103,98
43,Tarragona,67,Ginestar,1022,535,487
43,Tarragona,68,Godall,815,426,389
43,Tarragona,69,Gratallops,263,140,123
43,Tarragona,70,Guiamets (Els),329,156,173
43,Tarragona,71,Horta de Sant Joan,1307,693,614
43,Tarragona,72,Lloar (El),124,71,53
43,Tarragona,73,Llorac,107,58,49
43,Tarragona,74,Llorenç del Penedès,2251,1110,1141
43,Tarragona,76,Marçà,653,334,319
43,Tarragona,75,Margalef,115,60,55
43,Tarragona,77,Mas de Barberans,645,324,321
43,Tarragona,78,Masdenverge,1144,595,549
43,Tarragona,79,Masllorenç,526,278,248
43,Tarragona,80,Masó (La),300,151,149
43,Tarragona,81,Maspujols,710,367,343
43,Tarragona,82,Masroig (El),558,293,265
43,Tarragona,83,Milà (El),180,88,92
43,Tarragona,84,Miravet,798,417,381
43,Tarragona,85,Molar (El),297,165,132
43,Tarragona,86,Montblanc,7382,3735,3647
43,Tarragona,88,Montbrió del Camp,2298,1173,1125
43,Tarragona,89,Montferri,391,205,186
43,Tarragona,90,Montmell (El),1449,791,658
43,Tarragona,91,Mont-ral,172,101,71
43,Tarragona,92,Mont-roig del Camp,12193,6360,5833
43,Tarragona,93,Móra d'Ebre,5795,2866,2929
43,Tarragona,94,Móra la Nova,3238,1657,1581
43,Tarragona,95,Morell (El),3395,1776,1619
43,Tarragona,96,Morera de Montsant (La),160,95,65
43,Tarragona,97,Nou de Gaià (La),510,251,259
43,Tarragona,98,Nulles,451,227,224
43,Tarragona,100,Pallaresos (Els),4126,2126,2000
43,Tarragona,99,Palma d'Ebre (La),425,202,223
43,Tarragona,101,Passanant i Belltall,164,92,72
43,Tarragona,102,Paüls,598,297,301
43,Tarragona,103,Perafort,1218,629,589
43,Tarragona,104,Perelló (El),3303,1771,1532
43,Tarragona,105,Piles (Les),218,115,103
43,Tarragona,106,Pinell de Brai (El),1135,581,554
43,Tarragona,107,Pira,502,258,244
43,Tarragona,108,Pla de Santa Maria (El),2371,1250,1121
43,Tarragona,109,Pobla de Mafumet (La),2628,1344,1284
43,Tarragona,110,Pobla de Massaluca (La),391,203,188
43,Tarragona,111,Pobla de Montornès (La),2888,1532,1356
43,Tarragona,112,Poboleda,382,211,171
43,Tarragona,113,Pont d'Armentera (El),597,318,279
43,Tarragona,141,Pontils,131,72,59
43,Tarragona,114,Porrera,482,257,225
43,Tarragona,115,Pradell de la Teixeta,188,85,103
43,Tarragona,116,Prades,655,340,315
43,Tarragona,117,Prat de Comte,198,107,91
43,Tarragona,118,Pratdip,835,450,385
43,Tarragona,119,Puigpelat,1001,525,476
43,Tarragona,120,Querol,536,291,245
43,Tarragona,121,Rasquera,966,487,479
43,Tarragona,122,Renau,101,53,48
43,Tarragona,123,Reus,106622,52541,54081
43,Tarragona,124,Riba (La),705,376,329
43,Tarragona,125,Riba-roja d'Ebre,1336,713,623
43,Tarragona,126,Riera de Gaià (La),1661,847,814
43,Tarragona,127,Riudecanyes,1118,576,542
43,Tarragona,128,Riudecols,1277,668,609
43,Tarragona,129,Riudoms,6473,3330,3143
43,Tarragona,130,Rocafort de Queralt,258,139,119
43,Tarragona,131,Roda de Barà,6232,3261,2971
43,Tarragona,132,Rodonyà,527,288,239
43,Tarragona,133,Roquetes,8231,4345,3886
43,Tarragona,134,Rourell (El),384,198,186
43,Tarragona,135,Salomó,505,269,236
43,Tarragona,905,Salou,27016,14534,12482
43,Tarragona,136,Sant Carles de la Ràpita,15583,7732,7851
43,Tarragona,137,Sant Jaume dels Domenys,2450,1267,1183
43,Tarragona,902,Sant Jaume d'Enveja,3538,1797,1741
43,Tarragona,138,Santa Bàrbara,3965,2040,1925
43,Tarragona,139,Santa Coloma de Queralt,3153,1595,1558
43,Tarragona,140,Santa Oliva,3327,1730,1597
43,Tarragona,142,Sarral,1720,886,834
43,Tarragona,143,Savallà del Comtat,71,35,36
43,Tarragona,144,Secuita (La),1547,790,757
43,Tarragona,145,Selva del Camp (La),5477,2775,2702
43,Tarragona,146,Senan,56,34,22
43,Tarragona,44,Sénia (La),6087,3118,2969
43,Tarragona,147,Solivella,678,342,336
43,Tarragona,148,Tarragona,140184,69235,70949
43,Tarragona,149,Tivenys,925,473,452
43,Tarragona,150,Tivissa,1812,925,887
43,Tarragona,151,Torre de Fontaubella (La),147,74,73
43,Tarragona,152,Torre de l'Espanyol (La),679,350,329
43,Tarragona,153,Torredembarra,15406,7692,7714
43,Tarragona,154,Torroja del Priorat,165,93,72
43,Tarragona,155,Tortosa,34473,17344,17129
43,Tarragona,156,Ulldecona,7335,3788,3547
43,Tarragona,157,Ulldemolins,470,265,205
43,Tarragona,158,Vallclara,117,66,51
43,Tarragona,159,Vallfogona de Riucorb,114,66,48
43,Tarragona,160,Vallmoll,1637,853,784
43,Tarragona,161,Valls,25158,12693,12465
43,Tarragona,162,Vandellòs i l'Hospitalet de l'Infant,5839,2891,2948
43,Tarragona,163,Vendrell (El),36068,18116,17952
43,Tarragona,164,Vespella de Gaià,418,236,182
43,Tarragona,165,Vilabella,824,426,398
43,Tarragona,175,Vilalba dels Arcs,721,379,342
43,Tarragona,166,Vilallonga del Camp,2000,1023,977
43,Tarragona,168,Vilanova de Prades,143,74,69
43,Tarragona,167,Vilanova d'Escornalbou,573,322,251
43,Tarragona,169,Vilaplana,631,317,314
43,Tarragona,170,Vila-rodona,1276,661,615
43,Tarragona,171,Vila-seca,21373,10965,10408
43,Tarragona,172,Vilaverd,503,245,258
43,Tarragona,173,Vilella Alta (La),136,71,65
43,Tarragona,174,Vilella Baixa (La),213,115,98
43,Tarragona,176,Vimbodí i Poblet,1038,584,454
43,Tarragona,177,Vinebre,459,233,226
43,Tarragona,178,Vinyols i els Arcs,1887,971,916
43,Tarragona,52,Xerta,1304,643,661
44,Teruel,1,Ababuj,77,49,28
44,Teruel,2,Abejuela,56,34,22
44,Teruel,3,Aguatón,21,10,11
44,Teruel,4,Aguaviva,693,356,337
44,Teruel,5,Aguilar del Alfambra,67,39,28
44,Teruel,6,Alacón,361,190,171
44,Teruel,7,Alba,248,124,124
44,Teruel,8,Albalate del Arzobispo,2155,1099,1056
44,Teruel,9,Albarracín,1096,552,544
44,Teruel,10,Albentosa,310,164,146
44,Teruel,11,Alcaine,69,39,30
44,Teruel,12,Alcalá de la Selva,513,273,240
44,Teruel,13,Alcañiz,16291,8198,8093
44,Teruel,14,Alcorisa,3642,1872,1770
44,Teruel,16,Alfambra,676,362,314
44,Teruel,17,Aliaga,381,209,172
44,Teruel,21,Allepuz,133,66,67
44,Teruel,22,Alloza,711,368,343
44,Teruel,23,Allueva,15,10,5
44,Teruel,18,Almohaja,29,21,8
44,Teruel,19,Alobras,70,41,29
44,Teruel,20,Alpeñés,27,18,9
44,Teruel,24,Anadón,21,11,10
44,Teruel,25,Andorra,8367,4326,4041
44,Teruel,26,Arcos de las Salinas,111,57,54
44,Teruel,27,Arens de Lledó,213,98,115
44,Teruel,28,Argente,232,109,123
44,Teruel,29,Ariño,925,478,447
44,Teruel,31,Azaila,139,78,61
44,Teruel,32,Bádenas,22,13,9
44,Teruel,33,Báguena,398,218,180
44,Teruel,34,Bañón,167,91,76
44,Teruel,35,Barrachina,167,90,77
44,Teruel,36,Bea,37,23,14
44,Teruel,37,Beceite,608,318,290
44,Teruel,39,Bello,284,133,151
44,Teruel,38,Belmonte de San José,137,66,71
44,Teruel,40,Berge,274,138,136
44,Teruel,41,Bezas,79,43,36
44,Teruel,42,Blancas,166,98,68
44,Teruel,43,Blesa,121,74,47
44,Teruel,44,Bordón,141,79,62
44,Teruel,45,Bronchales,480,274,206
44,Teruel,46,Bueña,67,35,32
44,Teruel,47,Burbáguena,296,139,157
44,Teruel,48,Cabra de Mora,88,52,36
44,Teruel,49,Calaceite,1145,604,541
44,Teruel,50,Calamocha,4649,2356,2293
44,Teruel,51,Calanda,4004,1994,2010
44,Teruel,52,Calomarde,84,50,34
44,Teruel,53,Camañas,125,67,58
44,Teruel,54,Camarena de la Sierra,165,93,72
44,Teruel,55,Camarillas,119,75,44
44,Teruel,56,Caminreal,758,404,354
44,Teruel,59,Cantavieja,748,396,352
44,Teruel,60,Cañada de Benatanduz,42,27,15
44,Teruel,61,Cañada de Verich (La),111,60,51
44,Teruel,62,Cañada Vellida,42,30,12
44,Teruel,63,Cañizar del Olivar,109,64,45
44,Teruel,64,Cascante del Río,79,46,33
44,Teruel,65,Castejón de Tornos,70,39,31
44,Teruel,66,Castel de Cabra,140,74,66
44,Teruel,70,Castellar (El),68,42,26
44,Teruel,71,Castellote,804,420,384
44,Teruel,67,Castelnou,120,62,58
44,Teruel,68,Castelserás,831,435,396
44,Teruel,74,Cedrillas,623,323,300
44,Teruel,75,Celadas,440,238,202
44,Teruel,76,Cella,2951,1559,1392
44,Teruel,77,Cerollera (La),113,67,46
44,Teruel,80,Codoñera (La),397,211,186
44,Teruel,82,Corbalán,99,54,45
44,Teruel,84,Cortes de Aragón,75,36,39
44,Teruel,85,Cosa,64,38,26
44,Teruel,86,Cretas,618,318,300
44,Teruel,87,Crivillén,93,49,44
44,Teruel,88,Cuba (La),52,27,25
44,Teruel,89,Cubla,61,35,26
44,Teruel,90,Cucalón,102,61,41
44,Teruel,92,Cuervo (El),107,57,50
44,Teruel,93,Cuevas de Almudén,133,80,53
44,Teruel,94,Cuevas Labradas,141,72,69
44,Teruel,96,Ejulve,198,96,102
44,Teruel,97,Escorihuela,185,93,92
44,Teruel,99,Escucha,1015,579,436
44,Teruel,100,Estercuel,271,147,124
44,Teruel,101,Ferreruela de Huerva,74,39,35
44,Teruel,102,Fonfría,30,18,12
44,Teruel,103,Formiche Alto,190,103,87
44,Teruel,105,Fórnoles,103,52,51
44,Teruel,106,Fortanete,224,134,90
44,Teruel,107,Foz-Calanda,296,163,133
44,Teruel,108,Fresneda (La),511,282,229
44,Teruel,109,Frías de Albarracín,156,86,70
44,Teruel,110,Fuenferrada,37,19,18
44,Teruel,111,Fuentes Calientes,119,66,53
44,Teruel,112,Fuentes Claras,590,312,278
44,Teruel,113,Fuentes de Rubielos,127,67,60
44,Teruel,114,Fuentespalda,341,176,165
44,Teruel,115,Galve,154,85,69
44,Teruel,116,Gargallo,118,65,53
44,Teruel,117,Gea de Albarracín,430,222,208
44,Teruel,118,Ginebrosa (La),229,130,99
44,Teruel,119,Griegos,134,82,52
44,Teruel,120,Guadalaviar,243,130,113
44,Teruel,121,Gúdar,84,49,35
44,Teruel,122,Híjar,1899,970,929
44,Teruel,123,Hinojosa de Jarque,151,83,68
44,Teruel,124,Hoz de la Vieja (La),88,47,41
44,Teruel,125,Huesa del Común,90,58,32
44,Teruel,126,Iglesuela del Cid (La),505,270,235
44,Teruel,127,Jabaloyas,81,47,34
44,Teruel,128,Jarque de la Val,90,50,40
44,Teruel,129,Jatiel,52,27,25
44,Teruel,130,Jorcas,43,26,17
44,Teruel,131,Josa,34,19,15
44,Teruel,132,Lagueruela,62,31,31
44,Teruel,133,Lanzuela,25,16,9
44,Teruel,135,Libros,153,85,68
44,Teruel,136,Lidón,57,28,29
44,Teruel,137,Linares de Mora,313,186,127
44,Teruel,141,Lledó,170,92,78
44,Teruel,138,Loscos,177,102,75
44,Teruel,142,Maicas,42,22,20
44,Teruel,143,Manzanera,551,304,247
44,Teruel,144,Martín del Río,469,248,221
44,Teruel,145,Mas de las Matas,1415,731,684
44,Teruel,146,Mata de los Olmos (La),289,148,141
44,Teruel,147,Mazaleón,586,316,270
44,Teruel,148,Mezquita de Jarque,120,70,50
44,Teruel,149,Mirambel,125,69,56
44,Teruel,150,Miravete de la Sierra,38,22,16
44,Teruel,151,Molinos,303,169,134
44,Teruel,152,Monforte de Moyuela,69,46,23
44,Teruel,153,Monreal del Campo,2765,1377,1388
44,Teruel,154,Monroyo,379,230,149
44,Teruel,155,Montalbán,1408,731,677
44,Teruel,156,Monteagudo del Castillo,71,43,28
44,Teruel,157,Monterde de Albarracín,69,40,29
44,Teruel,158,Mora de Rubielos,1706,877,829
44,Teruel,159,Moscardón,71,35,36
44,Teruel,160,Mosqueruela,608,323,285
44,Teruel,161,Muniesa,669,348,321
44,Teruel,163,Noguera de Albarracín,134,67,67
44,Teruel,164,Nogueras,35,28,7
44,Teruel,165,Nogueruelas,237,132,105
44,Teruel,167,Obón,36,20,16
44,Teruel,168,Odón,220,105,115
44,Teruel,169,Ojos Negros,489,265,224
44,Teruel,171,Olba,237,129,108
44,Teruel,172,Oliete,479,254,225
44,Teruel,173,Olmos (Los),128,68,60
44,Teruel,174,Orihuela del Tremedal,564,296,268
44,Teruel,175,Orrios,159,83,76
44,Teruel,176,Palomar de Arroyos,198,113,85
44,Teruel,177,Pancrudo,136,82,54
44,Teruel,178,Parras de Castellote (Las),73,36,37
44,Teruel,179,Peñarroya de Tastavins,517,277,240
44,Teruel,180,Peracense,89,52,37
44,Teruel,181,Peralejos,78,39,39
44,Teruel,182,Perales del Alfambra,279,148,131
44,Teruel,183,Pitarque,96,43,53
44,Teruel,184,Plou,43,28,15
44,Teruel,185,Pobo (El),139,86,53
44,Teruel,187,Portellada (La),262,135,127
44,Teruel,189,Pozondón,83,40,43
44,Teruel,190,Pozuel del Campo,100,50,50
44,Teruel,191,Puebla de Híjar (La),1006,517,489
44,Teruel,192,Puebla de Valverde (La),571,322,249
44,Teruel,193,Puertomingalvo,207,124,83
44,Teruel,194,Ráfales,170,88,82
44,Teruel,195,Rillo,113,61,52
44,Teruel,196,Riodeva,180,86,94
44,Teruel,197,Ródenas,79,45,34
44,Teruel,198,Royuela,248,133,115
44,Teruel,199,Rubiales,57,35,22
44,Teruel,200,Rubielos de la Cérida,45,23,22
44,Teruel,201,Rubielos de Mora,772,390,382
44,Teruel,203,Salcedillo,8,6,2
44,Teruel,204,Saldón,29,21,8
44,Teruel,205,Samper de Calanda,925,465,460
44,Teruel,206,San Agustín,150,95,55
44,Teruel,207,San Martín del Río,199,102,97
44,Teruel,208,Santa Cruz de Nogueras,36,21,15
44,Teruel,209,Santa Eulalia,1152,568,584
44,Teruel,210,Sarrión,1140,630,510
44,Teruel,211,Segura de los Baños,40,27,13
44,Teruel,212,Seno,49,26,23
44,Teruel,213,Singra,98,54,44
44,Teruel,215,Terriente,186,107,79
44,Teruel,216,Teruel,35241,17133,18108
44,Teruel,217,Toril y Masegoso,34,24,10
44,Teruel,218,Tormón,32,17,15
44,Teruel,219,Tornos,232,126,106
44,Teruel,220,Torralba de los Sisones,216,120,96
44,Teruel,223,Torre de Arcas,96,49,47
44,Teruel,224,Torre de las Arcas,37,18,19
44,Teruel,225,Torre del Compte,153,83,70
44,Teruel,227,Torre los Negros,105,54,51
44,Teruel,221,Torrecilla de Alcañiz,440,233,207
44,Teruel,222,Torrecilla del Rebollar,151,82,69
44,Teruel,226,Torrelacárcel,223,118,105
44,Teruel,228,Torremocha de Jiloca,148,83,65
44,Teruel,229,Torres de Albarracín,175,98,77
44,Teruel,230,Torrevelilla,214,109,105
44,Teruel,231,Torrijas,66,29,37
44,Teruel,232,Torrijo del Campo,539,288,251
44,Teruel,234,Tramacastiel,98,56,42
44,Teruel,235,Tramacastilla,107,53,54
44,Teruel,236,Tronchón,106,58,48
44,Teruel,237,Urrea de Gaén,525,265,260
44,Teruel,238,Utrillas,3309,1706,1603
44,Teruel,239,Valacloche,30,16,14
44,Teruel,240,Valbona,224,123,101
44,Teruel,241,Valdealgorfa,685,332,353
44,Teruel,243,Valdecuenca,56,39,17
44,Teruel,244,Valdelinares,116,67,49
44,Teruel,245,Valdeltormo,328,169,159
44,Teruel,246,Valderrobres,2290,1196,1094
44,Teruel,247,Valjunquera,403,209,194
44,Teruel,249,Vallecillo (El),47,29,18
44,Teruel,250,Veguillas de la Sierra,28,17,11
44,Teruel,251,Villafranca del Campo,352,181,171
44,Teruel,252,Villahermosa del Campo,99,59,40
44,Teruel,256,Villanueva del Rebollar de la Sierra,53,30,23
44,Teruel,257,Villar del Cobo,208,114,94
44,Teruel,258,Villar del Salz,83,48,35
44,Teruel,260,Villarluengo,188,110,78
44,Teruel,261,Villarquemado,940,496,444
44,Teruel,262,Villarroya de los Pinares,177,98,79
44,Teruel,263,Villastar,450,232,218
44,Teruel,264,Villel,366,207,159
44,Teruel,265,Vinaceite,314,168,146
44,Teruel,266,Visiedo,149,65,84
44,Teruel,267,Vivel del Río Martín,86,46,40
44,Teruel,268,Zoma (La),22,9,13
45,Toledo,1,Ajofrín,2292,1182,1110
45,Toledo,2,Alameda de la Sagra,3405,1797,1608
45,Toledo,3,Albarreal de Tajo,725,378,347
45,Toledo,4,Alcabón,747,382,365
45,Toledo,5,Alcañizo,343,183,160
45,Toledo,6,Alcaudete de la Jara,2092,1048,1044
45,Toledo,7,Alcolea de Tajo,873,445,428
45,Toledo,8,Aldea en Cabo,213,118,95
45,Toledo,9,Aldeanueva de Barbarroya,664,328,336
45,Toledo,10,Aldeanueva de San Bartolomé,510,251,259
45,Toledo,11,Almendral de la Cañada,371,201,170
45,Toledo,12,Almonacid de Toledo,905,477,428
45,Toledo,13,Almorox,2458,1298,1160
45,Toledo,14,Añover de Tajo,5392,2813,2579
45,Toledo,15,Arcicóllar,779,388,391
45,Toledo,16,Argés,5511,2796,2715
45,Toledo,17,Azután,300,149,151
45,Toledo,18,Barcience,616,323,293
45,Toledo,19,Bargas,9332,4720,4612
45,Toledo,20,Belvís de la Jara,1823,916,907
45,Toledo,21,Borox,3307,1704,1603
45,Toledo,22,Buenaventura,483,256,227
45,Toledo,23,Burguillos de Toledo,2644,1348,1296
45,Toledo,24,Burujón,1422,743,679
45,Toledo,25,Cabañas de la Sagra,1949,1040,909
45,Toledo,26,Cabañas de Yepes,300,156,144
45,Toledo,27,Cabezamesada,493,269,224
45,Toledo,28,Calera y Chozas,4595,2360,2235
45,Toledo,29,Caleruela,274,148,126
45,Toledo,30,Calzada de Oropesa,580,312,268
45,Toledo,31,Camarena,3704,1930,1774
45,Toledo,32,Camarenilla,628,340,288
45,Toledo,33,Campillo de la Jara (El),422,225,197
45,Toledo,34,Camuñas,1917,986,931
45,Toledo,35,Cardiel de los Montes,375,199,176
45,Toledo,36,Carmena,864,455,409
45,Toledo,37,Carpio de Tajo (El),2184,1097,1087
45,Toledo,38,Carranque,4067,2094,1973
45,Toledo,39,Carriches,313,161,152
45,Toledo,40,Casar de Escalona (El),2225,1195,1030
45,Toledo,41,Casarrubios del Monte,5193,2737,2456
45,Toledo,42,Casasbuenas,224,110,114
45,Toledo,43,Castillo de Bayuela,1009,516,493
45,Toledo,45,Cazalegas,1818,932,886
45,Toledo,46,Cebolla,3834,1964,1870
45,Toledo,47,Cedillo del Condado,3097,1613,1484
45,Toledo,48,Cerralbos (Los),488,260,228
45,Toledo,49,Cervera de los Montes,440,227,213
45,Toledo,56,Chozas de Canales,3858,2074,1784
45,Toledo,57,Chueca,250,138,112
45,Toledo,50,Ciruelos,679,361,318
45,Toledo,51,Cobeja,2444,1284,1160
45,Toledo,52,Cobisa,3961,2040,1921
45,Toledo,53,Consuegra,10945,5557,5388
45,Toledo,54,Corral de Almaguer,6300,3236,3064
45,Toledo,55,Cuerva,1564,822,742
45,Toledo,58,Domingo Pérez,525,268,257
45,Toledo,59,Dosbarrios,2404,1205,1199
45,Toledo,60,Erustes,259,129,130
45,Toledo,61,Escalona,3523,1833,1690
45,Toledo,62,Escalonilla,1576,790,786
45,Toledo,63,Espinoso del Rey,579,309,270
45,Toledo,64,Esquivias,5376,2699,2677
45,Toledo,65,Estrella (La),325,160,165
45,Toledo,66,Fuensalida,11042,5679,5363
45,Toledo,67,Gálvez,3442,1764,1678
45,Toledo,68,Garciotum,169,85,84
45,Toledo,69,Gerindote,2441,1259,1182
45,Toledo,70,Guadamur,1847,936,911
45,Toledo,71,Guardia (La),2472,1241,1231
45,Toledo,72,Herencias (Las),816,421,395
45,Toledo,73,Herreruela de Oropesa,451,223,228
45,Toledo,74,Hinojosa de San Vicente,461,251,210
45,Toledo,75,Hontanar,171,90,81
45,Toledo,76,Hormigos,792,445,347
45,Toledo,77,Huecas,617,313,304
45,Toledo,78,Huerta de Valdecarábanos,1963,972,991
45,Toledo,79,Iglesuela (La),422,219,203
45,Toledo,80,Illán de Vacas,5,3,2
45,Toledo,81,Illescas,22482,11498,10984
45,Toledo,82,Lagartera,1595,797,798
45,Toledo,83,Layos,526,259,267
45,Toledo,84,Lillo,3043,1585,1458
45,Toledo,85,Lominchar,2057,1086,971
45,Toledo,86,Lucillos,658,332,326
45,Toledo,87,Madridejos,11314,5707,5607
45,Toledo,88,Magán,2982,1573,1409
45,Toledo,89,Malpica de Tajo,2120,1075,1045
45,Toledo,90,Manzaneque,465,231,234
45,Toledo,91,Maqueda,541,285,256
45,Toledo,92,Marjaliza,314,161,153
45,Toledo,93,Marrupe,170,85,85
45,Toledo,94,Mascaraque,519,258,261
45,Toledo,95,Mata (La),1023,535,488
45,Toledo,96,Mazarambroz,1345,691,654
45,Toledo,97,Mejorada,1329,688,641
45,Toledo,98,Menasalbas,3296,1768,1528
45,Toledo,99,Méntrida,4780,2472,2308
45,Toledo,100,Mesegar de Tajo,243,127,116
45,Toledo,101,Miguel Esteban,5582,2825,2757
45,Toledo,102,Mocejón,4895,2541,2354
45,Toledo,103,Mohedas de la Jara,499,271,228
45,Toledo,104,Montearagón,579,293,286
45,Toledo,105,Montesclaros,447,237,210
45,Toledo,106,Mora,10516,5350,5166
45,Toledo,107,Nambroca,3838,1977,1861
45,Toledo,108,Nava de Ricomalillo (La),650,329,321
45,Toledo,109,Navahermosa,4289,2247,2042
45,Toledo,110,Navalcán,2391,1256,1135
45,Toledo,111,Navalmoralejo,73,37,36
45,Toledo,112,Navalmorales (Los),2728,1429,1299
45,Toledo,113,Navalucillos (Los),2641,1364,1277
45,Toledo,114,Navamorcuende,676,350,326
45,Toledo,115,Noblejas,3556,1850,1706
45,Toledo,116,Noez,967,506,461
45,Toledo,117,Nombela,1057,545,512
45,Toledo,118,Novés,2807,1475,1332
45,Toledo,119,Numancia de la Sagra,4727,2493,2234
45,Toledo,120,Nuño Gómez,178,99,79
45,Toledo,121,Ocaña,10098,5126,4972
45,Toledo,122,Olías del Rey,6867,3538,3329
45,Toledo,123,Ontígola,3874,2118,1756
45,Toledo,124,Orgaz,2827,1415,1412
45,Toledo,125,Oropesa,2942,1447,1495
45,Toledo,126,Otero,364,169,195
45,Toledo,127,Palomeque,922,503,419
45,Toledo,128,Pantoja,3388,1700,1688
45,Toledo,129,Paredes de Escalona,158,71,87
45,Toledo,130,Parrillas,424,209,215
45,Toledo,131,Pelahustán,384,206,178
45,Toledo,132,Pepino,2429,1265,1164
45,Toledo,133,Polán,4066,2081,1985
45,Toledo,134,Portillo de Toledo,2244,1156,1088
45,Toledo,135,Puebla de Almoradiel (La),6122,3135,2987
45,Toledo,136,Puebla de Montalbán (La),8472,4319,4153
45,Toledo,137,Pueblanueva (La),2350,1203,1147
45,Toledo,138,Puente del Arzobispo (El),1436,702,734
45,Toledo,139,Puerto de San Vicente,232,120,112
45,Toledo,140,Pulgar,1669,880,789
45,Toledo,141,Quero,1329,680,649
45,Toledo,142,Quintanar de la Orden,12873,6653,6220
45,Toledo,143,Quismondo,1675,855,820
45,Toledo,144,Real de San Vicente (El),1089,592,497
45,Toledo,145,Recas,3912,2222,1690
45,Toledo,146,Retamoso de la Jara,126,63,63
45,Toledo,147,Rielves,757,373,384
45,Toledo,148,Robledo del Mazo,371,205,166
45,Toledo,149,Romeral (El),771,379,392
45,Toledo,150,San Bartolomé de las Abiertas,588,322,266
45,Toledo,151,San Martín de Montalbán,802,391,411
45,Toledo,152,San Martín de Pusa,850,444,406
45,Toledo,153,San Pablo de los Montes,2184,1108,1076
45,Toledo,154,San Román de los Montes,1782,966,816
45,Toledo,155,Santa Ana de Pusa,473,262,211
45,Toledo,156,Santa Cruz de la Zarza,4940,2530,2410
45,Toledo,157,Santa Cruz del Retamar,2998,1545,1453
45,Toledo,158,Santa Olalla,3522,1816,1706
45,Toledo,901,Santo Domingo-Caudilla,1058,535,523
45,Toledo,159,Sartajada,109,62,47
45,Toledo,160,Segurilla,1263,641,622
45,Toledo,161,Seseña,17522,9129,8393
45,Toledo,162,Sevilleja de la Jara,879,467,412
45,Toledo,163,Sonseca,11331,5758,5573
45,Toledo,164,Sotillo de las Palomas,214,107,107
45,Toledo,165,Talavera de la Reina,88986,43561,45425
45,Toledo,166,Tembleque,2390,1234,1156
45,Toledo,167,Toboso (El),2217,1108,1109
45,Toledo,168,Toledo,82489,39558,42931
45,Toledo,169,Torralba de Oropesa,272,140,132
45,Toledo,171,Torre de Esteban Hambrán (La),1793,946,847
45,Toledo,170,Torrecilla de la Jara,302,152,150
45,Toledo,172,Torrico,850,447,403
45,Toledo,173,Torrijos,13374,6697,6677
45,Toledo,174,Totanés,421,215,206
45,Toledo,175,Turleque,929,461,468
45,Toledo,176,Ugena,5120,2700,2420
45,Toledo,177,Urda,3073,1532,1541
45,Toledo,179,Valdeverdeja,722,341,381
45,Toledo,180,Valmojado,4026,2104,1922
45,Toledo,181,Velada,2827,1484,1343
45,Toledo,182,Ventas con Peña Aguilera (Las),1364,691,673
45,Toledo,183,Ventas de Retamosa (Las),3104,1615,1489
45,Toledo,184,Ventas de San Julián (Las),233,110,123
45,Toledo,186,Villa de Don Fadrique (La),4170,2066,2104
45,Toledo,185,Villacañas,10602,5322,5280
45,Toledo,187,Villafranca de los Caballeros,5438,2726,2712
45,Toledo,188,Villaluenga de la Sagra,3950,1999,1951
45,Toledo,189,Villamiel de Toledo,906,469,437
45,Toledo,190,Villaminaya,597,297,300
45,Toledo,191,Villamuelas,731,367,364
45,Toledo,192,Villanueva de Alcardete,3792,1969,1823
45,Toledo,193,Villanueva de Bogas,791,405,386
45,Toledo,194,Villarejo de Montalbán,66,35,31
45,Toledo,195,Villarrubia de Santiago,2875,1460,1415
45,Toledo,196,Villaseca de la Sagra,1807,928,879
45,Toledo,197,Villasequilla,2653,1381,1272
45,Toledo,198,Villatobas,2675,1370,1305
45,Toledo,199,Viso de San Juan (El),3558,1932,1626
45,Toledo,200,Yébenes (Los),6451,3295,3156
45,Toledo,201,Yeles,4841,2598,2243
45,Toledo,202,Yepes,5212,2676,2536
45,Toledo,203,Yuncler,3376,1731,1645
45,Toledo,204,Yunclillos,813,424,389
45,Toledo,205,Yuncos,9700,5024,4676
46,Valencia/València,1,Ademuz,1285,689,596
46,Valencia/València,2,Ador,1510,788,722
46,Valencia/València,4,Agullent,2463,1213,1250
46,Valencia/València,42,Aielo de Malferit,4726,2364,2362
46,Valencia/València,43,Aielo de Rugat,183,100,83
46,Valencia/València,5,Alaquàs,30270,15006,15264
46,Valencia/València,6,Albaida,6335,3142,3193
46,Valencia/València,7,Albal,15618,7876,7742
46,Valencia/València,8,Albalat de la Ribera,3585,1807,1778
46,Valencia/València,9,Albalat dels Sorells,3856,1879,1977
46,Valencia/València,10,Albalat dels Tarongers,1137,597,540
46,Valencia/València,11,Alberic,11325,5720,5605
46,Valencia/València,12,Alborache,1226,638,588
46,Valencia/València,13,Alboraya,22409,11154,11255
46,Valencia/València,14,Albuixech,3960,1964,1996
46,Valencia/València,16,Alcàntera de Xúquer,1432,705,727
46,Valencia/València,15,Alcàsser,9309,4726,4583
46,Valencia/València,18,Alcublas,778,404,374
46,Valencia/València,19,Alcúdia (l'),11246,5520,5726
46,Valencia/València,20,Alcúdia de Crespins (l'),5318,2718,2600
46,Valencia/València,21,Aldaia,30303,15192,15111
46,Valencia/València,22,Alfafar,20730,10280,10450
46,Valencia/València,24,Alfara de Algimia,547,271,276
46,Valencia/València,25,Alfara del Patriarca,3107,1552,1555
46,Valencia/València,26,Alfarp,1534,793,741
46,Valencia/València,27,Alfarrasí,1298,632,666
46,Valencia/València,23,Alfauir,448,237,211
46,Valencia/València,28,Algar de Palancia,570,287,283
46,Valencia/València,29,Algemesí,28329,14066,14263
46,Valencia/València,30,Algimia de Alfara,1028,510,518
46,Valencia/València,31,Alginet,13363,6762,6601
46,Valencia/València,32,Almàssera,7199,3478,3721
46,Valencia/València,33,Almiserà,307,157,150
46,Valencia/València,34,Almoines,2451,1270,1181
46,Valencia/València,35,Almussafes,8358,4179,4179
46,Valencia/València,36,Alpuente,781,421,360
46,Valencia/València,37,Alqueria de la Comtessa (l'),1540,765,775
46,Valencia/València,17,Alzira,44758,21882,22876
46,Valencia/València,38,Andilla,300,175,125
46,Valencia/València,39,Anna,2758,1381,1377
46,Valencia/València,40,Antella,1454,724,730
46,Valencia/València,41,Aras de los Olmos,439,248,191
46,Valencia/València,3,Atzeneta d'Albaida,1260,664,596
46,Valencia/València,44,Ayora,5469,2787,2682
46,Valencia/València,46,Barx,1445,728,717
46,Valencia/València,45,Barxeta,1662,853,809
46,Valencia/València,47,Bèlgida,728,366,362
46,Valencia/València,48,Bellreguard,4818,2407,2411
46,Valencia/València,49,Bellús,373,183,190
46,Valencia/València,50,Benagéber,152,84,68
46,Valencia/València,51,Benaguasil,11144,5739,5405
46,Valencia/València,52,Benavites,648,315,333
46,Valencia/València,53,Beneixida,726,342,384
46,Valencia/València,54,Benetússer,15399,7721,7678
46,Valencia/València,55,Beniarjó,1791,871,920
46,Valencia/València,56,Beniatjar,273,143,130
46,Valencia/València,57,Benicolet,647,340,307
46,Valencia/València,904,Benicull de Xúquer,1018,518,500
46,Valencia/València,60,Benifaió,12220,6035,6185
46,Valencia/València,59,Benifairó de la Valldigna,1679,835,844
46,Valencia/València,58,Benifairó de les Valls,2162,1083,1079
46,Valencia/València,61,Beniflá,421,214,207
46,Valencia/València,62,Benigánim,6570,3383,3187
46,Valencia/València,63,Benimodo,2272,1164,1108
46,Valencia/València,64,Benimuslem,645,330,315
46,Valencia/València,65,Beniparrell,1950,1002,948
46,Valencia/València,66,Benirredrà,1645,811,834
46,Valencia/València,67,Benisanó,2266,1138,1128
46,Valencia/València,68,Benissoda,378,217,161
46,Valencia/València,69,Benisuera,200,105,95
46,Valencia/València,70,Bétera,21220,10564,10656
46,Valencia/València,71,Bicorp,590,302,288
46,Valencia/València,72,Bocairent,4509,2264,2245
46,Valencia/València,73,Bolbaite,1469,762,707
46,Valencia/València,74,Bonrepòs i Mirambell,3434,1681,1753
46,Valencia/València,75,Bufali,194,104,90
46,Valencia/València,76,Bugarra,850,440,410
46,Valencia/València,77,Buñol,10077,5079,4998
46,Valencia/València,78,Burjassot,38170,18628,19542
46,Valencia/València,79,Calles,464,257,207
46,Valencia/València,80,Camporrobles,1487,766,721
46,Valencia/València,81,Canals,14079,7132,6947
46,Valencia/València,82,Canet d'En Berenguer,5598,2864,2734
46,Valencia/València,83,Carcaixent,20935,10359,10576
46,Valencia/València,84,Càrcer,2062,1000,1062
46,Valencia/València,85,Carlet,15606,7878,7728
46,Valencia/València,86,Carrícola,93,46,47
46,Valencia/València,87,Casas Altas,180,101,79
46,Valencia/València,88,Casas Bajas,234,125,109
46,Valencia/València,89,Casinos,2593,1321,1272
46,Valencia/València,90,Castelló de Rugat,2423,1225,1198
46,Valencia/València,91,Castellonet de la Conquesta,165,91,74
46,Valencia/València,92,Castielfabib,374,180,194
46,Valencia/València,93,Catadau,2712,1359,1353
46,Valencia/València,94,Catarroja,27175,13502,13673
46,Valencia/València,95,Caudete de las Fuentes,760,407,353
46,Valencia/València,96,Cerdà,371,192,179
46,Valencia/València,107,Chella,2820,1402,1418
46,Valencia/València,106,Chelva,1734,899,835
46,Valencia/València,108,Chera,574,310,264
46,Valencia/València,109,Cheste,8367,4311,4056
46,Valencia/València,111,Chiva,14539,7517,7022
46,Valencia/València,112,Chulilla,775,407,368
46,Valencia/València,97,Cofrentes,956,469,487
46,Valencia/València,98,Corbera,3330,1660,1670
46,Valencia/València,99,Cortes de Pallás,951,495,456
46,Valencia/València,100,Cotes,398,214,184
46,Valencia/València,105,Cullera,23813,12090,11723
46,Valencia/València,113,Daimús,3171,1603,1568
46,Valencia/València,114,Domeño,731,383,348
46,Valencia/València,115,Dos Aguas,414,234,180
46,Valencia/València,116,Eliana (l'),16738,8316,8422
46,Valencia/València,117,Emperador,615,317,298
46,Valencia/València,118,Enguera,5900,3051,2849
46,Valencia/València,119,Ènova (l'),991,500,491
46,Valencia/València,120,Estivella,1364,664,700
46,Valencia/València,121,Estubeny,133,70,63
46,Valencia/València,122,Faura,3578,1813,1765
46,Valencia/València,123,Favara,2373,1191,1182
46,Valencia/València,126,Foios,6781,3327,3454
46,Valencia/València,128,Font de la Figuera (la),2227,1132,1095
46,Valencia/València,127,Font d'En Carròs (la),4196,2126,2070
46,Valencia/València,124,Fontanars dels Alforins,1038,521,517
46,Valencia/València,125,Fortaleny,1026,504,522
46,Valencia/València,129,Fuenterrobles,733,386,347
46,Valencia/València,131,Gandia,79430,39983,39447
46,Valencia/València,902,Gátova,472,224,248
46,Valencia/València,130,Gavarda,1154,572,582
46,Valencia/València,132,Genovés,2796,1419,1377
46,Valencia/València,133,Gestalgar,675,349,326
46,Valencia/València,134,Gilet,3103,1617,1486
46,Valencia/València,135,Godella,13288,6417,6871
46,Valencia/València,136,Godelleta,3389,1737,1652
46,Valencia/València,137,Granja de la Costera (la),326,162,164
46,Valencia/València,138,Guadasequies,440,225,215
46,Valencia/València,139,Guadassuar,6067,3011,3056
46,Valencia/València,140,Guardamar de la Safor,442,240,202
46,Valencia/València,141,Higueruelas,506,261,245
46,Valencia/València,142,Jalance,995,496,499
46,Valencia/València,144,Jarafuel,828,434,394
46,Valencia/València,154,Llanera de Ranes,1119,583,536
46,Valencia/València,155,Llaurí,1332,681,651
46,Valencia/València,147,Llíria,22997,11700,11297
46,Valencia/València,152,Llocnou de la Corona,130,71,59
46,Valencia/València,153,Llocnou de Sant Jeroni,581,284,297
46,Valencia/València,151,Llocnou d'En Fenollet,877,455,422
46,Valencia/València,156,Llombai,2788,1417,1371
46,Valencia/València,157,Llosa de Ranes (la),4060,2108,1952
46,Valencia/València,150,Llutxent,2580,1322,1258
46,Valencia/València,148,Loriguilla,1534,773,761
46,Valencia/València,149,Losa del Obispo,566,304,262
46,Valencia/València,158,Macastre,1331,691,640
46,Valencia/València,159,Manises,30508,15104,15404
46,Valencia/València,160,Manuel,2627,1271,1356
46,Valencia/València,161,Marines,1795,909,886
46,Valencia/València,162,Masalavés,1658,855,803
46,Valencia/València,163,Massalfassar,2280,1130,1150
46,Valencia/València,164,Massamagrell,15339,7609,7730
46,Valencia/València,165,Massanassa,8918,4433,4485
46,Valencia/València,166,Meliana,10536,5236,5300
46,Valencia/València,167,Millares,491,236,255
46,Valencia/València,168,Miramar,2431,1260,1171
46,Valencia/València,169,Mislata,43792,21475,22317
46,Valencia/València,170,Mogente/Moixent,4753,2427,2326
46,Valencia/València,171,Moncada,21847,10867,10980
46,Valencia/València,173,Montaverner,1828,914,914
46,Valencia/València,174,Montesa,1369,715,654
46,Valencia/València,175,Montitxelvo/Montichelvo,656,337,319
46,Valencia/València,176,Montroy,2862,1532,1330
46,Valencia/València,172,Montserrat,6784,3585,3199
46,Valencia/València,177,Museros,5832,2934,2898
46,Valencia/València,178,Náquera,5643,2936,2707
46,Valencia/València,179,Navarrés,3242,1671,1571
46,Valencia/València,180,Novelé/Novetlè,852,425,427
46,Valencia/València,181,Oliva,28307,14335,13972
46,Valencia/València,183,Olleria (l'),8660,4400,4260
46,Valencia/València,182,Olocau,1482,777,705
46,Valencia/València,184,Ontinyent,37935,19046,18889
46,Valencia/València,185,Otos,491,252,239
46,Valencia/València,186,Paiporta,23980,12056,11924
46,Valencia/València,187,Palma de Gandía,1843,950,893
46,Valencia/València,188,Palmera,965,512,453
46,Valencia/València,189,Palomar (el),585,280,305
46,Valencia/València,190,Paterna,65921,33002,32919
46,Valencia/València,191,Pedralba,2869,1547,1322
46,Valencia/València,192,Petrés,995,489,506
46,Valencia/València,193,Picanya,11137,5514,5623
46,Valencia/València,194,Picassent,19944,10117,9827
46,Valencia/València,195,Piles,2842,1435,1407
46,Valencia/València,196,Pinet,180,92,88
46,Valencia/València,199,Pobla de Farnals (la),7461,3818,3643
46,Valencia/València,202,Pobla de Vallbona (la),21111,10760,10351
46,Valencia/València,200,Pobla del Duc (la),2514,1233,1281
46,Valencia/València,203,Pobla Llarga (la),4574,2288,2286
46,Valencia/València,197,Polinyà de Xúquer,2511,1263,1248
46,Valencia/València,198,Potríes,1037,524,513
46,Valencia/València,205,Puçol,19295,9622,9673
46,Valencia/València,201,Puebla de San Miguel,88,51,37
46,Valencia/València,204,Puig,8893,4402,4491
46,Valencia/València,101,Quart de les Valls,1099,533,566
46,Valencia/València,102,Quart de Poblet,25472,12546,12926
46,Valencia/València,103,Quartell,1480,735,745
46,Valencia/València,104,Quatretonda,2470,1271,1199
46,Valencia/València,206,Quesa,743,381,362
46,Valencia/València,207,Rafelbuñol/Rafelbunyol,8331,4117,4214
46,Valencia/València,208,Rafelcofer,1507,721,786
46,Valencia/València,209,Rafelguaraf,2486,1240,1246
46,Valencia/València,210,Ráfol de Salem,444,219,225
46,Valencia/València,212,Real,2349,1252,1097
46,Valencia/València,211,Real de Gandía,2220,1099,1121
46,Valencia/València,213,Requena,21448,10885,10563
46,Valencia/València,214,Riba-roja de Túria,20755,10568,10187
46,Valencia/València,215,Riola,1840,942,898
46,Valencia/València,216,Rocafort,6748,3285,3463
46,Valencia/València,217,Rotglà i Corberà,1190,591,599
46,Valencia/València,218,Rótova,1307,668,639
46,Valencia/València,219,Rugat,190,95,95
46,Valencia/València,220,Sagunto/Sagunt,66259,32876,33383
46,Valencia/València,221,Salem,472,240,232
46,Valencia/València,903,San Antonio de Benagéber,6246,3074,3172
46,Valencia/València,222,Sant Joan de l'Ènova,499,240,259
46,Valencia/València,223,Sedaví,9971,4874,5097
46,Valencia/València,224,Segart,134,71,63
46,Valencia/València,225,Sellent,425,219,206
46,Valencia/València,226,Sempere,36,17,19
46,Valencia/València,227,Senyera,1192,602,590
46,Valencia/València,228,Serra,3204,1670,1534
46,Valencia/València,229,Siete Aguas,1423,743,680
46,Valencia/València,230,Silla,19143,9627,9516
46,Valencia/València,231,Simat de la Valldigna,3722,1925,1797
46,Valencia/València,232,Sinarcas,1216,629,587
46,Valencia/València,233,Sollana,4899,2443,2456
46,Valencia/València,234,Sot de Chera,403,213,190
46,Valencia/València,235,Sueca,28926,14468,14458
46,Valencia/València,236,Sumacàrcer,1263,631,632
46,Valencia/València,237,Tavernes Blanques,9426,4621,4805
46,Valencia/València,238,Tavernes de la Valldigna,18130,9126,9004
46,Valencia/València,239,Teresa de Cofrentes,662,335,327
46,Valencia/València,240,Terrateig,335,173,162
46,Valencia/València,241,Titaguas,525,267,258
46,Valencia/València,242,Torrebaja,455,254,201
46,Valencia/València,243,Torrella,145,81,64
46,Valencia/València,244,Torrent,79843,40057,39786
46,Valencia/València,245,Torres Torres,591,309,282
46,Valencia/València,246,Tous,1268,655,613
46,Valencia/València,247,Tuéjar,1201,647,554
46,Valencia/València,248,Turís,6546,3444,3102
46,Valencia/València,249,Utiel,12421,6225,6196
46,Valencia/València,250,Valencia,809267,389228,420039
46,Valencia/València,251,Vallada,3447,1767,1680
46,Valencia/València,252,Vallanca,148,78,70
46,Valencia/València,253,Vallés,141,77,64
46,Valencia/València,254,Venta del Moro,1473,788,685
46,Valencia/València,256,Vilamarxant,9129,4718,4411
46,Valencia/València,255,Villalonga,4331,2154,2177
46,Valencia/València,257,Villanueva de Castellón,7686,3851,3835
46,Valencia/València,258,Villar del Arzobispo,3879,1977,1902
46,Valencia/València,259,Villargordo del Cabriel,688,365,323
46,Valencia/València,260,Vinalesa,3164,1555,1609
46,Valencia/València,145,Xàtiva,29361,14463,14898
46,Valencia/València,143,Xeraco,6129,3177,2952
46,Valencia/València,146,Xeresa,2274,1151,1123
46,Valencia/València,110,Xirivella,30910,15564,15346
46,Valencia/València,261,Yátova,2176,1122,1054
46,Valencia/València,262,Yesa (La),271,148,123
46,Valencia/València,263,Zarra,520,286,234
47,Valladolid,1,Adalia,59,32,27
47,Valladolid,2,Aguasal,30,19,11
47,Valladolid,3,Aguilar de Campos,292,161,131
47,Valladolid,4,Alaejos,1572,820,752
47,Valladolid,5,Alcazarén,722,385,337
47,Valladolid,6,Aldea de San Miguel,216,109,107
47,Valladolid,7,Aldeamayor de San Martín,3904,2018,1886
47,Valladolid,8,Almenara de Adaja,28,14,14
47,Valladolid,9,Amusquillo,126,77,49
47,Valladolid,10,Arroyo de la Encomienda,12758,6571,6187
47,Valladolid,11,Ataquines,718,396,322
47,Valladolid,12,Bahabón,169,81,88
47,Valladolid,13,Barcial de la Loma,130,66,64
47,Valladolid,14,Barruelo del Valle,61,37,24
47,Valladolid,15,Becilla de Valderaduey,321,174,147
47,Valladolid,16,Benafarces,90,48,42
47,Valladolid,17,Bercero,235,130,105
47,Valladolid,18,Berceruelo,43,24,19
47,Valladolid,19,Berrueces,117,68,49
47,Valladolid,20,Bobadilla del Campo,319,172,147
47,Valladolid,21,Bocigas,101,50,51
47,Valladolid,22,Bocos de Duero,62,27,35
47,Valladolid,23,Boecillo,3686,1907,1779
47,Valladolid,24,Bolaños de Campos,361,188,173
47,Valladolid,25,Brahojos de Medina,149,77,72
47,Valladolid,26,Bustillo de Chaves,89,47,42
47,Valladolid,27,Cabezón de Pisuerga,3440,1764,1676
47,Valladolid,28,Cabezón de Valderaduey,38,21,17
47,Valladolid,29,Cabreros del Monte,77,41,36
47,Valladolid,30,Campaspero,1346,720,626
47,Valladolid,31,Campillo (El),235,135,100
47,Valladolid,32,Camporredondo,174,96,78
47,Valladolid,33,Canalejas de Peñafiel,299,159,140
47,Valladolid,34,Canillas de Esgueva,94,51,43
47,Valladolid,35,Carpio,1101,582,519
47,Valladolid,36,Casasola de Arión,315,175,140
47,Valladolid,37,Castrejón de Trabancos,221,112,109
47,Valladolid,38,Castrillo de Duero,148,77,71
47,Valladolid,39,Castrillo-Tejeriego,207,118,89
47,Valladolid,40,Castrobol,78,36,42
47,Valladolid,41,Castrodeza,182,110,72
47,Valladolid,42,Castromembibre,73,38,35
47,Valladolid,43,Castromonte,377,206,171
47,Valladolid,44,Castronuevo de Esgueva,392,213,179
47,Valladolid,45,Castronuño,991,490,501
47,Valladolid,46,Castroponce,169,97,72
47,Valladolid,47,Castroverde de Cerrato,264,156,108
47,Valladolid,48,Ceinos de Campos,267,136,131
47,Valladolid,49,Cervillego de la Cruz,98,56,42
47,Valladolid,50,Cigales,4572,2355,2217
47,Valladolid,51,Ciguñuela,396,212,184
47,Valladolid,52,Cistérniga,8055,4169,3886
47,Valladolid,53,Cogeces de Íscar,175,98,77
47,Valladolid,54,Cogeces del Monte,815,444,371
47,Valladolid,55,Corcos,238,130,108
47,Valladolid,56,Corrales de Duero,104,59,45
47,Valladolid,57,Cubillas de Santa Marta,306,176,130
47,Valladolid,58,Cuenca de Campos,254,130,124
47,Valladolid,59,Curiel de Duero,135,84,51
47,Valladolid,60,Encinas de Esgueva,297,157,140
47,Valladolid,61,Esguevillas de Esgueva,309,165,144
47,Valladolid,62,Fombellida,216,119,97
47,Valladolid,63,Fompedraza,138,76,62
47,Valladolid,64,Fontihoyuelo,36,20,16
47,Valladolid,65,Fresno el Viejo,1057,556,501
47,Valladolid,66,Fuensaldaña,1443,725,718
47,Valladolid,67,Fuente el Sol,230,128,102
47,Valladolid,68,Fuente-Olmedo,45,23,22
47,Valladolid,69,Gallegos de Hornija,149,73,76
47,Valladolid,70,Gatón de Campos,39,25,14
47,Valladolid,71,Geria,481,259,222
47,Valladolid,73,Herrín de Campos,154,74,80
47,Valladolid,74,Hornillos de Eresma,184,99,85
47,Valladolid,75,Íscar,6876,3517,3359
47,Valladolid,76,Laguna de Duero,22110,11185,10925
47,Valladolid,77,Langayo,324,192,132
47,Valladolid,79,Llano de Olmedo,76,45,31
47,Valladolid,78,Lomoviejo,211,111,100
47,Valladolid,80,Manzanillo,64,34,30
47,Valladolid,81,Marzales,55,27,28
47,Valladolid,82,Matapozuelos,1053,531,522
47,Valladolid,83,Matilla de los Caños,97,56,41
47,Valladolid,84,Mayorga,1963,976,987
47,Valladolid,86,Medina de Rioseco,5042,2461,2581
47,Valladolid,85,Medina del Campo,21632,10547,11085
47,Valladolid,87,Megeces,465,246,219
47,Valladolid,88,Melgar de Abajo,145,83,62
47,Valladolid,89,Melgar de Arriba,228,124,104
47,Valladolid,90,Mojados,3348,1747,1601
47,Valladolid,91,Monasterio de Vega,106,56,50
47,Valladolid,92,Montealegre de Campos,144,83,61
47,Valladolid,93,Montemayor de Pililla,1001,521,480
47,Valladolid,94,Moral de la Reina,197,108,89
47,Valladolid,95,Moraleja de las Panaderas,41,27,14
47,Valladolid,96,Morales de Campos,160,83,77
47,Valladolid,97,Mota del Marqués,393,208,185
47,Valladolid,98,Mucientes,742,378,364
47,Valladolid,99,Mudarra (La),180,97,83
47,Valladolid,100,Muriel,183,94,89
47,Valladolid,101,Nava del Rey,2123,1077,1046
47,Valladolid,102,Nueva Villa de las Torres,339,196,143
47,Valladolid,103,Olivares de Duero,345,186,159
47,Valladolid,104,Olmedo,3897,1921,1976
47,Valladolid,105,Olmos de Esgueva,237,129,108
47,Valladolid,106,Olmos de Peñafiel,75,39,36
47,Valladolid,109,Palazuelo de Vedija,237,126,111
47,Valladolid,110,Parrilla (La),549,273,276
47,Valladolid,111,Pedraja de Portillo (La),1156,593,563
47,Valladolid,112,Pedrajas de San Esteban,3639,1867,1772
47,Valladolid,113,Pedrosa del Rey,205,111,94
47,Valladolid,114,Peñafiel,5571,2816,2755
47,Valladolid,115,Peñaflor de Hornija,350,192,158
47,Valladolid,116,Pesquera de Duero,526,292,234
47,Valladolid,117,Piña de Esgueva,352,175,177
47,Valladolid,118,Piñel de Abajo,186,103,83
47,Valladolid,119,Piñel de Arriba,130,70,60
47,Valladolid,121,Pollos,697,362,335
47,Valladolid,122,Portillo,2591,1332,1259
47,Valladolid,123,Pozal de Gallinas,535,287,248
47,Valladolid,124,Pozaldez,573,301,272
47,Valladolid,125,Pozuelo de la Orden,62,38,24
47,Valladolid,126,Puras,58,30,28
47,Valladolid,127,Quintanilla de Arriba,192,105,87
47,Valladolid,129,Quintanilla de Onésimo,1140,592,548
47,Valladolid,130,Quintanilla de Trigueros,109,56,53
47,Valladolid,128,Quintanilla del Molar,71,34,37
47,Valladolid,131,Rábano,208,113,95
47,Valladolid,132,Ramiro,43,24,19
47,Valladolid,133,Renedo de Esgueva,3000,1564,1436
47,Valladolid,134,Roales de Campos,209,110,99
47,Valladolid,135,Robladillo,105,58,47
47,Valladolid,137,Roturas,38,20,18
47,Valladolid,138,Rubí de Bracamonte,280,148,132
47,Valladolid,139,Rueda,1421,737,684
47,Valladolid,140,Saelices de Mayorga,141,78,63
47,Valladolid,141,Salvador de Zapardiel,163,91,72
47,Valladolid,142,San Cebrián de Mazote,172,99,73
47,Valladolid,143,San Llorente,165,90,75
47,Valladolid,144,San Martín de Valvení,106,58,48
47,Valladolid,145,San Miguel del Arroyo,759,398,361
47,Valladolid,146,San Miguel del Pino,289,157,132
47,Valladolid,147,San Pablo de la Moraleja,141,72,69
47,Valladolid,148,San Pedro de Latarce,562,300,262
47,Valladolid,149,San Pelayo,53,24,29
47,Valladolid,150,San Román de Hornija,386,177,209
47,Valladolid,151,San Salvador,34,20,14
47,Valladolid,156,San Vicente del Palacio,214,115,99
47,Valladolid,152,Santa Eufemia del Arroyo,107,58,49
47,Valladolid,153,Santervás de Campos,141,79,62
47,Valladolid,154,Santibáñez de Valcorba,175,93,82
47,Valladolid,155,Santovenia de Pisuerga,3845,1960,1885
47,Valladolid,157,Sardón de Duero,699,354,345
47,Valladolid,158,Seca (La),1093,565,528
47,Valladolid,159,Serrada,1184,615,569
47,Valladolid,160,Siete Iglesias de Trabancos,554,297,257
47,Valladolid,161,Simancas,5291,2696,2595
47,Valladolid,162,Tamariz de Campos,94,49,45
47,Valladolid,163,Tiedra,350,175,175
47,Valladolid,164,Tordehumos,463,236,227
47,Valladolid,165,Tordesillas,9213,4732,4481
47,Valladolid,169,Torre de Esgueva,79,40,39
47,Valladolid,170,Torre de Peñafiel,47,27,20
47,Valladolid,166,Torrecilla de la Abadesa,314,157,157
47,Valladolid,167,Torrecilla de la Orden,312,156,156
47,Valladolid,168,Torrecilla de la Torre,40,28,12
47,Valladolid,171,Torrelobatón,492,242,250
47,Valladolid,172,Torrescárcela,158,83,75
47,Valladolid,173,Traspinedo,1032,568,464
47,Valladolid,174,Trigueros del Valle,339,184,155
47,Valladolid,175,Tudela de Duero,8630,4423,4207
47,Valladolid,176,Unión de Campos (La),268,138,130
47,Valladolid,177,Urones de Castroponce,123,67,56
47,Valladolid,178,Urueña,232,123,109
47,Valladolid,179,Valbuena de Duero,507,273,234
47,Valladolid,180,Valdearcos de la Vega,123,59,64
47,Valladolid,181,Valdenebro de los Valles,220,113,107
47,Valladolid,182,Valdestillas,1765,928,837
47,Valladolid,183,Valdunquillo,173,82,91
47,Valladolid,186,Valladolid,315522,150061,165461
47,Valladolid,184,Valoria la Buena,699,361,338
47,Valladolid,185,Valverde de Campos,121,65,56
47,Valladolid,187,Vega de Ruiponce,117,67,50
47,Valladolid,188,Vega de Valdetronco,138,74,64
47,Valladolid,189,Velascálvaro,195,110,85
47,Valladolid,190,Velilla,126,64,62
47,Valladolid,191,Velliza,124,73,51
47,Valladolid,192,Ventosa de la Cuesta,141,82,59
47,Valladolid,193,Viana de Cega,1962,1015,947
47,Valladolid,195,Villabáñez,515,283,232
47,Valladolid,196,Villabaruz de Campos,45,22,23
47,Valladolid,197,Villabrágima,1116,591,525
47,Valladolid,198,Villacarralón,81,44,37
47,Valladolid,199,Villacid de Campos,103,55,48
47,Valladolid,200,Villaco,106,63,43
47,Valladolid,203,Villafrades de Campos,91,44,47
47,Valladolid,204,Villafranca de Duero,349,178,171
47,Valladolid,205,Villafrechós,533,288,245
47,Valladolid,206,Villafuerte,123,67,56
47,Valladolid,207,Villagarcía de Campos,377,216,161
47,Valladolid,208,Villagómez la Nueva,71,37,34
47,Valladolid,209,Villalán de Campos,51,28,23
47,Valladolid,210,Villalar de los Comuneros,459,227,232
47,Valladolid,211,Villalba de la Loma,57,30,27
47,Valladolid,212,Villalba de los Alcores,474,255,219
47,Valladolid,213,Villalbarba,138,69,69
47,Valladolid,214,Villalón de Campos,1911,953,958
47,Valladolid,215,Villamuriel de Campos,80,40,40
47,Valladolid,216,Villán de Tordesillas,140,76,64
47,Valladolid,217,Villanubla,2192,1149,1043
47,Valladolid,218,Villanueva de Duero,1205,622,583
47,Valladolid,219,Villanueva de la Condesa,73,39,34
47,Valladolid,220,Villanueva de los Caballeros,235,117,118
47,Valladolid,221,Villanueva de los Infantes,129,74,55
47,Valladolid,222,Villanueva de San Mancio,113,65,48
47,Valladolid,223,Villardefrades,202,111,91
47,Valladolid,224,Villarmentero de Esgueva,103,54,49
47,Valladolid,225,Villasexmir,103,56,47
47,Valladolid,226,Villavaquerín,208,115,93
47,Valladolid,227,Villavellid,72,39,33
47,Valladolid,228,Villaverde de Medina,551,301,250
47,Valladolid,229,Villavicencio de los Caballeros,255,130,125
47,Valladolid,194,Viloria,385,210,175
47,Valladolid,230,Wamba,370,196,174
47,Valladolid,231,Zaratán,5245,2716,2529
47,Valladolid,232,Zarza (La),129,73,56
48,Vizcaya,1,Abadiño,7310,3653,3657
48,Vizcaya,2,Abanto y Ciérvana-Abanto Zierbena,9724,4823,4901
48,Vizcaya,911,Ajangiz,450,225,225
48,Vizcaya,912,Alonsotegi,2828,1394,1434
48,Vizcaya,3,Amorebieta-Etxano,17969,8877,9092
48,Vizcaya,4,Amoroto,414,214,200
48,Vizcaya,5,Arakaldo,112,61,51
48,Vizcaya,6,Arantzazu,325,160,165
48,Vizcaya,93,Areatza,1142,539,603
48,Vizcaya,9,Arrankudiaga,920,452,468
48,Vizcaya,914,Arratzu,379,191,188
48,Vizcaya,10,Arrieta,558,285,273
48,Vizcaya,11,Arrigorriaga,12358,6099,6259
48,Vizcaya,23,Artea,760,376,384
48,Vizcaya,8,Artzentales,729,407,322
48,Vizcaya,91,Atxondo,1433,732,701
48,Vizcaya,70,Aulesti,680,339,341
48,Vizcaya,12,Bakio,2470,1248,1222
48,Vizcaya,90,Balmaseda,7366,3579,3787
48,Vizcaya,13,Barakaldo,99321,48216,51105
48,Vizcaya,14,Barrika,1487,740,747
48,Vizcaya,15,Basauri,42452,20771,21681
48,Vizcaya,92,Bedia,966,464,502
48,Vizcaya,16,Berango,6748,3294,3454
48,Vizcaya,17,Bermeo,17026,8377,8649
48,Vizcaya,18,Berriatua,1284,722,562
48,Vizcaya,19,Berriz,4882,2477,2405
48,Vizcaya,20,Bilbao,353187,167019,186168
48,Vizcaya,21,Busturia,1762,884,878
48,Vizcaya,901,Derio,5372,2628,2744
48,Vizcaya,26,Dima,1313,686,627
48,Vizcaya,27,Durango,28261,13863,14398
48,Vizcaya,28,Ea,897,454,443
48,Vizcaya,31,Elantxobe,439,207,232
48,Vizcaya,32,Elorrio,7252,3569,3683
48,Vizcaya,902,Erandio,24294,11954,12340
48,Vizcaya,33,Ereño,258,129,129
48,Vizcaya,34,Ermua,16196,8155,8041
48,Vizcaya,79,Errigoiti,529,276,253
48,Vizcaya,29,Etxebarri,9667,4881,4786
48,Vizcaya,30,Etxebarria,821,423,398
48,Vizcaya,906,Forua,1012,510,502
48,Vizcaya,35,Fruiz,450,227,223
48,Vizcaya,36,Galdakao,29254,14445,14809
48,Vizcaya,37,Galdames,838,437,401
48,Vizcaya,38,Gamiz-Fika,1327,679,648
48,Vizcaya,39,Garai,323,160,163
48,Vizcaya,40,Gatika,1570,808,762
48,Vizcaya,41,Gautegiz Arteaga,869,441,428
48,Vizcaya,46,Gernika-Lumo,16295,7888,8407
48,Vizcaya,44,Getxo,80277,37839,42438
48,Vizcaya,47,Gizaburuaga,201,100,101
48,Vizcaya,42,Gordexola,1740,867,873
48,Vizcaya,43,Gorliz,5503,2719,2784
48,Vizcaya,45,Güeñes,6473,3182,3291
48,Vizcaya,48,Ibarrangelu,614,311,303
48,Vizcaya,94,Igorre,4239,2087,2152
48,Vizcaya,49,Ispaster,668,342,326
48,Vizcaya,910,Iurreta,3812,1922,1890
48,Vizcaya,50,Izurtza,270,151,119
48,Vizcaya,22,Karrantza Harana/Valle de Carranza,2786,1453,1333
48,Vizcaya,907,Kortezubi,419,213,206
48,Vizcaya,51,Lanestosa,272,136,136
48,Vizcaya,52,Larrabetzu,1917,939,978
48,Vizcaya,53,Laukiz,1109,566,543
48,Vizcaya,54,Leioa,30262,14776,15486
48,Vizcaya,57,Lekeitio,7438,3641,3797
48,Vizcaya,55,Lemoa,3226,1595,1631
48,Vizcaya,56,Lemoiz,1023,538,485
48,Vizcaya,81,Lezama,2501,1246,1255
48,Vizcaya,903,Loiu,2521,1282,1239
48,Vizcaya,58,Mallabia,1182,599,583
48,Vizcaya,59,Mañaria,519,283,236
48,Vizcaya,60,Markina-Xemein,4950,2601,2349
48,Vizcaya,61,Maruri-Jatabe,896,461,435
48,Vizcaya,62,Mendata,390,210,180
48,Vizcaya,63,Mendexa,431,223,208
48,Vizcaya,64,Meñaka,702,352,350
48,Vizcaya,66,Morga,419,222,197
48,Vizcaya,68,Mundaka,1938,953,985
48,Vizcaya,69,Mungia,16527,8099,8428
48,Vizcaya,7,Munitibar-Arbatzegi Gerrikaitz,415,224,191
48,Vizcaya,908,Murueta,308,162,146
48,Vizcaya,71,Muskiz,7331,3676,3655
48,Vizcaya,67,Muxika,1466,754,712
48,Vizcaya,909,Nabarniz,234,125,109
48,Vizcaya,73,Ondarroa,8856,4476,4380
48,Vizcaya,75,Orozko,2405,1207,1198
48,Vizcaya,83,Ortuella,8435,4091,4344
48,Vizcaya,72,Otxandio,1269,666,603
48,Vizcaya,77,Plentzia,4292,2083,2209
48,Vizcaya,78,Portugalete,47856,23048,24808
48,Vizcaya,82,Santurtzi,47101,22926,24175
48,Vizcaya,84,Sestao,29224,14200,15024
48,Vizcaya,904,Sondika,4515,2181,2334
48,Vizcaya,85,Sopelana,12527,6184,6343
48,Vizcaya,86,Sopuerta,2552,1294,1258
48,Vizcaya,76,Sukarrieta,352,187,165
48,Vizcaya,87,Trucios-Turtzioz,542,278,264
48,Vizcaya,88,Ubide,167,80,87
48,Vizcaya,65,Ugao-Miraballes,4050,2043,2007
48,Vizcaya,89,Urduliz,3422,1702,1720
48,Vizcaya,74,Urduña/Orduña,4258,2191,2067
48,Vizcaya,80,Valle de Trápaga-Trapagaran,12317,6057,6260
48,Vizcaya,95,Zaldibar,3041,1499,1542
48,Vizcaya,96,Zalla,8176,4021,4155
48,Vizcaya,905,Zamudio,3232,1630,1602
48,Vizcaya,97,Zaratamo,1709,861,848
48,Vizcaya,24,Zeanuri,1302,670,632
48,Vizcaya,25,Zeberio,1060,527,533
48,Vizcaya,913,Zierbena,1398,752,646
48,Vizcaya,915,Ziortza-Bolibar,408,218,190
49,Zamora,2,Abezames,87,45,42
49,Zamora,3,Alcañices,1159,587,572
49,Zamora,4,Alcubilla de Nogales,147,73,74
49,Zamora,5,Alfaraz de Sayago,178,95,83
49,Zamora,6,Algodre,181,94,87
49,Zamora,7,Almaraz de Duero,418,213,205
49,Zamora,8,Almeida de Sayago,554,278,276
49,Zamora,9,Andavías,491,252,239
49,Zamora,10,Arcenillas,370,188,182
49,Zamora,11,Arcos de la Polvorosa,266,141,125
49,Zamora,12,Argañín,76,37,39
49,Zamora,13,Argujillo,330,166,164
49,Zamora,14,Arquillinos,147,79,68
49,Zamora,15,Arrabalde,289,137,152
49,Zamora,16,Aspariegos,305,149,156
49,Zamora,17,Asturianos,260,142,118
49,Zamora,18,Ayoó de Vidriales,380,202,178
49,Zamora,19,Barcial del Barco,284,152,132
49,Zamora,20,Belver de los Montes,368,201,167
49,Zamora,21,Benavente,19100,9319,9781
49,Zamora,22,Benegiles,382,203,179
49,Zamora,23,Bermillo de Sayago,1252,651,601
49,Zamora,24,Bóveda de Toro (La),868,440,428
49,Zamora,25,Bretó,191,110,81
49,Zamora,26,Bretocino,254,135,119
49,Zamora,27,Brime de Sog,177,83,94
49,Zamora,28,Brime de Urz,136,75,61
49,Zamora,29,Burganes de Valverde,788,410,378
49,Zamora,30,Bustillo del Oro,103,59,44
49,Zamora,31,Cabañas de Sayago,179,92,87
49,Zamora,32,Calzadilla de Tera,410,192,218
49,Zamora,33,Camarzana de Tera,977,474,503
49,Zamora,34,Cañizal,527,277,250
49,Zamora,35,Cañizo,287,147,140
49,Zamora,36,Carbajales de Alba,668,342,326
49,Zamora,37,Carbellino,215,107,108
49,Zamora,38,Casaseca de Campeán,118,65,53
49,Zamora,39,Casaseca de las Chanas,420,232,188
49,Zamora,40,Castrillo de la Guareña,139,70,69
49,Zamora,41,Castrogonzalo,513,271,242
49,Zamora,42,Castronuevo,305,152,153
49,Zamora,43,Castroverde de Campos,368,190,178
49,Zamora,44,Cazurra,80,44,36
49,Zamora,46,Cerecinos de Campos,362,194,168
49,Zamora,47,Cerecinos del Carrizal,137,77,60
49,Zamora,48,Cernadilla,159,77,82
49,Zamora,50,Cobreros,609,311,298
49,Zamora,52,Coomonte,240,120,120
49,Zamora,53,Coreses,1159,597,562
49,Zamora,54,Corrales,1077,540,537
49,Zamora,55,Cotanes del Monte,127,68,59
49,Zamora,56,Cubillos,358,179,179
49,Zamora,57,Cubo de Benavente,135,77,58
49,Zamora,58,Cubo de Tierra del Vino (El),421,227,194
49,Zamora,59,Cuelgamures,118,70,48
49,Zamora,61,Entrala,158,81,77
49,Zamora,62,Espadañedo,158,84,74
49,Zamora,63,Faramontanos de Tábara,419,216,203
49,Zamora,64,Fariza,615,311,304
49,Zamora,65,Fermoselle,1462,749,713
49,Zamora,66,Ferreras de Abajo,603,305,298
49,Zamora,67,Ferreras de Arriba,472,246,226
49,Zamora,68,Ferreruela,531,283,248
49,Zamora,69,Figueruela de Arriba,414,193,221
49,Zamora,71,Fonfría,923,465,458
49,Zamora,75,Fresno de la Polvorosa,169,87,82
49,Zamora,76,Fresno de la Ribera,395,213,182
49,Zamora,77,Fresno de Sayago,241,127,114
49,Zamora,78,Friera de Valverde,233,118,115
49,Zamora,79,Fuente Encalada,122,68,54
49,Zamora,80,Fuentelapeña,848,440,408
49,Zamora,82,Fuentes de Ropel,505,250,255
49,Zamora,81,Fuentesaúco,1915,967,948
49,Zamora,83,Fuentesecas,69,33,36
49,Zamora,84,Fuentespreadas,329,177,152
49,Zamora,85,Galende,1308,676,632
49,Zamora,86,Gallegos del Pan,144,80,64
49,Zamora,87,Gallegos del Río,647,347,300
49,Zamora,88,Gamones,103,57,46
49,Zamora,90,Gema,252,126,126
49,Zamora,91,Granja de Moreruela,301,163,138
49,Zamora,92,Granucillo,176,90,86
49,Zamora,93,Guarrate,383,204,179
49,Zamora,94,Hermisende,313,172,141
49,Zamora,95,Hiniesta (La),348,172,176
49,Zamora,96,Jambrina,207,102,105
49,Zamora,97,Justel,114,64,50
49,Zamora,98,Losacino,266,145,121
49,Zamora,99,Losacio,104,60,44
49,Zamora,100,Lubián,362,190,172
49,Zamora,101,Luelmo,217,112,105
49,Zamora,102,Maderal (El),233,121,112
49,Zamora,103,Madridanos,525,268,257
49,Zamora,104,Mahide,415,231,184
49,Zamora,105,Maire de Castroponce,170,93,77
49,Zamora,107,Malva,170,84,86
49,Zamora,108,Manganeses de la Lampreana,589,294,295
49,Zamora,109,Manganeses de la Polvorosa,751,366,385
49,Zamora,110,Manzanal de Arriba,412,212,200
49,Zamora,112,Manzanal de los Infantes,147,81,66
49,Zamora,111,Manzanal del Barco,156,80,76
49,Zamora,113,Matilla de Arzón,206,114,92
49,Zamora,114,Matilla la Seca,54,26,28
49,Zamora,115,Mayalde,226,116,110
49,Zamora,116,Melgar de Tera,444,217,227
49,Zamora,117,Micereces de Tera,553,278,275
49,Zamora,118,Milles de la Polvorosa,248,137,111
49,Zamora,119,Molacillos,281,149,132
49,Zamora,120,Molezuelas de la Carballeda,88,46,42
49,Zamora,121,Mombuey,437,234,203
49,Zamora,122,Monfarracinos,872,460,412
49,Zamora,123,Montamarta,616,308,308
49,Zamora,124,Moral de Sayago,317,177,140
49,Zamora,126,Moraleja de Sayago,274,144,130
49,Zamora,125,Moraleja del Vino,1577,832,745
49,Zamora,128,Morales de Rey,661,332,329
49,Zamora,129,Morales de Toro,1137,575,562
49,Zamora,130,Morales de Valverde,237,125,112
49,Zamora,127,Morales del Vino,2709,1420,1289
49,Zamora,131,Moralina,328,165,163
49,Zamora,132,Moreruela de los Infanzones,400,203,197
49,Zamora,133,Moreruela de Tábara,401,211,190
49,Zamora,134,Muelas de los Caballeros,205,106,99
49,Zamora,135,Muelas del Pan,782,395,387
49,Zamora,136,Muga de Sayago,400,197,203
49,Zamora,137,Navianos de Valverde,217,120,97
49,Zamora,138,Olmillos de Castro,308,159,149
49,Zamora,139,Otero de Bodas,203,108,95
49,Zamora,141,Pajares de la Lampreana,456,227,229
49,Zamora,143,Palacios de Sanabria,282,141,141
49,Zamora,142,Palacios del Pan,262,128,134
49,Zamora,145,Pedralba de la Pradería,298,164,134
49,Zamora,146,Pego (El),358,180,178
49,Zamora,147,Peleagonzalo,334,170,164
49,Zamora,148,Peleas de Abajo,268,140,128
49,Zamora,149,Peñausende,489,245,244
49,Zamora,150,Peque,178,84,94
49,Zamora,151,Perdigón (El),766,404,362
49,Zamora,152,Pereruela,655,347,308
49,Zamora,153,Perilla de Castro,202,96,106
49,Zamora,154,Pías,157,84,73
49,Zamora,155,Piedrahita de Castro,118,65,53
49,Zamora,156,Pinilla de Toro,287,154,133
49,Zamora,157,Pino del Oro,202,104,98
49,Zamora,158,Piñero (El),266,136,130
49,Zamora,160,Pobladura de Valderaduey,57,31,26
49,Zamora,159,Pobladura del Valle,317,161,156
49,Zamora,162,Porto,222,120,102
49,Zamora,163,Pozoantiguo,282,145,137
49,Zamora,164,Pozuelo de Tábara,166,78,88
49,Zamora,165,Prado,83,47,36
49,Zamora,166,Puebla de Sanabria,1565,754,811
49,Zamora,167,Pueblica de Valverde,252,131,121
49,Zamora,170,Quintanilla de Urz,134,67,67
49,Zamora,168,Quintanilla del Monte,107,53,54
49,Zamora,169,Quintanilla del Olmo,40,20,20
49,Zamora,171,Quiruelas de Vidriales,804,398,406
49,Zamora,172,Rabanales,679,357,322
49,Zamora,173,Rábano de Aliste,414,205,209
49,Zamora,174,Requejo,171,91,80
49,Zamora,175,Revellinos,303,161,142
49,Zamora,176,Riofrío de Aliste,866,463,403
49,Zamora,177,Rionegro del Puente,305,155,150
49,Zamora,178,Roales,787,410,377
49,Zamora,179,Robleda-Cervantes,453,238,215
49,Zamora,180,Roelos de Sayago,174,85,89
49,Zamora,181,Rosinos de la Requejada,436,222,214
49,Zamora,183,Salce,113,57,56
49,Zamora,184,Samir de los Caños,210,110,100
49,Zamora,185,San Agustín del Pozo,202,100,102
49,Zamora,186,San Cebrián de Castro,294,142,152
49,Zamora,187,San Cristóbal de Entreviñas,1560,814,746
49,Zamora,188,San Esteban del Molar,151,87,64
49,Zamora,189,San Justo,295,157,138
49,Zamora,190,San Martín de Valderaduey,83,42,41
49,Zamora,191,San Miguel de la Ribera,358,185,173
49,Zamora,192,San Miguel del Valle,182,87,95
49,Zamora,193,San Pedro de Ceque,589,295,294
49,Zamora,194,San Pedro de la Nave-Almendra,395,197,198
49,Zamora,208,San Vicente de la Cabeza,472,246,226
49,Zamora,209,San Vitero,650,359,291
49,Zamora,197,Santa Clara de Avedillo,201,100,101
49,Zamora,199,Santa Colomba de las Monjas,300,147,153
49,Zamora,200,Santa Cristina de la Polvorosa,1199,607,592
49,Zamora,201,Santa Croya de Tera,370,192,178
49,Zamora,202,Santa Eufemia del Barco,244,138,106
49,Zamora,203,Santa María de la Vega,400,204,196
49,Zamora,204,Santa María de Valverde,85,41,44
49,Zamora,205,Santibáñez de Tera,489,250,239
49,Zamora,206,Santibáñez de Vidriales,1183,589,594
49,Zamora,207,Santovenia,324,154,170
49,Zamora,210,Sanzoles,600,307,293
49,Zamora,214,Tábara,891,465,426
49,Zamora,216,Tapioles,192,104,88
49,Zamora,219,Toro,9748,4795,4953
49,Zamora,220,Torre del Valle (La),174,90,84
49,Zamora,221,Torregamones,303,163,140
49,Zamora,222,Torres del Carrizal,444,225,219
49,Zamora,223,Trabazos,1008,529,479
49,Zamora,224,Trefacio,189,92,97
49,Zamora,225,Uña de Quintana,182,93,89
49,Zamora,226,Vadillo de la Guareña,316,161,155
49,Zamora,227,Valcabado,327,160,167
49,Zamora,228,Valdefinjas,74,43,31
49,Zamora,229,Valdescorriel,163,82,81
49,Zamora,230,Vallesa de la Guareña,131,68,63
49,Zamora,231,Vega de Tera,413,199,214
49,Zamora,232,Vega de Villalobos,121,54,67
49,Zamora,233,Vegalatrave,124,72,52
49,Zamora,234,Venialbo,477,255,222
49,Zamora,235,Vezdemarbán,563,283,280
49,Zamora,236,Vidayanes,93,47,46
49,Zamora,237,Videmala,165,84,81
49,Zamora,238,Villabrázaro,308,160,148
49,Zamora,239,Villabuena del Puente,822,429,393
49,Zamora,240,Villadepera,266,141,125
49,Zamora,241,Villaescusa,308,159,149
49,Zamora,242,Villafáfila,577,302,275
49,Zamora,243,Villaferrueña,127,59,68
49,Zamora,244,Villageriz,51,30,21
49,Zamora,245,Villalazán,333,165,168
49,Zamora,246,Villalba de la Lampreana,269,143,126
49,Zamora,247,Villalcampo,551,277,274
49,Zamora,248,Villalobos,310,150,160
49,Zamora,249,Villalonso,88,47,41
49,Zamora,250,Villalpando,1624,794,830
49,Zamora,251,Villalube,202,103,99
49,Zamora,252,Villamayor de Campos,425,213,212
49,Zamora,255,Villamor de los Escuderos,481,249,232
49,Zamora,256,Villanázar,339,166,173
49,Zamora,257,Villanueva de Azoague,330,165,165
49,Zamora,258,Villanueva de Campeán,142,73,69
49,Zamora,259,Villanueva de las Peras,127,65,62
49,Zamora,260,Villanueva del Campo,969,478,491
49,Zamora,263,Villar de Fallaves,76,40,36
49,Zamora,264,Villar del Buey,721,383,338
49,Zamora,261,Villaralbo,1870,946,924
49,Zamora,262,Villardeciervos,479,231,248
49,Zamora,265,Villardiegua de la Ribera,160,81,79
49,Zamora,266,Villárdiga,101,54,47
49,Zamora,267,Villardondiego,127,79,48
49,Zamora,268,Villarrín de Campos,528,287,241
49,Zamora,269,Villaseco del Pan,254,112,142
49,Zamora,270,Villavendimio,197,112,85
49,Zamora,272,Villaveza de Valverde,105,50,55
49,Zamora,271,Villaveza del Agua,241,124,117
49,Zamora,273,Viñas,242,128,114
49,Zamora,275,Zamora,65998,31235,34763
50,Zaragoza,1,Abanto,124,65,59
50,Zaragoza,2,Acered,160,85,75
50,Zaragoza,3,Agón,166,89,77
50,Zaragoza,4,Aguarón,863,457,406
50,Zaragoza,5,Aguilón,250,131,119
50,Zaragoza,6,Ainzón,1269,651,618
50,Zaragoza,7,Aladrén,62,40,22
50,Zaragoza,8,Alagón,7178,3635,3543
50,Zaragoza,9,Alarba,155,86,69
50,Zaragoza,10,Alberite de San Juan,101,59,42
50,Zaragoza,11,Albeta,141,69,72
50,Zaragoza,12,Alborge,126,65,61
50,Zaragoza,13,Alcalá de Ebro,276,127,149
50,Zaragoza,14,Alcalá de Moncayo,153,89,64
50,Zaragoza,15,Alconchel de Ariza,99,56,43
50,Zaragoza,16,Aldehuela de Liestos,48,29,19
50,Zaragoza,17,Alfajarín,2168,1108,1060
50,Zaragoza,18,Alfamén,1509,814,695
50,Zaragoza,19,Alforque,81,44,37
50,Zaragoza,20,Alhama de Aragón,1172,604,568
50,Zaragoza,21,Almochuel,26,14,12
50,Zaragoza,22,Almolda (La),619,319,300
50,Zaragoza,23,Almonacid de la Cuba,283,147,136
50,Zaragoza,24,Almonacid de la Sierra,790,429,361
50,Zaragoza,25,Almunia de Doña Godina (La),7802,4059,3743
50,Zaragoza,26,Alpartir,564,296,268
50,Zaragoza,27,Ambel,305,150,155
50,Zaragoza,28,Anento,136,79,57
50,Zaragoza,29,Aniñón,818,447,371
50,Zaragoza,30,Añón de Moncayo,205,123,82
50,Zaragoza,31,Aranda de Moncayo,214,122,92
50,Zaragoza,32,Arándiga,406,208,198
50,Zaragoza,33,Ardisa,80,50,30
50,Zaragoza,34,Ariza,1279,654,625
50,Zaragoza,35,Artieda,94,55,39
50,Zaragoza,36,Asín,104,54,50
50,Zaragoza,37,Atea,125,72,53
50,Zaragoza,38,Ateca,2151,1107,1044
50,Zaragoza,39,Azuara,701,390,311
50,Zaragoza,40,Badules,95,50,45
50,Zaragoza,41,Bagüés,23,13,10
50,Zaragoza,42,Balconchán,12,5,7
50,Zaragoza,43,Bárboles,333,189,144
50,Zaragoza,44,Bardallur,327,161,166
50,Zaragoza,45,Belchite,1665,858,807
50,Zaragoza,46,Belmonte de Gracián,236,132,104
50,Zaragoza,47,Berdejo,64,38,26
50,Zaragoza,48,Berrueco,43,21,22
50,Zaragoza,901,Biel,186,108,78
50,Zaragoza,50,Bijuesca,113,74,39
50,Zaragoza,51,Biota,1115,574,541
50,Zaragoza,52,Bisimbre,109,57,52
50,Zaragoza,53,Boquiñeni,995,498,497
50,Zaragoza,54,Bordalba,74,44,30
50,Zaragoza,55,Borja,5042,2583,2459
50,Zaragoza,56,Botorrita,536,289,247
50,Zaragoza,57,Brea de Aragón,1854,922,932
50,Zaragoza,58,Bubierca,83,44,39
50,Zaragoza,59,Bujaraloz,1055,548,507
50,Zaragoza,60,Bulbuente,248,126,122
50,Zaragoza,61,Bureta,269,138,131
50,Zaragoza,62,Burgo de Ebro (El),2321,1224,1097
50,Zaragoza,63,Buste (El),88,45,43
50,Zaragoza,64,Cabañas de Ebro,556,298,258
50,Zaragoza,65,Cabolafuente,49,25,24
50,Zaragoza,66,Cadrete,3054,1594,1460
50,Zaragoza,67,Calatayud,21717,10794,10923
50,Zaragoza,68,Calatorao,3094,1616,1478
50,Zaragoza,69,Calcena,68,37,31
50,Zaragoza,70,Calmarza,77,44,33
50,Zaragoza,71,Campillo de Aragón,154,86,68
50,Zaragoza,72,Carenas,195,100,95
50,Zaragoza,73,Cariñena,3725,1945,1780
50,Zaragoza,74,Caspe,9989,5249,4740
50,Zaragoza,75,Castejón de Alarba,98,54,44
50,Zaragoza,76,Castejón de las Armas,122,66,56
50,Zaragoza,77,Castejón de Valdejasa,283,149,134
50,Zaragoza,78,Castiliscar,338,172,166
50,Zaragoza,79,Cervera de la Cañada,311,165,146
50,Zaragoza,80,Cerveruela,41,28,13
50,Zaragoza,81,Cetina,697,344,353
50,Zaragoza,92,Chiprana,276,132,144
50,Zaragoza,93,Chodes,149,80,69
50,Zaragoza,82,Cimballa,127,63,64
50,Zaragoza,83,Cinco Olivas,123,60,63
50,Zaragoza,84,Clarés de Ribota,101,57,44
50,Zaragoza,85,Codo,211,107,104
50,Zaragoza,86,Codos,256,165,91
50,Zaragoza,87,Contamina,38,23,15
50,Zaragoza,88,Cosuenda,389,198,191
50,Zaragoza,89,Cuarte de Huerva,8658,4512,4146
50,Zaragoza,90,Cubel,192,96,96
50,Zaragoza,91,Cuerlas (Las),66,33,33
50,Zaragoza,94,Daroca,2300,1136,1164
50,Zaragoza,95,Ejea de los Caballeros,17344,8969,8375
50,Zaragoza,96,Embid de Ariza,56,30,26
50,Zaragoza,98,Encinacorba,252,129,123
50,Zaragoza,99,Épila,4765,2548,2217
50,Zaragoza,100,Erla,421,212,209
50,Zaragoza,101,Escatrón,1132,563,569
50,Zaragoza,102,Fabara,1255,679,576
50,Zaragoza,104,Farlete,439,211,228
50,Zaragoza,105,Fayón,407,210,197
50,Zaragoza,106,Fayos (Los),153,79,74
50,Zaragoza,107,Figueruelas,1332,685,647
50,Zaragoza,108,Fombuena,52,30,22
50,Zaragoza,109,Frago (El),106,62,44
50,Zaragoza,110,Frasno (El),476,250,226
50,Zaragoza,111,Fréscano,220,120,100
50,Zaragoza,113,Fuendejalón,953,516,437
50,Zaragoza,114,Fuendetodos,174,93,81
50,Zaragoza,115,Fuentes de Ebro,4617,2416,2201
50,Zaragoza,116,Fuentes de Jiloca,280,149,131
50,Zaragoza,117,Gallocanta,152,81,71
50,Zaragoza,118,Gallur,3007,1517,1490
50,Zaragoza,119,Gelsa,1201,622,579
50,Zaragoza,120,Godojos,46,25,21
50,Zaragoza,121,Gotor,399,215,184
50,Zaragoza,122,Grisel,79,50,29
50,Zaragoza,123,Grisén,554,292,262
50,Zaragoza,124,Herrera de los Navarros,616,323,293
50,Zaragoza,125,Ibdes,490,258,232
50,Zaragoza,126,Illueca,3348,1675,1673
50,Zaragoza,128,Isuerre,37,24,13
50,Zaragoza,129,Jaraba,360,187,173
50,Zaragoza,130,Jarque,550,295,255
50,Zaragoza,131,Jaulín,323,176,147
50,Zaragoza,132,Joyosa (La),936,472,464
50,Zaragoza,133,Lagata,134,75,59
50,Zaragoza,134,Langa del Castillo,151,71,80
50,Zaragoza,135,Layana,124,70,54
50,Zaragoza,136,Lécera,765,402,363
50,Zaragoza,138,Lechón,57,30,27
50,Zaragoza,137,Leciñena,1305,640,665
50,Zaragoza,139,Letux,425,229,196
50,Zaragoza,140,Litago,183,100,83
50,Zaragoza,141,Lituénigo,125,66,59
50,Zaragoza,142,Lobera de Onsella,50,29,21
50,Zaragoza,143,Longares,896,499,397
50,Zaragoza,144,Longás,36,23,13
50,Zaragoza,146,Lucena de Jalón,309,173,136
50,Zaragoza,147,Luceni,1098,552,546
50,Zaragoza,148,Luesia,361,201,160
50,Zaragoza,149,Luesma,38,21,17
50,Zaragoza,150,Lumpiaque,937,493,444
50,Zaragoza,151,Luna,846,442,404
50,Zaragoza,152,Maella,2028,1044,984
50,Zaragoza,153,Magallón,1205,623,582
50,Zaragoza,154,Mainar,167,86,81
50,Zaragoza,155,Malanquilla,127,74,53
50,Zaragoza,156,Maleján,344,177,167
50,Zaragoza,160,Mallén,3704,1965,1739
50,Zaragoza,157,Malón,379,198,181
50,Zaragoza,159,Maluenda,1094,532,562
50,Zaragoza,161,Manchones,123,69,54
50,Zaragoza,162,Mara,206,103,103
50,Zaragoza,163,María de Huerva,4729,2488,2241
50,Zaragoza,902,Marracos,100,51,49
50,Zaragoza,164,Mediana de Aragón,481,248,233
50,Zaragoza,165,Mequinenza,2495,1274,1221
50,Zaragoza,166,Mesones de Isuela,315,158,157
50,Zaragoza,167,Mezalocha,226,130,96
50,Zaragoza,168,Mianos,41,22,19
50,Zaragoza,169,Miedes de Aragón,475,249,226
50,Zaragoza,170,Monegrillo,479,271,208
50,Zaragoza,171,Moneva,122,66,56
50,Zaragoza,172,Monreal de Ariza,189,106,83
50,Zaragoza,173,Monterde,194,115,79
50,Zaragoza,174,Montón,132,77,55
50,Zaragoza,175,Morata de Jalón,1352,667,685
50,Zaragoza,176,Morata de Jiloca,301,171,130
50,Zaragoza,177,Morés,437,227,210
50,Zaragoza,178,Moros,469,243,226
50,Zaragoza,179,Moyuela,260,141,119
50,Zaragoza,180,Mozota,114,55,59
50,Zaragoza,181,Muel,1385,704,681
50,Zaragoza,182,Muela (La),5166,2650,2516
50,Zaragoza,183,Munébrega,488,254,234
50,Zaragoza,184,Murero,146,85,61
50,Zaragoza,185,Murillo de Gállego,189,102,87
50,Zaragoza,186,Navardún,50,31,19
50,Zaragoza,187,Nigüella,81,46,35
50,Zaragoza,188,Nombrevilla,35,20,15
50,Zaragoza,189,Nonaspe,1061,556,505
50,Zaragoza,190,Novallas,919,489,430
50,Zaragoza,191,Novillas,626,316,310
50,Zaragoza,192,Nuévalos,356,194,162
50,Zaragoza,193,Nuez de Ebro,801,413,388
50,Zaragoza,194,Olvés,115,61,54
50,Zaragoza,195,Orcajo,33,17,16
50,Zaragoza,196,Orera,129,66,63
50,Zaragoza,197,Orés,101,59,42
50,Zaragoza,198,Oseja,55,30,25
50,Zaragoza,199,Osera de Ebro,473,237,236
50,Zaragoza,200,Paniza,759,405,354
50,Zaragoza,201,Paracuellos de Jiloca,576,288,288
50,Zaragoza,202,Paracuellos de la Ribera,194,91,103
50,Zaragoza,203,Pastriz,1384,673,711
50,Zaragoza,204,Pedrola,3721,1960,1761
50,Zaragoza,205,Pedrosas (Las),121,63,58
50,Zaragoza,206,Perdiguera,664,343,321
50,Zaragoza,207,Piedratajada,150,77,73
50,Zaragoza,208,Pina de Ebro,2655,1372,1283
50,Zaragoza,209,Pinseque,3481,1795,1686
50,Zaragoza,210,Pintanos (Los),38,24,14
50,Zaragoza,211,Plasencia de Jalón,404,234,170
50,Zaragoza,212,Pleitas,48,24,24
50,Zaragoza,213,Plenas,132,68,64
50,Zaragoza,214,Pomer,37,25,12
50,Zaragoza,215,Pozuel de Ariza,20,12,8
50,Zaragoza,216,Pozuelo de Aragón,342,184,158
50,Zaragoza,217,Pradilla de Ebro,618,322,296
50,Zaragoza,218,Puebla de Albortón,125,73,52
50,Zaragoza,219,Puebla de Alfindén (La),5250,2746,2504
50,Zaragoza,220,Puendeluna,65,36,29
50,Zaragoza,221,Purujosa,44,32,12
50,Zaragoza,222,Quinto,2111,1090,1021
50,Zaragoza,223,Remolinos,1199,609,590
50,Zaragoza,224,Retascón,79,44,35
50,Zaragoza,225,Ricla,3568,1976,1592
50,Zaragoza,227,Romanos,113,68,45
50,Zaragoza,228,Rueda de Jalón,353,189,164
50,Zaragoza,229,Ruesca,75,40,35
50,Zaragoza,241,Sabiñán,793,404,389
50,Zaragoza,230,Sádaba,1671,850,821
50,Zaragoza,231,Salillas de Jalón,375,188,187
50,Zaragoza,232,Salvatierra de Esca,235,114,121
50,Zaragoza,233,Samper del Salz,128,66,62
50,Zaragoza,234,San Martín de la Virgen de Moncayo,295,163,132
50,Zaragoza,235,San Mateo de Gállego,3079,1597,1482
50,Zaragoza,236,Santa Cruz de Grío,164,90,74
50,Zaragoza,237,Santa Cruz de Moncayo,126,62,64
50,Zaragoza,238,Santa Eulalia de Gállego,125,69,56
50,Zaragoza,239,Santed,61,33,28
50,Zaragoza,240,Sástago,1260,649,611
50,Zaragoza,242,Sediles,112,61,51
50,Zaragoza,243,Sestrica,402,232,170
50,Zaragoza,244,Sierra de Luna,308,167,141
50,Zaragoza,245,Sigüés,132,71,61
50,Zaragoza,246,Sisamón,50,35,15
50,Zaragoza,247,Sobradiel,999,489,510
50,Zaragoza,248,Sos del Rey Católico,662,334,328
50,Zaragoza,249,Tabuenca,412,229,183
50,Zaragoza,250,Talamantes,61,31,30
50,Zaragoza,251,Tarazona,11131,5510,5621
50,Zaragoza,252,Tauste,7567,3788,3779
50,Zaragoza,253,Terrer,519,260,259
50,Zaragoza,254,Tierga,179,99,80
50,Zaragoza,255,Tobed,256,123,133
50,Zaragoza,256,Torralba de los Frailes,96,52,44
50,Zaragoza,257,Torralba de Ribota,198,109,89
50,Zaragoza,258,Torralbilla,64,34,30
50,Zaragoza,259,Torrehermosa,83,44,39
50,Zaragoza,260,Torrelapaja,45,26,19
50,Zaragoza,261,Torrellas,293,152,141
50,Zaragoza,262,Torres de Berrellén,1496,779,717
50,Zaragoza,263,Torrijo de la Cañada,277,156,121
50,Zaragoza,264,Tosos,245,134,111
50,Zaragoza,265,Trasmoz,78,44,34
50,Zaragoza,266,Trasobares,152,91,61
50,Zaragoza,267,Uncastillo,781,373,408
50,Zaragoza,268,Undués de Lerda,71,37,34
50,Zaragoza,269,Urrea de Jalón,414,202,212
50,Zaragoza,270,Urriés,37,23,14
50,Zaragoza,271,Used,328,184,144
50,Zaragoza,272,Utebo,17999,9126,8873
50,Zaragoza,274,Val de San Martín,79,43,36
50,Zaragoza,273,Valdehorna,35,17,18
50,Zaragoza,275,Valmadrid,109,69,40
50,Zaragoza,276,Valpalmas,155,75,80
50,Zaragoza,277,Valtorres,114,58,56
50,Zaragoza,278,Velilla de Ebro,254,137,117
50,Zaragoza,279,Velilla de Jiloca,102,53,49
50,Zaragoza,280,Vera de Moncayo,419,216,203
50,Zaragoza,281,Vierlas,104,54,50
50,Zaragoza,283,Villadoz,83,49,34
50,Zaragoza,284,Villafeliche,200,106,94
50,Zaragoza,285,Villafranca de Ebro,837,423,414
50,Zaragoza,286,Villalba de Perejil,112,59,53
50,Zaragoza,287,Villalengua,391,201,190
50,Zaragoza,903,Villamayor de Gállego,2888,1437,1451
50,Zaragoza,288,Villanueva de Gállego,4376,2205,2171
50,Zaragoza,290,Villanueva de Huerva,562,302,260
50,Zaragoza,289,Villanueva de Jiloca,69,37,32
50,Zaragoza,291,Villar de los Navarros,120,65,55
50,Zaragoza,292,Villarreal de Huerva,202,114,88
50,Zaragoza,293,Villarroya de la Sierra,565,297,268
50,Zaragoza,294,Villarroya del Campo,75,42,33
50,Zaragoza,282,Vilueña (La),114,57,57
50,Zaragoza,295,Vistabella,50,34,16
50,Zaragoza,296,Zaida (La),509,250,259
50,Zaragoza,297,Zaragoza,675121,328181,346940
50,Zaragoza,298,Zuera,7510,3880,3630
51,Ceuta,1,Ceuta,80579,41269,39310
52,Melilla,1,Melilla,76034,38819,37215
