01,0014,Alegría-Dulantzi,1259,656,603
1,29,Amurrio,9753,4854,4899
1,493,Añana,185,94,91
1,35,Aramaio,1365,721,644
1,66,Armiñón,145,75,70
1,376,Arraia-Maeztu,692,369,323
1,88,Arrazua-Ubarrundia,761,399,362
1,40,Artziniega,1317,660,657
1,91,Asparrena,1544,771,773
1,105,Ayala/Aiara,2001,995,1006
1,112,Baños de Ebro/Mañueta,334,182,152
1,133,Barrundia,586,329,257
1,148,Berantevilla,406,211,195
1,164,Bernedo,548,316,232
1,170,Campezo/Kanpezu,1073,560,513
1,210,Elburgo,231,128,103
1,225,Elciego,909,462,447
1,231,Elvillar/Bilar,352,189,163
1,565,Harana/Valle de Arana,358,198,160
1,9015,Iruña Oka/Iruña de Oca,1683,886,797
1,278,Iruraiz-Gauna,417,231,186
1,199,Kripan,187,96,91
1,203,Kuartango,362,203,159
1,284,Labastida,1177,627,550
1,301,Lagrán,195,105,90
1,318,Laguardia,1409,724,685
1,323,Lanciego/Lantziego,645,335,310
1,9020,Lantarón,901,509,392
1,339,Lapuebla de Labarca,864,437,427
1,587,Legutiano,1324,693,631
1,344,Leza,172,93,79
1,360,Llodio,19694,9859,9835
1,395,Moreda de Álava,289,155,134
1,416,Navaridas,217,122,95
1,421,Okondo,810,414,396
1,437,Oyón/Oion,2246,1133,1113
1,442,Peñacerrada-Urizaharra,243,134,109
1,468,Ribera Alta,518,302,216
1,474,Ribera Baja/Erribera Beitia,499,274,225
1,513,Salvatierra o Agurain,3876,1940,1936
1,528,Samaniego,305,150,155
1,534,San Millán/Donemiliaga,700,382,318
1,549,Urkabustaiz,821,453,368
1,552,Valdegovía,896,488,408
1,571,Villabuena de Álava/Eskuernaga,339,167,172
1,590,Vitoria-Gasteiz,216527,106454,110073
1,604,Yécora,252,124,128
1,611,Zalduondo,132,71,61
1,626,Zambrana,366,194,172
1,186,Zigoitia,1132,630,502
1,632,Zuia,1578,796,782
2,19,Abengibre,1007,499,508
2,24,Alatoz,675,351,324
2,30,Albacete,145454,71126,74328
2,45,Albatana,874,442,432
2,58,Alborea,809,428,381
2,61,Alcadozo,779,395,384
2,77,Alcalá del Júcar,1512,777,735
2,83,Alcaraz,1730,831,899
2,96,Almansa,23658,11674,11984
2,100,Alpera,2324,1188,1136
2,117,Ayna,1003,505,498
2,122,Balazote,2223,1121,1102
2,143,Ballestero (El),573,283,290
2,138,Balsa de Ves,261,146,115
2,156,Barrax,1952,981,971
2,169,Bienservida,906,461,445
2,175,Bogarra,1369,725,644
2,181,Bonete,1240,627,613
2,194,Bonillo (El),3310,1677,1633
2,208,Carcelén,662,352,310
2,241,Casas-Ibáñez,4058,2046,2012
2,215,Casas de Juan Núñez,1279,666,613
2,220,Casas de Lázaro,451,243,208
2,236,Casas de Ves,912,474,438
2,254,Caudete,8827,4397,4430
2,267,Cenizate,1066,555,511
2,292,Chinchilla de Monte-Aragón,3190,1650,1540
2,273,Corral-Rubio,460,230,230
2,289,Cotillas,219,109,110
2,306,Elche de la Sierra,3943,1964,1979
2,313,Férez,787,395,392
2,328,Fuensanta,381,192,189
2,334,Fuente-Álamo,2447,1243,1204
2,349,Fuentealbilla,1805,914,891
2,352,Gineta (La),2065,1006,1059
2,365,Golosalvo,119,57,62
2,371,Hellín,25978,12871,13107
2,387,Herrera (La),395,204,191
2,390,Higueruela,1313,661,652
2,404,Hoya-Gonzalo,750,377,373
2,411,Jorquera,587,314,273
2,426,Letur,1387,685,702
2,432,Lezuza,1804,947,857
2,447,Liétor,1685,867,818
2,450,Madrigueras,4503,2274,2229
2,463,Mahora,1353,670,683
2,479,Masegoso,168,98,70
2,485,Minaya,1785,899,886
2,498,Molinicos,1397,716,681
2,501,Montalvos,145,73,72
2,518,Montealegre del Castillo,2115,1066,1049
2,523,Motilleja,510,252,258
2,539,Munera,4069,2044,2025
2,544,Navas de Jorquera,535,274,261
2,557,Nerpio,1792,959,833
2,560,Ontur,2428,1197,1231
2,576,Ossa de Montiel,2790,1387,1403
2,582,Paterna del Madera,583,302,281
2,609,Peñas de San Pedro,1244,658,586
2,595,Peñascosa,418,216,202
2,616,Pétrola,927,474,453
2,621,Povedilla,721,376,345
2,642,Pozo-Lorente,539,260,279
2,637,Pozohondo,1852,949,903
2,655,Pozuelo,674,349,325
2,668,Recueja (La),350,176,174
2,674,Riópar,1420,733,687
2,680,Robledo,431,227,204
2,693,Roda (La),13583,6808,6775
2,707,Salobre,622,322,300
2,714,San Pedro,1326,672,654
2,729,Socovos,2032,1044,988
2,735,Tarazona de la Mancha,6010,2999,3011
2,740,Tobarra,7435,3731,3704
2,753,Valdeganga,1966,994,972
2,766,Vianos,489,240,249
2,772,Villa de Ves,61,29,32
2,788,Villalgordo del Júcar,1329,665,664
2,791,Villamalea,3459,1771,1688
2,805,Villapalacios,860,433,427
2,812,Villarrobledo,22178,10833,11345
2,827,Villatoya,193,99,94
2,833,Villavaliente,291,152,139
2,848,Villaverde de Guadalimar,564,301,263
2,851,Viveros,564,302,262
2,864,Yeste,4657,2378,2279
3,15,Adsubia,579,296,283
3,20,Agost,4023,1998,2025
3,36,Agres,651,339,312
3,41,Aigües,558,286,272
3,54,Albatera,8521,4293,4228
3,67,Alcalalí,818,410,408
3,73,Alcocer de Planes,130,55,75
3,89,Alcoleja,279,134,145
3,92,Alcoy/Alcoi,60476,29135,31341
3,106,Alfafara,392,190,202
3,113,Alfàs del Pi (l'),13145,6403,6742
3,128,Algorfa,1168,590,578
3,134,Algueña,1428,692,736
3,149,Alicante/Alacant,272432,130607,141825
3,152,Almoradí,13499,6809,6690
3,165,Almudaina,118,62,56
3,171,Alqueria d'Asnar (l'),395,199,196
3,187,Altea,13976,6872,7104
3,190,Aspe,16406,8204,8202
3,204,Balones,178,85,93
3,211,Banyeres de Mariola,6848,3398,3450
3,226,Benasau,200,98,102
3,232,Beneixama,1796,891,905
3,247,Benejúzar,5067,2518,2549
3,250,Benferri,982,492,490
3,263,Beniarbeig,1205,586,619
3,279,Beniardá,216,101,115
3,285,Beniarrés,1447,727,720
3,298,Benichembla,382,194,188
3,302,Benidoleig,781,375,406
3,319,Benidorm,50946,24985,25961
3,324,Benifallim,151,71,80
3,330,Benifato,136,67,69
3,345,Benijófar,1621,790,831
3,358,Benilloba,926,469,457
3,361,Benillup,95,49,46
3,377,Benimantell,417,198,219
3,383,Benimarfull,407,187,220
3,396,Benimassot,108,56,52
3,400,Benimeli,331,164,167
3,417,Benissa,9368,4652,4716
3,422,Benitachell/Poble Nou de Benitatxell (el),2002,1000,1002
3,438,Biar,3528,1711,1817
3,443,Bigastro,4784,2424,2360
3,456,Bolulla,302,148,154
3,469,Busot,1502,744,758
3,494,Callosa de Segura,15150,7547,7603
3,481,Callosa d'En Sarrià,6370,3189,3181
3,475,Calpe/Calp,14819,7418,7401
3,507,Campello (el),16173,8020,8153
3,514,Campo de Mirra/Camp de Mirra (el),382,186,196
3,529,Cañada,1096,523,573
3,535,Castalla,7583,3742,3841
3,540,Castell de Castells,471,235,236
3,553,Catral,4894,2427,2467
3,566,Cocentaina,10572,5180,5392
3,572,Confrides,283,164,119
3,588,Cox,5794,2918,2876
3,591,Crevillente,23945,12032,11913
3,612,Daya Nueva,1142,593,549
3,627,Daya Vieja,168,84,84
3,633,Dénia,28629,13955,14674
3,648,Dolores,6144,3102,3042
3,651,Elche/Elx,191713,94650,97063
3,664,Elda,52490,25578,26912
3,670,Facheca,121,65,56
3,686,Famorca,66,31,35
3,699,Finestrat,1735,858,877
3,703,Formentera del Segura,2032,992,1040
3,725,Gaianes,301,134,167
3,710,Gata de Gorgos,5008,2485,2523
3,731,Gorga,258,134,124
3,746,Granja de Rocamora,2071,1038,1033
3,759,Guadalest,177,91,86
3,762,Guardamar del Segura,8490,4231,4259
3,778,Hondón de las Nieves,1563,770,793
3,784,Hondón de los Frailes,562,281,281
3,797,Ibi,21075,10433,10642
3,801,Jacarilla,1539,772,767
3,818,Jalón/Xaló,2032,994,1038
3,823,Jávea/Xàbia,21084,10451,10633
3,839,Jijona/Xixona,7453,3486,3967
3,857,Llíber,525,261,264
3,844,Lorcha/Orxa (l'),786,393,393
3,860,Millena,144,70,74
3,882,Monforte del Cid,5163,2654,2509
3,895,Monóvar/Monòver,11978,5854,6124
3,9037,Montesinos (Los),2472,1255,1217
3,916,Murla,319,136,183
3,921,Muro de Alcoy,7140,3518,3622
3,909,Mutxamel,13267,6662,6605
3,937,Novelda,23190,11428,11762
3,942,Nucia (la),7303,3613,3690
3,955,Ondara,5216,2612,2604
3,968,Onil,6788,3402,3386
3,974,Orba,1574,761,813
3,993,Orihuela,50581,24996,25585
3,980,Orxeta,444,224,220
3,1007,Parcent,785,384,401
3,1014,Pedreguer,5815,2823,2992
3,1029,Pego,10177,5184,4993
3,1035,Penàguila,335,155,180
3,1040,Petrer,27604,13730,13874
3,9021,Pilar de la Horadada,10210,5442,4768
3,1053,Pinoso,6026,2992,3034
3,1066,Planes,809,403,406
3,9016,Poblets (els),1368,663,705
3,1072,Polop,2009,975,1034
3,605,Quatretondeta,185,92,93
3,1091,Rafal,3081,1534,1547
3,1105,"Ràfol d'Almúnia, el",364,176,188
3,1112,Redován,5348,2741,2607
3,1127,Relleu,815,405,410
3,1133,Rojales,7048,3455,3593
3,1148,Romana (la),1978,1005,973
3,1151,Sagra,389,192,197
3,1164,Salinas,1180,596,584
3,1186,San Fulgencio,3149,1572,1577
3,9042,San Isidro,1253,653,600
3,1199,San Juan de Alicante,16299,7982,8317
3,1203,San Miguel de Salinas,3594,1838,1756
3,1225,San Vicente del Raspeig/Sant Vicent del Raspeig,36291,17940,18351
3,1170,Sanet y Negrals,546,250,296
3,1210,Santa Pola,17600,8704,8896
3,1231,Sax,8581,4313,4268
3,1246,Sella,579,293,286
3,1259,Senija,479,252,227
3,1278,Tárbena,701,341,360
3,1284,Teulada,8672,4309,4363
3,1297,Tibi,1197,618,579
3,1301,Tollos,43,27,16
3,1318,Tormos,299,143,156
3,1323,Torremanzanas/Torre de les Maçanes (la),727,363,364
3,1339,Torrevieja,38336,18890,19446
3,1344,Vall d'Alcalà (la),176,82,94
3,1357,Vall de Ebo,333,171,162
3,1360,Vall de Gallinera,614,319,295
3,1376,Vall de Laguart,904,436,468
3,1382,Verger (el),3538,1699,1839
3,1395,Villajoyosa/Vila Joiosa (la),22969,11292,11677
3,1409,Villena,31532,15564,15968
4,10,Abla,1516,746,770
4,25,Abrucena,1462,716,746
4,31,Adra,21016,10521,10495
4,46,Albánchez,605,303,302
4,59,Alboloduy,813,385,428
4,62,Albox,9471,4754,4717
4,78,Alcolea,849,427,422
4,84,Alcóntar,603,308,295
4,97,Alcudia de Monteagud,159,75,84
4,101,Alhabia,675,328,347
4,118,Alhama de Almería,3111,1551,1560
4,123,Alicún,245,118,127
4,139,Almería,168025,81480,86545
4,144,Almócita,187,97,90
4,157,Alsodux,106,53,53
4,160,Antas,2666,1314,1352
4,176,Arboleas,1540,781,759
4,182,Armuña de Almanzora,330,160,170
4,195,Bacares,278,146,132
4,209,Bayárcal,334,178,156
4,216,Bayarque,237,112,125
4,221,Bédar,550,290,260
4,237,Beires,141,67,74
4,242,Benahadux,2740,1300,1440
4,268,Benitagla,86,45,41
4,274,Benizalón,324,169,155
4,280,Bentarique,319,166,153
4,293,Berja,13197,6295,6902
4,307,Canjáyar,1728,873,855
4,314,Cantoria,3206,1611,1595
4,329,Carboneras,6312,3230,3082
4,335,Castro de Filabres,181,88,93
4,366,Chercos,298,156,142
4,372,Chirivel,1837,912,925
4,340,Cóbdar,255,128,127
4,353,Cuevas del Almanzora,9495,4723,4772
4,388,Dalías,3639,1800,1839
4,9026,Ejido (El),50170,26335,23835
4,412,Enix,232,122,110
4,433,Felix,565,284,281
4,448,Fines,1716,870,846
4,451,Fiñana,2607,1281,1326
4,464,Fondón,918,469,449
4,470,Gádor,2577,1276,1301
4,486,Gallardos (Los),1738,874,864
4,499,Garrucha,5001,2530,2471
4,502,Gérgal,1063,520,543
4,519,Huécija,532,269,263
4,530,Huércal-Overa,13839,6811,7028
4,524,Huércal de Almería,5951,3005,2946
4,545,Illar,469,224,245
4,558,Instinción,545,264,281
4,561,Laroya,108,57,51
4,577,Láujar de Andarax,1830,896,934
4,583,Líjar,502,248,254
4,596,Lubrín,1780,853,927
4,600,Lucainena de las Torres,565,283,282
4,617,Lúcar,786,389,397
4,622,Macael,5828,2959,2869
4,638,María,1635,842,793
4,643,Mojácar,4525,2232,2293
4,9032,Mojonera (La),6561,3530,3031
4,656,Nacimiento,539,268,271
4,669,Níjar,15406,8017,7389
4,675,Ohanes,811,405,406
4,681,Olula de Castro,178,87,91
4,694,Olula del Río,5952,2959,2993
4,708,Oria,2121,1076,1045
4,715,Padules,491,245,246
4,720,Partaloa,381,187,194
4,736,Paterna del Río,363,197,166
4,741,Pechina,2663,1350,1313
4,754,Pulpí,5291,2559,2732
4,767,Purchena,1634,791,843
4,773,Rágol,384,175,209
4,789,Rioja,1185,586,599
4,792,Roquetas de Mar,40582,20862,19720
4,806,Santa Cruz de Marchena,219,98,121
4,813,Santa Fe de Mondújar,412,200,212
4,828,Senés,335,170,165
4,834,Serón,2673,1298,1375
4,849,Sierro,495,244,251
4,852,Somontín,500,249,251
4,865,Sorbas,2748,1389,1359
4,871,Suflí,246,125,121
4,887,Tabernas,3241,1630,1611
4,890,Taberno,1002,495,507
4,904,Tahal,368,194,174
4,911,Terque,430,222,208
4,926,Tíjola,3796,1855,1941
4,9011,Tres Villas (Las),630,333,297
4,932,Turre,2151,1054,1097
4,947,Turrillas,242,126,116
4,950,Uleila del Campo,969,496,473
4,963,Urrácal,332,161,171
4,979,Velefique,312,159,153
4,985,Vélez-Blanco,2190,1119,1071
4,998,Vélez-Rubio,6463,3084,3379
4,1002,Vera,6695,3354,3341
4,1019,Viator,3385,1638,1747
4,1024,Vícar,14973,7879,7094
4,1030,Zurgena,2081,1012,1069
5,13,Adanero,321,169,152
5,28,Adrada (La),1979,1027,952
5,52,Albornos,272,152,120
5,71,Aldeanueva de Santa Cruz,189,101,88
5,87,Aldeaseca,348,179,169
5,104,Aldehuela (La),284,139,145
5,126,Amavida,199,101,98
5,132,Arenal (El),1090,525,565
5,147,Arenas de San Pedro,6348,3127,3221
5,150,Arevalillo,136,65,71
5,163,Arévalo,7414,3595,3819
5,179,Aveinte,144,76,68
5,185,Avellaneda,38,19,19
5,198,Ávila,47650,22927,24723
5,219,Barco de Ávila (El),2649,1309,1340
5,224,Barraco (El),2025,1030,995
5,230,Barromán,256,144,112
5,245,Becedas,445,234,211
5,258,Becedillas,174,92,82
5,261,Bercial de Zapardiel,321,154,167
5,277,Berlanas (Las),347,180,167
5,296,Bernuy-Zapardiel,245,137,108
5,300,Berrocalejo de Aragona,42,22,20
5,338,Blascomillán,304,147,157
5,343,Blasconuño de Matacabras,24,13,11
5,356,Blascosancho,152,73,79
5,369,Bohodón (El),206,100,106
5,375,Bohoyo,472,240,232
5,381,Bonilla de la Sierra,198,108,90
5,394,Brabos,70,40,30
5,408,Bularros,119,65,54
5,415,Burgohondo,1221,627,594
5,420,Cabezas de Alambre,238,125,113
5,436,Cabezas del Pozo,172,91,81
5,441,Cabezas del Villar,501,264,237
5,454,Cabizuela,155,79,76
5,467,Canales,67,36,31
5,473,Candeleda,5137,2641,2496
5,489,Cantiveros,197,102,95
5,492,Cardeñosa,578,309,269
5,512,Carrera (La),292,138,154
5,527,Casas del Puerto de Villatoro,109,60,49
5,533,Casasola,176,93,83
5,548,Casavieja,1644,854,790
5,551,Casillas,896,456,440
5,564,Castellanos de Zapardiel,147,83,64
5,570,Cebreros,3317,1662,1655
5,586,Cepeda la Mora,151,79,72
5,678,Chamartín,119,67,52
5,599,Cillán,153,81,72
5,603,Cisla,195,94,101
5,610,Colilla (La),201,107,94
5,625,Collado de Contreras,274,150,124
5,631,Collado del Mirón,87,44,43
5,646,Constanzana,194,101,93
5,659,Crespos,771,401,370
5,662,Cuevas del Valle,659,357,302
5,9035,Diego del Carpio,319,175,144
5,697,Donjimeno,143,76,67
5,701,Donvidas,73,37,36
5,723,Espinosa de los Caballeros,107,60,47
5,739,Flores de Ávila,446,231,215
5,744,Fontiveros,1014,519,495
5,757,Fresnedilla,111,50,61
5,760,Fresno (El),465,238,227
5,776,Fuente el Saúz,334,177,157
5,782,Fuentes de Año,215,114,101
5,795,Gallegos de Altamiros,102,54,48
5,809,Gallegos de Sobrinos,109,50,59
5,816,Garganta del Villar,80,46,34
5,821,Gavilanes,745,423,322
5,837,Gemuño,230,108,122
5,855,Gil García,68,33,35
5,842,Gilbuena,147,81,66
5,868,Gimialcón,127,69,58
5,874,Gotarrendura,179,66,113
5,880,Grandes y San Martín,53,27,26
5,893,Guisando,688,368,320
5,907,Gutierre-Muñoz,127,64,63
5,929,Hernansancho,230,117,113
5,935,Herradón de Pinares,488,246,242
5,940,Herreros de Suso,238,119,119
5,953,Higuera de las Dueñas,322,179,143
5,966,Hija de Dios (La),118,66,52
5,972,Horcajada (La),839,410,429
5,991,Horcajo de las Torres,827,454,373
5,1005,Hornillo (El),432,222,210
5,1027,Hoyo de Pinares (El),2455,1254,1201
5,1012,Hoyocasero,414,215,199
5,1033,Hoyorredondo,128,68,60
5,1064,Hoyos de Miguel Muñoz,57,29,28
5,1048,Hoyos del Collado,50,30,20
5,1051,Hoyos del Espino,405,225,180
5,1070,Hurtumpascual,116,64,52
5,1086,Junciana,100,52,48
5,1099,Langa,605,312,293
5,1103,Lanzahíta,912,472,440
5,1131,Llanos de Tormes (Los),135,71,64
5,1125,Losar del Barco (El),147,76,71
5,1146,Madrigal de las Altas Torres,2028,1036,992
5,1159,Maello,655,322,333
5,1162,Malpartida de Corneja,228,113,115
5,1178,Mamblas,284,156,128
5,1184,Mancera de Arriba,149,73,76
5,1197,Manjabálago,76,40,36
5,1201,Marlín,51,28,23
5,1218,Martiherrero,208,110,98
5,1223,Martínez,254,133,121
5,1239,Mediana de Voltoya,109,59,50
5,1244,Medinilla,235,118,117
5,1257,Mengamuñoz,73,32,41
5,1260,Mesegar de Corneja,125,64,61
5,1276,Mijares,1013,518,495
5,1282,Mingorría,547,271,276
5,1295,Mirón (El),263,153,110
5,1309,Mironcillo,130,73,57
5,1316,Mirueña de los Infanzones,203,102,101
5,1321,Mombeltrán,1198,637,561
5,1337,Monsalupe,92,47,45
5,1342,Moraleja de Matacabras,71,34,37
5,1355,Muñana,586,304,282
5,1368,Muñico,150,80,70
5,1380,Muñogalindo,452,245,207
5,1393,Muñogrande,111,58,53
5,1407,Muñomer del Peco,137,74,63
5,1414,Muñopepe,101,53,48
5,1429,Muñosancho,169,75,94
5,1435,Muñotello,128,69,59
5,1440,Narrillos del Álamo,172,90,82
5,1453,Narrillos del Rebollar,79,40,39
5,1491,Narros de Saldueña,199,110,89
5,1472,Narros del Castillo,259,142,117
5,1488,Narros del Puerto,40,22,18
5,1526,Nava de Arévalo,1007,524,483
5,1532,Nava del Barco,201,105,96
5,1511,Navacepedilla de Corneja,148,81,67
5,1547,Navadijos,64,37,27
5,1550,Navaescurial,95,54,41
5,1563,Navahondilla,137,81,56
5,1579,Navalacruz,328,161,167
5,1585,Navalmoral,625,317,308
5,1598,Navalonguilla,456,231,225
5,1602,Navalosa,527,276,251
5,1619,Navalperal de Pinares,907,441,466
5,1624,Navalperal de Tormes,142,77,65
5,1630,Navaluenga,2009,1018,991
5,1645,Navaquesera,68,28,40
5,1658,Navarredonda de Gredos,486,252,234
5,1661,Navarredondilla,304,149,155
5,1677,Navarrevisca,402,207,195
5,1683,Navas del Marqués (Las),4315,2163,2152
5,1696,Navatalgordo,352,180,172
5,1700,Navatejares,108,49,59
5,1717,Neila de San Miguel,127,66,61
5,1722,Niharra,202,102,100
5,1738,Ojos-Albos,51,25,26
5,1743,Orbita,110,54,56
5,1756,Oso (El),222,125,97
5,1769,Padiernos,238,123,115
5,1775,Pajares de Adaja,193,98,95
5,1781,Palacios de Goda,529,263,266
5,1794,Papatrigo,337,176,161
5,1808,Parral (El),132,70,62
5,1815,Pascualcobo,49,27,22
5,1836,Pedro-Rodríguez,215,101,114
5,1820,Pedro Bernardo,1354,700,654
5,1841,Peguerinos,310,163,147
5,1854,Peñalba de Ávila,131,75,56
5,1867,Piedrahíta,2225,1088,1137
5,1873,Piedralaves,2124,1065,1059
5,1889,Poveda,90,51,39
5,1892,Poyales del Hoyo,762,390,372
5,1906,Pozanco,55,30,25
5,1913,Pradosegar,176,93,83
5,1928,Puerto Castilla,148,83,65
5,1934,Rasueros,371,194,177
5,1949,Riocabado,202,114,88
5,1952,Riofrío,330,177,153
5,1965,Rivilla de Barajas,93,49,44
5,1971,Salobral,129,65,64
5,1987,Salvadiós,126,66,60
5,1990,San Bartolomé de Béjar,82,37,45
5,2004,San Bartolomé de Corneja,124,65,59
5,2011,San Bartolomé de Pinares,753,400,353
5,2063,San Esteban de los Patos,45,25,20
5,2085,San Esteban de Zapardiel,69,34,35
5,2079,San Esteban del Valle,921,478,443
5,2098,San García de Ingelmos,175,94,81
5,9014,San Juan de Gredos,413,218,195
5,2102,San Juan de la Encinilla,142,65,77
5,2119,San Juan de la Nava,698,365,333
5,2124,San Juan del Molinillo,343,192,151
5,2130,San Juan del Olmo,180,101,79
5,2145,San Lorenzo de Tormes,66,33,33
5,2158,San Martín de la Vega del Alberche,320,180,140
5,2161,San Martín del Pimpollar,348,191,157
5,2177,San Miguel de Corneja,114,54,60
5,2183,San Miguel de Serrezuela,220,116,104
5,2196,San Pascual,59,36,23
5,2200,San Pedro del Arroyo,471,243,228
5,2315,San Vicente de Arévalo,225,113,112
5,2047,Sanchidrián,802,414,388
5,2050,Sanchorreja,135,67,68
5,2222,Santa Cruz de Pinares,213,120,93
5,2217,Santa Cruz del Valle,654,332,322
5,2269,Santa María de los Caballeros,161,81,80
5,2243,Santa María del Arroyo,141,73,68
5,2256,Santa María del Berrocal,604,283,321
5,9029,Santa María del Cubillo,398,225,173
5,2275,Santa María del Tiétar,364,193,171
5,2281,Santiago del Collado,298,184,114
5,9040,Santiago del Tormes,290,145,145
5,2294,Santo Domingo de las Posadas,92,43,49
5,2308,Santo Tomé de Zabarcos,122,67,55
5,2320,Serrada (La),137,69,68
5,2336,Serranillos,438,225,213
5,2341,Sigeres,81,38,43
5,2354,Sinlabajos,248,128,120
5,2367,Solana de Ávila,225,122,103
5,2373,Solana de Rioalmar,303,162,141
5,2389,Solosancho,1088,567,521
5,2392,Sotalbo,267,137,130
5,2406,Sotillo de la Adrada,3522,1747,1775
5,2413,Tiemblo (El),3756,1893,1863
5,2428,Tiñosillos,761,401,360
5,2434,Tolbaños,135,66,69
5,2449,Tormellas,110,54,56
5,2452,Tornadizos de Ávila,356,176,180
5,2471,Torre (La),446,244,202
5,2465,Tórtoles,127,66,61
5,2490,Umbrías,177,93,84
5,2510,Vadillo de la Sierra,167,92,75
5,2525,Valdecasa,118,61,57
5,2531,Vega de Santa María,143,78,65
5,2546,Velayos,278,136,142
5,2562,Villaflor,168,88,80
5,2578,Villafranca de la Sierra,232,127,105
5,9053,Villanueva de Ávila,552,279,273
5,2584,Villanueva de Gómez,146,70,76
5,2597,Villanueva del Aceral,202,92,110
5,2601,Villanueva del Campillo,216,111,105
5,2618,Villar de Corneja,83,42,41
5,2623,Villarejo del Valle,508,262,246
5,2639,Villatoro,235,136,99
5,2644,Viñegra de Moraña,98,53,45
5,2657,Vita,118,72,46
5,2660,Zapardiel de la Cañada,204,103,101
5,2676,Zapardiel de la Ribera,146,73,73
6,16,Acedera,1001,527,474
6,21,Aceuchal,5240,2595,2645
6,37,Ahillones,1227,602,625
6,42,Alange,2035,1042,993
6,55,Albuera (La),1788,914,874
6,68,Alburquerque,5660,2843,2817
6,74,Alconchel,2153,1058,1095
6,80,Alconera,746,371,375
6,93,Aljucén,230,125,105
6,107,Almendral,1516,755,761
6,114,Almendralejo,27443,13385,14058
6,129,Arroyo de San Serván,3994,2062,1932
6,135,Atalaya,374,176,198
6,140,Azuaga,9091,4589,4502
6,153,Badajoz,134710,65330,69380
6,166,Barcarrota,3744,1904,1840
6,172,Baterno,411,213,198
6,188,Benquerencia de la Serena,1075,550,525
6,191,Berlanga,2716,1322,1394
6,205,Bienvenida,2366,1222,1144
6,212,Bodonal de la Sierra,1280,663,617
6,227,Burguillos del Cerro,3346,1624,1722
6,233,Cabeza del Buey,6067,2977,3090
6,248,Cabeza la Vaca,1666,819,847
6,251,Calamonte,6003,3011,2992
6,264,Calera de León,1118,560,558
6,270,Calzadilla de los Barros,845,414,431
6,286,Campanario,5777,2809,2968
6,299,Campillo de Llerena,1784,872,912
6,303,Capilla,228,107,121
6,310,Carmonita,680,352,328
6,325,Carrascalejo (El),37,19,18
6,331,Casas de Don Pedro,1766,878,888
6,346,Casas de Reina,254,120,134
6,359,Castilblanco,1428,701,727
6,362,Castuera,7526,3733,3793
6,423,Cheles,1378,690,688
6,378,Codosera (La),2376,1236,1140
6,384,Cordobilla de Lácara,1030,519,511
6,397,Coronada (La),2486,1244,1242
6,401,Corte de Peleas,1283,644,639
6,418,Cristina,573,304,269
6,439,Don Álvaro,672,335,337
6,444,Don Benito,31350,15462,15888
6,457,Entrín Bajo,682,338,344
6,460,Esparragalejo,1552,754,798
6,476,Esparragosa de la Serena,1138,562,576
6,482,Esparragosa de Lares,1235,595,640
6,495,Feria,1426,709,717
6,508,Fregenal de la Sierra,5360,2570,2790
6,515,Fuenlabrada de los Montes,2063,1018,1045
6,520,Fuente de Cantos,5045,2548,2497
6,536,Fuente del Arco,838,418,420
6,541,Fuente del Maestre,6815,3394,3421
6,554,Fuentes de León,2789,1367,1422
6,567,Garbayuela,596,317,279
6,573,Garlitos,784,393,391
6,589,Garrovilla (La),2618,1353,1265
6,592,Granja de Torrehermosa,2637,1316,1321
6,606,Guareña,7393,3718,3675
6,613,Haba (La),1465,741,724
6,628,Helechosa de los Montes,789,428,361
6,634,Herrera del Duque,4018,2031,1987
6,649,Higuera de la Serena,1275,650,625
6,652,Higuera de Llerena,478,236,242
6,665,Higuera de Vargas,2239,1119,1120
6,671,Higuera la Real,2696,1347,1349
6,687,Hinojosa del Valle,605,307,298
6,690,Hornachos,3814,1973,1841
6,704,Jerez de los Caballeros,9409,4693,4716
6,711,Lapa (La),341,173,168
6,732,Llera,1001,512,489
6,747,Llerena,5687,2747,2940
6,726,Lobón,2736,1404,1332
6,750,Magacela,734,377,357
6,763,Maguilla,1155,573,582
6,779,Malcocinado,562,299,263
6,785,Malpartida de la Serena,800,406,394
6,798,Manchita,775,388,387
6,802,Medellín,2452,1234,1218
6,819,Medina de las Torres,1536,773,763
6,824,Mengabril,465,241,224
6,830,Mérida,50471,24660,25811
6,845,Mirandilla,1389,696,693
6,858,Monesterio,5252,2631,2621
6,861,Montemolín,1736,900,836
6,877,Monterrubio de la Serena,3138,1543,1595
6,883,Montijo,15498,7618,7880
6,896,Morera (La),784,387,397
6,900,Nava de Santiago (La),1204,602,602
6,917,Navalvillar de Pela,5055,2542,2513
6,922,Nogales,798,396,402
6,938,Oliva de la Frontera,6002,2993,3009
6,943,Oliva de Mérida,2023,1006,1017
6,956,Olivenza,10558,5220,5338
6,969,Orellana de la Sierra,392,200,192
6,975,Orellana la Vieja,3586,1798,1788
6,981,Palomas,709,380,329
6,994,Parra (La),1401,723,678
6,1008,Peñalsordo,1592,757,835
6,1015,Peraleda del Zaucejo,682,345,337
6,1020,Puebla de Alcocer,1488,733,755
6,1036,Puebla de la Calzada,5520,2727,2793
6,1041,Puebla de la Reina,868,446,422
6,1073,Puebla de Obando,2045,1033,1012
6,1089,Puebla de Sancho Pérez,2940,1483,1457
6,1054,Puebla del Maestre,960,471,489
6,1067,Puebla del Prior,595,298,297
6,1092,Quintana de la Serena,5162,2596,2566
6,1106,Reina,237,126,111
6,1113,Rena,676,340,336
6,1128,Retamal de Llerena,590,303,287
6,1134,Ribera del Fresno,3331,1624,1707
6,1149,Risco,231,113,118
6,1152,Roca de la Sierra (La),1645,813,832
6,1165,Salvaleón,2330,1197,1133
6,1171,Salvatierra de los Barros,2001,988,1013
6,1190,San Pedro de Mérida,810,416,394
6,1232,San Vicente de Alcántara,5930,2924,3006
6,1187,Sancti-Spíritus,303,145,158
6,1204,Santa Amalia,4356,2176,2180
6,1211,Santa Marta,4081,2001,2080
6,1226,Santos de Maimona (Los),7929,3939,3990
6,1247,Segura de León,2325,1155,1170
6,1250,Siruela,2528,1248,1280
6,1263,Solana de los Barros,2813,1424,1389
6,1279,Talarrubias,3731,1842,1889
6,1285,Talavera la Real,5338,2703,2635
6,1298,Táliga,752,385,367
6,1302,Tamurejo,290,144,146
6,1319,Torre de Miguel Sesmero,1267,622,645
6,1324,Torremayor,1121,554,567
6,1330,Torremejía,2030,1029,1001
6,1345,Trasierra,701,375,326
6,1358,Trujillanos,1316,689,627
6,1361,Usagre,2124,1071,1053
6,1377,Valdecaballeros,1475,743,732
6,9017,Valdelacalzada,2580,1331,1249
6,1383,Valdetorres,1394,709,685
6,1396,Valencia de las Torres,875,441,434
6,1400,Valencia del Mombuey,839,408,431
6,1417,Valencia del Ventoso,2417,1180,1237
6,1469,Valle de la Serena,1633,803,830
6,1475,Valle de Matamoros,522,256,266
6,1481,Valle de Santa Ana,1271,644,627
6,1422,Valverde de Burguillos,390,198,192
6,1438,Valverde de Leganés,3745,1892,1853
6,1443,Valverde de Llerena,864,417,447
6,1456,Valverde de Mérida,1150,576,574
6,1494,Villafranca de los Barros,12444,6147,6297
6,1507,Villagarcía de la Torre,1036,526,510
6,1514,Villagonzalo,1504,725,779
6,1529,Villalba de los Barros,1757,900,857
6,1535,Villanueva de la Serena,23745,11719,12026
6,1540,Villanueva del Fresno,3332,1671,1661
6,1566,Villar de Rena,1720,914,806
6,1553,Villar del Rey,2336,1197,1139
6,1572,Villarta de los Montes,707,348,359
6,1588,Zafra,15001,7196,7805
6,1591,Zahínos,3096,1551,1545
6,1605,Zalamea de la Serena,4712,2322,2390
6,1612,Zarza-Capilla,526,278,248
6,1627,Zarza (La),3622,1838,1784
7,27,Alaior,7046,3490,3556
7,12,Alaró,3834,1834,2000
7,33,Alcúdia,10581,5345,5236
7,48,Algaida,3542,1766,1776
7,51,Andraitx,8333,4164,4169
7,9013,Ariany,772,379,393
7,64,Artà,5936,2963,2973
7,70,Bañalbufar,503,264,239
7,86,Binissalem,5019,2424,2595
7,99,Búger,951,470,481
7,103,Bunyola,4338,2144,2194
7,110,Calvià,32587,16293,16294
7,125,Campanet,2277,1115,1162
7,131,Campos,6944,3478,3466
7,146,Capdepera,6752,3374,3378
7,645,Castell (Es),6005,3017,2988
7,159,Ciutadella de Menorca,21785,10853,10932
7,162,Consell,2210,1090,1120
7,178,Costitx,849,415,434
7,184,Deyá,625,311,314
7,260,Eivissa,31582,15728,15854
7,197,Escorca,275,148,127
7,201,Esporles,3811,1900,1911
7,218,Estellenchs,338,176,162
7,223,Felanitx,14600,7268,7332
7,239,Ferreries,3921,2050,1871
7,244,Formentera,5859,2966,2893
7,257,Fornalutx,580,290,290
7,276,Inca,21103,10425,10678
7,282,Lloret de Vista Alegre,837,415,422
7,295,Lloseta,4529,2231,2298
7,309,Llubí,1893,926,967
7,316,Llucmajor,21771,10804,10967
7,321,Mahón,22358,10878,11480
7,337,Manacor,30177,14988,15189
7,342,Mancor de la Vall,936,453,483
7,355,María de la Salud,1733,861,872
7,368,Marratxí,18084,9101,8983
7,374,Mercadal (Es),2723,1353,1370
7,9028,Migjorn Gran (Es),1126,576,550
7,380,Montuïri,2235,1105,1130
7,393,Muro,6028,2979,3049
7,407,Palma de Mallorca,319181,154748,164433
7,414,Petra,2571,1244,1327
7,440,Pobla (Sa),10064,5169,4895
7,429,Pollença,13450,6713,6737
7,435,Porreres,4226,2102,2124
7,453,Puigpunyent,1163,576,587
7,598,Salines (Ses),3240,1642,1598
7,488,San José,13364,6815,6549
7,466,Sant Antoni de Portmany,14849,7507,7342
7,491,Sant Joan,1662,826,836
7,504,Sant Joan de Labritja,3943,1991,1952
7,511,Sant Llorenç des Cardassar,5594,2793,2801
7,526,Sant Lluís,4106,2058,2048
7,532,Santa Eugènia,1114,548,566
7,547,Santa Eulalia del Río,20306,10274,10032
7,550,Santa Margalida,7107,3532,3575
7,563,Santa María del Camí,4558,2243,2315
7,579,Santanyí,7974,4026,3948
7,585,Selva,2918,1425,1493
7,472,Sencelles,1969,1009,960
7,602,Sineu,2616,1278,1338
7,619,Sóller,11207,5565,5642
7,624,Son Servera,8065,4061,4004
7,630,Valldemosa,1599,779,820
7,658,Vilafranca de Bonany,2249,1101,1148
8,18,Abrera,7373,3791,3582
8,23,Aguilar de Segarra,211,104,107
8,142,Aiguafreda,2150,1047,1103
8,39,Alella,7889,3901,3988
8,44,Alpens,273,150,123
8,57,Ametlla del Vallès (L'),5041,2477,2564
8,60,Arenys de Mar,12238,5904,6334
8,76,Arenys de Munt,5759,2837,2922
8,82,Argençola,163,79,84
8,95,Argentona,8959,4476,4483
8,109,Artés,4271,2123,2148
8,116,Avià,1813,919,894
8,121,Avinyó,2000,990,1010
8,137,Avinyonet del Penedès,1187,622,565
8,155,Badalona,209606,103498,106108
8,9045,Badia del Vallès,16085,8110,7975
8,168,Bagà,2096,1014,1082
8,174,Balenyà,3119,1554,1565
8,180,Balsareny,3268,1613,1655
8,2520,Barberà del Vallès,26112,13109,13003
8,193,Barcelona,1505581,703231,802350
8,207,Begues,3580,1812,1768
8,214,Bellprat,89,50,39
8,229,Berga,14173,6910,7263
8,235,Bigues i Riells,4629,2414,2215
8,240,Borredà,457,221,236
8,253,Bruc (El),928,483,445
8,266,Brull (El),191,104,87
8,272,Cabanyes (Les),505,268,237
8,291,Cabrera de Mar,3561,1809,1752
8,288,Cabrera d'Igualada,384,217,167
8,305,Cabrils,4112,1992,2120
8,312,Calaf,3055,1499,1556
8,348,Calders,698,365,333
8,333,Caldes de Montbui,12673,6261,6412
8,327,Caldes d'Estrac,1808,858,950
8,351,Calella,12187,5800,6387
8,370,Calldetenes,1872,950,922
8,386,Callús,1334,658,676
8,364,Calonge de Segarra,188,99,89
8,399,Campins,262,129,133
8,403,Canet de Mar,9613,4708,4905
8,410,Canovelles,13106,6599,6507
8,425,Cànoves i Samalús,1659,843,816
8,431,Canyelles,1534,810,724
8,446,Capellades,4974,2425,2549
8,459,Capolat,68,41,27
8,462,Cardedeu,11317,5630,5687
8,478,Cardona,5720,2775,2945
8,484,Carme,677,349,328
8,497,Casserres,1628,783,845
8,575,Castell de l'Areny,48,30,18
8,522,Castellar de n'Hug,175,87,88
8,500,Castellar del Riu,98,55,43
8,517,Castellar del Vallès,16224,8106,8118
8,538,Castellbell i el Vilar,2604,1294,1310
8,543,Castellbisbal,6702,3437,3265
8,556,Castellcir,335,188,147
8,569,Castelldefels,41194,20529,20665
8,581,Castellet i la Gornal,1308,658,650
8,608,Castellfollit de Riubregós,239,119,120
8,594,Castellfollit del Boix,364,178,186
8,615,Castellgalí,853,440,413
8,620,Castellnou de Bages,415,217,198
8,636,Castellolí,432,222,210
8,641,Castellterçol,2013,977,1036
8,654,Castellví de la Marca,1459,738,721
8,667,Castellví de Rosanes,996,515,481
8,673,Centelles,5728,2836,2892
8,2687,Cercs,1483,727,756
8,2665,Cerdanyola del Vallès,51305,25710,25595
8,689,Cervelló,7682,3870,3812
8,692,Collbató,1712,922,790
8,706,Collsuspina,262,134,128
8,713,Copons,271,130,141
8,728,Corbera de Llobregat,8246,4179,4067
8,734,Cornellà de Llobregat,80329,39415,40914
8,749,Cubelles,5390,2709,2681
8,752,Dosrius,2538,1304,1234
8,765,Esparreguera,15548,7835,7713
8,771,Esplugues de Llobregat,46304,22823,23481
8,787,Espunyola (L'),282,145,137
8,790,Estany (L'),390,185,205
8,1347,Figaró-Montmany,777,409,368
8,804,Fígols,53,29,24
8,811,Fogars de Montclús,309,165,144
8,826,Fogars de Tordera,642,329,313
8,832,Folgueroles,1404,707,697
8,847,Fonollosa,852,434,418
8,850,Font-rubí,1225,630,595
8,863,Franqueses del Vallès (Les),11156,5581,5575
8,902,Gaià,164,88,76
8,879,Gallifa,157,84,73
8,885,Garriga (La),10929,5277,5652
8,898,Gavà,38813,19352,19461
8,919,Gelida,4220,2093,2127
8,924,Gironella,5001,2421,2580
8,930,Gisclareny,33,18,15
8,945,Granada (La),1325,634,691
8,958,Granera,59,37,22
8,961,Granollers,51600,25183,26417
8,977,Gualba,737,388,349
8,996,Guardiola de Berguedà,1003,507,496
8,1000,Gurb,1852,943,909
8,1017,Hospitalet de Llobregat (L'),248521,121667,126854
8,1629,Hostalets de Pierola (Els),1209,627,582
8,1022,Igualada,32526,15774,16752
8,1038,Jorba,575,272,303
8,1043,Llacuna (La),811,417,394
8,1056,Llagosta (La),11554,5739,5815
8,1075,Lliçà d'Amunt,8530,4440,4090
8,1081,Lliçà de Vall,4757,2440,2317
8,1069,Llinars del Vallès,6468,3262,3206
8,1094,Lluçà,281,154,127
8,1108,Malgrat de Mar,13012,6442,6570
8,1115,Malla,255,122,133
8,1120,Manlleu,17172,8507,8665
8,1136,Manresa,64067,30728,33339
8,2423,Marganell,213,95,118
8,1141,Martorell,18916,9501,9415
8,1154,Martorelles,4912,2482,2430
8,1167,Masies de Roda (Les),632,313,319
8,1173,Masies de Voltregà (Les),2608,1272,1336
8,1189,Masnou (El),20794,10011,10783
8,1192,Masquefa,3764,1905,1859
8,1206,Matadepera,6362,3192,3170
8,1213,Mataró,103265,50636,52629
8,1228,Mediona,1304,668,636
8,1385,Moià,3846,1884,1962
8,1234,Molins de Rei,18960,9322,9638
8,1249,Mollet del Vallès,44170,22067,22103
8,1287,Monistrol de Calders,614,299,315
8,1271,Monistrol de Montserrat,2487,1251,1236
8,1252,Montcada i Reixac,26886,13242,13644
8,1304,Montclar,120,60,60
8,1311,Montesquiu,850,421,429
8,1265,Montgat,7783,3827,3956
8,1326,Montmajor,488,249,239
8,1332,Montmaneu,201,110,91
8,1350,Montmeló,8059,4007,4052
8,1363,Montornès del Vallès,12098,6052,6046
8,1379,Montseny,286,150,136
8,1290,Muntanyola,266,144,122
8,1398,Mura,218,119,99
8,1402,Navarcles,5312,2617,2695
8,1419,Navàs,5792,2850,2942
8,1424,Nou de Berguedà (La),151,80,71
8,1430,Òdena,2667,1324,1343
8,1458,Olèrdola,2058,1051,1007
8,1461,Olesa de Bonesvalls,785,413,372
8,1477,Olesa de Montserrat,16356,8227,8129
8,1483,Olivella,1051,578,473
8,1496,Olost,1199,586,613
8,1445,Olvan,922,449,473
8,1509,Orís,237,120,117
8,1516,Oristà,662,328,334
8,1521,Orpí,147,77,70
8,1537,Òrrius,419,216,203
8,1542,Pacs del Penedès,635,319,316
8,1555,Palafolls,4612,2311,2301
8,1568,Palau de Plegamans,10393,5303,5090
8,1574,Pallejà,7001,3501,3500
8,1580,Papiol (El),3427,1700,1727
8,1593,Parets del Vallès,13513,6824,6689
8,1607,Perafita,336,167,169
8,1614,Piera,8031,4089,3942
8,1635,Pineda de Mar,18585,9279,9306
8,1640,Pla del Penedès (El),917,459,458
8,1653,Pobla de Claramunt (La),1657,840,817
8,1666,Pobla de Lillet (La),1527,749,778
8,1672,Polinyà,4246,2172,2074
8,1825,Pont de Vilomara i Rocafort (El),2483,1263,1220
8,1688,Pontons,299,160,139
8,1691,Prat de Llobregat (El),62514,31227,31287
8,1712,Prats de Lluçanès,2741,1348,1393
8,1705,Prats de Rei (Els),558,274,284
8,2303,Premià de Dalt,8043,4041,4002
8,1727,Premià de Mar,25529,12735,12794
8,1751,Puig-reig,4436,2137,2299
8,1748,Puigdàlber,319,147,172
8,1764,Pujalt,185,95,90
8,1770,Quar (La),60,31,29
8,1786,Rajadell,345,182,163
8,1799,Rellinars,343,174,169
8,1803,Ripollet,29155,14575,14580
8,1810,Roca del Vallès (La),6953,3481,3472
8,1831,Roda de Ter,5076,2448,2628
8,1846,Rubí,55728,27890,27838
8,1859,Rubió,118,61,57
8,9019,Rupit i Pruit,343,173,170
8,1878,Sabadell,184859,89881,94978
8,1884,Sagàs,159,85,74
8,1901,Saldes,346,190,156
8,1918,Sallent,7287,3526,3761
8,1944,Sant Adrià de Besòs,32830,16212,16618
8,1957,Sant Agustí de Lluçanès,107,55,52
8,1960,Sant Andreu de la Barca,18854,9602,9252
8,1976,Sant Andreu de Llavaneres,6418,3183,3235
8,1982,Sant Antoni de Vilamajor,3063,1528,1535
8,1995,Sant Bartomeu del Grau,1224,657,567
8,2009,Sant Boi de Llobregat,78632,39121,39511
8,2016,Sant Boi de Lluçanès,554,275,279
8,2037,Sant Cebrià de Vallalta,1470,780,690
8,2021,Sant Celoni,12840,6382,6458
8,2042,Sant Climent de Llobregat,2719,1342,1377
8,2055,Sant Cugat del Vallès,50529,24904,25625
8,2068,Sant Cugat Sesgarrigues,734,384,350
8,2074,Sant Esteve de Palautordera,1324,668,656
8,2080,Sant Esteve Sesrovires,4682,2517,2165
8,2107,Sant Feliu de Codines,4115,2010,2105
8,2114,Sant Feliu de Llobregat,35958,17753,18205
8,2129,Sant Feliu Sasserra,648,318,330
8,2093,Sant Fost de Campsentelles,5854,2965,2889
8,2135,Sant Fruitós de Bages,5330,2662,2668
8,2153,Sant Hipòlit de Voltregà,2947,1439,1508
8,1939,Sant Iscle de Vallalta,725,383,342
8,2166,Sant Jaume de Frontanyà,30,16,14
8,2188,Sant Joan de Vilatorrada,8676,4351,4325
8,2172,Sant Joan Despí,27338,13496,13842
8,9030,Sant Julià de Cerdanyola,219,117,102
8,2205,Sant Julià de Vilatorta,2141,1044,1097
8,2212,Sant Just Desvern,13682,6611,7071
8,2227,Sant Llorenç d'Hortons,1422,715,707
8,2233,Sant Llorenç Savall,2027,987,1040
8,2251,Sant Martí d'Albars,129,66,63
8,2248,Sant Martí de Centelles,687,352,335
8,2264,Sant Martí de Tous,952,471,481
8,2270,Sant Martí Sarroca,2457,1240,1217
8,2286,Sant Martí Sesgueioles,355,176,179
8,2299,Sant Mateu de Bages,513,262,251
8,2310,Sant Pere de Ribes,20213,10189,10024
8,2325,Sant Pere de Riudebitlles,2082,1018,1064
8,2331,Sant Pere de Torelló,2169,1046,1123
8,2346,Sant Pere de Vilamajor,2178,1129,1049
8,1897,Sant Pere Sallavinera,164,82,82
8,2359,Sant Pol de Mar,3170,1623,1547
8,2362,Sant Quintí de Mediona,1617,802,815
8,2378,Sant Quirze de Besora,2005,973,1032
8,2384,Sant Quirze del Vallès,11287,5620,5667
8,2397,Sant Quirze Safaja,305,167,138
8,2401,Sant Sadurní d'Anoia,9343,4651,4692
8,2418,Sant Sadurní d'Osormort,76,42,34
8,983,Sant Salvador de Guardiola,1786,905,881
8,2628,Sant Vicenç de Castellet,7386,3536,3850
8,2649,Sant Vicenç de Montalt,2638,1334,1304
8,2652,Sant Vicenç de Torelló,1729,825,904
8,2634,Sant Vicenç dels Horts,23504,11809,11695
8,2439,Santa Cecília de Voltregà,198,111,87
8,2444,Santa Coloma de Cervelló,3668,1825,1843
8,2457,Santa Coloma de Gramenet,120958,60170,60788
8,2460,Santa Eugènia de Berga,1938,997,941
8,2476,Santa Eulàlia de Riuprimer,859,444,415
8,2482,Santa Eulàlia de Ronçana,4178,2110,2068
8,2495,Santa Fe del Penedès,261,126,135
8,2508,Santa Margarida de Montbui,9216,4595,4621
8,2515,Santa Margarida i els Monjos,4088,2091,1997
8,2536,Santa Maria de Besora,175,88,87
8,2541,Santa Maria de Corcó,2049,1032,1017
8,2567,Santa Maria de Martorelles,692,335,357
8,2554,Santa Maria de Merlès,169,83,86
8,2573,Santa Maria de Miralles,94,45,49
8,2592,Santa Maria de Palautordera,5795,2916,2879
8,2589,Santa Maria d'Oló,988,501,487
8,2606,Santa Perpètua de Mogoda,18233,9195,9038
8,2613,Santa Susanna,1660,830,830
8,1923,Santpedor,5156,2531,2625
8,2671,Sentmenat,5363,2654,2709
8,2690,Seva,2376,1211,1165
8,2704,Sitges,17600,3693,13907
8,2711,Sobremunt,95,47,48
8,2726,Sora,181,96,85
8,2732,Subirats,2376,1208,1168
8,2747,Súria,6265,3069,3196
8,2763,Tagamanent,195,108,87
8,2779,Talamanca,79,42,37
8,2785,Taradell,4854,2405,2449
8,2750,Tavèrnoles,250,119,131
8,2802,Tavertet,141,75,66
8,2819,Teià,4847,2444,2403
8,2798,Terrassa,165654,80719,84935
8,2824,Tiana,5385,2678,2707
8,2830,Tona,5799,2859,2940
8,2845,Tordera,9181,4650,4531
8,2858,Torelló,12031,5857,6174
8,2861,Torre de Claramunt (La),2098,1089,1009
8,2877,Torrelavit,1161,588,573
8,2883,Torrelles de Foix,1702,901,801
8,2896,Torrelles de Llobregat,3216,1623,1593
8,2900,Ullastrell,1021,521,500
8,2917,Vacarisses,2084,1093,991
8,2922,Vallbona d'Anoia,1046,534,512
8,2938,Vallcebre,285,155,130
8,2943,Vallgorguina,1186,606,580
8,2956,Vallirana,8914,4517,4397
8,2969,Vallromanes,1127,583,544
8,2975,Veciana,154,82,72
8,2981,Vic,30739,14784,15955
8,2994,Vilada,538,278,260
8,3015,Viladecans,54840,27643,27197
8,3008,Viladecavalls,5155,2593,2562
8,3054,Vilafranca del Penedès,28925,14169,14756
8,3067,Vilalba Sasserra,326,171,155
8,3036,Vilanova de Sau,304,142,162
8,3020,Vilanova del Camí,10056,5067,4989
8,9024,Vilanova del Vallès,2169,1098,1071
8,3073,Vilanova i la Geltrú,50244,24682,25562
8,2140,Vilassar de Dalt,7264,3588,3676
8,2191,Vilassar de Mar,16024,7892,8132
8,3041,Vilobí del Penedès,852,438,414
8,3089,Viver i Serrateix,184,98,86
9,11,Abajas,34,16,18
9,32,Adrada de Haza,295,157,138
9,63,Aguas Cándidas,90,51,39
9,79,Aguilar de Bureba,93,51,42
9,98,Albillos,158,89,69
9,102,Alcocero de Mola,57,34,23
9,119,Alfoz de Bricia,136,63,73
9,9070,Alfoz de Quintanadueñas,601,316,285
9,124,Alfoz de Santa Gadea,152,81,71
9,130,Altable,61,38,23
9,145,Altos (Los),236,138,98
9,161,Ameyugo,60,32,28
9,177,Anguix,155,77,78
9,183,Aranda de Duero,29641,14765,14876
9,196,Arandilla,191,110,81
9,200,Arauzo de Miel,391,214,177
9,217,Arauzo de Salce,78,45,33
9,222,Arauzo de Torre,112,61,51
9,238,Arcos,242,132,110
9,243,Arenillas de Riopisuerga,239,128,111
9,256,Arija,244,116,128
9,269,Arlanzón,425,230,195
9,275,Arraya de Oca,54,27,27
9,294,Atapuerca,207,105,102
9,308,Ausines (Los),130,73,57
9,320,Avellanosa de Muñó,167,86,81
9,336,Bahabón de Esgueva,141,82,59
9,341,Balbases (Los),388,201,187
9,354,Baños de Valdearados,491,270,221
9,367,Bañuelos de Bureba,47,29,18
9,373,Barbadillo de Herreros,156,85,71
9,389,Barbadillo del Mercado,178,100,78
9,392,Barbadillo del Pez,117,62,55
9,413,Barrio de Muñó,35,21,14
9,434,Barrios de Bureba (Los),282,152,130
9,449,Barrios de Colina,74,41,33
9,452,Basconcillos del Tozo,393,210,183
9,465,Bascuñana,74,42,32
9,471,Belbimbre,74,41,33
9,487,Belorado,2092,1042,1050
9,503,Berberana,85,41,44
9,510,Berlangas de Roa,277,142,135
9,525,Berzosa de Bureba,53,31,22
9,546,Bozoó,107,58,49
9,559,Brazacorta,106,59,47
9,562,Briviesca,6105,3033,3072
9,578,Bugedo,100,72,28
9,584,Buniel,169,91,78
9,597,Burgos,161984,78133,83851
9,601,Busto de Bureba,252,131,121
9,618,Cabañes de Esgueva,279,146,133
9,623,Cabezón de la Sierra,75,34,41
9,639,Cabia,243,129,114
9,644,Caleruega,431,230,201
9,657,Campillo de Aranda,196,104,92
9,660,Campolara,105,57,48
9,676,Canicosa de la Sierra,635,326,309
9,682,Cantabrana,58,31,27
9,709,Carazo,47,26,21
9,716,Carcedo de Bureba,36,19,17
9,721,Carcedo de Burgos,142,81,61
9,737,Cardeñadijo,478,246,232
9,742,Cardeñajimeno,400,213,187
9,755,Cardeñuela Riopico,72,35,37
9,768,Carrias,52,35,17
9,774,Cascajares de Bureba,62,35,27
9,780,Cascajares de la Sierra,22,9,13
9,793,Castellanos de Castro,71,39,32
9,835,Castil de Peones,34,17,17
9,829,Castildelgado,80,40,40
9,840,Castrillo de la Reina,302,184,118
9,853,Castrillo de la Vega,593,319,274
9,888,Castrillo de Riopisuerga,96,51,45
9,866,Castrillo del Val,382,214,168
9,905,Castrillo Matajudíos,81,41,40
9,912,Castrojeriz,1041,535,506
9,933,Cayuela,122,71,51
9,948,Cebrecos,78,47,31
9,951,Celada del Camino,92,42,50
9,986,Cerezo de Río Tirón,791,420,371
9,1003,Cerratón de Juarros,72,39,33
9,1010,Ciadoncha,135,79,56
9,1025,Cillaperlata,74,40,34
9,1031,Cilleruelo de Abajo,339,189,150
9,1046,Cilleruelo de Arriba,93,50,43
9,1059,Ciruelos de Cervera,171,89,82
9,1084,Cogollos,221,121,100
9,1097,Condado de Treviño,915,514,401
9,1101,Contreras,121,77,44
9,1123,Coruña del Conde,164,90,74
9,1139,Covarrubias,634,331,303
9,1144,Cubillo del Campo,73,41,32
9,1157,Cubo de Bureba,127,64,63
9,1176,Cueva de Roa (La),118,67,51
9,1195,Cuevas de San Clemente,66,31,35
9,1209,Encío,60,32,28
9,1221,Espinosa de Cervera,117,70,47
9,1242,Espinosa de los Monteros,2236,1143,1093
9,1237,Espinosa del Camino,47,24,23
9,1255,Estépar,851,455,396
9,1274,Fontioso,90,49,41
9,1280,Frandovínez,95,52,43
9,1293,Fresneda de la Sierra Tirón,103,57,46
9,1307,Fresneña,120,66,54
9,1314,Fresnillo de las Dueñas,301,155,146
9,1329,Fresno de Río Tirón,268,154,114
9,1335,Fresno de Rodilla,37,21,16
9,1340,Frías,312,167,145
9,1353,Fuentebureba,80,38,42
9,1366,Fuentecén,289,158,131
9,1372,Fuentelcésped,198,94,104
9,1388,Fuentelisendo,115,57,58
9,1391,Fuentemolinos,127,73,54
9,1405,Fuentenebro,207,111,96
9,1412,Fuentespina,597,318,279
9,1433,Galbarros,33,23,10
9,1448,Gallega (La),98,57,41
9,1486,Grijalba,134,65,69
9,1499,Grisaleña,51,32,19
9,1519,Gumiel de Hizán,629,336,293
9,1524,Gumiel de Mercado,401,216,185
9,1545,Hacinas,213,116,97
9,1558,Haza,44,21,23
9,1596,Hontanas,77,41,36
9,1600,Hontangas,153,88,65
9,1622,Hontoria de la Cantera,124,64,60
9,1643,Hontoria de Valdearados,234,143,91
9,1638,Hontoria del Pinar,920,491,429
9,1669,Hormazas (Las),148,80,68
9,1675,Hornillos del Camino,77,43,34
9,1681,Horra (La),458,239,219
9,1694,Hortigüela,125,80,45
9,1708,Hoyales de Roa,313,153,160
9,1720,Huérmeces,153,85,68
9,1736,Huerta de Arriba,195,101,94
9,1741,Huerta de Rey,1181,621,560
9,1754,Humada,237,137,100
9,1767,Hurones,61,39,22
9,1773,Ibeas de Juarros,979,537,442
9,1789,Ibrillos,100,58,42
9,1792,Iglesiarrubia,67,35,32
9,1806,Iglesias,187,102,85
9,1813,Isar,436,203,233
9,1828,Itero del Castillo,128,68,60
9,1834,Jaramillo de la Fuente,33,20,13
9,1849,Jaramillo Quemado,17,13,4
9,1890,Junta de Traslaloma,208,111,97
9,1904,Junta de Villalba de Losa,96,47,49
9,1911,Jurisdicción de Lara,82,47,35
9,1926,Jurisdicción de San Zadornil,102,51,51
9,1947,Lerma,2530,1262,1268
9,1950,Llano de Bureba,61,35,26
9,1963,Madrigal del Monte,192,104,88
9,1979,Madrigalejo del Monte,170,94,76
9,1985,Mahamud,168,84,84
9,1998,Mambrilla de Castrejón,159,82,77
9,2002,Mambrillas de Lara,80,40,40
9,2019,Mamolar,78,41,37
9,2024,Manciles,51,28,23
9,2061,Mazuela,89,48,41
9,2083,Mecerreyes,311,161,150
9,2096,Medina de Pomar,5026,2518,2508
9,2117,Melgar de Fernamental,2038,1041,997
9,2138,Merindad de Cuesta-Urria,509,289,220
9,2143,Merindad de Montija,972,531,441
9,9064,Merindad de Río Ubierna,1245,634,611
9,2156,Merindad de Sotoscueva,599,318,281
9,2169,Merindad de Valdeporres,528,274,254
9,2175,Merindad de Valdivielso,573,297,276
9,2181,Milagros,454,242,212
9,2194,Miranda de Ebro,35397,17483,17914
9,2208,Miraveche,116,65,51
9,2215,Modúbar de la Emparedada,250,137,113
9,2236,Monasterio de la Sierra,37,22,15
9,2241,Monasterio de Rodilla,229,126,103
9,2254,Moncalvillo,132,78,54
9,2267,Monterrubio de la Demanda,90,49,41
9,2273,Montorio,166,82,84
9,2289,Moradillo de Roa,224,120,104
9,2292,Nava de Roa,275,145,130
9,2306,Navas de Bureba,52,26,26
9,2313,Nebreda,108,67,41
9,2328,Neila,232,111,121
9,2352,Olmedillo de Roa,221,117,104
9,2365,Olmillos de Muñó,46,25,21
9,2387,Oña,1674,837,837
9,2390,Oquillas,78,41,37
9,2411,Orbaneja Riopico,137,75,62
9,2426,Padilla de Abajo,104,61,43
9,2432,Padilla de Arriba,134,71,63
9,2447,Padrones de Bureba,79,43,36
9,2463,Palacios de la Sierra,913,477,436
9,2479,Palacios de Riopisuerga,31,16,15
9,2485,Palazuelos de la Sierra,64,32,32
9,2498,Palazuelos de Muñó,73,41,32
9,2501,Pampliega,427,214,213
9,2518,Pancorbo,509,265,244
9,2539,Pardilla,123,67,56
9,2557,Partido de la Sierra en Tobalina,83,49,34
9,2560,Pedrosa de Duero,587,305,282
9,2595,Pedrosa de Río Úrbel,284,158,126
9,2576,Pedrosa del Páramo,120,68,52
9,2582,Pedrosa del Príncipe,301,158,143
9,2616,Peñaranda de Duero,611,326,285
9,2621,Peral de Arlanza,256,131,125
9,2655,Piérnigas,47,30,17
9,2674,Pineda-Trasmonte,191,100,91
9,2668,Pineda de la Sierra,125,68,57
9,2707,Pinilla-Trasmonte,233,128,105
9,2680,Pinilla de los Barruecos,137,72,65
9,2693,Pinilla de los Moros,49,32,17
9,2729,Poza de la Sal,381,192,189
9,2735,Prádanos de Bureba,74,41,33
9,2740,Pradoluengo,1732,842,890
9,2753,Presencio,291,154,137
9,2766,Puebla de Arganzón (La),275,152,123
9,2772,Puentedura,128,69,59
9,2791,Quemada,260,145,115
9,2812,Quintana del Pidio,200,107,93
9,2805,Quintanabureba,36,20,16
9,2833,Quintanaélez,108,52,56
9,2870,Quintanaortuño,127,65,62
9,2886,Quintanapalla,123,66,57
9,2899,Quintanar de la Sierra,2154,1112,1042
9,2925,Quintanavides,90,43,47
9,9012,Quintanilla-Tordueles,599,315,284
9,2946,Quintanilla de la Mata,170,94,76
9,2959,Quintanilla del Coco,119,60,59
9,2984,Quintanilla San García,113,54,59
9,3018,Quintanilla Vivar,361,181,180
9,2978,Quintanillas (Las),344,181,163
9,3023,Rabanera del Pinar,140,74,66
9,3039,Rábanos,93,57,36
9,3044,Rabé de las Calzadas,182,97,85
9,3060,Rebolledo de la Torre,168,91,77
9,3076,Redecilla del Camino,150,88,62
9,3082,Redecilla del Campo,96,50,46
9,3095,Regumiel de la Sierra,510,256,254
9,3109,Reinoso,26,18,8
9,3116,Retuerta,82,46,36
9,3142,Revilla del Campo,134,66,68
9,3168,Revilla Vallejera,179,101,78
9,3121,Revilla y Ahedo (La),126,69,57
9,3155,Revillarruz,146,76,70
9,3174,Rezmondo,24,11,13
9,3180,Riocavado de la Sierra,76,40,36
9,3214,Roa,2299,1177,1122
9,3235,Rojas,102,57,45
9,3253,Royuela de Río Franco,352,196,156
9,3266,Rubena,156,79,77
9,3272,Rublacedo de Abajo,41,21,20
9,3288,Rucandio,118,60,58
9,3291,Salas de Bureba,173,97,76
9,3305,Salas de los Infantes,2091,1044,1047
9,3327,Saldaña de Burgos,107,57,50
9,3348,Salinillas de Bureba,71,39,32
9,3351,San Adrián de Juarros,47,24,23
9,3370,San Juan del Monte,171,90,81
9,3386,San Mamés de Burgos,171,97,74
9,3399,San Martín de Rubiales,272,140,132
9,3403,San Millán de Lara,81,52,29
9,3608,San Vicente del Valle,42,27,15
9,3431,Santa Cecilia,132,73,59
9,3459,Santa Cruz de la Salceda,200,111,89
9,3462,Santa Cruz del Valle Urbión,132,79,53
9,3478,Santa Gadea del Cid,190,101,89
9,3484,Santa Inés,209,111,98
9,3500,Santa María del Campo,725,373,352
9,3517,Santa María del Invierno,61,37,24
9,3522,Santa María del Mercadillo,193,111,82
9,3538,Santa María Rivarredonda,137,76,61
9,3543,Santa Olalla de Bureba,40,16,24
9,3556,Santibáñez de Esgueva,173,86,87
9,3569,Santibáñez del Val,62,38,24
9,3581,Santo Domingo de Silos,313,198,115
9,3615,Sargentes de la Lora,175,99,76
9,3620,Sarracín,176,102,74
9,3636,Sasamón,1543,835,708
9,3654,Sequera de Haza (La),68,39,29
9,3667,Solarana,117,66,51
9,3689,Sordillos,40,24,16
9,3692,Sotillo de la Ribera,632,351,281
9,3728,Sotragero,155,84,71
9,3734,Sotresgudo,765,412,353
9,3749,Susinos del Páramo,106,48,58
9,3752,Tamarón,51,32,19
9,3771,Tardajos,676,364,312
9,3787,Tejada,51,30,21
9,3804,Terradillos de Esgueva,130,65,65
9,3811,Tinieblas de la Sierra,47,22,25
9,3826,Tobar,52,29,23
9,3847,Tordómar,416,233,183
9,3863,Torrecilla del Monte,75,42,33
9,3879,Torregalindo,144,83,61
9,3885,Torrelara,32,17,15
9,3898,Torrepadre,143,77,66
9,3902,Torresandino,826,444,382
9,3919,Tórtoles de Esgueva,563,316,247
9,3924,Tosantos,74,38,36
9,3945,Trespaderne,1126,588,538
9,3958,Tubilla del Agua,159,107,52
9,3961,Tubilla del Lago,206,109,97
9,3983,Úrbel del Castillo,102,57,45
9,4000,Vadocondes,460,238,222
9,4038,Valdeande,153,86,67
9,4056,Valdezate,212,111,101
9,4069,Valdorros,125,71,54
9,4081,Vallarta de Bureba,73,41,32
9,9048,Valle de las Navas,650,359,291
9,9086,Valle de Losa,691,396,295
9,4094,Valle de Manzanedo,122,66,56
9,4108,Valle de Mena,3338,1705,1633
9,4115,Valle de Oca,222,109,113
9,9027,Valle de Santibáñez,643,325,318
9,9051,Valle de Sedano,523,279,244
9,4120,Valle de Tobalina,1111,584,527
9,4136,Valle de Valdebezana,759,413,346
9,4141,Valle de Valdelaguna,251,135,116
9,4154,Valle de Valdelucio,371,199,172
9,4167,Valle de Zamanzas,76,46,30
9,4173,Vallejera,62,34,28
9,4189,Valles de Palenzuela,108,55,53
9,4192,Valluércanes,125,68,57
9,4075,Valmala,33,15,18
9,4228,Vid de Bureba (La),47,23,24
9,4213,Vid y Barrios (La),345,194,151
9,4234,Vileña,42,26,16
9,4271,Villadiego,2050,1122,928
9,4287,Villaescusa de Roa,184,105,79
9,4290,Villaescusa la Sombría,61,35,26
9,4304,Villaespasa,32,16,16
9,4311,Villafranca Montes de Oca,205,105,100
9,4326,Villafruela,311,176,135
9,4332,Villagalijo,77,49,28
9,4347,Villagonzalo Pedernales,707,351,356
9,4379,Villahoz,425,216,209
9,4385,Villalba de Duero,559,299,260
9,4398,Villalbilla de Burgos,679,368,311
9,4402,Villalbilla de Gumiel,136,77,59
9,4419,Villaldemiro,85,45,40
9,4424,Villalmanzo,502,275,227
9,4430,Villamayor de los Montes,266,131,135
9,4445,Villamayor de Treviño,116,65,51
9,4458,Villambistia,83,48,35
9,4461,Villamedianilla,28,13,15
9,4477,Villamiel de la Sierra,42,24,18
9,4483,Villangómez,336,184,152
9,4496,Villanueva de Argaño,122,64,58
9,4509,Villanueva de Carazo,23,14,9
9,4516,Villanueva de Gumiel,310,160,150
9,4542,Villanueva de Teba,73,41,32
9,4555,Villaquirán de la Puebla,72,40,32
9,4568,Villaquirán de los Infantes,192,96,96
9,9033,Villarcayo de Merindad de Castilla la Vieja,3798,1906,1892
9,4580,Villariezo,167,89,78
9,4607,Villasandino,266,132,134
9,4635,Villasur de Herreros,301,171,130
9,4640,Villatuelda,78,42,36
9,4672,Villaverde-Mogina,134,82,52
9,4666,Villaverde del Monte,201,107,94
9,4712,Villayerno Morquillas,135,69,66
9,4727,Villazopeque,95,54,41
9,4733,Villegas,135,73,62
9,4764,Villoruebo,52,33,19
9,4249,Viloria de Rioja,72,40,32
9,4252,Vilviestre del Pinar,789,411,378
9,4786,Vizcaínos,67,35,32
9,4803,Zael,154,80,74
9,4825,Zarzosa de Río Pisuerga,62,36,26
9,4831,Zazuar,246,128,118
9,4859,Zuñeda,87,45,42
10,15,Abadía,278,156,122
10,20,Abertura,510,275,235
10,36,Acebo,788,419,369
10,41,Acehuche,966,486,480
10,54,Aceituna,732,376,356
10,67,Ahigal,1684,869,815
10,73,Albalá del Caudillo,832,400,432
10,89,Alcántara,1829,937,892
10,92,Alcollarín,364,172,192
10,106,Alcuéscar,3110,1613,1497
10,128,Aldea del Cano,760,376,384
10,134,Aldea del Obispo (La),415,220,195
10,113,Aldeacentenera,1002,509,493
10,149,Aldeanueva de la Vera,2526,1251,1275
10,152,Aldeanueva del Camino,906,467,439
10,165,Aldehuela de Jerte,388,220,168
10,171,Alía,1371,682,689
10,187,Aliseda,2373,1188,1185
10,190,Almaraz,1433,744,689
10,204,Almoharín,2003,994,1009
10,211,Arroyo de la Luz,6446,3228,3218
10,232,Arroyomolinos,1085,549,536
10,226,Arroyomolinos de la Vera,604,300,304
10,247,Baños de Montemayor,712,361,351
10,250,Barrado,565,291,274
10,263,Belvís de Monroy,598,308,290
10,279,Benquerencia,104,62,42
10,285,Berrocalejo,131,59,72
10,298,Berzocana,660,336,324
10,302,Bohonal de Ibor,620,319,301
10,319,Botija,182,80,102
10,324,Brozas,2407,1203,1204
10,330,Cabañas del Castillo,575,292,283
10,345,Cabezabellosa,498,250,248
10,358,Cabezuela del Valle,2414,1250,1164
10,361,Cabrero,455,239,216
10,377,Cáceres,78614,37864,40750
10,383,Cachorrilla,100,47,53
10,396,Cadalso,592,308,284
10,400,Calzadilla,535,275,260
10,417,Caminomorisco,1297,690,607
10,422,Campillo de Deleitosa,144,70,74
10,438,Campo Lugar,1221,613,608
10,443,Cañamero,1959,1011,948
10,456,Cañaveral,1533,754,779
10,469,Carbajo,283,150,133
10,475,Carcaboso,1145,660,485
10,481,Carrascalejo,437,221,216
10,494,Casar de Cáceres,4641,2323,2318
10,507,Casar de Palomero,1353,679,674
10,514,Casares de las Hurdes,798,401,397
10,529,Casas de Don Antonio,235,110,125
10,535,Casas de Don Gómez,371,193,178
10,566,Casas de Millán,812,422,390
10,572,Casas de Miravete,163,87,76
10,540,Casas del Castañar,741,369,372
10,553,Casas del Monte,926,479,447
10,588,Casatejada,1277,638,639
10,591,Casillas de Coria,539,249,290
10,605,Castañar de Ibor,1388,710,678
10,612,Ceclavín,2149,1134,1015
10,627,Cedillo,545,281,264
10,633,Cerezo,238,112,126
10,648,Cilleros,2206,1112,1094
10,651,Collado,231,124,107
10,664,Conquista de la Sierra,183,87,96
10,670,Coria,11811,5934,5877
10,686,Cuacos de Yuste,933,498,435
10,699,Cumbre (La),1167,579,588
10,703,Deleitosa,953,476,477
10,710,Descargamaría,268,138,130
10,725,Eljas,1260,638,622
10,731,Escurial,947,474,473
10,759,Fresnedoso de Ibor,448,226,222
10,762,Galisteo,2002,1012,990
10,778,Garciaz,1038,532,506
10,784,Garganta (La),604,337,267
10,797,Garganta la Olla,1068,560,508
10,801,Gargantilla,501,267,234
10,818,Gargüera,202,103,99
10,823,Garrovillas,2488,1196,1292
10,839,Garvín,122,70,52
10,844,Gata,1950,979,971
10,857,Gordo (El),304,150,154
10,860,Granja (La),432,243,189
10,876,Guadalupe,2414,1198,1216
10,882,Guijo de Coria,297,157,140
10,895,Guijo de Galisteo,1836,936,900
10,909,Guijo de Granadilla,761,374,387
10,916,Guijo de Santa Bárbara,501,250,251
10,921,Herguijuela,445,218,227
10,937,Hernán-Pérez,496,258,238
10,942,Herrera de Alcántara,340,170,170
10,955,Herreruela,477,251,226
10,968,Hervás,3934,1917,2017
10,974,Higuera,120,65,55
10,980,Hinojal,446,212,234
10,993,Holguera,847,422,425
10,1007,Hoyos,1001,512,489
10,1014,Huélaga,208,107,101
10,1029,Ibahernando,761,373,388
10,1035,Jaraicejo,672,327,345
10,1040,Jaraíz de la Vera,6768,3446,3322
10,1053,Jarandilla de la Vera,3228,1620,1608
10,1066,Jarilla,199,106,93
10,1072,Jerte,1377,719,658
10,1088,Ladrillar,327,180,147
10,1091,Logrosán,2629,1332,1297
10,1105,Losar de la Vera,3007,1514,1493
10,1112,Madrigal de la Vera,1521,872,649
10,1127,Madrigalejo,2247,1105,1142
10,1133,Madroñera,3165,1584,1581
10,1148,Majadas,1237,686,551
10,1151,Malpartida de Cáceres,4361,2189,2172
10,1164,Malpartida de Plasencia,4191,2043,2148
10,1170,Marchagaz,398,194,204
10,1186,Mata de Alcántara,398,201,197
10,1199,Membrío,907,430,477
10,1203,Mesas de Ibor,202,110,92
10,1210,Miajadas,9629,4817,4812
10,1225,Millanes,253,143,110
10,1231,Mirabel,861,422,439
10,1246,Mohedas de Granadilla,1163,588,575
10,1259,Monroy,1253,666,587
10,1262,Montánchez,2233,1102,1131
10,1278,Montehermoso,5211,2639,2572
10,1284,Moraleja,8355,4138,4217
10,1297,Morcillo,505,253,252
10,1301,Navaconcejo,2176,1103,1073
10,1318,Navalmoral de la Mata,14874,7402,7472
10,1323,Navalvillar de Ibor,553,288,265
10,1339,Navas del Madroño,1575,793,782
10,1344,Navezuelas,755,395,360
10,1357,Nuñomoral,2013,1064,949
10,1360,Oliva de Plasencia,327,164,163
10,1376,Palomero,580,295,285
10,1382,Pasarón de la Vera,714,357,357
10,1395,Pedroso de Acim,147,78,69
10,1409,Peraleda de la Mata,1454,727,727
10,1416,Peraleda de San Román,431,211,220
10,1421,Perales del Puerto,1026,508,518
10,1437,Pescueza,224,105,119
10,1442,Pesga (La),1290,732,558
10,1455,Piedras Albas,226,107,119
10,1468,Pinofranqueado,1793,975,818
10,1474,Piornal,1560,774,786
10,1480,Plasencia,36465,17841,18624
10,1493,Plasenzuela,514,235,279
10,1506,Portaje,416,204,212
10,1513,Portezuelo,328,159,169
10,1528,Pozuelo de Zarzón,649,312,337
10,1534,Puerto de Santa Cruz,440,212,228
10,1549,Rebollar,251,129,122
10,1552,Riolobos,1567,833,734
10,1565,Robledillo de Gata,174,92,82
10,1571,Robledillo de la Vera,367,180,187
10,1587,Robledillo de Trujillo,462,247,215
10,1590,Robledollano,453,246,207
10,1604,Romangordo,197,94,103
10,9016,Rosalejo,1854,1045,809
10,1611,Ruanes,112,58,54
10,1626,Salorino,852,421,431
10,1632,Salvatierra de Santiago,434,223,211
10,1647,San Martín de Trevejo,1018,518,500
10,1650,Santa Ana,397,199,198
10,1663,Santa Cruz de la Sierra,375,193,182
10,1679,Santa Cruz de Paniagua,467,250,217
10,1685,Santa Marta de Magasca,382,192,190
10,1698,Santiago de Alcántara,789,391,398
10,1702,Santiago del Campo,340,173,167
10,1719,Santibáñez el Alto,535,274,261
10,1724,Santibáñez el Bajo,1013,526,487
10,1730,Saucedilla,617,313,304
10,1745,Segura de Toro,220,119,101
10,1758,Serradilla,1974,1002,972
10,1761,Serrejón,525,274,251
10,1777,Sierra de Fuentes,1677,860,817
10,1783,Talaván,1033,514,519
10,1796,Talaveruela de la Vera,468,219,249
10,1800,Talayuela,7005,3913,3092
10,1817,Tejeda de Tiétar,1025,554,471
10,1822,Toril,224,143,81
10,1838,Tornavacas,1341,712,629
10,1843,Torno (El),980,505,475
10,1875,Torre de Don Miguel,654,329,325
10,1881,Torre de Santa María,765,380,385
10,1856,Torrecilla de los Ángeles,706,358,348
10,1869,Torrecillas de la Tiesa,1266,640,626
10,1908,Torrejón el Rubio,726,377,349
10,1894,Torrejoncillo,3633,1775,1858
10,1915,Torremenga,585,326,259
10,1920,Torremocha,1254,597,657
10,1936,Torreorgaz,1571,803,768
10,1941,Torrequemada,615,293,322
10,1954,Trujillo,9070,4366,4704
10,1967,Valdastillas,419,209,210
10,1973,Valdecañas de Tajo,140,77,63
10,1989,Valdefuentes,1583,796,787
10,1992,Valdehúncar,178,87,91
10,2006,Valdelacasa de Tajo,583,277,306
10,2013,Valdemorales,282,140,142
10,2028,Valdeobispo,843,413,430
10,2034,Valencia de Alcántara,6226,3047,3179
10,2049,Valverde de la Vera,564,292,272
10,2052,Valverde del Fresno,2630,1336,1294
10,2065,Viandar de la Vera,333,156,177
10,2071,Villa del Campo,672,332,340
10,2087,Villa del Rey,183,97,86
10,2090,Villamesías,393,196,197
10,2104,Villamiel,849,486,363
10,2111,Villanueva de la Sierra,615,294,321
10,2126,Villanueva de la Vera,2003,1000,1003
10,2147,Villar de Plasencia,303,151,152
10,2132,Villar del Pedroso,856,429,427
10,2150,Villasbuenas de Gata,518,266,252
10,2163,Zarza de Granadilla,1862,959,903
10,2179,Zarza de Montánchez,660,326,334
10,2185,Zarza la Mayor,1732,863,869
10,2198,Zorita,2025,996,1029
11,12,Alcalá de los Gazules,5578,2894,2684
11,27,Alcalá del Valle,5277,2711,2566
11,33,Algar,1833,993,840
11,48,Algeciras,101972,50124,51848
11,51,Algodonales,5680,2923,2757
11,64,Arcos de la Frontera,27897,14007,13890
11,70,Barbate,21916,10922,10994
11,86,Barrios (Los),16083,8118,7965
11,9013,Benalup,6179,3144,3035
11,99,Benaocaz,592,297,295
11,103,Bornos,8062,4011,4051
11,110,Bosque (El),1833,949,884
11,125,Cádiz,143129,68727,74402
11,131,Castellar de la Frontera,2428,1244,1184
11,159,Chiclana de la Frontera,55494,28163,27331
11,162,Chipiona,15989,8078,7911
11,146,Conil de la Frontera,17089,8675,8414
11,178,Espera,3957,2072,1885
11,184,Gastor (El),2015,1064,951
11,197,Grazalema,2256,1163,1093
11,201,Jerez de la Frontera,181602,88706,92896
11,218,Jimena de la Frontera,8948,4565,4383
11,223,Línea de la Concepción (La),59629,29058,30571
11,239,Medina-Sidonia,10872,5639,5233
11,244,Olvera,8884,4462,4422
11,257,Paterna de Rivera,5121,2659,2462
11,260,Prado del Rey,5785,2895,2890
11,276,Puerto de Santa María (El),73728,36783,36945
11,282,Puerto Real,33415,16819,16596
11,295,Puerto Serrano,6677,3413,3264
11,309,Rota,24704,12478,12226
11,316,San Fernando,84014,41453,42561
11,9028,San José del Valle,4322,2227,2095
11,337,San Roque,22322,11194,11128
11,321,Sanlúcar de Barrameda,61382,30718,30664
11,342,Setenil de las Bodegas,3130,1597,1533
11,355,Tarifa,15118,7642,7476
11,368,Torre Alháquime,988,504,484
11,374,Trebujena,6927,3592,3335
11,380,Ubrique,17960,8933,9027
11,393,Vejer de la Frontera,12731,6447,6284
11,407,Villaluenga del Rosario,451,244,207
11,414,Villamartín,11963,6004,5959
11,429,Zahara,1552,809,743
12,22,Aín,155,79,76
12,38,Albocàsser,1374,664,710
12,43,Alcalà de Xivert,4902,2422,2480
12,56,Alcora (l'),8788,4473,4315
12,69,Alcudia de Veo,177,82,95
12,75,Alfondeguilla,919,453,466
12,81,Algimia de Almonacid,288,162,126
12,94,Almazora/Almassora,16465,8134,8331
12,108,Almedíjar,283,136,147
12,115,Almenara,5001,2468,2533
12,9018,Alquerías del Niño Perdido,3531,1720,1811
12,120,Altura,3144,1582,1562
12,136,Arañuel,142,74,68
12,141,Ares del Maestre,266,128,138
12,154,Argelita,117,57,60
12,167,Artana,1869,928,941
12,17,Atzeneta del Maestrat,1465,741,724
12,173,Ayódar,223,122,101
12,189,Azuébar,351,173,178
12,206,Barracas,166,91,75
12,228,Bejís,362,201,161
12,249,Benafer,148,81,67
12,252,Benafigos,218,119,99
12,265,Benasal,1416,687,729
12,271,Benicarló,19350,9557,9793
12,287,Benicasim/Benicàssim,10702,5445,5257
12,290,Benlloch,863,443,420
12,213,Betxí,5314,2701,2613
12,311,Borriol,3284,1660,1624
12,326,Burriana,26097,12677,13420
12,332,Cabanes,2366,1158,1208
12,347,Cálig,1755,854,901
12,363,Canet lo Roig,914,436,478
12,379,Castell de Cabres,22,10,12
12,385,Castellfort,235,124,111
12,398,Castellnovo,1026,491,535
12,402,Castellón de la Plana/Castelló de la Plana,137741,67015,70726
12,419,Castillo de Villamalefa,130,64,66
12,424,Catí,897,462,435
12,430,Caudiel,707,350,357
12,445,Cervera del Maestre,730,348,382
12,521,Chert/Xert,920,449,471
12,537,Chilches,2222,1134,1088
12,555,Chodos/Xodos,159,84,75
12,568,Chóvar,393,199,194
12,458,Cinctorres,551,253,298
12,461,Cirat,281,148,133
12,483,Cortes de Arenoso,410,224,186
12,496,Costur,469,238,231
12,509,Coves de Vinromà (les),1866,935,931
12,516,Culla,811,411,400
12,574,Eslida,766,364,402
12,580,Espadilla,78,37,41
12,593,Fanzara,269,128,141
12,607,Figueroles,548,273,275
12,614,Forcall,540,262,278
12,635,Fuente la Reina,29,13,16
12,640,Fuentes de Ayódar,105,58,47
12,653,Gaibiel,205,108,97
12,672,Geldo,704,351,353
12,688,Herbés,106,54,52
12,691,Higueras,41,25,16
12,705,Jana (la),823,418,405
12,712,Jérica,1574,801,773
12,748,Llosa (la),932,471,461
12,727,Lucena del Cid,1581,792,789
12,733,Ludiente,232,117,115
12,751,Mata de Morella (la),196,96,100
12,764,Matet,139,71,68
12,770,Moncofa,3724,1897,1827
12,786,Montán,340,175,165
12,799,Montanejos,408,209,199
12,803,Morella,2719,1309,1410
12,810,Navajas,508,256,252
12,825,Nules,11490,5733,5757
12,831,Olocau del Rey,149,81,68
12,846,Onda,18909,9536,9373
12,859,Oropesa del Mar/Orpesa,3044,1555,1489
12,878,Palanques,23,13,10
12,884,Pavías,58,36,22
12,897,Peñíscola,4047,2037,2010
12,901,Pina de Montalgrao,167,88,79
12,939,Pobla de Benifassà (la),217,110,107
12,944,Pobla Tornesa (la),532,260,272
12,918,Portell de Morella,265,130,135
12,923,Puebla de Arenoso,173,86,87
12,957,Ribesalbes,1283,640,643
12,960,Rossell,1148,589,559
12,976,Sacañet,119,67,52
12,982,Salzadella (la),797,391,406
12,995,San Jorge,577,280,297
12,1016,San Rafael del Río,462,234,228
12,9023,Sant Joan de Moró,1683,854,829
12,1009,Sant Mateu,1780,890,890
12,1021,Santa Magdalena de Pulpis,693,350,343
12,1037,Sarratella,96,52,44
12,1042,Segorbe,7710,3747,3963
12,1055,Sierra Engarcerán,1084,570,514
12,1068,Soneja,1387,703,684
12,1074,Sot de Ferrer,405,206,199
12,1080,Sueras/Suera,548,274,274
12,1093,Tales,763,366,397
12,1107,Teresa,368,188,180
12,1114,Tírig,567,285,282
12,1129,Todolella,136,81,55
12,1135,Toga,94,45,49
12,1140,Torás,259,135,124
12,1153,Toro (El),356,187,169
12,1166,Torralba del Pinar,67,31,36
12,1191,Torre d'En Besora (la),210,106,104
12,1205,Torre Endoménech,238,118,120
12,1172,Torreblanca,4590,2291,2299
12,1188,Torrechiva,68,40,28
12,1212,Traiguera,1586,816,770
12,1227,Useras/Useres (les),1027,520,507
12,1248,Vall d'Alba,1856,935,921
12,1251,Vall de Almonacid,292,150,142
12,1264,Vall d'Uixó (la),28823,14306,14517
12,1233,Vallat,46,22,24
12,1270,Vallibona,102,61,41
12,1286,Vilafamés,1427,766,661
12,1325,Vilanova d'Alcolea,632,320,312
12,1346,Vilar de Canes,188,93,95
12,1299,Villafranca del Cid,2680,1290,1390
12,1303,Villahermosa del Río,456,254,202
12,1310,Villamalur,149,84,65
12,1331,Villanueva de Viver,88,46,42
12,1359,Villarreal/Vila-real,40124,19959,20165
12,1362,Villavieja,3401,1686,1715
12,1378,Villores,66,33,33
12,1384,Vinaròs,21592,10513,11079
12,1397,Vistabella del Maestrazgo,473,233,240
12,1401,Viver,1237,636,601
12,1418,Zorita del Maestrazgo,135,68,67
12,1423,Zucaina,218,123,95
13,13,Abenójar,1810,904,906
13,28,Agudo,2132,1078,1054
13,34,Alamillo,685,346,339
13,49,Albaladejo,1697,864,833
13,52,Alcázar de San Juan,26022,12681,13341
13,65,Alcoba,770,405,365
13,71,Alcolea de Calatrava,1644,820,824
13,87,Alcubillas,722,344,378
13,90,Aldea del Rey,2222,1091,1131
13,104,Alhambra,1298,660,638
13,111,Almadén,7410,3549,3861
13,126,Almadenejos,606,324,282
13,132,Almagro,8278,3996,4282
13,147,Almedina,749,378,371
13,150,Almodóvar del Campo,7599,3748,3851
13,163,Almuradiel,1030,473,557
13,179,Anchuras,451,249,202
13,185,Arenas de San Juan,1065,531,534
13,198,Argamasilla de Alba,6667,3293,3374
13,202,Argamasilla de Calatrava,5536,2806,2730
13,219,Arroba de los Montes,649,333,316
13,224,Ballesteros de Calatrava,572,272,300
13,230,Bolaños de Calatrava,10618,5302,5316
13,245,Brazatortas,1241,622,619
13,258,Cabezarados,393,206,187
13,261,Cabezarrubias del Puerto,671,345,326
13,277,Calzada de Calatrava,4852,2385,2467
13,283,Campo de Criptana,13829,6791,7038
13,296,Cañada de Calatrava,89,49,40
13,300,Caracuel de Calatrava,174,96,78
13,317,Carrión de Calatrava,2627,1297,1330
13,322,Carrizosa,1729,866,863
13,338,Castellar de Santiago,2244,1088,1156
13,381,Chillón,2389,1155,1234
13,343,Ciudad Real,61138,28872,32266
13,356,Corral de Calatrava,1331,674,657
13,369,Cortijos (Los),1094,535,559
13,375,Cózar,1348,653,695
13,394,Daimiel,17045,8379,8666
13,408,Fernancaballero,1044,498,546
13,415,Fontanarejo,380,200,180
13,420,Fuencaliente,1308,688,620
13,436,Fuenllana,331,152,179
13,441,Fuente el Fresno,3444,1698,1746
13,454,Granátula de Calatrava,1003,479,524
13,467,Guadalmez,1070,550,520
13,473,Herencia,7041,3520,3521
13,489,Hinojosas de Calatrava,787,382,405
13,492,Horcajo de los Montes,1113,561,552
13,505,Labores (Las),699,347,352
13,512,Luciana,448,229,219
13,527,Malagón,8059,3969,4090
13,533,Manzanares,18222,8917,9305
13,548,Membrilla,6600,3294,3306
13,551,Mestanza,968,467,501
13,564,Miguelturra,9252,4632,4620
13,570,Montiel,1721,865,856
13,586,Moral de Calatrava,5202,2543,2659
13,599,Navalpino,326,160,166
13,603,Navas de Estena,433,235,198
13,610,Pedro Muñoz,7213,3590,3623
13,625,Picón,636,333,303
13,631,Piedrabuena,5036,2567,2469
13,646,Poblete,784,395,389
13,659,Porzuna,3984,2019,1965
13,662,Pozuelo de Calatrava,2532,1248,1284
13,678,Pozuelos de Calatrava (Los),589,293,296
13,684,Puebla de Don Rodrigo,1331,702,629
13,697,Puebla del Príncipe,1094,552,542
13,701,Puerto Lápice,1049,522,527
13,718,Puertollano,50778,24708,26070
13,723,Retuerta del Bullaque,1049,543,506
13,9014,Robledo (El),1131,596,535
13,9029,Ruidera,610,321,289
13,739,Saceruela,765,410,355
13,744,San Carlos del Valle,1251,626,625
13,757,San Lorenzo de Calatrava,310,161,149
13,760,Santa Cruz de los Cáñamos,677,342,335
13,776,Santa Cruz de Mudela,4843,2367,2476
13,782,Socuéllamos,11189,5486,5703
13,795,Solana (La),14960,7491,7469
13,809,Solana del Pino,554,280,274
13,816,Terrinches,972,472,500
13,821,Tomelloso,29255,14349,14906
13,837,Torralba de Calatrava,2914,1447,1467
13,842,Torre de Juan Abad,1468,719,749
13,855,Torrenueva,3252,1650,1602
13,868,Valdemanco del Esteras,337,165,172
13,874,Valdepeñas,26331,12662,13669
13,880,Valenzuela de Calatrava,819,400,419
13,893,Villahermosa,2719,1296,1423
13,907,Villamanrique,1695,832,863
13,914,Villamayor de Calatrava,656,329,327
13,929,Villanueva de la Fuente,2748,1353,1395
13,935,Villanueva de los Infantes,5801,2781,3020
13,940,Villanueva de San Carlos,498,245,253
13,953,Villar del Pozo,102,56,46
13,966,Villarrubia de los Ojos,9608,4786,4822
13,972,Villarta de San Juan,2957,1495,1462
13,988,Viso del Marqués,3100,1537,1563
14,18,Adamuz,4440,2257,2183
14,23,Aguilar de la Frontera,13397,6631,6766
14,39,Alcaracejos,1474,737,737
14,44,Almedinilla,2554,1269,1285
14,57,Almodóvar del Río,7155,3540,3615
14,60,Añora,1628,802,826
14,76,Baena,20057,9912,10145
14,82,Belalcázar,3879,1870,2009
14,95,Belmez,4057,1936,2121
14,109,Benamejí,4735,2378,2357
14,116,Blázquez (Los),712,361,351
14,121,Bujalance,8204,4023,4181
14,137,Cabra,20819,10130,10689
14,142,Cañete de las Torres,3424,1695,1729
14,155,Carcabuey,2887,1443,1444
14,168,Cardeña,1966,997,969
14,174,Carlota (La),10295,5161,5134
14,180,Carpio (El),4394,2146,2248
14,193,Castro del Río,8015,3902,4113
14,207,Conquista,512,261,251
14,214,Córdoba,309961,149284,160677
14,229,Doña Mencía,5047,2518,2529
14,235,Dos Torres,2515,1236,1279
14,240,Encinas Reales,2341,1146,1195
14,253,Espejo,4023,1993,2030
14,266,Espiel,2451,1217,1234
14,272,Fernán-Núñez,9494,4742,4752
14,312,Fuente-Tójar,844,389,455
14,288,Fuente la Lancha,430,214,216
14,291,Fuente Obejuna,6107,3120,2987
14,305,Fuente Palmera,9695,4886,4809
14,327,Granjuela (La),512,267,245
14,333,Guadalcázar,1167,593,574
14,348,Guijo (El),413,212,201
14,351,Hinojosa del Duque,7995,3868,4127
14,364,Hornachuelos,5056,2540,2516
14,370,Iznájar,5200,2621,2579
14,386,Lucena,35564,17677,17887
14,399,Luque,3397,1695,1702
14,403,Montalbán de Córdoba,4563,2285,2278
14,410,Montemayor,3809,1916,1893
14,425,Montilla,22792,11213,11579
14,431,Montoro,9489,4648,4841
14,446,Monturque,1935,970,965
14,459,Moriles,3796,1891,1905
14,462,Nueva Carteya,5659,2844,2815
14,478,Obejo,1493,754,739
14,484,Palenciana,1560,778,782
14,497,Palma del Río,18948,9468,9480
14,500,Pedro Abad,2919,1458,1461
14,517,Pedroche,1848,920,928
14,522,Peñarroya-Pueblonuevo,13606,6498,7108
14,538,Posadas,7164,3574,3590
14,543,Pozoblanco,16223,7786,8437
14,556,Priego de Córdoba,22196,10858,11338
14,569,Puente Genil,27918,13661,14257
14,575,Rambla (La),7229,3612,3617
14,581,Rute,10083,4983,5100
14,594,San Sebastián de los Ballesteros,834,429,405
14,615,Santa Eufemia,1185,603,582
14,608,Santaella,5869,2954,2915
14,620,Torrecampo,1417,698,719
14,636,Valenzuela,1486,714,772
14,641,Valsequillo,474,230,244
14,654,Victoria (La),1767,869,898
14,667,Villa del Río,7149,3642,3507
14,673,Villafranca de Córdoba,3748,1928,1820
14,689,Villaharta,614,309,305
14,692,Villanueva de Córdoba,10069,4913,5156
14,706,Villanueva del Duque,1833,854,979
14,713,Villanueva del Rey,1241,642,599
14,728,Villaralto,1559,750,809
14,734,Villaviciosa de Córdoba,3832,1961,1871
14,749,Viso (El),3153,1516,1637
14,752,Zuheros,899,446,453
15,11,Abegondo,5451,2724,2727
15,26,Ames,14189,6868,7321
15,32,Aranga,2448,1219,1229
15,47,Ares,4662,2307,2355
15,50,Arteixo,21290,10677,10613
15,63,Arzúa,6947,3409,3538
15,79,Baña (A),5578,2681,2897
15,85,Bergondo,5817,2830,2987
15,98,Betanzos,12296,5801,6495
15,102,Boimorto,2691,1355,1336
15,119,Boiro,17845,8671,9174
15,124,Boqueixón,4275,2108,2167
15,130,Brión,6275,3014,3261
15,145,Cabana de Bergantiños,5804,2888,2916
15,158,Cabanas,3249,1582,1667
15,161,Camariñas,7105,3517,3588
15,177,Cambre,16401,8062,8339
15,183,Capela (A),1619,794,825
15,196,Carballo,27497,13352,14145
15,9012,Cariño,5199,2539,2660
15,200,Carnota,5930,2859,3071
15,217,Carral,5212,2537,2675
15,222,Cedeira,7699,3791,3908
15,238,Cee,7326,3537,3789
15,243,Cerceda,5658,2763,2895
15,256,Cerdido,1707,819,888
15,269,Cesuras,2733,1362,1371
15,275,Coirós,1553,764,789
15,281,Corcubión,1949,943,1006
15,294,Coristanco,8240,4088,4152
15,308,Coruña (A),243134,113548,129586
15,315,Culleredo,18743,9220,9523
15,320,Curtis,4523,2208,2315
15,336,Dodro,3313,1606,1707
15,341,Dumbría,4755,2306,2449
15,354,Fene,14912,7355,7557
15,367,Ferrol,82548,38561,43987
15,373,Fisterra,5295,2659,2636
15,389,Frades,3150,1583,1567
15,392,Irixoa,1768,871,897
15,413,Laracha,10706,5246,5460
15,406,Laxe,3541,1743,1798
15,428,Lousame,4329,2091,2238
15,434,Malpica de Bergantiños,7377,3619,3758
15,449,Mañón,2034,1000,1034
15,452,Mazaricos,6648,3226,3422
15,465,Melide,8439,4167,4272
15,471,Mesía,3489,1739,1750
15,487,Miño,4870,2289,2581
15,490,Moeche,1583,759,824
15,503,Monfero,2758,1413,1345
15,510,Mugardos,6110,2953,3157
15,531,Muros,10855,5194,5661
15,525,Muxía,6422,3126,3296
15,546,Narón,31086,15040,16046
15,559,Neda,6214,3006,3208
15,562,Negreira,6595,3153,3442
15,578,Noia,14473,6933,7540
15,584,Oleiros,24102,11673,12429
15,597,Ordes,11861,5782,6079
15,601,Oroso,4732,2333,2399
15,618,Ortigueira,8748,4201,4547
15,623,Outes,8948,4281,4667
15,639,Oza dos Ríos,3240,1572,1668
15,644,Paderne,2758,1311,1447
15,657,Padrón,9548,4592,4956
15,660,Pino (O),5004,2495,2509
15,676,Pobra do Caramiñal (A),10082,4822,5260
15,682,Ponteceso,7423,3716,3707
15,695,Pontedeume,8893,4281,4612
15,709,Pontes de García Rodríguez (As),12473,6299,6174
15,716,Porto do Son,10416,5103,5313
15,721,Rianxo,12147,5949,6198
15,737,Ribeira,26413,13017,13396
15,742,Rois,5295,2541,2754
15,755,Sada,10296,5072,5224
15,768,San Sadurniño,3503,1713,1790
15,774,Santa Comba,10960,5400,5560
15,780,Santiago de Compostela,93584,43972,49612
15,793,Santiso,2319,1192,1127
15,807,Sobrado,2609,1344,1265
15,814,Somozas (As),1506,747,759
15,829,Teo,13960,6827,7133
15,835,Toques,1668,866,802
15,840,Tordoia,5205,2495,2710
15,853,Touro,5077,2493,2584
15,866,Trazo,3912,1933,1979
15,888,Val do Dubra,5091,2494,2597
15,872,Valdoviño,6769,3329,3440
15,891,Vedra,5101,2446,2655
15,912,Vilarmaior,1412,714,698
15,905,Vilasantar,1707,873,834
15,927,Vimianzo,8937,4370,4567
15,933,Zas,6311,3046,3265
16,14,Abia de la Obispalía,88,48,40
16,29,Acebrón (El),279,142,137
16,35,Alarcón,204,101,103
16,40,Albaladejo del Cuende,413,216,197
16,53,Albalate de las Nogueras,383,211,172
16,66,Albendea,190,94,96
16,72,Alberca de Záncara (La),1728,855,873
16,88,Alcalá de la Vega,164,89,75
16,91,Alcantud,129,69,60
16,105,Alcázar del Rey,266,128,138
16,112,Alcohujate,53,30,23
16,127,Alconchel de la Estrella,223,114,109
16,133,Algarra,36,18,18
16,148,Aliaguilla,880,464,416
16,151,Almarcha (La),631,318,313
16,164,Almendros,349,178,171
16,170,Almodóvar del Pinar,510,261,249
16,186,Almonacid del Marquesado,581,300,281
16,199,Altarejos,332,170,162
16,203,Arandilla del Arroyo,54,24,30
16,9054,Arcas del Villar,595,296,299
16,225,Arcos de la Sierra,121,64,57
16,246,Arguisuelas,205,106,99
16,259,Arrancacepas,38,20,18
16,262,Atalaya del Cañavate,129,66,63
16,278,Barajas de Melo,703,345,358
16,297,Barchín del Hoyo,136,77,59
16,301,Bascuñana de San Pedro,41,22,19
16,318,Beamud,104,59,45
16,323,Belinchón,340,174,166
16,339,Belmonte,2471,1165,1306
16,344,Belmontejo,276,136,140
16,357,Beteta,402,197,205
16,360,Boniches,227,118,109
16,382,Buciegas,85,43,42
16,395,Buenache de Alarcón,630,322,308
16,409,Buenache de la Sierra,104,65,39
16,416,Buendía,543,267,276
16,421,Campillo de Altobuey,1672,826,846
16,437,Campillos-Paravientos,147,81,66
16,442,Campillos-Sierra,94,49,45
16,9015,Campos del Paraíso,1142,537,605
16,455,Canalejas del Arroyo,313,164,149
16,468,Cañada del Hoyo,369,193,176
16,474,Cañada Juncosa,353,185,168
16,480,Cañamares,582,304,278
16,493,Cañavate (El),270,130,140
16,506,Cañaveras,407,202,205
16,513,Cañaveruelas,251,126,125
16,528,Cañete,816,401,415
16,534,Cañizares,614,320,294
16,552,Carboneras de Guadazaón,1004,534,470
16,565,Cardenete,689,353,336
16,571,Carrascosa,116,70,46
16,587,Carrascosa de Haro,155,79,76
16,604,Casas de Benítez,1096,524,572
16,611,Casas de Fernando Alonso,1340,659,681
16,626,Casas de Garcimolina,34,16,18
16,632,Casas de Guijarro,154,77,77
16,647,Casas de Haro,890,447,443
16,650,Casas de los Pinos,510,244,266
16,663,Casasimarro,3061,1559,1502
16,679,Castejón,241,119,122
16,702,Castillejo-Sierra,54,25,29
16,685,Castillejo de Iniesta,200,109,91
16,719,Castillo-Albaráñez,33,17,16
16,724,Castillo de Garcimuñoz,228,116,112
16,730,Cervera del Llano,314,153,161
16,231,Chillarón de Cuenca,343,179,164
16,817,Chumillas,46,29,17
16,745,Cierva (La),57,30,27
16,783,Cuenca,44558,21401,23157
16,796,Cueva del Hierro,44,25,19
16,822,Enguídanos,529,272,257
16,838,Fresneda de Altarejos,92,51,41
16,843,Fresneda de la Sierra,76,38,38
16,856,Frontera (La),213,108,105
16,869,Fuente de Pedro Naharro,1205,600,605
16,875,Fuentelespino de Haro,326,178,148
16,881,Fuentelespino de Moya,143,74,69
16,9041,Fuentenava de Jábaga,277,146,131
16,894,Fuentes,504,264,240
16,915,Fuertescusa,118,61,57
16,920,Gabaldón,178,101,77
16,936,Garaballa,144,79,65
16,941,Gascueña,155,73,82
16,954,Graja de Campalbo,145,79,66
16,967,Graja de Iniesta,351,190,161
16,973,Henarejos,281,132,149
16,989,Herrumblar (El),773,399,374
16,992,Hinojosa (La),352,169,183
16,1006,Hinojosos (Los),1108,548,560
16,1013,Hito (El),237,120,117
16,1028,Honrubia,1611,790,821
16,1034,Hontanaya,472,234,238
16,1049,Hontecillas,94,46,48
16,1065,Horcajo de Santiago,3553,1763,1790
16,1071,Huélamo,157,80,77
16,1087,Huelves,71,29,42
16,1090,Huérguina,89,45,44
16,1104,Huerta de la Obispalía,153,84,69
16,1111,Huerta del Marquesado,216,121,95
16,1126,Huete,2278,1160,1118
16,1132,Iniesta,3786,1847,1939
16,1150,Laguna del Marquesado,78,42,36
16,1163,Lagunaseca,113,53,60
16,1179,Landete,1589,789,800
16,1185,Ledaña,1968,969,999
16,1198,Leganiel,234,119,115
16,1219,Majadas (Las),374,182,192
16,1224,Mariana,318,156,162
16,1230,Masegosa,128,69,59
16,1245,Mesas (Las),2503,1280,1223
16,1258,Minglanilla,2304,1172,1132
16,1261,Mira,1118,568,550
16,1283,Monreal del Llano,85,43,42
16,1296,Montalbanejo,204,92,112
16,1300,Montalbo,737,388,349
16,1317,Monteagudo de las Salinas,118,68,50
16,1322,Mota de Altarejos,58,36,22
16,1338,Mota del Cuervo,5411,2669,2742
16,1343,Motilla del Palancar,4946,2469,2477
16,1356,Moya,278,151,127
16,1375,Narboneta,113,55,58
16,1394,Olivares de Júcar,567,292,275
16,1408,Olmeda de la Cuesta,49,27,22
16,1415,Olmeda del Rey,247,116,131
16,1420,Olmedilla de Alarcón,183,93,90
16,1436,Olmedilla de Eliz,34,18,16
16,1454,Osa de la Vega,663,334,329
16,1467,Pajarón,139,71,68
16,1473,Pajaroncillo,97,48,49
16,1489,Palomares del Campo,1008,493,515
16,1492,Palomera,153,71,82
16,1505,Paracuellos,154,70,84
16,1512,Paredes,82,43,39
16,1527,Parra de las Vegas (La),61,31,30
16,1533,Pedernoso (El),1358,683,675
16,1548,Pedroñeras (Las),6382,3252,3130
16,1551,Peral (El),722,368,354
16,1564,Peraleja (La),153,76,77
16,1570,Pesquera (La),270,141,129
16,1586,Picazo (El),722,356,366
16,1599,Pinarejo,423,221,202
16,1603,Pineda de Gigüela,159,86,73
16,1610,Piqueras del Castillo,81,47,34
16,1625,Portalrubio de Guadamejud,94,45,49
16,1631,Portilla,93,48,45
16,1659,Poyatos,116,66,50
16,1662,Pozoamargo,319,150,169
16,9089,Pozorrubielos de la Mancha,288,144,144
16,1678,Pozorrubio,523,249,274
16,1697,Pozuelo (El),104,56,48
16,1701,Priego,1013,524,489
16,1718,Provencio (El),2569,1285,1284
16,1723,Puebla de Almenara,576,300,276
16,1739,Puebla de Don Francisco,372,183,189
16,1744,Puebla del Salvador,299,164,135
16,1757,Quintanar del Rey,6086,3102,2984
16,1760,Rada de Haro,65,32,33
16,1776,Reíllo,146,75,71
16,1816,Rozalén del Monte,124,58,66
16,1855,Saceda-Trasierra,99,58,41
16,1868,Saelices,704,349,355
16,1874,Salinas del Manzano,119,69,50
16,1880,Salmeroncillos,182,92,90
16,1893,Salvacañete,340,183,157
16,1907,San Clemente,6289,3080,3209
16,1914,San Lorenzo de la Parrilla,1492,757,735
16,1929,San Martín de Boniches,109,55,54
16,1935,San Pedro Palmiches,109,58,51
16,1940,Santa Cruz de Moya,430,217,213
16,1966,Santa María de los Llanos,865,441,424
16,1953,Santa María del Campo Rus,795,404,391
16,1972,Santa María del Val,118,62,56
16,1988,Sisante,1791,898,893
16,1991,Solera de Gabaldón,42,23,19
16,9092,Sotorribas,958,471,487
16,2027,Talayuelas,1124,580,544
16,2033,Tarancón,11189,5494,5695
16,2048,Tébar,412,221,191
16,2051,Tejadillos,178,92,86
16,2064,Tinajas,372,203,169
16,2099,Torralba,191,97,94
16,2110,Torrejoncillo del Rey,737,349,388
16,2125,Torrubia del Campo,366,170,196
16,2131,Torrubia del Castillo,44,22,22
16,2159,Tragacete,378,211,167
16,2162,Tresjuncos,518,264,254
16,2178,Tribaldos,134,62,72
16,2184,Uclés,293,136,157
16,2197,Uña,139,68,71
16,9067,Valdecolmenas (Los),127,68,59
16,2244,Valdemeca,110,57,53
16,2257,Valdemorillo de la Sierra,108,57,51
16,2276,Valdemoro-Sierra,164,95,69
16,2282,Valdeolivas,284,151,133
16,9020,Valdetórtola,146,80,66
16,9036,Valeras (Las),1418,702,716
16,2316,Valhermoso de la Fuente,60,27,33
16,2342,Valsalobre,56,29,27
16,2368,Valverde de Júcar,1383,694,689
16,2374,Valverdejo,148,79,69
16,2380,Vara de Rey,714,353,361
16,2393,Vega del Codorno,233,123,110
16,2407,Vellisca,186,91,95
16,2429,Villaconejos de Trabaque,534,273,261
16,2435,Villaescusa de Haro,623,317,306
16,2440,Villagarcía del Llano,981,481,500
16,2453,Villalba de la Sierra,553,289,264
16,2466,Villalba del Rey,712,364,348
16,2472,Villalgordo del Marquesado,141,70,71
16,2488,Villalpardo,1101,547,554
16,2491,Villamayor de Santiago,2736,1359,1377
16,2504,Villanueva de Guadamejud,132,62,70
16,2511,Villanueva de la Jara,2465,1243,1222
16,2532,Villar de Cañas,447,217,230
16,2547,Villar de Domingo García,276,140,136
16,2550,Villar de la Encina,241,120,121
16,2630,Villar de Olalla,863,447,416
16,2585,Villar del Humo,493,262,231
16,2598,Villar del Infantado,57,33,24
16,9106,Villar y Velasco,131,72,59
16,2661,Villarejo-Periesteban,548,277,271
16,2645,Villarejo de Fuentes,815,388,427
16,2658,Villarejo de la Peñuela,36,17,19
16,2696,Villares del Saz,743,374,369
16,2700,Villarrubio,266,137,129
16,2717,Villarta,794,411,383
16,2722,Villas de la Ventosa,392,209,183
16,2738,Villaverde y Pasaconsol,432,213,219
16,2743,Víllora,252,125,127
16,2756,Vindel,25,16,9
16,2769,Yémeda,29,13,16
16,2775,Zafra de Záncara,217,108,109
16,2781,Zafrilla,139,64,75
16,2794,Zarza de Tajo,268,123,145
16,2808,Zarzuela,292,144,148
17,10,Agullana,622,325,297
17,25,Aiguaviva,455,230,225
17,31,Albanyà,131,69,62
17,46,Albons,528,273,255
17,62,Alp,1105,570,535
17,78,Amer,2241,1108,1133
17,84,Anglès,4752,2394,2358
17,97,Arbúcies,4814,2401,2413
17,101,Argelaguer,365,201,164
17,118,Armentera (L'),749,374,375
17,123,Avinyonet de Puigventós,537,271,266
17,157,Banyoles,14748,7218,7530
17,160,Bàscara,778,404,374
17,139,Begur,3179,1601,1578
17,182,Bellcaire d'Empordà,502,251,251
17,195,Besalú,1991,966,1025
17,209,Bescanó,3063,1536,1527
17,216,Beuda,130,73,57
17,221,Bisbal d'Empordà (La),8107,3954,4153
17,2348,Biure,211,105,106
17,237,Blanes,28826,14463,14363
17,293,Boadella d'Empordà,227,113,114
17,242,Bolvir,247,123,124
17,255,Bordils,1386,696,690
17,268,Borrassà,489,239,250
17,274,Breda,3254,1664,1590
17,280,Brunyola,405,207,198
17,314,Cabanelles,220,122,98
17,307,Cabanes,783,394,389
17,329,Cadaqués,1878,908,970
17,335,Caldes de Malavella,3752,1888,1864
17,340,Calonge,6226,3126,3100
17,353,Camós,618,314,304
17,366,Campdevànol,3342,1636,1706
17,372,Campelles,123,63,60
17,388,Campllong,293,147,146
17,391,Camprodon,2344,1169,1175
17,405,Canet d'Adri,519,266,253
17,412,Cantallops,257,129,128
17,427,Capmany,397,200,197
17,448,Cassà de la Selva,7445,3693,3752
17,464,Castellfollit de la Roca,981,475,506
17,470,Castelló d'Empúries,5283,2699,2584
17,486,Castell-Platja d'Aro,5785,2925,2860
17,1899,Cellera de Ter (La),2019,996,1023
17,499,Celrà,2450,1186,1264
17,502,Cervià de Ter,643,318,325
17,519,Cistella,211,105,106
17,545,Colera,493,238,255
17,558,Colomers,202,100,102
17,577,Corçà,1110,567,543
17,561,Cornellà del Terri,1862,931,931
17,583,Crespià,205,99,106
17,9011,"Cruïlles, Monells i Sant Sadurní de l'Heura",1071,525,546
17,600,Darnius,525,279,246
17,617,Das,151,84,67
17,622,Escala (L'),5942,2955,2987
17,638,Espinelves,180,93,87
17,643,Espolla,376,191,185
17,656,Esponellà,392,198,194
17,59,Far d'Empordà (El),401,201,200
17,669,Figueres,33600,16292,17308
17,675,Flaçà,840,419,421
17,681,Foixà,315,155,160
17,694,Fontanals de Cerdanya,374,189,185
17,708,Fontanilles,126,69,57
17,715,Fontcoberta,1076,547,529
17,9026,Forallac,1642,794,848
17,736,Fornells de la Selva,1392,682,710
17,741,Fortià,494,239,255
17,754,Garrigàs,310,165,145
17,767,Garrigoles,147,80,67
17,773,Garriguella,658,333,325
17,789,Ger,330,174,156
17,792,Girona,71858,34515,37343
17,806,Gombrèn,235,109,126
17,813,Gualta,259,130,129
17,828,Guils de Cerdanya,319,160,159
17,834,Hostalric,2865,1407,1458
17,849,Isòvol,205,112,93
17,852,Jafre,338,172,166
17,865,Jonquera (La),2490,1241,1249
17,871,Juià,256,117,139
17,887,Lladó,492,244,248
17,890,Llagostera,5565,2803,2762
17,904,Llambilles,435,217,218
17,911,Llanars,449,231,218
17,926,Llançà,3930,1964,1966
17,932,Llers,873,443,430
17,947,Llívia,975,513,462
17,950,Lloret de Mar,17875,8913,8962
17,963,Llosses (Les),270,146,124
17,1024,Maçanet de Cabrenys,628,329,299
17,1030,Maçanet de la Selva,3472,1763,1709
17,979,Madremanya,185,79,106
17,985,Maià de Montcal,329,166,163
17,1002,Masarac,244,119,125
17,1019,Massanes,492,254,238
17,998,Meranges,73,43,30
17,1058,Mieres,318,166,152
17,1061,Mollet de Peralada,180,98,82
17,1077,Molló,338,173,165
17,1100,Mont-ras,1541,821,720
17,1096,Montagut,801,412,389
17,1117,Navata,663,326,337
17,1122,Ogassa,243,142,101
17,1143,Olot,27644,13310,14334
17,1156,Ordis,287,151,136
17,1169,Osor,480,260,220
17,1175,Palafrugell,17564,8787,8777
17,1181,Palamós,14420,7102,7318
17,1215,Palau-sator,286,146,140
17,1208,Palau-saverdera,797,404,393
17,1194,Palau de Santa Eulàlia,85,48,37
17,1236,Palol de Revardit,367,190,177
17,1241,Pals,1822,935,887
17,1254,Pardines,134,66,68
17,1267,Parlavà,328,173,155
17,1289,Pau,415,204,211
17,1292,Pedret i Marzà,114,57,57
17,1306,Pera (La),370,192,178
17,1328,Peralada,1188,608,580
17,1334,Planes d'Hostoles (Les),1745,862,883
17,1349,Planoles,269,146,123
17,1352,Pont de Molins,450,241,209
17,1365,Pontós,211,117,94
17,1371,Porqueres,3383,1660,1723
17,1404,Port de la Selva (El),782,378,404
17,1387,Portbou,1590,797,793
17,1390,Preses (Les),1320,644,676
17,1411,Puigcerdà,6580,3323,3257
17,1426,Quart,2183,1118,1065
17,433,Queralbs,200,111,89
17,1432,Rabós,137,66,71
17,1447,Regencós,290,161,129
17,1450,Ribes de Freser,2125,1031,1094
17,1463,Riells i Viabrea,1686,883,803
17,1479,Ripoll,10953,5332,5621
17,1485,Riudarenes,1257,644,613
17,1498,Riudaura,390,196,194
17,1501,Riudellots de la Selva,1489,750,739
17,1518,Riumors,191,93,98
17,1523,Roses,12022,6033,5989
17,1539,Rupià,192,103,89
17,1544,Sales de Llierca,65,38,27
17,1557,Salt,21678,10740,10938
17,1576,Sant Andreu Salou,143,70,73
17,1833,Sant Aniol de Finestres,251,133,118
17,1582,Sant Climent Sescebes,428,216,212
17,1595,Sant Feliu de Buixalleu,695,374,321
17,1609,Sant Feliu de Guíxols,17850,8724,9126
17,1616,Sant Feliu de Pallerols,1137,555,582
17,1621,Sant Ferriol,177,99,78
17,1637,Sant Gregori,2214,1158,1056
17,1642,Sant Hilari Sacalm,4873,2464,2409
17,1655,Sant Jaume de Llierca,711,351,360
17,1674,Sant Joan de les Abadesses,3734,1839,1895
17,1680,Sant Joan de Mollet,351,171,180
17,1851,Sant Joan les Fonts,2777,1387,1390
17,1668,Sant Jordi Desvalls,602,306,296
17,1693,Sant Julià de Ramis,1959,982,977
17,9032,Sant Julià del Llor i Bonmatí,925,471,454
17,1714,Sant Llorenç de la Muga,127,64,63
17,1729,Sant Martí de Llémena,396,205,191
17,1735,Sant Martí Vell,171,88,83
17,1740,Sant Miquel de Campmajor,219,123,96
17,1753,Sant Miquel de Fluvià,539,275,264
17,1766,Sant Mori,144,72,72
17,1772,Sant Pau de Segúries,659,327,332
17,1788,Sant Pere Pescador,1379,747,632
17,1805,Santa Coloma de Farners,8594,4375,4219
17,1812,Santa Cristina d'Aro,2650,1380,1270
17,1827,Santa Llogaia d'Àlguema,305,160,145
17,1848,Santa Pau,1448,745,703
17,1864,Sarrià de Ter,3139,1532,1607
17,1870,Saus,688,336,352
17,1886,Selva de Mar (La),189,98,91
17,1903,Serinyà,791,411,380
17,1910,Serra de Daró,180,91,89
17,1925,Setcases,158,81,77
17,1931,Sils,2848,1440,1408
17,524,Siurana,158,73,85
17,1946,Susqueda,89,49,40
17,1959,Tallada d'Empordà (La),326,169,157
17,1962,Terrades,183,86,97
17,1978,Torrent,173,86,87
17,1984,Torroella de Fluvià,300,165,135
17,1997,Torroella de Montgrí,8020,4065,3955
17,2001,Tortellà,709,358,351
17,2018,Toses,141,84,57
17,2023,Tossa de Mar,4016,1984,2032
17,2044,Ullà,803,419,384
17,2057,Ullastret,243,127,116
17,2039,Ultramort,194,107,87
17,2060,Urús,163,86,77
17,144,Vajol (La),68,35,33
17,2095,Vall-llobrega,324,147,177
17,2082,Vall de Bianya (La),1129,556,573
17,2076,Vall d'en Bas (La),2501,1285,1216
17,1707,Vallfogona de Ripollès,217,112,105
17,2109,Ventalló,571,296,275
17,2116,Verges,1127,555,572
17,2121,Vidrà,163,82,81
17,2137,Vidreres,4302,2162,2140
17,2305,Vila-sacra,344,165,179
17,2142,Vilabertran,775,388,387
17,2155,Vilablareix,1535,766,769
17,2174,Viladamat,408,210,198
17,2168,Viladasens,193,98,95
17,2180,Vilademuls,736,371,365
17,2207,Viladrau,861,434,427
17,2214,Vilafant,3636,1822,1814
17,2235,Vilajuïga,894,443,451
17,2240,Vilallonga de Ter,423,227,196
17,2253,Vilamacolum,246,120,126
17,2266,Vilamalla,615,319,296
17,2272,Vilamaniscle,123,64,59
17,2288,Vilanant,295,157,138
17,2229,Vilaür,115,67,48
17,2333,Vilobí d'Onyar,2153,1118,1035
17,2327,Vilopriu,158,78,80
18,16,Agrón,425,222,203
18,21,Alamedilla,953,483,470
18,37,Albolote,12693,6357,6336
18,42,Albondón,1060,520,540
18,55,Albuñán,486,243,243
18,68,Albuñol,5482,2749,2733
18,74,Albuñuelas,1258,649,609
18,107,Aldeire,789,400,389
18,114,Alfacar,4255,2154,2101
18,129,Algarinejo,5269,2693,2576
18,135,Alhama de Granada,5894,2949,2945
18,140,Alhendín,4157,2098,2059
18,153,Alicún de Ortega,727,389,338
18,166,Almegíjar,430,217,213
18,172,Almuñécar,20997,10367,10630
18,9043,Alpujarra de la Sierra,1204,613,591
18,188,Alquife,962,474,488
18,205,Arenas del Rey,2028,1048,980
18,212,Armilla,13211,6511,6700
18,227,Atarfe,10477,5173,5304
18,233,Baza,20113,9838,10275
18,248,Beas de Granada,959,501,458
18,251,Beas de Guadix,389,205,184
18,270,Benalúa de Guadix,3339,1663,1676
18,286,Benalúa de las Villas,1379,686,693
18,299,Benamaurel,2431,1228,1203
18,303,Bérchules,808,425,383
18,325,Bubión,376,182,194
18,331,Busquístar,349,189,160
18,346,Cacín,820,414,406
18,359,Cádiar,1703,883,820
18,362,Cájar,2828,1322,1506
18,1149,Calahorra (La),927,455,472
18,378,Calicasas,602,304,298
18,384,Campotéjar,1452,738,714
18,397,Caniles,5116,2498,2618
18,401,Cáñar,305,148,157
18,423,Capileira,560,272,288
18,439,Carataunas,191,99,92
18,444,Cástaras,314,166,148
18,457,Castilléjar,2114,1045,1069
18,460,Castril,2848,1448,1400
18,476,Cenes de la Vega,4515,2301,2214
18,592,Chauchina,4058,1995,2063
18,613,Chimeneas,1537,770,767
18,628,Churriana de la Vega,6435,3186,3249
18,482,Cijuela,1523,747,776
18,495,Cogollos de Guadix,768,402,366
18,508,Cogollos de la Vega,2020,1028,992
18,515,Colomera,1692,867,825
18,536,Cortes de Baza,2765,1420,1345
18,541,Cortes y Graena,1013,520,493
18,9120,Cuevas del Campo,2256,1124,1132
18,567,Cúllar,5078,2533,2545
18,573,Cúllar Vega,3080,1535,1545
18,634,Darro,1521,751,770
18,649,Dehesas de Guadix,694,350,344
18,665,Deifontes,2415,1206,1209
18,671,Diezma,945,496,449
18,687,Dílar,1511,744,767
18,690,Dólar,643,315,328
18,704,Dúdar,296,153,143
18,711,Dúrcal,5774,2857,2917
18,726,Escúzar,857,429,428
18,747,Ferreira,375,179,196
18,763,Fonelas,1286,647,639
18,785,Freila,1034,526,508
18,798,Fuente Vaqueros,3969,1967,2002
18,9056,Gabias (Las),7906,3951,3955
18,824,Galera,1378,685,693
18,830,Gobernador,390,198,192
18,845,Gójar,3340,1702,1638
18,858,Gor,1165,577,588
18,861,Gorafe,581,281,300
18,877,Granada,241471,112719,128752
18,883,Guadahortuna,2303,1181,1122
18,896,Guadix,20322,10060,10262
18,9069,Guajares (Los),1361,693,668
18,938,Gualchos,2968,1496,1472
18,943,Güejar Sierra,2698,1369,1329
18,956,Güevéjar,1438,716,722
18,969,Huélago,644,336,308
18,975,Huéneja,1277,627,650
18,981,Huéscar,8013,3957,4056
18,994,Huétor de Santillán,1649,857,792
18,1008,Huétor Tájar,8298,4126,4172
18,1015,Huétor Vega,8297,4152,4145
18,1020,Illora,10664,5357,5307
18,1036,Itrabo,1029,505,524
18,1054,Iznalloz,6451,3264,3187
18,1073,Jayena,1395,707,688
18,1089,Jerez del Marquesado,1174,590,584
18,1092,Jete,752,362,390
18,1113,Jun,1623,819,804
18,1128,Juviles,187,95,92
18,1152,Láchar,2434,1228,1206
18,1165,Lanjarón,3877,1918,1959
18,1171,Lanteira,669,337,332
18,1190,Lecrín,2375,1173,1202
18,1204,Lentegí,347,160,187
18,1211,Lobras,181,88,93
18,1226,Loja,20143,9969,10174
18,1232,Lugros,412,209,203
18,1247,Lújar,562,298,264
18,1263,Malahá (La),1576,797,779
18,1279,Maracena,14331,7139,7192
18,1285,Marchal,439,209,230
18,1324,Moclín,4618,2283,2335
18,1330,Molvízar,2670,1307,1363
18,1345,Monachil,4831,2436,2395
18,1358,Montefrío,7030,3522,3508
18,1361,Montejícar,2888,1458,1430
18,1377,Montillana,1396,704,692
18,1383,Moraleda de Zafayona,2722,1390,1332
18,9094,Morelábor,917,466,451
18,1400,Motril,50025,24668,25357
18,1417,Murtas,852,438,414
18,9038,Nevada,1369,700,669
18,1438,Nigüelas,1154,586,568
18,1443,Nívar,641,330,311
18,1456,Ogíjares,8123,4084,4039
18,1469,Orce,1427,718,709
18,1475,Órgiva,5039,2531,2508
18,1481,Otívar,1096,547,549
18,1494,Otura,3828,1908,1920
18,1507,Padul,6632,3321,3311
18,1514,Pampaneira,337,172,165
18,1529,Pedro Martínez,1499,755,744
18,1535,Peligros,7380,3653,3727
18,1540,Peza (La),1450,764,686
18,9108,Pinar (El),1253,630,623
18,1572,Pinos Genil,1186,619,567
18,1588,Pinos Puente,13215,6640,6575
18,1591,Píñar,1397,724,673
18,1612,Polícar,254,133,121
18,1627,Polopos,1264,655,609
18,1633,Pórtugos,444,216,228
18,1648,Puebla de Don Fadrique,2569,1283,1286
18,1651,Pulianas,3599,1833,1766
18,1670,Purullena,2068,1014,1054
18,1686,Quéntar,1108,551,557
18,1703,Rubite,410,217,193
18,1710,Salar,2783,1380,1403
18,1731,Salobreña,10053,5010,5043
18,1746,Santa Cruz del Comercio,555,292,263
18,1759,Santa Fe,12387,6083,6304
18,1762,Soportújar,288,153,135
18,1778,Sorvilán,679,344,335
18,9017,Taha (La),830,414,416
18,1784,Torre-Cardela,1225,613,612
18,1797,Torvizcón,972,490,482
18,1801,Trevélez,793,417,376
18,1818,Turón,361,205,156
18,1823,Ugíjar,2572,1278,1294
18,9022,Valle (El),1377,669,708
18,9075,Valle del Zalabí,2417,1193,1224
18,1839,Válor,1001,506,495
18,9115,Vegas del Genil,2758,1391,1367
18,1844,Vélez de Benaudalla,2563,1252,1311
18,1857,Ventas de Huelma,675,327,348
18,9081,Villamena,1010,474,536
18,1876,Villanueva de las Torres,965,505,460
18,1882,Villanueva Mesía,1897,941,956
18,1895,Víznar,743,388,355
18,1921,Zafarraya,2213,1143,1070
18,9136,Zagra,1215,600,615
18,1937,Zubia (La),12407,6101,6306
18,1942,Zújar,2887,1469,1418
19,19,Abánades,115,62,53
19,24,Ablanque,158,79,79
19,30,Adobes,43,22,21
19,45,Alaminos,86,40,46
19,58,Alarilla,122,67,55
19,61,Albalate de Zorita,1002,533,469
19,77,Albares,497,243,254
19,83,Albendiego,47,27,20
19,96,Alcocer,299,153,146
19,100,Alcolea de las Peñas,32,17,15
19,117,Alcolea del Pinar,397,197,200
19,138,Alcoroches,202,111,91
19,156,Aldeanueva de Guadalajara,101,44,57
19,169,Algar de Mesa,83,45,38
19,175,Algora,117,64,53
19,181,Alhóndiga,241,136,105
19,194,Alique,27,8,19
19,208,Almadrones,90,54,36
19,215,Almoguera,899,469,430
19,220,Almonacid de Zorita,921,446,475
19,236,Alocén,147,67,80
19,241,Alovera,1444,745,699
19,273,Alustante,261,140,121
19,313,Angón,47,26,21
19,328,Anguita,299,156,143
19,334,Anquela del Ducado,98,51,47
19,349,Anquela del Pedregal,26,16,10
19,365,Aranzueque,367,184,183
19,371,Arbancón,225,121,104
19,387,Arbeteta,54,28,26
19,390,Argecilla,113,68,45
19,404,Armallones,60,37,23
19,411,Armuña de Tajuña,111,60,51
19,426,Arroyo de las Fraguas,47,25,22
19,432,Atanzón,106,60,46
19,447,Atienza,489,254,235
19,450,Auñón,260,138,122
19,463,Azuqueca de Henares,17505,8876,8629
19,479,Baides,93,50,43
19,485,Baños de Tajo,31,20,11
19,498,Bañuelos,30,17,13
19,501,Barriopedro,36,15,21
19,518,Berninches,115,66,49
19,523,Bodera (La),60,33,27
19,539,Brihuega,2916,1483,1433
19,544,Budia,282,152,130
19,557,Bujalaro,85,46,39
19,576,Bustares,105,58,47
19,582,Cabanillas del Campo,2287,1176,1111
19,595,Campillo de Dueñas,142,85,57
19,609,Campillo de Ranas,128,68,60
19,616,Campisábalos,61,29,32
19,642,Canredondo,108,54,54
19,655,Cantalojas,155,83,72
19,668,Cañizar,108,53,55
19,674,Cardoso de la Sierra (El),96,62,34
19,707,Casa de Uceda,116,61,55
19,714,Casar (El),2742,1422,1320
19,735,Casas de San Galindo,39,23,16
19,740,Caspueñas,83,49,34
19,753,Castejón de Henares,120,65,55
19,766,Castellar de la Muela,50,22,28
19,788,Castilforte,54,32,22
19,791,Castilnuevo,11,5,6
19,805,Cendejas de Enmedio,126,62,64
19,812,Cendejas de la Torre,102,59,43
19,827,Centenera,74,40,34
19,1039,Checa,420,224,196
19,1044,Chequilla,16,8,8
19,1060,Chillarón del Rey,126,66,60
19,1057,Chiloeches,1091,566,525
19,864,Cifuentes,2299,1156,1143
19,870,Cincovillas,39,21,18
19,886,Ciruelas,86,44,42
19,899,Ciruelos del Pinar,59,31,28
19,903,Cobeta,122,64,58
19,910,Cogollor,59,32,27
19,925,Cogolludo,603,337,266
19,959,Condemios de Abajo,29,17,12
19,962,Condemios de Arriba,176,88,88
19,978,Congostrina,37,15,22
19,984,Copernal,29,17,12
19,997,Corduente,470,257,213
19,1023,Cubillo de Uceda (El),134,65,69
19,1076,Driebes,366,191,175
19,1082,Durón,108,53,55
19,1095,Embid,68,37,31
19,1109,Escamilla,132,57,75
19,1116,Escariche,204,107,97
19,1121,Escopete,61,19,42
19,1137,Espinosa de Henares,604,302,302
19,1142,Esplegares,63,36,27
19,1155,Establés,47,26,21
19,1168,Estriégana,27,17,10
19,1174,Fontanar,931,475,456
19,1180,Fuembellida,17,10,7
19,1193,Fuencemillán,123,64,59
19,1207,Fuentelahiguera de Albatages,164,85,79
19,1214,Fuentelencina,176,99,77
19,1229,Fuentelsaz,142,69,73
19,1235,Fuentelviejo,78,38,40
19,1240,Fuentenovilla,222,124,98
19,1253,Gajanejos,89,47,42
19,1266,Galápagos,225,114,111
19,1272,Galve de Sorbe,162,77,85
19,1291,Gascueña de Bornova,48,25,23
19,1305,Guadalajara,68721,33769,34952
19,1327,Henche,79,41,38
19,1333,Heras de Ayuso,129,65,64
19,1348,Herrería,42,18,24
19,1351,Hiendelaencina,139,71,68
19,1364,Hijes,26,14,12
19,1386,Hita,295,163,132
19,1399,Hombrados,48,26,22
19,1425,Hontoba,187,96,91
19,1431,Horche,1407,712,695
19,1459,Hortezuela de Océn,79,41,38
19,1462,Huerce (La),40,22,18
19,1478,Huérmeces del Cerro,66,39,27
19,1484,Huertahernando,74,45,29
19,1500,Hueva,143,71,72
19,1517,Humanes,1223,627,596
19,1522,Illana,684,357,327
19,1538,Iniéstola,18,11,7
19,1543,Inviernas (Las),87,48,39
19,1556,Irueste,68,37,31
19,1569,Jadraque,1272,635,637
19,1575,Jirueque,73,40,33
19,1594,Ledanca,143,75,68
19,1608,Loranca de Tajuña,312,171,141
19,1615,Lupiana,277,147,130
19,1620,Luzaga,124,61,63
19,1636,Luzón,88,43,45
19,1654,Majaelrayo,57,31,26
19,1667,Málaga del Fresno,221,114,107
19,1673,Malaguilla,157,94,63
19,1689,Mandayona,462,217,245
19,1692,Mantiel,69,36,33
19,1706,Maranchón,245,132,113
19,1728,Masegoso de Tajuña,100,49,51
19,1734,Matarrubia,55,34,21
19,1749,Matillas,216,111,105
19,1752,Mazarete,79,38,41
19,1765,Mazuecos,387,197,190
19,1771,Medranda,134,66,68
19,1787,Megina,87,44,43
19,1790,Membrillera,104,49,55
19,1811,Miedes de Atienza,101,51,50
19,1826,Mierla (La),27,15,12
19,1847,Millana,118,60,58
19,1832,Milmarcos,114,61,53
19,1850,Miñosa (La),48,27,21
19,1863,Mirabueno,121,64,57
19,1879,Miralrío,85,50,35
19,1885,Mochales,121,57,64
19,1898,Mohernando,139,81,58
19,1902,Molina de Aragón,3432,1760,1672
19,1919,Monasterio,19,8,11
19,1924,Mondéjar,2065,1029,1036
19,1930,Montarrón,59,33,26
19,1945,Moratilla de los Meleros,111,58,53
19,1958,Morenilla,53,34,19
19,1961,Muduex,122,63,59
19,1977,Navas de Jadraque (Las),26,16,10
19,1983,Negredo,23,10,13
19,1996,Ocentejo,52,23,29
19,2000,Olivar (El),114,56,58
19,2017,Olmeda de Cobeta,75,29,46
19,2022,Olmeda de Jadraque (La),19,9,10
19,2038,Ordial (El),48,20,28
19,2043,Orea,273,148,125
19,2081,Pálmaces de Jadraque,65,34,31
19,2094,Pardos,63,31,32
19,2108,Paredes de Sigüenza,68,36,32
19,2115,Pareja,469,232,237
19,2120,Pastrana,1161,590,571
19,2136,Pedregal (El),110,61,49
19,2141,Peñalén,147,79,68
19,2154,Peñalver,246,142,104
19,2167,Peralejos de las Truchas,176,92,84
19,2173,Peralveche,79,42,37
19,2189,Pinilla de Jadraque,92,47,45
19,2192,Pinilla de Molina,26,17,9
19,2206,Pioz,366,195,171
19,2213,Piqueras,60,34,26
19,2228,Pobo de Dueñas (El),180,97,83
19,2234,Poveda de la Sierra,207,107,100
19,2249,Pozo de Almoguera,207,106,101
19,2252,Pozo de Guadalajara,379,200,179
19,2265,Prádena de Atienza,38,23,15
19,2271,Prados Redondos,86,51,35
19,2287,Puebla de Beleña,41,26,15
19,2290,Puebla de Valles,67,37,30
19,2304,Quer,102,49,53
19,2311,Rebollosa de Jadraque,39,21,18
19,2326,Recuenco (El),93,48,45
19,2332,Renera,64,34,30
19,2347,Retiendas,51,25,26
19,2350,Riba de Saelices,183,100,83
19,2379,Rillo de Gallo,66,38,28
19,2385,Riofrío del Llano,75,44,31
19,2398,Robledillo de Mohernando,174,89,85
19,2402,Robledo de Corpes,73,38,35
19,2419,Romanillos de Atienza,70,42,28
19,2424,Romanones,143,82,61
19,2430,Rueda de la Sierra,70,38,32
19,2445,Sacecorbo,134,79,55
19,2458,Sacedón,1538,769,769
19,2461,Saelices de la Sal,68,34,34
19,2477,Salmerón,285,152,133
19,2483,San Andrés del Congosto,84,44,40
19,2496,San Andrés del Rey,42,17,25
19,2509,Santiuste,29,14,15
19,2516,Saúca,70,36,34
19,2521,Sayatón,172,92,80
19,2542,Selas,57,26,31
19,9010,Semillas,35,16,19
19,2555,Setiles,160,88,72
19,2568,Sienes,91,51,40
19,2574,Sigüenza,4801,2407,2394
19,2580,Solanillos del Extremo,127,66,61
19,2593,Somolinos,40,20,20
19,2607,Sotillo (El),50,30,20
19,2614,Sotodosos,64,31,33
19,2629,Tamajón,226,111,115
19,2635,Taragudo,31,18,13
19,2640,Taravilla,72,37,35
19,2653,Tartanedo,207,103,104
19,2666,Tendilla,361,188,173
19,2672,Terzaga,35,22,13
19,2688,Tierzo,43,23,20
19,2691,Toba (La),116,66,50
19,2712,Tordellego,76,38,38
19,2705,Tordelrábano,16,8,8
19,2727,Tordesilos,141,74,67
19,2748,Torija,365,178,187
19,2799,Torre del Burgo,66,36,30
19,2770,Torrecuadrada de Molina,17,11,6
19,2786,Torrecuadradilla,72,44,28
19,2803,Torrejón del Rey,974,509,465
19,2810,Torremocha de Jadraque,16,12,4
19,2825,Torremocha del Campo,326,180,146
19,2831,Torremocha del Pinar,73,34,39
19,2846,Torremochuela,14,7,7
19,2859,Torrubia,45,24,21
19,2862,Tórtola de Henares,384,197,187
19,2878,Tortuera,238,123,115
19,2884,Tortuero,43,25,18
19,2897,Traíd,62,29,33
19,2901,Trijueque,526,279,247
19,2918,Trillo,1447,741,706
19,2939,Uceda,824,411,413
19,2944,Ujados,36,20,16
19,2960,Utande,60,37,23
19,2976,Valdarachas,30,12,18
19,2982,Valdearenas,66,34,32
19,2995,Valdeavellano,97,52,45
19,3009,Valdeaveruelo,229,125,104
19,3016,Valdeconcha,46,26,20
19,3021,Valdegrudas,58,31,27
19,3037,Valdelcubo,68,40,28
19,3042,Valdenuño Fernández,141,72,69
19,3055,Valdepeñas de la Sierra,237,132,105
19,3068,Valderrebollo,36,20,16
19,3074,Valdesotos,44,19,25
19,3080,Valfermoso de Tajuña,109,57,52
19,3093,Valhermoso,35,20,15
19,3107,Valtablado del Río,15,10,5
19,3114,Valverde de los Arroyos,100,55,45
19,3140,Viana de Jadraque,61,36,25
19,3172,Villanueva de Alcorón,301,167,134
19,3188,Villanueva de Argecilla,40,21,19
19,3191,Villanueva de la Torre,322,163,159
19,3212,Villares de Jadraque,54,26,28
19,3227,Villaseca de Henares,75,36,39
19,3233,Villaseca de Uceda,64,35,29
19,3248,Villel de Mesa,261,136,125
19,3251,Viñuelas,118,70,48
19,3264,Yebes,169,122,47
19,3270,Yebra,562,288,274
19,3299,Yélamos de Abajo,102,49,53
19,3303,Yélamos de Arriba,153,78,75
19,3310,Yunquera de Henares,2005,1016,989
19,3325,Yunta (La),177,88,89
19,3331,Zaorejas,195,111,84
19,3346,Zarzuela de Jadraque,28,13,15
19,3359,Zorita de los Canes,111,62,49
20,13,Abaltzisketa,265,155,110
20,28,Aduna,308,165,143
20,163,Aia,1651,925,726
20,34,Aizarnazabal,543,293,250
20,49,Albiztur,288,158,130
20,52,Alegia,1639,835,804
20,65,Alkiza,255,146,109
20,9066,Altzaga,97,50,47
20,71,Altzo,330,178,152
20,87,Amezketa,1006,533,473
20,90,Andoain,14371,7193,7178
20,104,Anoeta,1749,903,846
20,111,Antzuola,1920,987,933
20,126,Arama,158,77,81
20,132,Aretxabaleta,5975,3056,2919
20,551,Arrasate o Mondragón,24185,12093,12092
20,147,Asteasu,1172,634,538
20,9035,Astigarraga,3201,1584,1617
20,150,Ataun,1574,811,763
20,179,Azkoitia,10231,5066,5165
20,185,Azpeitia,13606,6826,6780
20,9040,Baliarrain,84,41,43
20,198,Beasain,12297,6150,6147
20,202,Beizama,163,92,71
20,219,Belauntza,295,160,135
20,224,Berastegi,951,513,438
20,744,Bergara,15141,7531,7610
20,230,Berrobi,552,300,252
20,245,Bidegoyan,414,235,179
20,296,Deba,5032,2555,2477
20,697,Donostia-San Sebastián,178229,83416,94813
20,300,Eibar,29747,14594,15153
20,317,Elduain,221,119,102
20,338,Elgeta,984,503,481
20,322,Elgoibar,10869,5423,5446
20,662,Errezil,638,345,293
20,343,Eskoriatza,3987,2072,1915
20,356,Ezkio-Itsaso,537,285,252
20,381,Gabiria,436,242,194
20,375,Gaintza,132,80,52
20,9072,Gaztelu,148,88,60
20,394,Getaria,2345,1184,1161
20,408,Hernani,18787,9338,9449
20,415,Hernialde,302,151,151
20,369,Hondarribia,14546,7250,7296
20,420,Ibarra,4380,2278,2102
20,436,Idiazabal,2032,1037,995
20,441,Ikaztegieta,379,199,180
20,454,Irun,55196,26943,28253
20,467,Irura,745,380,365
20,473,Itsasondo,609,304,305
20,489,Larraul,136,81,55
20,9029,Lasarte-Oria,17750,8837,8913
20,492,Lazkao,4847,2492,2355
20,505,Leaburu,356,190,166
20,512,Legazpi,9126,4675,4451
20,527,Legorreta,1423,716,707
20,684,Leintz-Gatzaga,254,139,115
20,533,Lezo,5798,2877,2921
20,548,Lizartza,621,326,295
20,9014,Mendaro,1284,661,623
20,570,Mutiloa,158,81,77
20,564,Mutriku,4743,2355,2388
20,631,Oiartzun,9003,4525,4478
20,586,Olaberria,985,509,476
20,599,Oñati,10634,5322,5312
20,760,Ordizia,9066,4421,4645
20,9053,Orendain,150,85,65
20,603,Orexa,80,42,38
20,610,Orio,4294,2169,2125
20,625,Ormaiztegi,1173,587,586
20,646,Pasaia,17255,8409,8846
20,678,Rentería,39376,19431,19945
20,701,Segura,1263,623,640
20,659,Soraluze/Placencia de las Armas,4337,2165,2172
20,718,Tolosa,18066,8673,9393
20,723,Urnieta,5295,2700,2595
20,776,Urretxu,6283,3137,3146
20,739,Usurbil,5282,2714,2568
20,757,Villabona,5408,2746,2662
20,782,Zaldibia,1550,811,739
20,795,Zarautz,19716,9716,10000
20,258,Zegama,1312,669,643
20,261,Zerain,236,118,118
20,277,Zestoa,3182,1646,1536
20,283,Zizurkil,2660,1357,1303
20,816,Zumaia,8305,4153,4152
20,809,Zumarraga,10330,5170,5160
21,10,Alájar,774,391,383
21,25,Aljaraque,9743,4882,4861
21,31,Almendro (El),880,454,426
21,46,Almonaster la Real,2016,980,1036
21,59,Almonte,16902,8470,8432
21,62,Alosno,4861,2346,2515
21,78,Aracena,6683,3279,3404
21,84,Aroche,3542,1755,1787
21,97,Arroyomolinos de León,1163,591,572
21,101,Ayamonte,16891,8287,8604
21,118,Beas,4165,2083,2082
21,123,Berrocal,416,207,209
21,139,Bollullos Par del Condado,12634,6279,6355
21,144,Bonares,5056,2563,2493
21,157,Cabezas Rubias,973,500,473
21,160,Cala,1450,724,726
21,176,Calañas,4928,2432,2496
21,182,Campillo (El),2446,1180,1266
21,195,Campofrío,866,443,423
21,209,Cañaveral de León,514,249,265
21,216,Cartaya,11809,5886,5923
21,221,Castaño del Robledo,207,110,97
21,237,Cerro de Andévalo (El),2762,1344,1418
21,307,Chucena,1943,984,959
21,242,Corteconcepción,680,341,339
21,255,Cortegana,5137,2554,2583
21,268,Cortelazor,326,164,162
21,274,Cumbres de Enmedio,63,32,31
21,280,Cumbres de San Bartolomé,575,287,288
21,293,Cumbres Mayores,2161,1058,1103
21,314,Encinasola,1865,916,949
21,329,Escacena del Campo,2159,1071,1088
21,335,Fuenteheridos,658,335,323
21,340,Galaroza,1586,771,815
21,353,Gibraleón,10868,5485,5383
21,366,Granada de Río-Tinto (La),224,114,110
21,372,Granado (El),664,363,301
21,388,Higuera de la Sierra,1271,643,628
21,391,Hinojales,440,218,222
21,405,Hinojos,3529,1790,1739
21,412,Huelva,139991,67662,72329
21,427,Isla Cristina,17761,8895,8866
21,433,Jabugo,2590,1299,1291
21,448,Lepe,18565,9487,9078
21,451,Linares de la Sierra,300,146,154
21,464,Lucena del Puerto,2191,1124,1067
21,470,Manzanilla,2519,1252,1267
21,486,Marines (Los),320,161,159
21,499,Minas de Riotinto,5056,2404,2652
21,502,Moguer,13749,6972,6777
21,519,Nava (La),321,166,155
21,524,Nerva,6544,3174,3370
21,530,Niebla,3814,1932,1882
21,545,Palma del Condado (La),9614,4755,4859
21,558,Palos de la Frontera,7009,3563,3446
21,561,Paterna del Campo,3914,1994,1920
21,577,Paymogo,1247,608,639
21,583,Puebla de Guzmán,3228,1625,1603
21,596,Puerto Moral,242,120,122
21,600,Punta Umbría,11523,5870,5653
21,617,Rociana del Condado,6310,3222,3088
21,622,Rosal de la Frontera,1880,896,984
21,638,San Bartolomé de la Torre,2909,1485,1424
21,643,San Juan del Puerto,5910,2959,2951
21,669,San Silvestre de Guzmán,648,318,330
21,656,Sanlúcar de Guadiana,393,197,196
21,675,Santa Ana la Real,495,236,259
21,681,Santa Bárbara de Casa,1377,684,693
21,694,Santa Olalla del Cala,2278,1147,1131
21,708,Trigueros,7229,3602,3627
21,715,Valdelarco,279,133,146
21,720,Valverde del Camino,12510,6081,6429
21,736,Villablanca,2052,1066,986
21,741,Villalba del Alcor,3587,1778,1809
21,754,Villanueva de las Cruces,428,198,230
21,767,Villanueva de los Castillejos,2677,1314,1363
21,773,Villarrasa,2082,1063,1019
21,789,Zalamea la Real,3489,1715,1774
21,792,Zufre,1097,569,528
22,15,Abiego,290,147,143
22,20,Abizanda,140,73,67
22,36,Adahuesca,158,83,75
22,41,Agüero,157,81,76
22,9074,Aínsa-Sobrarbe,1557,804,753
22,67,Aisa,363,199,164
22,73,Albalate de Cinca,1090,542,548
22,89,Albalatillo,270,136,134
22,92,Albelda,962,489,473
22,113,Albero Alto,100,53,47
22,128,Albero Bajo,119,64,55
22,134,Alberuela de Tubo,388,193,195
22,149,Alcalá de Gurrea,342,166,176
22,152,Alcalá del Obispo,355,180,175
22,165,Alcampell,950,474,476
22,171,Alcolea de Cinca,1237,623,614
22,187,Alcubierre,467,248,219
22,190,Alerre,181,94,87
22,204,Alfántega,128,65,63
22,211,Almudévar,2373,1220,1153
22,226,Almunia de San Juan,709,355,354
22,232,Almuniente,619,321,298
22,247,Alquézar,304,157,147
22,250,Altorricón,1448,750,698
22,279,Angüés,429,234,195
22,285,Ansó,527,262,265
22,298,Antillón,161,78,83
22,324,Aragüés del Puerto,138,82,56
22,358,Arén,398,205,193
22,361,Argavieso,127,73,54
22,377,Arguis,57,30,27
22,396,Ayerbe,1116,576,540
22,400,Azanuy-Alins,203,97,106
22,417,Azara,224,111,113
22,422,Azlor,166,83,83
22,438,Baélls,157,89,68
22,443,Bailo,321,186,135
22,456,Baldellou,156,83,73
22,469,Ballobar,1084,544,540
22,475,Banastás,177,94,83
22,481,Barbastro,14462,7027,7435
22,494,Barbués,119,61,58
22,507,Barbuñales,109,55,54
22,514,Bárcabo,120,66,54
22,529,Belver de Cinca,1397,728,669
22,535,Benabarre,1166,600,566
22,540,Benasque,1312,693,619
22,553,Berbegal,476,241,235
22,572,Bielsa,461,239,222
22,588,Bierge,224,128,96
22,591,Biescas,1243,651,592
22,605,Binaced,1597,815,782
22,612,Binéfar,8115,4053,4062
22,627,Bisaurri,220,123,97
22,633,Biscarrués,227,123,104
22,648,Blecua y Torres,178,95,83
22,664,Boltaña,846,437,409
22,670,Bonansa,74,38,36
22,686,Borau,76,39,37
22,699,Broto,511,261,250
22,725,Caldearenas,260,144,116
22,746,Campo,360,171,189
22,759,Camporrélls,254,130,124
22,762,Canal de Berdún,433,239,194
22,778,Candasnos,569,295,274
22,784,Canfranc,526,290,236
22,797,Capdesaso,177,81,96
22,801,Capella,402,204,198
22,818,Casbas de Huesca,308,164,144
22,839,Castejón de Monegros,723,360,363
22,844,Castejón de Sos,532,275,257
22,823,Castejón del Puente,400,210,190
22,857,Castelflorite,152,79,73
22,860,Castiello de Jaca,160,82,78
22,876,Castigaleu,104,59,45
22,882,Castillazuelo,233,110,123
22,895,Castillonroy,423,207,216
22,942,Chalamera,166,94,72
22,955,Chía,115,64,51
22,968,Chimillas,177,96,81
22,909,Colungo,124,65,59
22,993,Esplús,797,380,417
22,1029,Estada,185,95,90
22,1035,Estadilla,928,477,451
22,1053,Estopiñán del Castillo,188,98,90
22,1066,Fago,40,25,15
22,1072,Fanlo,118,70,48
22,1091,Fiscal,229,124,105
22,1105,Fonz,1123,572,551
22,1112,Foradada del Toscar,252,120,132
22,1127,Fraga,11804,5900,5904
22,1133,Fueva (La),626,331,295
22,1148,Gistaín,181,106,75
22,1151,Grado (El),571,296,275
22,1164,Grañén,2006,1018,988
22,1170,Graus,3232,1633,1599
22,1199,Gurrea de Gállego,1871,956,915
22,1225,Hoz de Jaca,76,32,44
22,9080,Hoz y Costean,268,143,125
22,1246,Huerto,275,153,122
22,1259,Huesca,45485,21904,23581
22,1262,Ibieca,105,53,52
22,1278,Igriés,185,94,91
22,1284,Ilche,284,150,134
22,1297,Isábena,257,132,125
22,1301,Jaca,11197,5537,5660
22,1318,Jasa,124,67,57
22,1339,Labuerda,165,87,78
22,1357,Laluenga,265,138,127
22,1360,Lalueza,1267,678,589
22,1376,Lanaja,1605,839,766
22,1395,Laperdiguera,102,51,51
22,1416,Lascellas-Ponzano,164,84,80
22,1421,Lascuarre,170,91,79
22,1437,Laspaúles,284,156,128
22,1442,Laspuña,268,144,124
22,1493,Loarre,396,211,185
22,1506,Loporzano,524,271,253
22,1513,Loscorrales,129,68,61
22,9055,Lupiñén-Ortilla,360,195,165
22,1552,Monesma y Cajigar,106,56,50
22,1565,Monflorite-Lascasas,192,105,87
22,1571,Montanuy,306,170,136
22,1587,Monzón,14539,7307,7232
22,1604,Naval,302,151,151
22,1626,Novales,189,95,94
22,1632,Nueno,215,118,97
22,1647,Olvena,55,24,31
22,1650,Ontiñena,656,332,324
22,1679,Osso de Cinca,750,405,345
22,1685,Palo,26,14,12
22,1702,Panticosa,647,324,323
22,1724,Peñalba,812,406,406
22,1730,Peñas de Riglos (Las),276,156,120
22,1745,Peralta de Alcofea,727,361,366
22,1758,Peralta de Calasanz,292,153,139
22,1761,Peraltilla,171,92,79
22,1777,Perarrúa,135,65,70
22,1783,Pertusa,149,77,72
22,1817,Piracés,101,64,37
22,1822,Plan,306,167,139
22,1843,Poleñino,252,126,126
22,1869,Pozán de Vero,254,122,132
22,1875,Puebla de Castro (La),306,160,146
22,1881,Puente de Montañana,129,60,69
22,9021,Puente la Reina de Jaca,241,125,116
22,1894,Puértolas,213,120,93
22,1908,Pueyo de Araguás (El),163,100,63
22,1936,Pueyo de Santa Cruz,359,185,174
22,1954,Quicena,135,71,64
22,1973,Robres,690,357,333
22,1992,Sabiñánigo,8637,4376,4261
22,2006,Sahún,311,168,143
22,2013,Salas Altas,389,197,192
22,2028,Salas Bajas,173,77,96
22,2034,Salillas,128,67,61
22,2049,Sallent de Gállego,1016,537,479
22,2052,San Esteban de Litera,634,317,317
22,2071,San Juan de Plan,162,90,72
22,9037,San Miguel del Cinca,903,473,430
22,2065,Sangarrén,283,140,143
22,2087,Santa Cilia de Jaca,204,109,95
22,2090,Santa Cruz de la Serós,155,89,66
22,9068,Santa María de Dulcis,210,107,103
22,2126,Santaliestra y San Quílez,97,56,41
22,2132,Sariñena,4026,2001,2025
22,2147,Secastilla,163,71,92
22,2150,Seira,210,107,103
22,2179,Sena,596,313,283
22,2185,Senés de Alcubierre,60,31,29
22,2202,Sesa,268,136,132
22,2219,Sesué,123,64,59
22,2224,Siétamo,373,207,166
22,2230,Sopeira,105,53,52
22,9042,Sotonera (La),1108,589,519
22,2258,Tamarite de Litera,3838,1913,1925
22,2261,Tardienta,1063,550,513
22,2277,Tella-Sin,267,137,130
22,2283,Tierz,180,91,89
22,2296,Tolva,209,110,99
22,2300,Torla,330,174,156
22,2322,Torralba de Aragón,133,62,71
22,2338,Torre la Ribera,120,65,55
22,2343,Torrente de Cinca,1121,555,566
22,2356,Torres de Alcanadre,139,80,59
22,2369,Torres de Barbués,365,185,180
22,2394,Tramaced,105,63,42
22,2420,Valfarta,101,56,45
22,2436,Valle de Bardají,56,29,27
22,9016,Valle de Hecho,980,514,466
22,2441,Valle de Lierp,60,31,29
22,2454,Velilla de Cinca,489,244,245
22,9093,Vencillón,480,245,235
22,2467,Veracruz,116,62,54
22,2473,Viacamp y Litera,33,22,11
22,2489,Vicién,116,64,52
22,2492,Villanova,104,56,48
22,2505,Villanúa,332,167,165
22,2512,Villanueva de Sigena,495,249,246
22,2527,Yebra de Basa,162,97,65
22,2533,Yésero,61,33,28
22,2548,Zaidín,1688,842,846
23,11,Albánchez de Úbeda,1496,766,730
23,26,Alcalá la Real,21493,10626,10867
23,32,Alcaudete,11346,5626,5720
23,47,Aldeaquemada,613,317,296
23,50,Andújar,38254,18938,19316
23,63,Arjona,5683,2876,2807
23,79,Arjonilla,3996,1998,1998
23,85,Arquillos,1892,941,951
23,98,Baeza,15635,7665,7970
23,102,Bailén,17414,8905,8509
23,119,Baños de la Encina,2747,1399,1348
23,124,Beas de Segura,8092,4115,3977
23,9027,Bedmar y Garcíez,3220,1631,1589
23,145,Begíjar,3176,1601,1575
23,158,Bélmez de la Moraleda,2067,1062,1005
23,161,Benatae,581,310,271
23,177,Cabra del Santo Cristo,2249,1151,1098
23,183,Cambil,3221,1694,1527
23,196,Campillo de Arenas,2250,1144,1106
23,200,Canena,2142,1042,1100
23,217,Carboneros,696,344,352
23,9012,Cárcheles,1550,770,780
23,243,Carolina (La),14674,7198,7476
23,256,Castellar,3654,1842,1812
23,269,Castillo de Locubín,5366,2628,2738
23,275,Cazalilla,821,399,422
23,281,Cazorla,8527,4156,4371
23,294,Chiclana de Segura,1488,736,752
23,308,Chilluévar,1781,881,900
23,315,Escañuela,976,488,488
23,320,Espelúy,805,391,414
23,336,Frailes,1872,955,917
23,341,Fuensanta de Martos,3377,1681,1696
23,354,Fuerte del Rey,1165,576,589
23,373,Génave,719,373,346
23,389,Guardia de Jaén (La),2093,1089,1004
23,392,Guarromán,2825,1403,1422
23,413,Higuera de Calatrava,706,366,340
23,428,Hinojares,502,245,257
23,434,Hornos,741,365,376
23,449,Huelma,6051,3082,2969
23,452,Huesa,2702,1365,1337
23,465,Ibros,3036,1525,1511
23,471,Iruela (La),2031,1036,995
23,487,Iznatoraf,1204,593,611
23,490,Jabalquinto,2583,1284,1299
23,503,Jaén,107184,51658,55526
23,510,Jamilena,3289,1673,1616
23,525,Jimena,1589,769,820
23,531,Jódar,12115,5991,6124
23,406,Lahiguera,1921,937,984
23,546,Larva,531,270,261
23,559,Linares,58410,28516,29894
23,562,Lopera,3996,1973,2023
23,578,Lupión,1092,521,571
23,584,Mancha Real,8970,4594,4376
23,597,Marmolejo,7666,3849,3817
23,601,Martos,22391,10793,11598
23,618,Mengíbar,8535,4291,4244
23,623,Montizón,2017,1032,985
23,639,Navas de San Juan,5285,2628,2657
23,644,Noalejo,2294,1145,1149
23,657,Orcera,2261,1135,1126
23,660,Peal de Becerro,5280,2611,2669
23,676,Pegalajar,3137,1615,1522
23,695,Porcuna,6974,3473,3501
23,709,Pozo Alcón,6010,3049,2961
23,716,Puente de Génave,2048,1036,1012
23,721,Puerta de Segura (La),2745,1368,1377
23,737,Quesada,6181,3018,3163
23,742,Rus,3793,1903,1890
23,755,Sabiote,4186,2088,2098
23,768,Santa Elena,1043,556,487
23,9048,Santiago-Pontones,4640,2345,2295
23,774,Santiago de Calatrava,931,466,465
23,793,Santisteban del Puerto,5074,2577,2497
23,807,Santo Tomé,2462,1233,1229
23,814,Segura de la Sierra,2186,1093,1093
23,829,Siles,2777,1384,1393
23,840,Sorihuela del Guadalimar,1269,649,620
23,866,Torre del Campo,12675,6347,6328
23,853,Torreblascopedro,3044,1509,1535
23,872,Torredonjimeno,13773,6775,6998
23,888,Torreperogil,7538,3712,3826
23,905,Torres,1854,956,898
23,912,Torres de Albánchez,1055,528,527
23,927,Úbeda,32524,15865,16659
23,933,Valdepeñas de Jaén,4573,2305,2268
23,948,Vilches,5086,2543,2543
23,951,Villacarrillo,11152,5600,5552
23,964,Villanueva de la Reina,3331,1660,1671
23,970,Villanueva del Arzobispo,8628,4297,4331
23,986,Villardompardo,1257,616,641
23,999,Villares (Los),4860,2434,2426
23,1010,Villarrodrigo,588,290,298
23,9033,Villatorres,4060,2018,2042
24,16,Acebedo,291,156,135
24,21,Algadefe,382,196,186
24,37,Alija del Infantado,1006,503,503
24,42,Almanza,776,411,365
24,55,Antigua (La),638,336,302
24,68,Ardón,697,364,333
24,74,Arganza,967,476,491
24,80,Astorga,12387,5863,6524
24,93,Balboa,484,257,227
24,107,Bañeza (La),10312,5010,5302
24,114,Barjas,411,219,192
24,129,Barrios de Luna (Los),348,174,174
24,140,Bembibre,11063,5490,5573
24,153,Benavides,3077,1570,1507
24,166,Benuza,728,383,345
24,172,Bercianos del Páramo,869,431,438
24,188,Bercianos del Real Camino,226,114,112
24,191,Berlanga del Bierzo,449,215,234
24,205,Boca de Huérgano,597,331,266
24,212,Boñar,2621,1284,1337
24,227,Borrenes,530,270,260
24,233,Brazuelo,345,167,178
24,248,Burgo Ranero (El),994,521,473
24,251,Burón,394,209,185
24,264,Bustillo del Páramo,1944,969,975
24,270,Cabañas Raras,1287,653,634
24,286,Cabreros del Río,632,325,307
24,299,Cabrillanes,1165,567,598
24,303,Cacabelos,4844,2427,2417
24,310,Calzada del Coto,306,167,139
24,325,Campazas,179,90,89
24,331,Campo de Villavidel,350,182,168
24,346,Camponaraya,3084,1497,1587
24,362,Candín,428,234,194
24,378,Cármenes,441,225,216
24,384,Carracedelo,3530,1731,1799
24,397,Carrizo,2755,1378,1377
24,401,Carrocera,643,318,325
24,418,Carucedo,641,309,332
24,423,Castilfalé,106,55,51
24,439,Castrillo de Cabrera,203,99,104
24,444,Castrillo de la Valduerna,245,107,138
24,460,Castrocalbón,1406,711,695
24,476,Castrocontrigo,1177,581,596
24,495,Castropodame,1870,943,927
24,508,Castrotierra de Valmadrigal,164,83,81
24,515,Cea,773,399,374
24,520,Cebanico,267,143,124
24,536,Cebrones del Río,729,368,361
24,652,Chozas de Abajo,2170,1104,1066
24,541,Cimanes de la Vega,704,345,359
24,554,Cimanes del Tejar,1073,529,544
24,567,Cistierna,4440,2169,2271
24,573,Congosto,1765,847,918
24,589,Corbillos de los Oteros,316,163,153
24,592,Corullón,1245,617,628
24,606,Crémenes,1194,570,624
24,613,Cuadros,1654,773,881
24,628,Cubillas de los Oteros,227,115,112
24,634,Cubillas de Rueda,628,318,310
24,649,Cubillos del Sil,1498,783,715
24,665,Destriana,903,439,464
24,671,Encinedo,1067,543,524
24,687,Ercina (La),726,358,368
24,690,Escobar de Campos,80,48,32
24,704,Fabero,6019,3004,3015
24,711,Folgoso de la Ribera,1401,690,711
24,732,Fresno de la Vega,723,358,365
24,747,Fuentes de Carbajal,142,71,71
24,763,Garrafe de Torío,1101,558,543
24,779,Gordaliza del Pino,369,186,183
24,785,Gordoncillo,642,321,321
24,798,Gradefes,1379,663,716
24,802,Grajal de Campos,303,131,172
24,819,Gusendos de los Oteros,234,117,117
24,824,Hospital de Órbigo,1145,560,585
24,830,Igüeña,2079,1090,989
24,845,Izagre,279,140,139
24,861,Joarilla de las Matas,458,237,221
24,877,Laguna Dalga,961,480,481
24,883,Laguna de Negrillos,1598,810,788
24,896,León,139809,65340,74469
24,922,Llamas de la Ribera,1273,645,628
24,900,Lucillo,544,271,273
24,917,Luyego,1007,479,528
24,938,Magaz de Cepeda,552,263,289
24,943,Mansilla de las Mulas,1773,891,882
24,956,Mansilla Mayor,412,203,209
24,969,Maraña,180,93,87
24,975,Matadeón de los Oteros,313,162,151
24,981,Matallana de Torío,1732,864,868
24,994,Matanza,311,156,155
24,1008,Molinaseca,767,390,377
24,1015,Murias de Paredes,703,326,377
24,1020,Noceda,970,485,485
24,1036,Oencia,531,282,249
24,1041,Omañas (Las),470,236,234
24,1054,Onzonilla,1447,712,735
24,1067,Oseja de Sajambre,347,192,155
24,1073,Pajares de los Oteros,383,197,186
24,1089,Palacios de la Valduerna,561,268,293
24,1092,Palacios del Sil,1523,760,763
24,1106,Páramo del Sil,1890,958,932
24,1128,Peranzanes,355,198,157
24,1134,Pobladura de Pelayo García,598,311,287
24,1149,Pola de Gordón (La),5277,2549,2728
24,1152,Ponferrada,61469,29981,31488
24,1165,Posada de Valdeón,496,265,231
24,1171,Pozuelo del Páramo,679,354,325
24,1187,Prado de la Guzpeña,173,93,80
24,1190,Priaranza del Bierzo,1004,515,489
24,1204,Prioro,475,245,230
24,1211,Puebla de Lillo,690,368,322
24,1226,Puente de Domingo Flórez,1936,1008,928
24,1232,Quintana del Castillo,1156,607,549
24,1247,Quintana del Marco,567,289,278
24,1250,Quintana y Congosto,841,423,418
24,1279,Regueras de Arriba,412,212,200
24,1298,Reyero,162,88,74
24,1302,Riaño,512,285,227
24,1319,Riego de la Vega,1163,567,596
24,1324,Riello,1064,547,517
24,1330,Rioseco de Tapia,591,316,275
24,1345,Robla (La),5214,2606,2608
24,1361,Roperuelos del Páramo,845,420,425
24,1377,Sabero,1989,986,1003
24,1396,Sahagún,3223,1547,1676
24,1417,San Adrián del Valle,172,82,90
24,1422,San Andrés del Rabanedo,23487,11426,12061
24,1443,San Cristóbal de la Polantera,1136,576,560
24,1456,San Emiliano,1021,528,493
24,1469,San Esteban de Nogales,362,169,193
24,1481,San Justo de la Vega,2289,1157,1132
24,1494,San Millán de los Caballeros,195,99,96
24,1507,San Pedro Bercianos,400,199,201
24,1438,Sancedo,601,299,302
24,1514,Santa Colomba de Curueño,666,316,350
24,1529,Santa Colomba de Somoza,472,234,238
24,1535,Santa Cristina de Valmadrigal,386,195,191
24,1540,Santa Elena de Jamuz,1427,725,702
24,1553,Santa María de la Isla,733,385,348
24,1588,Santa María de Ordás,461,232,229
24,1566,Santa María del Monte de Cea,405,197,208
24,1572,Santa María del Páramo,3170,1538,1632
24,1591,Santa Marina del Rey,2639,1309,1330
24,1605,Santas Martas,1051,551,500
24,1612,Santiago Millas,354,181,173
24,1627,Santovenia de la Valdoncina,1578,778,800
24,1633,Sariegos,2352,1185,1167
24,1648,Sena de Luna,512,255,257
24,1651,Sobrado,550,277,273
24,1664,Soto de la Vega,2034,1027,1007
24,1670,Soto y Amío,1087,528,559
24,1686,Toral de los Guzmanes,692,356,336
24,1699,Toreno,4392,2260,2132
24,1703,Torre del Bierzo,3271,1641,1630
24,1710,Trabadelo,606,322,284
24,1725,Truchas,814,407,407
24,1731,Turcia,1380,685,695
24,1746,Urdiales del Páramo,745,385,360
24,1857,Val de San Lorenzo,790,383,407
24,1759,Valdefresno,1658,837,821
24,1762,Valdefuentes del Páramo,455,236,219
24,1778,Valdelugueros,448,248,200
24,1784,Valdemora,127,60,67
24,1797,Valdepiélago,403,205,198
24,1801,Valdepolo,1618,838,780
24,1818,Valderas,2267,1159,1108
24,1823,Valderrey,666,323,343
24,1839,Valderrueda,1341,667,674
24,1844,Valdesamario,296,148,148
24,1876,Valdevimbre,1252,633,619
24,1882,Valencia de Don Juan,3934,1951,1983
24,1916,Vallecillo,177,92,85
24,1909,Valverde-Enrique,238,115,123
24,1895,Valverde de la Virgen,4208,2101,2107
24,1937,Vecilla (La),459,238,221
24,1968,Vega de Espinareda,3052,1543,1509
24,1974,Vega de Infanzones,877,429,448
24,1980,Vega de Valcarce,950,484,466
24,1942,Vegacervera,363,191,172
24,1993,Vegaquemada,561,260,301
24,2014,Vegas del Condado,1399,722,677
24,2029,Villablino,14956,7547,7409
24,2035,Villabraz,164,87,77
24,2053,Villadangos del Páramo,1016,511,505
24,2066,Villadecanes,2371,1204,1167
24,2072,Villademor de la Vega,481,257,224
24,2091,Villafranca del Bierzo,3941,1952,1989
24,2105,Villagatón,881,458,423
24,2112,Villamandos,461,217,244
24,9017,Villamanín,1342,663,679
24,2127,Villamañán,1428,714,714
24,2133,Villamartín de Don Sancho,208,109,99
24,2148,Villamejil,1020,510,510
24,2151,Villamol,251,127,124
24,2164,Villamontán de la Valduerna,1135,571,564
24,2170,Villamoratiel de las Matas,185,105,80
24,2186,Villanueva de las Manzanas,644,311,333
24,2199,Villaobispo de Otero,742,378,364
24,9022,Villaornate y Castro,576,309,267
24,2210,Villaquejida,1101,578,523
24,2225,Villaquilambre,7389,3724,3665
24,2231,Villarejo de Órbigo,3579,1742,1837
24,2246,Villares de Órbigo,1002,509,493
24,2259,Villasabariego,1228,615,613
24,2262,Villaselán,333,179,154
24,2278,Villaturiel,1807,936,871
24,2284,Villazala,1060,546,514
24,2297,Villazanzo de Valderaduey,715,386,329
24,2301,Zotes del Páramo,697,356,341
25,19,Abella de la Conca,182,98,84
25,24,Àger,542,289,253
25,30,Agramunt,4950,2511,2439
25,387,Aitona,2184,1085,1099
25,45,Alamús (Els),679,340,339
25,58,Alàs i Cerc,410,222,188
25,61,Albagés (L'),512,266,246
25,77,Albatàrrec,1069,533,536
25,83,Albesa,1486,729,757
25,96,Albi (L'),776,395,381
25,100,Alcanó,272,136,136
25,117,Alcarràs,4786,2382,2404
25,122,Alcoletge,1709,865,844
25,138,Alfarràs,2922,1433,1489
25,143,Alfés,334,178,156
25,156,Algerri,518,252,266
25,169,Alguaire,2824,1432,1392
25,175,Alins,288,149,139
25,194,Almacelles,5520,2787,2733
25,208,Almatret,488,245,243
25,215,Almenar,3443,1762,1681
25,220,Alòs de Balaguer,177,102,75
25,236,Alpicat,3600,1787,1813
25,241,Alt Àneu,394,216,178
25,273,Anglesola,1242,629,613
25,292,Arbeca,2359,1198,1161
25,313,Arres,64,34,30
25,328,Arsèguel,104,54,50
25,334,Artesa de Lleida,1243,624,619
25,349,Artesa de Segre,3123,1601,1522
25,365,Aspa,248,124,124
25,371,Avellanes i Santa Linya (Les),483,256,227
25,390,Baix Pallars,340,193,147
25,404,Balaguer,13188,6455,6733
25,411,Barbens,754,389,365
25,426,Baronia de Rialb (La),247,130,117
25,447,Bassella,335,168,167
25,450,Bausen,67,39,28
25,463,Belianes,558,269,289
25,485,Bell-lloc d'Urgell,2106,1041,1065
25,1706,Bellaguarda,363,183,180
25,479,Bellcaire d'Urgell,1346,640,706
25,498,Bellmunt d'Urgell,233,117,116
25,501,Bellpuig,3956,1966,1990
25,518,Bellver de Cerdanya,1598,838,760
25,523,Bellvís,2171,1063,1108
25,539,Benavent de Segrià,852,448,404
25,557,Biosca,268,135,133
25,576,Bòrdes (Es),207,111,96
25,582,Borges Blanques (Les),5181,2568,2613
25,595,Bossòst,821,415,406
25,560,Bovera,408,209,199
25,609,Cabanabona,100,48,52
25,616,Cabó,120,67,53
25,621,Camarasa,893,448,445
25,637,Canejan,100,53,47
25,9046,Castell de Mur,149,79,70
25,642,Castellar de la Ribera,149,67,82
25,674,Castelldans,943,472,471
25,680,Castellnou de Seana,726,375,351
25,693,Castelló de Farfanya,592,300,292
25,707,Castellserà,1126,548,578
25,714,Cava,56,33,23
25,729,Cervera,7272,3586,3686
25,735,Cervià de les Garrigues,844,441,403
25,740,Ciutadilla,226,117,109
25,753,Clariana de Cardener,148,76,72
25,766,Cogul (El),228,116,112
25,772,Coll de Nargó,614,328,286
25,1636,Coma i la Pedra (La),234,144,90
25,1615,Conca de Dalt,421,222,199
25,788,Corbins,1051,530,521
25,791,Cubells,358,181,177
25,812,Espluga Calba (L'),442,228,214
25,827,Espot,276,147,129
25,886,Estamariu,131,70,61
25,851,Estaràs,179,97,82
25,864,Esterri d'Àneu,632,308,324
25,870,Esterri de Cardós,72,39,33
25,899,Farrera,86,47,39
25,9084,Fígols i Alinyà,307,167,140
25,925,Floresta (La),174,92,82
25,931,Fondarella,686,347,339
25,946,Foradada,189,112,77
25,962,Fuliola (La),1255,628,627
25,978,Fulleda,115,60,55
25,984,Gavet de la Conca,324,158,166
25,9123,Gimenells i el Pla de la Font,1122,591,531
25,997,Golmés,1275,617,658
25,1001,Gósol,207,114,93
25,1018,Granadella (La),831,427,404
25,1023,Granja d'Escarp (La),1108,587,521
25,1039,Granyanella,127,63,64
25,1057,Granyena de les Garrigues,168,86,82
25,1044,Granyena de Segarra,162,83,79
25,1095,Guimerà,375,188,187
25,9031,Guingueta d'Àneu (La),290,147,143
25,1109,Guissona,3060,1561,1499
25,1116,Guixers,151,92,59
25,1155,Isona i Conca Dellà,1270,668,602
25,1121,Ivars de Noguera,334,167,167
25,1137,Ivars d'Urgell,1699,859,840
25,1142,Ivorra,156,84,72
25,9101,Josa i Tuixén,139,76,63
25,1180,Juncosa,594,327,267
25,1193,Juneda,3002,1520,1482
25,1214,Les,687,345,342
25,1229,Linyola,2391,1185,1206
25,1235,Lladorre,207,106,101
25,1240,Lladurs,250,133,117
25,1253,Llardecans,639,329,310
25,1266,Llavorsí,286,145,141
25,1207,Lleida,112207,54637,57570
25,1272,Lles de Cerdanya,299,166,133
25,1288,Llimiana,139,74,65
25,1291,Llobera,240,125,115
25,1333,Maials,1005,500,505
25,1305,Maldà,289,148,141
25,1312,Massalcoreig,649,312,337
25,1327,Massoteres,184,96,88
25,1348,Menàrguens,817,416,401
25,1351,Miralcamp,1239,592,647
25,1370,Mollerussa,9477,4703,4774
25,1364,Molsosa (La),135,69,66
25,1399,Montellà i Martinet,500,250,250
25,1403,Montferrer i Castellbò,728,394,334
25,1386,Montgai,794,403,391
25,1425,Montoliu de Lleida,500,246,254
25,1410,Montoliu de Segarra,202,108,94
25,1431,Montornès de Segarra,101,45,56
25,1459,Nalec,104,49,55
25,254,Naut Aran,1435,750,685
25,1462,Navès,277,133,144
25,1484,Odèn,280,158,122
25,1497,Oliana,1877,956,921
25,1500,Oliola,199,112,87
25,1517,Olius,520,264,256
25,1522,Oluges (Les),192,102,90
25,1538,Omellons (Els),266,134,132
25,1543,Omells de na Gaia (Els),153,84,69
25,1556,Organyà,993,511,482
25,1569,Os de Balaguer,761,403,358
25,1575,Ossó de Sió,210,106,104
25,1581,Palau d'Anglesola (El),1630,824,806
25,1641,Penelles,549,303,246
25,1654,Peramola,379,203,176
25,1667,Pinell de Solsonès,228,121,107
25,1673,Pinós,317,175,142
25,9118,Plans de Sió (Els),620,325,295
25,1689,Poal (El),625,331,294
25,1692,Pobla de Cérvoles (La),218,124,94
25,1713,Pobla de Segur (La),2912,1404,1508
25,306,Pont de Bar (El),145,78,67
25,1734,Pont de Suert (El),2079,1045,1034
25,1728,Ponts,2368,1189,1179
25,1749,Portella (La),580,312,268
25,1752,Prats i Sansor,187,103,84
25,1765,Preixana,431,217,214
25,1771,Preixens,518,250,268
25,1790,Prullans,218,113,105
25,1804,Puiggròs,255,135,120
25,1811,Puigverd d'Agramunt,218,116,102
25,1826,Puigverd de Lleida,1010,499,511
25,1832,Rialp,535,280,255
25,9059,Ribera d'Ondara,531,269,262
25,1850,Ribera d'Urgellet,748,390,358
25,1863,Riner,278,142,136
25,1898,Rosselló,1784,868,916
25,1902,Salàs de Pallars,334,171,163
25,1919,Sanaüja,465,228,237
25,1961,Sant Esteve de la Sarga,113,69,44
25,1924,Sant Guim de Freixenet,1047,507,540
25,1977,Sant Guim de la Plana,194,102,92
25,1930,Sant Llorenç de Morunys,896,454,442
25,9025,Sant Martí de Riucorb,718,365,353
25,1945,Sant Ramon,554,270,284
25,2017,Sarroca de Bellera,145,79,66
25,2000,Sarroca de Lleida,489,247,242
25,2022,Senterada,116,61,55
25,352,Sentiu de Sió (La),481,231,250
25,2043,Seròs,1780,939,841
25,2038,Seu d'Urgell (La),10661,5196,5465
25,2056,Sidamon,476,238,238
25,2069,Soleràs (El),420,212,208
25,2075,Solsona,7172,3593,3579
25,2081,Soriguera,298,155,143
25,2094,Sort,1715,854,861
25,2108,Soses,1531,795,736
25,2115,Sudanell,731,394,337
25,2120,Sunyer,305,152,153
25,2154,Talarn,362,187,175
25,2167,Talavera,290,152,138
25,2173,Tàrrega,12181,5863,6318
25,2189,Tarrés,109,58,51
25,2192,Tarroja de Segarra,187,97,90
25,2206,Térmens,1395,704,691
25,2213,Tírvia,122,65,57
25,2228,Tiurana,23,16,7
25,2234,Torà,1174,596,578
25,2249,Torms (Els),195,108,87
25,2252,Tornabous,822,422,400
25,2332,Torre-serona,295,147,148
25,2271,Torre de Cabdella (La),658,327,331
25,2265,Torrebesses,337,165,172
25,2287,Torrefarrera,1609,821,788
25,9078,Torrefeta i Florejacs,660,327,333
25,2304,Torregrossa,2238,1101,1137
25,2311,Torrelameu,577,311,266
25,2326,Torres de Segre,1805,914,891
25,2347,Tremp,5357,2641,2716
25,432,Vall de Boí (La),793,445,348
25,9010,Vall de Cardós,324,166,158
25,2385,Vallbona de les Monges,259,129,130
25,2402,Vallfogona de Balaguer,1443,727,716
25,9062,Valls d'Aguilar (Les),296,158,138
25,2398,Valls de Valira (Les),736,398,338
25,9097,Vansa i Fórnols (La),171,87,84
25,2424,Verdú,991,477,514
25,2430,Vielha e Mijaran,3896,1955,1941
25,2521,Vila-sana,530,260,270
25,2445,Vilagrassa,431,228,203
25,2458,Vilaller,618,327,291
25,2477,Vilamòs,148,73,75
25,2483,Vilanova de Bellpuig,1163,576,587
25,2542,Vilanova de la Barca,923,456,467
25,2496,Vilanova de l'Aguda,270,141,129
25,2509,Vilanova de Meià,478,252,226
25,2516,Vilanova de Segrià,749,382,367
25,2537,Vilosell (El),195,86,109
25,2555,Vinaixa,639,311,328
26,12,Ábalos,271,147,124
26,27,Agoncillo,879,460,419
26,33,Aguilar del Río Alhama,699,358,341
26,48,Ajamil,75,50,25
26,51,Albelda de Iregua,2218,1125,1093
26,64,Alberite,2005,998,1007
26,70,Alcanadre,808,416,392
26,86,Aldeanueva de Ebro,2486,1284,1202
26,99,Alesanco,505,259,246
26,103,Alesón,143,71,72
26,110,Alfaro,9098,4568,4530
26,125,Almarza de Cameros,38,24,14
26,131,Anguciana,313,160,153
26,146,Anguiano,608,333,275
26,159,Arenzana de Abajo,318,166,152
26,162,Arenzana de Arriba,40,22,18
26,178,Arnedillo,444,211,233
26,184,Arnedo,12796,6387,6409
26,197,Arrúbal,425,220,205
26,201,Ausejo,725,394,331
26,218,Autol,3368,1718,1650
26,223,Azofra,355,192,163
26,239,Badarán,739,391,348
26,244,Bañares,427,214,213
26,260,Baños de Río Tobía,1808,924,884
26,257,Baños de Rioja,110,64,46
26,276,Berceo,222,131,91
26,282,Bergasa,184,98,86
26,295,Bergasillas Bajera,30,17,13
26,309,Bezares,31,19,12
26,316,Bobadilla,167,96,71
26,321,Brieva de Cameros,72,42,30
26,337,Briñas,198,99,99
26,342,Briones,810,429,381
26,355,Cabezón de Cameros,34,24,10
26,368,Calahorra,18801,9092,9709
26,374,Camprovín,227,122,105
26,380,Canales de la Sierra,95,51,44
26,393,Canillas de Río Tuerto,69,33,36
26,407,Cañas,117,54,63
26,414,Cárdenas,249,124,125
26,429,Casalarreina,870,439,431
26,435,Castañares de Rioja,483,249,234
26,440,Castroviejo,61,31,30
26,453,Cellorigo,20,11,9
26,466,Cenicero,2088,1060,1028
26,472,Cervera del Río Alhama,3121,1622,1499
26,488,Cidamón,47,25,22
26,491,Cihuri,157,84,73
26,504,Cirueña,130,76,54
26,511,Clavijo,199,103,96
26,526,Cordovín,218,112,106
26,532,Corera,251,122,129
26,547,Cornago,579,316,263
26,550,Corporales,63,32,31
26,563,Cuzcurrita de Río Tirón,475,257,218
26,579,Daroca de Rioja,56,34,22
26,585,Enciso,174,107,67
26,598,Entrena,1132,585,547
26,602,Estollo,154,85,69
26,619,Ezcaray,1822,966,856
26,624,Foncea,125,64,61
26,630,Fonzaleche,166,100,66
26,645,Fuenmayor,2179,1086,1093
26,658,Galbárruli,72,39,33
26,661,Galilea,293,155,138
26,677,Gallinero de Cameros,29,19,10
26,683,Gimileo,93,44,49
26,696,Grañón,420,220,200
26,700,Grávalos,282,143,139
26,717,Haro,9150,4515,4635
26,722,Herce,321,167,154
26,738,Herramélluri,174,93,81
26,743,Hervías,192,98,94
26,756,Hormilla,483,250,233
26,769,Hormilleja,178,89,89
26,775,Hornillos de Cameros,25,13,12
26,781,Hornos de Moncalvillo,99,48,51
26,794,Huércanos,877,448,429
26,808,Igea,792,423,369
26,815,Jalón de Cameros,36,20,16
26,820,Laguna de Cameros,174,100,74
26,836,Lagunilla del Jubera,357,192,165
26,841,Lardero,3421,1719,1702
26,867,Ledesma de la Cogolla,21,14,7
26,873,Leiva,291,140,151
26,889,Leza de Río Leza,33,22,11
26,892,Logroño,125617,60344,65273
26,913,Lumbreras,173,106,67
26,928,Manjarrés,148,84,64
26,934,Mansilla de la Sierra,53,36,17
26,949,Manzanares de Rioja,125,68,57
26,952,Matute,172,82,90
26,965,Medrano,217,118,99
26,987,Munilla,118,61,57
26,990,Murillo de Río Leza,1519,771,748
26,1004,Muro de Aguas,73,43,30
26,1011,Muro en Cameros,43,28,15
26,1026,Nájera,7055,3520,3535
26,1032,Nalda,859,452,407
26,1047,Navajún,19,12,7
26,1050,Navarrete,1988,1015,973
26,1063,Nestares,73,39,34
26,1079,Nieva de Cameros,119,62,57
26,1098,Ochánduri,103,52,51
26,1085,Ocón,339,193,146
26,1102,Ojacastro,232,137,95
26,1119,Ollauri,313,174,139
26,1124,Ortigosa de Cameros,327,171,156
26,1130,Pazuengos,50,32,18
26,1145,Pedroso,118,65,53
26,1158,Pinillos,30,16,14
26,1177,Pradejón,2820,1472,1348
26,1183,Pradillo,97,54,43
26,1196,Préjano,208,104,104
26,1200,Quel,1892,986,906
26,1217,Rabanera,52,36,16
26,1222,Rasillo de Cameros (El),123,65,58
26,1238,Redal (El),207,100,107
26,1243,Ribafrecha,1022,557,465
26,1256,Rincón de Soto,2562,1366,1196
26,1269,Robres del Castillo,17,11,6
26,1275,Rodezno,327,180,147
26,1281,Sajazarra,146,75,71
26,1294,San Asensio,1259,655,604
26,1308,San Millán de la Cogolla,276,171,105
26,1315,San Millán de Yécora,56,34,22
26,1320,San Román de Cameros,174,95,79
26,1392,San Torcuato,100,56,44
26,1428,San Vicente de la Sonsierra,1096,558,538
26,1341,Santa Coloma,148,92,56
26,1354,Santa Engracia del Jubera,218,129,89
26,1367,Santa Eulalia Bajera,103,59,44
26,1389,Santo Domingo de la Calzada,5646,2836,2810
26,1406,Santurde de Rioja,313,156,157
26,1413,Santurdejo,207,116,91
26,1434,Sojuela,87,51,36
26,1449,Sorzano,238,123,115
26,1452,Sotés,235,135,100
26,1465,Soto en Cameros,140,75,65
26,1471,Terroba,32,17,15
26,1487,Tirgo,268,137,131
26,1490,Tobía,61,36,25
26,1503,Tormantos,220,118,102
26,1531,Torre en Cameros,14,11,3
26,1510,Torrecilla en Cameros,558,300,258
26,1525,Torrecilla sobre Alesanco,88,45,43
26,1546,Torremontalbo,15,9,6
26,1559,Treviana,268,143,125
26,1578,Tricio,336,175,161
26,1584,Tudelilla,448,228,220
26,1601,Uruñuela,748,385,363
26,1618,Valdemadera,15,10,5
26,1623,Valgañón,173,98,75
26,1639,Ventosa,130,71,59
26,1644,Ventrosa,92,41,51
26,1657,Viguera,380,223,157
26,1660,Villalba de Rioja,158,93,65
26,1676,Villalobar de Rioja,134,81,53
26,1682,Villamediana de Iregua,2003,1031,972
26,1695,Villanueva de Cameros,125,66,59
26,1709,Villar de Arnedo (El),670,322,348
26,1716,Villar de Torre,316,166,150
26,1721,Villarejo,50,31,19
26,1737,Villarroya,9,4,5
26,1742,Villarta-Quintana,221,111,110
26,1755,Villavelayo,76,44,32
26,1768,Villaverde de Rioja,103,58,45
26,1774,Villoslada de Cameros,379,219,160
26,1780,Viniegra de Abajo,124,66,58
26,1793,Viniegra de Arriba,54,34,20
26,1807,Zarratón,268,141,127
26,1814,Zarzosa,17,12,5
26,1835,Zorraquín,49,30,19
27,18,Abadín,3582,1686,1896
27,23,Alfoz,2506,1210,1296
27,39,Antas de Ulla,2856,1357,1499
27,44,Baleira,2002,1033,969
27,9019,Baralla,3450,1770,1680
27,57,Barreiros,3536,1706,1830
27,60,Becerreá,3796,1926,1870
27,76,Begonte,3903,1931,1972
27,82,Bóveda,2141,1050,1091
27,9024,Burela,7915,3928,3987
27,95,Carballedo,3363,1665,1698
27,109,Castro de Rei,5778,2906,2872
27,116,Castroverde,3612,1843,1769
27,121,Cervantes,2329,1271,1058
27,137,Cervo,5086,2550,2536
27,168,Chantada,10002,4931,5071
27,142,Corgo (O),4394,2205,2189
27,155,Cospeito,6045,2973,3072
27,174,Folgoso do Courel,1669,854,815
27,180,Fonsagrada (A),5682,2978,2704
27,193,Foz,9520,4538,4982
27,207,Friol,4910,2451,2459
27,229,Guitiriz,6473,3216,3257
27,235,Guntín,3663,1828,1835
27,240,Incio (O),2674,1321,1353
27,266,Láncara,3377,1755,1622
27,272,Lourenzá,2931,1413,1518
27,288,Lugo,86620,40753,45867
27,291,Meira,1828,897,931
27,305,Mondoñedo,5242,2417,2825
27,312,Monforte de Lemos,19933,9542,10391
27,327,Monterroso,4285,2124,2161
27,333,Muras,1186,580,606
27,348,Navia de Suarna,2073,1113,960
27,351,Negueira de Muñiz,297,156,141
27,370,Nogais (As),1662,856,806
27,386,Ourol,1638,796,842
27,399,Outeiro de Rei,4126,2086,2040
27,403,Palas de Rei,4386,2149,2237
27,410,Pantón,3637,1729,1908
27,425,Paradela,2752,1370,1382
27,431,Páramo (O),1934,994,940
27,446,Pastoriza (A),4177,2092,2085
27,459,Pedrafita do Cebreiro,1669,891,778
27,478,Pobra de Brollón (A),2753,1340,1413
27,462,Pol,2258,1110,1148
27,484,Pontenova (A),3484,1700,1784
27,497,Portomarín,2141,1055,1086
27,500,Quiroga,4458,2170,2288
27,569,Rábade,1589,793,796
27,517,Ribadeo,8872,4159,4713
27,522,Ribas de Sil,1529,726,803
27,538,Ribeira de Piquín,939,457,482
27,543,Riotorto,2018,994,1024
27,556,Samos,2203,1158,1045
27,575,Sarria,12942,6326,6616
27,581,Saviñao (O),5246,2553,2693
27,594,Sober,3250,1573,1677
27,608,Taboada,4344,2104,2240
27,615,Trabada,1770,846,924
27,620,Triacastela,942,464,478
27,636,Valadouro (O),2524,1250,1274
27,641,Vicedo (O),2460,1208,1252
27,654,Vilalba,15645,7655,7990
27,667,Viveiro,15298,7379,7919
27,214,Xermade,2847,1398,1449
27,253,Xove,3599,1798,1801
28,14,Acebeda (La),47,26,21
28,29,Ajalvir,1817,942,875
28,35,Alameda del Valle,162,89,73
28,40,Álamo (El),4028,2170,1858
28,53,Alcalá de Henares,163831,81672,82159
28,66,Alcobendas,86146,42468,43678
28,72,Alcorcón,143970,71274,72696
28,88,Aldea del Fresno,1308,677,631
28,91,Algete,13476,6860,6616
28,105,Alpedrete,5824,2927,2897
28,112,Ambite,303,147,156
28,127,Anchuelo,592,325,267
28,133,Aranjuez,38680,18649,20031
28,148,Arganda del Rey,29767,14714,15053
28,151,Arroyomolinos,3017,1532,1485
28,164,Atazar (El),95,51,44
28,170,Batres,730,377,353
28,186,Becerril de la Sierra,2878,1491,1387
28,199,Belmonte de Tajo,1131,570,561
28,210,Berrueco (El),343,182,161
28,203,Berzosa del Lozoya,100,48,52
28,225,Boadilla del Monte,18914,9614,9300
28,231,Boalo (El),2685,1364,1321
28,246,Braojos,147,80,67
28,259,Brea de Tajo,480,244,236
28,262,Brunete,4354,2166,2188
28,278,Buitrago del Lozoya,1404,700,704
28,284,Bustarviejo,1371,702,669
28,297,Cabanillas de la Sierra,432,222,210
28,301,Cabrera (La),1517,758,759
28,318,Cadalso de los Vidrios,2249,1159,1090
28,323,Camarma de Esteruelas,2235,1116,1119
28,339,Campo Real,2555,1289,1266
28,344,Canencia,458,238,220
28,357,Carabaña,1005,499,506
28,360,Casarrubuelos,668,358,310
28,376,Cenicientos,1854,914,940
28,382,Cercedilla,5328,2636,2692
28,395,Cervera de Buitrago,96,57,39
28,513,Chapinería,1235,626,609
28,528,Chinchón,3856,1905,1951
28,409,Ciempozuelos,12934,6548,6386
28,416,Cobeña,2339,1189,1150
28,468,Collado Mediano,3631,1834,1797
28,474,Collado Villalba,39295,19607,19688
28,437,Colmenar de Oreja,5510,2695,2815
28,421,Colmenar del Arroyo,853,400,453
28,455,Colmenar Viejo,29682,14721,14961
28,442,Colmenarejo,3795,1923,1872
28,480,Corpa,365,186,179
28,493,Coslada,73732,36614,37118
28,506,Cubas de la Sagra,1397,684,713
28,534,Daganzo de Arriba,3041,1530,1511
28,549,Escorial (El),9444,4717,4727
28,552,Estremera,1047,540,507
28,565,Fresnedillas de la Oliva,677,341,336
28,571,Fresno de Torote,538,291,247
28,587,Fuenlabrada,167458,84331,83127
28,590,Fuente el Saz de Jarama,3372,1743,1629
28,604,Fuentidueña de Tajo,1432,699,733
28,611,Galapagar,18995,9600,9395
28,626,Garganta de los Montes,322,161,161
28,632,Gargantilla del Lozoya,227,137,90
28,647,Gascones,100,54,46
28,650,Getafe,143629,71342,72287
28,663,Griñón,4083,2083,2000
28,679,Guadalix de la Sierra,2646,1371,1275
28,685,Guadarrama,8251,4043,4208
28,698,Hiruela (La),53,27,26
28,702,Horcajo de la Sierra,136,76,60
28,719,Horcajuelo de la Sierra,81,37,44
28,724,Hoyo de Manzanares,5017,2535,2482
28,730,Humanes de Madrid,8756,4477,4279
28,745,Leganés,173163,86270,86893
28,758,Loeches,2838,1400,1438
28,761,Lozoya,442,227,215
28,9015,Lozoyuela-Navas-Sieteiglesias,628,334,294
28,783,Madarcos,26,14,12
28,796,Madrid,2881506,1346168,1535338
28,800,Majadahonda,41642,20239,21403
28,822,Manzanares el Real,3363,1764,1599
28,838,Meco,4689,2386,2303
28,843,Mejorada del Campo,15186,7642,7544
28,856,Miraflores de la Sierra,3495,1761,1734
28,869,Molar (El),3552,1884,1668
28,875,Molinos (Los),3084,1483,1601
28,881,Montejo de la Sierra,262,127,135
28,894,Moraleja de Enmedio,2680,1335,1345
28,908,Moralzarzal,4149,2130,2019
28,915,Morata de Tajuña,5412,2666,2746
28,920,Móstoles,195311,96877,98434
28,936,Navacerrada,1741,857,884
28,941,Navalafuente,481,261,220
28,954,Navalagamella,994,507,487
28,967,Navalcarnero,11458,5807,5651
28,973,Navarredonda,96,50,46
28,992,Navas del Rey,1501,791,710
28,1006,Nuevo Baztán,2743,1422,1321
28,1013,Olmeda de las Fuentes,146,81,65
28,1028,Orusco de Tajuña,650,336,314
28,1049,Paracuellos de Jarama,5557,2857,2700
28,1065,Parla,71396,35719,35677
28,1071,Patones,362,187,175
28,1087,Pedrezuela,1274,662,612
28,1090,Pelayos de la Presa,1277,634,643
28,1104,Perales de Tajuña,2024,979,1045
28,1111,Pezuela de las Torres,524,269,255
28,1126,Pinilla del Valle,163,92,71
28,1132,Pinto,26316,13172,13144
28,1147,Piñuécar,157,75,82
28,1150,Pozuelo de Alarcón,62010,30278,31732
28,1163,Pozuelo del Rey,236,125,111
28,1179,Prádena del Rincón,100,54,46
28,1185,Puebla de la Sierra,77,44,33
28,9020,Puentes Viejas,412,217,195
28,1198,Quijorna,890,481,409
28,1202,Rascafría,1404,728,676
28,1219,Redueña,159,77,82
28,1224,Ribatejada,335,181,154
28,1230,Rivas-Vaciamadrid,24777,12413,12364
28,1245,Robledillo de la Jara,78,40,38
28,1258,Robledo de Chavela,2014,1004,1010
28,1261,Robregordo,86,41,45
28,1277,Rozas de Madrid (Las),47922,23449,24473
28,1283,Rozas de Puerto Real,306,163,143
28,1296,San Agustín de Guadalix,5307,2685,2622
28,1300,San Fernando de Henares,31677,15903,15774
28,1317,San Lorenzo de El Escorial,10995,5327,5668
28,1322,San Martín de la Vega,9661,4928,4733
28,1338,San Martín de Valdeiglesias,6034,2980,3054
28,1343,San Sebastián de los Reyes,57791,28783,29008
28,1356,Santa María de la Alameda,770,423,347
28,1369,Santorcaz,557,295,262
28,1375,Santos de la Humosa (Los),898,456,442
28,1381,Serna del Monte (La),100,53,47
28,1408,Serranillos del Valle,778,406,372
28,1415,Sevilla la Nueva,2936,1539,1397
28,1436,Somosierra,93,50,43
28,1441,Soto del Real,4368,2225,2143
28,1454,Talamanca de Jarama,1356,668,688
28,1467,Tielmes,1974,1001,973
28,1473,Titulcia,962,485,477
28,1489,Torrejón de Ardoz,91186,42881,48305
28,1492,Torrejón de la Calzada,3608,1818,1790
28,1505,Torrejón de Velasco,1608,847,761
28,1512,Torrelaguna,2558,1229,1329
28,1527,Torrelodones,11100,5469,5631
28,1533,Torremocha de Jarama,341,167,174
28,1548,Torres de la Alameda,4131,2084,2047
28,9036,Tres Cantos,30970,15373,15597
28,1551,Valdaracete,640,313,327
28,1564,Valdeavero,553,286,267
28,1570,Valdelaguna,524,282,242
28,1586,Valdemanco,518,279,239
28,1599,Valdemaqueda,561,284,277
28,1603,Valdemorillo,4722,2418,2304
28,1610,Valdemoro,23146,11596,11550
28,1625,Valdeolmos-Alalpardo,1661,868,793
28,1631,Valdepiélagos,310,161,149
28,1646,Valdetorres de Jarama,1738,902,836
28,1659,Valdilecha,1833,929,904
28,1662,Valverde de Alcalá,266,142,124
28,1678,Velilla de San Antonio,5137,2612,2525
28,1684,Vellón (El),1072,553,519
28,1697,Venturada,639,337,302
28,1718,Villa del Prado,3809,1925,1884
28,1701,Villaconejos,2850,1454,1396
28,1723,Villalbilla,3524,1855,1669
28,1739,Villamanrique de Tajo,602,296,306
28,1744,Villamanta,1485,749,736
28,1757,Villamantilla,345,181,164
28,1760,Villanueva de la Cañada,9124,4524,4600
28,1782,Villanueva de Perales,430,239,191
28,1776,Villanueva del Pardillo,3412,1744,1668
28,1795,Villar del Olmo,1168,598,570
28,1809,Villarejo de Salvanés,5435,2691,2744
28,1816,Villaviciosa de Odón,17853,8881,8972
28,1821,Villavieja del Lozoya,172,81,91
28,1837,Zarzalejo,1028,530,498
29,17,Alameda,4961,2450,2511
29,22,Alcaucín,1509,763,746
29,38,Alfarnate,1451,744,707
29,43,Alfarnatejo,405,217,188
29,56,Algarrobo,4794,2387,2407
29,69,Algatocín,972,489,483
29,75,Alhaurín de la Torre,19024,9431,9593
29,81,Alhaurín el Grande,16838,8418,8420
29,94,Almáchar,1956,991,965
29,108,Almargen,2145,449,1696
29,115,Almogía,4159,2133,2026
29,120,Álora,12633,6316,6317
29,136,Alozaina,2188,1144,1044
29,141,Alpandeire,311,158,153
29,154,Antequera,40239,19643,20596
29,167,Árchez,333,166,167
29,173,Archidona,8168,4060,4108
29,189,Ardales,2977,1473,1504
29,192,Arenas,1224,653,571
29,206,Arriate,3415,1632,1783
29,213,Atajate,176,96,80
29,228,Benadalid,253,130,123
29,234,Benahavís,1710,836,874
29,249,Benalauría,509,270,239
29,252,Benalmádena,28479,13956,14523
29,265,Benamargosa,1558,795,763
29,271,Benamocarra,2795,1400,1395
29,287,Benaoján,1684,823,861
29,290,Benarrabá,602,321,281
29,304,Borge (El),1032,528,504
29,311,Burgo (El),2051,1058,993
29,326,Campillos,7638,3835,3803
29,332,Canillas de Aceituno,2269,1129,1140
29,347,Canillas de Albaida,667,357,310
29,350,Cañete la Real,2233,1157,1076
29,363,Carratraca,852,417,435
29,379,Cartajima,254,134,120
29,385,Cártama,12752,6423,6329
29,398,Casabermeja,2982,1557,1425
29,402,Casarabonela,2552,1296,1256
29,419,Casares,3144,1656,1488
29,424,Coín,17450,8705,8745
29,430,Colmenar,3149,1550,1599
29,445,Comares,1395,715,680
29,458,Cómpeta,2681,1355,1326
29,461,Cortes de la Frontera,3628,1805,1823
29,477,Cuevas Bajas,1501,723,778
29,496,Cuevas de San Marcos,4073,2009,2064
29,483,Cuevas del Becerro,1999,1023,976
29,509,Cútar,611,307,304
29,516,Estepona,39178,19432,19746
29,521,Faraján,302,155,147
29,537,Frigiliana,2155,1055,1100
29,542,Fuengirola,44924,22056,22868
29,555,Fuente de Piedra,2065,990,1075
29,568,Gaucín,1677,866,811
29,574,Genalguacil,583,299,284
29,580,Guaro,2020,1016,1004
29,593,Humilladero,2564,1302,1262
29,607,Igualeja,930,461,469
29,614,Istán,1303,649,654
29,629,Iznate,758,383,375
29,635,Jimera de Líbar,422,195,227
29,640,Jubrique,849,416,433
29,653,Júzcar,217,119,98
29,666,Macharaviaya,325,175,150
29,672,Málaga,528079,252877,275202
29,688,Manilva,5428,2762,2666
29,691,Marbella,98377,48532,49845
29,705,Mijas,37490,18721,18769
29,712,Moclinejo,1029,519,510
29,727,Mollina,3359,1634,1725
29,733,Monda,1637,815,822
29,748,Montejaque,1009,495,514
29,751,Nerja,15326,7541,7785
29,764,Ojén,1961,1030,931
29,770,Parauta,230,120,110
29,799,Periana,3417,1771,1646
29,803,Pizarra,6602,3197,3405
29,810,Pujerra,313,175,138
29,825,Rincón de la Victoria,20629,10281,10348
29,831,Riogordo,2680,1371,1309
29,846,Ronda,33806,16554,17252
29,859,Salares,219,107,112
29,862,Sayalonga,1147,598,549
29,878,Sedella,498,268,230
29,884,Sierra de Yeguas,3175,1577,1598
29,897,Teba,4371,2231,2140
29,901,Tolox,2512,1299,1213
29,9018,Torremolinos,37235,18310,18925
29,918,Torrox,11691,5793,5898
29,923,Totalán,613,313,300
29,939,Valle de Abdalajís,3049,1491,1558
29,944,Vélez-Málaga,53816,26748,27068
29,957,Villanueva de Algaidas,4143,2046,2097
29,982,Villanueva de Tapia,1613,821,792
29,960,Villanueva del Rosario,3326,1618,1708
29,976,Villanueva del Trabuco,4697,2378,2319
29,995,Viñuela,1189,593,596
29,1009,Yunquera,3261,1689,1572
30,11,Abanilla,6065,3005,3060
30,26,Abarán,12095,6002,6093
30,32,Águilas,26197,13055,13142
30,47,Albudeite,1348,673,675
30,50,Alcantarilla,32667,16052,16615
30,9027,Alcázares (Los),6134,3057,3077
30,63,Aledo,1005,511,494
30,79,Alguazas,6933,3440,3493
30,85,Alhama de Murcia,15471,7729,7742
30,98,Archena,14176,7066,7110
30,102,Beniel,7906,3927,3979
30,119,Blanca,5703,2816,2887
30,124,Bullas,10613,5343,5270
30,130,Calasparra,8934,4493,4441
30,145,Campos del Río,2009,978,1031
30,158,Caravaca de la Cruz,21924,10864,11060
30,161,Cartagena,175628,86656,88972
30,177,Cehegín,14037,7051,6986
30,183,Ceutí,7041,3561,3480
30,196,Cieza,31637,15482,16155
30,200,Fortuna,6502,3310,3192
30,217,Fuente Álamo de Murcia,9451,4771,4680
30,222,Jumilla,20420,10148,10272
30,238,Librilla,3823,1888,1935
30,243,Lorca,69930,34607,35323
30,256,Lorquí,5482,2724,2758
30,269,Mazarrón,16829,8560,8269
30,275,Molina de Segura,42008,20854,21154
30,281,Moratalla,8574,4357,4217
30,294,Mula,13518,6713,6805
30,308,Murcia,349040,169669,179371
30,315,Ojós,594,293,301
30,320,Pliego,3383,1729,1654
30,336,Puerto Lumbreras,10585,5175,5410
30,341,Ricote,1604,783,821
30,354,San Javier,17523,8923,8600
30,367,San Pedro del Pinatar,14487,7147,7340
30,9012,Santomera,10306,5174,5132
30,373,Torre-Pacheco,21301,11633,9668
30,389,Torres de Cotillas (Las),15380,7705,7675
30,392,Totana,21666,10882,10784
30,406,Ulea,971,479,492
30,413,Unión (La),14188,7061,7127
30,428,Villanueva del Río Segura,1458,705,753
30,434,Yecla,28522,14292,14230
31,18,Abáigar,94,50,44
31,23,Abárzuza,517,256,261
31,39,Abaurregaina/Abaurrea Alta,185,109,76
31,44,Abaurrepea/Abaurrea Baja,45,32,13
31,57,Aberin,353,186,167
31,60,Ablitas,2255,1155,1100
31,76,Adiós,128,63,65
31,82,Aguilar de Codés,108,59,49
31,95,Aibar,929,475,454
31,116,Allín,817,428,389
31,121,Allo,1028,515,513
31,109,Altsasu/Alsasua,7037,3550,3487
31,137,Améscoa Baja,827,439,388
31,142,Ancín,265,133,132
31,155,Andosilla,2505,1246,1259
31,168,Ansoáin,6027,3075,2952
31,174,Anue,431,254,177
31,180,Añorbe,395,220,175
31,193,Aoiz/Agoitz,1861,925,936
31,207,Araitz,606,356,250
31,253,Arakil,872,462,410
31,214,Aranarache,91,45,46
31,235,Aranguren,3241,1714,1527
31,240,Arano,141,73,68
31,229,Arantza,703,390,313
31,266,Aras,228,121,107
31,272,Arbizu,925,485,440
31,288,Arce,303,168,135
31,291,Arcos (Los),1326,654,672
31,305,Arellano,205,109,96
31,312,Areso,307,157,150
31,327,Arguedas,2257,1128,1129
31,333,Aria,68,42,26
31,348,Aribe,67,32,35
31,351,Armañanzas,97,52,45
31,364,Arróniz,1196,627,569
31,370,Arruazu,104,57,47
31,386,Artajona,1637,858,779
31,399,Artazu,84,47,37
31,403,Atez,208,128,80
31,581,Auritz/Burguete,328,149,179
31,410,Ayegui,832,431,401
31,425,Azagra,3507,1737,1770
31,431,Azuelo,60,28,32
31,446,Bakaiku,365,202,163
31,9019,Barañain,20182,9921,10261
31,459,Barásoain,456,225,231
31,462,Barbarin,106,49,57
31,478,Bargota,386,190,196
31,484,Barillas,189,89,100
31,497,Basaburua,685,398,287
31,500,Baztan,7741,3935,3806
31,1379,Beintza-Labaien,300,164,136
31,517,Beire,342,167,175
31,522,Belascoáin,102,51,51
31,2508,Bera/Vera de Bidasoa,3507,1783,1724
31,538,Berbinzana,720,362,358
31,9058,Beriáin,2431,1208,1223
31,9024,Berrioplano,1038,520,518
31,9030,Berriozar,5412,2776,2636
31,543,Bertizarana,637,319,318
31,556,Betelu,340,185,155
31,569,Biurrun-Olcoz,176,96,80
31,575,Buñuel,2383,1157,1226
31,594,Burgui,238,133,105
31,608,Burlada,15860,7815,8045
31,615,Busto (El),102,54,48
31,620,Cabanillas,1465,751,714
31,636,Cabredo,128,66,62
31,641,Cadreita,1869,915,954
31,654,Caparroso,2286,1122,1164
31,667,Cárcar,1239,600,639
31,673,Carcastillo,2655,1333,1322
31,689,Cascante,3548,1748,1800
31,692,Cáseda,1067,524,543
31,706,Castejón,3179,1581,1598
31,713,Castillonuevo,27,16,11
31,728,Cintruénigo,5475,2710,2765
31,749,Cirauqui,450,249,201
31,752,Ciriza,53,20,33
31,765,Cizur,1091,564,527
31,771,Corella,6458,3219,3239
31,787,Cortes,3207,1634,1573
31,790,Desojo,144,83,61
31,804,Dicastillo,703,370,333
31,811,Donamaria,382,193,189
31,2212,Doneztebe/Santesteban,1297,638,659
31,832,Echarri,51,27,24
31,863,Egüés,9541,4773,4768
31,879,Elgorriaga,199,102,97
31,898,Enériz,182,92,90
31,902,Eratsun,189,118,71
31,919,Ergoiena,482,275,207
31,924,Erro,797,433,364
31,945,Eslava,184,90,94
31,958,Esparza de Salazar,116,61,55
31,961,Espronceda,181,103,78
31,977,Estella/Lizarra,12535,6021,6514
31,983,Esteribar,1452,769,683
31,996,Etayo,94,51,43
31,826,Etxalar,812,423,389
31,847,Etxarri-Aranatz,2309,1193,1116
31,850,Etxauri,375,193,182
31,1000,Eulate,404,209,195
31,1017,Ezcabarte,1140,610,530
31,930,Ezcároz,356,192,164
31,1022,Ezkurra,252,155,97
31,1038,Ezprogui,65,32,33
31,1043,Falces,2595,1274,1321
31,1056,Fitero,2034,1017,1017
31,1069,Fontellas,646,327,319
31,1075,Funes,2142,1100,1042
31,1081,Fustiñana,2311,1166,1145
31,1094,Galar,1066,569,497
31,1108,Gallipienzo,161,92,69
31,1115,Gallués,120,74,46
31,1120,Garaioa,131,71,60
31,1136,Garde,202,108,94
31,1141,Garínoain,331,174,157
31,1154,Garralda,219,113,106
31,1167,Genevilla,127,67,60
31,1173,Goizueta,923,496,427
31,1189,Goñi,201,112,89
31,1192,Güesa,78,45,33
31,1206,Guesálaz,474,276,198
31,1213,Guirguillano,76,42,34
31,2567,Hiriberri/Villanueva de Aezkoa,155,86,69
31,1228,Huarte/Uharte,2793,1407,1386
31,1249,Ibargoiti,224,127,97
31,2592,Igantzi,587,305,282
31,1252,Igúzquiza,342,168,174
31,1265,Imotz,410,230,180
31,1271,Irañeta,159,84,75
31,9045,Irurtzun,1974,1005,969
31,1287,Isaba,538,271,267
31,1290,Ituren,456,231,225
31,1304,Iturmendi,364,188,176
31,1311,Iza,632,323,309
31,1326,Izagaondoa,166,100,66
31,1332,Izalzu,50,28,22
31,1347,Jaurrieta,264,140,124
31,1350,Javier,137,60,77
31,1363,Juslapeña,464,256,208
31,1385,Lakuntza,1007,522,485
31,1398,Lana,219,129,90
31,1402,Lantz,119,75,44
31,1419,Lapoblación,176,97,79
31,1424,Larraga,1889,994,895
31,1430,Larraona,159,82,77
31,1445,Larraun,1099,611,488
31,1458,Lazagurría,236,126,110
31,1461,Leache,49,29,20
31,1477,Legarda,76,46,30
31,1483,Legaria,136,72,64
31,1496,Leitza,3026,1578,1448
31,9083,Lekunberri,838,429,409
31,1509,Leoz,265,162,103
31,1516,Lerga,87,46,41
31,1521,Lerín,1923,960,963
31,1537,Lesaka,2760,1449,1311
31,1542,Lezáun,281,159,122
31,1555,Liédena,322,152,170
31,1568,Lizoáin,237,135,102
31,1574,Lodosa,4589,2326,2263
31,1580,Lónguida,294,155,139
31,1593,Lumbier,1405,749,656
31,1607,Luquin,132,73,59
31,2482,Luzaide/Valcarlos,466,233,233
31,1614,Mañeru,374,186,188
31,1629,Marañón,72,39,33
31,1635,Marcilla,2454,1251,1203
31,1640,Mélida,827,425,402
31,1653,Mendavia,3543,1755,1788
31,1666,Mendaza,379,183,196
31,1672,Mendigorría,894,459,435
31,1688,Metauten,296,162,134
31,1691,Milagro,2586,1260,1326
31,1705,Mirafuentes,55,30,25
31,1712,Miranda de Arga,999,502,497
31,1727,Monreal,291,157,134
31,1733,Monteagudo,1172,595,577
31,1748,Morentin,111,53,58
31,1751,Mues,110,60,50
31,1764,Murchante,3059,1513,1546
31,1770,Murieta,272,151,121
31,1786,Murillo el Cuende,659,354,305
31,1799,Murillo el Fruto,755,375,380
31,1803,Muruzábal,214,109,105
31,1810,Navascués,220,134,86
31,1825,Nazar,57,31,26
31,885,Noáin (Valle de Elorz),3879,1938,1941
31,1831,Obanos,759,364,395
31,1859,Ochagavía,680,349,331
31,1846,Oco,87,51,36
31,1862,Odieta,334,180,154
31,1878,Oitz,157,91,66
31,1884,Olaibar,170,92,78
31,1897,Olazti/Olazagutía,1630,837,793
31,1901,Olejua,55,26,29
31,1918,Olite,3109,1557,1552
31,1944,Ollo,355,202,153
31,1923,Olóriz,169,94,75
31,1939,Olza,1311,669,642
31,1957,Orbaitzeta,242,133,109
31,1960,Orbara,62,33,29
31,9061,Orcoyen,1260,650,610
31,1976,Orísoain,93,52,41
31,1982,Oronz,56,31,25
31,1995,Oroz-Betelu,231,126,105
31,2114,Orreaga/Roncesvalles,31,17,14
31,2009,Oteiza,916,480,436
31,2016,Pamplona/Iruña,171150,81377,89773
31,2021,Peralta,4628,2296,2332
31,2037,Petilla de Aragón,54,28,26
31,2042,Piedramillera,73,43,30
31,2055,Pitillas,593,303,290
31,2068,Puente la Reina/Gares,2094,1034,1060
31,2074,Pueyo,324,170,154
31,2080,Ribaforada,3189,1638,1551
31,2093,Romanzado,162,94,68
31,2107,Roncal,363,180,183
31,2129,Sada,249,135,114
31,2135,Saldías,155,84,71
31,2140,Salinas de Oro,108,64,44
31,2153,San Adrián,5340,2595,2745
31,2172,San Martín de Unx,486,264,222
31,2166,Sangüesa,4558,2343,2215
31,2191,Sansol,124,63,61
31,2205,Santacara,1048,533,515
31,2227,Sarriés,83,48,35
31,2233,Sartaguda,1342,679,663
31,2248,Sesma,1390,678,712
31,2251,Sorlada,51,26,25
31,2264,Sunbilla,683,356,327
31,2270,Tafalla,10159,4996,5163
31,2286,Tiebas-Muruarte de Reta,582,311,271
31,2299,Tirapu,69,38,31
31,2303,Torralba del Río,152,83,69
31,2310,Torres del Río,185,87,98
31,2325,Tudela,27188,13190,13998
31,2331,Tulebras,100,33,67
31,2346,Ucar,119,68,51
31,1234,Uharte-Arakil,751,396,355
31,2359,Ujué,252,130,122
31,2362,Ultzama,1641,830,811
31,2378,Unciti,236,135,101
31,2384,Unzué,135,79,56
31,2397,Urdazubi/Urdax,396,188,208
31,2401,Urdiain,638,327,311
31,2418,Urraul Alto,154,89,65
31,2423,Urraul Bajo,274,127,147
31,2444,Urrotz,214,121,93
31,2439,Urroz,355,184,171
31,2457,Urzainqui,112,59,53
31,2460,Uterga,141,67,74
31,2476,Uztárroz,282,141,141
31,2495,Valtierra,2423,1178,1245
31,2515,Viana,3389,1725,1664
31,2520,Vidángoz,114,60,54
31,2536,Vidaurreta,101,64,37
31,2541,Villafranca,2520,1225,1295
31,2554,Villamayor de Monjardín,119,67,52
31,2573,Villatuerta,767,389,378
31,2589,Villava/Atarrabia,9006,4467,4539
31,2606,Yerri,1486,790,696
31,2613,Yesa,255,145,110
31,2628,Zabalza,150,69,81
31,734,Ziordia,373,174,199
31,9077,Zizur Mayor/Zizur Nagusia,9397,4697,4700
31,2634,Zubieta,308,179,129
31,2649,Zugarramurdi,239,123,116
31,2652,Zúñiga,126,71,55
32,13,Allariz,5107,2447,2660
32,28,Amoeiro,2264,1103,1161
32,34,Arnoia (A),1148,539,609
32,49,Avión,2953,1299,1654
32,52,Baltar,1332,660,672
32,65,Bande,2679,1270,1409
32,71,Baños de Molgas,2258,1119,1139
32,87,Barbadás,5576,2680,2896
32,90,Barco de Valdeorras (O),12157,6065,6092
32,104,Beade,585,281,304
32,111,Beariz,1671,768,903
32,126,Blancos (Os),1243,620,623
32,132,Boborás,3560,1627,1933
32,147,Bola (A),1621,761,860
32,150,Bolo (O),1549,758,791
32,163,Calvos de Randín,1346,664,682
32,185,Carballeda de Avia,1754,841,913
32,179,Carballeda de Valdeorras,2341,1173,1168
32,198,Carballiño (O),12170,5764,6406
32,202,Cartelle,4055,1950,2105
32,224,Castrelo de Miño,2099,1007,1092
32,219,Castrelo do Val,1308,644,664
32,230,Castro Caldelas,2001,1009,992
32,245,Celanova,5959,2816,3143
32,258,Cenlle,1744,812,932
32,296,Chandrexa de Queixa,928,506,422
32,261,Coles,3064,1505,1559
32,277,Cortegada,1468,711,757
32,283,Cualedro,2475,1239,1236
32,300,Entrimo,1510,677,833
32,317,Esgos,1376,666,710
32,338,Gomesende,1218,560,658
32,343,Gudiña (A),1826,925,901
32,356,Irixo (O),2259,1041,1218
32,381,Larouco,625,292,333
32,394,Laza,2112,1053,1059
32,408,Leiro,2052,978,1074
32,415,Lobeira,1249,602,647
32,420,Lobios,2715,1297,1418
32,436,Maceda,3366,1612,1754
32,441,Manzaneda,1343,691,652
32,454,Maside,3364,1573,1791
32,467,Melón,1631,716,915
32,473,Merca (A),2441,1175,1266
32,489,Mezquita (A),1581,804,777
32,492,Montederramo,1367,701,666
32,505,Monterrei,3465,1727,1738
32,512,Muíños,2122,1014,1108
32,527,Nogueira de Ramuín,2676,1251,1425
32,533,Oímbra,2002,995,1007
32,548,Ourense,107965,50698,57267
32,551,Paderne de Allariz,1756,837,919
32,564,Padrenda,2745,1318,1427
32,570,Parada de Sil,895,426,469
32,586,Pereiro de Aguiar (O),4673,2285,2388
32,599,Peroxa (A),2599,1225,1374
32,603,Petín,1181,564,617
32,610,Piñor,1641,816,825
32,631,Pobra de Trives (A),2986,1488,1498
32,646,Pontedeva,751,348,403
32,625,Porqueira,1196,572,624
32,659,Punxín,985,467,518
32,662,Quintela de Leirado,1014,475,539
32,678,Rairiz de Veiga,1952,955,997
32,684,Ramirás,2100,969,1131
32,697,Ribadavia,5568,2680,2888
32,718,Riós,2364,1192,1172
32,723,Rúa (A),5009,2453,2556
32,739,Rubiá,1887,932,955
32,744,San Amaro,1603,776,827
32,757,San Cibrao das Viñas,3423,1646,1777
32,760,San Cristovo de Cea,3313,1608,1705
32,701,San Xoán de Río,1084,514,570
32,776,Sandiás,1691,789,902
32,782,Sarreaus,2023,1001,1022
32,795,Taboadela,1746,874,872
32,809,Teixeira (A),624,293,331
32,816,Toén,2597,1317,1280
32,821,Trasmiras,1874,911,963
32,837,Veiga (A),1473,736,737
32,842,Verea,1478,701,777
32,855,Verín,12441,6079,6362
32,868,Viana do Bolo,4286,2114,2172
32,874,Vilamarín,2260,1104,1156
32,880,Vilamartín de Valdeorras,2514,1235,1279
32,893,Vilar de Barrio,2158,1073,1085
32,907,Vilar de Santos,1039,511,528
32,914,Vilardevós,2994,1500,1494
32,929,Vilariño de Conso,847,465,382
32,322,Xinzo de Limia,9511,4718,4793
32,369,Xunqueira de Ambía,2103,1028,1075
32,375,Xunqueira de Espadanedo,1106,528,578
33,19,Allande,2558,1309,1249
33,24,Aller,15985,7896,8089
33,30,Amieva,947,502,445
33,45,Avilés,84835,40876,43959
33,58,Belmonte de Miranda,2397,1227,1170
33,61,Bimenes,2225,1055,1170
33,77,Boal,2656,1310,1346
33,83,Cabrales,2318,1186,1132
33,96,Cabranes,1289,639,650
33,100,Candamo,2644,1270,1374
33,122,Cangas de Onís,6211,3030,3181
33,117,Cangas del Narcea,17812,9042,8770
33,138,Caravia,559,282,277
33,143,Carreño,10587,5141,5446
33,156,Caso,2052,1079,973
33,169,Castrillón,22457,10900,11557
33,175,Castropol,4467,2130,2337
33,181,Coaña,3780,1840,1940
33,194,Colunga,4571,2239,2332
33,208,Corvera de Asturias,16396,8058,8338
33,215,Cudillero,6176,3028,3148
33,220,Degaña,1565,827,738
33,236,Franco (El),4159,2032,2127
33,241,Gijón,265491,126181,139310
33,254,Gozón,11372,5534,5838
33,267,Grado,11844,5710,6134
33,273,Grandas de Salime,1366,698,668
33,289,Ibias,2222,1202,1020
33,292,Illano,666,354,312
33,306,Illas,1188,625,563
33,313,Langreo,50001,23925,26076
33,328,Laviana,14862,7222,7640
33,334,Lena,14066,6861,7205
33,352,Llanera,11528,5671,5857
33,365,Llanes,13015,6243,6772
33,371,Mieres,50760,24363,26397
33,387,Morcín,2996,1468,1528
33,390,Muros de Nalón,2397,1125,1272
33,404,Nava,5666,2787,2879
33,411,Navia,9149,4401,4748
33,426,Noreña,4230,2016,2214
33,432,Onís,906,456,450
33,447,Oviedo,199549,93036,106513
33,450,Parres,5539,2699,2840
33,463,Peñamellera Alta,760,373,387
33,479,Peñamellera Baja,1639,814,825
33,485,Pesoz,265,132,133
33,498,Piloña,9147,4416,4731
33,501,Ponga,776,456,320
33,518,Pravia,9548,4597,4951
33,523,Proaza,942,479,463
33,539,Quirós,1688,881,807
33,544,Regueras (Las),2215,1097,1118
33,557,Ribadedeva,1892,923,969
33,560,Ribadesella,6241,2974,3267
33,576,Ribera de Arriba,2041,1001,1040
33,582,Riosa,2635,1345,1290
33,595,Salas,7280,3548,3732
33,616,San Martín de Oscos,546,283,263
33,609,San Martín del Rey Aurelio,21758,10445,11313
33,637,San Tirso de Abres,662,325,337
33,621,Santa Eulalia de Oscos,594,300,294
33,642,Santo Adriano,348,181,167
33,655,Sariego,1426,706,720
33,668,Siero,46664,22599,24065
33,674,Sobrescobio,794,411,383
33,680,Somiedo,1625,858,767
33,693,Soto del Barco,4426,2098,2328
33,707,Tapia de Casariego,4407,2096,2311
33,714,Taramundi,948,461,487
33,729,Teverga,2298,1196,1102
33,735,Tineo,13273,6680,6593
33,349,Valdés,15740,7704,8036
33,740,Vegadeo,4910,2338,2572
33,753,Villanueva de Oscos,418,213,205
33,766,Villaviciosa,14223,6976,7247
33,772,Villayón,2017,1036,981
33,788,Yernes y Tameza,229,113,116
34,14,Abarca de Campos,48,25,23
34,35,Abia de las Torres,222,111,111
34,40,Aguilar de Campoo,7734,3799,3935
34,53,Alar del Rey,1335,633,702
34,66,Alba de Cerrato,111,50,61
34,91,Amayuelas de Arriba,44,26,18
34,105,Ampudia,696,362,334
34,112,Amusco,610,335,275
34,127,Antigüedad,439,237,202
34,151,Arconada,77,40,37
34,170,Astudillo,1310,678,632
34,186,Autilla del Pino,243,128,115
34,199,Autillo de Campos,195,89,106
34,203,Ayuela,84,51,33
34,225,Baltanás,1597,824,773
34,246,Baquerín de Campos,38,23,15
34,259,Bárcena de Campos,67,29,38
34,278,Barruelo de Santullán,1970,933,1037
34,284,Báscones de Ojeda,224,112,112
34,297,Becerril de Campos,1149,562,587
34,318,Belmonte de Campos,52,24,28
34,323,Berzosilla,75,34,41
34,339,Boada de Campos,28,16,12
34,357,Boadilla de Rioseco,192,97,95
34,344,Boadilla del Camino,192,104,88
34,360,Brañosera,295,154,141
34,376,Buenavista de Valdavia,459,229,230
34,382,Bustillo de la Vega,376,201,175
34,395,Bustillo del Páramo de Carrión,101,54,47
34,416,Calahorra de Boedo,143,71,72
34,421,Calzada de los Molinos,393,208,185
34,455,Capillas,124,59,65
34,468,Cardeñosa de Volpejera,57,31,26
34,474,Carrión de los Condes,2485,1165,1320
34,480,Castil de Vela,111,53,58
34,493,Castrejón de la Peña,652,343,309
34,506,Castrillo de Don Juan,350,196,154
34,513,Castrillo de Onielo,194,93,101
34,528,Castrillo de Villavega,312,163,149
34,534,Castromocho,273,140,133
34,552,Cervatos de la Cueza,396,210,186
34,565,Cervera de Pisuerga,2770,1400,1370
34,571,Cevico de la Torre,707,347,360
34,587,Cevico Navero,306,161,145
34,590,Cisneros,646,310,336
34,604,Cobos de Cerrato,265,127,138
34,611,Collazos de Boedo,171,94,77
34,626,Congosto de Valdavia,293,168,125
34,632,Cordovilla la Real,129,75,54
34,663,Cubillas de Cerrato,101,50,51
34,679,Dehesa de Montejo,246,140,106
34,685,Dehesa de Romanos,53,28,25
34,698,Dueñas,2912,1488,1424
34,702,Espinosa de Cerrato,276,144,132
34,719,Espinosa de Villagonzalo,277,141,136
34,724,Frechilla,276,131,145
34,730,Fresno del Río,202,104,98
34,745,Frómista,1027,509,518
34,761,Fuentes de Nava,842,421,421
34,777,Fuentes de Valdepero,243,132,111
34,796,Grijota,812,403,409
34,800,Guardo,8762,4440,4322
34,817,Guaza de Campos,83,38,45
34,822,Hérmedes de Cerrato,149,71,78
34,838,Herrera de Pisuerga,2732,1357,1375
34,843,Herrera de Valdecañas,206,102,104
34,869,Hontoria de Cerrato,128,64,64
34,875,Hornillos de Cerrato,140,65,75
34,881,Husillos,225,124,101
34,894,Itero de la Vega,247,127,120
34,915,Lagartos,175,94,81
34,920,Lantadilla,552,264,288
34,941,Ledigos,112,58,54
34,9036,Loma de Ucieza,347,184,163
34,967,Lomas,57,28,29
34,989,Magaz de Pisuerga,724,375,349
34,992,Manquillos,77,41,36
34,1006,Mantinos,204,102,102
34,1013,Marcilla de Campos,77,34,43
34,1028,Mazariegos,289,156,133
34,1034,Mazuecos de Valdeginate,141,72,69
34,1049,Melgar de Yuso,405,220,185
34,1065,Meneses de Campos,162,85,77
34,1071,Micieces de Ojeda,108,56,52
34,1087,Monzón de Campos,788,412,376
34,1090,Moratinos,95,50,45
34,1104,Mudá,133,67,66
34,1126,Nogal de las Huertas,75,43,32
34,1132,Olea de Boedo,47,22,25
34,1147,Olmos de Ojeda,356,198,158
34,1163,Osornillo,108,57,51
34,9015,Osorno la Mayor,1717,924,793
34,1202,Palencia,79745,38123,41622
34,1219,Palenzuela,336,179,157
34,1224,Páramo de Boedo,118,62,56
34,1230,Paredes de Nava,2507,1234,1273
34,1245,Payo de Ojeda,97,57,40
34,1258,Pedraza de Campos,142,74,68
34,1261,Pedrosa de la Vega,406,217,189
34,1277,Perales,125,66,59
34,9041,Pernía (La),482,265,217
34,1296,Pino del Río,271,157,114
34,1300,Piña de Campos,312,169,143
34,1317,Población de Arroyo,95,51,44
34,1322,Población de Campos,207,114,93
34,1338,Población de Cerrato,129,68,61
34,1343,Polentinos,93,49,44
34,1356,Pomar de Valdivia,533,275,258
34,1369,Poza de la Vega,282,156,126
34,1375,Pozo de Urama,44,25,19
34,1394,Prádanos de Ojeda,263,139,124
34,1408,Puebla de Valdavia (La),165,83,82
34,1415,Quintana del Puente,269,137,132
34,1436,Quintanilla de Onsoña,263,152,111
34,1467,Reinoso de Cerrato,86,50,36
34,1473,Renedo de la Vega,273,156,117
34,1492,Requena de Campos,58,29,29
34,1512,Respenda de la Peña,287,152,135
34,1527,Revenga de Campos,188,90,98
34,1548,Revilla de Collazos,92,50,42
34,1551,Ribas de Campos,205,107,98
34,1564,Riberos de la Cueza,93,51,42
34,1570,Saldaña,3200,1614,1586
34,1586,Salinas de Pisuerga,287,157,130
34,1599,San Cebrián de Campos,544,312,232
34,1603,San Cebrián de Mudá,211,102,109
34,1610,San Cristóbal de Boedo,49,29,20
34,1631,San Mamés de Campos,120,49,71
34,1659,San Román de la Cuba,128,65,63
34,1678,Santa Cecilia del Alcor,171,94,77
34,1684,Santa Cruz de Boedo,69,38,31
34,1697,Santervás de la Vega,570,310,260
34,1701,Santibáñez de Ecla,105,43,62
34,1718,Santibáñez de la Peña,1590,802,788
34,1744,Santoyo,295,145,150
34,1757,Serna (La),130,76,54
34,1776,Soto de Cerrato,236,120,116
34,1760,Sotobañado y Priorato,194,105,89
34,1782,Tabanera de Cerrato,175,89,86
34,1795,Tabanera de Valdavia,56,23,33
34,1809,Támara de Campos,104,52,52
34,1816,Tariego de Cerrato,563,294,269
34,1821,Torquemada,1240,631,609
34,1842,Torremormojón,78,42,36
34,1855,Triollo,97,53,44
34,1868,Valbuena de Pisuerga,75,43,32
34,1929,Valde-Ucieza,126,72,54
34,1893,Valdeolmillos,92,49,43
34,1907,Valderrábano,81,49,32
34,1966,Valle de Cerrato,137,77,60
34,9020,Valle del Retortillo,228,111,117
34,1991,Velilla del Río Carrión,1903,973,930
34,231,Venta de Baños,6410,3119,3291
34,2012,Vertavillo,246,136,110
34,936,Vid de Ojeda (La),141,82,59
34,2027,Villabasta de Valdavia,42,18,24
34,2048,Villacidaler,81,41,40
34,2051,Villaconancio,94,53,41
34,2064,Villada,1320,645,675
34,2086,Villaeles de Valdavia,87,48,39
34,2103,Villahán,151,81,70
34,2110,Villaherreros,289,138,151
34,2131,Villalaco,87,36,51
34,2146,Villalba de Guardo,243,130,113
34,2159,Villalcázar de Sirga,239,113,126
34,2162,Villalcón,88,42,46
34,2178,Villalobón,275,140,135
34,2184,Villaluenga de la Vega,665,373,292
34,2201,Villamartín de Campos,172,91,81
34,2218,Villamediana,246,126,120
34,2223,Villameriel,164,88,76
34,2239,Villamoronta,342,184,158
34,2244,Villamuera de la Cueza,72,43,29
34,2257,Villamuriel de Cerrato,4491,2302,2189
34,2276,Villanueva del Rebollar,108,54,54
34,2282,Villanuño de Valdavia,129,71,58
34,2295,Villaprovedo,106,61,45
34,2309,Villarmentero de Campos,16,10,6
34,2316,Villarrabé,295,147,148
34,2321,Villarramiel,1110,558,552
34,2337,Villasarracino,288,147,141
34,2342,Villasila de Valdavia,119,66,53
34,2368,Villaturde,270,129,141
34,2374,Villaumbrales,896,468,428
34,2380,Villaviudas,478,231,247
34,2407,Villerías de Campos,129,71,58
34,2414,Villodre,48,28,20
34,2429,Villodrigo,133,67,66
34,2435,Villoldo,504,266,238
34,2453,Villota del Páramo,467,271,196
34,2466,Villovieco,134,67,67
35,17,Agaete,5712,2916,2796
35,22,Agüimes,19305,9802,9503
35,38,Antigua,3617,1942,1675
35,43,Arrecife,40770,20737,20033
35,56,Artenara,1247,640,607
35,69,Arucas,30390,15241,15149
35,75,Betancuria,619,322,297
35,81,Firgas,6575,3307,3268
35,94,Gáldar,21987,11026,10961
35,108,Haría,3779,1943,1836
35,115,Ingenio,23496,11902,11594
35,120,Mogán,11607,6076,5531
35,136,Moya,8613,4367,4246
35,141,Oliva (La),8500,4527,3973
35,154,Pájara,8556,4707,3849
35,167,Palmas de Gran Canaria (Las),352641,171964,180677
35,173,Puerto del Rosario,19367,10165,9202
35,189,San Bartolomé,10127,5289,4838
35,192,San Bartolomé de Tirajana,37162,19138,18024
35,206,San Nicolás de Tolentino,8091,4074,4017
35,213,Santa Brígida,17143,8517,8626
35,228,Santa Lucía de Tirajana,41769,21222,20547
35,234,Santa María de Guía de Gran Canaria,13544,6757,6787
35,249,Teguise,10874,5566,5308
35,252,Tejeda,2445,1247,1198
35,265,Telde,83733,41907,41826
35,271,Teror,11459,5755,5704
35,287,Tías,11534,5935,5599
35,290,Tinajo,3964,2035,1929
35,304,Tuineje,8361,4398,3963
35,326,Valleseco,4219,2150,2069
35,311,Valsequillo de Gran Canaria,7710,3945,3765
35,332,Vega de San Mateo,7146,3684,3462
35,347,Yaiza,3801,2057,1744
36,209,Agolada,4457,2176,2281
36,10,Arbo,4459,2178,2281
36,31,Baiona,10443,5107,5336
36,25,Barro,3540,1694,1846
36,46,Bueu,12484,6111,6373
36,59,Caldas de Reis,9369,4501,4868
36,62,Cambados,12918,6269,6649
36,78,Campo Lameiro,2384,1131,1253
36,84,Cangas,23235,11468,11767
36,97,Cañiza (A),7245,3401,3844
36,101,Catoira,3541,1723,1818
36,118,Cerdedo,2684,1162,1522
36,123,Cotobade,5012,2293,2719
36,139,Covelo (O),4224,1956,2268
36,144,Crecente,2979,1352,1627
36,157,Cuntis,5733,2642,3091
36,160,Dozón,2279,1104,1175
36,176,Estrada (A),22369,10532,11837
36,182,Forcarei,5064,2389,2675
36,195,Fornelos de Montes,2343,1063,1280
36,216,Gondomar,11190,5485,5705
36,221,Grove (O),10985,5464,5521
36,237,Guarda (A),9919,4799,5120
36,9011,Illa de Arousa (A),4828,2363,2465
36,242,Lalín,20090,9723,10367
36,255,Lama (A),2956,1345,1611
36,268,Marín,25344,12526,12818
36,274,Meaño,5451,2595,2856
36,280,Meis,5001,2325,2676
36,293,Moaña,17673,8556,9117
36,307,Mondariz,5915,2770,3145
36,314,Mondariz-Balneario,635,296,339
36,329,Moraña,4402,2093,2309
36,335,Mos,13704,6654,7050
36,340,Neves (As),5027,2374,2653
36,353,Nigrán,15422,7540,7882
36,366,Oia,2956,1468,1488
36,372,Pazos de Borbén,3202,1488,1714
36,412,Poio,13802,6688,7114
36,433,Ponte-Caldelas,6648,3137,3511
36,427,Ponteareas,17136,8152,8984
36,448,Pontecesures,2963,1471,1492
36,388,Pontevedra,73871,34924,38947
36,391,Porriño (O),15812,7617,8195
36,405,Portas,3218,1510,1708
36,451,Redondela,28768,13910,14858
36,464,Ribadumia,4205,2051,2154
36,470,Rodeiro,4455,2280,2175
36,486,Rosal (O),5807,2797,3010
36,499,Salceda de Caselas,6009,2921,3088
36,502,Salvaterra de Miño,8589,4110,4479
36,519,Sanxenxo,15964,7827,8137
36,524,Silleda,9339,4490,4849
36,530,Soutomaior,5239,2509,2730
36,545,Tomiño,10652,5188,5464
36,558,Tui,15756,7494,8262
36,561,Valga,6288,3060,3228
36,577,Vigo,283110,134369,148741
36,596,Vila de Cruces,7370,3604,3766
36,583,Vilaboa,5731,2805,2926
36,600,Vilagarcía de Arousa,33724,16318,17406
36,617,Vilanova de Arousa,10380,5033,5347
37,16,Abusejo,270,131,139
37,21,Agallas,184,96,88
37,37,Ahigal de los Aceiteros,214,110,104
37,42,Ahigal de Villarino,48,25,23
37,55,Alameda de Gardón (La),179,85,94
37,68,Alamedilla (La),220,113,107
37,74,Alaraz,688,355,333
37,80,Alba de Tormes,4609,2266,2343
37,93,Alba de Yeltes,305,147,158
37,107,Alberca (La),1105,571,534
37,114,Alberguería de Argañán (La),207,106,101
37,129,Alconada,230,113,117
37,153,Aldea del Obispo,416,216,200
37,135,Aldeacipreste,249,137,112
37,140,Aldeadávila de la Ribera,1697,864,833
37,166,Aldealengua,477,240,237
37,172,Aldeanueva de Figueroa,353,177,176
37,188,Aldeanueva de la Sierra,105,49,56
37,191,Aldearrodrigo,220,112,108
37,205,Aldearrubia,517,275,242
37,212,Aldeaseca de Alba,141,68,73
37,227,Aldeaseca de la Frontera,370,184,186
37,233,Aldeatejada,583,282,301
37,248,Aldeavieja de Tormes,142,71,71
37,251,Aldehuela de la Bóveda,395,194,201
37,264,Aldehuela de Yeltes,341,169,172
37,270,Almenara de Tormes,253,127,126
37,286,Almendra,204,106,98
37,299,Anaya de Alba,330,181,149
37,303,Añover de Tormes,119,63,56
37,310,Arabayona de Mógica,546,293,253
37,325,Arapiles,513,253,260
37,331,Arcediano,106,54,52
37,346,Arco (El),110,57,53
37,359,Armenteros,344,170,174
37,378,Atalaya (La),160,85,75
37,384,Babilafuente,1008,531,477
37,397,Bañobárez,464,234,230
37,401,Barbadillo,580,278,302
37,418,Barbalos,117,60,57
37,423,Barceo,73,39,34
37,444,Barruecopardo,595,302,293
37,457,Bastida (La),43,23,20
37,460,Béjar,16165,7672,8493
37,476,Beleña,153,86,67
37,495,Bermellar,220,103,117
37,508,Berrocal de Huebra,129,62,67
37,515,Berrocal de Salvatierra,147,74,73
37,520,Boada,463,236,227
37,541,Bodón (El),350,183,167
37,554,Bogajo,217,116,101
37,567,Bouza (La),66,31,35
37,573,Bóveda del Río Almar,300,160,140
37,589,Brincones,115,55,60
37,592,Buenamadre,175,94,81
37,606,Buenavista,86,45,41
37,613,Cabaco (El),287,143,144
37,634,Cabeza de Béjar (La),114,58,56
37,652,Cabeza del Caballo,494,254,240
37,628,Cabezabellosa de la Calzada,146,76,70
37,671,Cabrerizos,1546,775,771
37,687,Cabrillas,560,265,295
37,690,Calvarrasa de Abajo,1004,497,507
37,704,Calvarrasa de Arriba,642,332,310
37,711,Calzada de Béjar (La),104,53,51
37,726,Calzada de Don Diego,263,135,128
37,732,Calzada de Valdunciel,649,321,328
37,747,Campillo de Azaba,268,133,135
37,779,Campo de Peñaranda (El),427,222,205
37,785,Candelario,1123,551,572
37,798,Canillas de Abajo,117,67,50
37,802,Cantagallo,291,140,151
37,819,Cantalapiedra,1385,682,703
37,824,Cantalpino,1179,637,542
37,830,Cantaracillo,282,144,138
37,858,Carbajosa de la Sagrada,1292,646,646
37,861,Carpio de Azaba,114,60,54
37,877,Carrascal de Barregas,417,217,200
37,883,Carrascal del Obispo,258,125,133
37,896,Casafranca,84,37,47
37,900,Casas del Conde (Las),90,42,48
37,917,Casillas de Flores,282,129,153
37,922,Castellanos de Moriscos,358,170,188
37,1857,Castellanos de Villiquera,592,310,282
37,969,Castillejo de Martín Viejo,336,174,162
37,975,Castraz,70,43,27
37,981,Cepeda,531,256,275
37,994,Cereceda de la Sierra,105,57,48
37,1008,Cerezal de Peñahorcada,144,76,68
37,1015,Cerralbo,264,140,124
37,1020,Cerro (El),578,305,273
37,1036,Cespedosa de Tormes,668,350,318
37,1149,Chagarcía Medianero,158,85,73
37,1041,Cilleros de la Bastida,49,24,25
37,1067,Cipérez,469,233,236
37,1073,Ciudad Rodrigo,14553,6991,7562
37,1089,Coca de Alba,157,70,87
37,1092,Colmenar de Montemayor,296,166,130
37,1106,Cordovilla,144,81,63
37,1128,Cristóbal,247,128,119
37,1134,Cubo de Don Sancho (El),599,318,281
37,1152,Dios le Guarde,172,97,75
37,1165,Doñinos de Ledesma,101,52,49
37,1171,Doñinos de Salamanca,703,364,339
37,1187,Ejeme,206,111,95
37,1190,Encina (La),221,119,102
37,1204,Encina de San Silvestre,125,65,60
37,1211,Encinas de Abajo,688,359,329
37,1226,Encinas de Arriba,292,141,151
37,1232,Encinasola de los Comendadores,311,160,151
37,1247,Endrinal,309,168,141
37,1250,Escurial de la Sierra,308,152,156
37,1263,Espadaña,52,26,26
37,1279,Espeja,301,154,147
37,1285,Espino de la Orbada,371,190,181
37,1298,Florida de Liébana,254,137,117
37,1302,Forfoleda,250,127,123
37,1319,Frades de la Sierra,291,150,141
37,1324,Fregeneda (La),594,286,308
37,1330,Fresnedoso,126,56,70
37,1345,Fresno Alhándiga,346,182,164
37,1358,Fuente de San Esteban (La),1544,783,761
37,1361,Fuenteguinaldo,992,501,491
37,1377,Fuenteliante,160,73,87
37,1383,Fuenterroble de Salvatierra,288,146,142
37,1396,Fuentes de Béjar,323,134,189
37,1400,Fuentes de Oñoro,1442,690,752
37,1417,Gajates,271,135,136
37,1422,Galindo y Perahuy,250,134,116
37,1438,Galinduste,568,277,291
37,1443,Galisancho,597,327,270
37,1456,Gallegos de Argañán,422,219,203
37,1469,Gallegos de Solmirón,202,98,104
37,1475,Garcibuey,298,169,129
37,1481,Garcihernández,598,322,276
37,1494,Garcirrey,113,56,57
37,1507,Gejuelo del Barro,51,29,22
37,1514,Golpejas,219,112,107
37,1529,Gomecello,564,287,277
37,1540,Guadramiro,235,136,99
37,1553,Guijo de Ávila,113,62,51
37,1566,Guijuelo,5050,2511,2539
37,1572,Herguijuela de Ciudad Rodrigo,158,83,75
37,1588,Herguijuela de la Sierra,326,164,162
37,1591,Herguijuela del Campo,126,58,68
37,1605,Hinojosa de Duero,870,432,438
37,1612,Horcajo de Montemayor,205,103,102
37,1627,Horcajo Medianero,383,190,193
37,1633,Hoya (La),25,19,6
37,1648,Huerta,274,147,127
37,1651,Iruelos,67,27,40
37,1664,Ituero de Azaba,300,162,138
37,1670,Juzbado,175,89,86
37,1686,Lagunilla,669,356,313
37,1699,Larrodrigo,325,170,155
37,1703,Ledesma,1989,969,1020
37,1710,Ledrada,592,299,293
37,1725,Linares de Riofrío,1038,526,512
37,1731,Lumbrales,2234,1106,1128
37,1759,Machacón,544,274,270
37,1746,Macotera,1745,882,863
37,1762,Madroñal,176,92,84
37,1778,Maíllo (El),455,229,226
37,1784,Malpartida,168,93,75
37,1797,Mancera de Abajo,378,188,190
37,1801,Manzano (El),101,55,46
37,1818,Martiago,391,204,187
37,1839,Martín de Yeltes,579,294,285
37,1823,Martinamor,81,42,39
37,1844,Masueco,488,244,244
37,1860,Mata de Ledesma (La),152,73,79
37,1876,Matilla de los Caños del Río,672,350,322
37,1882,Maya (La),263,140,123
37,1895,Membribe de la Sierra,102,54,48
37,1909,Mieza,357,175,182
37,1916,Milano (El),199,106,93
37,1921,Miranda de Azán,300,133,167
37,1937,Miranda del Castañar,636,331,305
37,1942,Mogarraz,368,173,195
37,1955,Molinillo,72,33,39
37,1968,Monforte de la Sierra,126,71,55
37,1974,Monleón,135,78,57
37,1980,Monleras,273,138,135
37,1993,Monsagro,241,136,105
37,2007,Montejo,246,132,114
37,2014,Montemayor del Río,368,196,172
37,2029,Monterrubio de Armuña,386,191,195
37,2035,Monterrubio de la Sierra,164,89,75
37,2040,Morasverdes,460,229,231
37,2053,Morille,183,98,85
37,2066,Moríñigo,146,75,71
37,2072,Moriscos,143,72,71
37,2088,Moronta,138,73,65
37,2091,Mozárbez,394,203,191
37,2112,Narros de Matalayegua,308,166,142
37,2133,Nava de Béjar,123,62,61
37,2148,Nava de Francia,153,80,73
37,2151,Nava de Sotrobal,203,107,96
37,2127,Navacarros,125,67,58
37,2164,Navales,406,230,176
37,2170,Navalmoral de Béjar,77,34,43
37,2186,Navamorales,193,104,89
37,2199,Navarredonda de la Rinconada,272,131,141
37,2210,Navasfrías,719,356,363
37,2225,Negrilla de Palencia,140,67,73
37,2231,Olmedo de Camaces,184,88,96
37,2246,Orbada (La),289,148,141
37,2259,Pajares de la Laguna,148,73,75
37,2262,Palacios del Arzobispo,249,127,122
37,2284,Palaciosrubios,568,302,266
37,2297,Palencia de Negrilla,208,103,105
37,2301,Parada de Arriba,255,138,117
37,2318,Parada de Rubiales,352,184,168
37,2323,Paradinas de San Juan,660,353,307
37,2339,Pastores,64,35,29
37,2344,Payo (El),503,239,264
37,2357,Pedraza de Alba,299,159,140
37,2360,Pedrosillo de Alba,283,142,141
37,2376,Pedrosillo de los Aires,456,245,211
37,2382,Pedrosillo el Ralo,148,73,75
37,2395,Pedroso de la Armuña (El),325,159,166
37,2409,Pelabravo,732,372,360
37,2416,Pelarrodríguez,207,119,88
37,2421,Pelayos,81,41,40
37,2437,Peña (La),163,74,89
37,2442,Peñacaballera,226,106,120
37,2455,Peñaparda,499,243,256
37,2468,Peñaranda de Bracamonte,6159,3011,3148
37,2474,Peñarandilla,282,142,140
37,2480,Peralejos de Abajo,207,99,108
37,2493,Peralejos de Arriba,75,41,34
37,2506,Pereña de la Ribera,556,282,274
37,2513,Peromingo,165,79,86
37,2528,Pinedas,203,104,99
37,2534,Pino de Tormes (El),179,90,89
37,2549,Pitiegua,273,132,141
37,2552,Pizarral,91,44,47
37,2565,Poveda de las Cintas,356,193,163
37,2571,Pozos de Hinojo,88,47,41
37,2587,Puebla de Azaba,303,156,147
37,2590,Puebla de San Medel,75,40,35
37,2604,Puebla de Yeltes,261,143,118
37,2611,Puente del Congosto,358,175,183
37,2626,Puertas,106,58,48
37,2632,Puerto de Béjar,509,234,275
37,2647,Puerto Seguro,117,59,58
37,2650,Rágama,318,163,155
37,2663,Redonda (La),121,57,64
37,2679,Retortillo,251,118,133
37,2685,Rinconada de la Sierra (La),172,86,86
37,2698,Robleda,581,311,270
37,2702,Robliza de Cojos,198,101,97
37,2719,Rollán,604,311,293
37,2724,Saelices el Chico,189,101,88
37,2730,Sagrada (La),194,99,95
37,3034,Sahugo (El),289,152,137
37,2745,Salamanca,158457,74404,84053
37,2758,Saldeana,193,107,86
37,2761,Salmoral,350,171,179
37,2777,Salvatierra de Tormes,65,33,32
37,2783,San Cristóbal de la Cuesta,341,174,167
37,2843,San Esteban de la Sierra,463,235,228
37,2856,San Felices de los Gallegos,660,330,330
37,2869,San Martín del Castañar,284,144,140
37,2875,San Miguel de Valero,451,238,213
37,362,San Miguel del Robledo,100,47,53
37,2881,San Morales,206,110,96
37,2894,San Muñoz,371,185,186
37,2915,San Pedro de Rozados,367,183,184
37,2908,San Pedro del Valle,131,64,67
37,2920,San Pelayo de Guareña,108,55,53
37,2800,Sanchón de la Ribera,127,68,59
37,2817,Sanchón de la Sagrada,56,31,25
37,2822,Sanchotello,324,164,160
37,2796,Sancti-Spíritus,1215,630,585
37,2838,Sando,201,106,95
37,2936,Santa María de Sando,195,103,92
37,2941,Santa Marta de Tormes,9884,4918,4966
37,2967,Santiago de la Puebla,586,302,284
37,2973,Santibáñez de Béjar,699,346,353
37,2989,Santibáñez de la Sierra,258,142,116
37,2992,Santiz,285,145,140
37,3006,Santos (Los),777,401,376
37,3013,Sardón de los Frailes,102,55,47
37,3028,Saucelle,483,240,243
37,3049,Sepulcro-Hilario,303,156,147
37,3052,Sequeros,270,115,155
37,3065,Serradilla del Arroyo,447,225,222
37,3071,Serradilla del Llano,277,142,135
37,3090,Sierpe (La),58,32,26
37,3104,Sieteiglesias de Tormes,178,87,91
37,3111,Sobradillo,374,181,193
37,3126,Sorihuela,391,190,201
37,3132,Sotoserrano,738,388,350
37,3147,Tabera de Abajo,115,59,56
37,3150,Tala (La),145,77,68
37,3163,Tamames,1040,531,509
37,3179,Tarazona de Guareña,437,235,202
37,3185,Tardáguila,267,142,125
37,3198,Tejado (El),178,86,92
37,3202,Tejeda y Segoyuela,124,63,61
37,3219,Tenebrón,237,121,116
37,3224,Terradillos,3002,1518,1484
37,3230,Topas,708,359,349
37,3245,Tordillos,577,291,286
37,3258,Tornadizo (El),145,73,72
37,3277,Torresmenudas,240,117,123
37,3283,Trabanca,256,130,126
37,3296,Tremedal de Tormes,49,24,25
37,3300,Valdecarros,466,242,224
37,3317,Valdefuentes de Sangusín,332,167,165
37,3322,Valdehijaderos,119,65,54
37,3338,Valdelacasa,360,194,166
37,3343,Valdelageve,135,71,64
37,3356,Valdelosa,484,232,252
37,3369,Valdemierque,71,36,35
37,3375,Valderrodrigo,196,93,103
37,3381,Valdunciel,127,60,67
37,3394,Valero,464,229,235
37,3436,Vallejera de Riofrío,53,24,29
37,3408,Valsalabroso,232,122,110
37,3415,Valverde de Valdelacasa,75,38,37
37,3420,Valverdón,273,138,135
37,3441,Vecinos,296,145,151
37,3454,Vega de Tirados,227,117,110
37,3467,Veguillas (Las),312,151,161
37,3473,Vellés (La),472,239,233
37,3489,Ventosa del Río Almar,170,82,88
37,3492,Vídola (La),191,97,94
37,3512,Villaflores,477,236,241
37,3527,Villagonzalo de Tormes,249,132,117
37,3533,Villalba de los Llanos,196,108,88
37,3548,Villamayor,2490,1297,1193
37,3551,Villanueva del Conde,263,140,123
37,3564,Villar de Argañán,109,55,54
37,3570,Villar de Ciervo,409,211,198
37,3586,Villar de Gallimazo,221,107,114
37,3599,Villar de la Yegua,319,144,175
37,3603,Villar de Peralonso,356,167,189
37,3610,Villar de Samaniego,126,66,60
37,3625,Villares de la Reina,2397,1195,1202
37,3631,Villares de Yeltes,173,77,96
37,3646,Villarino de los Aires,1125,553,572
37,3659,Villarmayor,243,127,116
37,3662,Villarmuerto,65,37,28
37,3678,Villasbuenas,323,162,161
37,3684,Villasdardo,26,12,14
37,3697,Villaseco de los Gamitos,208,107,101
37,3701,Villaseco de los Reyes,461,238,223
37,3718,Villasrubias,388,209,179
37,3723,Villaverde de Guareña,198,98,100
37,3739,Villavieja de Yeltes,1132,563,569
37,3744,Villoria,1400,695,705
37,3757,Villoruela,1015,507,508
37,3505,Vilvestre,626,305,321
37,3760,Vitigudino,3159,1554,1605
37,3776,Yecla de Yeltes,363,178,185
37,3782,Zamarra,161,83,78
37,3795,Zamayón,205,117,88
37,3809,Zarapicos,66,37,29
37,3816,Zarza de Pumareda (La),201,114,87
37,3821,Zorita de la Frontera,293,161,132
38,12,Adeje,13605,6833,6772
38,27,Agulo,1090,538,552
38,33,Alajeró,1206,636,570
38,48,Arafo,4536,2198,2338
38,51,Arico,5053,2586,2467
38,64,Arona,26312,13161,13151
38,70,Barlovento,2408,1207,1201
38,86,Breña Alta,5784,2869,2915
38,99,Breña Baja,3737,1852,1885
38,103,Buenavista del Norte,5469,2782,2687
38,110,Candelaria,12681,6265,6416
38,125,Fasnia,2378,1195,1183
38,131,Frontera,4218,2141,2077
38,146,Fuencaliente de la Palma,1728,876,852
38,159,Garachico,5497,2702,2795
38,162,Garafía,1754,891,863
38,178,Granadilla de Abona,17321,8665,8656
38,184,Guancha (La),5140,2558,2582
38,197,Guía de Isora,11958,5810,6148
38,201,Güímar,13761,6753,7008
38,218,Hermigua,2057,1056,1001
38,223,Icod de los Vinos,22079,10833,11246
38,244,Llanos de Aridane (Los),17774,8773,9001
38,257,Matanza de Acentejo (La),6377,3241,3136
38,260,Orotava (La),35775,17704,18071
38,276,Paso (El),7192,3630,3562
38,282,Puerto de la Cruz,24050,11713,12337
38,295,Puntagorda,1785,879,906
38,309,Puntallana,2025,1004,1021
38,316,Realejos (Los),32469,16112,16357
38,321,Rosario (El),11544,5780,5764
38,337,San Andrés y Sauces,5339,2696,2643
38,239,San Cristóbal de La Laguna,127945,62703,65242
38,342,San Juan de la Rambla,4645,2297,2348
38,355,San Miguel de Abona,5722,2871,2851
38,368,San Sebastián de la Gomera,6100,3061,3039
38,374,Santa Cruz de la Palma,15445,7434,8011
38,380,Santa Cruz de Tenerife,211930,101429,110501
38,393,Santa Úrsula,9943,4937,5006
38,407,Santiago del Teide,8069,4091,3978
38,414,Sauzal (El),6912,3420,3492
38,429,Silos (Los),5230,2589,2641
38,435,Tacoronte,20026,10024,10002
38,440,Tanque (El),3242,1623,1619
38,453,Tazacorte,6371,3186,3185
38,466,Tegueste,8744,4345,4399
38,472,Tijarafe,2607,1319,1288
38,491,Valle Gran Rey,3627,1845,1782
38,504,Vallehermoso,2710,1364,1346
38,488,Valverde,3461,1718,1743
38,511,Victoria de Acentejo (La),7566,3757,3809
38,526,Vilaflor,1506,759,747
38,532,Villa de Mazo,4249,2121,2128
39,15,Alfoz de Lloredo,2608,1332,1276
39,20,Ampuero,3424,1726,1698
39,36,Anievas,394,201,193
39,41,Arenas de Iguña,2085,1046,1039
39,54,Argoños,805,409,396
39,67,Arnuero,1739,876,863
39,73,Arredondo,645,353,292
39,89,Astillero (El),12920,6238,6682
39,92,Bárcena de Cicero,2237,1136,1101
39,106,Bárcena de Pie de Concha,932,450,482
39,113,Bareyo,1654,841,813
39,128,Cabezón de la Sal,7089,3496,3593
39,134,Cabezón de Liébana,732,399,333
39,149,Cabuérniga,1119,568,551
39,152,Camaleño,1091,567,524
39,165,Camargo,22788,11154,11634
39,279,Campoo de Enmedio,3866,1963,1903
39,171,Campoo de Yuso,772,379,393
39,187,Cartes,2804,1390,1414
39,190,Castañeda,1481,732,749
39,204,Castro-Urdiales,16795,8388,8407
39,211,Cieza,707,348,359
39,226,Cillorigo de Liébana,1135,602,533
39,232,Colindres,6140,3071,3069
39,247,Comillas,2330,1097,1233
39,250,Corrales de Buelna (Los),10491,5243,5248
39,263,Corvera de Toranzo,2141,1077,1064
39,285,Entrambasaguas,2446,1220,1226
39,298,Escalante,743,378,365
39,302,Guriezo,1707,895,812
39,319,Hazas de Cesto,1280,643,637
39,324,Hermandad de Campoo de Suso,1856,998,858
39,330,Herrerías,744,413,331
39,345,Lamasón,410,230,180
39,358,Laredo,13155,6379,6776
39,361,Liendo,828,427,401
39,377,Liérganes,2258,1098,1160
39,383,Limpias,1261,625,636
39,396,Luena,1010,528,482
39,400,Marina de Cudeyo,4640,2314,2326
39,417,Mazcuerras,1872,997,875
39,422,Medio Cudeyo,6030,2962,3068
39,438,Meruelo,1028,514,514
39,443,Miengo,3466,1720,1746
39,456,Miera,548,276,272
39,469,Molledo,1984,949,1035
39,475,Noja,1865,939,926
39,481,Penagos,1635,813,822
39,494,Peñarrubia,286,145,141
39,507,Pesaguero,403,212,191
39,514,Pesquera,100,49,51
39,529,Piélagos,11075,5490,5585
39,535,Polaciones,291,173,118
39,540,Polanco,3631,1760,1871
39,553,Potes,1579,774,805
39,566,Puente Viesgo,2314,1156,1158
39,572,Ramales de la Victoria,2239,1158,1081
39,588,Rasines,983,506,477
39,591,Reinosa,11656,5656,6000
39,605,Reocín,6843,3410,3433
39,612,Ribamontán al Mar,3457,1761,1696
39,627,Ribamontán al Monte,2006,1027,979
39,633,Rionansa,1495,830,665
39,648,Riotuerto,1537,740,797
39,651,Rozas de Valdearroyo (Las),289,149,140
39,664,Ruente,953,495,458
39,670,Ruesga,1246,641,605
39,686,Ruiloba,703,354,349
39,699,San Felices de Buelna,2176,1049,1127
39,703,San Miguel de Aguayo,156,82,74
39,710,San Pedro del Romeral,668,339,329
39,725,San Roque de Riomiera,527,298,229
39,801,San Vicente de la Barquera,4417,2248,2169
39,731,Santa Cruz de Bezana,7239,3596,3643
39,746,Santa María de Cayón,6265,3134,3131
39,759,Santander,184165,86385,97780
39,762,Santillana del Mar,3860,1901,1959
39,778,Santiurde de Reinosa,347,184,163
39,784,Santiurde de Toranzo,1675,848,827
39,797,Santoña,11657,5948,5709
39,818,Saro,534,269,265
39,823,Selaya,1963,990,973
39,839,Soba,1711,898,813
39,844,Solórzano,1003,513,490
39,857,Suances,6237,3070,3167
39,860,Tojos (Los),394,214,180
39,876,Torrelavega,57493,27730,29763
39,882,Tresviso,60,35,25
39,895,Tudanca,264,157,107
39,909,Udías,839,420,419
39,955,Val de San Vicente,2551,1293,1258
39,916,Valdáliga,2595,1334,1261
39,921,Valdeolea,1560,800,760
39,937,Valdeprado del Río,306,155,151
39,942,Valderredible,1159,609,550
39,968,Vega de Liébana,1035,553,482
39,974,Vega de Pas,1009,511,498
39,980,Villacarriedo,1760,929,831
39,993,Villaescusa,3018,1464,1554
39,1007,Villafufre,1116,582,534
39,1014,Villaverde de Trucíos,372,191,181
39,1029,Voto,2230,1151,1079
40,19,Abades,860,434,426
40,24,Adrada de Pirón,61,34,27
40,30,Adrados,230,116,114
40,45,Aguilafuente,785,376,409
40,58,Alconada de Maderuelo,59,34,25
40,122,Aldea Real,409,218,191
40,61,Aldealcorvo,33,16,17
40,77,Aldealengua de Pedraza,101,57,44
40,83,Aldealengua de Santa María,94,50,44
40,96,Aldeanueva de la Serrezuela,57,35,22
40,100,Aldeanueva del Codonal,216,109,107
40,138,Aldeasoña,117,54,63
40,143,Aldehorno,82,42,40
40,156,Aldehuela del Codonal,59,28,31
40,169,Aldeonte,92,46,46
40,175,Anaya,135,68,67
40,181,Añe,122,66,56
40,194,Arahuetes,44,24,20
40,208,Arcones,254,134,120
40,215,Arevalillo de Cega,38,19,19
40,220,Armuña,274,148,126
40,241,Ayllón,1199,607,592
40,254,Barbolla,231,122,109
40,267,Basardilla,101,50,51
40,289,Bercial,133,62,71
40,292,Bercimuel,72,33,39
40,306,Bernardos,753,378,375
40,313,Bernuy de Porreros,325,169,156
40,328,Boceguillas,575,295,280
40,334,Brieva,69,42,27
40,349,Caballar,102,47,55
40,352,Cabañas de Polendos,117,60,57
40,365,Cabezuela,732,389,343
40,371,Calabazas de Fuentidueña,78,38,40
40,390,Campo de San Pedro,405,228,177
40,404,Cantalejo,3442,1742,1700
40,411,Cantimpalos,1291,664,627
40,432,Carbonero el Mayor,2327,1181,1146
40,447,Carrascal del Río,214,115,99
40,450,Casla,156,81,75
40,463,Castillejo de Mesleón,131,66,65
40,479,Castro de Fuentidueña,93,51,42
40,485,Castrojimeno,49,29,20
40,498,Castroserna de Abajo,59,35,24
40,518,Castroserracín,57,33,24
40,523,Cedillo de la Torre,135,68,67
40,539,Cerezo de Abajo,177,84,93
40,544,Cerezo de Arriba,208,108,100
40,655,Chañe,738,390,348
40,557,Cilleruelo de San Mamés,54,25,29
40,560,Cobos de Fuentidueña,69,29,40
40,576,Coca,2002,986,1016
40,582,Codorniz,504,244,260
40,595,Collado Hermoso,143,69,74
40,609,Condado de Castilnovo,142,80,62
40,616,Corral de Ayllón,111,59,52
40,9025,Cozuelos de Fuentidueña,202,104,98
40,621,Cubillo,58,35,23
40,637,Cuéllar,9059,4612,4447
40,9059,Cuevas de Provanco,219,117,102
40,680,Domingo García,45,22,23
40,693,Donhierro,109,61,48
40,707,Duruelo,136,71,65
40,714,Encinas,72,34,38
40,729,Encinillas,76,43,33
40,735,Escalona del Prado,589,309,280
40,740,Escarabajosa de Cabezas,381,201,180
40,753,Escobar de Polendos,227,117,110
40,766,Espinar (El),6044,3083,2961
40,772,Espirdo,216,123,93
40,788,Fresneda de Cuéllar,250,133,117
40,791,Fresno de Cantespino,242,128,114
40,805,Fresno de la Fuente,75,39,36
40,812,Frumales,227,117,110
40,827,Fuente de Santa Cruz,198,98,100
40,833,Fuente el Olmo de Fuentidueña,155,77,78
40,848,Fuente el Olmo de Íscar,118,65,53
40,864,Fuentepelayo,979,494,485
40,870,Fuentepiñel,198,98,100
40,886,Fuenterrebollo,453,235,218
40,899,Fuentesaúco de Fuentidueña,339,178,161
40,910,Fuentesoto,171,91,80
40,925,Fuentidueña,185,95,90
40,931,Gallegos,116,63,53
40,946,Garcillán,360,188,172
40,959,Gomezserracín,664,340,324
40,978,Grajera,99,53,46
40,997,Honrubia de la Cuesta,84,38,46
40,1001,Hontalbilla,452,232,220
40,1018,Hontanares de Eresma,162,88,74
40,1039,Huertos (Los),166,78,88
40,1044,Ituero y Lama,92,54,38
40,1057,Juarros de Riomoros,74,40,34
40,1060,Juarros de Voltoya,307,165,142
40,1076,Labajos,157,88,69
40,1082,Laguna de Contreras,179,97,82
40,1095,Languilla,132,78,54
40,1109,Lastras de Cuéllar,583,309,274
40,1116,Lastras del Pozo,79,41,38
40,1121,Lastrilla (La),1456,728,728
40,1137,Losa (La),380,200,180
40,1155,Maderuelo,156,81,75
40,9031,Marazoleja,158,92,66
40,1180,Marazuela,86,44,42
40,1193,Martín Miguel,207,101,106
40,1207,Martín Muñoz de la Dehesa,195,106,89
40,1214,Martín Muñoz de las Posadas,531,265,266
40,1229,Marugán,299,155,144
40,1240,Mata de Cuéllar,331,186,145
40,1235,Matabuena,218,112,106
40,1253,Matilla (La),120,63,57
40,1266,Melque de Cercos,129,62,67
40,1272,Membibre de la Hoz,80,41,39
40,1288,Migueláñez,178,87,91
40,1291,Montejo de Arévalo,305,167,138
40,1305,Montejo de la Vega de la Serrezuela,201,106,95
40,1312,Monterrubio,67,34,33
40,1327,Moral de Hornuez,112,60,52
40,1348,Mozoncillo,1037,536,501
40,1351,Muñopedro,403,205,198
40,1364,Muñoveros,206,109,97
40,1386,Nava de la Asunción,2662,1357,1305
40,1399,Navafría,381,203,178
40,1403,Navalilla,164,80,84
40,1410,Navalmanzano,1148,589,559
40,1425,Navares de Ayuso,87,44,43
40,1431,Navares de Enmedio,171,93,78
40,1446,Navares de las Cuevas,22,11,11
40,1459,Navas de Oro,1478,753,725
40,9046,Navas de Riofrío,268,130,138
40,1462,Navas de San Antonio,289,151,138
40,1484,Nieva,376,201,175
40,1497,Olombrada,821,437,384
40,1500,Orejana,117,64,53
40,1517,Ortigosa de Pestaño,86,46,40
40,9010,Ortigosa del Monte,333,168,165
40,1522,Otero de Herreros,803,387,416
40,1543,Pajarejos,47,22,25
40,1556,Palazuelos de Eresma,2681,1344,1337
40,1569,Pedraza,447,238,209
40,1575,Pelayos del Arroyo,49,24,25
40,1581,Perosillo,33,21,12
40,1594,Pinarejos,205,115,90
40,1608,Pinarnegrillo,202,102,100
40,1615,Pradales,73,38,35
40,1620,Prádena,576,307,269
40,1636,Puebla de Pedraza,89,46,43
40,1641,Rapariegos,269,136,133
40,1654,Rebollo,135,73,62
40,1667,Remondo,373,179,194
40,1689,Riaguas de San Bartolomé,79,41,38
40,1706,Riaza,1661,882,779
40,1713,Ribota,34,21,13
40,1728,Riofrío de Riaza,56,30,26
40,1734,Roda de Eresma,107,54,53
40,1749,Sacramenia,582,299,283
40,1765,Samboal,616,315,301
40,1771,San Cristóbal de Cuéllar,241,119,122
40,1787,San Cristóbal de la Vega,164,82,82
40,1811,San Ildefonso,5166,2504,2662
40,1826,San Martín y Mudrián,301,154,147
40,1832,San Miguel de Bernuy,179,91,88
40,1847,San Pedro de Gaíllos,361,180,181
40,1790,Sanchonuño,753,373,380
40,1804,Sangarcía,465,241,224
40,1850,Santa María la Real de Nieva,1496,754,742
40,1863,Santa Marta del Cerro,53,27,26
40,1885,Santiuste de Pedraza,109,61,48
40,1898,Santiuste de San Juan Bautista,776,399,377
40,1902,Santo Domingo de Pirón,58,27,31
40,1919,Santo Tomé del Puerto,334,179,155
40,1924,Sauquillo de Cabezas,256,140,116
40,1930,Sebúlcor,289,156,133
40,1945,Segovia,54012,25951,28061
40,1958,Sepúlveda,1330,685,645
40,1961,Sequera de Fresno,53,28,25
40,1983,Sotillo,46,21,25
40,1996,Sotosalbos,111,62,49
40,2000,Tabanera la Luenga,76,40,36
40,2017,Tolocirio,65,29,36
40,2069,Torre Val de San Pedro,197,107,90
40,2022,Torreadrada,140,70,70
40,2038,Torrecaballeros,456,240,216
40,2043,Torrecilla del Pinar,330,161,169
40,2056,Torreiglesias,389,204,185
40,2075,Trescasas,267,133,134
40,2081,Turégano,1113,556,557
40,2108,Urueñas,120,65,55
40,2115,Valdeprados,62,31,31
40,2120,Valdevacas de Montejo,32,19,13
40,2136,Valdevacas y Guijar,147,77,70
40,2189,Valle de Tabladillo,170,88,82
40,2192,Vallelado,856,433,423
40,2206,Valleruela de Pedraza,78,43,35
40,2213,Valleruela de Sepúlveda,79,38,41
40,2141,Valseca,310,163,147
40,2154,Valtiendas,201,111,90
40,2167,Valverde del Majano,493,255,238
40,2228,Veganzones,288,144,144
40,2234,Vegas de Matute,252,144,108
40,2249,Ventosilla y Tejadilla,29,19,10
40,2252,Villacastín,1538,781,757
40,2287,Villaverde de Íscar,756,386,370
40,2290,Villaverde de Montejo,69,37,32
40,2304,Villeguillo,133,76,57
40,2311,Yanguas de Eresma,190,93,97
40,2332,Zarzuela del Monte,532,268,264
40,2347,Zarzuela del Pinar,614,325,289
41,16,Aguadulce,1966,996,970
41,21,Alanís,2047,1024,1023
41,37,Albaida del Aljarafe,1814,917,897
41,42,Alcalá de Guadaira,56244,27852,28392
41,55,Alcalá del Río,9274,4720,4554
41,68,Alcolea del Río,3385,1662,1723
41,74,Algaba (La),12784,6445,6339
41,80,Algámitas,1377,721,656
41,93,Almadén de la Plata,1716,857,859
41,107,Almensilla,2703,1371,1332
41,114,Arahal,18252,9034,9218
41,129,Aznalcázar,3431,1721,1710
41,135,Aznalcóllar,5756,2932,2824
41,140,Badolatosa,3130,1621,1509
41,153,Benacazón,4937,2507,2430
41,166,Bollullos de la Mitación,5012,2521,2491
41,172,Bormujos,7521,3757,3764
41,188,Brenes,10509,5289,5220
41,191,Burguillos,3485,1740,1745
41,205,Cabezas de San Juan (Las),15632,8056,7576
41,212,Camas,25499,12416,13083
41,227,Campana (La),5212,2632,2580
41,233,Cantillana,8929,4503,4426
41,9017,Cañada Rosal,2948,1465,1483
41,248,Carmona,25326,12730,12596
41,251,Carrión de los Céspedes,2271,1079,1192
41,264,Casariche,5118,2589,2529
41,270,Castilblanco de los Arroyos,4394,2195,2199
41,286,Castilleja de Guzmán,829,423,406
41,299,Castilleja de la Cuesta,15862,7801,8061
41,303,Castilleja del Campo,625,308,317
41,310,Castillo de las Guardas (El),1606,814,792
41,325,Cazalla de la Sierra,5242,2626,2616
41,331,Constantina,7246,3565,3681
41,346,Coria del Río,23517,11797,11720
41,359,Coripe,1560,790,770
41,362,Coronil (El),5140,2616,2524
41,378,Corrales (Los),4137,2105,2032
41,9038,Cuervo de Sevilla (El),7625,3865,3760
41,384,Dos Hermanas,92506,45887,46619
41,397,Écija,37113,18235,18878
41,401,Espartinas,4408,2241,2167
41,418,Estepa,11654,5744,5910
41,423,Fuentes de Andalucía,7447,3683,3764
41,439,Garrobo (El),780,385,395
41,444,Gelves,5245,2594,2651
41,457,Gerena,5421,2722,2699
41,460,Gilena,3834,1947,1887
41,476,Gines,9025,4459,4566
41,482,Guadalcanal,3067,1516,1551
41,495,Guillena,8257,4189,4068
41,508,Herrera,5979,2949,3030
41,515,Huévar,2283,1175,1108
41,520,Lantejuela (La),3488,1797,1691
41,536,Lebrija,23924,12102,11822
41,541,Lora de Estepa,752,374,378
41,554,Lora del Río,18855,9298,9557
41,567,Luisiana (La),4349,2223,2126
41,573,Madroño (El),376,186,190
41,589,Mairena del Alcor,16249,8073,8176
41,592,Mairena del Aljarafe,31793,15941,15852
41,606,Marchena,18018,8859,9159
41,613,Marinaleda,2616,1290,1326
41,628,Martín de la Jara,2802,1470,1332
41,634,Molares (Los),2675,1341,1334
41,649,Montellano,6943,3507,3436
41,652,Morón de la Frontera,28232,14041,14191
41,665,Navas de la Concepción (Las),1899,947,952
41,671,Olivares,7687,3888,3799
41,687,Osuna,17306,8548,8758
41,690,Palacios y Villafranca (Los),32114,16247,15867
41,704,Palomares del Río,3493,1775,1718
41,711,Paradas,6897,3463,3434
41,726,Pedrera,5003,2496,2507
41,732,Pedroso (El),2422,1193,1229
41,747,Peñaflor,3895,1984,1911
41,750,Pilas,11155,5513,5642
41,763,Pruna,3354,1719,1635
41,779,Puebla de Cazalla (La),10834,5456,5378
41,785,Puebla de los Infantes (La),3464,1747,1717
41,798,Puebla del Río (La),10660,5312,5348
41,802,Real de la Jara (El),1752,858,894
41,819,Rinconada (La),26942,13579,13363
41,824,Roda de Andalucía (La),4194,2074,2120
41,830,Ronquillo (El),1437,719,718
41,845,Rubio (El),3710,1864,1846
41,858,Salteras,2913,1448,1465
41,861,San Juan de Aznalfarache,20563,9934,10629
41,883,San Nicolás del Puerto,702,359,343
41,877,Sanlúcar la Mayor,10655,5272,5383
41,896,Santiponce,6841,3428,3413
41,900,Saucejo (El),4170,2086,2084
41,917,Sevilla,701927,335437,366490
41,922,Tocina,8811,4384,4427
41,938,Tomares,17028,8410,8618
41,943,Umbrete,4818,2408,2410
41,956,Utrera,45947,23014,22933
41,969,Valencina de la Concepción,6127,3088,3039
41,9022,Villafranco del Guadalquivir,6053,3032,3021
41,975,Villamanrique de la Condesa,3777,1871,1906
41,1008,Villanueva de San Juan,1571,779,792
41,981,Villanueva del Ariscal,4472,2172,2300
41,994,Villanueva del Río y Minas,5549,2675,2874
41,1015,Villaverde del Río,6633,3378,3255
41,1020,Viso del Alcor (El),15918,8063,7855
42,11,Abejar,358,190,168
42,32,Adradas,100,53,47
42,47,Ágreda,3399,1673,1726
42,63,Alconaba,174,100,74
42,79,Alcubilla de Avellaneda,229,116,113
42,85,Alcubilla de las Peñas,92,47,45
42,98,Aldealafuente,155,77,78
42,102,Aldealices,31,15,16
42,119,Aldealpozo,31,14,17
42,124,Aldealseñor,49,30,19
42,130,Aldehuela de Periáñez,26,17,9
42,145,Aldehuelas (Las),121,68,53
42,158,Alentisque,43,19,24
42,161,Aliud,43,20,23
42,177,Almajano,187,94,93
42,183,Almaluez,317,165,152
42,196,Almarza,632,342,290
42,200,Almazán,5871,2915,2956
42,217,Almazul,170,87,83
42,222,Almenar de Soria,393,204,189
42,238,Alpanseque,113,59,54
42,243,Arancón,112,61,51
42,256,Arcos de Jalón,1964,979,985
42,269,Arenillas,47,25,22
42,275,Arévalo de la Sierra,108,58,50
42,281,Ausejo de la Sierra,53,26,27
42,294,Baraona,246,133,113
42,308,Barca,147,85,62
42,315,Barcones,50,26,24
42,320,Bayubas de Abajo,285,151,134
42,336,Bayubas de Arriba,91,45,46
42,341,Beratón,36,29,7
42,354,Berlanga de Duero,1169,598,571
42,367,Blacos,65,37,28
42,373,Bliecos,55,31,24
42,389,Borjabad,64,34,30
42,392,Borobia,388,190,198
42,413,Buberos,50,23,27
42,428,Buitrago,49,24,25
42,434,Burgo de Osma-Ciudad de Osma,5042,2487,2555
42,449,Cabrejas del Campo,92,52,40
42,452,Cabrejas del Pinar,488,260,228
42,465,Calatañazor,75,43,32
42,487,Caltojar,137,74,63
42,490,Candilichera,226,111,115
42,503,Cañamaque,44,26,18
42,510,Carabantes,40,21,19
42,525,Caracena,22,15,7
42,531,Carrascosa de Abajo,44,22,22
42,546,Carrascosa de la Sierra,15,8,7
42,559,Casarejos,268,134,134
42,562,Castilfrío de la Sierra,32,20,12
42,584,Castillejo de Robledo,211,112,99
42,578,Castilruiz,337,169,168
42,597,Centenera de Andaluz,32,11,21
42,601,Cerbón,53,29,24
42,618,Cidones,336,184,152
42,623,Cigudosa,79,47,32
42,639,Cihuela,103,48,55
42,644,Ciria,100,46,54
42,657,Cirujales del Río,44,23,21
42,682,Coscurita,153,86,67
42,695,Covaleda,2051,1051,1000
42,709,Cubilla,80,41,39
42,716,Cubo de la Solana,261,143,118
42,737,Cueva de Ágreda,106,56,50
42,755,Dévanos,141,74,67
42,768,Deza,394,197,197
42,780,Duruelo de la Sierra,1473,740,733
42,793,Escobosa de Almazán,43,24,19
42,807,Espeja de San Marcelino,262,146,116
42,814,Espejón,234,118,116
42,829,Estepa de San Juan,15,8,7
42,835,Frechilla de Almazán,51,27,24
42,840,Fresno de Caracena,54,30,24
42,853,Fuentearmegil,366,195,171
42,866,Fuentecambrón,82,44,38
42,872,Fuentecantos,52,25,27
42,888,Fuentelmonge,145,74,71
42,891,Fuentelsaz de Soria,59,23,36
42,905,Fuentepinilla,164,88,76
42,927,Fuentes de Magaña,102,49,53
42,933,Fuentestrún,76,43,33
42,948,Garray,362,186,176
42,951,Golmayo,588,328,260
42,964,Gómara,518,260,258
42,970,Gormaz,22,11,11
42,986,Herrera de Soria,28,17,11
42,1003,Hinojosa del Campo,56,34,22
42,1031,Langa de Duero,949,511,438
42,1059,Liceras,66,34,32
42,1062,Losilla (La),21,13,8
42,1078,Magaña,100,52,48
42,1084,Maján,18,9,9
42,1101,Matalebreras,126,62,64
42,1118,Matamala de Almazán,426,214,212
42,1139,Medinaceli,729,366,363
42,1157,Miño de Medinaceli,121,57,64
42,1160,Miño de San Esteban,97,55,42
42,1176,Molinos de Duero,193,102,91
42,1182,Momblona,43,25,18
42,1195,Monteagudo de las Vicarías,309,151,158
42,1209,Montejo de Tiermes,251,144,107
42,1216,Montenegro de Cameros,118,64,54
42,1237,Morón de Almazán,287,134,153
42,1242,Muriel de la Fuente,81,50,31
42,1255,Muriel Viejo,86,43,43
42,1274,Nafría de Ucero,90,47,43
42,1280,Narros,56,28,28
42,1293,Navaleno,945,474,471
42,1307,Nepas,86,52,34
42,1314,Nolay,96,50,46
42,1329,Noviercas,254,120,134
42,1340,Ólvega,3283,1699,1584
42,1353,Oncala,107,62,45
42,1391,Pinilla del Campo,26,15,11
42,1405,Portillo de Soria,23,12,11
42,1412,Póveda de Soria (La),121,64,57
42,1427,Pozalmuro,99,48,51
42,1448,Quintana Redonda,573,303,270
42,1451,Quintanas de Gormaz,197,100,97
42,1486,Quiñonería,15,5,10
42,1499,Rábanos (Los),408,241,167
42,1519,Rebollar,49,27,22
42,1524,Recuerda,113,57,56
42,1530,Rello,42,20,22
42,1545,Renieblas,122,62,60
42,1558,Retortillo de Soria,258,137,121
42,1561,Reznos,51,28,23
42,1577,Riba de Escalote (La),33,20,13
42,1583,Rioseco de Soria,147,74,73
42,1596,Rollamienta,49,28,21
42,1600,Royo (El),365,176,189
42,1617,Salduero,191,102,89
42,1622,San Esteban de Gormaz,3361,1716,1645
42,1638,San Felices,79,40,39
42,1643,San Leonardo de Yagüe,2093,1068,1025
42,1656,San Pedro Manrique,475,251,224
42,1669,Santa Cruz de Yanguas,56,33,23
42,1675,Santa María de Huerta,471,239,232
42,1681,Santa María de las Hoyas,210,110,100
42,1715,Serón de Nágima,284,153,131
42,1720,Soliedra,46,28,18
42,1736,Soria,33882,16132,17750
42,1741,Sotillo del Rincón,212,105,107
42,1754,Suellacabras,41,24,17
42,1767,Tajahuerce,48,23,25
42,1773,Tajueco,130,68,62
42,1789,Talveila,211,110,101
42,1813,Tardelcuende,674,333,341
42,1828,Taroda,82,41,41
42,1834,Tejado,230,113,117
42,1849,Torlengua,114,58,56
42,1852,Torreblacos,40,20,20
42,1871,Torrubia de Soria,101,56,45
42,1887,Trévago,79,32,47
42,1890,Ucero,112,55,57
42,1904,Vadillo,154,81,73
42,1911,Valdeavellano de Tera,251,125,126
42,1926,Valdegeña,52,28,24
42,1932,Valdelagua del Cerro,31,16,15
42,1947,Valdemaluque,304,149,155
42,1950,Valdenebro,161,85,76
42,1963,Valdeprado,17,8,9
42,1979,Valderrodilla,131,66,65
42,1985,Valtajeros,28,15,13
42,2002,Velamazán,150,86,64
42,2019,Velilla de la Sierra,25,11,14
42,2024,Velilla de los Ajos,44,27,17
42,2045,Viana de Duero,79,46,33
42,2058,Villaciervos,102,59,43
42,2061,Villanueva de Gormaz,19,12,7
42,2077,Villar del Ala,58,27,31
42,2083,Villar del Campo,39,19,20
42,2096,Villar del Río,186,93,93
42,2117,Villares de Soria (Los),125,61,64
42,2122,Villasayas,106,64,42
42,2138,Villaseca de Arciel,46,26,20
42,2156,Vinuesa,1092,577,515
42,2169,Vizmanos,46,31,15
42,2175,Vozmediano,51,27,24
42,2181,Yanguas,107,52,55
42,2194,Yelo,67,34,33
43,17,Aiguamúrcia,627,313,314
43,22,Albinyana,1184,603,581
43,38,Albiol (L'),144,73,71
43,43,Alcanar,7711,3812,3899
43,56,Alcover,3664,1861,1803
43,9044,Aldea (L'),3533,1792,1741
43,69,Aldover,795,376,419
43,75,Aleixar (L'),685,337,348
43,81,Alfara de Carles,382,201,181
43,94,Alforja,1179,605,574
43,108,Alió,355,180,175
43,115,Almoster,716,362,354
43,120,Altafulla,2778,1419,1359
43,136,Ametlla de Mar (L'),4537,2263,2274
43,9060,Ampolla (L'),1701,840,861
43,141,Amposta,15951,7896,8055
43,167,Arboç (L'),3427,1772,1655
43,154,Arbolí,131,65,66
43,173,Argentera (L'),139,77,62
43,189,Arnes,511,266,245
43,192,Ascó,1711,863,848
43,206,Banyeres del Penedès,1595,826,769
43,213,Barberà de la Conca,394,198,196
43,228,Batea,1973,997,976
43,234,Bellmunt del Priorat,307,151,156
43,249,Bellvei,1273,673,600
43,252,Benifallet,886,447,439
43,265,Benissanet,1016,519,497
43,271,Bisbal de Falset (La),245,121,124
43,287,Bisbal del Penedès (La),1747,909,838
43,290,Blancafort,390,198,192
43,304,Bonastre,328,162,166
43,311,Borges del Camp (Les),1476,749,727
43,326,Bot,858,434,424
43,332,Botarell,530,264,266
43,347,Bràfim,567,276,291
43,350,Cabacés,337,177,160
43,363,Cabra del Camp,508,275,233
43,379,Calafell,10576,5338,5238
43,9039,Camarles,2944,1463,1481
43,385,Cambrils,18385,9114,9271
43,398,Capafonts,118,61,57
43,402,Capçanes,411,190,221
43,419,Caseres,326,160,166
43,424,Castellvell del Camp,1088,554,534
43,430,Catllar (El),1945,1019,926
43,458,Colldejou,193,105,88
43,461,Conesa,107,56,51
43,477,Constantí,5135,2672,2463
43,483,Corbera d'Ebre,1070,557,513
43,496,Cornudella de Montsant,865,437,428
43,509,Creixell,1565,788,777
43,516,Cunit,4849,2506,2343
43,9018,Deltebre,10164,5088,5076
43,537,Duesaigües,214,131,83
43,542,Espluga de Francolí (L'),3665,1797,1868
43,555,Falset,2461,1236,1225
43,568,Fatarella (La),1276,636,640
43,574,Febró (La),56,32,24
43,580,Figuera (La),119,60,59
43,593,Figuerola del Camp,263,132,131
43,607,Flix,4316,2158,2158
43,614,Forès,67,32,35
43,629,Freginals,347,176,171
43,635,Galera (La),734,366,368
43,640,Gandesa,2646,1319,1327
43,653,Garcia,533,268,265
43,666,Garidells (Els),154,75,79
43,672,Ginestar,829,423,406
43,688,Godall,732,371,361
43,691,Gratallops,218,114,104
43,705,Guiamets (Els),298,147,151
43,712,Horta de Sant Joan,1245,664,581
43,727,Lloar (El),129,68,61
43,733,Llorac,119,57,62
43,748,Llorenç del Penedès,1460,708,752
43,764,Marçà,610,293,317
43,751,Margalef,131,69,62
43,770,Mas de Barberans,711,364,347
43,786,Masdenverge,927,472,455
43,799,Masllorenç,421,209,212
43,803,Masó (La),256,120,136
43,810,Maspujols,451,229,222
43,825,Masroig (El),524,254,270
43,831,Milà (El),147,70,77
43,846,Miravet,806,416,390
43,859,Molar (El),277,146,131
43,918,Mont-ral,137,74,63
43,923,Mont-roig del Camp,6197,3147,3050
43,862,Montblanc,5901,2936,2965
43,884,Montbrió del Camp,1424,709,715
43,897,Montferri,158,83,75
43,901,Montmell (El),404,221,183
43,939,Móra d'Ebre,4832,2403,2429
43,944,Móra la Nova,2703,1342,1361
43,957,Morell (El),2293,1145,1148
43,960,Morera de Montsant (La),169,93,76
43,976,Nou de Gaià (La),367,177,190
43,982,Nulles,340,157,183
43,1009,Pallaresos (Els),2287,1187,1100
43,995,Palma d'Ebre (La),418,200,218
43,1016,Passanant,182,107,75
43,1021,Paüls,640,329,311
43,1037,Perafort,537,274,263
43,1042,Perelló (El),2145,1086,1059
43,1055,Piles (Les),168,95,73
43,1068,Pinell de Brai (El),1081,552,529
43,1074,Pira,387,189,198
43,1080,Pla de Santa Maria (El),1603,829,774
43,1093,Pobla de Mafumet (La),1068,530,538
43,1107,Pobla de Massaluca (La),436,224,212
43,1114,Pobla de Montornès (La),1204,640,564
43,1129,Poboleda,335,172,163
43,1135,Pont d'Armentera (El),564,278,286
43,1418,Pontils,137,69,68
43,1140,Porrera,431,226,205
43,1153,Pradell de la Teixeta,219,116,103
43,1166,Prades,519,262,257
43,1172,Prat de Comte,190,89,101
43,1188,Pratdip,491,240,251
43,1191,Puigpelat,539,274,265
43,1205,Querol,249,140,109
43,1212,Rasquera,805,411,394
43,1227,Renau,55,28,27
43,1233,Reus,89034,43545,45489
43,1251,Riba-roja d'Ebre,1425,740,685
43,1248,Riba (La),785,406,379
43,1264,Riera de Gaià (La),877,439,438
43,1270,Riudecanyes,653,327,326
43,1286,Riudecols,1004,516,488
43,1299,Riudoms,5068,2549,2519
43,1303,Rocafort de Queralt,272,146,126
43,1310,Roda de Barà,2978,1625,1353
43,1325,Rodonyà,396,205,191
43,1331,Roquetes,6215,3092,3123
43,1346,Rourell (El),252,135,117
43,1359,Salomó,383,192,191
43,9057,Salou,11499,5816,5683
43,1362,Sant Carles de la Ràpita,10976,5442,5534
43,1378,Sant Jaume dels Domenys,1359,699,660
43,9023,Sant Jaume d'Enveja,3323,1672,1651
43,1384,Santa Bàrbara,3226,1607,1619
43,1397,Santa Coloma de Queralt,2568,1238,1330
43,1401,Santa Oliva,1972,996,976
43,1423,Sarral,1403,723,680
43,1439,Savallà del Comtat,73,36,37
43,1444,Secuita (La),1091,543,548
43,1457,Selva del Camp (La),3949,1987,1962
43,1460,Senan,31,19,12
43,445,Sénia (La),5029,2545,2484
43,1476,Solivella,631,304,327
43,1482,Tarragona,112795,55158,57637
43,1495,Tivenys,936,464,472
43,1508,Tivissa,1763,870,893
43,1515,Torre de Fontaubella (La),102,46,56
43,1520,Torre de l'Espanyol (La),663,345,318
43,1536,Torredembarra,9554,4721,4833
43,1541,Torroja del Priorat,130,75,55
43,1554,Tortosa,29600,14339,15261
43,1567,Ulldecona,5208,2575,2633
43,1573,Ulldemolins,499,259,240
43,1589,Vallclara,105,53,52
43,1592,Vallfogona de Riucorb,132,71,61
43,1606,Vallmoll,1058,543,515
43,1613,Valls,20098,9842,10256
43,1628,Vandellòs i l'Hospitalet de l'Infant,4270,2149,2121
43,1634,Vendrell (El),20002,9992,10010
43,1649,Vespella de Gaià,172,97,75
43,1704,Vila-rodona,1008,537,471
43,1711,Vila-seca,12498,6285,6213
43,1652,Vilabella,818,406,412
43,1750,Vilalba dels Arcs,774,412,362
43,1665,Vilallonga del Camp,1205,605,600
43,1687,Vilanova de Prades,143,77,66
43,1671,Vilanova d'Escornalbou,463,230,233
43,1690,Vilaplana,527,272,255
43,1726,Vilaverd,360,182,178
43,1732,Vilella Alta (La),130,68,62
43,1747,Vilella Baixa (La),172,91,81
43,1763,Vimbodí,1023,527,496
43,1779,Vinebre,445,218,227
43,1785,Vinyols i els Arcs,1113,580,533
43,521,Xerta,1218,600,618
44,12,Ababuj,86,48,38
44,27,Abejuela,61,37,24
44,33,Aguatón,26,10,16
44,48,Aguaviva,622,309,313
44,51,Aguilar del Alfambra,84,42,42
44,64,Alacón,470,244,226
44,70,Alba,286,145,141
44,86,Albalate del Arzobispo,2379,1170,1209
44,99,Albarracín,1041,535,506
44,103,Albentosa,272,135,137
44,110,Alcaine,56,31,25
44,125,Alcalá de la Selva,453,235,218
44,131,Alcañiz,12823,6330,6493
44,146,Alcorisa,3296,1650,1646
44,162,Alfambra,682,348,334
44,178,Aliaga,422,224,198
44,218,Allepuz,144,73,71
44,223,Alloza,817,394,423
44,239,Allueva,14,9,5
44,184,Almohaja,31,20,11
44,197,Alobras,94,53,41
44,201,Alpeñés,31,18,13
44,244,Anadón,19,10,9
44,257,Andorra,8174,4228,3946
44,260,Arcos de las Salinas,163,82,81
44,276,Arens de Lledó,240,113,127
44,282,Argente,269,141,128
44,295,Ariño,916,453,463
44,316,Azaila,184,99,85
44,321,Bádenas,25,12,13
44,337,Báguena,524,266,258
44,342,Bañón,180,96,84
44,355,Barrachina,170,87,83
44,368,Bea,46,25,21
44,374,Beceite,654,332,322
44,393,Bello,408,188,220
44,380,Belmonte de San José,159,85,74
44,407,Berge,223,117,106
44,414,Bezas,69,35,34
44,429,Blancas,196,104,92
44,435,Blesa,156,93,63
44,440,Bordón,145,79,66
44,453,Bronchales,441,237,204
44,466,Bueña,107,61,46
44,472,Burbáguena,332,156,176
44,488,Cabra de Mora,106,60,46
44,491,Calaceite,1232,620,612
44,504,Calamocha,4016,1997,2019
44,511,Calanda,3531,1781,1750
44,526,Calomarde,87,41,46
44,532,Camañas,142,81,61
44,547,Camarena de la Sierra,171,91,80
44,550,Camarillas,124,69,55
44,563,Caminreal,817,405,412
44,598,Cantavieja,726,379,347
44,602,Cañada de Benatanduz,65,41,24
44,619,Cañada de Verich (La),110,61,49
44,624,Cañada Vellida,61,40,21
44,630,Cañizar del Olivar,128,67,61
44,645,Cascante del Río,128,80,48
44,658,Castejón de Tornos,109,58,51
44,661,Castel de Cabra,183,97,86
44,700,Castellar (El),105,55,50
44,717,Castellote,744,379,365
44,677,Castelnou,104,55,49
44,683,Castelserás,870,461,409
44,743,Cedrillas,544,282,262
44,756,Celadas,422,227,195
44,769,Cella,2953,1513,1440
44,775,Cerollera (La),84,45,39
44,808,Codoñera (La),352,180,172
44,820,Corbalán,70,41,29
44,841,Cortes de Aragón,134,68,66
44,854,Cosa,106,58,48
44,867,Cretas,631,321,310
44,873,Crivillén,133,70,63
44,889,Cuba (La),66,33,33
44,892,Cubla,56,29,27
44,906,Cucalón,80,45,35
44,928,Cuervo (El),131,68,63
44,934,Cuevas de Almudén,106,59,47
44,949,Cuevas Labradas,173,94,79
44,965,Ejulve,224,114,110
44,971,Escorihuela,236,118,118
44,990,Escucha,1146,611,535
44,1004,Estercuel,373,187,186
44,1011,Ferreruela de Huerva,84,46,38
44,1026,Fonfría,33,19,14
44,1032,Formiche Alto,196,108,88
44,1050,Fórnoles,101,46,55
44,1063,Fortanete,195,98,97
44,1079,Foz-Calanda,240,131,109
44,1085,Fresneda (La),418,213,205
44,1098,Frías de Albarracín,179,94,85
44,1102,Fuenferrada,50,27,23
44,1119,Fuentes Calientes,142,80,62
44,1124,Fuentes Claras,665,332,333
44,1130,Fuentes de Rubielos,86,44,42
44,1145,Fuentespalda,365,183,182
44,1158,Galve,142,75,67
44,1161,Gargallo,131,72,59
44,1177,Gea de Albarracín,473,242,231
44,1183,Ginebrosa (La),262,146,116
44,1196,Griegos,143,84,59
44,1200,Guadalaviar,288,145,143
44,1217,Gúdar,76,46,30
44,1222,Híjar,1949,976,973
44,1238,Hinojosa de Jarque,183,97,86
44,1243,Hoz de la Vieja (La),139,73,66
44,1256,Huesa del Común,136,78,58
44,1269,Iglesuela del Cid (La),486,251,235
44,1275,Jabaloyas,94,50,44
44,1281,Jarque de la Val,102,56,46
44,1294,Jatiel,70,35,35
44,1308,Jorcas,52,34,18
44,1315,Josa,45,25,20
44,1320,Lagueruela,70,37,33
44,1336,Lanzuela,30,19,11
44,1354,Libros,166,86,80
44,1367,Lidón,83,39,44
44,1373,Linares de Mora,307,171,136
44,1413,Lledó,210,112,98
44,1389,Loscos,214,113,101
44,1428,Maicas,25,13,12
44,1434,Manzanera,481,261,220
44,1449,Martín del Río,491,250,241
44,1452,Mas de las Matas,1478,750,728
44,1465,Mata de los Olmos (La),276,131,145
44,1471,Mazaleón,600,309,291
44,1487,Mezquita de Jarque,143,75,68
44,1490,Mirambel,146,82,64
44,1503,Miravete de la Sierra,51,30,21
44,1510,Molinos,342,175,167
44,1525,Monforte de Moyuela,84,49,35
44,1531,Monreal del Campo,2301,1144,1157
44,1546,Monroyo,381,204,177
44,1559,Montalbán,1594,809,785
44,1562,Monteagudo del Castillo,69,40,29
44,1578,Monterde de Albarracín,74,35,39
44,1584,Mora de Rubielos,1378,715,663
44,1597,Moscardón,56,30,26
44,1601,Mosqueruela,695,368,327
44,1618,Muniesa,745,385,360
44,1639,Noguera de Albarracín,185,93,92
44,1644,Nogueras,22,16,6
44,1657,Nogueruelas,211,113,98
44,1676,Obón,54,27,27
44,1682,Odón,265,124,141
44,1695,Ojos Negros,587,305,282
44,1716,Olba,198,101,97
44,1721,Oliete,490,249,241
44,1737,Olmos (Los),152,84,68
44,1742,Orihuela del Tremedal,612,306,306
44,1755,Orrios,194,103,91
44,1768,Palomar de Arroyos,264,151,113
44,1774,Pancrudo,183,99,84
44,1780,Parras de Castellote (Las),94,50,44
44,1793,Peñarroya de Tastavins,538,275,263
44,1807,Peracense,117,63,54
44,1814,Peralejos,96,50,46
44,1829,Perales del Alfambra,299,163,136
44,1835,Pitarque,113,55,58
44,1840,Plou,52,28,24
44,1853,Pobo (El),156,85,71
44,1872,Portellada (La),328,171,157
44,1891,Pozondón,85,44,41
44,1905,Pozuel del Campo,113,61,52
44,1912,Puebla de Híjar (La),1117,550,567
44,1927,Puebla de Valverde (La),488,254,234
44,1933,Puertomingalvo,139,74,65
44,1948,Ráfales,211,105,106
44,1951,Rillo,144,78,66
44,1964,Riodeva,228,111,117
44,1970,Ródenas,93,44,49
44,1986,Royuela,241,140,101
44,1999,Rubiales,61,34,27
44,2003,Rubielos de la Cérida,60,29,31
44,2010,Rubielos de Mora,617,311,306
44,2031,Salcedillo,8,4,4
44,2046,Saldón,43,25,18
44,2059,Samper de Calanda,1002,477,525
44,2062,San Agustín,157,82,75
44,2078,San Martín del Río,307,147,160
44,2084,Santa Cruz de Nogueras,28,17,11
44,2097,Santa Eulalia,1241,601,640
44,2101,Sarrión,1025,540,485
44,2118,Segura de los Baños,52,27,25
44,2123,Seno,53,26,27
44,2139,Singra,99,51,48
44,2157,Terriente,176,102,74
44,2160,Teruel,29320,14134,15186
44,2176,Toril y Masegoso,36,20,16
44,2182,Tormón,41,21,20
44,2195,Tornos,257,138,119
44,2209,Torralba de los Sisones,221,112,109
44,2237,Torre de Arcas,111,53,58
44,2242,Torre de las Arcas,38,22,16
44,2255,Torre del Compte,179,85,94
44,2274,Torre los Negros,95,47,48
44,2216,Torrecilla de Alcañiz,441,230,211
44,2221,Torrecilla del Rebollar,182,98,84
44,2268,Torrelacárcel,304,157,147
44,2280,Torremocha de Jiloca,171,82,89
44,2293,Torres de Albarracín,159,81,78
44,2307,Torrevelilla,205,101,104
44,2314,Torrijas,80,38,42
44,2329,Torrijo del Campo,576,293,283
44,2340,Tramacastiel,116,57,59
44,2353,Tramacastilla,135,63,72
44,2366,Tronchón,97,51,46
44,2372,Urrea de Gaén,628,309,319
44,2388,Utrillas,3329,1711,1618
44,2391,Valacloche,22,13,9
44,2405,Valbona,184,99,85
44,2412,Valdealgorfa,753,371,382
44,2433,Valdecuenca,38,21,17
44,2448,Valdelinares,129,72,57
44,2451,Valdeltormo,384,199,185
44,2464,Valderrobres,1914,985,929
44,2470,Valjunquera,443,225,218
44,2499,Vallecillo (El),43,26,17
44,2502,Veguillas de la Sierra,27,16,11
44,2519,Villafranca del Campo,407,205,202
44,2524,Villahermosa del Campo,69,40,29
44,2561,Villanueva del Rebollar de la Sierra,51,29,22
44,2577,Villar del Cobo,231,115,116
44,2583,Villar del Salz,112,60,52
44,2600,Villarluengo,205,114,91
44,2617,Villarquemado,1003,502,501
44,2622,Villarroya de los Pinares,203,100,103
44,2638,Villastar,346,185,161
44,2643,Villel,329,169,160
44,2656,Vinaceite,304,158,146
44,2669,Visiedo,212,95,117
44,2675,Vivel del Río Martín,95,52,43
44,2681,Zoma (La),33,18,15
45,15,Ajofrín,2155,1114,1041
45,20,Alameda de la Sagra,2823,1483,1340
45,36,Albarreal de Tajo,605,299,306
45,41,Alcabón,609,312,297
45,54,Alcañizo,332,174,158
45,67,Alcaudete de la Jara,1893,886,1007
45,73,Alcolea de Tajo,798,396,402
45,89,Aldea en Cabo,183,97,86
45,92,Aldeanueva de Barbarroya,837,426,411
45,106,Aldeanueva de San Bartolomé,623,308,315
45,113,Almendral de la Cañada,405,211,194
45,128,Almonacid de Toledo,785,405,380
45,134,Almorox,2199,1129,1070
45,149,Añover de Tajo,4608,2408,2200
45,152,Arcicóllar,589,287,302
45,165,Argés,2266,1116,1150
45,171,Azután,372,190,182
45,187,Barcience,113,57,56
45,190,Bargas,6639,3299,3340
45,204,Belvís de la Jara,1751,845,906
45,211,Borox,2163,1077,1086
45,226,Buenaventura,548,264,284
45,232,Burguillos de Toledo,848,429,419
45,247,Burujón,1268,654,614
45,250,Cabañas de la Sagra,1212,625,587
45,263,Cabañas de Yepes,258,133,125
45,279,Cabezamesada,503,259,244
45,285,Calera y Chozas,3767,1892,1875
45,298,Caleruela,321,166,155
45,302,Calzada de Oropesa,621,309,312
45,319,Camarena,2215,1121,1094
45,324,Camarenilla,525,263,262
45,330,Campillo de la Jara (El),545,292,253
45,345,Camuñas,1745,882,863
45,358,Cardiel de los Montes,135,74,61
45,361,Carmena,820,416,404
45,377,Carpio de Tajo (El),2320,1134,1186
45,383,Carranque,1434,735,699
45,396,Carriches,296,145,151
45,400,Casar de Escalona (El),909,447,462
45,417,Casarrubios del Monte,2671,1374,1297
45,422,Casasbuenas,229,114,115
45,438,Castillo de Bayuela,1001,501,500
45,456,Cazalegas,1161,583,578
45,469,Cebolla,2789,1384,1405
45,475,Cedillo del Condado,1227,603,624
45,481,Cerralbos (Los),457,227,230
45,494,Cervera de los Montes,406,210,196
45,566,Chozas de Canales,1023,513,510
45,572,Chueca,271,139,132
45,507,Ciruelos,328,180,148
45,514,Cobeja,1746,872,874
45,529,Cobisa,1185,613,572
45,535,Consuegra,10081,5000,5081
45,540,Corral de Almaguer,5744,2877,2867
45,553,Cuerva,1276,627,649
45,588,Domingo Pérez,509,247,262
45,591,Dosbarrios,2069,1036,1033
45,605,Erustes,198,104,94
45,612,Escalona,2072,1053,1019
45,627,Escalonilla,1452,706,746
45,633,Espinoso del Rey,645,333,312
45,648,Esquivias,3800,1910,1890
45,651,Estrella (La),433,228,205
45,664,Fuensalida,7594,3826,3768
45,670,Gálvez,3086,1561,1525
45,686,Garciotum,158,73,85
45,699,Gerindote,1835,934,901
45,703,Guadamur,1593,820,773
45,710,Guardia (La),2423,1199,1224
45,725,Herencias (Las),728,374,354
45,731,Herreruela de Oropesa,435,209,226
45,746,Hinojosa de San Vicente,482,265,217
45,759,Hontanar,105,58,47
45,762,Hormigos,395,193,202
45,778,Huecas,416,215,201
45,784,Huerta de Valdecarábanos,1683,829,854
45,797,Iglesuela (La),459,228,231
45,801,Illán de Vacas,4,3,1
45,818,Illescas,9930,4977,4953
45,823,Lagartera,1891,922,969
45,839,Layos,277,137,140
45,844,Lillo,2885,1443,1442
45,857,Lominchar,1116,579,537
45,860,Lucillos,512,251,261
45,876,Madridejos,10461,5153,5308
45,882,Magán,1122,562,560
45,895,Malpica de Tajo,1827,928,899
45,909,Manzaneque,453,227,226
45,916,Maqueda,496,247,249
45,921,Marjaliza,328,161,167
45,937,Marrupe,124,62,62
45,942,Mascaraque,493,232,261
45,955,Mata (La),988,486,502
45,968,Mazarambroz,1210,600,610
45,974,Mejorada,1091,550,541
45,980,Menasalbas,2978,1556,1422
45,993,Méntrida,1984,993,991
45,1007,Mesegar de Tajo,236,117,119
45,1014,Miguel Esteban,4684,2328,2356
45,1029,Mocejón,4124,2101,2023
45,1035,Mohedas de la Jara,633,324,309
45,1040,Montearagón,449,233,216
45,1053,Montesclaros,465,232,233
45,1066,Mora,9339,4596,4743
45,1072,Nambroca,2508,1259,1249
45,1088,Nava de Ricomalillo (La),742,375,367
45,1091,Navahermosa,3893,1993,1900
45,1105,Navalcán,2362,1240,1122
45,1112,Navalmoralejo,85,38,47
45,1127,Navalmorales (Los),2669,1332,1337
45,1133,Navalucillos (Los),2776,1395,1381
45,1148,Navamorcuende,735,381,354
45,1151,Noblejas,3010,1526,1484
45,1164,Noez,818,414,404
45,1170,Nombela,955,495,460
45,1186,Novés,1560,794,766
45,1199,Numancia de la Sagra,2222,1153,1069
45,1203,Nuño Gómez,176,88,88
45,1210,Ocaña,6103,3018,3085
45,1225,Olías del Rey,4125,2066,2059
45,1231,Ontígola,1175,636,539
45,1246,Orgaz,2664,1336,1328
45,1259,Oropesa,2736,1361,1375
45,1262,Otero,213,103,110
45,1278,Palomeque,485,254,231
45,1284,Pantoja,2344,1200,1144
45,1297,Paredes de Escalona,111,57,54
45,1301,Parrillas,441,217,224
45,1318,Pelahustán,374,195,179
45,1323,Pepino,821,421,400
45,1339,Polán,3294,1676,1618
45,1344,Portillo de Toledo,1942,998,944
45,1357,Puebla de Almoradiel (La),5374,2696,2678
45,1360,Puebla de Montalbán (La),6988,3489,3499
45,1376,Pueblanueva (La),2007,1021,986
45,1382,Puente del Arzobispo (El),1582,758,824
45,1395,Puerto de San Vicente,288,140,148
45,1409,Pulgar,1235,628,607
45,1416,Quero,1353,679,674
45,1421,Quintanar de la Orden,9389,4659,4730
45,1437,Quismondo,1313,656,657
45,1442,Real de San Vicente (El),1006,514,492
45,1455,Recas,2580,1345,1235
45,1468,Retamoso,174,93,81
45,1474,Rielves,493,250,243
45,1480,Robledo del Mazo,518,272,246
45,1493,Romeral (El),913,453,460
45,1506,San Bartolomé de las Abiertas,493,262,231
45,1513,San Martín de Montalbán,741,363,378
45,1528,San Martín de Pusa,797,399,398
45,1534,San Pablo de los Montes,2098,1053,1045
45,1549,San Román de los Montes,685,357,328
45,1552,Santa Ana de Pusa,399,209,190
45,1565,Santa Cruz de la Zarza,4440,2229,2211
45,1571,Santa Cruz del Retamar,1616,819,797
45,1587,Santa Olalla,2478,1261,1217
45,9016,Santo Domingo-Caudilla,791,389,402
45,1590,Sartajada,103,63,40
45,1604,Segurilla,918,463,455
45,1611,Seseña,3866,2018,1848
45,1626,Sevilleja de la Jara,1075,565,510
45,1632,Sonseca,9261,4664,4597
45,1647,Sotillo de las Palomas,226,117,109
45,1650,Talavera de la Reina,72208,35254,36954
45,1663,Tembleque,2115,1068,1047
45,1679,Toboso (El),2062,1008,1054
45,1685,Toledo,66989,32233,34756
45,1698,Torralba de Oropesa,282,135,147
45,1719,Torre de Esteban Hambrán (La),1467,754,713
45,1702,Torrecilla de la Jara,286,147,139
45,1724,Torrico,914,465,449
45,1730,Torrijos,9975,4898,5077
45,1745,Totanés,359,186,173
45,1758,Turleque,1000,501,499
45,1761,Ugena,1204,642,562
45,1777,Urda,2996,1493,1503
45,1796,Valdeverdeja,821,376,445
45,1800,Valmojado,2355,1208,1147
45,1817,Velada,2366,1223,1143
45,1822,Ventas con Peña Aguilera (Las),1411,723,688
45,1838,Ventas de Retamosa (Las),752,389,363
45,1843,Ventas de San Julián (Las),235,107,128
45,1869,Villa de Don Fadrique (La),4153,2055,2098
45,1856,Villacañas,9352,4628,4724
45,1875,Villafranca de los Caballeros,5286,2616,2670
45,1881,Villaluenga de la Sagra,2629,1318,1311
45,1894,Villamiel de Toledo,466,230,236
45,1908,Villaminaya,656,328,328
45,1915,Villamuelas,750,370,380
45,1920,Villanueva de Alcardete,3301,1657,1644
45,1936,Villanueva de Bogas,849,421,428
45,1941,Villarejo de Montalbán,97,49,48
45,1954,Villarrubia de Santiago,2901,1443,1458
45,1967,Villaseca de la Sagra,1598,804,794
45,1973,Villasequilla,2357,1223,1134
45,1989,Villatobas,2267,1142,1125
45,1992,Viso de San Juan (El),1065,563,502
45,2006,Yébenes (Los),6313,3149,3164
45,2013,Yeles,1606,847,759
45,2028,Yepes,4381,2220,2161
45,2034,Yuncler,1990,1004,986
45,2049,Yunclillos,587,298,289
45,2052,Yuncos,3421,1772,1649
46,18,Ademuz,1199,601,598
46,23,Ador,1125,570,555
46,44,Agullent,2204,1064,1140
46,425,Aielo de Malferit,3953,1949,2004
46,57,Alaquàs,25925,12869,13056
46,60,Albaida,5782,2844,2938
46,76,Albal,11239,5586,5653
46,82,Albalat de la Ribera,3492,1696,1796
46,95,Albalat dels Sorells,3516,1706,1810
46,109,Albalat dels Tarongers,664,348,316
46,116,Alberic,9131,4479,4652
46,121,Alborache,897,456,441
46,137,Alboraya,14628,7245,7383
46,142,Albuixech,3049,1495,1554
46,155,Alcácer,7375,3722,3653
46,168,Alcàntera de Xúquer,1459,720,739
46,180,Alcublas,857,460,397
46,193,Alcúdia (l'),10455,5155,5300
46,207,Alcúdia de Crespins (l'),4126,2038,2088
46,214,Aldaia,24094,12088,12006
46,229,Alfafar,19430,9573,9857
46,240,Alfara de Algimia,499,247,252
46,253,Alfara del Patriarca,2726,1334,1392
46,266,Alfarp,1303,636,667
46,272,Alfarrasí,1225,594,631
46,235,Alfauir,356,184,172
46,288,Algar de Palancia,416,206,210
46,291,Algemesí,24894,12283,12611
46,305,Algimia de Alfara,819,409,410
46,312,Alginet,12062,6009,6053
46,327,Almàssera,5523,2664,2859
46,333,Almiserà,240,114,126
46,348,Almoines,1725,854,871
46,351,Almussafes,7030,3519,3511
46,364,Alpuente,958,492,466
46,370,Alquería de la Condesa/Alqueria de la Comtessa (l'),1457,688,769
46,174,Alzira,40390,19709,20681
46,386,Andilla,311,173,138
46,399,Anna,2574,1293,1281
46,403,Antella,1533,763,770
46,410,Aras de Alpuente,397,222,175
46,39,Atzeneta d'Albaida,1232,629,603
46,431,Ayelo de Rugat,193,101,92
46,446,Ayora,5501,2814,2687
46,462,Barx,1180,570,610
46,459,Barxeta,1612,814,798
46,478,Bèlgida,674,325,349
46,484,Bellreguard,3760,1876,1884
46,497,Bellús,391,194,197
46,500,Benagéber,157,86,71
46,517,Benaguasil,9151,4609,4542
46,522,Benavites,650,313,337
46,538,Beneixida,651,309,342
46,543,Benetússer,13771,6834,6937
46,556,Beniarjó,1170,568,602
46,569,Beniatjar,240,121,119
46,575,Benicolet,489,251,238
46,608,Benifaió,12120,5974,6146
46,594,Benifairó de la Valldigna,1634,807,827
46,581,Benifairó de les Valls,1966,973,993
46,615,Beniflá,157,70,87
46,620,Benigánim,5439,2767,2672
46,636,Benimodo,1760,905,855
46,641,Benimuslem,551,271,280
46,654,Beniparrell,1578,808,770
46,667,Benirredrà,1035,493,542
46,673,Benisanó,1695,870,825
46,689,Benisoda,298,166,132
46,692,Benisuera,191,89,102
46,706,Bétera,12376,6142,6234
46,713,Bicorp,696,341,355
46,728,Bocairent,4586,2261,2325
46,734,Bolbaite,1432,729,703
46,749,Bonrepòs i Mirambell,2355,1153,1202
46,752,Bufalí,216,104,112
46,765,Bugarra,836,417,419
46,771,Buñol,9358,4631,4727
46,787,Burjassot,34426,16699,17727
46,790,Calles,434,232,202
46,804,Camporrobles,1379,699,680
46,811,Canals,12857,6370,6487
46,826,Canet d'En Berenguer,2244,1081,1163
46,832,Carcaixent,20722,10107,10615
46,847,Cárcer,2034,983,1051
46,850,Carlet,14056,6879,7177
46,863,Carrícola,78,37,41
46,879,Casas Altas,163,87,76
46,885,Casas Bajas,300,161,139
46,898,Casinos,2316,1206,1110
46,2573,Castelló de la Ribera,7030,3478,3552
46,902,Castelló de Rugat,2052,1051,1001
46,919,Castellonet de la Conquesta,147,78,69
46,924,Castielfabib,536,289,247
46,930,Catadau,2273,1114,1159
46,945,Catarroja,20463,10052,10411
46,958,Caudete de las Fuentes,812,410,402
46,961,Cerdà,293,145,148
46,1075,Chella,2525,1247,1278
46,1069,Chelva,2174,1096,1078
46,1081,Chera,567,289,278
46,1094,Cheste,6834,3451,3383
46,1115,Chiva,9060,4525,4535
46,1120,Chulilla,739,365,374
46,977,Cofrentes,990,487,503
46,983,Corbera,3099,1491,1608
46,996,Cortes de Pallás,645,337,308
46,1000,Cotes,372,170,202
46,1056,Cullera,20397,10047,10350
46,1136,Daimús,1438,721,717
46,1141,Domeño,491,253,238
46,1154,Dos Aguas,389,219,170
46,1167,Eliana (l'),12067,6066,6001
46,1173,Emperador,192,94,98
46,1189,Enguera,4698,2321,2377
46,1192,Ènova (l'),1060,538,522
46,1206,Estivella,1076,500,576
46,1213,Estubeny,142,63,79
46,1228,Faura,2819,1413,1406
46,1234,Favara,1723,830,893
46,1265,Foios,5265,2555,2710
46,1287,Font de la Figuera (la),2130,1078,1052
46,1271,Font d'En Carròs (la),3171,1576,1595
46,1249,Fontanars dels Alforins,972,504,468
46,1252,Fortaleny,995,508,487
46,1290,Fuenterrobles,719,372,347
46,1311,Gandia,57518,28075,29443
46,9024,Gátova,502,239,263
46,1304,Gavarda,1244,600,644
46,1326,Genovés,2323,1158,1165
46,1332,Gestalgar,660,327,333
46,1347,Gilet,1480,735,745
46,1350,Godella,10758,5257,5501
46,1363,Godelleta,2144,1046,1098
46,1379,Granja de la Costera (la),357,169,188
46,1385,Guadasequies,390,203,187
46,1398,Guadassuar,5362,2672,2690
46,1402,Guardamar,70,38,32
46,1419,Higueruelas,559,291,268
46,1424,Jalance,1103,563,540
46,1445,Jarafuel,950,501,449
46,1542,Llanera de Ranes,1013,518,495
46,1555,Llaurí,1288,643,645
46,1477,Llíria,15800,7885,7915
46,1537,Llocnou de Sant Jeroni,555,276,279
46,1568,Llombai,2228,1121,1107
46,1574,Llosa de Ranes,3686,1902,1784
46,1509,Llutxent,2378,1205,1173
46,1483,Loriguilla,1003,509,494
46,1496,Losa del Obispo,462,226,236
46,1516,Lugar Nuevo de Fenollet,722,352,370
46,1521,Lugar Nuevo de la Corona,106,49,57
46,1580,Macastre,1000,490,510
46,1593,Manises,24140,11799,12341
46,1607,Manuel,2425,1176,1249
46,1614,Marines,1341,700,641
46,1629,Masalavés,1470,747,723
46,1635,Massalfassar,1351,665,686
46,1640,Massamagrell,12499,6157,6342
46,1653,Massanassa,7649,3717,3932
46,1666,Meliana,9163,4462,4701
46,1672,Millares,676,331,345
46,1688,Miramar,1114,542,572
46,1691,Mislata,40348,19710,20638
46,1705,Mogente/Moixent,4237,2141,2096
46,1712,Moncada,18404,9118,9286
46,1727,Monserrat,2958,1514,1444
46,1733,Montaverner,1662,837,825
46,1748,Montesa,1258,629,629
46,1751,Montichelvo,601,306,295
46,1764,Montroy,1514,771,743
46,1770,Museros,4161,2074,2087
46,1786,Náquera,2377,1193,1184
46,1799,Navarrés,2748,1381,1367
46,1803,Novelé/Novetlè,664,318,346
46,1810,Oliva,20577,10128,10449
46,1831,Olleria (l'),7005,3582,3423
46,1825,Olocau,786,393,393
46,1846,Ontinyent,31343,15444,15899
46,1859,Otos,524,263,261
46,1862,Paiporta,17490,8692,8798
46,1878,Palma de Gandía,1520,742,778
46,1884,Palmera,544,271,273
46,1897,Palomar,493,244,249
46,1901,Paterna,46380,22933,23447
46,1918,Pedralba,2085,1072,1013
46,1923,Petrés,741,361,380
46,1939,Picanya,8741,4364,4377
46,1944,Picassent,15555,7886,7669
46,1957,Piles,1946,951,995
46,1960,Pinet,228,119,109
46,1995,Pobla de Farnals (la),5191,2600,2591
46,2021,Pobla de Vallbona (la),10563,5399,5164
46,2009,Pobla del Duc (la),2435,1192,1243
46,2037,Pobla Llarga (la),4339,2108,2231
46,1976,Polinyà de Xúquer,3031,1512,1519
46,1982,Potríes,939,462,477
46,2055,Puçol,13930,6827,7103
46,2016,Puebla de San Miguel,80,43,37
46,2042,Puig,7039,3458,3581
46,1017,Quart de les Valls,1083,516,567
46,1022,Quart de Poblet,26666,13152,13514
46,1038,Quartell,1366,670,696
46,1043,Quatretonda,2511,1287,1224
46,2068,Quesa,791,397,394
46,2074,Rafelbuñol/Rafelbunyol,5273,2576,2697
46,2080,Rafelcofer,1403,663,740
46,2093,Rafelguaraf,2453,1202,1251
46,2107,Ráfol de Salem,372,176,196
46,2114,Real de Gandía,1790,856,934
46,2129,Real de Montroi,1814,927,887
46,2135,Requena,18829,9459,9370
46,2140,Riba-roja de Túria,11671,5801,5870
46,2153,Riola,1584,781,803
46,2166,Rocafort,4629,2261,2368
46,2172,Rotglá y Corbera,1016,512,504
46,2188,Rótova,1331,673,658
46,2191,Rugat,194,96,98
46,2205,Sagunto/Sagunt,56607,27546,29061
46,2212,Salem,469,236,233
46,9030,San Antonio de Benagéber,2142,1136,1006
46,2227,San Juan de Énova,358,162,196
46,2233,Sedaví,8276,4041,4235
46,2248,Segart,168,78,90
46,2251,Sellent,479,253,226
46,2264,Sempere,31,17,14
46,2270,Senyera,920,438,482
46,2286,Serra,1712,860,852
46,2299,Siete Aguas,1062,542,520
46,2303,Silla,15880,8000,7880
46,2310,Simat de la Valldigna,3120,1584,1536
46,2325,Sinarcas,1270,664,606
46,2331,Sollana,4451,2151,2300
46,2346,Sot de Chera,275,140,135
46,2359,Sueca,24893,12226,12667
46,2362,Sumacàrcer,1375,691,684
46,2378,Tavernes Blanques,8409,4122,4287
46,2384,Tavernes de la Valldigna,16247,8071,8176
46,2397,Teresa de Cofrentes,728,369,359
46,2401,Terrateig,206,106,100
46,2418,Titaguas,554,302,252
46,2423,Torrebaja,450,228,222
46,2439,Torrella,196,98,98
46,2444,Torrent,62562,31017,31545
46,2457,Torres Torres,415,206,209
46,2460,Tous,1182,582,600
46,2476,Tuéjar,1311,687,624
46,2482,Turís,4560,2337,2223
46,2495,Utiel,11843,5887,5956
46,2508,Valencia,739412,351211,388201
46,2515,Vallada,2972,1496,1476
46,2520,Vallanca,236,113,123
46,2536,Vallés,101,55,46
46,2541,Venta del Moro,1601,814,787
46,2567,Vilamarxant,5813,2948,2865
46,2554,Villalonga,3649,1823,1826
46,2589,Villar del Arzobispo,3494,1745,1749
46,2592,Villargordo del Cabriel,694,355,339
46,2606,Vinalesa,2295,1091,1204
46,1458,Xàtiva,24878,12077,12801
46,1430,Xeraco,4754,2355,2399
46,1461,Xeresa,1878,950,928
46,1108,Xirivella,25947,12831,13116
46,2613,Yátova,2013,1046,967
46,2628,Yesa (La),287,144,143
46,2634,Zarra,416,220,196
47,14,Adalia,87,44,43
47,29,Aguasal,25,13,12
47,35,Aguilar de Campos,380,200,180
47,40,Alaejos,1677,868,809
47,53,Alcazarén,721,385,336
47,66,Aldea de San Miguel,231,116,115
47,72,Aldeamayor de San Martín,1364,692,672
47,88,Almenara de Adaja,26,13,13
47,91,Amusquillo,183,98,85
47,105,Arroyo de la Encomienda,2609,1348,1261
47,112,Ataquines,895,467,428
47,127,Bahabón,206,101,105
47,133,Barcial de la Loma,168,84,84
47,148,Barruelo del Valle,75,40,35
47,151,Becilla de Valderaduey,442,235,207
47,164,Benafarces,113,55,58
47,170,Bercero,292,154,138
47,186,Berceruelo,44,23,21
47,199,Berrueces,100,56,44
47,203,Bobadilla del Campo,407,210,197
47,210,Bocigas,151,74,77
47,225,Bocos de Duero,77,33,44
47,231,Boecillo,1429,740,689
47,246,Bolaños de Campos,386,198,188
47,259,Brahojos de Medina,185,105,80
47,262,Bustillo de Chaves,97,47,50
47,278,Cabezón de Pisuerga,1757,900,857
47,284,Cabezón de Valderaduey,59,33,26
47,297,Cabreros del Monte,99,55,44
47,301,Campaspero,1504,778,726
47,318,Campillo (El),251,142,109
47,323,Camporredondo,213,119,94
47,339,Canalejas de Peñafiel,299,150,149
47,344,Canillas de Esgueva,137,73,64
47,357,Carpio,1226,647,579
47,360,Casasola de Arión,386,210,176
47,376,Castrejón de Trabancos,277,147,130
47,395,Castrillo-Tejeriego,279,145,134
47,382,Castrillo de Duero,217,104,113
47,409,Castrobol,89,41,48
47,416,Castrodeza,247,135,112
47,421,Castromembibre,90,47,43
47,437,Castromonte,464,238,226
47,442,Castronuevo de Esgueva,304,161,143
47,455,Castronuño,1097,552,545
47,468,Castroponce,207,107,100
47,474,Castroverde de Cerrato,271,156,115
47,480,Ceinos de Campos,275,147,128
47,493,Cervillego de la Cruz,156,80,76
47,506,Cigales,2772,1338,1434
47,513,Ciguñuela,379,199,180
47,528,Cistérniga,2725,1421,1304
47,534,Cogeces de Íscar,154,81,73
47,549,Cogeces del Monte,971,523,448
47,552,Corcos,272,140,132
47,565,Corrales de Duero,141,83,58
47,571,Cubillas de Santa Marta,272,149,123
47,587,Cuenca de Campos,303,150,153
47,590,Curiel de Duero,126,71,55
47,604,Encinas de Esgueva,390,208,182
47,611,Esguevillas de Esgueva,436,222,214
47,626,Fombellida,297,150,147
47,632,Fompedraza,145,79,66
47,647,Fontihoyuelo,47,29,18
47,650,Fresno el Viejo,1301,668,633
47,663,Fuensaldaña,951,454,497
47,685,Fuente-Olmedo,67,35,32
47,679,Fuente el Sol,311,161,150
47,698,Gallegos de Hornija,154,77,77
47,702,Gatón de Campos,45,28,17
47,719,Geria,473,254,219
47,730,Herrín de Campos,217,102,115
47,745,Hornillos de Eresma,151,79,72
47,758,Íscar,6125,3080,3045
47,761,Laguna de Duero,14915,7537,7378
47,777,Langayo,473,250,223
47,796,Llano de Olmedo,104,54,50
47,783,Lomoviejo,262,128,134
47,800,Manzanillo,71,36,35
47,817,Marzales,77,38,39
47,822,Matapozuelos,1001,505,496
47,838,Matilla de los Caños,94,55,39
47,843,Mayorga,1720,824,896
47,869,Medina de Rioseco,5001,2445,2556
47,856,Medina del Campo,20023,9842,10181
47,875,Megeces,471,232,239
47,881,Melgar de Abajo,187,95,92
47,894,Melgar de Arriba,307,153,154
47,908,Mojados,2443,1223,1220
47,915,Monasterio de Vega,89,47,42
47,920,Montealegre de Campos,176,98,78
47,936,Montemayor de Pililla,1054,554,500
47,941,Moral de la Reina,240,121,119
47,954,Moraleja de las Panaderas,31,19,12
47,967,Morales de Campos,200,100,100
47,973,Mota del Marqués,450,213,237
47,989,Mucientes,618,310,308
47,992,Mudarra (La),274,148,126
47,1006,Muriel,222,109,113
47,1013,Nava del Rey,2287,1116,1171
47,1028,Nueva Villa de las Torres,421,233,188
47,1034,Olivares de Duero,349,191,158
47,1049,Olmedo,3502,1698,1804
47,1052,Olmos de Esgueva,189,105,84
47,1065,Olmos de Peñafiel,90,46,44
47,1090,Palazuelo de Vedija,248,129,119
47,1104,Parrilla (La),658,318,340
47,1111,Pedraja de Portillo (La),1117,561,556
47,1126,Pedrajas de San Esteban,3227,1635,1592
47,1132,Pedrosa del Rey,243,131,112
47,1147,Peñafiel,5132,2584,2548
47,1150,Peñaflor de Hornija,476,255,221
47,1163,Pesquera de Duero,535,286,249
47,1179,Piña de Esgueva,417,216,201
47,1185,Piñel de Abajo,217,113,104
47,1198,Piñel de Arriba,156,76,80
47,1219,Pollos,827,425,402
47,1224,Portillo,2549,1293,1256
47,1230,Pozal de Gallinas,502,264,238
47,1245,Pozaldez,524,258,266
47,1258,Pozuelo de la Orden,78,44,34
47,1261,Puras,59,28,31
47,1277,Quintanilla de Arriba,229,122,107
47,1296,Quintanilla de Onésimo,1145,603,542
47,1300,Quintanilla de Trigueros,97,50,47
47,1283,Quintanilla del Molar,83,34,49
47,1317,Rábano,253,127,126
47,1322,Ramiro,83,47,36
47,1338,Renedo de Esgueva,961,495,466
47,1343,Roales de Campos,261,132,129
47,1356,Robladillo,107,53,54
47,1375,Roturas,28,16,12
47,1381,Rubí de Bracamonte,352,184,168
47,1394,Rueda,1495,764,731
47,1408,Saelices de Mayorga,195,101,94
47,1415,Salvador de Zapardiel,207,112,95
47,1420,San Cebrián de Mazote,239,129,110
47,1436,San Llorente,211,112,99
47,1441,San Martín de Valvení,119,69,50
47,1454,San Miguel del Arroyo,817,426,391
47,1467,San Miguel del Pino,231,124,107
47,1473,San Pablo de la Moraleja,194,106,88
47,1489,San Pedro de Latarce,666,359,307
47,1492,San Pelayo,39,20,19
47,1505,San Román de Hornija,458,226,232
47,1512,San Salvador,52,27,25
47,1564,San Vicente del Palacio,255,132,123
47,1527,Santa Eufemia del Arroyo,135,66,69
47,1533,Santervás de Campos,172,91,81
47,1548,Santibáñez de Valcorba,241,128,113
47,1551,Santovenia de Pisuerga,1930,972,958
47,1570,Sardón de Duero,641,328,313
47,1586,Seca (La),1066,576,490
47,1599,Serrada,1027,526,501
47,1603,Siete Iglesias de Trabancos,641,332,309
47,1610,Simancas,3038,1552,1486
47,1625,Tamariz de Campos,108,57,51
47,1631,Tiedra,409,201,208
47,1646,Tordehumos,569,289,280
47,1659,Tordesillas,7999,4045,3954
47,1697,Torre de Esgueva,113,57,56
47,1701,Torre de Peñafiel,45,26,19
47,1662,Torrecilla de la Abadesa,389,201,188
47,1678,Torrecilla de la Orden,385,191,194
47,1684,Torrecilla de la Torre,39,23,16
47,1718,Torrelobatón,582,284,298
47,1723,Torrescárcela,178,94,84
47,1739,Traspinedo,821,419,402
47,1744,Trigueros del Valle,279,142,137
47,1757,Tudela de Duero,6010,3096,2914
47,1760,Unión de Campos (La),318,156,162
47,1776,Urones de Castroponce,157,88,69
47,1782,Urueña,204,101,103
47,1795,Valbuena de Duero,529,276,253
47,1809,Valdearcos de la Vega,151,75,76
47,1816,Valdenebro de los Valles,244,125,119
47,1821,Valdestillas,1563,790,773
47,1837,Valdunquillo,235,110,125
47,1868,Valladolid,319946,154066,165880
47,1842,Valoria la Buena,651,339,312
47,1855,Valverde de Campos,117,62,55
47,1874,Vega de Ruiponce,146,70,76
47,1880,Vega de Valdetronco,196,104,92
47,1893,Velascálvaro,197,102,95
47,1907,Velilla,155,81,74
47,1914,Velliza,167,95,72
47,1929,Ventosa de la Cuesta,164,88,76
47,1935,Viana de Cega,1404,712,692
47,1953,Villabáñez,494,264,230
47,1966,Villabaruz de Campos,56,27,29
47,1972,Villabrágima,1234,637,597
47,1988,Villacarralón,118,59,59
47,1991,Villacid de Campos,112,60,52
47,2005,Villaco,136,80,56
47,2033,Villafrades de Campos,117,53,64
47,2048,Villafranca de Duero,389,196,193
47,2051,Villafrechós,532,273,259
47,2064,Villafuerte,155,75,80
47,2070,Villagarcía de Campos,453,243,210
47,2086,Villagómez la Nueva,106,49,57
47,2099,Villalán de Campos,58,27,31
47,2103,Villalar de los Comuneros,502,242,260
47,2110,Villalba de la Loma,48,26,22
47,2125,Villalba de los Alcores,566,297,269
47,2131,Villalbarba,173,85,88
47,2146,Villalón de Campos,2168,1050,1118
47,2159,Villamuriel de Campos,97,48,49
47,2162,Villán de Tordesillas,188,93,95
47,2178,Villanubla,921,480,441
47,2184,Villanueva de Duero,957,490,467
47,2197,Villanueva de la Condesa,44,26,18
47,2201,Villanueva de los Caballeros,286,137,149
47,2218,Villanueva de los Infantes,155,81,74
47,2223,Villanueva de San Mancio,106,58,48
47,2239,Villardefrades,239,122,117
47,2244,Villarmentero de Esgueva,136,68,68
47,2257,Villasexmir,125,65,60
47,2260,Villavaquerín,231,122,109
47,2276,Villavellid,72,39,33
47,2282,Villaverde de Medina,595,320,275
47,2295,Villavicencio de los Caballeros,336,153,183
47,1940,Viloria,385,206,179
47,2309,Wamba,388,209,179
47,2316,Zaratán,1243,644,599
47,2321,Zarza (La),165,84,81
48,10,Abadiño,6820,3420,3400
48,25,Abanto y Ciérvana/Abanto Zierbena,8812,4364,4448
48,9119,Ajangiz,401,203,198
48,9124,Alonsotegi,2829,1376,1453
48,31,Amorebieta-Etxano,16207,8105,8102
48,46,Amoroto,370,196,174
48,59,Arakaldo,92,53,39
48,62,Arantzazu,270,129,141
48,84,Arcentales,644,350,294
48,932,Areatza,1049,468,581
48,97,Arrankudiaga,740,356,384
48,9145,Arratzu,390,194,196
48,101,Arrieta,472,233,239
48,118,Arrigorriaga,10502,5167,5335
48,237,Artea,595,283,312
48,911,Atxondo,1488,745,743
48,708,Aulesti,643,333,310
48,123,Bakio,1490,756,734
48,904,Balmaseda,7106,3419,3687
48,139,Barakaldo,98649,48261,50388
48,144,Barrika,1076,546,530
48,157,Basauri,48107,23824,24283
48,926,Bedia,988,498,490
48,160,Berango,4690,2329,2361
48,176,Bermeo,16989,8336,8653
48,182,Berriatua,955,493,462
48,195,Berriz,4113,2072,2041
48,209,Bilbao,358467,170187,188280
48,216,Busturia,1667,838,829
48,221,Carranza,3081,1622,1459
48,9011,Derio,4666,2306,2360
48,268,Dima,1050,534,516
48,274,Durango,24260,11898,12362
48,280,Ea,813,392,421
48,314,Elantxobe,484,212,272
48,329,Elorrio,7233,3629,3604
48,9026,Erandio,23207,11405,11802
48,335,Ereño,266,133,133
48,340,Ermua,17334,8838,8496
48,792,Errigoiti,452,255,197
48,293,"Etxebarri, Anteiglesia de San Esteban/Etxebarri Doneztebeko Elizatea",6438,3259,3179
48,307,Etxebarria,793,409,384
48,9063,Forua,979,494,485
48,353,Fruiz,314,155,159
48,366,Galdakao,29418,14594,14824
48,372,Galdames,780,403,377
48,388,Gamiz-Fika,1022,520,502
48,391,Garay,240,120,120
48,405,Gatika,1177,601,576
48,412,Gautegiz Arteaga,811,402,409
48,464,Gernika-Lumo,15485,7523,7962
48,448,Getxo,82974,39706,43268
48,427,Gordexola,1463,723,740
48,433,Gorliz,3808,1899,1909
48,451,Güeñes,5870,2900,2970
48,470,Guizaburuaga,131,65,66
48,486,Ibarrangelu,517,246,271
48,947,Igorre,3940,1976,1964
48,499,Ispaster,615,325,290
48,9102,Iurreta,4420,2190,2230
48,502,Izurtza,273,138,135
48,9079,Kortezubi,357,190,167
48,519,Lanestosa,296,151,145
48,524,Larrabetzu,1552,779,773
48,530,Laukiz,919,474,445
48,545,Leioa,27308,13499,13809
48,577,Lekeitio,7466,3680,3786
48,558,Lemoa,2466,1222,1244
48,561,Lemoiz,877,458,419
48,813,Lezama,2053,1030,1023
48,9032,Loiu,1661,854,807
48,583,Mallabia,1079,570,509
48,596,Mañaria,476,251,225
48,600,Markina-Xemein,4692,2333,2359
48,617,Maruri-Jatabe,582,286,296
48,622,Mendata,322,175,147
48,638,Mendexa,341,181,160
48,643,Meñaka,476,244,232
48,669,Morga,381,206,175
48,681,Mundaka,1783,836,947
48,694,Mungia,13216,6499,6717
48,78,Munitibar-Arbatzegi Gerrikaitz,394,212,182
48,9085,Murueta,221,117,104
48,715,Muskiz,6123,3003,3120
48,675,Muxika,1387,716,671
48,9098,Nabarniz,236,114,122
48,736,Ondarroa,10114,5069,5045
48,741,Orduña,3882,1979,1903
48,754,Orozko,1922,962,960
48,834,Ortuella,8778,4286,4492
48,720,Otxandio,1018,534,484
48,773,Plentzia,3286,1585,1701
48,789,Portugalete,53498,26196,27302
48,828,Santurtzi,48962,24033,24929
48,849,Sestao,33732,16435,17297
48,9047,Sondika,3694,1773,1921
48,852,Sopelana,9815,4885,4930
48,865,Sopuerta,2271,1146,1125
48,767,Sukarrieta,330,168,162
48,871,Trucios-Turtzioz,530,265,265
48,887,Ubide,163,81,82
48,656,Ugao-Miraballes,4150,2084,2066
48,890,Urduliz,2825,1403,1422
48,806,Valle de Trápaga-Trapagaran,12673,6239,6434
48,950,Zaldibar,2944,1413,1531
48,963,Zalla,7582,3738,3844
48,9050,Zamudio,2953,1482,1471
48,979,Zaratamo,1614,820,794
48,242,Zeanuri,1160,600,560
48,255,Zeberio,929,482,447
48,9130,Zierbena,1170,617,553
49,28,Abezames,115,58,57
49,34,Alcañices,1205,595,610
49,49,Alcubilla de Nogales,214,103,111
49,52,Alfaraz de Sayago,222,118,104
49,65,Algodre,217,112,105
49,71,Almaraz de Duero,484,240,244
49,87,Almeida de Sayago,683,348,335
49,90,Andavías,514,251,263
49,104,Arcenillas,286,144,142
49,111,Arcos de la Polvorosa,309,164,145
49,126,Argañín,110,47,63
49,132,Argujillo,394,209,185
49,147,Arquillinos,199,102,97
49,150,Arrabalde,402,193,209
49,163,Aspariegos,392,191,201
49,179,Asturianos,355,176,179
49,185,Ayoó de Vidriales,498,244,254
49,198,Barcial del Barco,306,171,135
49,202,Belver de los Montes,515,269,246
49,219,Benavente,16272,7917,8355
49,224,Benegiles,433,228,205
49,230,Bermillo de Sayago,1526,795,731
49,245,Bóveda de Toro (La),1011,513,498
49,258,Bretó,263,138,125
49,261,Bretocino,334,181,153
49,277,Brime de Sog,263,122,141
49,283,Brime de Urz,167,92,75
49,296,Burganes de Valverde,915,472,443
49,300,Bustillo del Oro,164,84,80
49,317,Cabañas de Sayago,197,92,105
49,322,Calzadilla de Tera,528,252,276
49,338,Camarzana de Tera,1083,541,542
49,343,Cañizal,643,344,299
49,356,Cañizo,334,169,165
49,369,Carbajales de Alba,707,343,364
49,375,Carbellino,277,139,138
49,381,Casaseca de Campeán,164,86,78
49,394,Casaseca de las Chanas,369,185,184
49,408,Castrillo de la Guareña,172,85,87
49,415,Castrogonzalo,538,288,250
49,420,Castronuevo,352,179,173
49,436,Castroverde de Campos,428,214,214
49,441,Cazurra,102,56,46
49,467,Cerecinos de Campos,436,225,211
49,473,Cerecinos del Carrizal,165,89,76
49,489,Cernadilla,166,78,88
49,505,Cobreros,851,424,427
49,527,Coomonte,346,180,166
49,533,Coreses,1213,621,592
49,548,Corrales,1186,568,618
49,551,Cotanes,177,93,84
49,564,Cubillos,402,202,200
49,570,Cubo de Benavente,192,104,88
49,586,Cubo de Tierra del Vino (El),484,247,237
49,599,Cuelgamures,147,80,67
49,610,Entrala,164,85,79
49,625,Espadañedo,222,112,110
49,631,Faramontanos de Tábara,501,251,250
49,646,Fariza,727,367,360
49,659,Fermoselle,1686,840,846
49,662,Ferreras de Abajo,632,307,325
49,678,Ferreras de Arriba,544,279,265
49,684,Ferreruela,690,361,329
49,697,Figueruela de Arriba,571,278,293
49,718,Fonfría,1191,603,588
49,757,Fresno de la Polvorosa,224,105,119
49,760,Fresno de la Ribera,434,237,197
49,776,Fresno de Sayago,287,145,142
49,782,Friera de Valverde,292,150,142
49,795,Fuente Encalada,160,81,79
49,809,Fuentelapeña,1064,544,520
49,821,Fuentes de Ropel,608,316,292
49,816,Fuentesaúco,1858,932,926
49,837,Fuentesecas,88,42,46
49,842,Fuentespreadas,428,236,192
49,855,Galende,1379,677,702
49,868,Gallegos del Pan,174,90,84
49,874,Gallegos del Río,898,472,426
49,880,Gamones,104,59,45
49,907,Gema,284,141,143
49,914,Granja de Moreruela,394,190,204
49,929,Granucillo,276,138,138
49,935,Guarrate,389,213,176
49,940,Hermisende,460,246,214
49,953,Hiniesta (La),391,188,203
49,966,Jambrina,277,136,141
49,972,Justel,188,99,89
49,988,Losacino,373,201,172
49,991,Losacio,175,93,82
49,1005,Lubián,405,197,208
49,1012,Luelmo,265,136,129
49,1027,Maderal (El),313,161,152
49,1033,Madridanos,573,288,285
49,1048,Mahide,584,300,284
49,1051,Maire de Castroponce,251,129,122
49,1070,Malva,237,119,118
49,1086,Manganeses de la Lampreana,815,412,403
49,1099,Manganeses de la Polvorosa,887,441,446
49,1103,Manzanal de Arriba,477,239,238
49,1125,Manzanal de los Infantes,184,98,86
49,1110,Manzanal del Barco,207,110,97
49,1131,Matilla de Arzón,274,149,125
49,1146,Matilla la Seca,69,35,34
49,1159,Mayalde,243,123,120
49,1162,Melgar de Tera,610,303,307
49,1178,Micereces de Tera,667,340,327
49,1184,Milles de la Polvorosa,293,143,150
49,1197,Molacillos,307,161,146
49,1201,Molezuelas de la Carballeda,118,58,60
49,1218,Mombuey,481,238,243
49,1223,Monfarracinos,590,313,277
49,1239,Montamarta,718,344,374
49,1244,Moral de Sayago,401,215,186
49,1260,Moraleja de Sayago,299,161,138
49,1257,Moraleja del Vino,1276,667,609
49,1282,Morales de Rey,777,376,401
49,1295,Morales de Toro,1123,569,554
49,1309,Morales de Valverde,319,154,165
49,1276,Morales del Vino,1513,781,732
49,1316,Moralina,389,199,190
49,1321,Moreruela de los Infanzones,491,257,234
49,1337,Moreruela de Tábara,558,289,269
49,1342,Muelas de los Caballeros,251,132,119
49,1355,Muelas del Pan,930,453,477
49,1368,Muga de Sayago,520,256,264
49,1374,Navianos de Valverde,264,143,121
49,1380,Olmillos de Castro,448,231,217
49,1393,Otero de Bodas,279,150,129
49,1414,Pajares de la Lampreana,527,267,260
49,1435,Palacios de Sanabria,354,171,183
49,1429,Palacios del Pan,260,116,144
49,1453,Pedralba de la Pradería,312,150,162
49,1466,Pego (El),480,240,240
49,1472,Peleagonzalo,468,239,229
49,1488,Peleas de Abajo,253,123,130
49,1491,Peñausende,603,305,298
49,1504,Peque,230,115,115
49,1511,Perdigón (El),792,404,388
49,1526,Pereruela,756,377,379
49,1532,Perilla de Castro,268,134,134
49,1547,Pías,252,126,126
49,1550,Piedrahita de Castro,161,84,77
49,1563,Pinilla de Toro,395,199,196
49,1579,Pino,238,127,111
49,1585,Piñero (El),317,169,148
49,1602,Pobladura de Valderaduey,84,40,44
49,1598,Pobladura del Valle,329,162,167
49,1624,Porto,338,183,155
49,1630,Pozoantiguo,359,178,181
49,1645,Pozuelo de Tábara,246,119,127
49,1658,Prado,109,56,53
49,1661,Puebla de Sanabria,1708,824,884
49,1677,Pueblica de Valverde,334,169,165
49,1700,Quintanilla de Urz,142,75,67
49,1683,Quintanilla del Monte,154,69,85
49,1696,Quintanilla del Olmo,65,29,36
49,1717,Quiruelas de Vidriales,1006,477,529
49,1722,Rabanales,894,459,435
49,1738,Rábano de Aliste,513,256,257
49,1743,Requejo,222,106,116
49,1756,Revellinos,350,190,160
49,1769,Riofrío de Aliste,1126,586,540
49,1775,Rionegro del Puente,407,200,207
49,1781,Roales,403,207,196
49,1794,Robleda-Cervantes,455,211,244
49,1808,Roelos de Sayago,172,91,81
49,1815,Rosinos de la Requejada,534,255,279
49,1836,Salce,155,85,70
49,1841,Samir de los Caños,254,133,121
49,1854,San Agustín del Pozo,221,117,104
49,1867,San Cebrián de Castro,410,191,219
49,1873,San Cristóbal de Entreviñas,1643,835,808
49,1889,San Esteban del Molar,190,103,87
49,1892,San Justo,388,186,202
49,1906,San Martín de Valderaduey,104,47,57
49,1913,San Miguel de la Ribera,422,213,209
49,1928,San Miguel del Valle,244,113,131
49,1934,San Pedro de Ceque,726,361,365
49,1949,San Pedro de la Nave-Almendra,535,266,269
49,2085,San Vicente de la Cabeza,648,342,306
49,2098,San Vitero,759,397,362
49,1971,Santa Clara de Avedillo,255,124,131
49,1990,Santa Colomba de las Monjas,348,178,170
49,2004,Santa Cristina de la Polvorosa,1292,662,630
49,2011,Santa Croya de Tera,504,253,251
49,2026,Santa Eufemia del Barco,305,166,139
49,2032,Santa María de la Vega,509,268,241
49,2047,Santa María de Valverde,109,52,57
49,2050,Santibáñez de Tera,589,297,292
49,2063,Santibáñez de Vidriales,1405,702,703
49,2079,Santovenia,441,212,229
49,2102,Sanzoles,716,368,348
49,2145,Tábara,980,500,480
49,2161,Tapioles,251,135,116
49,2196,Toro,9622,4676,4946
49,2200,Torre del Valle (La),195,105,90
49,2217,Torregamones,347,171,176
49,2222,Torres del Carrizal,539,276,263
49,2238,Trabazos,966,490,476
49,2243,Trefacio,255,119,136
49,2256,Uña de Quintana,230,117,113
49,2269,Vadillo de la Guareña,374,195,179
49,2275,Valcabado,355,182,173
49,2281,Valdefinjas,98,56,42
49,2294,Valdescorriel,193,96,97
49,2308,Vallesa de la Guareña,196,107,89
49,2315,Vega de Tera,539,255,284
49,2320,Vega de Villalobos,170,78,92
49,2336,Vegalatrave,166,88,78
49,2341,Venialbo,554,287,267
49,2354,Vezdemarbán,729,356,373
49,2367,Vidayanes,121,58,63
49,2373,Videmala,219,108,111
49,2389,Villabrázaro,395,203,192
49,2392,Villabuena del Puente,1003,523,480
49,2406,Villadepera,292,140,152
49,2413,Villaescusa,390,199,191
49,2428,Villafáfila,673,332,341
49,2434,Villaferrueña,162,84,78
49,2449,Villageriz,73,38,35
49,2452,Villalazán,398,195,203
49,2465,Villalba de la Lampreana,336,175,161
49,2471,Villalcampo,721,350,371
49,2487,Villalobos,329,155,174
49,2490,Villalonso,138,67,71
49,2503,Villalpando,1752,860,892
49,2510,Villalube,333,168,165
49,2525,Villamayor de Campos,561,286,275
49,2559,Villamor de los Escuderos,595,298,297
49,2562,Villanázar,383,180,203
49,2578,Villanueva de Azoague,387,194,193
49,2584,Villanueva de Campeán,196,98,98
49,2597,Villanueva de las Peras,193,97,96
49,2601,Villanueva del Campo,1114,550,564
49,2639,Villar de Fallaves,111,60,51
49,2644,Villar del Buey,897,486,411
49,2618,Villaralbo,1586,786,800
49,2623,Villardeciervos,532,246,286
49,2657,Villardiegua de la Ribera,177,85,92
49,2660,Villárdiga,118,60,58
49,2676,Villardondiego,137,74,63
49,2682,Villarrín de Campos,663,340,323
49,2695,Villaseco del Pan,343,169,174
49,2709,Villavendimio,213,116,97
49,2721,Villaveza de Valverde,151,77,74
49,2716,Villaveza del Agua,277,144,133
49,2737,Viñas,298,150,148
49,2755,Zamora,64421,30569,33852
50,16,Abanto,189,101,88
50,21,Acered,283,145,138
50,37,Agón,198,107,91
50,42,Aguarón,716,354,362
50,55,Aguilón,267,131,136
50,68,Ainzón,1236,624,612
50,74,Aladrén,59,33,26
50,80,Alagón,5552,2765,2787
50,93,Alarba,160,92,68
50,107,Alberite de San Juan,105,55,50
50,114,Albeta,122,56,66
50,129,Alborge,136,68,68
50,135,Alcalá de Ebro,299,144,155
50,140,Alcalá de Moncayo,151,80,71
50,153,Alconchel de Ariza,171,95,76
50,166,Aldehuela de Liestos,61,32,29
50,172,Alfajarín,1460,748,712
50,188,Alfamén,1307,683,624
50,191,Alforque,90,47,43
50,205,Alhama de Aragón,1204,584,620
50,212,Almochuel,43,23,20
50,227,Almolda (La),712,351,361
50,233,Almonacid de la Cuba,350,175,175
50,248,Almonacid de la Sierra,854,443,411
50,251,Almunia de Doña Godina (La),5383,2751,2632
50,264,Alpartir,622,326,296
50,270,Ambel,359,165,194
50,286,Anento,74,46,28
50,299,Aniñón,901,473,428
50,303,Añón de Moncayo,315,185,130
50,310,Aranda de Moncayo,239,127,112
50,325,Arándiga,524,268,256
50,331,Ardisa,82,43,39
50,346,Ariza,1334,686,648
50,359,Artieda,103,57,46
50,362,Asín,101,48,53
50,378,Atea,245,137,108
50,384,Ateca,2044,1005,1039
50,397,Azuara,725,380,345
50,401,Badules,116,59,57
50,418,Bagüés,34,20,14
50,423,Balconchán,30,15,15
50,439,Bárboles,329,174,155
50,444,Bardallur,308,151,157
50,457,Belchite,1625,831,794
50,460,Belmonte de Gracián,302,163,139
50,476,Berdejo,51,28,23
50,482,Berrueco,41,23,18
50,9017,Biel-Fuencalderas,200,111,89
50,508,Bijuesca,135,77,58
50,515,Biota,1261,643,618
50,520,Bisimbre,135,60,75
50,536,Boquiñeni,1006,512,494
50,541,Bordalba,98,56,42
50,554,Borja,3999,1951,2048
50,567,Botorrita,471,251,220
50,573,Brea de Aragón,2022,1006,1016
50,589,Bubierca,106,51,55
50,592,Bujaraloz,1018,539,479
50,606,Bulbuente,253,140,113
50,613,Bureta,327,163,164
50,628,Burgo de Ebro (El),1493,756,737
50,634,Buste (El),114,61,53
50,649,Cabañas de Ebro,517,270,247
50,652,Cabolafuente,99,54,45
50,665,Cadrete,1367,727,640
50,671,Calatayud,16569,7912,8657
50,687,Calatorao,2719,1404,1315
50,690,Calcena,95,51,44
50,704,Calmarza,99,50,49
50,711,Campillo de Aragón,200,112,88
50,726,Carenas,241,119,122
50,732,Cariñena,2893,1475,1418
50,747,Caspe,7750,3795,3955
50,750,Castejón de Alarba,122,67,55
50,763,Castejón de las Armas,143,70,73
50,779,Castejón de Valdejasa,341,178,163
50,785,Castiliscar,409,205,204
50,798,Cervera de la Cañada,354,171,183
50,802,Cerveruela,6,5,1
50,819,Cetina,736,364,372
50,922,Chiprana,390,192,198
50,938,Chodes,126,61,65
50,824,Cimballa,135,70,65
50,830,Cinco Olivas,130,63,67
50,845,Clarés de Ribota,99,52,47
50,858,Codo,282,137,145
50,861,Codos,290,170,120
50,877,Contamina,56,30,26
50,883,Cosuenda,422,217,205
50,896,Cuarte de Huerva,1746,908,838
50,900,Cubel,242,119,123
50,917,Cuerlas (Las),101,52,49
50,943,Daroca,2309,1138,1171
50,956,Ejea de los Caballeros,14734,7501,7233
50,969,Embid de Ariza,65,34,31
50,981,Encinacorba,325,174,151
50,994,Épila,3959,2045,1914
50,1008,Erla,479,226,253
50,1015,Escatrón,1209,586,623
50,1020,Fabara,1239,654,585
50,1041,Farlete,463,230,233
50,1054,Fayón,392,204,188
50,1067,Fayos (Los),194,105,89
50,1073,Figueruelas,997,504,493
50,1089,Fombuena,21,15,6
50,1092,Frago (El),99,61,38
50,1106,Frasno (El),555,291,264
50,1113,Fréscano,261,128,133
50,1134,Fuendejalón,908,463,445
50,1149,Fuendetodos,145,79,66
50,1152,Fuentes de Ebro,3771,1948,1823
50,1165,Fuentes de Jiloca,370,192,178
50,1171,Gallocanta,186,94,92
50,1187,Gallur,2948,1486,1462
50,1190,Gelsa,1238,628,610
50,1204,Godojos,71,35,36
50,1211,Gotor,384,204,180
50,1226,Grisel,68,37,31
50,1232,Grisén,478,241,237
50,1247,Herrera de los Navarros,590,312,278
50,1250,Ibdes,589,300,289
50,1263,Illueca,3310,1627,1683
50,1285,Isuerre,64,36,28
50,1298,Jaraba,316,164,152
50,1302,Jarque,581,311,270
50,1319,Jaulín,309,158,151
50,1324,Joyosa (La),363,187,176
50,1330,Lagata,154,81,73
50,1345,Langa del Castillo,190,90,100
50,1358,Layana,153,75,78
50,1361,Lécera,860,419,441
50,1383,Lechón,53,32,21
50,1377,Leciñena,1387,690,697
50,1396,Letux,498,253,245
50,1400,Litago,181,105,76
50,1417,Lituénigo,117,57,60
50,1422,Lobera de Onsella,57,34,23
50,1438,Longares,861,440,421
50,1443,Longás,41,26,15
50,1469,Lucena de Jalón,264,133,131
50,1475,Luceni,1063,528,535
50,1481,Luesia,425,220,205
50,1494,Luesma,23,13,10
50,1507,Lumpiaque,945,491,454
50,1514,Luna,932,492,440
50,1529,Maella,2027,1028,999
50,1535,Magallón,1218,659,559
50,1540,Mainar,184,99,85
50,1553,Malanquilla,129,67,62
50,1566,Maleján,311,164,147
50,1605,Mallén,2935,1502,1433
50,1572,Malón,479,244,235
50,1591,Maluenda,1012,486,526
50,1612,Manchones,157,76,81
50,1627,Mara,216,112,104
50,1633,María de Huerva,868,420,448
50,1648,Mediana de Aragón,506,255,251
50,1651,Mequinenza,2544,1260,1284
50,1664,Mesones de Isuela,388,191,197
50,1670,Mezalocha,316,171,145
50,1686,Mianos,39,22,17
50,1699,Miedes de Aragón,521,269,252
50,1703,Monegrillo,551,301,250
50,1710,Moneva,111,54,57
50,1725,Monreal de Ariza,317,163,154
50,1731,Monterde,223,112,111
50,1746,Montón,145,72,73
50,1759,Morata de Jalón,1546,768,778
50,1762,Morata de Jiloca,355,190,165
50,1778,Morés,507,267,240
50,1784,Moros,533,265,268
50,1797,Moyuela,356,180,176
50,1801,Mozota,116,58,58
50,1818,Muel,1135,570,565
50,1823,Muela (La),1136,593,543
50,1839,Munébrega,483,253,230
50,1844,Murero,143,82,61
50,1857,Murillo de Gállego,137,81,56
50,1860,Navardún,61,32,29
50,1876,Nigüella,119,65,54
50,1882,Nombrevilla,33,15,18
50,1895,Nonaspe,1087,544,543
50,1909,Novallas,758,366,392
50,1916,Novillas,699,356,343
50,1921,Nuévalos,300,174,126
50,1937,Nuez de Ebro,563,298,265
50,1942,Olvés,171,90,81
50,1955,Orcajo,46,23,23
50,1968,Orera,133,66,67
50,1974,Orés,104,62,42
50,1980,Oseja,56,32,24
50,1993,Osera de Ebro,345,167,178
50,2007,Paniza,711,348,363
50,2014,Paracuellos de Jiloca,495,221,274
50,2029,Paracuellos de la Ribera,314,149,165
50,2035,Pastriz,936,457,479
50,2040,Pedrola,2574,1316,1258
50,2053,Pedrosas (Las),100,45,55
50,2066,Perdiguera,447,236,211
50,2072,Piedratajada,194,98,96
50,2088,Pina de Ebro,2208,1093,1115
50,2091,Pinseque,1470,725,745
50,2105,Pintanos (Los),84,42,42
50,2112,Plasencia de Jalón,370,201,169
50,2127,Pleitas,69,40,29
50,2133,Plenas,161,81,80
50,2148,Pomer,15,8,7
50,2151,Pozuel de Ariza,25,18,7
50,2164,Pozuelo de Aragón,350,192,158
50,2170,Pradilla de Ebro,659,345,314
50,2186,Puebla de Albortón,158,82,76
50,2199,Puebla de Alfindén (La),1633,845,788
50,2203,Puendeluna,58,35,23
50,2210,Purujosa,39,29,10
50,2225,Quinto,2154,1086,1068
50,2231,Remolinos,1257,634,623
50,2246,Retascón,79,46,33
50,2259,Ricla,1838,976,862
50,2278,Romanos,147,85,62
50,2284,Rueda de Jalón,371,189,182
50,2297,Ruesca,92,47,45
50,2416,Sabiñán,980,473,507
50,2301,Sádaba,1683,851,832
50,2318,Salillas de Jalón,365,194,171
50,2323,Salvatierra de Esca,289,148,141
50,2339,Samper del Salz,144,72,72
50,2344,San Martín de la Virgen de Moncayo,311,161,150
50,2357,San Mateo de Gállego,2036,1042,994
50,2360,Santa Cruz de Grío,234,128,106
50,2376,Santa Cruz de Moncayo,107,52,55
50,2382,Santa Eulalia de Gállego,133,62,71
50,2395,Santed,78,37,41
50,2409,Sástago,1479,739,740
50,2421,Sediles,107,55,52
50,2437,Sestrica,486,246,240
50,2442,Sierra de Luna,263,132,131
50,2455,Sigüés,181,96,85
50,2468,Sisamón,85,50,35
50,2474,Sobradiel,610,296,314
50,2480,Sos del Rey Católico,813,405,408
50,2493,Tabuenca,484,264,220
50,2506,Talamantes,68,37,31
50,2513,Tarazona,10287,4966,5321
50,2528,Tauste,6998,3466,3532
50,2534,Terrer,672,322,350
50,2549,Tierga,260,143,117
50,2552,Tobed,285,140,145
50,2565,Torralba de los Frailes,109,53,56
50,2571,Torralba de Ribota,230,129,101
50,2587,Torralbilla,71,36,35
50,2590,Torrehermosa,122,65,57
50,2604,Torrelapaja,44,22,22
50,2611,Torrellas,321,160,161
50,2626,Torres de Berrellén,1404,700,704
50,2632,Torrijo de la Cañada,414,214,200
50,2647,Tosos,206,107,99
50,2650,Trasmoz,67,35,32
50,2663,Trasobares,238,125,113
50,2679,Uncastillo,920,450,470
50,2685,Undués de Lerda,58,36,22
50,2698,Urrea de Jalón,345,174,171
50,2702,Urriés,84,52,32
50,2719,Used,389,212,177
50,2724,Utebo,9488,4793,4695
50,2745,Val de San Martín,75,35,40
50,2730,Valdehorna,59,30,29
50,2758,Valmadrid,62,33,29
50,2761,Valpalmas,198,100,98
50,2777,Valtorres,100,48,52
50,2783,Velilla de Ebro,281,141,140
50,2796,Velilla de Jiloca,122,61,61
50,2800,Vera de Moncayo,481,246,235
50,2817,Vierlas,103,50,53
50,2838,Villadoz,87,47,40
50,2843,Villafeliche,235,118,117
50,2856,Villafranca de Ebro,672,321,351
50,2869,Villalba de Perejil,115,61,54
50,2875,Villalengua,434,229,205
50,2881,Villanueva de Gállego,2860,1451,1409
50,2908,Villanueva de Huerva,590,302,288
50,2894,Villanueva de Jiloca,116,57,59
50,2915,Villar de los Navarros,149,75,74
50,2920,Villarreal de Huerva,188,105,83
50,2936,Villarroya de la Sierra,708,363,345
50,2941,Villarroya del Campo,90,43,47
50,2822,Vilueña (La),96,41,55
50,2954,Vistabella,34,19,15
50,2967,Zaida (La),614,307,307
50,2973,Zaragoza,603367,290375,312992
50,2989,Zuera,5404,2775,2629
51,13,Ceuta,72117,36102,36015
52,18,Melilla,60108,30569,29539
