CPRO,PROVINCIA,CMUN,MUNICIPIO,AMBOS SEXOS,VARONES,MUJERES
1,Álava,1,Alegría-Dulantzi,2189,1144,1045
1,Álava,2,Amurrio,9632,4822,4810
1,Álava,49,Añana,182,96,86
1,Álava,3,Aramaio,1490,788,702
1,Álava,6,Armiñón,179,94,85
1,Álava,37,Arraia-Maeztu,728,399,329
1,Álava,8,Arrazua-Ubarrundia,862,456,406
1,Álava,4,Artziniega,1631,808,823
1,Álava,9,Asparrena,1583,794,789
1,Álava,10,Ayala/Aiara,2625,1333,1292
1,Álava,11,Baños de Ebro/Mañueta,367,210,157
1,Álava,13,Barrundia,795,441,354
1,Álava,14,Berantevilla,442,229,213
1,Álava,16,Bernedo,569,329,240
1,Álava,17,Campezo/Kanpezu,1075,578,497
1,Álava,21,Elburgo/Burgelu,480,249,231
1,Álava,22,Elciego,932,470,462
1,Álava,23,Elvillar/Bilar,350,181,169
1,Álava,56,Harana/Valle de Arana,329,189,140
1,Álava,901,Iruña Oka/Iruña de Oca,2437,1283,1154
1,Álava,27,Iruraiz-Gauna,474,253,221
1,Álava,19,Kripan,188,103,85
1,Álava,20,Kuartango,364,209,155
1,Álava,28,Labastida,1434,770,664
1,Álava,30,Lagrán,191,105,86
1,Álava,31,Laguardia,1485,779,706
1,Álava,32,Lanciego/Lantziego,673,343,330
1,Álava,902,Lantarón,957,528,429
1,Álava,33,Lapuebla de Labarca,842,434,408
1,Álava,36,Laudio/Llodio,18478,9184,9294
1,Álava,58,Legutiano,1517,795,722
1,Álava,34,Leza,222,123,99
1,Álava,39,Moreda de Álava,274,133,141
1,Álava,41,Navaridas,211,110,101
1,Álava,42,Okondo,1032,538,494
1,Álava,43,Oyón-Oion,2929,1486,1443
1,Álava,44,Peñacerrada-Urizaharra,260,141,119
1,Álava,46,Ribera Alta,602,343,259
1,Álava,47,Ribera Baja/Erribera Beitia,1098,611,487
1,Álava,51,Salvatierra/Agurain,4217,2122,2095
1,Álava,52,Samaniego,308,162,146
1,Álava,53,San Millán/Donemiliaga,716,401,315
1,Álava,54,Urkabustaiz,1048,555,493
1,Álava,55,Valdegovía,1076,592,484
1,Álava,57,Villabuena de Álava/Eskuernaga,325,164,161
1,Álava,59,Vitoria-Gasteiz,227568,112028,115540
1,Álava,60,Yécora/Iekora,286,145,141
1,Álava,61,Zalduondo,176,90,86
1,Álava,62,Zambrana,362,199,163
1,Álava,18,Zigoitia,1407,762,645
1,Álava,63,Zuia,2329,1196,1133
2,Albacete,1,Abengibre,960,476,484
2,Albacete,2,Alatoz,592,322,270
2,Albacete,3,Albacete,161508,79498,82010
2,Albacete,4,Albatana,849,421,428
2,Albacete,5,Alborea,797,410,387
2,Albacete,6,Alcadozo,756,393,363
2,Albacete,7,Alcalá del Júcar,1386,723,663
2,Albacete,8,Alcaraz,1722,850,872
2,Albacete,9,Almansa,25075,12365,12710
2,Albacete,10,Alpera,2392,1254,1138
2,Albacete,11,Ayna,877,463,414
2,Albacete,12,Balazote,2406,1236,1170
2,Albacete,14,Ballestero (El),507,261,246
2,Albacete,13,Balsa de Ves,227,113,114
2,Albacete,15,Barrax,1925,963,962
2,Albacete,16,Bienservida,777,393,384
2,Albacete,17,Bogarra,1080,567,513
2,Albacete,18,Bonete,1289,676,613
2,Albacete,19,Bonillo (El),3164,1609,1555
2,Albacete,20,Carcelén,639,344,295
2,Albacete,21,Casas de Juan Núñez,1358,728,630
2,Albacete,22,Casas de Lázaro,442,236,206
2,Albacete,23,Casas de Ves,800,417,383
2,Albacete,24,Casas-Ibáñez,4493,2298,2195
2,Albacete,25,Caudete,9744,4956,4788
2,Albacete,26,Cenizate,1268,666,602
2,Albacete,29,Chinchilla de Monte-Aragón,3507,1860,1647
2,Albacete,27,Corral-Rubio,421,212,209
2,Albacete,28,Cotillas,164,82,82
2,Albacete,30,Elche de la Sierra,3895,1950,1945
2,Albacete,31,Férez,773,392,381
2,Albacete,32,Fuensanta,369,203,166
2,Albacete,33,Fuente-Álamo,2776,1484,1292
2,Albacete,34,Fuentealbilla,1925,987,938
2,Albacete,35,Gineta (La),2189,1117,1072
2,Albacete,36,Golosalvo,106,51,55
2,Albacete,37,Hellín,30024,15049,14975
2,Albacete,38,Herrera (La),351,178,173
2,Albacete,39,Higueruela,1346,683,663
2,Albacete,40,Hoya-Gonzalo,808,415,393
2,Albacete,41,Jorquera,494,253,241
2,Albacete,42,Letur,1186,589,597
2,Albacete,43,Lezuza,1715,886,829
2,Albacete,44,Liétor,1520,774,746
2,Albacete,45,Madrigueras,4742,2431,2311
2,Albacete,46,Mahora,1370,678,692
2,Albacete,47,Masegoso,104,60,44
2,Albacete,48,Minaya,1773,942,831
2,Albacete,49,Molinicos,1139,588,551
2,Albacete,50,Montalvos,131,68,63
2,Albacete,51,Montealegre del Castillo,2320,1187,1133
2,Albacete,52,Motilleja,535,273,262
2,Albacete,53,Munera,3921,1986,1935
2,Albacete,54,Navas de Jorquera,531,274,257
2,Albacete,55,Nerpio,1605,870,735
2,Albacete,56,Ontur,2426,1204,1222
2,Albacete,57,Ossa de Montiel,2788,1378,1410
2,Albacete,58,Paterna del Madera,468,244,224
2,Albacete,60,Peñas de San Pedro,1237,674,563
2,Albacete,59,Peñascosa,383,193,190
2,Albacete,61,Pétrola,835,426,409
2,Albacete,62,Povedilla,611,322,289
2,Albacete,901,Pozo Cañada,2726,1353,1373
2,Albacete,63,Pozohondo,1833,950,883
2,Albacete,64,Pozo-Lorente,477,239,238
2,Albacete,65,Pozuelo,656,345,311
2,Albacete,66,Recueja (La),320,151,169
2,Albacete,67,Riópar,1463,748,715
2,Albacete,68,Robledo,461,234,227
2,Albacete,69,Roda (La),15288,7761,7527
2,Albacete,70,Salobre,603,307,296
2,Albacete,71,San Pedro,1252,650,602
2,Albacete,72,Socovos,1929,1006,923
2,Albacete,73,Tarazona de la Mancha,6493,3317,3176
2,Albacete,74,Tobarra,7907,4063,3844
2,Albacete,75,Valdeganga,1908,963,945
2,Albacete,76,Vianos,447,219,228
2,Albacete,77,Villa de Ves,75,34,41
2,Albacete,78,Villalgordo del Júcar,1246,633,613
2,Albacete,79,Villamalea,3986,2059,1927
2,Albacete,80,Villapalacios,719,359,360
2,Albacete,81,Villarrobledo,25485,12849,12636
2,Albacete,82,Villatoya,160,85,75
2,Albacete,83,Villavaliente,280,147,133
2,Albacete,84,Villaverde de Guadalimar,445,237,208
2,Albacete,85,Viveros,459,242,217
2,Albacete,86,Yeste,3519,1796,1723
3,Alicante/Alacant,1,Adsubia,627,317,310
3,Alicante/Alacant,2,Agost,4723,2391,2332
3,Alicante/Alacant,3,Agres,614,329,285
3,Alicante/Alacant,4,Aigües,827,421,406
3,Alicante/Alacant,5,Albatera,10878,5625,5253
3,Alicante/Alacant,6,Alcalalí,1418,738,680
3,Alicante/Alacant,7,Alcocer de Planes,194,92,102
3,Alicante/Alacant,8,Alcoleja,213,103,110
3,Alicante/Alacant,9,Alcoy/Alcoi,60590,29382,31208
3,Alicante/Alacant,10,Alfafara,422,206,216
3,Alicante/Alacant,11,Alfàs del Pi (l'),18469,9282,9187
3,Alicante/Alacant,12,Algorfa,2914,1463,1451
3,Alicante/Alacant,13,Algueña,1528,745,783
3,Alicante/Alacant,14,Alicante/Alacant,322431,156772,165659
3,Alicante/Alacant,15,Almoradí,17494,9052,8442
3,Alicante/Alacant,16,Almudaina,119,66,53
3,Alicante/Alacant,17,Alqueria d'Asnar (l'),453,225,228
3,Alicante/Alacant,18,Altea,21898,10942,10956
3,Alicante/Alacant,19,Aspe,18821,9539,9282
3,Alicante/Alacant,20,Balones,160,77,83
3,Alicante/Alacant,21,Banyeres de Mariola,7237,3625,3612
3,Alicante/Alacant,22,Benasau,210,100,110
3,Alicante/Alacant,23,Beneixama,1802,901,901
3,Alicante/Alacant,24,Benejúzar,5306,2690,2616
3,Alicante/Alacant,25,Benferri,1493,771,722
3,Alicante/Alacant,26,Beniarbeig,1615,801,814
3,Alicante/Alacant,27,Beniardá,208,108,100
3,Alicante/Alacant,28,Beniarrés,1324,664,660
3,Alicante/Alacant,30,Benidoleig,1113,541,572
3,Alicante/Alacant,31,Benidorm,67627,34062,33565
3,Alicante/Alacant,32,Benifallim,127,57,70
3,Alicante/Alacant,33,Benifato,175,91,84
3,Alicante/Alacant,29,Benigembla,563,293,270
3,Alicante/Alacant,34,Benijófar,3541,1754,1787
3,Alicante/Alacant,35,Benilloba,847,419,428
3,Alicante/Alacant,36,Benillup,98,46,52
3,Alicante/Alacant,37,Benimantell,468,227,241
3,Alicante/Alacant,38,Benimarfull,433,212,221
3,Alicante/Alacant,39,Benimassot,137,81,56
3,Alicante/Alacant,40,Benimeli,389,190,199
3,Alicante/Alacant,41,Benissa,12424,6315,6109
3,Alicante/Alacant,42,Benitachell/Poble Nou de Benitatxell (el),4276,2181,2095
3,Alicante/Alacant,43,Biar,3647,1800,1847
3,Alicante/Alacant,44,Bigastro,6303,3218,3085
3,Alicante/Alacant,45,Bolulla,390,200,190
3,Alicante/Alacant,46,Busot,2643,1335,1308
3,Alicante/Alacant,49,Callosa de Segura,17366,8885,8481
3,Alicante/Alacant,48,Callosa d'En Sarrià,7939,4148,3791
3,Alicante/Alacant,47,Calpe/Calp,26382,13565,12817
3,Alicante/Alacant,50,Campello (el),24674,12215,12459
3,Alicante/Alacant,51,Campo de Mirra/Camp de Mirra (el),409,201,208
3,Alicante/Alacant,52,Cañada,1203,580,623
3,Alicante/Alacant,53,Castalla,9331,4728,4603
3,Alicante/Alacant,54,Castell de Castells,487,239,248
3,Alicante/Alacant,75,Castell de Guadalest (el),204,103,101
3,Alicante/Alacant,55,Catral,7530,3829,3701
3,Alicante/Alacant,56,Cocentaina,11143,5514,5629
3,Alicante/Alacant,57,Confrides,256,139,117
3,Alicante/Alacant,58,Cox,6464,3305,3159
3,Alicante/Alacant,59,Crevillent,27815,14341,13474
3,Alicante/Alacant,61,Daya Nueva,1676,852,824
3,Alicante/Alacant,62,Daya Vieja,354,182,172
3,Alicante/Alacant,63,Dénia,41591,20823,20768
3,Alicante/Alacant,64,Dolores,6786,3487,3299
3,Alicante/Alacant,65,Elche/Elx,219032,109595,109437
3,Alicante/Alacant,66,Elda,55138,27054,28084
3,Alicante/Alacant,67,Facheca,93,48,45
3,Alicante/Alacant,68,Famorca,54,25,29
3,Alicante/Alacant,69,Finestrat,4172,2131,2041
3,Alicante/Alacant,77,Fondó de les Neus (el),2312,1161,1151
3,Alicante/Alacant,70,Formentera del Segura,3173,1627,1546
3,Alicante/Alacant,72,Gaianes,347,172,175
3,Alicante/Alacant,71,Gata de Gorgos,5551,2860,2691
3,Alicante/Alacant,73,Gorga,250,131,119
3,Alicante/Alacant,74,Granja de Rocamora,2093,1082,1011
3,Alicante/Alacant,76,Guardamar del Segura,14261,7230,7031
3,Alicante/Alacant,78,Hondón de los Frailes,1109,570,539
3,Alicante/Alacant,79,Ibi,23360,11673,11687
3,Alicante/Alacant,80,Jacarilla,1813,904,909
3,Alicante/Alacant,81,Jalón/Xaló,2946,1480,1466
3,Alicante/Alacant,82,Jávea/Xàbia,29279,14851,14428
3,Alicante/Alacant,83,Jijona/Xixona,7596,3664,3932
3,Alicante/Alacant,85,Llíber,950,478,472
3,Alicante/Alacant,84,Lorcha/Orxa (l'),743,369,374
3,Alicante/Alacant,86,Millena,186,88,98
3,Alicante/Alacant,88,Monforte del Cid,6157,3225,2932
3,Alicante/Alacant,89,Monóvar/Monòver,12841,6386,6455
3,Alicante/Alacant,903,Montesinos (Los),3654,1851,1803
3,Alicante/Alacant,91,Murla,562,259,303
3,Alicante/Alacant,92,Muro de Alcoy,8446,4191,4255
3,Alicante/Alacant,90,Mutxamel,19264,9706,9558
3,Alicante/Alacant,93,Novelda,26335,13115,13220
3,Alicante/Alacant,94,Nucia (la),14006,7155,6851
3,Alicante/Alacant,95,Ondara,6004,3027,2977
3,Alicante/Alacant,96,Onil,7466,3721,3745
3,Alicante/Alacant,97,Orba,2361,1162,1199
3,Alicante/Alacant,99,Orihuela,77979,39589,38390
3,Alicante/Alacant,98,Orxeta,719,363,356
3,Alicante/Alacant,100,Parcent,1019,506,513
3,Alicante/Alacant,101,Pedreguer,6857,3422,3435
3,Alicante/Alacant,102,Pego,10721,5534,5187
3,Alicante/Alacant,103,Penàguila,334,171,163
3,Alicante/Alacant,104,Petrer,33026,16517,16509
3,Alicante/Alacant,902,Pilar de la Horadada,19578,10377,9201
3,Alicante/Alacant,105,Pinós (el)/Pinoso,7315,3702,3613
3,Alicante/Alacant,106,Planes,799,406,393
3,Alicante/Alacant,901,Poblets (els),2865,1385,1480
3,Alicante/Alacant,107,Polop,3636,1850,1786
3,Alicante/Alacant,60,Quatretondeta,145,71,74
3,Alicante/Alacant,109,Rafal,3805,1959,1846
3,Alicante/Alacant,110,"Ràfol d'Almúnia, el",588,289,299
3,Alicante/Alacant,111,Redován,6825,3491,3334
3,Alicante/Alacant,112,Relleu,1046,531,515
3,Alicante/Alacant,113,Rojales,15987,8234,7753
3,Alicante/Alacant,114,Romana (la),2407,1243,1164
3,Alicante/Alacant,115,Sagra,464,224,240
3,Alicante/Alacant,116,Salinas,1498,773,725
3,Alicante/Alacant,118,San Fulgencio,9597,4866,4731
3,Alicante/Alacant,904,San Isidro,1401,725,676
3,Alicante/Alacant,120,San Miguel de Salinas,7104,3632,3472
3,Alicante/Alacant,122,San Vicente del Raspeig/Sant Vicent del Raspeig,47706,23820,23886
3,Alicante/Alacant,117,Sanet y Negrals,684,329,355
3,Alicante/Alacant,119,Sant Joan d'Alacant,20430,9989,10441
3,Alicante/Alacant,121,Santa Pola,27521,13823,13698
3,Alicante/Alacant,123,Sax,9577,4819,4758
3,Alicante/Alacant,124,Sella,650,332,318
3,Alicante/Alacant,125,Senija,649,358,291
3,Alicante/Alacant,127,Tàrbena,751,383,368
3,Alicante/Alacant,128,Teulada,12745,6493,6252
3,Alicante/Alacant,129,Tibi,1572,819,753
3,Alicante/Alacant,130,Tollos,43,23,20
3,Alicante/Alacant,131,Tormos,346,171,175
3,Alicante/Alacant,132,Torremanzanas/Torre de les Maçanes (la),733,374,359
3,Alicante/Alacant,133,Torrevieja,92034,47714,44320
3,Alicante/Alacant,134,Vall d'Alcalà (la),179,86,93
3,Alicante/Alacant,135,Vall de Ebo,309,147,162
3,Alicante/Alacant,136,Vall de Gallinera,623,338,285
3,Alicante/Alacant,137,Vall de Laguar (la),948,442,506
3,Alicante/Alacant,138,Verger (el),4538,2328,2210
3,Alicante/Alacant,139,Villajoyosa/Vila Joiosa (la),29263,14640,14623
3,Alicante/Alacant,140,Villena,34186,16998,17188
4,Almería,1,Abla,1505,757,748
4,Almería,2,Abrucena,1339,673,666
4,Almería,3,Adra,23545,11909,11636
4,Almería,4,Albánchez,660,334,326
4,Almería,5,Alboloduy,727,351,376
4,Almería,6,Albox,11000,5816,5184
4,Almería,7,Alcolea,967,502,465
4,Almería,8,Alcóntar,617,323,294
4,Almería,9,Alcudia de Monteagud,142,68,74
4,Almería,10,Alhabia,703,343,360
4,Almería,11,Alhama de Almería,3522,1778,1744
4,Almería,12,Alicún,258,133,125
4,Almería,13,Almería,185309,91235,94074
4,Almería,14,Almócita,156,83,73
4,Almería,15,Alsodux,131,68,63
4,Almería,16,Antas,3157,1598,1559
4,Almería,17,Arboleas,3402,1785,1617
4,Almería,18,Armuña de Almanzora,321,162,159
4,Almería,19,Bacares,290,149,141
4,Almería,20,Bayárcal,277,148,129
4,Almería,21,Bayarque,237,122,115
4,Almería,22,Bédar,824,427,397
4,Almería,23,Beires,128,64,64
4,Almería,24,Benahadux,3396,1674,1722
4,Almería,26,Benitagla,66,36,30
4,Almería,27,Benizalón,295,149,146
4,Almería,28,Bentarique,284,147,137
4,Almería,29,Berja,14450,7209,7241
4,Almería,30,Canjáyar,1561,806,755
4,Almería,31,Cantoria,3703,1893,1810
4,Almería,32,Carboneras,7508,3910,3598
4,Almería,33,Castro de Filabres,155,80,75
4,Almería,36,Chercos,300,157,143
4,Almería,37,Chirivel,1845,906,939
4,Almería,34,Cóbdar,192,100,92
4,Almería,35,Cuevas del Almanzora,11422,5926,5496
4,Almería,38,Dalías,3807,1875,1932
4,Almería,902,Ejido (El),75969,42968,33001
4,Almería,41,Enix,335,180,155
4,Almería,43,Felix,513,265,248
4,Almería,44,Fines,2106,1143,963
4,Almería,45,Fiñana,2422,1219,1203
4,Almería,46,Fondón,950,491,459
4,Almería,47,Gádor,2959,1535,1424
4,Almería,48,Gallardos (Los),3126,1614,1512
4,Almería,49,Garrucha,7398,3810,3588
4,Almería,50,Gérgal,1042,547,495
4,Almería,51,Huécija,533,268,265
4,Almería,52,Huércal de Almería,11816,6028,5788
4,Almería,53,Huércal-Overa,16170,8038,8132
4,Almería,54,Illar,410,205,205
4,Almería,55,Instinción,508,251,257
4,Almería,56,Laroya,128,70,58
4,Almería,57,Láujar de Andarax,1798,893,905
4,Almería,58,Líjar,498,259,239
4,Almería,59,Lubrín,1733,843,890
4,Almería,60,Lucainena de las Torres,676,388,288
4,Almería,61,Lúcar,806,400,406
4,Almería,62,Macael,6055,3129,2926
4,Almería,63,María,1532,774,758
4,Almería,64,Mojácar,6406,3282,3124
4,Almería,903,Mojonera (La),7847,4332,3515
4,Almería,65,Nacimiento,452,237,215
4,Almería,66,Níjar,26070,15224,10846
4,Almería,67,Ohanes,765,387,378
4,Almería,68,Olula de Castro,191,100,91
4,Almería,69,Olula del Río,6405,3273,3132
4,Almería,70,Oria,2619,1367,1252
4,Almería,71,Padules,523,276,247
4,Almería,72,Partaloa,679,328,351
4,Almería,73,Paterna del Río,406,223,183
4,Almería,74,Pechina,3463,1775,1688
4,Almería,75,Pulpí,7537,3967,3570
4,Almería,76,Purchena,1653,820,833
4,Almería,77,Rágol,365,173,192
4,Almería,78,Rioja,1363,684,679
4,Almería,79,Roquetas de Mar,71740,37934,33806
4,Almería,80,Santa Cruz de Marchena,245,123,122
4,Almería,81,Santa Fe de Mondújar,468,235,233
4,Almería,82,Senés,331,172,159
4,Almería,83,Serón,2422,1204,1218
4,Almería,84,Sierro,472,236,236
4,Almería,85,Somontín,529,266,263
4,Almería,86,Sorbas,2836,1485,1351
4,Almería,87,Suflí,253,136,117
4,Almería,88,Tabernas,3494,1829,1665
4,Almería,89,Taberno,1106,549,557
4,Almería,90,Tahal,416,213,203
4,Almería,91,Terque,440,224,216
4,Almería,92,Tíjola,3877,1941,1936
4,Almería,901,Tres Villas (Las),581,308,273
4,Almería,93,Turre,3045,1575,1470
4,Almería,94,Turrillas,249,142,107
4,Almería,95,Uleila del Campo,1003,523,480
4,Almería,96,Urrácal,347,167,180
4,Almería,97,Velefique,250,131,119
4,Almería,98,Vélez-Blanco,2165,1131,1034
4,Almería,99,Vélez-Rubio,7025,3434,3591
4,Almería,100,Vera,11159,5747,5412
4,Almería,101,Viator,4288,2165,2123
4,Almería,102,Vícar,20220,11089,9131
4,Almería,103,Zurgena,2461,1211,1250
5,Ávila,1,Adanero,326,161,165
5,Ávila,2,Adrada (La),2385,1231,1154
5,Ávila,5,Albornos,240,130,110
5,Ávila,7,Aldeanueva de Santa Cruz,163,90,73
5,Ávila,8,Aldeaseca,291,144,147
5,Ávila,10,Aldehuela (La),222,108,114
5,Ávila,12,Amavida,185,95,90
5,Ávila,13,Arenal (El),1088,541,547
5,Ávila,14,Arenas de San Pedro,6682,3260,3422
5,Ávila,15,Arevalillo,121,58,63
5,Ávila,16,Arévalo,7835,3798,4037
5,Ávila,17,Aveinte,104,55,49
5,Ávila,18,Avellaneda,32,15,17
5,Ávila,19,Ávila,53272,25539,27733
5,Ávila,21,Barco de Ávila (El),2673,1294,1379
5,Ávila,22,Barraco (El),2129,1070,1059
5,Ávila,23,Barromán,223,123,100
5,Ávila,24,Becedas,330,170,160
5,Ávila,25,Becedillas,147,80,67
5,Ávila,26,Bercial de Zapardiel,265,130,135
5,Ávila,27,Berlanas (Las),342,191,151
5,Ávila,29,Bernuy-Zapardiel,166,97,69
5,Ávila,30,Berrocalejo de Aragona,53,30,23
5,Ávila,33,Blascomillán,254,115,139
5,Ávila,34,Blasconuño de Matacabras,20,9,11
5,Ávila,35,Blascosancho,132,65,67
5,Ávila,36,Bohodón (El),168,86,82
5,Ávila,37,Bohoyo,399,207,192
5,Ávila,38,Bonilla de la Sierra,152,84,68
5,Ávila,39,Brabos,62,34,28
5,Ávila,40,Bularros,98,55,43
5,Ávila,41,Burgohondo,1264,641,623
5,Ávila,42,Cabezas de Alambre,187,94,93
5,Ávila,43,Cabezas del Pozo,116,62,54
5,Ávila,44,Cabezas del Villar,399,220,179
5,Ávila,45,Cabizuela,129,62,67
5,Ávila,46,Canales,57,30,27
5,Ávila,47,Candeleda,5137,2648,2489
5,Ávila,48,Cantiveros,176,89,87
5,Ávila,49,Cardeñosa,533,281,252
5,Ávila,51,Carrera (La),230,118,112
5,Ávila,52,Casas del Puerto,106,55,51
5,Ávila,53,Casasola,124,66,58
5,Ávila,54,Casavieja,1590,812,778
5,Ávila,55,Casillas,815,429,386
5,Ávila,56,Castellanos de Zapardiel,131,73,58
5,Ávila,57,Cebreros,3370,1706,1664
5,Ávila,58,Cepeda la Mora,108,58,50
5,Ávila,67,Chamartín,99,59,40
5,Ávila,59,Cillán,128,74,54
5,Ávila,60,Cisla,175,85,90
5,Ávila,61,Colilla (La),279,140,139
5,Ávila,62,Collado de Contreras,246,134,112
5,Ávila,63,Collado del Mirón,56,28,28
5,Ávila,64,Constanzana,147,82,65
5,Ávila,65,Crespos,612,314,298
5,Ávila,66,Cuevas del Valle,559,301,258
5,Ávila,903,Diego del Carpio,230,124,106
5,Ávila,69,Donjimeno,116,63,53
5,Ávila,70,Donvidas,62,32,30
5,Ávila,72,Espinosa de los Caballeros,110,63,47
5,Ávila,73,Flores de Ávila,384,206,178
5,Ávila,74,Fontiveros,918,469,449
5,Ávila,75,Fresnedilla,102,42,60
5,Ávila,76,Fresno (El),519,266,253
5,Ávila,77,Fuente el Saúz,251,133,118
5,Ávila,78,Fuentes de Año,162,87,75
5,Ávila,79,Gallegos de Altamiros,87,52,35
5,Ávila,80,Gallegos de Sobrinos,91,44,47
5,Ávila,81,Garganta del Villar,56,32,24
5,Ávila,82,Gavilanes,675,370,305
5,Ávila,83,Gemuño,184,87,97
5,Ávila,85,Gil García,47,23,24
5,Ávila,84,Gilbuena,96,54,42
5,Ávila,86,Gimialcón,102,59,43
5,Ávila,87,Gotarrendura,189,70,119
5,Ávila,88,Grandes y San Martín,46,24,22
5,Ávila,89,Guisando,620,320,300
5,Ávila,90,Gutierre-Muñoz,112,53,59
5,Ávila,92,Hernansancho,215,113,102
5,Ávila,93,Herradón de Pinares,578,306,272
5,Ávila,94,Herreros de Suso,188,94,94
5,Ávila,95,Higuera de las Dueñas,321,185,136
5,Ávila,96,Hija de Dios (La),78,44,34
5,Ávila,97,Horcajada (La),672,329,343
5,Ávila,99,Horcajo de las Torres,679,376,303
5,Ávila,100,Hornillo (El),390,194,196
5,Ávila,102,Hoyo de Pinares (El),2369,1240,1129
5,Ávila,101,Hoyocasero,340,173,167
5,Ávila,103,Hoyorredondo,105,59,46
5,Ávila,106,Hoyos de Miguel Muñoz,46,22,24
5,Ávila,104,Hoyos del Collado,39,23,16
5,Ávila,105,Hoyos del Espino,463,254,209
5,Ávila,107,Hurtumpascual,96,57,39
5,Ávila,108,Junciana,83,46,37
5,Ávila,109,Langa,560,290,270
5,Ávila,110,Lanzahíta,970,522,448
5,Ávila,113,Llanos de Tormes (Los),108,53,55
5,Ávila,112,Losar del Barco (El),118,60,58
5,Ávila,114,Madrigal de las Altas Torres,1784,909,875
5,Ávila,115,Maello,686,368,318
5,Ávila,116,Malpartida de Corneja,176,89,87
5,Ávila,117,Mamblas,252,141,111
5,Ávila,118,Mancera de Arriba,110,57,53
5,Ávila,119,Manjabálago,48,25,23
5,Ávila,120,Marlín,41,24,17
5,Ávila,121,Martiherrero,273,144,129
5,Ávila,122,Martínez,187,100,87
5,Ávila,123,Mediana de Voltoya,107,55,52
5,Ávila,124,Medinilla,156,73,83
5,Ávila,125,Mengamuñoz,66,32,34
5,Ávila,126,Mesegar de Corneja,100,50,50
5,Ávila,127,Mijares,874,448,426
5,Ávila,128,Mingorría,467,247,220
5,Ávila,129,Mirón (El),198,111,87
5,Ávila,130,Mironcillo,124,67,57
5,Ávila,131,Mirueña de los Infanzones,143,74,69
5,Ávila,132,Mombeltrán,1145,603,542
5,Ávila,133,Monsalupe,71,32,39
5,Ávila,134,Moraleja de Matacabras,62,35,27
5,Ávila,135,Muñana,543,274,269
5,Ávila,136,Muñico,127,67,60
5,Ávila,138,Muñogalindo,423,232,191
5,Ávila,139,Muñogrande,87,46,41
5,Ávila,140,Muñomer del Peco,128,65,63
5,Ávila,141,Muñopepe,108,62,46
5,Ávila,142,Muñosancho,132,63,69
5,Ávila,143,Muñotello,106,57,49
5,Ávila,144,Narrillos del Álamo,122,63,59
5,Ávila,145,Narrillos del Rebollar,63,34,29
5,Ávila,149,Narros de Saldueña,141,78,63
5,Ávila,147,Narros del Castillo,195,107,88
5,Ávila,148,Narros del Puerto,37,19,18
5,Ávila,152,Nava de Arévalo,928,486,442
5,Ávila,153,Nava del Barco,133,69,64
5,Ávila,151,Navacepedilla de Corneja,135,76,59
5,Ávila,154,Navadijos,54,33,21
5,Ávila,155,Navaescurial,74,44,30
5,Ávila,156,Navahondilla,271,153,118
5,Ávila,157,Navalacruz,264,126,138
5,Ávila,158,Navalmoral,471,245,226
5,Ávila,159,Navalonguilla,378,192,186
5,Ávila,160,Navalosa,433,235,198
5,Ávila,161,Navalperal de Pinares,961,491,470
5,Ávila,162,Navalperal de Tormes,131,71,60
5,Ávila,163,Navaluenga,2198,1104,1094
5,Ávila,164,Navaquesera,38,16,22
5,Ávila,165,Navarredonda de Gredos,469,239,230
5,Ávila,166,Navarredondilla,273,135,138
5,Ávila,167,Navarrevisca,376,192,184
5,Ávila,168,Navas del Marqués (Las),5098,2631,2467
5,Ávila,169,Navatalgordo,294,156,138
5,Ávila,170,Navatejares,73,33,40
5,Ávila,171,Neila de San Miguel,96,51,45
5,Ávila,172,Niharra,178,92,86
5,Ávila,173,Ojos-Albos,59,35,24
5,Ávila,174,Orbita,97,46,51
5,Ávila,175,Oso (El),199,112,87
5,Ávila,176,Padiernos,243,129,114
5,Ávila,177,Pajares de Adaja,176,90,86
5,Ávila,178,Palacios de Goda,476,241,235
5,Ávila,179,Papatrigo,283,149,134
5,Ávila,180,Parral (El),121,66,55
5,Ávila,181,Pascualcobo,42,23,19
5,Ávila,182,Pedro Bernardo,1136,593,543
5,Ávila,183,Pedro-Rodríguez,204,97,107
5,Ávila,184,Peguerinos,318,169,149
5,Ávila,185,Peñalba de Ávila,125,71,54
5,Ávila,186,Piedrahíta,1948,954,994
5,Ávila,187,Piedralaves,2169,1110,1059
5,Ávila,188,Poveda,81,48,33
5,Ávila,189,Poyales del Hoyo,598,301,297
5,Ávila,190,Pozanco,53,32,21
5,Ávila,191,Pradosegar,179,101,78
5,Ávila,192,Puerto Castilla,140,80,60
5,Ávila,193,Rasueros,275,145,130
5,Ávila,194,Riocabado,181,103,78
5,Ávila,195,Riofrío,299,167,132
5,Ávila,196,Rivilla de Barajas,83,40,43
5,Ávila,197,Salobral,117,61,56
5,Ávila,198,Salvadiós,102,49,53
5,Ávila,199,San Bartolomé de Béjar,53,27,26
5,Ávila,200,San Bartolomé de Corneja,64,32,32
5,Ávila,201,San Bartolomé de Pinares,684,360,324
5,Ávila,206,San Esteban de los Patos,30,16,14
5,Ávila,208,San Esteban de Zapardiel,56,32,24
5,Ávila,207,San Esteban del Valle,890,459,431
5,Ávila,209,San García de Ingelmos,129,73,56
5,Ávila,901,San Juan de Gredos,382,207,175
5,Ávila,210,San Juan de la Encinilla,124,61,63
5,Ávila,211,San Juan de la Nava,603,310,293
5,Ávila,212,San Juan del Molinillo,329,189,140
5,Ávila,213,San Juan del Olmo,144,81,63
5,Ávila,214,San Lorenzo de Tormes,54,26,28
5,Ávila,215,San Martín de la Vega del Alberche,244,144,100
5,Ávila,216,San Martín del Pimpollar,270,147,123
5,Ávila,217,San Miguel de Corneja,94,44,50
5,Ávila,218,San Miguel de Serrezuela,178,97,81
5,Ávila,219,San Pascual,52,35,17
5,Ávila,220,San Pedro del Arroyo,471,241,230
5,Ávila,231,San Vicente de Arévalo,217,111,106
5,Ávila,204,Sanchidrián,773,388,385
5,Ávila,205,Sanchorreja,121,56,65
5,Ávila,222,Santa Cruz de Pinares,196,106,90
5,Ávila,221,Santa Cruz del Valle,534,271,263
5,Ávila,226,Santa María de los Caballeros,112,60,52
5,Ávila,224,Santa María del Arroyo,114,61,53
5,Ávila,225,Santa María del Berrocal,486,233,253
5,Ávila,902,Santa María del Cubillo,373,211,162
5,Ávila,227,Santa María del Tiétar,501,263,238
5,Ávila,228,Santiago del Collado,254,157,97
5,Ávila,904,Santiago del Tormes,178,90,88
5,Ávila,229,Santo Domingo de las Posadas,101,51,50
5,Ávila,230,Santo Tomé de Zabarcos,100,55,45
5,Ávila,232,Serrada (La),131,68,63
5,Ávila,233,Serranillos,327,173,154
5,Ávila,234,Sigeres,71,34,37
5,Ávila,235,Sinlabajos,174,97,77
5,Ávila,236,Solana de Ávila,186,99,87
5,Ávila,237,Solana de Rioalmar,256,136,120
5,Ávila,238,Solosancho,1002,526,476
5,Ávila,239,Sotalbo,266,139,127
5,Ávila,240,Sotillo de la Adrada,4413,2189,2224
5,Ávila,241,Tiemblo (El),4071,2089,1982
5,Ávila,242,Tiñosillos,794,410,384
5,Ávila,243,Tolbaños,106,50,56
5,Ávila,244,Tormellas,84,44,40
5,Ávila,245,Tornadizos de Ávila,410,199,211
5,Ávila,247,Torre (La),335,187,148
5,Ávila,246,Tórtoles,100,52,48
5,Ávila,249,Umbrías,135,71,64
5,Ávila,251,Vadillo de la Sierra,113,59,54
5,Ávila,252,Valdecasa,97,52,45
5,Ávila,253,Vega de Santa María,118,66,52
5,Ávila,254,Velayos,235,118,117
5,Ávila,256,Villaflor,148,77,71
5,Ávila,257,Villafranca de la Sierra,156,82,74
5,Ávila,905,Villanueva de Ávila,291,143,148
5,Ávila,258,Villanueva de Gómez,156,78,78
5,Ávila,259,Villanueva del Aceral,160,76,84
5,Ávila,260,Villanueva del Campillo,156,83,73
5,Ávila,261,Villar de Corneja,64,33,31
5,Ávila,262,Villarejo del Valle,463,235,228
5,Ávila,263,Villatoro,221,122,99
5,Ávila,264,Viñegra de Moraña,74,40,34
5,Ávila,265,Vita,100,62,38
5,Ávila,266,Zapardiel de la Cañada,144,71,73
5,Ávila,267,Zapardiel de la Ribera,129,64,65
6,Badajoz,1,Acedera,846,441,405
6,Badajoz,2,Aceuchal,5518,2767,2751
6,Badajoz,3,Ahillones,1084,534,550
6,Badajoz,4,Alange,2035,1048,987
6,Badajoz,5,Albuera (La),1833,927,906
6,Badajoz,6,Alburquerque,5656,2857,2799
6,Badajoz,7,Alconchel,1979,999,980
6,Badajoz,8,Alconera,741,371,370
6,Badajoz,9,Aljucén,245,133,112
6,Badajoz,10,Almendral,1316,641,675
6,Badajoz,11,Almendralejo,30741,15370,15371
6,Badajoz,12,Arroyo de San Serván,4138,2139,1999
6,Badajoz,13,Atalaya,340,160,180
6,Badajoz,14,Azuaga,8536,4328,4208
6,Badajoz,15,Badajoz,143748,69853,73895
6,Badajoz,16,Barcarrota,3518,1794,1724
6,Badajoz,17,Baterno,354,186,168
6,Badajoz,18,Benquerencia de la Serena,972,481,491
6,Badajoz,19,Berlanga,2564,1254,1310
6,Badajoz,20,Bienvenida,2336,1209,1127
6,Badajoz,21,Bodonal de la Sierra,1176,608,568
6,Badajoz,22,Burguillos del Cerro,3143,1503,1640
6,Badajoz,23,Cabeza del Buey,5559,2734,2825
6,Badajoz,24,Cabeza la Vaca,1542,779,763
6,Badajoz,25,Calamonte,6084,3025,3059
6,Badajoz,26,Calera de León,1100,556,544
6,Badajoz,27,Calzadilla de los Barros,854,420,434
6,Badajoz,28,Campanario,5502,2712,2790
6,Badajoz,29,Campillo de Llerena,1605,794,811
6,Badajoz,30,Capilla,198,99,99
6,Badajoz,31,Carmonita,610,310,300
6,Badajoz,32,Carrascalejo (El),83,42,41
6,Badajoz,33,Casas de Don Pedro,1545,774,771
6,Badajoz,34,Casas de Reina,184,86,98
6,Badajoz,35,Castilblanco,1110,537,573
6,Badajoz,36,Castuera,6645,3280,3365
6,Badajoz,42,Cheles,1302,640,662
6,Badajoz,37,Codosera (La),2269,1191,1078
6,Badajoz,38,Cordobilla de Lácara,1008,510,498
6,Badajoz,39,Coronada (La),2300,1134,1166
6,Badajoz,40,Corte de Peleas,1290,638,652
6,Badajoz,41,Cristina,565,300,265
6,Badajoz,43,Don Álvaro,681,340,341
6,Badajoz,44,Don Benito,34051,16851,17200
6,Badajoz,45,Entrín Bajo,596,297,299
6,Badajoz,46,Esparragalejo,1527,751,776
6,Badajoz,47,Esparragosa de la Serena,1113,556,557
6,Badajoz,48,Esparragosa de Lares,1068,528,540
6,Badajoz,49,Feria,1375,687,688
6,Badajoz,50,Fregenal de la Sierra,5275,2561,2714
6,Badajoz,51,Fuenlabrada de los Montes,1935,953,982
6,Badajoz,52,Fuente de Cantos,5050,2517,2533
6,Badajoz,53,Fuente del Arco,744,374,370
6,Badajoz,54,Fuente del Maestre,6900,3438,3462
6,Badajoz,55,Fuentes de León,2643,1307,1336
6,Badajoz,56,Garbayuela,531,289,242
6,Badajoz,57,Garlitos,710,367,343
6,Badajoz,58,Garrovilla (La),2387,1201,1186
6,Badajoz,59,Granja de Torrehermosa,2420,1180,1240
6,Badajoz,60,Guareña,7350,3707,3643
6,Badajoz,61,Haba (La),1397,706,691
6,Badajoz,62,Helechosa de los Montes,747,411,336
6,Badajoz,63,Herrera del Duque,3686,1864,1822
6,Badajoz,64,Higuera de la Serena,1086,559,527
6,Badajoz,65,Higuera de Llerena,387,192,195
6,Badajoz,66,Higuera de Vargas,2158,1088,1070
6,Badajoz,67,Higuera la Real,2514,1280,1234
6,Badajoz,68,Hinojosa del Valle,556,275,281
6,Badajoz,69,Hornachos,3829,1966,1863
6,Badajoz,70,Jerez de los Caballeros,9778,4867,4911
6,Badajoz,71,Lapa (La),307,158,149
6,Badajoz,73,Llera,951,491,460
6,Badajoz,74,Llerena,5836,2891,2945
6,Badajoz,72,Lobón,2646,1377,1269
6,Badajoz,75,Magacela,635,330,305
6,Badajoz,76,Maguilla,1099,538,561
6,Badajoz,77,Malcocinado,484,257,227
6,Badajoz,78,Malpartida de la Serena,700,362,338
6,Badajoz,79,Manchita,736,368,368
6,Badajoz,80,Medellín,2346,1189,1157
6,Badajoz,81,Medina de las Torres,1384,691,693
6,Badajoz,82,Mengabril,447,223,224
6,Badajoz,83,Mérida,53915,26240,27675
6,Badajoz,84,Mirandilla,1364,699,665
6,Badajoz,85,Monesterio,4355,2201,2154
6,Badajoz,86,Montemolín,1565,788,777
6,Badajoz,87,Monterrubio de la Serena,2841,1373,1468
6,Badajoz,88,Montijo,15648,7764,7884
6,Badajoz,89,Morera (La),766,378,388
6,Badajoz,90,Nava de Santiago (La),1129,569,560
6,Badajoz,91,Navalvillar de Pela,4770,2426,2344
6,Badajoz,92,Nogales,688,341,347
6,Badajoz,93,Oliva de la Frontera,5657,2806,2851
6,Badajoz,94,Oliva de Mérida,1871,930,941
6,Badajoz,95,Olivenza,11512,5735,5777
6,Badajoz,96,Orellana de la Sierra,315,173,142
6,Badajoz,97,Orellana la Vieja,3033,1525,1508
6,Badajoz,98,Palomas,703,358,345
6,Badajoz,99,Parra (La),1419,707,712
6,Badajoz,100,Peñalsordo,1327,649,678
6,Badajoz,101,Peraleda del Zaucejo,590,307,283
6,Badajoz,102,Puebla de Alcocer,1288,636,652
6,Badajoz,103,Puebla de la Calzada,5594,2768,2826
6,Badajoz,104,Puebla de la Reina,868,441,427
6,Badajoz,107,Puebla de Obando,2020,1013,1007
6,Badajoz,108,Puebla de Sancho Pérez,2893,1451,1442
6,Badajoz,105,Puebla del Maestre,817,400,417
6,Badajoz,106,Puebla del Prior,543,272,271
6,Badajoz,902,Pueblonuevo del Guadiana,1972,1006,966
6,Badajoz,109,Quintana de la Serena,5161,2599,2562
6,Badajoz,110,Reina,194,99,95
6,Badajoz,111,Rena,654,329,325
6,Badajoz,112,Retamal de Llerena,502,271,231
6,Badajoz,113,Ribera del Fresno,3292,1635,1657
6,Badajoz,114,Risco,176,84,92
6,Badajoz,115,Roca de la Sierra (La),1579,785,794
6,Badajoz,116,Salvaleón,2127,1072,1055
6,Badajoz,117,Salvatierra de los Barros,1845,926,919
6,Badajoz,119,San Pedro de Mérida,842,423,419
6,Badajoz,123,San Vicente de Alcántara,5825,2897,2928
6,Badajoz,118,Sancti-Spíritus,233,112,121
6,Badajoz,120,Santa Amalia,4414,2208,2206
6,Badajoz,121,Santa Marta,4236,2115,2121
6,Badajoz,122,Santos de Maimona (Los),8036,4027,4009
6,Badajoz,124,Segura de León,2191,1088,1103
6,Badajoz,125,Siruela,2214,1106,1108
6,Badajoz,126,Solana de los Barros,2714,1360,1354
6,Badajoz,127,Talarrubias,3628,1793,1835
6,Badajoz,128,Talavera la Real,5126,2580,2546
6,Badajoz,129,Táliga,677,345,332
6,Badajoz,130,Tamurejo,265,135,130
6,Badajoz,131,Torre de Miguel Sesmero,1206,607,599
6,Badajoz,132,Torremayor,1011,480,531
6,Badajoz,133,Torremejía,2184,1131,1053
6,Badajoz,134,Trasierra,701,372,329
6,Badajoz,135,Trujillanos,1368,707,661
6,Badajoz,136,Usagre,1996,1000,996
6,Badajoz,137,Valdecaballeros,1264,634,630
6,Badajoz,901,Valdelacalzada,2640,1373,1267
6,Badajoz,138,Valdetorres,1315,662,653
6,Badajoz,139,Valencia de las Torres,708,365,343
6,Badajoz,140,Valencia del Mombuey,798,396,402
6,Badajoz,141,Valencia del Ventoso,2218,1114,1104
6,Badajoz,146,Valle de la Serena,1474,728,746
6,Badajoz,147,Valle de Matamoros,440,212,228
6,Badajoz,148,Valle de Santa Ana,1196,612,584
6,Badajoz,142,Valverde de Burguillos,322,167,155
6,Badajoz,143,Valverde de Leganés,3959,1985,1974
6,Badajoz,144,Valverde de Llerena,744,356,388
6,Badajoz,145,Valverde de Mérida,1173,583,590
6,Badajoz,149,Villafranca de los Barros,13056,6478,6578
6,Badajoz,150,Villagarcía de la Torre,1003,508,495
6,Badajoz,151,Villagonzalo,1334,668,666
6,Badajoz,152,Villalba de los Barros,1704,870,834
6,Badajoz,153,Villanueva de la Serena,24932,12272,12660
6,Badajoz,154,Villanueva del Fresno,3564,1763,1801
6,Badajoz,156,Villar de Rena,1506,780,726
6,Badajoz,155,Villar del Rey,2517,1339,1178
6,Badajoz,157,Villarta de los Montes,597,294,303
6,Badajoz,158,Zafra,15706,7567,8139
6,Badajoz,159,Zahínos,2938,1483,1455
6,Badajoz,160,Zalamea de la Serena,4250,2127,2123
6,Badajoz,162,Zarza (La),3578,1812,1766
6,Badajoz,161,Zarza-Capilla,439,218,221
7,Illes Balears,2,Alaior,8933,4524,4409
7,Illes Balears,1,Alaró,4869,2417,2452
7,Illes Balears,3,Alcúdia,16176,8331,7845
7,Illes Balears,4,Algaida,4339,2248,2091
7,Illes Balears,5,Andratx,10410,5251,5159
7,Illes Balears,901,Ariany,766,404,362
7,Illes Balears,6,Artà,6730,3385,3345
7,Illes Balears,7,Banyalbufar,572,325,247
7,Illes Balears,8,Binissalem,6475,3304,3171
7,Illes Balears,9,Búger,1063,540,523
7,Illes Balears,10,Bunyola,5574,2804,2770
7,Illes Balears,11,Calvià,45284,22717,22567
7,Illes Balears,12,Campanet,2507,1251,1256
7,Illes Balears,13,Campos,8296,4180,4116
7,Illes Balears,14,Capdepera,11074,5593,5481
7,Illes Balears,64,Castell (Es),7475,3822,3653
7,Illes Balears,15,Ciutadella de Menorca,27468,13698,13770
7,Illes Balears,16,Consell,3045,1548,1497
7,Illes Balears,17,Costitx,976,476,500
7,Illes Balears,18,Deyá,708,379,329
7,Illes Balears,26,Eivissa,42884,21851,21033
7,Illes Balears,19,Escorca,307,179,128
7,Illes Balears,20,Esporles,4546,2255,2291
7,Illes Balears,21,Estellencs,399,211,188
7,Illes Balears,22,Felanitx,16948,8742,8206
7,Illes Balears,23,Ferreries,4476,2309,2167
7,Illes Balears,24,Formentera,7957,4203,3754
7,Illes Balears,25,Fornalutx,717,358,359
7,Illes Balears,27,Inca,27301,13855,13446
7,Illes Balears,28,Lloret de Vistalegre,1149,577,572
7,Illes Balears,29,Lloseta,5375,2791,2584
7,Illes Balears,30,Llubí,2042,1022,1020
7,Illes Balears,31,Llucmajor,31381,15908,15473
7,Illes Balears,32,Mahón,27893,13854,14039
7,Illes Balears,33,Manacor,37165,18737,18428
7,Illes Balears,34,Mancor de la Vall,991,492,499
7,Illes Balears,35,Maria de la Salut,2141,1110,1031
7,Illes Balears,36,Marratxí,29742,15121,14621
7,Illes Balears,37,Mercadal (Es),4504,2336,2168
7,Illes Balears,902,Migjorn Gran (Es),1503,742,761
7,Illes Balears,38,Montuïri,2576,1304,1272
7,Illes Balears,39,Muro,6717,3486,3231
7,Illes Balears,40,Palma de Mallorca,375048,183443,191605
7,Illes Balears,41,Petra,2744,1372,1372
7,Illes Balears,44,Pobla (Sa),12122,6360,5762
7,Illes Balears,42,Pollença,16398,8292,8106
7,Illes Balears,43,Porreres,4848,2558,2290
7,Illes Balears,45,Puigpunyent,1631,845,786
7,Illes Balears,59,Salines (Ses),4502,2303,2199
7,Illes Balears,46,Sant Antoni de Portmany,19673,10229,9444
7,Illes Balears,49,Sant Joan,1853,938,915
7,Illes Balears,50,Sant Joan de Labritja,4975,2579,2396
7,Illes Balears,48,Sant Josep de sa Talaia,19224,10031,9193
7,Illes Balears,51,Sant Llorenç des Cardassar,7738,3946,3792
7,Illes Balears,52,Sant Lluís,6182,3135,3047
7,Illes Balears,53,Santa Eugènia,1439,769,670
7,Illes Balears,54,Santa Eulalia del Río,27152,13964,13188
7,Illes Balears,55,Santa Margalida,10204,5260,4944
7,Illes Balears,56,Santa María del Camí,5323,2653,2670
7,Illes Balears,57,Santanyí,11172,5636,5536
7,Illes Balears,58,Selva,3203,1631,1572
7,Illes Balears,47,Sencelles,2743,1413,1330
7,Illes Balears,60,Sineu,3133,1579,1554
7,Illes Balears,61,Sóller,12847,6475,6372
7,Illes Balears,62,Son Servera,10951,5589,5362
7,Illes Balears,63,Valldemossa,1930,982,948
7,Illes Balears,65,Vilafranca de Bonany,2573,1277,1296
8,Barcelona,1,Abrera,10244,5277,4967
8,Barcelona,2,Aguilar de Segarra,250,133,117
8,Barcelona,14,Aiguafreda,2373,1151,1222
8,Barcelona,3,Alella,9013,4444,4569
8,Barcelona,4,Alpens,307,165,142
8,Barcelona,5,Ametlla del Vallès (L'),7517,3756,3761
8,Barcelona,6,Arenys de Mar,14016,6855,7161
8,Barcelona,7,Arenys de Munt,7721,3859,3862
8,Barcelona,8,Argençola,209,115,94
8,Barcelona,9,Argentona,11161,5529,5632
8,Barcelona,10,Artés,5072,2568,2504
8,Barcelona,11,Avià,2058,1025,1033
8,Barcelona,12,Avinyó,2122,1064,1058
8,Barcelona,13,Avinyonet del Penedès,1591,854,737
8,Barcelona,15,Badalona,221520,112117,109403
8,Barcelona,904,Badia del Vallès,14123,7004,7119
8,Barcelona,16,Bagà,2178,1073,1105
8,Barcelona,17,Balenyà,3479,1740,1739
8,Barcelona,18,Balsareny,3310,1637,1673
8,Barcelona,252,Barberà del Vallès,28633,14337,14296
8,Barcelona,19,Barcelona,1605602,761870,843732
8,Barcelona,20,Begues,5699,2860,2839
8,Barcelona,21,Bellprat,99,54,45
8,Barcelona,22,Berga,16457,8178,8279
8,Barcelona,23,Bigues i Riells,7564,3905,3659
8,Barcelona,24,Borredà,530,271,259
8,Barcelona,25,Bruc (El),1655,881,774
8,Barcelona,26,Brull (El),219,117,102
8,Barcelona,27,Cabanyes (Les),791,403,388
8,Barcelona,29,Cabrera de Mar,4174,2139,2035
8,Barcelona,28,Cabrera d'Igualada,1059,564,495
8,Barcelona,30,Cabrils,6536,3204,3332
8,Barcelona,31,Calaf,3352,1757,1595
8,Barcelona,34,Calders,833,424,409
8,Barcelona,33,Caldes de Montbui,15941,7992,7949
8,Barcelona,32,Caldes d'Estrac,2607,1268,1339
8,Barcelona,35,Calella,17673,8774,8899
8,Barcelona,37,Calldetenes,2214,1145,1069
8,Barcelona,38,Callús,1577,772,805
8,Barcelona,36,Calonge de Segarra,205,106,99
8,Barcelona,39,Campins,363,185,178
8,Barcelona,40,Canet de Mar,12766,6274,6492
8,Barcelona,41,Canovelles,15012,7877,7135
8,Barcelona,42,Cànoves i Samalús,2490,1295,1195
8,Barcelona,43,Canyelles,3440,1794,1646
8,Barcelona,44,Capellades,5383,2642,2741
8,Barcelona,45,Capolat,72,38,34
8,Barcelona,46,Cardedeu,15561,7709,7852
8,Barcelona,47,Cardona,5226,2541,2685
8,Barcelona,48,Carme,752,397,355
8,Barcelona,49,Casserres,1586,772,814
8,Barcelona,57,Castell de l'Areny,68,39,29
8,Barcelona,52,Castellar de n'Hug,198,103,95
8,Barcelona,50,Castellar del Riu,148,83,65
8,Barcelona,51,Castellar del Vallès,21335,10687,10648
8,Barcelona,53,Castellbell i el Vilar,3369,1724,1645
8,Barcelona,54,Castellbisbal,11272,5803,5469
8,Barcelona,55,Castellcir,575,301,274
8,Barcelona,56,Castelldefels,58663,29370,29293
8,Barcelona,58,Castellet i la Gornal,1919,995,924
8,Barcelona,60,Castellfollit de Riubregós,201,102,99
8,Barcelona,59,Castellfollit del Boix,407,197,210
8,Barcelona,61,Castellgalí,1436,772,664
8,Barcelona,62,Castellnou de Bages,837,448,389
8,Barcelona,63,Castellolí,460,221,239
8,Barcelona,64,Castellterçol,2202,1088,1114
8,Barcelona,65,Castellví de la Marca,1603,803,800
8,Barcelona,66,Castellví de Rosanes,1505,767,738
8,Barcelona,67,Centelles,6671,3250,3421
8,Barcelona,268,Cercs,1333,679,654
8,Barcelona,266,Cerdanyola del Vallès,57959,28747,29212
8,Barcelona,68,Cervelló,7674,3921,3753
8,Barcelona,69,Collbató,3576,1859,1717
8,Barcelona,70,Collsuspina,316,168,148
8,Barcelona,71,Copons,289,140,149
8,Barcelona,72,Corbera de Llobregat,12805,6544,6261
8,Barcelona,73,Cornellà de Llobregat,84289,41844,42445
8,Barcelona,74,Cubelles,11835,6316,5519
8,Barcelona,75,Dosrius,4469,2236,2233
8,Barcelona,76,Esparreguera,21145,10869,10276
8,Barcelona,77,Esplugues de Llobregat,46808,22940,23868
8,Barcelona,78,Espunyola (L'),272,137,135
8,Barcelona,79,Estany (L'),383,184,199
8,Barcelona,134,Figaró-Montmany,1019,526,493
8,Barcelona,80,Fígols,42,24,18
8,Barcelona,82,Fogars de la Selva,1338,689,649
8,Barcelona,81,Fogars de Montclús,437,238,199
8,Barcelona,83,Folgueroles,1983,991,992
8,Barcelona,84,Fonollosa,1280,655,625
8,Barcelona,85,Font-rubí,1394,736,658
8,Barcelona,86,Franqueses del Vallès (Les),15817,8138,7679
8,Barcelona,90,Gaià,154,79,75
8,Barcelona,87,Gallifa,216,114,102
8,Barcelona,88,Garriga (La),13942,6756,7186
8,Barcelona,89,Gavà,44531,22218,22313
8,Barcelona,91,Gelida,5976,3053,2923
8,Barcelona,92,Gironella,4786,2301,2485
8,Barcelona,93,Gisclareny,33,18,15
8,Barcelona,94,Granada (La),1754,887,867
8,Barcelona,95,Granera,75,52,23
8,Barcelona,96,Granollers,58940,29414,29526
8,Barcelona,97,Gualba,1048,552,496
8,Barcelona,99,Guardiola de Berguedà,931,484,447
8,Barcelona,100,Gurb,2296,1164,1132
8,Barcelona,101,Hospitalet de Llobregat (L'),248150,121707,126443
8,Barcelona,162,Hostalets de Pierola (Els),2003,1050,953
8,Barcelona,102,Igualada,36817,18223,18594
8,Barcelona,103,Jorba,714,348,366
8,Barcelona,104,Llacuna (La),860,465,395
8,Barcelona,105,Llagosta (La),13674,6918,6756
8,Barcelona,107,Lliçà d'Amunt,12938,6629,6309
8,Barcelona,108,Lliçà de Vall,6033,3138,2895
8,Barcelona,106,Llinars del Vallès,8425,4231,4194
8,Barcelona,109,Lluçà,253,135,118
8,Barcelona,110,Malgrat de Mar,17531,8869,8662
8,Barcelona,111,Malla,257,120,137
8,Barcelona,112,Manlleu,19979,10159,9820
8,Barcelona,113,Manresa,71772,35280,36492
8,Barcelona,242,Marganell,288,130,158
8,Barcelona,114,Martorell,26170,13582,12588
8,Barcelona,115,Martorelles,4938,2511,2427
8,Barcelona,116,Masies de Roda (Les),742,372,370
8,Barcelona,117,Masies de Voltregà (Les),3125,1530,1595
8,Barcelona,118,Masnou (El),21833,10533,11300
8,Barcelona,119,Masquefa,7414,3767,3647
8,Barcelona,120,Matadepera,8169,4125,4044
8,Barcelona,121,Mataró,118748,59683,59065
8,Barcelona,122,Mediona,2083,1102,981
8,Barcelona,138,Moià,5399,2761,2638
8,Barcelona,123,Molins de Rei,23374,11511,11863
8,Barcelona,124,Mollet del Vallès,51713,26270,25443
8,Barcelona,128,Monistrol de Calders,691,348,343
8,Barcelona,127,Monistrol de Montserrat,2840,1490,1350
8,Barcelona,125,Montcada i Reixac,32153,16038,16115
8,Barcelona,130,Montclar,116,54,62
8,Barcelona,131,Montesquiu,875,448,427
8,Barcelona,126,Montgat,9427,4617,4810
8,Barcelona,132,Montmajor,463,243,220
8,Barcelona,133,Montmaneu,201,109,92
8,Barcelona,135,Montmeló,8921,4463,4458
8,Barcelona,136,Montornès del Vallès,14516,7486,7030
8,Barcelona,137,Montseny,299,163,136
8,Barcelona,129,Muntanyola,464,247,217
8,Barcelona,139,Mura,233,127,106
8,Barcelona,140,Navarcles,5723,2830,2893
8,Barcelona,141,Navàs,5810,2878,2932
8,Barcelona,142,Nou de Berguedà (La),162,83,79
8,Barcelona,143,Òdena,3100,1565,1535
8,Barcelona,145,Olèrdola,3084,1616,1468
8,Barcelona,146,Olesa de Bonesvalls,1506,795,711
8,Barcelona,147,Olesa de Montserrat,21714,10991,10723
8,Barcelona,148,Olivella,2515,1341,1174
8,Barcelona,149,Olost,1187,591,596
8,Barcelona,144,Olvan,922,454,468
8,Barcelona,150,Orís,284,141,143
8,Barcelona,151,Oristà,593,292,301
8,Barcelona,152,Orpí,190,97,93
8,Barcelona,153,Òrrius,295,153,142
8,Barcelona,154,Pacs del Penedès,787,392,395
8,Barcelona,155,Palafolls,7583,3801,3782
8,Barcelona,156,Palau-solità i Plegamans,13310,6786,6524
8,Barcelona,157,Pallejà,10535,5326,5209
8,Barcelona,905,Palma de Cervelló (La),2988,1501,1487
8,Barcelona,158,Papiol (El),3733,1887,1846
8,Barcelona,159,Parets del Vallès,16413,8402,8011
8,Barcelona,160,Perafita,379,187,192
8,Barcelona,161,Piera,12951,6668,6283
8,Barcelona,163,Pineda de Mar,25504,13083,12421
8,Barcelona,164,Pla del Penedès (El),931,476,455
8,Barcelona,165,Pobla de Claramunt (La),2112,1114,998
8,Barcelona,166,Pobla de Lillet (La),1327,640,687
8,Barcelona,167,Polinyà,6764,3463,3301
8,Barcelona,182,Pont de Vilomara i Rocafort (El),3310,1708,1602
8,Barcelona,168,Pontons,498,273,225
8,Barcelona,169,Prat de Llobregat (El),63069,31526,31543
8,Barcelona,171,Prats de Lluçanès,2753,1392,1361
8,Barcelona,170,Prats de Rei (Els),532,271,261
8,Barcelona,230,Premià de Dalt,9890,4913,4977
8,Barcelona,172,Premià de Mar,27860,13918,13942
8,Barcelona,174,Puigdàlber,377,180,197
8,Barcelona,175,Puig-reig,4202,2059,2143
8,Barcelona,176,Pujalt,203,101,102
8,Barcelona,177,Quar (La),61,35,26
8,Barcelona,178,Rajadell,467,251,216
8,Barcelona,179,Rellinars,653,330,323
8,Barcelona,180,Ripollet,35427,18022,17405
8,Barcelona,181,Roca del Vallès (La),9418,4759,4659
8,Barcelona,183,Roda de Ter,5535,2695,2840
8,Barcelona,184,Rubí,70006,35444,34562
8,Barcelona,185,Rubió,146,81,65
8,Barcelona,901,Rupit i Pruit,339,164,175
8,Barcelona,187,Sabadell,200545,98312,102233
8,Barcelona,188,Sagàs,143,70,73
8,Barcelona,190,Saldes,326,180,146
8,Barcelona,191,Sallent,7146,3446,3700
8,Barcelona,194,Sant Adrià de Besòs,32585,16002,16583
8,Barcelona,195,Sant Agustí de Lluçanès,107,56,51
8,Barcelona,196,Sant Andreu de la Barca,25383,13073,12310
8,Barcelona,197,Sant Andreu de Llavaneres,9463,4842,4621
8,Barcelona,198,Sant Antoni de Vilamajor,4877,2460,2417
8,Barcelona,199,Sant Bartomeu del Grau,1001,527,474
8,Barcelona,200,Sant Boi de Llobregat,81368,40483,40885
8,Barcelona,201,Sant Boi de Lluçanès,575,291,284
8,Barcelona,203,Sant Cebrià de Vallalta,2873,1533,1340
8,Barcelona,202,Sant Celoni,15544,7823,7721
8,Barcelona,204,Sant Climent de Llobregat,3516,1772,1744
8,Barcelona,205,Sant Cugat del Vallès,73774,36199,37575
8,Barcelona,206,Sant Cugat Sesgarrigues,890,464,426
8,Barcelona,207,Sant Esteve de Palautordera,2079,1019,1060
8,Barcelona,208,Sant Esteve Sesrovires,6590,3382,3208
8,Barcelona,210,Sant Feliu de Codines,5412,2789,2623
8,Barcelona,211,Sant Feliu de Llobregat,42486,20855,21631
8,Barcelona,212,Sant Feliu Sasserra,622,306,316
8,Barcelona,209,Sant Fost de Campsentelles,7409,3764,3645
8,Barcelona,213,Sant Fruitós de Bages,7199,3701,3498
8,Barcelona,215,Sant Hipòlit de Voltregà,3319,1665,1654
8,Barcelona,193,Sant Iscle de Vallalta,1166,604,562
8,Barcelona,216,Sant Jaume de Frontanyà,32,15,17
8,Barcelona,218,Sant Joan de Vilatorrada,10362,5234,5128
8,Barcelona,217,Sant Joan Despí,31485,15560,15925
8,Barcelona,903,Sant Julià de Cerdanyola,259,137,122
8,Barcelona,220,Sant Julià de Vilatorta,2809,1370,1439
8,Barcelona,221,Sant Just Desvern,15327,7249,8078
8,Barcelona,222,Sant Llorenç d'Hortons,2126,1081,1045
8,Barcelona,223,Sant Llorenç Savall,2271,1155,1116
8,Barcelona,225,Sant Martí d'Albars,114,57,57
8,Barcelona,224,Sant Martí de Centelles,907,469,438
8,Barcelona,226,Sant Martí de Tous,1101,562,539
8,Barcelona,227,Sant Martí Sarroca,2849,1457,1392
8,Barcelona,228,Sant Martí Sesgueioles,361,185,176
8,Barcelona,229,Sant Mateu de Bages,661,337,324
8,Barcelona,231,Sant Pere de Ribes,26859,13576,13283
8,Barcelona,232,Sant Pere de Riudebitlles,2246,1136,1110
8,Barcelona,233,Sant Pere de Torelló,2264,1131,1133
8,Barcelona,234,Sant Pere de Vilamajor,3578,1809,1769
8,Barcelona,189,Sant Pere Sallavinera,171,87,84
8,Barcelona,235,Sant Pol de Mar,4773,2433,2340
8,Barcelona,236,Sant Quintí de Mediona,2039,1069,970
8,Barcelona,237,Sant Quirze de Besora,2069,1014,1055
8,Barcelona,238,Sant Quirze del Vallès,17138,8477,8661
8,Barcelona,239,Sant Quirze Safaja,579,302,277
8,Barcelona,240,Sant Sadurní d'Anoia,11617,5768,5849
8,Barcelona,241,Sant Sadurní d'Osormort,89,52,37
8,Barcelona,98,Sant Salvador de Guardiola,2863,1459,1404
8,Barcelona,262,Sant Vicenç de Castellet,7835,3787,4048
8,Barcelona,264,Sant Vicenç de Montalt,5127,2608,2519
8,Barcelona,265,Sant Vicenç de Torelló,1911,922,989
8,Barcelona,263,Sant Vicenç dels Horts,27019,13563,13456
8,Barcelona,243,Santa Cecília de Voltregà,199,107,92
8,Barcelona,244,Santa Coloma de Cervelló,7314,3661,3653
8,Barcelona,245,Santa Coloma de Gramenet,119056,60583,58473
8,Barcelona,246,Santa Eugènia de Berga,2178,1149,1029
8,Barcelona,247,Santa Eulàlia de Riuprimer,926,477,449
8,Barcelona,248,Santa Eulàlia de Ronçana,6111,3062,3049
8,Barcelona,249,Santa Fe del Penedès,350,180,170
8,Barcelona,250,Santa Margarida de Montbui,9715,4883,4832
8,Barcelona,251,Santa Margarida i els Monjos,6221,3269,2952
8,Barcelona,253,Santa Maria de Besora,187,94,93
8,Barcelona,254,Santa Maria de Corcó,2239,1117,1122
8,Barcelona,256,Santa Maria de Martorelles,788,403,385
8,Barcelona,255,Santa Maria de Merlès,152,76,76
8,Barcelona,257,Santa Maria de Miralles,128,64,64
8,Barcelona,259,Santa Maria de Palautordera,8099,4221,3878
8,Barcelona,258,Santa Maria d'Oló,1072,536,536
8,Barcelona,260,Santa Perpètua de Mogoda,21644,11014,10630
8,Barcelona,261,Santa Susanna,2939,1527,1412
8,Barcelona,192,Santpedor,6263,3117,3146
8,Barcelona,267,Sentmenat,7209,3640,3569
8,Barcelona,269,Seva,3099,1576,1523
8,Barcelona,270,Sitges,25642,12641,13001
8,Barcelona,271,Sobremunt,102,49,53
8,Barcelona,272,Sora,193,106,87
8,Barcelona,273,Subirats,2943,1472,1471
8,Barcelona,274,Súria,6290,3078,3212
8,Barcelona,276,Tagamanent,282,150,132
8,Barcelona,277,Talamanca,134,71,63
8,Barcelona,278,Taradell,5764,2992,2772
8,Barcelona,275,Tavèrnoles,300,150,150
8,Barcelona,280,Tavertet,155,89,66
8,Barcelona,281,Teià,5867,2981,2886
8,Barcelona,279,Terrassa,199817,99579,100238
8,Barcelona,282,Tiana,7305,3599,3706
8,Barcelona,283,Tona,7328,3691,3637
8,Barcelona,284,Tordera,13420,6849,6571
8,Barcelona,285,Torelló,13269,6558,6711
8,Barcelona,286,Torre de Claramunt (La),3298,1707,1591
8,Barcelona,287,Torrelavit,1232,668,564
8,Barcelona,288,Torrelles de Foix,2252,1202,1050
8,Barcelona,289,Torrelles de Llobregat,4861,2446,2415
8,Barcelona,290,Ullastrell,1529,797,732
8,Barcelona,291,Vacarisses,5094,2624,2470
8,Barcelona,292,Vallbona d'Anoia,1311,669,642
8,Barcelona,293,Vallcebre,276,149,127
8,Barcelona,294,Vallgorguina,2016,1033,983
8,Barcelona,295,Vallirana,12928,6501,6427
8,Barcelona,296,Vallromanes,2094,1057,1037
8,Barcelona,297,Veciana,167,90,77
8,Barcelona,298,Vic,38747,19743,19004
8,Barcelona,299,Vilada,516,261,255
8,Barcelona,301,Viladecans,61168,30754,30414
8,Barcelona,300,Viladecavalls,7036,3545,3491
8,Barcelona,305,Vilafranca del Penedès,36687,18375,18312
8,Barcelona,306,Vilalba Sasserra,581,293,288
8,Barcelona,303,Vilanova de Sau,323,149,174
8,Barcelona,302,Vilanova del Camí,12039,6107,5932
8,Barcelona,902,Vilanova del Vallès,3774,1959,1815
8,Barcelona,307,Vilanova i la Geltrú,62826,31047,31779
8,Barcelona,214,Vilassar de Dalt,8334,4140,4194
8,Barcelona,219,Vilassar de Mar,19051,9343,9708
8,Barcelona,304,Vilobí del Penedès,1033,535,498
8,Barcelona,308,Viver i Serrateix,194,98,96
9,Burgos,1,Abajas,36,18,18
9,Burgos,3,Adrada de Haza,250,133,117
9,Burgos,6,Aguas Cándidas,79,46,33
9,Burgos,7,Aguilar de Bureba,64,34,30
9,Burgos,9,Albillos,211,120,91
9,Burgos,10,Alcocero de Mola,49,31,18
9,Burgos,11,Alfoz de Bricia,104,55,49
9,Burgos,907,Alfoz de Quintanadueñas,1515,841,674
9,Burgos,12,Alfoz de Santa Gadea,125,69,56
9,Burgos,13,Altable,56,34,22
9,Burgos,14,Altos (Los),203,117,86
9,Burgos,16,Ameyugo,93,51,42
9,Burgos,17,Anguix,161,88,73
9,Burgos,18,Aranda de Duero,31545,15769,15776
9,Burgos,19,Arandilla,186,109,77
9,Burgos,20,Arauzo de Miel,341,190,151
9,Burgos,21,Arauzo de Salce,80,42,38
9,Burgos,22,Arauzo de Torre,103,57,46
9,Burgos,23,Arcos,643,349,294
9,Burgos,24,Arenillas de Riopisuerga,202,112,90
9,Burgos,25,Arija,192,101,91
9,Burgos,26,Arlanzón,439,251,188
9,Burgos,27,Arraya de Oca,51,27,24
9,Burgos,29,Atapuerca,191,100,91
9,Burgos,30,Ausines (Los),137,75,62
9,Burgos,32,Avellanosa de Muñó,142,76,66
9,Burgos,33,Bahabón de Esgueva,121,73,48
9,Burgos,34,Balbases (Los),346,185,161
9,Burgos,35,Baños de Valdearados,418,241,177
9,Burgos,36,Bañuelos de Bureba,35,22,13
9,Burgos,37,Barbadillo de Herreros,137,84,53
9,Burgos,38,Barbadillo del Mercado,166,92,74
9,Burgos,39,Barbadillo del Pez,82,46,36
9,Burgos,41,Barrio de Muñó,30,18,12
9,Burgos,43,Barrios de Bureba (Los),234,129,105
9,Burgos,44,Barrios de Colina,71,36,35
9,Burgos,45,Basconcillos del Tozo,358,198,160
9,Burgos,46,Bascuñana,55,33,22
9,Burgos,47,Belbimbre,79,42,37
9,Burgos,48,Belorado,2157,1114,1043
9,Burgos,50,Berberana,77,42,35
9,Burgos,51,Berlangas de Roa,222,115,107
9,Burgos,52,Berzosa de Bureba,45,29,16
9,Burgos,54,Bozoó,105,52,53
9,Burgos,55,Brazacorta,85,44,41
9,Burgos,56,Briviesca,7146,3623,3523
9,Burgos,57,Bugedo,152,100,52
9,Burgos,58,Buniel,351,191,160
9,Burgos,59,Burgos,173676,83580,90096
9,Burgos,60,Busto de Bureba,193,104,89
9,Burgos,61,Cabañes de Esgueva,223,115,108
9,Burgos,62,Cabezón de la Sierra,56,24,32
9,Burgos,64,Caleruega,462,238,224
9,Burgos,65,Campillo de Aranda,190,105,85
9,Burgos,66,Campolara,82,50,32
9,Burgos,67,Canicosa de la Sierra,566,301,265
9,Burgos,68,Cantabrana,36,22,14
9,Burgos,70,Carazo,45,28,17
9,Burgos,71,Carcedo de Bureba,42,20,22
9,Burgos,72,Carcedo de Burgos,253,150,103
9,Burgos,73,Cardeñadijo,785,430,355
9,Burgos,74,Cardeñajimeno,696,388,308
9,Burgos,75,Cardeñuela Riopico,108,68,40
9,Burgos,76,Carrias,34,25,9
9,Burgos,77,Cascajares de Bureba,57,30,27
9,Burgos,78,Cascajares de la Sierra,32,14,18
9,Burgos,79,Castellanos de Castro,58,35,23
9,Burgos,83,Castil de Peones,27,16,11
9,Burgos,82,Castildelgado,67,34,33
9,Burgos,84,Castrillo de la Reina,252,156,96
9,Burgos,85,Castrillo de la Vega,657,355,302
9,Burgos,88,Castrillo de Riopisuerga,76,45,31
9,Burgos,86,Castrillo del Val,609,342,267
9,Burgos,90,Castrillo Matajudíos,70,36,34
9,Burgos,91,Castrojeriz,910,468,442
9,Burgos,63,Cavia,266,149,117
9,Burgos,93,Cayuela,133,73,60
9,Burgos,94,Cebrecos,63,35,28
9,Burgos,95,Celada del Camino,101,52,49
9,Burgos,98,Cerezo de Río Tirón,686,370,316
9,Burgos,100,Cerratón de Juarros,63,39,24
9,Burgos,101,Ciadoncha,89,57,32
9,Burgos,102,Cillaperlata,39,24,15
9,Burgos,103,Cilleruelo de Abajo,292,163,129
9,Burgos,104,Cilleruelo de Arriba,75,40,35
9,Burgos,105,Ciruelos de Cervera,131,76,55
9,Burgos,108,Cogollos,431,237,194
9,Burgos,109,Condado de Treviño,1345,751,594
9,Burgos,110,Contreras,100,61,39
9,Burgos,112,Coruña del Conde,162,91,71
9,Burgos,113,Covarrubias,620,333,287
9,Burgos,114,Cubillo del Campo,85,43,42
9,Burgos,115,Cubo de Bureba,118,67,51
9,Burgos,117,Cueva de Roa (La),105,56,49
9,Burgos,119,Cuevas de San Clemente,53,26,27
9,Burgos,120,Encío,45,26,19
9,Burgos,122,Espinosa de Cervera,104,61,43
9,Burgos,124,Espinosa de los Monteros,1951,1016,935
9,Burgos,123,Espinosa del Camino,38,22,16
9,Burgos,125,Estépar,777,444,333
9,Burgos,127,Fontioso,69,35,34
9,Burgos,128,Frandovínez,125,70,55
9,Burgos,129,Fresneda de la Sierra Tirón,113,66,47
9,Burgos,130,Fresneña,111,56,55
9,Burgos,131,Fresnillo de las Dueñas,363,197,166
9,Burgos,132,Fresno de Río Tirón,215,119,96
9,Burgos,133,Fresno de Rodilla,44,27,17
9,Burgos,134,Frías,293,157,136
9,Burgos,135,Fuentebureba,59,29,30
9,Burgos,136,Fuentecén,268,148,120
9,Burgos,137,Fuentelcésped,187,97,90
9,Burgos,138,Fuentelisendo,106,61,45
9,Burgos,139,Fuentemolinos,106,62,44
9,Burgos,140,Fuentenebro,178,100,78
9,Burgos,141,Fuentespina,685,365,320
9,Burgos,143,Galbarros,32,22,10
9,Burgos,144,Gallega (La),81,44,37
9,Burgos,148,Grijalba,123,60,63
9,Burgos,149,Grisaleña,45,31,14
9,Burgos,151,Gumiel de Izán,641,366,275
9,Burgos,152,Gumiel de Mercado,394,220,174
9,Burgos,154,Hacinas,188,104,84
9,Burgos,155,Haza,32,20,12
9,Burgos,159,Hontanas,70,42,28
9,Burgos,160,Hontangas,128,81,47
9,Burgos,162,Hontoria de la Cantera,137,75,62
9,Burgos,164,Hontoria de Valdearados,242,154,88
9,Burgos,163,Hontoria del Pinar,863,468,395
9,Burgos,166,Hormazas (Las),121,64,57
9,Burgos,167,Hornillos del Camino,64,36,28
9,Burgos,168,Horra (La),412,212,200
9,Burgos,169,Hortigüela,124,73,51
9,Burgos,170,Hoyales de Roa,251,121,130
9,Burgos,172,Huérmeces,127,68,59
9,Burgos,173,Huerta de Arriba,156,86,70
9,Burgos,174,Huerta de Rey,1175,617,558
9,Burgos,175,Humada,167,102,65
9,Burgos,176,Hurones,70,44,26
9,Burgos,177,Ibeas de Juarros,1276,689,587
9,Burgos,178,Ibrillos,87,51,36
9,Burgos,179,Iglesiarrubia,52,29,23
9,Burgos,180,Iglesias,156,90,66
9,Burgos,181,Isar,359,163,196
9,Burgos,182,Itero del Castillo,100,54,46
9,Burgos,183,Jaramillo de la Fuente,39,22,17
9,Burgos,184,Jaramillo Quemado,9,6,3
9,Burgos,189,Junta de Traslaloma,195,103,92
9,Burgos,190,Junta de Villalba de Losa,139,71,68
9,Burgos,191,Jurisdicción de Lara,60,35,25
9,Burgos,192,Jurisdicción de San Zadornil,98,45,53
9,Burgos,194,Lerma,2789,1345,1444
9,Burgos,195,Llano de Bureba,71,41,30
9,Burgos,196,Madrigal del Monte,194,110,84
9,Burgos,197,Madrigalejo del Monte,197,117,80
9,Burgos,198,Mahamud,153,82,71
9,Burgos,199,Mambrilla de Castrejón,136,70,66
9,Burgos,200,Mambrillas de Lara,62,34,28
9,Burgos,201,Mamolar,56,31,25
9,Burgos,202,Manciles,33,19,14
9,Burgos,206,Mazuela,73,41,32
9,Burgos,208,Mecerreyes,302,159,143
9,Burgos,209,Medina de Pomar,5610,2920,2690
9,Burgos,211,Melgar de Fernamental,1876,991,885
9,Burgos,213,Merindad de Cuesta-Urria,492,265,227
9,Burgos,214,Merindad de Montija,843,475,368
9,Burgos,906,Merindad de Río Ubierna,1362,724,638
9,Burgos,215,Merindad de Sotoscueva,487,273,214
9,Burgos,216,Merindad de Valdeporres,468,243,225
9,Burgos,217,Merindad de Valdivielso,469,260,209
9,Burgos,218,Milagros,496,266,230
9,Burgos,219,Miranda de Ebro,38276,19129,19147
9,Burgos,220,Miraveche,102,60,42
9,Burgos,221,Modúbar de la Emparedada,388,224,164
9,Burgos,223,Monasterio de la Sierra,43,27,16
9,Burgos,224,Monasterio de Rodilla,215,125,90
9,Burgos,225,Moncalvillo,107,67,40
9,Burgos,226,Monterrubio de la Demanda,91,50,41
9,Burgos,227,Montorio,172,90,82
9,Burgos,228,Moradillo de Roa,210,117,93
9,Burgos,229,Nava de Roa,259,132,127
9,Burgos,230,Navas de Bureba,47,24,23
9,Burgos,231,Nebreda,88,54,34
9,Burgos,232,Neila,239,129,110
9,Burgos,235,Olmedillo de Roa,191,101,90
9,Burgos,236,Olmillos de Muñó,38,24,14
9,Burgos,238,Oña,1422,733,689
9,Burgos,239,Oquillas,76,41,35
9,Burgos,241,Orbaneja Riopico,160,99,61
9,Burgos,242,Padilla de Abajo,94,55,39
9,Burgos,243,Padilla de Arriba,98,59,39
9,Burgos,244,Padrones de Bureba,49,27,22
9,Burgos,246,Palacios de la Sierra,854,455,399
9,Burgos,247,Palacios de Riopisuerga,31,16,15
9,Burgos,248,Palazuelos de la Sierra,67,39,28
9,Burgos,249,Palazuelos de Muñó,65,39,26
9,Burgos,250,Pampliega,381,196,185
9,Burgos,251,Pancorbo,476,251,225
9,Burgos,253,Pardilla,130,72,58
9,Burgos,255,Partido de la Sierra en Tobalina,81,49,32
9,Burgos,256,Pedrosa de Duero,514,291,223
9,Burgos,259,Pedrosa de Río Úrbel,258,151,107
9,Burgos,257,Pedrosa del Páramo,95,50,45
9,Burgos,258,Pedrosa del Príncipe,201,104,97
9,Burgos,261,Peñaranda de Duero,551,296,255
9,Burgos,262,Peral de Arlanza,205,110,95
9,Burgos,265,Piérnigas,33,24,9
9,Burgos,266,Pineda de la Sierra,121,66,55
9,Burgos,267,Pineda Trasmonte,151,86,65
9,Burgos,268,Pinilla de los Barruecos,129,75,54
9,Burgos,269,Pinilla de los Moros,40,28,12
9,Burgos,270,Pinilla Trasmonte,202,115,87
9,Burgos,272,Poza de la Sal,359,177,182
9,Burgos,273,Prádanos de Bureba,51,34,17
9,Burgos,274,Pradoluengo,1549,779,770
9,Burgos,275,Presencio,234,133,101
9,Burgos,276,Puebla de Arganzón (La),456,260,196
9,Burgos,277,Puentedura,131,80,51
9,Burgos,279,Quemada,265,155,110
9,Burgos,281,Quintana del Pidio,180,102,78
9,Burgos,280,Quintanabureba,33,19,14
9,Burgos,283,Quintanaélez,76,38,38
9,Burgos,287,Quintanaortuño,215,120,95
9,Burgos,288,Quintanapalla,129,68,61
9,Burgos,289,Quintanar de la Sierra,1994,1035,959
9,Burgos,292,Quintanavides,107,58,49
9,Burgos,294,Quintanilla de la Mata,151,81,70
9,Burgos,901,Quintanilla del Agua y Tordueles,573,310,263
9,Burgos,295,Quintanilla del Coco,98,52,46
9,Burgos,298,Quintanilla San García,102,59,43
9,Burgos,301,Quintanilla Vivar,660,339,321
9,Burgos,297,Quintanillas (Las),385,209,176
9,Burgos,302,Rabanera del Pinar,142,78,64
9,Burgos,303,Rábanos,103,61,42
9,Burgos,304,Rabé de las Calzadas,196,100,96
9,Burgos,306,Rebolledo de la Torre,160,91,69
9,Burgos,307,Redecilla del Camino,140,79,61
9,Burgos,308,Redecilla del Campo,72,42,30
9,Burgos,309,Regumiel de la Sierra,442,223,219
9,Burgos,310,Reinoso,17,11,6
9,Burgos,311,Retuerta,74,44,30
9,Burgos,314,Revilla del Campo,135,74,61
9,Burgos,316,Revilla Vallejera,102,63,39
9,Burgos,312,Revilla y Ahedo (La),121,73,48
9,Burgos,315,Revillarruz,252,135,117
9,Burgos,317,Rezmondo,23,10,13
9,Burgos,318,Riocavado de la Sierra,66,37,29
9,Burgos,321,Roa,2363,1225,1138
9,Burgos,323,Rojas,87,52,35
9,Burgos,325,Royuela de Río Franco,264,153,111
9,Burgos,326,Rubena,194,102,92
9,Burgos,327,Rublacedo de Abajo,33,19,14
9,Burgos,328,Rucandio,88,46,42
9,Burgos,329,Salas de Bureba,144,86,58
9,Burgos,330,Salas de los Infantes,2049,1047,1002
9,Burgos,332,Saldaña de Burgos,144,81,63
9,Burgos,334,Salinillas de Bureba,54,34,20
9,Burgos,335,San Adrián de Juarros,49,29,20
9,Burgos,337,San Juan del Monte,158,86,72
9,Burgos,338,San Mamés de Burgos,295,160,135
9,Burgos,339,San Martín de Rubiales,220,121,99
9,Burgos,340,San Millán de Lara,78,56,22
9,Burgos,360,San Vicente del Valle,48,29,19
9,Burgos,343,Santa Cecilia,115,65,50
9,Burgos,345,Santa Cruz de la Salceda,179,108,71
9,Burgos,346,Santa Cruz del Valle Urbión,105,62,43
9,Burgos,347,Santa Gadea del Cid,170,91,79
9,Burgos,348,Santa Inés,172,96,76
9,Burgos,350,Santa María del Campo,683,374,309
9,Burgos,351,Santa María del Invierno,62,42,20
9,Burgos,352,Santa María del Mercadillo,159,89,70
9,Burgos,353,Santa María Rivarredonda,105,55,50
9,Burgos,354,Santa Olalla de Bureba,41,12,29
9,Burgos,355,Santibáñez de Esgueva,130,62,68
9,Burgos,356,Santibáñez del Val,66,43,23
9,Burgos,358,Santo Domingo de Silos,321,197,124
9,Burgos,361,Sargentes de la Lora,169,93,76
9,Burgos,362,Sarracín,284,161,123
9,Burgos,363,Sasamón,1296,721,575
9,Burgos,365,Sequera de Haza (La),50,31,19
9,Burgos,366,Solarana,105,58,47
9,Burgos,368,Sordillos,29,18,11
9,Burgos,369,Sotillo de la Ribera,593,330,263
9,Burgos,372,Sotragero,230,121,109
9,Burgos,373,Sotresgudo,606,346,260
9,Burgos,374,Susinos del Páramo,110,56,54
9,Burgos,375,Tamarón,43,30,13
9,Burgos,377,Tardajos,761,441,320
9,Burgos,378,Tejada,41,26,15
9,Burgos,380,Terradillos de Esgueva,117,58,59
9,Burgos,381,Tinieblas de la Sierra,42,22,20
9,Burgos,382,Tobar,39,23,16
9,Burgos,384,Tordómar,365,212,153
9,Burgos,386,Torrecilla del Monte,72,38,34
9,Burgos,387,Torregalindo,148,84,64
9,Burgos,388,Torrelara,24,14,10
9,Burgos,389,Torrepadre,84,54,30
9,Burgos,390,Torresandino,778,414,364
9,Burgos,391,Tórtoles de Esgueva,501,275,226
9,Burgos,392,Tosantos,56,31,25
9,Burgos,394,Trespaderne,1067,551,516
9,Burgos,395,Tubilla del Agua,189,117,72
9,Burgos,396,Tubilla del Lago,168,97,71
9,Burgos,398,Úrbel del Castillo,102,63,39
9,Burgos,400,Vadocondes,425,223,202
9,Burgos,403,Valdeande,129,80,49
9,Burgos,405,Valdezate,172,87,85
9,Burgos,406,Valdorros,188,107,81
9,Burgos,408,Vallarta de Bureba,58,34,24
9,Burgos,904,Valle de las Navas,611,341,270
9,Burgos,908,Valle de Losa,610,355,255
9,Burgos,409,Valle de Manzanedo,134,76,58
9,Burgos,410,Valle de Mena,3611,1860,1751
9,Burgos,411,Valle de Oca,215,116,99
9,Burgos,902,Valle de Santibáñez,564,301,263
9,Burgos,905,Valle de Sedano,506,290,216
9,Burgos,412,Valle de Tobalina,1021,552,469
9,Burgos,413,Valle de Valdebezana,631,347,284
9,Burgos,414,Valle de Valdelaguna,202,122,80
9,Burgos,415,Valle de Valdelucio,362,194,168
9,Burgos,416,Valle de Zamanzas,72,42,30
9,Burgos,417,Vallejera,54,33,21
9,Burgos,418,Valles de Palenzuela,98,52,46
9,Burgos,419,Valluércanes,92,54,38
9,Burgos,407,Valmala,36,20,16
9,Burgos,422,Vid de Bureba (La),37,19,18
9,Burgos,421,Vid y Barrios (La),300,171,129
9,Burgos,423,Vileña,30,20,10
9,Burgos,427,Villadiego,1840,1000,840
9,Burgos,428,Villaescusa de Roa,166,94,72
9,Burgos,429,Villaescusa la Sombría,69,45,24
9,Burgos,430,Villaespasa,18,10,8
9,Burgos,431,Villafranca Montes de Oca,155,87,68
9,Burgos,432,Villafruela,252,148,104
9,Burgos,433,Villagalijo,82,52,30
9,Burgos,434,Villagonzalo Pedernales,1245,651,594
9,Burgos,437,Villahoz,360,190,170
9,Burgos,438,Villalba de Duero,652,345,307
9,Burgos,439,Villalbilla de Burgos,846,476,370
9,Burgos,440,Villalbilla de Gumiel,112,70,42
9,Burgos,441,Villaldemiro,68,39,29
9,Burgos,442,Villalmanzo,507,257,250
9,Burgos,443,Villamayor de los Montes,221,110,111
9,Burgos,444,Villamayor de Treviño,95,53,42
9,Burgos,445,Villambistia,59,30,29
9,Burgos,446,Villamedianilla,23,11,12
9,Burgos,447,Villamiel de la Sierra,37,21,16
9,Burgos,448,Villangómez,301,176,125
9,Burgos,449,Villanueva de Argaño,132,76,56
9,Burgos,450,Villanueva de Carazo,24,16,8
9,Burgos,451,Villanueva de Gumiel,274,143,131
9,Burgos,454,Villanueva de Teba,55,35,20
9,Burgos,455,Villaquirán de la Puebla,50,27,23
9,Burgos,456,Villaquirán de los Infantes,165,86,79
9,Burgos,903,Villarcayo de Merindad de Castilla la Vieja,4377,2289,2088
9,Burgos,458,Villariezo,418,239,179
9,Burgos,460,Villasandino,224,127,97
9,Burgos,463,Villasur de Herreros,312,171,141
9,Burgos,464,Villatuelda,58,33,25
9,Burgos,466,Villaverde del Monte,167,95,72
9,Burgos,467,Villaverde-Mogina,100,64,36
9,Burgos,471,Villayerno Morquillas,185,93,92
9,Burgos,472,Villazopeque,73,44,29
9,Burgos,473,Villegas,111,62,49
9,Burgos,476,Villoruebo,60,37,23
9,Burgos,424,Viloria de Rioja,55,32,23
9,Burgos,425,Vilviestre del Pinar,718,389,329
9,Burgos,478,Vizcaínos,49,30,19
9,Burgos,480,Zael,130,67,63
9,Burgos,482,Zarzosa de Río Pisuerga,47,28,19
9,Burgos,483,Zazuar,265,142,123
9,Burgos,485,Zuñeda,63,35,28
10,Cáceres,1,Abadía,272,152,120
10,Cáceres,2,Abertura,486,250,236
10,Cáceres,3,Acebo,728,390,338
10,Cáceres,4,Acehúche,866,434,432
10,Cáceres,5,Aceituna,618,320,298
10,Cáceres,6,Ahigal,1559,815,744
10,Cáceres,7,Albalá,850,438,412
10,Cáceres,8,Alcántara,1694,849,845
10,Cáceres,9,Alcollarín,312,155,157
10,Cáceres,10,Alcuéscar,2980,1552,1428
10,Cáceres,12,Aldea del Cano,744,358,386
10,Cáceres,13,Aldea del Obispo (La),368,196,172
10,Cáceres,11,Aldeacentenera,820,420,400
10,Cáceres,14,Aldeanueva de la Vera,2304,1126,1178
10,Cáceres,15,Aldeanueva del Camino,830,406,424
10,Cáceres,16,Aldehuela de Jerte,345,194,151
10,Cáceres,17,Alía,1140,576,564
10,Cáceres,18,Aliseda,1953,983,970
10,Cáceres,19,Almaraz,1229,628,601
10,Cáceres,20,Almoharín,2102,1050,1052
10,Cáceres,21,Arroyo de la Luz,6572,3277,3295
10,Cáceres,23,Arroyomolinos,981,505,476
10,Cáceres,22,Arroyomolinos de la Vera,540,270,270
10,Cáceres,24,Baños de Montemayor,746,348,398
10,Cáceres,25,Barrado,495,252,243
10,Cáceres,26,Belvís de Monroy,701,346,355
10,Cáceres,27,Benquerencia,98,56,42
10,Cáceres,28,Berrocalejo,107,53,54
10,Cáceres,29,Berzocana,534,271,263
10,Cáceres,30,Bohonal de Ibor,542,286,256
10,Cáceres,31,Botija,186,89,97
10,Cáceres,32,Brozas,2248,1113,1135
10,Cáceres,33,Cabañas del Castillo,477,243,234
10,Cáceres,34,Cabezabellosa,439,218,221
10,Cáceres,35,Cabezuela del Valle,2198,1147,1051
10,Cáceres,36,Cabrero,356,192,164
10,Cáceres,37,Cáceres,90218,43383,46835
10,Cáceres,38,Cachorrilla,88,44,44
10,Cáceres,39,Cadalso,548,282,266
10,Cáceres,40,Calzadilla,491,254,237
10,Cáceres,41,Caminomorisco,1292,669,623
10,Cáceres,42,Campillo de Deleitosa,102,45,57
10,Cáceres,43,Campo Lugar,1108,562,546
10,Cáceres,44,Cañamero,1570,812,758
10,Cáceres,45,Cañaveral,1309,640,669
10,Cáceres,46,Carbajo,253,129,124
10,Cáceres,47,Carcaboso,972,545,427
10,Cáceres,48,Carrascalejo,347,179,168
10,Cáceres,49,Casar de Cáceres,4848,2422,2426
10,Cáceres,50,Casar de Palomero,1247,638,609
10,Cáceres,51,Casares de las Hurdes,582,283,299
10,Cáceres,52,Casas de Don Antonio,218,97,121
10,Cáceres,53,Casas de Don Gómez,357,187,170
10,Cáceres,56,Casas de Millán,720,359,361
10,Cáceres,57,Casas de Miravete,172,95,77
10,Cáceres,54,Casas del Castañar,632,311,321
10,Cáceres,55,Casas del Monte,850,446,404
10,Cáceres,58,Casatejada,1341,688,653
10,Cáceres,59,Casillas de Coria,494,235,259
10,Cáceres,60,Castañar de Ibor,1229,636,593
10,Cáceres,61,Ceclavín,2114,1054,1060
10,Cáceres,62,Cedillo,549,281,268
10,Cáceres,63,Cerezo,196,89,107
10,Cáceres,64,Cilleros,1962,992,970
10,Cáceres,65,Collado,220,116,104
10,Cáceres,66,Conquista de la Sierra,220,116,104
10,Cáceres,67,Coria,12901,6483,6418
10,Cáceres,68,Cuacos de Yuste,939,493,446
10,Cáceres,69,Cumbre (La),1023,518,505
10,Cáceres,70,Deleitosa,844,427,417
10,Cáceres,71,Descargamaría,235,126,109
10,Cáceres,72,Eljas,1081,553,528
10,Cáceres,73,Escurial,895,455,440
10,Cáceres,75,Fresnedoso de Ibor,338,163,175
10,Cáceres,76,Galisteo,2001,1002,999
10,Cáceres,77,Garciaz,902,467,435
10,Cáceres,78,Garganta (La),530,287,243
10,Cáceres,79,Garganta la Olla,1112,592,520
10,Cáceres,80,Gargantilla,450,230,220
10,Cáceres,81,Gargüera,151,81,70
10,Cáceres,82,Garrovillas de Alconétar,2350,1143,1207
10,Cáceres,83,Garvín,109,59,50
10,Cáceres,84,Gata,1729,876,853
10,Cáceres,85,Gordo (El),314,155,159
10,Cáceres,86,Granja (La),378,206,172
10,Cáceres,87,Guadalupe,2206,1085,1121
10,Cáceres,88,Guijo de Coria,242,128,114
10,Cáceres,89,Guijo de Galisteo,1513,821,692
10,Cáceres,90,Guijo de Granadilla,643,319,324
10,Cáceres,91,Guijo de Santa Bárbara,416,215,201
10,Cáceres,92,Herguijuela,351,180,171
10,Cáceres,93,Hernán-Pérez,516,267,249
10,Cáceres,94,Herrera de Alcántara,293,153,140
10,Cáceres,95,Herreruela,397,198,199
10,Cáceres,96,Hervás,3924,1927,1997
10,Cáceres,97,Higuera,108,58,50
10,Cáceres,98,Hinojal,421,209,212
10,Cáceres,99,Holguera,748,375,373
10,Cáceres,100,Hoyos,970,494,476
10,Cáceres,101,Huélaga,181,87,94
10,Cáceres,102,Ibahernando,568,276,292
10,Cáceres,103,Jaraicejo,593,288,305
10,Cáceres,104,Jaraíz de la Vera,6647,3361,3286
10,Cáceres,105,Jarandilla de la Vera,3043,1514,1529
10,Cáceres,106,Jarilla,153,74,79
10,Cáceres,107,Jerte,1302,661,641
10,Cáceres,108,Ladrillar,249,132,117
10,Cáceres,109,Logrosán,2227,1147,1080
10,Cáceres,110,Losar de la Vera,3026,1577,1449
10,Cáceres,111,Madrigal de la Vera,1742,914,828
10,Cáceres,112,Madrigalejo,2075,1040,1035
10,Cáceres,113,Madroñera,2910,1448,1462
10,Cáceres,114,Majadas,1291,676,615
10,Cáceres,115,Malpartida de Cáceres,4426,2262,2164
10,Cáceres,116,Malpartida de Plasencia,4410,2198,2212
10,Cáceres,117,Marchagaz,269,136,133
10,Cáceres,118,Mata de Alcántara,317,157,160
10,Cáceres,119,Membrío,880,421,459
10,Cáceres,120,Mesas de Ibor,201,108,93
10,Cáceres,121,Miajadas,10106,5016,5090
10,Cáceres,122,Millanes,246,122,124
10,Cáceres,123,Mirabel,751,384,367
10,Cáceres,124,Mohedas de Granadilla,1029,515,514
10,Cáceres,125,Monroy,1001,518,483
10,Cáceres,126,Montánchez,2086,1035,1051
10,Cáceres,127,Montehermoso,5668,2889,2779
10,Cáceres,128,Moraleja,7904,3983,3921
10,Cáceres,129,Morcillo,437,214,223
10,Cáceres,130,Navaconcejo,2081,1045,1036
10,Cáceres,131,Navalmoral de la Mata,17099,8618,8481
10,Cáceres,132,Navalvillar de Ibor,420,222,198
10,Cáceres,133,Navas del Madroño,1508,752,756
10,Cáceres,134,Navezuelas,722,382,340
10,Cáceres,135,Nuñomoral,1523,809,714
10,Cáceres,136,Oliva de Plasencia,271,145,126
10,Cáceres,137,Palomero,495,249,246
10,Cáceres,138,Pasarón de la Vera,692,333,359
10,Cáceres,139,Pedroso de Acim,111,58,53
10,Cáceres,140,Peraleda de la Mata,1536,786,750
10,Cáceres,141,Peraleda de San Román,342,166,176
10,Cáceres,142,Perales del Puerto,992,493,499
10,Cáceres,143,Pescueza,165,78,87
10,Cáceres,144,Pesga (La),1148,591,557
10,Cáceres,145,Piedras Albas,147,69,78
10,Cáceres,146,Pinofranqueado,1673,894,779
10,Cáceres,147,Piornal,1524,751,773
10,Cáceres,148,Plasencia,39785,19457,20328
10,Cáceres,149,Plasenzuela,546,265,281
10,Cáceres,150,Portaje,398,196,202
10,Cáceres,151,Portezuelo,287,141,146
10,Cáceres,152,Pozuelo de Zarzón,564,271,293
10,Cáceres,153,Puerto de Santa Cruz,403,207,196
10,Cáceres,154,Rebollar,227,113,114
10,Cáceres,155,Riolobos,1268,662,606
10,Cáceres,156,Robledillo de Gata,136,73,63
10,Cáceres,157,Robledillo de la Vera,318,164,154
10,Cáceres,158,Robledillo de Trujillo,454,242,212
10,Cáceres,159,Robledollano,403,218,185
10,Cáceres,160,Romangordo,173,86,87
10,Cáceres,901,Rosalejo,1454,764,690
10,Cáceres,161,Ruanes,70,38,32
10,Cáceres,162,Salorino,743,369,374
10,Cáceres,163,Salvatierra de Santiago,355,170,185
10,Cáceres,164,San Martín de Trevejo,927,445,482
10,Cáceres,165,Santa Ana,323,167,156
10,Cáceres,166,Santa Cruz de la Sierra,296,148,148
10,Cáceres,167,Santa Cruz de Paniagua,372,201,171
10,Cáceres,168,Santa Marta de Magasca,252,123,129
10,Cáceres,169,Santiago de Alcántara,724,361,363
10,Cáceres,170,Santiago del Campo,323,166,157
10,Cáceres,171,Santibáñez el Alto,480,241,239
10,Cáceres,172,Santibáñez el Bajo,863,450,413
10,Cáceres,173,Saucedilla,729,383,346
10,Cáceres,174,Segura de Toro,185,89,96
10,Cáceres,175,Serradilla,1781,917,864
10,Cáceres,176,Serrejón,490,248,242
10,Cáceres,177,Sierra de Fuentes,1808,942,866
10,Cáceres,178,Talaván,925,470,455
10,Cáceres,179,Talaveruela de la Vera,378,178,200
10,Cáceres,180,Talayuela,10432,6108,4324
10,Cáceres,181,Tejeda de Tiétar,967,509,458
10,Cáceres,182,Toril,199,122,77
10,Cáceres,183,Tornavacas,1255,658,597
10,Cáceres,184,Torno (El),926,489,437
10,Cáceres,187,Torre de Don Miguel,609,312,297
10,Cáceres,188,Torre de Santa María,668,339,329
10,Cáceres,185,Torrecilla de los Ángeles,708,365,343
10,Cáceres,186,Torrecillas de la Tiesa,1172,587,585
10,Cáceres,190,Torrejón el Rubio,613,316,297
10,Cáceres,189,Torrejoncillo,3350,1641,1709
10,Cáceres,191,Torremenga,627,332,295
10,Cáceres,192,Torremocha,1096,541,555
10,Cáceres,193,Torreorgaz,1728,850,878
10,Cáceres,194,Torrequemada,591,282,309
10,Cáceres,195,Trujillo,9770,4785,4985
10,Cáceres,196,Valdastillas,368,197,171
10,Cáceres,197,Valdecañas de Tajo,168,98,70
10,Cáceres,198,Valdefuentes,1489,765,724
10,Cáceres,199,Valdehúncar,194,96,98
10,Cáceres,200,Valdelacasa de Tajo,477,228,249
10,Cáceres,201,Valdemorales,242,119,123
10,Cáceres,202,Valdeobispo,773,376,397
10,Cáceres,203,Valencia de Alcántara,6102,3023,3079
10,Cáceres,204,Valverde de la Vera,612,316,296
10,Cáceres,205,Valverde del Fresno,2576,1327,1249
10,Cáceres,206,Viandar de la Vera,279,134,145
10,Cáceres,207,Villa del Campo,581,280,301
10,Cáceres,208,Villa del Rey,137,72,65
10,Cáceres,209,Villamesías,344,173,171
10,Cáceres,210,Villamiel,758,380,378
10,Cáceres,211,Villanueva de la Sierra,553,273,280
10,Cáceres,212,Villanueva de la Vera,2113,1078,1035
10,Cáceres,214,Villar de Plasencia,258,129,129
10,Cáceres,213,Villar del Pedroso,699,350,349
10,Cáceres,215,Villasbuenas de Gata,491,252,239
10,Cáceres,216,Zarza de Granadilla,1761,898,863
10,Cáceres,217,Zarza de Montánchez,631,318,313
10,Cáceres,218,Zarza la Mayor,1488,763,725
10,Cáceres,219,Zorita,1768,861,907
11,Cádiz,1,Alcalá de los Gazules,5650,2881,2769
11,Cádiz,2,Alcalá del Valle,5382,2769,2613
11,Cádiz,3,Algar,1613,843,770
11,Cádiz,4,Algeciras,112937,57853,55084
11,Cádiz,5,Algodonales,5706,2933,2773
11,Cádiz,6,Arcos de la Frontera,29905,14952,14953
11,Cádiz,7,Barbate,22602,11344,11258
11,Cádiz,8,Barrios (Los),20871,10528,10343
11,Cádiz,901,Benalup-Casas Viejas,6865,3482,3383
11,Cádiz,9,Benaocaz,720,367,353
11,Cádiz,10,Bornos,8140,4055,4085
11,Cádiz,11,Bosque (El),2024,1043,981
11,Cádiz,12,Cádiz,130561,62374,68187
11,Cádiz,13,Castellar de la Frontera,2943,1503,1440
11,Cádiz,15,Chiclana de la Frontera,72364,36617,35747
11,Cádiz,16,Chipiona,17952,8990,8962
11,Cádiz,14,Conil de la Frontera,19890,10123,9767
11,Cádiz,17,Espera,3949,2001,1948
11,Cádiz,18,Gastor (El),1900,1005,895
11,Cádiz,19,Grazalema,2243,1172,1071
11,Cádiz,20,Jerez de la Frontera,199544,97424,102120
11,Cádiz,21,Jimena de la Frontera,9893,5161,4732
11,Cádiz,22,Línea de la Concepción (La),63026,31218,31808
11,Cádiz,23,Medina-Sidonia,11166,5793,5373
11,Cádiz,24,Olvera,8612,4276,4336
11,Cádiz,25,Paterna de Rivera,5443,2846,2597
11,Cádiz,26,Prado del Rey,5994,2985,3009
11,Cádiz,27,Puerto de Santa María (El),83101,41210,41891
11,Cádiz,28,Puerto Real,38354,19329,19025
11,Cádiz,29,Puerto Serrano,6960,3553,3407
11,Cádiz,30,Rota,27270,13718,13552
11,Cádiz,31,San Fernando,93544,46238,47306
11,Cádiz,902,San José del Valle,4244,2167,2077
11,Cádiz,33,San Roque,26569,13420,13149
11,Cádiz,32,Sanlúcar de Barrameda,63509,31732,31777
11,Cádiz,34,Setenil de las Bodegas,3023,1550,1473
11,Cádiz,35,Tarifa,17478,8929,8549
11,Cádiz,36,Torre Alháquime,874,459,415
11,Cádiz,37,Trebujena,6911,3582,3329
11,Cádiz,38,Ubrique,17205,8511,8694
11,Cádiz,39,Vejer de la Frontera,12801,6490,6311
11,Cádiz,40,Villaluenga del Rosario,481,251,230
11,Cádiz,41,Villamartín,12291,6166,6125
11,Cádiz,42,Zahara,1552,804,748
12,Castellón/Castelló,2,Aín,145,71,74
12,Castellón/Castelló,3,Albocàsser,1377,685,692
12,Castellón/Castelló,4,Alcalà de Xivert,7074,3656,3418
12,Castellón/Castelló,5,Alcora (l'),10535,5368,5167
12,Castellón/Castelló,6,Alcudia de Veo,211,99,112
12,Castellón/Castelló,7,Alfondeguilla,893,432,461
12,Castellón/Castelló,8,Algimia de Almonacid,286,162,124
12,Castellón/Castelló,9,Almazora/Almassora,20597,10288,10309
12,Castellón/Castelló,10,Almedíjar,272,133,139
12,Castellón/Castelló,11,Almenara,5324,2634,2690
12,Castellón/Castelló,901,Alquerías del Niño Perdido,3866,1909,1957
12,Castellón/Castelló,12,Altura,3470,1772,1698
12,Castellón/Castelló,13,Arañuel,188,87,101
12,Castellón/Castelló,14,Ares del Maestre,222,117,105
12,Castellón/Castelló,15,Argelita,112,58,54
12,Castellón/Castelló,16,Artana,1857,935,922
12,Castellón/Castelló,1,Atzeneta del Maestrat,1463,743,720
12,Castellón/Castelló,17,Ayódar,227,126,101
12,Castellón/Castelló,18,Azuébar,342,168,174
12,Castellón/Castelló,20,Barracas,192,100,92
12,Castellón/Castelló,22,Bejís,421,235,186
12,Castellón/Castelló,24,Benafer,167,86,81
12,Castellón/Castelló,25,Benafigos,190,105,85
12,Castellón/Castelló,26,Benasal,1346,685,661
12,Castellón/Castelló,27,Benicarló,24427,12351,12076
12,Castellón/Castelló,28,Benicasim/Benicàssim,16584,8370,8214
12,Castellón/Castelló,29,Benlloch,1107,590,517
12,Castellón/Castelló,21,Betxí,5615,2849,2766
12,Castellón/Castelló,31,Borriol,4478,2286,2192
12,Castellón/Castelló,32,Burriana,32349,16194,16155
12,Castellón/Castelló,33,Cabanes,2734,1382,1352
12,Castellón/Castelló,34,Càlig,1963,971,992
12,Castellón/Castelló,36,Canet lo Roig,913,445,468
12,Castellón/Castelló,37,Castell de Cabres,19,9,10
12,Castellón/Castelló,38,Castellfort,218,112,106
12,Castellón/Castelló,39,Castellnovo,1019,497,522
12,Castellón/Castelló,40,Castellón de la Plana/Castelló de la Plana,172110,85208,86902
12,Castellón/Castelló,41,Castillo de Villamalefa,101,48,53
12,Castellón/Castelló,42,Catí,869,454,415
12,Castellón/Castelló,43,Caudiel,697,361,336
12,Castellón/Castelló,44,Cervera del Maestre,680,328,352
12,Castellón/Castelló,52,Chert/Xert,912,449,463
12,Castellón/Castelló,53,Chilches/Xilxes,2638,1354,1284
12,Castellón/Castelló,55,Chodos/Xodos,128,69,59
12,Castellón/Castelló,56,Chóvar,356,184,172
12,Castellón/Castelló,45,Cinctorres,526,249,277
12,Castellón/Castelló,46,Cirat,262,144,118
12,Castellón/Castelló,48,Cortes de Arenoso,407,217,190
12,Castellón/Castelló,49,Costur,498,255,243
12,Castellón/Castelló,50,Coves de Vinromà (les),1876,942,934
12,Castellón/Castelló,51,Culla,651,338,313
12,Castellón/Castelló,57,Eslida,863,429,434
12,Castellón/Castelló,58,Espadilla,72,32,40
12,Castellón/Castelló,59,Fanzara,280,135,145
12,Castellón/Castelló,60,Figueroles,571,287,284
12,Castellón/Castelló,61,Forcall,542,258,284
12,Castellón/Castelló,63,Fuente la Reina,44,21,23
12,Castellón/Castelló,64,Fuentes de Ayódar,100,55,45
12,Castellón/Castelló,65,Gaibiel,183,96,87
12,Castellón/Castelló,67,Geldo,684,355,329
12,Castellón/Castelló,68,Herbés,72,42,30
12,Castellón/Castelló,69,Higueras,73,35,38
12,Castellón/Castelló,70,Jana (la),823,412,411
12,Castellón/Castelló,71,Jérica,1589,800,789
12,Castellón/Castelló,74,Llosa (la),917,466,451
12,Castellón/Castelló,72,Lucena del Cid,1605,817,788
12,Castellón/Castelló,73,Ludiente,185,99,86
12,Castellón/Castelló,75,Mata de Morella (la),174,91,83
12,Castellón/Castelló,76,Matet,121,59,62
12,Castellón/Castelló,77,Moncofa,5278,2707,2571
12,Castellón/Castelló,78,Montán,380,192,188
12,Castellón/Castelló,79,Montanejos,500,252,248
12,Castellón/Castelló,80,Morella,2802,1389,1413
12,Castellón/Castelló,81,Navajas,646,336,310
12,Castellón/Castelló,82,Nules,12666,6340,6326
12,Castellón/Castelló,83,Olocau del Rey,136,76,60
12,Castellón/Castelló,84,Onda,22526,11450,11076
12,Castellón/Castelló,85,Oropesa del Mar/Orpesa,8527,4740,3787
12,Castellón/Castelló,87,Palanques,33,17,16
12,Castellón/Castelló,88,Pavías,62,37,25
12,Castellón/Castelló,89,Peñíscola,6432,3341,3091
12,Castellón/Castelló,90,Pina de Montalgrao,161,89,72
12,Castellón/Castelló,93,Pobla de Benifassà (la),252,130,122
12,Castellón/Castelló,94,Pobla Tornesa (la),845,436,409
12,Castellón/Castelló,91,Portell de Morella,254,125,129
12,Castellón/Castelló,92,Puebla de Arenoso,184,110,74
12,Castellón/Castelló,95,Ribesalbes,1342,678,664
12,Castellón/Castelló,96,Rossell,1275,676,599
12,Castellón/Castelló,97,Sacañet,111,59,52
12,Castellón/Castelló,98,Salzadella (la),816,426,390
12,Castellón/Castelló,101,San Rafael del Río,511,268,243
12,Castellón/Castelló,902,Sant Joan de Moró,2375,1298,1077
12,Castellón/Castelló,99,Sant Jordi/San Jorge,782,404,378
12,Castellón/Castelló,100,Sant Mateu,2043,1050,993
12,Castellón/Castelló,102,Santa Magdalena de Pulpis,836,436,400
12,Castellón/Castelló,103,Sarratella,93,48,45
12,Castellón/Castelló,104,Segorbe,8730,4293,4437
12,Castellón/Castelló,105,Sierra Engarcerán,1069,550,519
12,Castellón/Castelló,106,Soneja,1408,710,698
12,Castellón/Castelló,107,Sot de Ferrer,475,238,237
12,Castellón/Castelló,108,Sueras/Suera,592,295,297
12,Castellón/Castelló,109,Tales,828,419,409
12,Castellón/Castelló,110,Teresa,320,163,157
12,Castellón/Castelló,111,Tírig,555,293,262
12,Castellón/Castelló,112,Todolella,140,83,57
12,Castellón/Castelló,113,Toga,107,50,57
12,Castellón/Castelló,114,Torás,255,128,127
12,Castellón/Castelló,115,Toro (El),288,153,135
12,Castellón/Castelló,116,Torralba del Pinar,73,34,39
12,Castellón/Castelló,119,Torre d'En Besora (la),189,104,85
12,Castellón/Castelló,120,Torre Endoménech,248,132,116
12,Castellón/Castelló,117,Torreblanca,5884,3064,2820
12,Castellón/Castelló,118,Torrechiva,98,57,41
12,Castellón/Castelló,121,Traiguera,1664,882,782
12,Castellón/Castelló,122,Useras/Useres (les),1001,519,482
12,Castellón/Castelló,124,Vall d'Alba,2438,1245,1193
12,Castellón/Castelló,125,Vall de Almonacid,278,142,136
12,Castellón/Castelló,126,Vall d'Uixó (la),31553,15792,15761
12,Castellón/Castelló,123,Vallat,69,35,34
12,Castellón/Castelló,127,Vallibona,100,53,47
12,Castellón/Castelló,128,Vilafamés,1806,974,832
12,Castellón/Castelló,132,Vilanova d'Alcolea,671,348,323
12,Castellón/Castelló,134,Vilar de Canes,185,94,91
12,Castellón/Castelló,136,Vilavella (la),3368,1686,1682
12,Castellón/Castelló,129,Villafranca del Cid/Vilafranca,2518,1215,1303
12,Castellón/Castelló,130,Villahermosa del Río,444,233,211
12,Castellón/Castelló,131,Villamalur,100,52,48
12,Castellón/Castelló,133,Villanueva de Viver,72,41,31
12,Castellón/Castelló,135,Villarreal/Vila-real,48055,24108,23947
12,Castellón/Castelló,137,Villores,54,30,24
12,Castellón/Castelló,138,Vinaròs,26251,13082,13169
12,Castellón/Castelló,139,Vistabella del Maestrazgo,399,203,196
12,Castellón/Castelló,140,Viver,1479,765,714
12,Castellón/Castelló,141,Zorita del Maestrazgo,131,60,71
12,Castellón/Castelló,142,Zucaina,186,106,80
13,Ciudad Real,1,Abenójar,1635,835,800
13,Ciudad Real,2,Agudo,1937,974,963
13,Ciudad Real,3,Alamillo,615,308,307
13,Ciudad Real,4,Albaladejo,1558,805,753
13,Ciudad Real,5,Alcázar de San Juan,29625,14634,14991
13,Ciudad Real,6,Alcoba,744,375,369
13,Ciudad Real,7,Alcolea de Calatrava,1630,838,792
13,Ciudad Real,8,Alcubillas,660,354,306
13,Ciudad Real,9,Aldea del Rey,2002,996,1006
13,Ciudad Real,10,Alhambra,1169,592,577
13,Ciudad Real,11,Almadén,6406,3053,3353
13,Ciudad Real,12,Almadenejos,521,276,245
13,Ciudad Real,13,Almagro,8490,4171,4319
13,Ciudad Real,14,Almedina,680,343,337
13,Ciudad Real,15,Almodóvar del Campo,6936,3405,3531
13,Ciudad Real,16,Almuradiel,993,483,510
13,Ciudad Real,17,Anchuras,383,222,161
13,Ciudad Real,903,Arenales de San Gregorio,713,371,342
13,Ciudad Real,18,Arenas de San Juan,1044,536,508
13,Ciudad Real,19,Argamasilla de Alba,7040,3557,3483
13,Ciudad Real,20,Argamasilla de Calatrava,5551,2809,2742
13,Ciudad Real,21,Arroba de los Montes,556,294,262
13,Ciudad Real,22,Ballesteros de Calatrava,546,272,274
13,Ciudad Real,23,Bolaños de Calatrava,12117,6262,5855
13,Ciudad Real,24,Brazatortas,1121,575,546
13,Ciudad Real,25,Cabezarados,364,185,179
13,Ciudad Real,26,Cabezarrubias del Puerto,576,294,282
13,Ciudad Real,27,Calzada de Calatrava,4539,2265,2274
13,Ciudad Real,28,Campo de Criptana,13753,6928,6825
13,Ciudad Real,29,Cañada de Calatrava,108,57,51
13,Ciudad Real,30,Caracuel de Calatrava,171,89,82
13,Ciudad Real,31,Carrión de Calatrava,2712,1367,1345
13,Ciudad Real,32,Carrizosa,1552,776,776
13,Ciudad Real,33,Castellar de Santiago,2209,1100,1109
13,Ciudad Real,38,Chillón,2153,1051,1102
13,Ciudad Real,34,Ciudad Real,70124,33224,36900
13,Ciudad Real,35,Corral de Calatrava,1278,638,640
13,Ciudad Real,36,Cortijos (Los),1015,506,509
13,Ciudad Real,37,Cózar,1303,658,645
13,Ciudad Real,39,Daimiel,17913,8888,9025
13,Ciudad Real,40,Fernán Caballero,1139,561,578
13,Ciudad Real,41,Fontanarejo,296,153,143
13,Ciudad Real,42,Fuencaliente,1186,631,555
13,Ciudad Real,43,Fuenllana,277,130,147
13,Ciudad Real,44,Fuente el Fresno,3545,1788,1757
13,Ciudad Real,45,Granátula de Calatrava,1018,500,518
13,Ciudad Real,46,Guadalmez,930,481,449
13,Ciudad Real,47,Herencia,8372,4340,4032
13,Ciudad Real,48,Hinojosas de Calatrava,635,312,323
13,Ciudad Real,49,Horcajo de los Montes,985,487,498
13,Ciudad Real,50,Labores (Las),673,336,337
13,Ciudad Real,904,Llanos del Caudillo,687,355,332
13,Ciudad Real,51,Luciana,437,229,208
13,Ciudad Real,52,Malagón,8135,4036,4099
13,Ciudad Real,53,Manzanares,18721,9337,9384
13,Ciudad Real,54,Membrilla,6517,3273,3244
13,Ciudad Real,55,Mestanza,833,404,429
13,Ciudad Real,56,Miguelturra,12354,6233,6121
13,Ciudad Real,57,Montiel,1656,842,814
13,Ciudad Real,58,Moral de Calatrava,5297,2639,2658
13,Ciudad Real,59,Navalpino,270,133,137
13,Ciudad Real,60,Navas de Estena,408,224,184
13,Ciudad Real,61,Pedro Muñoz,7905,4084,3821
13,Ciudad Real,62,Picón,665,341,324
13,Ciudad Real,63,Piedrabuena,4901,2490,2411
13,Ciudad Real,64,Poblete,1156,586,570
13,Ciudad Real,65,Porzuna,4013,2033,1980
13,Ciudad Real,66,Pozuelo de Calatrava,2750,1379,1371
13,Ciudad Real,67,Pozuelos de Calatrava (Los),444,224,220
13,Ciudad Real,68,Puebla de Don Rodrigo,1277,688,589
13,Ciudad Real,69,Puebla del Príncipe,930,474,456
13,Ciudad Real,70,Puerto Lápice,1011,514,497
13,Ciudad Real,71,Puertollano,50470,24666,25804
13,Ciudad Real,72,Retuerta del Bullaque,1127,612,515
13,Ciudad Real,901,Robledo (El),1154,589,565
13,Ciudad Real,902,Ruidera,577,292,285
13,Ciudad Real,73,Saceruela,694,355,339
13,Ciudad Real,74,San Carlos del Valle,1219,613,606
13,Ciudad Real,75,San Lorenzo de Calatrava,289,151,138
13,Ciudad Real,76,Santa Cruz de los Cáñamos,625,311,314
13,Ciudad Real,77,Santa Cruz de Mudela,4734,2337,2397
13,Ciudad Real,78,Socuéllamos,12918,6592,6326
13,Ciudad Real,79,Solana (La),15948,8069,7879
13,Ciudad Real,80,Solana del Pino,415,205,210
13,Ciudad Real,81,Terrinches,926,477,449
13,Ciudad Real,82,Tomelloso,35534,17889,17645
13,Ciudad Real,83,Torralba de Calatrava,3006,1488,1518
13,Ciudad Real,84,Torre de Juan Abad,1335,659,676
13,Ciudad Real,85,Torrenueva,3020,1544,1476
13,Ciudad Real,86,Valdemanco del Esteras,258,129,129
13,Ciudad Real,87,Valdepeñas,28183,13707,14476
13,Ciudad Real,88,Valenzuela de Calatrava,804,387,417
13,Ciudad Real,89,Villahermosa,2344,1122,1222
13,Ciudad Real,90,Villamanrique,1500,736,764
13,Ciudad Real,91,Villamayor de Calatrava,611,302,309
13,Ciudad Real,92,Villanueva de la Fuente,2585,1296,1289
13,Ciudad Real,93,Villanueva de los Infantes,5913,2944,2969
13,Ciudad Real,94,Villanueva de San Carlos,398,201,197
13,Ciudad Real,95,Villar del Pozo,110,57,53
13,Ciudad Real,96,Villarrubia de los Ojos,10378,5226,5152
13,Ciudad Real,97,Villarta de San Juan,3026,1547,1479
13,Ciudad Real,98,Viso del Marqués,2898,1459,1439
14,Córdoba,1,Adamuz,4476,2277,2199
14,Córdoba,2,Aguilar de la Frontera,13657,6812,6845
14,Córdoba,3,Alcaracejos,1485,719,766
14,Córdoba,4,Almedinilla,2536,1278,1258
14,Córdoba,5,Almodóvar del Río,7487,3717,3770
14,Córdoba,6,Añora,1534,756,778
14,Córdoba,7,Baena,20507,10409,10098
14,Córdoba,8,Belalcázar,3567,1723,1844
14,Córdoba,9,Belmez,3327,1596,1731
14,Córdoba,10,Benamejí,5072,2524,2548
14,Córdoba,11,Blázquez (Los),691,350,341
14,Córdoba,12,Bujalance,7832,3864,3968
14,Córdoba,13,Cabra,20935,10224,10711
14,Córdoba,14,Cañete de las Torres,3211,1623,1588
14,Córdoba,15,Carcabuey,2775,1403,1372
14,Córdoba,16,Cardeña,1750,876,874
14,Córdoba,17,Carlota (La),11906,5987,5919
14,Córdoba,18,Carpio (El),4477,2213,2264
14,Córdoba,19,Castro del Río,8074,4019,4055
14,Córdoba,20,Conquista,486,231,255
14,Córdoba,21,Córdoba,322867,155543,167324
14,Córdoba,22,Doña Mencía,5001,2473,2528
14,Córdoba,23,Dos Torres,2592,1286,1306
14,Córdoba,24,Encinas Reales,2425,1197,1228
14,Córdoba,25,Espejo,3749,1875,1874
14,Córdoba,26,Espiel,2422,1227,1195
14,Córdoba,27,Fernán-Núñez,9502,4743,4759
14,Córdoba,28,Fuente la Lancha,415,199,216
14,Córdoba,29,Fuente Obejuna,5409,2728,2681
14,Córdoba,30,Fuente Palmera,10356,5203,5153
14,Córdoba,31,Fuente-Tójar,795,376,419
14,Córdoba,32,Granjuela (La),501,262,239
14,Córdoba,33,Guadalcázar,1261,628,633
14,Córdoba,34,Guijo (El),404,204,200
14,Córdoba,35,Hinojosa del Duque,7546,3649,3897
14,Córdoba,36,Hornachuelos,4662,2350,2312
14,Córdoba,37,Iznájar,4865,2440,2425
14,Córdoba,38,Lucena,40143,20012,20131
14,Córdoba,39,Luque,3293,1645,1648
14,Córdoba,40,Montalbán de Córdoba,4621,2340,2281
14,Córdoba,41,Montemayor,3936,1959,1977
14,Córdoba,42,Montilla,23574,11675,11899
14,Córdoba,43,Montoro,9690,4795,4895
14,Córdoba,44,Monturque,2001,994,1007
14,Córdoba,45,Moriles,3884,1947,1937
14,Córdoba,46,Nueva Carteya,5566,2799,2767
14,Córdoba,47,Obejo,1791,891,900
14,Córdoba,48,Palenciana,1584,801,783
14,Córdoba,49,Palma del Río,20640,10335,10305
14,Córdoba,50,Pedro Abad,2934,1480,1454
14,Córdoba,51,Pedroche,1677,829,848
14,Córdoba,52,Peñarroya-Pueblonuevo,12050,5780,6270
14,Córdoba,53,Posadas,7360,3641,3719
14,Córdoba,54,Pozoblanco,17219,8389,8830
14,Córdoba,55,Priego de Córdoba,23087,11364,11723
14,Córdoba,56,Puente Genil,28639,14232,14407
14,Córdoba,57,Rambla (La),7410,3686,3724
14,Córdoba,58,Rute,10309,5150,5159
14,Córdoba,59,San Sebastián de los Ballesteros,836,439,397
14,Córdoba,61,Santa Eufemia,998,504,494
14,Córdoba,60,Santaella,6002,3003,2999
14,Córdoba,62,Torrecampo,1320,638,682
14,Córdoba,63,Valenzuela,1364,675,689
14,Córdoba,64,Valsequillo,415,199,216
14,Córdoba,65,Victoria (La),1882,949,933
14,Córdoba,66,Villa del Río,7433,3781,3652
14,Córdoba,67,Villafranca de Córdoba,4074,2079,1995
14,Córdoba,68,Villaharta,687,355,332
14,Córdoba,69,Villanueva de Córdoba,9800,4847,4953
14,Córdoba,70,Villanueva del Duque,1666,807,859
14,Córdoba,71,Villanueva del Rey,1224,624,600
14,Córdoba,72,Villaralto,1350,664,686
14,Córdoba,73,Villaviciosa de Córdoba,3601,1829,1772
14,Córdoba,74,Viso (El),2849,1398,1451
14,Córdoba,75,Zuheros,821,420,401
15,A Coruña,1,Abegondo,5773,2860,2913
15,A Coruña,2,Ames,23219,11268,11951
15,A Coruña,3,Aranga,2230,1122,1108
15,A Coruña,4,Ares,5405,2676,2729
15,A Coruña,5,Arteixo,26739,13347,13392
15,A Coruña,6,Arzúa,6532,3221,3311
15,A Coruña,7,Baña (A),4652,2230,2422
15,A Coruña,8,Bergondo,6539,3140,3399
15,A Coruña,9,Betanzos,13165,6227,6938
15,A Coruña,10,Boimorto,2410,1212,1198
15,A Coruña,11,Boiro,18554,8978,9576
15,A Coruña,12,Boqueixón,4406,2170,2236
15,A Coruña,13,Brión,6972,3381,3591
15,A Coruña,14,Cabana de Bergantiños,5199,2558,2641
15,A Coruña,15,Cabanas,3343,1654,1689
15,A Coruña,16,Camariñas,6323,3120,3203
15,A Coruña,17,Cambre,22092,10897,11195
15,A Coruña,18,Capela (A),1487,729,758
15,A Coruña,19,Carballo,29985,14585,15400
15,A Coruña,901,Cariño,4700,2295,2405
15,A Coruña,20,Carnota,5112,2458,2654
15,A Coruña,21,Carral,5579,2718,2861
15,A Coruña,22,Cedeira,7443,3689,3754
15,A Coruña,23,Cee,7489,3604,3885
15,A Coruña,24,Cerceda,5483,2657,2826
15,A Coruña,25,Cerdido,1496,733,763
15,A Coruña,26,Cesuras,2391,1174,1217
15,A Coruña,27,Coirós,1654,814,840
15,A Coruña,28,Corcubión,1912,930,982
15,A Coruña,29,Coristanco,7582,3687,3895
15,A Coruña,30,Coruña (A),243320,113431,129889
15,A Coruña,31,Culleredo,26547,12918,13629
15,A Coruña,32,Curtis,4287,2110,2177
15,A Coruña,33,Dodro,3087,1494,1593
15,A Coruña,34,Dumbría,3970,1910,2060
15,A Coruña,35,Fene,14346,6961,7385
15,A Coruña,36,Ferrol,76399,35615,40784
15,A Coruña,37,Fisterra,5009,2532,2477
15,A Coruña,38,Frades,2841,1427,1414
15,A Coruña,39,Irixoa,1552,767,785
15,A Coruña,41,Laracha (A),10803,5257,5546
15,A Coruña,40,Laxe,3489,1743,1746
15,A Coruña,42,Lousame,3798,1805,1993
15,A Coruña,43,Malpica de Bergantiños,6567,3199,3368
15,A Coruña,44,Mañón,1765,865,900
15,A Coruña,45,Mazaricos,5329,2543,2786
15,A Coruña,46,Melide,7931,3873,4058
15,A Coruña,47,Mesía,3102,1554,1548
15,A Coruña,48,Miño,5162,2500,2662
15,A Coruña,49,Moeche,1437,664,773
15,A Coruña,50,Monfero,2414,1220,1194
15,A Coruña,51,Mugardos,5638,2754,2884
15,A Coruña,53,Muros,9999,4845,5154
15,A Coruña,52,Muxía,5746,2811,2935
15,A Coruña,54,Narón,35664,17313,18351
15,A Coruña,55,Neda,5675,2783,2892
15,A Coruña,56,Negreira,6481,3107,3374
15,A Coruña,57,Noia,14702,7027,7675
15,A Coruña,58,Oleiros,31264,15196,16068
15,A Coruña,59,Ordes,12294,5975,6319
15,A Coruña,60,Oroso,6526,3259,3267
15,A Coruña,61,Ortigueira,7376,3520,3856
15,A Coruña,62,Outes,7751,3697,4054
15,A Coruña,63,Oza dos Ríos,3184,1569,1615
15,A Coruña,64,Paderne,2735,1336,1399
15,A Coruña,65,Padrón,9016,4317,4699
15,A Coruña,66,Pino (O),4885,2411,2474
15,A Coruña,67,Pobra do Caramiñal (A),10001,4807,5194
15,A Coruña,68,Ponteceso,6588,3305,3283
15,A Coruña,69,Pontedeume,8619,4142,4477
15,A Coruña,70,Pontes de García Rodríguez (As),11697,5855,5842
15,A Coruña,71,Porto do Son,10025,4952,5073
15,A Coruña,72,Rianxo,11246,5475,5771
15,A Coruña,73,Ribeira,27053,13383,13670
15,A Coruña,74,Rois,5105,2426,2679
15,A Coruña,75,Sada,13134,6520,6614
15,A Coruña,76,San Sadurniño,3182,1551,1631
15,A Coruña,77,Santa Comba,10647,5172,5475
15,A Coruña,78,Santiago de Compostela,93458,43680,49778
15,A Coruña,79,Santiso,2116,1082,1034
15,A Coruña,80,Sobrado,2289,1149,1140
15,A Coruña,81,Somozas (As),1392,689,703
15,A Coruña,82,Teo,17168,8413,8755
15,A Coruña,83,Toques,1485,773,712
15,A Coruña,84,Tordoia,4548,2161,2387
15,A Coruña,85,Touro,4448,2190,2258
15,A Coruña,86,Trazo,3557,1755,1802
15,A Coruña,88,Val do Dubra,4580,2221,2359
15,A Coruña,87,Valdoviño,6896,3358,3538
15,A Coruña,89,Vedra,5052,2425,2627
15,A Coruña,91,Vilarmaior,1326,685,641
15,A Coruña,90,Vilasantar,1496,775,721
15,A Coruña,92,Vimianzo,8402,4098,4304
15,A Coruña,93,Zas,5674,2776,2898
16,Cuenca,1,Abia de la Obispalía,88,48,40
16,Cuenca,2,Acebrón (El),253,129,124
16,Cuenca,3,Alarcón,176,81,95
16,Cuenca,4,Albaladejo del Cuende,366,195,171
16,Cuenca,5,Albalate de las Nogueras,317,176,141
16,Cuenca,6,Albendea,160,79,81
16,Cuenca,7,Alberca de Záncara (La),2010,1057,953
16,Cuenca,8,Alcalá de la Vega,152,80,72
16,Cuenca,9,Alcantud,98,52,46
16,Cuenca,10,Alcázar del Rey,224,117,107
16,Cuenca,11,Alcohujate,45,30,15
16,Cuenca,12,Alconchel de la Estrella,156,80,76
16,Cuenca,13,Algarra,28,16,12
16,Cuenca,14,Aliaguilla,818,417,401
16,Cuenca,15,Almarcha (La),579,301,278
16,Cuenca,16,Almendros,297,155,142
16,Cuenca,17,Almodóvar del Pinar,493,253,240
16,Cuenca,18,Almonacid del Marquesado,527,278,249
16,Cuenca,19,Altarejos,292,151,141
16,Cuenca,20,Arandilla del Arroyo,30,17,13
16,Cuenca,905,Arcas del Villar,945,478,467
16,Cuenca,22,Arcos de la Sierra,105,55,50
16,Cuenca,24,Arguisuelas,157,86,71
16,Cuenca,25,Arrancacepas,38,19,19
16,Cuenca,26,Atalaya del Cañavate,118,59,59
16,Cuenca,27,Barajas de Melo,864,452,412
16,Cuenca,29,Barchín del Hoyo,110,63,47
16,Cuenca,30,Bascuñana de San Pedro,35,20,15
16,Cuenca,31,Beamud,88,47,41
16,Cuenca,32,Belinchón,354,182,172
16,Cuenca,33,Belmonte,2254,1091,1163
16,Cuenca,34,Belmontejo,208,101,107
16,Cuenca,35,Beteta,401,193,208
16,Cuenca,36,Boniches,166,81,85
16,Cuenca,38,Buciegas,58,28,30
16,Cuenca,39,Buenache de Alarcón,645,338,307
16,Cuenca,40,Buenache de la Sierra,123,78,45
16,Cuenca,41,Buendía,533,276,257
16,Cuenca,42,Campillo de Altobuey,1678,830,848
16,Cuenca,43,Campillos-Paravientos,130,71,59
16,Cuenca,44,Campillos-Sierra,78,41,37
16,Cuenca,901,Campos del Paraíso,994,486,508
16,Cuenca,45,Canalejas del Arroyo,370,196,174
16,Cuenca,46,Cañada del Hoyo,314,159,155
16,Cuenca,47,Cañada Juncosa,321,178,143
16,Cuenca,48,Cañamares,542,294,248
16,Cuenca,49,Cañavate (El),185,91,94
16,Cuenca,50,Cañaveras,378,185,193
16,Cuenca,51,Cañaveruelas,174,88,86
16,Cuenca,52,Cañete,889,444,445
16,Cuenca,53,Cañizares,565,290,275
16,Cuenca,55,Carboneras de Guadazaón,891,461,430
16,Cuenca,56,Cardenete,666,341,325
16,Cuenca,57,Carrascosa,111,64,47
16,Cuenca,58,Carrascosa de Haro,133,64,69
16,Cuenca,60,Casas de Benítez,1100,538,562
16,Cuenca,61,Casas de Fernando Alonso,1366,704,662
16,Cuenca,62,Casas de Garcimolina,29,18,11
16,Cuenca,63,Casas de Guijarro,134,73,61
16,Cuenca,64,Casas de Haro,904,464,440
16,Cuenca,65,Casas de los Pinos,522,242,280
16,Cuenca,66,Casasimarro,3073,1576,1497
16,Cuenca,67,Castejón,205,92,113
16,Cuenca,68,Castillejo de Iniesta,221,125,96
16,Cuenca,70,Castillejo-Sierra,49,27,22
16,Cuenca,72,Castillo de Garcimuñoz,183,98,85
16,Cuenca,71,Castillo-Albaráñez,23,11,12
16,Cuenca,73,Cervera del Llano,277,143,134
16,Cuenca,23,Chillarón de Cuenca,406,215,191
16,Cuenca,81,Chumillas,67,38,29
16,Cuenca,74,Cierva (La),44,25,19
16,Cuenca,78,Cuenca,51205,24503,26702
16,Cuenca,79,Cueva del Hierro,53,30,23
16,Cuenca,82,Enguídanos,473,242,231
16,Cuenca,83,Fresneda de Altarejos,79,43,36
16,Cuenca,84,Fresneda de la Sierra,68,33,35
16,Cuenca,85,Frontera (La),190,96,94
16,Cuenca,86,Fuente de Pedro Naharro,1294,680,614
16,Cuenca,87,Fuentelespino de Haro,285,151,134
16,Cuenca,88,Fuentelespino de Moya,154,81,73
16,Cuenca,904,Fuentenava de Jábaga,504,256,248
16,Cuenca,89,Fuentes,511,271,240
16,Cuenca,91,Fuertescusa,111,65,46
16,Cuenca,92,Gabaldón,189,112,77
16,Cuenca,93,Garaballa,122,67,55
16,Cuenca,94,Gascueña,164,73,91
16,Cuenca,95,Graja de Campalbo,124,67,57
16,Cuenca,96,Graja de Iniesta,442,237,205
16,Cuenca,97,Henarejos,227,109,118
16,Cuenca,98,Herrumblar (El),753,397,356
16,Cuenca,99,Hinojosa (La),285,143,142
16,Cuenca,100,Hinojosos (Los),1044,513,531
16,Cuenca,101,Hito (El),198,102,96
16,Cuenca,102,Honrubia,1675,832,843
16,Cuenca,103,Hontanaya,391,198,193
16,Cuenca,104,Hontecillas,99,50,49
16,Cuenca,106,Horcajo de Santiago,3848,1987,1861
16,Cuenca,107,Huélamo,118,62,56
16,Cuenca,108,Huelves,67,30,37
16,Cuenca,109,Huérguina,94,53,41
16,Cuenca,110,Huerta de la Obispalía,141,78,63
16,Cuenca,111,Huerta del Marquesado,209,124,85
16,Cuenca,112,Huete,2018,1027,991
16,Cuenca,113,Iniesta,4412,2225,2187
16,Cuenca,115,Laguna del Marquesado,66,32,34
16,Cuenca,116,Lagunaseca,112,54,58
16,Cuenca,117,Landete,1385,698,687
16,Cuenca,118,Ledaña,1908,959,949
16,Cuenca,119,Leganiel,255,128,127
16,Cuenca,121,Majadas (Las),339,173,166
16,Cuenca,122,Mariana,287,141,146
16,Cuenca,123,Masegosa,122,68,54
16,Cuenca,124,Mesas (Las),2467,1262,1205
16,Cuenca,125,Minglanilla,2532,1365,1167
16,Cuenca,126,Mira,1020,525,495
16,Cuenca,128,Monreal del Llano,71,37,34
16,Cuenca,129,Montalbanejo,157,74,83
16,Cuenca,130,Montalbo,753,392,361
16,Cuenca,131,Monteagudo de las Salinas,155,91,64
16,Cuenca,132,Mota de Altarejos,55,35,20
16,Cuenca,133,Mota del Cuervo,6078,3052,3026
16,Cuenca,134,Motilla del Palancar,5620,2838,2782
16,Cuenca,135,Moya,234,128,106
16,Cuenca,137,Narboneta,73,37,36
16,Cuenca,139,Olivares de Júcar,477,246,231
16,Cuenca,140,Olmeda de la Cuesta,39,21,18
16,Cuenca,141,Olmeda del Rey,209,104,105
16,Cuenca,142,Olmedilla de Alarcón,157,84,73
16,Cuenca,143,Olmedilla de Eliz,27,13,14
16,Cuenca,145,Osa de la Vega,648,328,320
16,Cuenca,146,Pajarón,112,59,53
16,Cuenca,147,Pajaroncillo,89,45,44
16,Cuenca,148,Palomares del Campo,877,445,432
16,Cuenca,149,Palomera,170,86,84
16,Cuenca,150,Paracuellos,157,74,83
16,Cuenca,151,Paredes,99,55,44
16,Cuenca,152,Parra de las Vegas (La),39,23,16
16,Cuenca,153,Pedernoso (El),1288,650,638
16,Cuenca,154,Pedroñeras (Las),6919,3652,3267
16,Cuenca,155,Peral (El),729,387,342
16,Cuenca,156,Peraleja (La),144,71,73
16,Cuenca,157,Pesquera (La),246,128,118
16,Cuenca,158,Picazo (El),763,384,379
16,Cuenca,159,Pinarejo,353,167,186
16,Cuenca,160,Pineda de Gigüela,117,62,55
16,Cuenca,161,Piqueras del Castillo,75,39,36
16,Cuenca,162,Portalrubio de Guadamejud,47,24,23
16,Cuenca,163,Portilla,93,45,48
16,Cuenca,165,Poyatos,94,54,40
16,Cuenca,166,Pozoamargo,382,185,197
16,Cuenca,908,Pozorrubielos de la Mancha,299,148,151
16,Cuenca,167,Pozorrubio,424,203,221
16,Cuenca,169,Pozuelo (El),103,50,53
16,Cuenca,170,Priego,1102,567,535
16,Cuenca,171,Provencio (El),2682,1346,1336
16,Cuenca,172,Puebla de Almenara,483,245,238
16,Cuenca,173,Puebla de Don Francisco,364,193,171
16,Cuenca,174,Puebla del Salvador,263,140,123
16,Cuenca,175,Quintanar del Rey,7568,4007,3561
16,Cuenca,176,Rada de Haro,65,34,31
16,Cuenca,177,Reíllo,133,66,67
16,Cuenca,181,Rozalén del Monte,80,35,45
16,Cuenca,185,Saceda-Trasierra,88,49,39
16,Cuenca,186,Saelices,640,320,320
16,Cuenca,187,Salinas del Manzano,111,64,47
16,Cuenca,188,Salmeroncillos,174,88,86
16,Cuenca,189,Salvacañete,318,168,150
16,Cuenca,190,San Clemente,6886,3533,3353
16,Cuenca,191,San Lorenzo de la Parrilla,1316,661,655
16,Cuenca,192,San Martín de Boniches,78,38,40
16,Cuenca,193,San Pedro Palmiches,101,54,47
16,Cuenca,194,Santa Cruz de Moya,364,190,174
16,Cuenca,196,Santa María de los Llanos,788,410,378
16,Cuenca,195,Santa María del Campo Rus,757,379,378
16,Cuenca,197,Santa María del Val,98,54,44
16,Cuenca,198,Sisante,1840,918,922
16,Cuenca,199,Solera de Gabaldón,38,15,23
16,Cuenca,909,Sotorribas,888,444,444
16,Cuenca,202,Talayuelas,1101,564,537
16,Cuenca,203,Tarancón,13447,6651,6796
16,Cuenca,204,Tébar,369,195,174
16,Cuenca,205,Tejadillos,167,82,85
16,Cuenca,206,Tinajas,351,185,166
16,Cuenca,209,Torralba,176,100,76
16,Cuenca,211,Torrejoncillo del Rey,649,315,334
16,Cuenca,212,Torrubia del Campo,342,168,174
16,Cuenca,213,Torrubia del Castillo,39,21,18
16,Cuenca,215,Tragacete,302,163,139
16,Cuenca,216,Tresjuncos,439,224,215
16,Cuenca,217,Tribaldos,121,56,65
16,Cuenca,218,Uclés,263,129,134
16,Cuenca,219,Uña,127,66,61
16,Cuenca,906,Valdecolmenas (Los),106,58,48
16,Cuenca,224,Valdemeca,105,57,48
16,Cuenca,225,Valdemorillo de la Sierra,88,47,41
16,Cuenca,227,Valdemoro-Sierra,164,92,72
16,Cuenca,228,Valdeolivas,259,142,117
16,Cuenca,902,Valdetórtola,163,97,66
16,Cuenca,903,Valeras (Las),1559,833,726
16,Cuenca,231,Valhermoso de la Fuente,42,19,23
16,Cuenca,234,Valsalobre,61,34,27
16,Cuenca,236,Valverde de Júcar,1241,630,611
16,Cuenca,237,Valverdejo,128,65,63
16,Cuenca,238,Vara de Rey,622,322,300
16,Cuenca,239,Vega del Codorno,187,99,88
16,Cuenca,240,Vellisca,143,72,71
16,Cuenca,242,Villaconejos de Trabaque,444,223,221
16,Cuenca,243,Villaescusa de Haro,548,284,264
16,Cuenca,244,Villagarcía del Llano,917,470,447
16,Cuenca,245,Villalba de la Sierra,553,282,271
16,Cuenca,246,Villalba del Rey,621,320,301
16,Cuenca,247,Villalgordo del Marquesado,116,63,53
16,Cuenca,248,Villalpardo,1221,619,602
16,Cuenca,249,Villamayor de Santiago,2888,1458,1430
16,Cuenca,250,Villanueva de Guadamejud,100,56,44
16,Cuenca,251,Villanueva de la Jara,2132,1097,1035
16,Cuenca,253,Villar de Cañas,505,258,247
16,Cuenca,254,Villar de Domingo García,241,132,109
16,Cuenca,255,Villar de la Encina,192,93,99
16,Cuenca,263,Villar de Olalla,1061,556,505
16,Cuenca,258,Villar del Humo,341,193,148
16,Cuenca,259,Villar del Infantado,52,29,23
16,Cuenca,910,Villar y Velasco,127,71,56
16,Cuenca,264,Villarejo de Fuentes,717,355,362
16,Cuenca,265,Villarejo de la Peñuela,30,15,15
16,Cuenca,266,Villarejo-Periesteban,490,242,248
16,Cuenca,269,Villares del Saz,630,329,301
16,Cuenca,270,Villarrubio,247,134,113
16,Cuenca,271,Villarta,909,474,435
16,Cuenca,272,Villas de la Ventosa,358,191,167
16,Cuenca,273,Villaverde y Pasaconsol,398,200,198
16,Cuenca,274,Víllora,175,80,95
16,Cuenca,275,Vindel,22,12,10
16,Cuenca,276,Yémeda,28,14,14
16,Cuenca,277,Zafra de Záncara,155,79,76
16,Cuenca,278,Zafrilla,113,54,59
16,Cuenca,279,Zarza de Tajo,300,158,142
16,Cuenca,280,Zarzuela,254,134,120
17,Girona,1,Agullana,756,394,362
17,Girona,2,Aiguaviva,594,292,302
17,Girona,3,Albanyà,137,72,65
17,Girona,4,Albons,620,329,291
17,Girona,6,Alp,1467,771,696
17,Girona,7,Amer,2258,1127,1131
17,Girona,8,Anglès,5211,2679,2532
17,Girona,9,Arbúcies,6232,3368,2864
17,Girona,10,Argelaguer,418,225,193
17,Girona,11,Armentera (L'),770,382,388
17,Girona,12,Avinyonet de Puigventós,1241,646,595
17,Girona,15,Banyoles,17309,8705,8604
17,Girona,16,Bàscara,900,478,422
17,Girona,13,Begur,4076,2112,1964
17,Girona,18,Bellcaire d'Empordà,672,338,334
17,Girona,19,Besalú,2257,1107,1150
17,Girona,20,Bescanó,3859,1940,1919
17,Girona,21,Beuda,164,80,84
17,Girona,22,Bisbal d'Empordà (La),9261,4608,4653
17,Girona,234,Biure,236,120,116
17,Girona,23,Blanes,37819,19190,18629
17,Girona,29,Boadella i les Escaules,230,112,118
17,Girona,24,Bolvir,295,155,140
17,Girona,25,Bordils,1554,795,759
17,Girona,26,Borrassà,614,327,287
17,Girona,27,Breda,3685,1878,1807
17,Girona,28,Brunyola,362,185,177
17,Girona,31,Cabanelles,240,135,105
17,Girona,30,Cabanes,917,474,443
17,Girona,32,Cadaqués,2922,1431,1491
17,Girona,33,Caldes de Malavella,5674,2843,2831
17,Girona,34,Calonge,9458,4827,4631
17,Girona,35,Camós,677,341,336
17,Girona,36,Campdevànol,3499,1766,1733
17,Girona,37,Campelles,106,56,50
17,Girona,38,Campllong,381,194,187
17,Girona,39,Camprodon,2438,1217,1221
17,Girona,40,Canet d'Adri,576,297,279
17,Girona,41,Cantallops,287,148,139
17,Girona,42,Capmany,494,254,240
17,Girona,44,Cassà de la Selva,8780,4510,4270
17,Girona,46,Castellfollit de la Roca,993,513,480
17,Girona,47,Castelló d'Empúries,10021,5180,4841
17,Girona,48,Castell-Platja d'Aro,9768,5035,4733
17,Girona,189,Cellera de Ter (La),2096,1065,1031
17,Girona,49,Celrà,3783,1904,1879
17,Girona,50,Cervià de Ter,827,408,419
17,Girona,51,Cistella,232,118,114
17,Girona,54,Colera,601,310,291
17,Girona,55,Colomers,213,109,104
17,Girona,57,Corçà,1261,633,628
17,Girona,56,Cornellà del Terri,2079,1040,1039
17,Girona,58,Crespià,242,127,115
17,Girona,901,"Cruïlles, Monells i Sant Sadurní de l'Heura",1271,641,630
17,Girona,60,Darnius,547,276,271
17,Girona,61,Das,176,98,78
17,Girona,62,Escala (L'),8795,4552,4243
17,Girona,63,Espinelves,199,108,91
17,Girona,64,Espolla,367,184,183
17,Girona,65,Esponellà,437,219,218
17,Girona,5,Far d'Empordà (El),483,247,236
17,Girona,66,Figueres,39641,19636,20005
17,Girona,67,Flaçà,997,494,503
17,Girona,68,Foixà,325,168,157
17,Girona,69,Fontanals de Cerdanya,425,212,213
17,Girona,70,Fontanilles,175,101,74
17,Girona,71,Fontcoberta,1181,574,607
17,Girona,902,Forallac,1746,864,882
17,Girona,73,Fornells de la Selva,1890,912,978
17,Girona,74,Fortià,582,295,287
17,Girona,75,Garrigàs,346,192,154
17,Girona,76,Garrigoles,155,85,70
17,Girona,77,Garriguella,731,377,354
17,Girona,78,Ger,450,241,209
17,Girona,79,Girona,89890,43863,46027
17,Girona,80,Gombrèn,222,111,111
17,Girona,81,Gualta,358,210,148
17,Girona,82,Guils de Cerdanya,438,226,212
17,Girona,83,Hostalric,3619,1852,1767
17,Girona,84,Isòvol,265,152,113
17,Girona,85,Jafre,386,213,173
17,Girona,86,Jonquera (La),3020,1564,1456
17,Girona,87,Juià,318,174,144
17,Girona,88,Lladó,591,301,290
17,Girona,89,Llagostera,7062,3661,3401
17,Girona,90,Llambilles,612,313,299
17,Girona,91,Llanars,558,295,263
17,Girona,92,Llançà,4611,2287,2324
17,Girona,93,Llers,1167,594,573
17,Girona,94,Llívia,1291,694,597
17,Girona,95,Lloret de Mar,32728,17268,15460
17,Girona,96,Llosses (Les),246,134,112
17,Girona,102,Maçanet de Cabrenys,700,366,334
17,Girona,103,Maçanet de la Selva,5712,2925,2787
17,Girona,97,Madremanya,222,102,120
17,Girona,98,Maià de Montcal,379,197,182
17,Girona,100,Masarac,265,133,132
17,Girona,101,Massanes,660,348,312
17,Girona,99,Meranges,86,53,33
17,Girona,105,Mieres,331,175,156
17,Girona,106,Mollet de Peralada,172,85,87
17,Girona,107,Molló,329,165,164
17,Girona,109,Montagut i Oix,903,468,435
17,Girona,110,Mont-ras,1841,967,874
17,Girona,111,Navata,980,488,492
17,Girona,112,Ogassa,265,152,113
17,Girona,114,Olot,31932,16043,15889
17,Girona,115,Ordis,353,185,168
17,Girona,116,Osor,390,198,192
17,Girona,117,Palafrugell,21307,10950,10357
17,Girona,118,Palamós,17197,8522,8675
17,Girona,119,Palau de Santa Eulàlia,91,53,38
17,Girona,121,Palau-sator,280,150,130
17,Girona,120,Palau-saverdera,1197,603,594
17,Girona,123,Palol de Revardit,429,229,200
17,Girona,124,Pals,2400,1231,1169
17,Girona,125,Pardines,149,80,69
17,Girona,126,Parlavà,352,185,167
17,Girona,128,Pau,501,260,241
17,Girona,129,Pedret i Marzà,154,80,74
17,Girona,130,Pera (La),436,224,212
17,Girona,132,Peralada,1625,836,789
17,Girona,133,Planes d'Hostoles (Les),1798,913,885
17,Girona,134,Planoles,281,151,130
17,Girona,135,Pont de Molins,419,223,196
17,Girona,136,Pontós,217,119,98
17,Girona,137,Porqueres,4154,2054,2100
17,Girona,140,Port de la Selva (El),908,460,448
17,Girona,138,Portbou,1347,675,672
17,Girona,139,Preses (Les),1692,833,859
17,Girona,141,Puigcerdà,8859,4628,4231
17,Girona,142,Quart,2637,1361,1276
17,Girona,43,Queralbs,198,113,85
17,Girona,143,Rabós,194,97,97
17,Girona,144,Regencós,304,169,135
17,Girona,145,Ribes de Freser,2017,993,1024
17,Girona,146,Riells i Viabrea,3238,1686,1552
17,Girona,147,Ripoll,10832,5367,5465
17,Girona,148,Riudarenes,1761,919,842
17,Girona,149,Riudaura,417,214,203
17,Girona,150,Riudellots de la Selva,1849,952,897
17,Girona,151,Riumors,172,91,81
17,Girona,152,Roses,17173,8696,8477
17,Girona,153,Rupià,213,113,100
17,Girona,154,Sales de Llierca,128,63,65
17,Girona,155,Salt,28017,14906,13111
17,Girona,157,Sant Andreu Salou,156,73,83
17,Girona,183,Sant Aniol de Finestres,289,152,137
17,Girona,158,Sant Climent Sescebes,482,250,232
17,Girona,159,Sant Feliu de Buixalleu,756,402,354
17,Girona,160,Sant Feliu de Guíxols,20867,10337,10530
17,Girona,161,Sant Feliu de Pallerols,1272,631,641
17,Girona,162,Sant Ferriol,194,107,87
17,Girona,163,Sant Gregori,2951,1505,1446
17,Girona,164,Sant Hilari Sacalm,5385,2789,2596
17,Girona,165,Sant Jaume de Llierca,815,409,406
17,Girona,167,Sant Joan de les Abadesses,3565,1788,1777
17,Girona,168,Sant Joan de Mollet,487,245,242
17,Girona,185,Sant Joan les Fonts,2652,1347,1305
17,Girona,166,Sant Jordi Desvalls,632,314,318
17,Girona,169,Sant Julià de Ramis,2656,1363,1293
17,Girona,903,Sant Julià del Llor i Bonmatí,1093,558,535
17,Girona,171,Sant Llorenç de la Muga,196,102,94
17,Girona,172,Sant Martí de Llémena,520,268,252
17,Girona,173,Sant Martí Vell,209,116,93
17,Girona,174,Sant Miquel de Campmajor,218,117,101
17,Girona,175,Sant Miquel de Fluvià,671,347,324
17,Girona,176,Sant Mori,164,80,84
17,Girona,177,Sant Pau de Segúries,666,335,331
17,Girona,178,Sant Pere Pescador,1804,988,816
17,Girona,180,Santa Coloma de Farners,10565,5417,5148
17,Girona,181,Santa Cristina d'Aro,4214,2164,2050
17,Girona,182,Santa Llogaia d'Àlguema,313,165,148
17,Girona,184,Santa Pau,1565,799,766
17,Girona,186,Sarrià de Ter,4065,2011,2054
17,Girona,187,Saus,737,372,365
17,Girona,188,Selva de Mar (La),223,115,108
17,Girona,190,Serinyà,1045,546,499
17,Girona,191,Serra de Daró,184,104,80
17,Girona,192,Setcases,181,97,84
17,Girona,193,Sils,4126,2089,2037
17,Girona,52,Siurana,181,91,90
17,Girona,194,Susqueda,112,64,48
17,Girona,195,Tallada d'Empordà (La),367,199,168
17,Girona,196,Terrades,146,72,74
17,Girona,197,Torrent,190,100,90
17,Girona,198,Torroella de Fluvià,460,253,207
17,Girona,199,Torroella de Montgrí,10588,5449,5139
17,Girona,200,Tortellà,729,364,365
17,Girona,201,Toses,160,97,63
17,Girona,202,Tossa de Mar,5414,2753,2661
17,Girona,204,Ullà,1039,591,448
17,Girona,205,Ullastret,233,121,112
17,Girona,203,Ultramort,200,115,85
17,Girona,206,Urús,200,103,97
17,Girona,14,Vajol (La),101,59,42
17,Girona,208,Vall de Bianya (La),1256,640,616
17,Girona,207,Vall d'en Bas (La),2650,1345,1305
17,Girona,170,Vallfogona de Ripollès,206,110,96
17,Girona,209,Vall-llobrega,730,439,291
17,Girona,210,Ventalló,698,375,323
17,Girona,211,Verges,1179,588,591
17,Girona,212,Vidrà,168,84,84
17,Girona,213,Vidreres,6676,3501,3175
17,Girona,214,Vilabertran,843,435,408
17,Girona,215,Vilablareix,2213,1107,1106
17,Girona,217,Viladamat,421,216,205
17,Girona,216,Viladasens,191,98,93
17,Girona,218,Vilademuls,786,409,377
17,Girona,220,Viladrau,999,522,477
17,Girona,221,Vilafant,5013,2489,2524
17,Girona,223,Vilajuïga,1072,530,542
17,Girona,224,Vilallonga de Ter,448,243,205
17,Girona,225,Vilamacolum,280,148,132
17,Girona,226,Vilamalla,1092,581,511
17,Girona,227,Vilamaniscle,182,98,84
17,Girona,228,Vilanant,333,163,170
17,Girona,230,Vila-sacra,485,241,244
17,Girona,222,Vilaür,139,69,70
17,Girona,233,Vilobí d'Onyar,2718,1468,1250
17,Girona,232,Vilopriu,189,103,86
18,Granada,1,Agrón,283,150,133
18,Granada,2,Alamedilla,785,396,389
18,Granada,3,Albolote,15978,8052,7926
18,Granada,4,Albondón,914,499,415
18,Granada,5,Albuñán,448,229,219
18,Granada,6,Albuñol,6270,3345,2925
18,Granada,7,Albuñuelas,1070,552,518
18,Granada,10,Aldeire,727,370,357
18,Granada,11,Alfacar,5178,2654,2524
18,Granada,12,Algarinejo,4078,2086,1992
18,Granada,13,Alhama de Granada,6137,3237,2900
18,Granada,14,Alhendín,5579,2874,2705
18,Granada,15,Alicún de Ortega,561,300,261
18,Granada,16,Almegíjar,421,213,208
18,Granada,17,Almuñécar,26264,12959,13305
18,Granada,904,Alpujarra de la Sierra,1142,590,552
18,Granada,18,Alquife,788,400,388
18,Granada,20,Arenas del Rey,2202,1157,1045
18,Granada,21,Armilla,19667,10096,9571
18,Granada,22,Atarfe,13431,6695,6736
18,Granada,23,Baza,22581,11256,11325
18,Granada,24,Beas de Granada,1092,580,512
18,Granada,25,Beas de Guadix,374,190,184
18,Granada,27,Benalúa,3311,1645,1666
18,Granada,28,Benalúa de las Villas,1352,688,664
18,Granada,29,Benamaurel,2328,1176,1152
18,Granada,30,Bérchules,811,432,379
18,Granada,32,Bubión,366,194,172
18,Granada,33,Busquístar,348,192,156
18,Granada,34,Cacín,685,345,340
18,Granada,35,Cádiar,1621,843,778
18,Granada,36,Cájar,4139,2029,2110
18,Granada,114,Calahorra (La),766,396,370
18,Granada,37,Calicasas,565,290,275
18,Granada,38,Campotéjar,1467,773,694
18,Granada,39,Caniles,4897,2461,2436
18,Granada,40,Cáñar,365,197,168
18,Granada,42,Capileira,564,282,282
18,Granada,43,Carataunas,200,96,104
18,Granada,44,Cástaras,259,133,126
18,Granada,45,Castilléjar,1619,808,811
18,Granada,46,Castril,2581,1321,1260
18,Granada,47,Cenes de la Vega,6341,3275,3066
18,Granada,59,Chauchina,4476,2251,2225
18,Granada,61,Chimeneas,1456,763,693
18,Granada,62,Churriana de la Vega,9406,4682,4724
18,Granada,48,Cijuela,2307,1192,1115
18,Granada,49,Cogollos de Guadix,721,378,343
18,Granada,50,Cogollos de la Vega,2095,1075,1020
18,Granada,51,Colomera,1570,820,750
18,Granada,53,Cortes de Baza,2206,1113,1093
18,Granada,54,Cortes y Graena,1083,547,536
18,Granada,912,Cuevas del Campo,2073,1055,1018
18,Granada,56,Cúllar,4898,2440,2458
18,Granada,57,Cúllar Vega,5892,2974,2918
18,Granada,63,Darro,1438,717,721
18,Granada,64,Dehesas de Guadix,557,270,287
18,Granada,66,Deifontes,2478,1276,1202
18,Granada,67,Diezma,837,443,394
18,Granada,68,Dílar,1600,786,814
18,Granada,69,Dólar,576,294,282
18,Granada,70,Dúdar,292,158,134
18,Granada,71,Dúrcal,6856,3451,3405
18,Granada,72,Escúzar,738,365,373
18,Granada,74,Ferreira,324,167,157
18,Granada,76,Fonelas,1145,569,576
18,Granada,78,Freila,1074,529,545
18,Granada,79,Fuente Vaqueros,4108,2047,2061
18,Granada,905,Gabias (Las),13345,7002,6343
18,Granada,82,Galera,1119,555,564
18,Granada,83,Gobernador,321,158,163
18,Granada,84,Gójar,4946,2560,2386
18,Granada,85,Gor,977,504,473
18,Granada,86,Gorafe,526,261,265
18,Granada,87,Granada,237929,110698,127231
18,Granada,88,Guadahortuna,2220,1138,1082
18,Granada,89,Guadix,20296,10003,10293
18,Granada,906,Guajares (Los),1337,743,594
18,Granada,93,Gualchos,2294,1167,1127
18,Granada,94,Güejar Sierra,2915,1550,1365
18,Granada,95,Güevéjar,2154,1096,1058
18,Granada,96,Huélago,439,232,207
18,Granada,97,Huéneja,1230,623,607
18,Granada,98,Huéscar,8212,4129,4083
18,Granada,99,Huétor de Santillán,1784,928,856
18,Granada,100,Huétor Tájar,9340,4737,4603
18,Granada,101,Huétor Vega,10743,5446,5297
18,Granada,102,Illora,10304,5154,5150
18,Granada,103,Itrabo,1117,554,563
18,Granada,105,Iznalloz,7046,3567,3479
18,Granada,107,Jayena,1285,672,613
18,Granada,108,Jerez del Marquesado,1091,553,538
18,Granada,109,Jete,820,438,382
18,Granada,111,Jun,2326,1193,1133
18,Granada,112,Juviles,177,88,89
18,Granada,115,Láchar,2819,1438,1381
18,Granada,116,Lanjarón,3796,1876,1920
18,Granada,117,Lanteira,528,279,249
18,Granada,119,Lecrín,2329,1192,1137
18,Granada,120,Lentegí,342,178,164
18,Granada,121,Lobras,121,60,61
18,Granada,122,Loja,21196,10580,10616
18,Granada,123,Lugros,367,182,185
18,Granada,124,Lújar,491,261,230
18,Granada,126,Malahá (La),1703,876,827
18,Granada,127,Maracena,19388,9639,9749
18,Granada,128,Marchal,403,181,222
18,Granada,132,Moclín,4146,2064,2082
18,Granada,133,Molvízar,2998,1486,1512
18,Granada,134,Monachil,6289,3218,3071
18,Granada,135,Montefrío,6446,3215,3231
18,Granada,136,Montejícar,2596,1297,1299
18,Granada,137,Montillana,1288,670,618
18,Granada,138,Moraleda de Zafayona,3058,1563,1495
18,Granada,909,Morelábor,812,426,386
18,Granada,140,Motril,57895,28717,29178
18,Granada,141,Murtas,730,418,312
18,Granada,903,Nevada,1179,616,563
18,Granada,143,Nigüelas,1149,566,583
18,Granada,144,Nívar,668,345,323
18,Granada,145,Ogíjares,12040,6145,5895
18,Granada,146,Orce,1387,711,676
18,Granada,147,Órgiva,5460,2761,2699
18,Granada,148,Otívar,1113,572,541
18,Granada,149,Otura,5632,2869,2763
18,Granada,150,Padul,7871,3920,3951
18,Granada,151,Pampaneira,344,178,166
18,Granada,152,Pedro Martínez,1217,607,610
18,Granada,153,Peligros,10385,5347,5038
18,Granada,154,Peza (La),1367,722,645
18,Granada,910,Pinar (El),1088,556,532
18,Granada,157,Pinos Genil,1252,658,594
18,Granada,158,Pinos Puente,13450,6892,6558
18,Granada,159,Píñar,1362,718,644
18,Granada,161,Polícar,227,113,114
18,Granada,162,Polopos,1557,860,697
18,Granada,163,Pórtugos,419,205,214
18,Granada,164,Puebla de Don Fadrique,2565,1301,1264
18,Granada,165,Pulianas,4924,2485,2439
18,Granada,167,Purullena,2294,1156,1138
18,Granada,168,Quéntar,1036,542,494
18,Granada,170,Rubite,468,260,208
18,Granada,171,Salar,2795,1410,1385
18,Granada,173,Salobreña,12063,6052,6011
18,Granada,174,Santa Cruz del Comercio,546,293,253
18,Granada,175,Santa Fe,14599,7217,7382
18,Granada,176,Soportújar,265,140,125
18,Granada,177,Sorvilán,677,353,324
18,Granada,901,Taha (La),743,370,373
18,Granada,178,Torre-Cardela,1092,538,554
18,Granada,179,Torvizcón,803,410,393
18,Granada,180,Trevélez,831,444,387
18,Granada,181,Turón,327,187,140
18,Granada,182,Ugíjar,2531,1307,1224
18,Granada,902,Valle (El),1130,544,586
18,Granada,907,Valle del Zalabí,2315,1140,1175
18,Granada,183,Válor,708,357,351
18,Granada,911,Vegas del Genil,6599,3445,3154
18,Granada,184,Vélez de Benaudalla,2965,1502,1463
18,Granada,185,Ventas de Huelma,734,388,346
18,Granada,908,Villamena,1004,493,511
18,Granada,187,Villanueva de las Torres,778,418,360
18,Granada,188,Villanueva Mesía,2147,1098,1049
18,Granada,189,Víznar,796,427,369
18,Granada,192,Zafarraya,2170,1179,991
18,Granada,913,Zagra,1054,507,547
18,Granada,193,Zubia (La),16450,8140,8310
18,Granada,194,Zújar,2813,1473,1340
19,Guadalajara,1,Abánades,97,52,45
19,Guadalajara,2,Ablanque,129,66,63
19,Guadalajara,3,Adobes,61,33,28
19,Guadalajara,4,Alaminos,76,40,36
19,Guadalajara,5,Alarilla,126,76,50
19,Guadalajara,6,Albalate de Zorita,987,548,439
19,Guadalajara,7,Albares,504,261,243
19,Guadalajara,8,Albendiego,39,29,10
19,Guadalajara,9,Alcocer,319,152,167
19,Guadalajara,10,Alcolea de las Peñas,21,12,9
19,Guadalajara,11,Alcolea del Pinar,407,221,186
19,Guadalajara,13,Alcoroches,164,93,71
19,Guadalajara,15,Aldeanueva de Guadalajara,122,62,60
19,Guadalajara,16,Algar de Mesa,65,34,31
19,Guadalajara,17,Algora,120,70,50
19,Guadalajara,18,Alhóndiga,238,133,105
19,Guadalajara,19,Alique,32,12,20
19,Guadalajara,20,Almadrones,94,62,32
19,Guadalajara,21,Almoguera,1441,765,676
19,Guadalajara,22,Almonacid de Zorita,799,383,416
19,Guadalajara,23,Alocén,184,87,97
19,Guadalajara,24,Alovera,8369,4331,4038
19,Guadalajara,27,Alustante,252,147,105
19,Guadalajara,31,Angón,31,18,13
19,Guadalajara,32,Anguita,263,143,120
19,Guadalajara,33,Anquela del Ducado,72,37,35
19,Guadalajara,34,Anquela del Pedregal,25,17,8
19,Guadalajara,36,Aranzueque,401,205,196
19,Guadalajara,37,Arbancón,198,118,80
19,Guadalajara,38,Arbeteta,53,28,25
19,Guadalajara,39,Argecilla,81,47,34
19,Guadalajara,40,Armallones,51,32,19
19,Guadalajara,41,Armuña de Tajuña,139,77,62
19,Guadalajara,42,Arroyo de las Fraguas,47,24,23
19,Guadalajara,43,Atanzón,112,69,43
19,Guadalajara,44,Atienza,463,246,217
19,Guadalajara,45,Auñón,234,126,108
19,Guadalajara,46,Azuqueca de Henares,26064,13334,12730
19,Guadalajara,47,Baides,58,29,29
19,Guadalajara,48,Baños de Tajo,25,17,8
19,Guadalajara,49,Bañuelos,32,20,12
19,Guadalajara,50,Barriopedro,29,14,15
19,Guadalajara,51,Berninches,116,69,47
19,Guadalajara,52,Bodera (La),36,22,14
19,Guadalajara,53,Brihuega,2823,1463,1360
19,Guadalajara,54,Budia,240,126,114
19,Guadalajara,55,Bujalaro,83,41,42
19,Guadalajara,57,Bustares,101,61,40
19,Guadalajara,58,Cabanillas del Campo,7767,3910,3857
19,Guadalajara,59,Campillo de Dueñas,109,59,50
19,Guadalajara,60,Campillo de Ranas,190,102,88
19,Guadalajara,61,Campisábalos,54,30,24
19,Guadalajara,64,Canredondo,104,54,50
19,Guadalajara,65,Cantalojas,145,82,63
19,Guadalajara,66,Cañizar,106,49,57
19,Guadalajara,67,Cardoso de la Sierra (El),69,47,22
19,Guadalajara,70,Casa de Uceda,116,64,52
19,Guadalajara,71,Casar (El),7626,3931,3695
19,Guadalajara,73,Casas de San Galindo,31,16,15
19,Guadalajara,74,Caspueñas,108,61,47
19,Guadalajara,75,Castejón de Henares,103,54,49
19,Guadalajara,76,Castellar de la Muela,38,20,18
19,Guadalajara,78,Castilforte,56,36,20
19,Guadalajara,79,Castilnuevo,14,9,5
19,Guadalajara,80,Cendejas de Enmedio,116,63,53
19,Guadalajara,81,Cendejas de la Torre,65,40,25
19,Guadalajara,82,Centenera,95,52,43
19,Guadalajara,103,Checa,339,188,151
19,Guadalajara,104,Chequilla,18,9,9
19,Guadalajara,106,Chillarón del Rey,117,64,53
19,Guadalajara,105,Chiloeches,2073,1091,982
19,Guadalajara,86,Cifuentes,2038,1041,997
19,Guadalajara,87,Cincovillas,33,16,17
19,Guadalajara,88,Ciruelas,104,57,47
19,Guadalajara,89,Ciruelos del Pinar,49,25,24
19,Guadalajara,90,Cobeta,103,49,54
19,Guadalajara,91,Cogollor,39,22,17
19,Guadalajara,92,Cogolludo,609,347,262
19,Guadalajara,95,Condemios de Abajo,29,18,11
19,Guadalajara,96,Condemios de Arriba,177,84,93
19,Guadalajara,97,Congostrina,54,32,22
19,Guadalajara,98,Copernal,30,19,11
19,Guadalajara,99,Corduente,416,232,184
19,Guadalajara,102,Cubillo de Uceda (El),132,66,66
19,Guadalajara,107,Driebes,388,204,184
19,Guadalajara,108,Durón,151,75,76
19,Guadalajara,109,Embid,58,33,25
19,Guadalajara,110,Escamilla,108,49,59
19,Guadalajara,111,Escariche,202,112,90
19,Guadalajara,112,Escopete,65,35,30
19,Guadalajara,113,Espinosa de Henares,660,345,315
19,Guadalajara,114,Esplegares,52,32,20
19,Guadalajara,115,Establés,53,30,23
19,Guadalajara,116,Estriégana,23,13,10
19,Guadalajara,117,Fontanar,1444,770,674
19,Guadalajara,118,Fuembellida,13,9,4
19,Guadalajara,119,Fuencemillán,113,57,56
19,Guadalajara,120,Fuentelahiguera de Albatages,149,82,67
19,Guadalajara,121,Fuentelencina,264,140,124
19,Guadalajara,122,Fuentelsaz,118,59,59
19,Guadalajara,123,Fuentelviejo,57,30,27
19,Guadalajara,124,Fuentenovilla,416,229,187
19,Guadalajara,125,Gajanejos,67,39,28
19,Guadalajara,126,Galápagos,1283,700,583
19,Guadalajara,127,Galve de Sorbe,120,63,57
19,Guadalajara,129,Gascueña de Bornova,52,30,22
19,Guadalajara,130,Guadalajara,75493,36885,38608
19,Guadalajara,132,Henche,108,54,54
19,Guadalajara,133,Heras de Ayuso,178,98,80
19,Guadalajara,134,Herrería,27,16,11
19,Guadalajara,135,Hiendelaencina,117,63,54
19,Guadalajara,136,Hijes,28,15,13
19,Guadalajara,138,Hita,361,191,170
19,Guadalajara,139,Hombrados,36,21,15
19,Guadalajara,142,Hontoba,250,125,125
19,Guadalajara,143,Horche,1945,1021,924
19,Guadalajara,145,Hortezuela de Océn,73,37,36
19,Guadalajara,146,Huerce (La),47,31,16
19,Guadalajara,147,Huérmeces del Cerro,49,31,18
19,Guadalajara,148,Huertahernando,68,41,27
19,Guadalajara,150,Hueva,141,68,73
19,Guadalajara,151,Humanes,1351,689,662
19,Guadalajara,152,Illana,764,409,355
19,Guadalajara,153,Iniéstola,15,12,3
19,Guadalajara,154,Inviernas (Las),101,60,41
19,Guadalajara,155,Irueste,61,34,27
19,Guadalajara,156,Jadraque,1532,821,711
19,Guadalajara,157,Jirueque,95,58,37
19,Guadalajara,159,Ledanca,119,65,54
19,Guadalajara,160,Loranca de Tajuña,1016,570,446
19,Guadalajara,161,Lupiana,247,130,117
19,Guadalajara,162,Luzaga,97,50,47
19,Guadalajara,163,Luzón,72,35,37
19,Guadalajara,165,Majaelrayo,64,41,23
19,Guadalajara,166,Málaga del Fresno,211,118,93
19,Guadalajara,167,Malaguilla,126,68,58
19,Guadalajara,168,Mandayona,387,194,193
19,Guadalajara,169,Mantiel,70,40,30
19,Guadalajara,170,Maranchón,264,145,119
19,Guadalajara,171,Marchamalo,4792,2503,2289
19,Guadalajara,172,Masegoso de Tajuña,98,53,45
19,Guadalajara,173,Matarrubia,50,30,20
19,Guadalajara,174,Matillas,171,85,86
19,Guadalajara,175,Mazarete,58,24,34
19,Guadalajara,176,Mazuecos,359,182,177
19,Guadalajara,177,Medranda,128,70,58
19,Guadalajara,178,Megina,54,27,27
19,Guadalajara,179,Membrillera,128,61,67
19,Guadalajara,181,Miedes de Atienza,91,50,41
19,Guadalajara,182,Mierla (La),23,16,7
19,Guadalajara,184,Millana,164,85,79
19,Guadalajara,183,Milmarcos,109,64,45
19,Guadalajara,185,Miñosa (La),48,27,21
19,Guadalajara,186,Mirabueno,102,61,41
19,Guadalajara,187,Miralrío,76,44,32
19,Guadalajara,188,Mochales,77,37,40
19,Guadalajara,189,Mohernando,172,90,82
19,Guadalajara,190,Molina de Aragón,3656,1851,1805
19,Guadalajara,191,Monasterio,22,9,13
19,Guadalajara,192,Mondéjar,2661,1387,1274
19,Guadalajara,193,Montarrón,46,24,22
19,Guadalajara,194,Moratilla de los Meleros,110,61,49
19,Guadalajara,195,Morenilla,42,25,17
19,Guadalajara,196,Muduex,114,60,54
19,Guadalajara,197,Navas de Jadraque (Las),32,17,15
19,Guadalajara,198,Negredo,20,11,9
19,Guadalajara,199,Ocentejo,40,22,18
19,Guadalajara,200,Olivar (El),112,70,42
19,Guadalajara,201,Olmeda de Cobeta,96,46,50
19,Guadalajara,202,Olmeda de Jadraque (La),16,8,8
19,Guadalajara,203,Ordial (El),44,22,22
19,Guadalajara,204,Orea,236,143,93
19,Guadalajara,208,Pálmaces de Jadraque,69,37,32
19,Guadalajara,209,Pardos,66,32,34
19,Guadalajara,210,Paredes de Sigüenza,40,21,19
19,Guadalajara,211,Pareja,548,294,254
19,Guadalajara,212,Pastrana,1095,531,564
19,Guadalajara,213,Pedregal (El),103,59,44
19,Guadalajara,214,Peñalén,108,64,44
19,Guadalajara,215,Peñalver,220,130,90
19,Guadalajara,216,Peralejos de las Truchas,162,93,69
19,Guadalajara,217,Peralveche,106,66,40
19,Guadalajara,218,Pinilla de Jadraque,69,32,37
19,Guadalajara,219,Pinilla de Molina,24,14,10
19,Guadalajara,220,Pioz,1337,751,586
19,Guadalajara,221,Piqueras,54,35,19
19,Guadalajara,222,Pobo de Dueñas (El),159,89,70
19,Guadalajara,223,Poveda de la Sierra,162,91,71
19,Guadalajara,224,Pozo de Almoguera,151,80,71
19,Guadalajara,225,Pozo de Guadalajara,993,522,471
19,Guadalajara,226,Prádena de Atienza,49,32,17
19,Guadalajara,227,Prados Redondos,111,64,47
19,Guadalajara,228,Puebla de Beleña,49,34,15
19,Guadalajara,229,Puebla de Valles,106,62,44
19,Guadalajara,230,Quer,556,301,255
19,Guadalajara,231,Rebollosa de Jadraque,32,20,12
19,Guadalajara,232,Recuenco (El),84,45,39
19,Guadalajara,233,Renera,73,42,31
19,Guadalajara,234,Retiendas,48,25,23
19,Guadalajara,235,Riba de Saelices,158,89,69
19,Guadalajara,237,Rillo de Gallo,75,43,32
19,Guadalajara,238,Riofrío del Llano,52,29,23
19,Guadalajara,239,Robledillo de Mohernando,125,65,60
19,Guadalajara,240,Robledo de Corpes,87,47,40
19,Guadalajara,241,Romanillos de Atienza,58,35,23
19,Guadalajara,242,Romanones,141,72,69
19,Guadalajara,243,Rueda de la Sierra,51,28,23
19,Guadalajara,244,Sacecorbo,163,98,65
19,Guadalajara,245,Sacedón,1758,915,843
19,Guadalajara,246,Saelices de la Sal,63,31,32
19,Guadalajara,247,Salmerón,211,113,98
19,Guadalajara,248,San Andrés del Congosto,76,46,30
19,Guadalajara,249,San Andrés del Rey,43,17,26
19,Guadalajara,250,Santiuste,27,15,12
19,Guadalajara,251,Saúca,69,37,32
19,Guadalajara,252,Sayatón,121,69,52
19,Guadalajara,254,Selas,64,34,30
19,Guadalajara,901,Semillas,50,31,19
19,Guadalajara,255,Setiles,129,72,57
19,Guadalajara,256,Sienes,82,46,36
19,Guadalajara,257,Sigüenza,4629,2333,2296
19,Guadalajara,258,Solanillos del Extremo,134,71,63
19,Guadalajara,259,Somolinos,42,18,24
19,Guadalajara,260,Sotillo (El),53,31,22
19,Guadalajara,261,Sotodosos,61,27,34
19,Guadalajara,262,Tamajón,205,106,99
19,Guadalajara,263,Taragudo,32,19,13
19,Guadalajara,264,Taravilla,63,34,29
19,Guadalajara,265,Tartanedo,160,85,75
19,Guadalajara,266,Tendilla,363,191,172
19,Guadalajara,267,Terzaga,28,16,12
19,Guadalajara,268,Tierzo,43,27,16
19,Guadalajara,269,Toba (La),107,59,48
19,Guadalajara,271,Tordellego,63,33,30
19,Guadalajara,270,Tordelrábano,9,3,6
19,Guadalajara,272,Tordesilos,140,79,61
19,Guadalajara,274,Torija,599,288,311
19,Guadalajara,279,Torre del Burgo,139,76,63
19,Guadalajara,277,Torrecuadrada de Molina,18,11,7
19,Guadalajara,278,Torrecuadradilla,47,28,19
19,Guadalajara,280,Torrejón del Rey,3509,1885,1624
19,Guadalajara,281,Torremocha de Jadraque,19,13,6
19,Guadalajara,282,Torremocha del Campo,264,149,115
19,Guadalajara,283,Torremocha del Pinar,51,24,27
19,Guadalajara,284,Torremochuela,17,10,7
19,Guadalajara,285,Torrubia,36,19,17
19,Guadalajara,286,Tórtola de Henares,585,318,267
19,Guadalajara,287,Tortuera,219,113,106
19,Guadalajara,288,Tortuero,34,19,15
19,Guadalajara,289,Traíd,55,26,29
19,Guadalajara,290,Trijueque,1216,649,567
19,Guadalajara,291,Trillo,1345,688,657
19,Guadalajara,293,Uceda,1900,976,924
19,Guadalajara,294,Ujados,31,17,14
19,Guadalajara,296,Utande,51,35,16
19,Guadalajara,297,Valdarachas,29,13,16
19,Guadalajara,298,Valdearenas,110,73,37
19,Guadalajara,299,Valdeavellano,104,63,41
19,Guadalajara,300,Valdeaveruelo,703,370,333
19,Guadalajara,301,Valdeconcha,48,27,21
19,Guadalajara,302,Valdegrudas,62,39,23
19,Guadalajara,303,Valdelcubo,69,38,31
19,Guadalajara,304,Valdenuño Fernández,242,133,109
19,Guadalajara,305,Valdepeñas de la Sierra,200,108,92
19,Guadalajara,306,Valderrebollo,39,19,20
19,Guadalajara,307,Valdesotos,25,13,12
19,Guadalajara,308,Valfermoso de Tajuña,86,46,40
19,Guadalajara,309,Valhermoso,41,23,18
19,Guadalajara,310,Valtablado del Río,19,12,7
19,Guadalajara,311,Valverde de los Arroyos,114,67,47
19,Guadalajara,314,Viana de Jadraque,42,26,16
19,Guadalajara,317,Villanueva de Alcorón,237,127,110
19,Guadalajara,318,Villanueva de Argecilla,46,26,20
19,Guadalajara,319,Villanueva de la Torre,5131,2636,2495
19,Guadalajara,321,Villares de Jadraque,58,33,25
19,Guadalajara,322,Villaseca de Henares,53,30,23
19,Guadalajara,323,Villaseca de Uceda,71,43,28
19,Guadalajara,324,Villel de Mesa,210,108,102
19,Guadalajara,325,Viñuelas,123,71,52
19,Guadalajara,326,Yebes,239,158,81
19,Guadalajara,327,Yebra,515,268,247
19,Guadalajara,329,Yélamos de Abajo,77,39,38
19,Guadalajara,330,Yélamos de Arriba,133,74,59
19,Guadalajara,331,Yunquera de Henares,2746,1409,1337
19,Guadalajara,332,Yunta (La),138,69,69
19,Guadalajara,333,Zaorejas,192,114,78
19,Guadalajara,334,Zarzuela de Jadraque,48,24,24
19,Guadalajara,335,Zorita de los Canes,100,53,47
20,Guipúzcoa,1,Abaltzisketa,295,169,126
20,Guipúzcoa,2,Aduna,368,202,166
20,Guipúzcoa,16,Aia,1773,975,798
20,Guipúzcoa,3,Aizarnazabal,614,343,271
20,Guipúzcoa,4,Albiztur,293,154,139
20,Guipúzcoa,5,Alegia,1671,852,819
20,Guipúzcoa,6,Alkiza,320,181,139
20,Guipúzcoa,906,Altzaga,153,78,75
20,Guipúzcoa,7,Altzo,359,190,169
20,Guipúzcoa,8,Amezketa,974,500,474
20,Guipúzcoa,9,Andoain,14082,7037,7045
20,Guipúzcoa,10,Anoeta,1777,919,858
20,Guipúzcoa,11,Antzuola,2073,1053,1020
20,Guipúzcoa,12,Arama,173,87,86
20,Guipúzcoa,13,Aretxabaleta,6469,3290,3179
20,Guipúzcoa,55,Arrasate/Mondragón,22312,11152,11160
20,Guipúzcoa,14,Asteasu,1424,763,661
20,Guipúzcoa,903,Astigarraga,4242,2167,2075
20,Guipúzcoa,15,Ataun,1574,828,746
20,Guipúzcoa,17,Azkoitia,10641,5309,5332
20,Guipúzcoa,18,Azpeitia,13930,6995,6935
20,Guipúzcoa,904,Baliarrain,95,52,43
20,Guipúzcoa,19,Beasain,12682,6358,6324
20,Guipúzcoa,20,Beizama,170,97,73
20,Guipúzcoa,21,Belauntza,307,172,135
20,Guipúzcoa,22,Berastegi,1003,542,461
20,Guipúzcoa,74,Bergara,14853,7427,7426
20,Guipúzcoa,23,Berrobi,588,315,273
20,Guipúzcoa,24,Bidegoian,464,255,209
20,Guipúzcoa,29,Deba,5313,2689,2624
20,Guipúzcoa,69,Donostia-San Sebastián,183308,86116,97192
20,Guipúzcoa,30,Eibar,27530,13406,14124
20,Guipúzcoa,31,Elduain,215,112,103
20,Guipúzcoa,33,Elgeta,1021,537,484
20,Guipúzcoa,32,Elgoibar,10690,5353,5337
20,Guipúzcoa,67,Errenteria,37853,18561,19292
20,Guipúzcoa,66,Errezil,611,323,288
20,Guipúzcoa,34,Eskoriatza,3926,2017,1909
20,Guipúzcoa,35,Ezkio-Itsaso,549,278,271
20,Guipúzcoa,38,Gabiria,429,229,200
20,Guipúzcoa,37,Gaintza,132,78,54
20,Guipúzcoa,907,Gaztelu,152,92,60
20,Guipúzcoa,39,Getaria,2525,1265,1260
20,Guipúzcoa,40,Hernani,18943,9342,9601
20,Guipúzcoa,41,Hernialde,334,170,164
20,Guipúzcoa,36,Hondarribia,16073,8114,7959
20,Guipúzcoa,42,Ibarra,4299,2220,2079
20,Guipúzcoa,43,Idiazabal,2166,1101,1065
20,Guipúzcoa,44,Ikaztegieta,453,235,218
20,Guipúzcoa,45,Irun,60261,29644,30617
20,Guipúzcoa,46,Irura,1193,631,562
20,Guipúzcoa,47,Itsasondo,591,298,293
20,Guipúzcoa,48,Larraul,177,97,80
20,Guipúzcoa,902,Lasarte-Oria,17582,8767,8815
20,Guipúzcoa,49,Lazkao,5123,2629,2494
20,Guipúzcoa,50,Leaburu,375,204,171
20,Guipúzcoa,51,Legazpi,8610,4408,4202
20,Guipúzcoa,52,Legorreta,1414,744,670
20,Guipúzcoa,68,Leintz-Gatzaga,257,144,113
20,Guipúzcoa,53,Lezo,5945,2962,2983
20,Guipúzcoa,54,Lizartza,602,317,285
20,Guipúzcoa,901,Mendaro,1689,888,801
20,Guipúzcoa,57,Mutiloa,200,106,94
20,Guipúzcoa,56,Mutriku,4795,2395,2400
20,Guipúzcoa,63,Oiartzun,9829,4933,4896
20,Guipúzcoa,58,Olaberria,920,461,459
20,Guipúzcoa,59,Oñati,10743,5350,5393
20,Guipúzcoa,76,Ordizia,9188,4505,4683
20,Guipúzcoa,905,Orendain,170,91,79
20,Guipúzcoa,60,Orexa,96,53,43
20,Guipúzcoa,61,Orio,4695,2374,2321
20,Guipúzcoa,62,Ormaiztegi,1268,671,597
20,Guipúzcoa,64,Pasaia,16160,7837,8323
20,Guipúzcoa,70,Segura,1250,622,628
20,Guipúzcoa,65,Soraluze/Placencia de las Armas,4098,2042,2056
20,Guipúzcoa,71,Tolosa,17877,8640,9237
20,Guipúzcoa,72,Urnieta,5896,3010,2886
20,Guipúzcoa,77,Urretxu,6778,3441,3337
20,Guipúzcoa,73,Usurbil,5723,2934,2789
20,Guipúzcoa,75,Villabona,5741,2914,2827
20,Guipúzcoa,78,Zaldibia,1446,749,697
20,Guipúzcoa,79,Zarautz,22323,11048,11275
20,Guipúzcoa,25,Zegama,1348,708,640
20,Guipúzcoa,26,Zerain,244,123,121
20,Guipúzcoa,27,Zestoa,3311,1712,1599
20,Guipúzcoa,28,Zizurkil,2861,1461,1400
20,Guipúzcoa,81,Zumaia,8837,4403,4434
20,Guipúzcoa,80,Zumarraga,10078,5035,5043
21,Huelva,1,Alájar,821,423,398
21,Huelva,2,Aljaraque,15617,7855,7762
21,Huelva,3,Almendro (El),847,438,409
21,Huelva,4,Almonaster la Real,1860,919,941
21,Huelva,5,Almonte,20224,10336,9888
21,Huelva,6,Alosno,4478,2159,2319
21,Huelva,7,Aracena,7228,3557,3671
21,Huelva,8,Aroche,3211,1577,1634
21,Huelva,9,Arroyomolinos de León,1061,538,523
21,Huelva,10,Ayamonte,18636,9310,9326
21,Huelva,11,Beas,4210,2110,2100
21,Huelva,12,Berrocal,377,183,194
21,Huelva,13,Bollullos Par del Condado,13500,6743,6757
21,Huelva,14,Bonares,5493,2827,2666
21,Huelva,15,Cabezas Rubias,858,449,409
21,Huelva,16,Cala,1308,662,646
21,Huelva,17,Calañas,4400,2165,2235
21,Huelva,18,Campillo (El),2276,1102,1174
21,Huelva,19,Campofrío,772,382,390
21,Huelva,20,Cañaveral de León,412,199,213
21,Huelva,21,Cartaya,16042,8330,7712
21,Huelva,22,Castaño del Robledo,214,115,99
21,Huelva,23,Cerro de Andévalo (El),2581,1247,1334
21,Huelva,30,Chucena,2054,1031,1023
21,Huelva,24,Corteconcepción,615,309,306
21,Huelva,25,Cortegana,5039,2489,2550
21,Huelva,26,Cortelazor,270,133,137
21,Huelva,27,Cumbres de Enmedio,44,26,18
21,Huelva,28,Cumbres de San Bartolomé,490,238,252
21,Huelva,29,Cumbres Mayores,2024,1008,1016
21,Huelva,31,Encinasola,1634,816,818
21,Huelva,32,Escacena del Campo,2174,1080,1094
21,Huelva,33,Fuenteheridos,606,310,296
21,Huelva,34,Galaroza,1606,794,812
21,Huelva,35,Gibraleón,11349,5733,5616
21,Huelva,36,Granada de Río-Tinto (La),222,114,108
21,Huelva,37,Granado (El),618,343,275
21,Huelva,38,Higuera de la Sierra,1361,680,681
21,Huelva,39,Hinojales,366,190,176
21,Huelva,40,Hinojos,3797,1922,1875
21,Huelva,41,Huelva,145763,70688,75075
21,Huelva,42,Isla Cristina,20323,10280,10043
21,Huelva,43,Jabugo,2473,1226,1247
21,Huelva,44,Lepe,23781,12364,11417
21,Huelva,45,Linares de la Sierra,308,152,156
21,Huelva,46,Lucena del Puerto,2175,1120,1055
21,Huelva,47,Manzanilla,2355,1182,1173
21,Huelva,48,Marines (Los),320,159,161
21,Huelva,49,Minas de Riotinto,4401,2111,2290
21,Huelva,50,Moguer,18441,9991,8450
21,Huelva,51,Nava (La),328,172,156
21,Huelva,52,Nerva,5947,2884,3063
21,Huelva,53,Niebla,4033,2036,1997
21,Huelva,54,Palma del Condado (La),10074,5014,5060
21,Huelva,55,Palos de la Frontera,8415,4406,4009
21,Huelva,56,Paterna del Campo,3763,1913,1850
21,Huelva,57,Paymogo,1273,630,643
21,Huelva,58,Puebla de Guzmán,3200,1644,1556
21,Huelva,59,Puerto Moral,272,139,133
21,Huelva,60,Punta Umbría,14033,7092,6941
21,Huelva,61,Rociana del Condado,6863,3541,3322
21,Huelva,62,Rosal de la Frontera,1819,903,916
21,Huelva,63,San Bartolomé de la Torre,3205,1627,1578
21,Huelva,64,San Juan del Puerto,7204,3632,3572
21,Huelva,66,San Silvestre de Guzmán,662,348,314
21,Huelva,65,Sanlúcar de Guadiana,373,189,184
21,Huelva,67,Santa Ana la Real,484,227,257
21,Huelva,68,Santa Bárbara de Casa,1158,576,582
21,Huelva,69,Santa Olalla del Cala,2135,1078,1057
21,Huelva,70,Trigueros,7373,3692,3681
21,Huelva,71,Valdelarco,237,113,124
21,Huelva,72,Valverde del Camino,12615,6143,6472
21,Huelva,73,Villablanca,2419,1287,1132
21,Huelva,74,Villalba del Alcor,3445,1726,1719
21,Huelva,75,Villanueva de las Cruces,409,191,218
21,Huelva,76,Villanueva de los Castillejos,2768,1391,1377
21,Huelva,77,Villarrasa,2121,1078,1043
21,Huelva,78,Zalamea la Real,3516,1748,1768
21,Huelva,79,Zufre,995,521,474
22,Huesca,1,Abiego,288,155,133
22,Huesca,2,Abizanda,136,63,73
22,Huesca,3,Adahuesca,169,83,86
22,Huesca,4,Agüero,166,92,74
22,Huesca,907,Aínsa-Sobrarbe,1897,984,913
22,Huesca,6,Aisa,415,233,182
22,Huesca,7,Albalate de Cinca,1153,619,534
22,Huesca,8,Albalatillo,255,137,118
22,Huesca,9,Albelda,892,459,433
22,Huesca,11,Albero Alto,125,69,56
22,Huesca,12,Albero Bajo,111,60,51
22,Huesca,13,Alberuela de Tubo,357,186,171
22,Huesca,14,Alcalá de Gurrea,282,139,143
22,Huesca,15,Alcalá del Obispo,348,184,164
22,Huesca,16,Alcampell,827,406,421
22,Huesca,17,Alcolea de Cinca,1183,611,572
22,Huesca,18,Alcubierre,441,237,204
22,Huesca,19,Alerre,228,117,111
22,Huesca,20,Alfántega,112,57,55
22,Huesca,21,Almudévar,2381,1226,1155
22,Huesca,22,Almunia de San Juan,650,335,315
22,Huesca,23,Almuniente,559,276,283
22,Huesca,24,Alquézar,313,163,150
22,Huesca,25,Altorricón,1469,796,673
22,Huesca,27,Angüés,423,226,197
22,Huesca,28,Ansó,509,249,260
22,Huesca,29,Antillón,165,81,84
22,Huesca,32,Aragüés del Puerto,137,73,64
22,Huesca,35,Arén,337,168,169
22,Huesca,36,Argavieso,130,72,58
22,Huesca,37,Arguis,82,46,36
22,Huesca,39,Ayerbe,1112,560,552
22,Huesca,40,Azanuy-Alins,173,85,88
22,Huesca,41,Azara,191,97,94
22,Huesca,42,Azlor,144,76,68
22,Huesca,43,Baélls,125,73,52
22,Huesca,44,Bailo,240,145,95
22,Huesca,45,Baldellou,115,63,52
22,Huesca,46,Ballobar,980,492,488
22,Huesca,47,Banastás,239,126,113
22,Huesca,48,Barbastro,15880,7782,8098
22,Huesca,49,Barbués,115,59,56
22,Huesca,50,Barbuñales,110,55,55
22,Huesca,51,Bárcabo,104,59,45
22,Huesca,52,Belver de Cinca,1340,714,626
22,Huesca,53,Benabarre,1160,609,551
22,Huesca,54,Benasque,2045,1105,940
22,Huesca,55,Berbegal,465,239,226
22,Huesca,57,Bielsa,506,268,238
22,Huesca,58,Bierge,239,136,103
22,Huesca,59,Biescas,1513,837,676
22,Huesca,60,Binaced,1533,816,717
22,Huesca,61,Binéfar,9012,4702,4310
22,Huesca,62,Bisaurri,247,131,116
22,Huesca,63,Biscarrués,217,112,105
22,Huesca,64,Blecua y Torres,195,112,83
22,Huesca,66,Boltaña,924,485,439
22,Huesca,67,Bonansa,101,54,47
22,Huesca,68,Borau,72,40,32
22,Huesca,69,Broto,520,273,247
22,Huesca,72,Caldearenas,244,142,102
22,Huesca,74,Campo,287,136,151
22,Huesca,75,Camporrélls,217,120,97
22,Huesca,76,Canal de Berdún,416,232,184
22,Huesca,77,Candasnos,446,234,212
22,Huesca,78,Canfranc,678,389,289
22,Huesca,79,Capdesaso,161,76,85
22,Huesca,80,Capella,404,207,197
22,Huesca,81,Casbas de Huesca,293,153,140
22,Huesca,83,Castejón de Monegros,655,338,317
22,Huesca,84,Castejón de Sos,733,387,346
22,Huesca,82,Castejón del Puente,433,228,205
22,Huesca,85,Castelflorite,131,66,65
22,Huesca,86,Castiello de Jaca,230,125,105
22,Huesca,87,Castigaleu,118,67,51
22,Huesca,88,Castillazuelo,223,109,114
22,Huesca,89,Castillonroy,391,189,202
22,Huesca,94,Chalamera,144,79,65
22,Huesca,95,Chía,113,59,54
22,Huesca,96,Chimillas,340,170,170
22,Huesca,90,Colungo,140,72,68
22,Huesca,99,Esplús,704,355,349
22,Huesca,102,Estada,231,126,105
22,Huesca,103,Estadilla,877,436,441
22,Huesca,105,Estopiñán del Castillo,199,112,87
22,Huesca,106,Fago,35,20,15
22,Huesca,107,Fanlo,170,105,65
22,Huesca,109,Fiscal,300,170,130
22,Huesca,110,Fonz,1040,527,513
22,Huesca,111,Foradada del Toscar,212,110,102
22,Huesca,112,Fraga,13191,6749,6442
22,Huesca,113,Fueva (La),621,317,304
22,Huesca,114,Gistaín,158,87,71
22,Huesca,115,Grado (El),497,262,235
22,Huesca,116,Grañén,2009,1044,965
22,Huesca,117,Graus,3472,1784,1688
22,Huesca,119,Gurrea de Gállego,1745,905,840
22,Huesca,122,Hoz de Jaca,77,39,38
22,Huesca,908,Hoz y Costean,223,123,100
22,Huesca,124,Huerto,258,142,116
22,Huesca,125,Huesca,49312,23939,25373
22,Huesca,126,Ibieca,110,59,51
22,Huesca,127,Igriés,456,233,223
22,Huesca,128,Ilche,275,148,127
22,Huesca,129,Isábena,302,163,139
22,Huesca,130,Jaca,12736,6389,6347
22,Huesca,131,Jasa,124,73,51
22,Huesca,133,Labuerda,169,91,78
22,Huesca,135,Laluenga,244,133,111
22,Huesca,136,Lalueza,1136,590,546
22,Huesca,137,Lanaja,1457,763,694
22,Huesca,139,Laperdiguera,101,53,48
22,Huesca,141,Lascellas-Ponzano,162,89,73
22,Huesca,142,Lascuarre,147,77,70
22,Huesca,143,Laspaúles,281,160,121
22,Huesca,144,Laspuña,298,160,138
22,Huesca,149,Loarre,392,211,181
22,Huesca,150,Loporzano,520,288,232
22,Huesca,151,Loscorrales,114,63,51
22,Huesca,905,Lupiñén-Ortilla,350,190,160
22,Huesca,155,Monesma y Cajigar,111,59,52
22,Huesca,156,Monflorite-Lascasas,240,135,105
22,Huesca,157,Montanuy,311,177,134
22,Huesca,158,Monzón,16200,8305,7895
22,Huesca,160,Naval,296,147,149
22,Huesca,162,Novales,179,96,83
22,Huesca,163,Nueno,492,273,219
22,Huesca,164,Olvena,65,31,34
22,Huesca,165,Ontiñena,608,309,299
22,Huesca,167,Osso de Cinca,749,420,329
22,Huesca,168,Palo,38,26,12
22,Huesca,170,Panticosa,740,376,364
22,Huesca,172,Peñalba,756,389,367
22,Huesca,173,Peñas de Riglos (Las),295,173,122
22,Huesca,174,Peralta de Alcofea,654,330,324
22,Huesca,175,Peralta de Calasanz,261,151,110
22,Huesca,176,Peraltilla,181,98,83
22,Huesca,177,Perarrúa,110,52,58
22,Huesca,178,Pertusa,124,67,57
22,Huesca,181,Piracés,110,69,41
22,Huesca,182,Plan,319,163,156
22,Huesca,184,Poleñino,247,127,120
22,Huesca,186,Pozán de Vero,256,123,133
22,Huesca,187,Puebla de Castro (La),382,201,181
22,Huesca,188,Puente de Montañana,88,43,45
22,Huesca,902,Puente la Reina de Jaca,232,123,109
22,Huesca,189,Puértolas,222,126,96
22,Huesca,190,Pueyo de Araguás (El),164,96,68
22,Huesca,193,Pueyo de Santa Cruz,347,176,171
22,Huesca,195,Quicena,274,138,136
22,Huesca,197,Robres,643,331,312
22,Huesca,199,Sabiñánigo,9264,4689,4575
22,Huesca,200,Sahún,331,177,154
22,Huesca,201,Salas Altas,330,174,156
22,Huesca,202,Salas Bajas,144,67,77
22,Huesca,203,Salillas,119,64,55
22,Huesca,204,Sallent de Gállego,1384,695,689
22,Huesca,205,San Esteban de Litera,512,256,256
22,Huesca,207,San Juan de Plan,150,82,68
22,Huesca,903,San Miguel del Cinca,854,442,412
22,Huesca,206,Sangarrén,263,128,135
22,Huesca,208,Santa Cilia,191,110,81
22,Huesca,209,Santa Cruz de la Serós,148,89,59
22,Huesca,906,Santa María de Dulcis,211,108,103
22,Huesca,212,Santaliestra y San Quílez,108,56,52
22,Huesca,213,Sariñena,4152,2142,2010
22,Huesca,214,Secastilla,131,57,74
22,Huesca,215,Seira,170,86,84
22,Huesca,217,Sena,556,303,253
22,Huesca,218,Senés de Alcubierre,51,29,22
22,Huesca,220,Sesa,244,132,112
22,Huesca,221,Sesué,125,72,53
22,Huesca,222,Siétamo,576,312,264
22,Huesca,223,Sopeira,102,52,50
22,Huesca,904,Sotonera (La),1083,569,514
22,Huesca,225,Tamarite de Litera,3678,1852,1826
22,Huesca,226,Tardienta,1035,541,494
22,Huesca,227,Tella-Sin,268,139,129
22,Huesca,228,Tierz,550,274,276
22,Huesca,229,Tolva,176,94,82
22,Huesca,230,Torla,329,173,156
22,Huesca,232,Torralba de Aragón,117,63,54
22,Huesca,233,Torre la Ribera,118,64,54
22,Huesca,234,Torrente de Cinca,1084,576,508
22,Huesca,235,Torres de Alcanadre,122,65,57
22,Huesca,236,Torres de Barbués,324,159,165
22,Huesca,239,Tramaced,105,61,44
22,Huesca,242,Valfarta,101,55,46
22,Huesca,243,Valle de Bardají,53,29,24
22,Huesca,901,Valle de Hecho,973,504,469
22,Huesca,244,Valle de Lierp,47,25,22
22,Huesca,245,Velilla de Cinca,469,244,225
22,Huesca,909,Vencillón,471,242,229
22,Huesca,246,Veracruz,111,61,50
22,Huesca,247,Viacamp y Litera,25,16,9
22,Huesca,248,Vicién,118,63,55
22,Huesca,249,Villanova,154,75,79
22,Huesca,250,Villanúa,466,267,199
22,Huesca,251,Villanueva de Sigena,520,262,258
22,Huesca,252,Yebra de Basa,155,93,62
22,Huesca,253,Yésero,80,49,31
22,Huesca,254,Zaidín,1822,946,876
23,Jaén,1,Albanchez de Mágina,1326,688,638
23,Jaén,2,Alcalá la Real,22129,10980,11149
23,Jaén,3,Alcaudete,11164,5550,5614
23,Jaén,4,Aldeaquemada,542,284,258
23,Jaén,5,Andújar,38662,19049,19613
23,Jaén,6,Arjona,5775,2891,2884
23,Jaén,7,Arjonilla,3908,1949,1959
23,Jaén,8,Arquillos,1985,995,990
23,Jaén,905,Arroyo del Ojanco,2500,1279,1221
23,Jaén,9,Baeza,16056,7951,8105
23,Jaén,10,Bailén,18362,9402,8960
23,Jaén,11,Baños de la Encina,2715,1410,1305
23,Jaén,12,Beas de Segura,5467,2811,2656
23,Jaén,902,Bedmar y Garcíez,3185,1597,1588
23,Jaén,14,Begíjar,3101,1577,1524
23,Jaén,15,Bélmez de la Moraleda,1922,1002,920
23,Jaén,16,Benatae,586,338,248
23,Jaén,17,Cabra del Santo Cristo,2212,1170,1042
23,Jaén,18,Cambil,2996,1581,1415
23,Jaén,19,Campillo de Arenas,2020,1032,988
23,Jaén,20,Canena,2082,1016,1066
23,Jaén,21,Carboneros,671,349,322
23,Jaén,901,Cárcheles,1441,731,710
23,Jaén,24,Carolina (La),15576,7684,7892
23,Jaén,25,Castellar,3748,1929,1819
23,Jaén,26,Castillo de Locubín,5009,2492,2517
23,Jaén,27,Cazalilla,839,439,400
23,Jaén,28,Cazorla,8173,4011,4162
23,Jaén,29,Chiclana de Segura,1191,589,602
23,Jaén,30,Chilluévar,1629,798,831
23,Jaén,31,Escañuela,950,470,480
23,Jaén,32,Espelúy,750,381,369
23,Jaén,33,Frailes,1796,905,891
23,Jaén,34,Fuensanta de Martos,3326,1665,1661
23,Jaén,35,Fuerte del Rey,1267,639,628
23,Jaén,37,Génave,565,300,265
23,Jaén,38,Guardia de Jaén (La),3301,1725,1576
23,Jaén,39,Guarromán,2904,1441,1463
23,Jaén,41,Higuera de Calatrava,696,368,328
23,Jaén,42,Hinojares,446,214,232
23,Jaén,43,Hornos,663,332,331
23,Jaén,44,Huelma,6172,3146,3026
23,Jaén,45,Huesa,2726,1382,1344
23,Jaén,46,Ibros,3186,1615,1571
23,Jaén,47,Iruela (La),1989,1002,987
23,Jaén,48,Iznatoraf,1155,599,556
23,Jaén,49,Jabalquinto,2416,1215,1201
23,Jaén,50,Jaén,116769,56459,60310
23,Jaén,51,Jamilena,3459,1758,1701
23,Jaén,52,Jimena,1507,728,779
23,Jaén,53,Jódar,12150,6071,6079
23,Jaén,40,Lahiguera,1877,937,940
23,Jaén,54,Larva,474,245,229
23,Jaén,55,Linares,61452,30118,31334
23,Jaén,56,Lopera,3995,1963,2032
23,Jaén,57,Lupión,1009,493,516
23,Jaén,58,Mancha Real,10431,5339,5092
23,Jaén,59,Marmolejo,7618,3844,3774
23,Jaén,60,Martos,24061,11810,12251
23,Jaén,61,Mengíbar,9102,4597,4505
23,Jaén,62,Montizón,1956,1008,948
23,Jaén,63,Navas de San Juan,5047,2503,2544
23,Jaén,64,Noalejo,2110,1056,1054
23,Jaén,65,Orcera,2141,1080,1061
23,Jaén,66,Peal de Becerro,5494,2755,2739
23,Jaén,67,Pegalajar,3171,1636,1535
23,Jaén,69,Porcuna,6859,3427,3432
23,Jaén,70,Pozo Alcón,5322,2737,2585
23,Jaén,71,Puente de Génave,2153,1068,1085
23,Jaén,72,Puerta de Segura (La),2618,1318,1300
23,Jaén,73,Quesada,5938,2951,2987
23,Jaén,74,Rus,3778,1921,1857
23,Jaén,75,Sabiote,4129,2100,2029
23,Jaén,76,Santa Elena,1002,535,467
23,Jaén,77,Santiago de Calatrava,883,453,430
23,Jaén,904,Santiago-Pontones,4040,2066,1974
23,Jaén,79,Santisteban del Puerto,4959,2583,2376
23,Jaén,80,Santo Tomé,2276,1169,1107
23,Jaén,81,Segura de la Sierra,2029,1133,896
23,Jaén,82,Siles,2465,1239,1226
23,Jaén,84,Sorihuela del Guadalimar,1223,654,569
23,Jaén,86,Torre del Campo,14076,7092,6984
23,Jaén,85,Torreblascopedro,2832,1422,1410
23,Jaén,87,Torredonjimeno,13914,6856,7058
23,Jaén,88,Torreperogil,6649,3260,3389
23,Jaén,90,Torres,1682,867,815
23,Jaén,91,Torres de Albánchez,870,432,438
23,Jaén,92,Úbeda,34139,16694,17445
23,Jaén,93,Valdepeñas de Jaén,4241,2104,2137
23,Jaén,94,Vilches,5018,2545,2473
23,Jaén,95,Villacarrillo,11137,5619,5518
23,Jaén,96,Villanueva de la Reina,3375,1693,1682
23,Jaén,97,Villanueva del Arzobispo,8724,4447,4277
23,Jaén,98,Villardompardo,1160,585,575
23,Jaén,99,Villares (Los),5329,2654,2675
23,Jaén,101,Villarrodrigo,477,237,240
23,Jaén,903,Villatorres,4351,2262,2089
24,León,1,Acebedo,276,157,119
24,León,2,Algadefe,324,166,158
24,León,3,Alija del Infantado,900,459,441
24,León,4,Almanza,664,378,286
24,León,5,Antigua (La),543,299,244
24,León,6,Ardón,657,348,309
24,León,7,Arganza,803,406,397
24,León,8,Astorga,12285,5841,6444
24,León,9,Balboa,404,219,185
24,León,10,Bañeza (La),10549,5114,5435
24,León,11,Barjas,326,170,156
24,León,12,Barrios de Luna (Los),309,163,146
24,León,14,Bembibre,10092,5008,5084
24,León,15,Benavides,2903,1462,1441
24,León,16,Benuza,667,351,316
24,León,17,Bercianos del Páramo,779,394,385
24,León,18,Bercianos del Real Camino,215,107,108
24,León,19,Berlanga del Bierzo,410,194,216
24,León,20,Boca de Huérgano,575,319,256
24,León,21,Boñar,2236,1092,1144
24,León,22,Borrenes,446,222,224
24,León,23,Brazuelo,347,184,163
24,León,24,Burgo Ranero (El),893,472,421
24,León,25,Burón,372,207,165
24,León,26,Bustillo del Páramo,1560,799,761
24,León,27,Cabañas Raras,1259,654,605
24,León,28,Cabreros del Río,497,266,231
24,León,29,Cabrillanes,973,491,482
24,León,30,Cacabelos,5236,2656,2580
24,León,31,Calzada del Coto,280,155,125
24,León,32,Campazas,173,91,82
24,León,33,Campo de Villavidel,265,133,132
24,León,34,Camponaraya,3859,1917,1942
24,León,36,Candín,367,195,172
24,León,37,Cármenes,410,220,190
24,León,38,Carracedelo,3561,1739,1822
24,León,39,Carrizo,2698,1363,1335
24,León,40,Carrocera,589,285,304
24,León,41,Carucedo,634,310,324
24,León,42,Castilfalé,86,47,39
24,León,43,Castrillo de Cabrera,172,86,86
24,León,44,Castrillo de la Valduerna,212,94,118
24,León,46,Castrocalbón,1196,618,578
24,León,47,Castrocontrigo,1006,501,505
24,León,49,Castropodame,1861,951,910
24,León,50,Castrotierra de Valmadrigal,135,64,71
24,León,51,Cea,628,325,303
24,León,52,Cebanico,222,126,96
24,León,53,Cebrones del Río,630,329,301
24,León,65,Chozas de Abajo,2170,1100,1070
24,León,54,Cimanes de la Vega,586,298,288
24,León,55,Cimanes del Tejar,877,437,440
24,León,56,Cistierna,3750,1829,1921
24,León,57,Congosto,1742,829,913
24,León,58,Corbillos de los Oteros,284,145,139
24,León,59,Corullón,1101,559,542
24,León,60,Crémenes,734,372,362
24,León,61,Cuadros,1854,916,938
24,León,62,Cubillas de los Oteros,194,104,90
24,León,63,Cubillas de Rueda,548,284,264
24,León,64,Cubillos del Sil,1523,795,728
24,León,66,Destriana,679,325,354
24,León,67,Encinedo,961,497,464
24,León,68,Ercina (La),625,315,310
24,León,69,Escobar de Campos,69,41,28
24,León,70,Fabero,5296,2589,2707
24,León,71,Folgoso de la Ribera,1266,611,655
24,León,73,Fresno de la Vega,608,312,296
24,León,74,Fuentes de Carbajal,126,66,60
24,León,76,Garrafe de Torío,1200,626,574
24,León,77,Gordaliza del Pino,322,169,153
24,León,78,Gordoncillo,534,258,276
24,León,79,Gradefes,1155,587,568
24,León,80,Grajal de Campos,276,120,156
24,León,81,Gusendos de los Oteros,170,90,80
24,León,82,Hospital de Órbigo,1078,529,549
24,León,83,Igüeña,1557,814,743
24,León,84,Izagre,233,111,122
24,León,86,Joarilla de las Matas,381,200,181
24,León,87,Laguna Dalga,833,431,402
24,León,88,Laguna de Negrillos,1307,662,645
24,León,89,León,136985,63255,73730
24,León,92,Llamas de la Ribera,1065,540,525
24,León,90,Lucillo,454,232,222
24,León,91,Luyego,828,400,428
24,León,93,Magaz de Cepeda,449,218,231
24,León,94,Mansilla de las Mulas,1973,984,989
24,León,95,Mansilla Mayor,377,188,189
24,León,96,Maraña,155,84,71
24,León,97,Matadeón de los Oteros,285,157,128
24,León,98,Matallana de Torío,1475,742,733
24,León,99,Matanza,269,132,137
24,León,100,Molinaseca,796,415,381
24,León,101,Murias de Paredes,543,256,287
24,León,102,Noceda del Bierzo,810,394,416
24,León,103,Oencia,457,243,214
24,León,104,Omañas (Las),345,179,166
24,León,105,Onzonilla,1578,801,777
24,León,106,Oseja de Sajambre,290,163,127
24,León,107,Pajares de los Oteros,340,183,157
24,León,108,Palacios de la Valduerna,494,234,260
24,León,109,Palacios del Sil,1301,675,626
24,León,110,Páramo del Sil,1557,804,753
24,León,112,Peranzanes,314,188,126
24,León,113,Pobladura de Pelayo García,509,256,253
24,León,114,Pola de Gordón (La),4220,2103,2117
24,León,115,Ponferrada,66656,32243,34413
24,León,116,Posada de Valdeón,526,300,226
24,León,117,Pozuelo del Páramo,556,282,274
24,León,118,Prado de la Guzpeña,133,71,62
24,León,119,Priaranza del Bierzo,918,448,470
24,León,120,Prioro,414,221,193
24,León,121,Puebla de Lillo,631,331,300
24,León,122,Puente de Domingo Flórez,1850,974,876
24,León,123,Quintana del Castillo,958,505,453
24,León,124,Quintana del Marco,503,258,245
24,León,125,Quintana y Congosto,657,337,320
24,León,127,Regueras de Arriba,360,189,171
24,León,129,Reyero,131,68,63
24,León,130,Riaño,551,322,229
24,León,131,Riego de la Vega,998,500,498
24,León,132,Riello,798,421,377
24,León,133,Rioseco de Tapia,458,241,217
24,León,134,Robla (La),4730,2339,2391
24,León,136,Roperuelos del Páramo,729,365,364
24,León,137,Sabero,1517,728,789
24,León,139,Sahagún,2924,1433,1491
24,León,141,San Adrián del Valle,129,59,70
24,León,142,San Andrés del Rabanedo,28413,13810,14603
24,León,144,San Cristóbal de la Polantera,930,456,474
24,León,145,San Emiliano,731,387,344
24,León,146,San Esteban de Nogales,330,162,168
24,León,148,San Justo de la Vega,2043,1035,1008
24,León,149,San Millán de los Caballeros,171,85,86
24,León,150,San Pedro Bercianos,326,167,159
24,León,143,Sancedo,573,284,289
24,León,151,Santa Colomba de Curueño,642,312,330
24,León,152,Santa Colomba de Somoza,471,240,231
24,León,153,Santa Cristina de Valmadrigal,343,181,162
24,León,154,Santa Elena de Jamuz,1339,691,648
24,León,155,Santa María de la Isla,631,324,307
24,León,158,Santa María de Ordás,365,180,185
24,León,156,Santa María del Monte de Cea,317,165,152
24,León,157,Santa María del Páramo,3156,1544,1612
24,León,159,Santa Marina del Rey,2264,1135,1129
24,León,160,Santas Martas,920,468,452
24,León,161,Santiago Millas,349,181,168
24,León,162,Santovenia de la Valdoncina,1888,956,932
24,León,163,Sariegos,3742,1894,1848
24,León,164,Sena de Luna,437,210,227
24,León,165,Sobrado,455,229,226
24,León,166,Soto de la Vega,1946,998,948
24,León,167,Soto y Amío,1022,496,526
24,León,168,Toral de los Guzmanes,663,354,309
24,León,169,Toreno,3876,1923,1953
24,León,170,Torre del Bierzo,2825,1421,1404
24,León,171,Trabadelo,509,272,237
24,León,172,Truchas,632,296,336
24,León,173,Turcia,1196,585,611
24,León,174,Urdiales del Páramo,557,287,270
24,León,185,Val de San Lorenzo,662,331,331
24,León,175,Valdefresno,2004,1046,958
24,León,176,Valdefuentes del Páramo,365,196,169
24,León,177,Valdelugueros,454,262,192
24,León,178,Valdemora,94,41,53
24,León,179,Valdepiélago,413,215,198
24,León,180,Valdepolo,1457,767,690
24,León,181,Valderas,2055,1041,1014
24,León,182,Valderrey,588,287,301
24,León,183,Valderrueda,1099,576,523
24,León,184,Valdesamario,225,114,111
24,León,187,Valdevimbre,1125,574,551
24,León,188,Valencia de Don Juan,4412,2177,2235
24,León,191,Vallecillo,137,73,64
24,León,189,Valverde de la Virgen,5505,2768,2737
24,León,190,Valverde-Enrique,214,117,97
24,León,193,Vecilla (La),438,231,207
24,León,196,Vega de Espinareda,2638,1325,1313
24,León,197,Vega de Infanzones,925,455,470
24,León,198,Vega de Valcarce,731,373,358
24,León,194,Vegacervera,306,165,141
24,León,199,Vegaquemada,475,246,229
24,León,201,Vegas del Condado,1319,699,620
24,León,202,Villablino,11544,5733,5811
24,León,203,Villabraz,142,75,67
24,León,205,Villadangos del Páramo,1109,567,542
24,León,206,Villadecanes,2198,1083,1115
24,León,207,Villademor de la Vega,419,221,198
24,León,209,Villafranca del Bierzo,3636,1770,1866
24,León,210,Villagatón,707,351,356
24,León,211,Villamandos,359,180,179
24,León,901,Villamanín,1147,586,561
24,León,212,Villamañán,1295,637,658
24,León,213,Villamartín de Don Sancho,142,76,66
24,León,214,Villamejil,868,432,436
24,León,215,Villamol,216,110,106
24,León,216,Villamontán de la Valduerna,970,503,467
24,León,217,Villamoratiel de las Matas,175,99,76
24,León,218,Villanueva de las Manzanas,547,270,277
24,León,219,Villaobispo de Otero,657,337,320
24,León,902,Villaornate y Castro,468,245,223
24,León,221,Villaquejida,1042,542,500
24,León,222,Villaquilambre,13891,6942,6949
24,León,223,Villarejo de Órbigo,3225,1588,1637
24,León,224,Villares de Órbigo,820,421,399
24,León,225,Villasabariego,1271,651,620
24,León,226,Villaselán,266,147,119
24,León,227,Villaturiel,1798,941,857
24,León,228,Villazala,924,480,444
24,León,229,Villazanzo de Valderaduey,609,331,278
24,León,230,Zotes del Páramo,556,297,259
25,Lleida,1,Abella de la Conca,186,102,84
25,Lleida,2,Àger,491,270,221
25,Lleida,3,Agramunt,5459,2900,2559
25,Lleida,38,Aitona,2370,1241,1129
25,Lleida,4,Alamús (Els),701,362,339
25,Lleida,5,Alàs i Cerc,404,217,187
25,Lleida,6,Albagés (L'),492,263,229
25,Lleida,7,Albatàrrec,1519,814,705
25,Lleida,8,Albesa,1587,799,788
25,Lleida,9,Albi (L'),811,416,395
25,Lleida,10,Alcanó,253,123,130
25,Lleida,11,Alcarràs,5970,3082,2888
25,Lleida,12,Alcoletge,2239,1202,1037
25,Lleida,13,Alfarràs,3274,1714,1560
25,Lleida,14,Alfés,321,170,151
25,Lleida,15,Algerri,467,238,229
25,Lleida,16,Alguaire,3088,1607,1481
25,Lleida,17,Alins,251,130,121
25,Lleida,19,Almacelles,6088,3227,2861
25,Lleida,20,Almatret,443,232,211
25,Lleida,21,Almenar,3576,1874,1702
25,Lleida,22,Alòs de Balaguer,174,100,74
25,Lleida,23,Alpicat,5362,2695,2667
25,Lleida,24,Alt Àneu,457,261,196
25,Lleida,27,Anglesola,1303,659,644
25,Lleida,29,Arbeca,2512,1292,1220
25,Lleida,31,Arres,61,37,24
25,Lleida,32,Arsèguel,100,49,51
25,Lleida,33,Artesa de Lleida,1451,756,695
25,Lleida,34,Artesa de Segre,3696,1917,1779
25,Lleida,36,Aspa,269,135,134
25,Lleida,37,Avellanes i Santa Linya (Les),469,264,205
25,Lleida,39,Baix Pallars,381,211,170
25,Lleida,40,Balaguer,15769,7948,7821
25,Lleida,41,Barbens,828,453,375
25,Lleida,42,Baronia de Rialb (La),281,152,129
25,Lleida,44,Bassella,256,134,122
25,Lleida,45,Bausen,52,33,19
25,Lleida,46,Belianes,592,306,286
25,Lleida,170,Bellaguarda,352,184,168
25,Lleida,47,Bellcaire d'Urgell,1295,631,664
25,Lleida,48,Bell-lloc d'Urgell,2326,1142,1184
25,Lleida,49,Bellmunt d'Urgell,225,108,117
25,Lleida,50,Bellpuig,4454,2307,2147
25,Lleida,51,Bellver de Cerdanya,1906,1002,904
25,Lleida,52,Bellvís,2360,1228,1132
25,Lleida,53,Benavent de Segrià,1249,650,599
25,Lleida,55,Biosca,228,120,108
25,Lleida,57,Bòrdes (Es),247,131,116
25,Lleida,58,Borges Blanques (Les),5606,2835,2771
25,Lleida,59,Bossòst,1043,539,504
25,Lleida,56,Bovera,371,188,183
25,Lleida,60,Cabanabona,115,55,60
25,Lleida,61,Cabó,104,60,44
25,Lleida,62,Camarasa,931,484,447
25,Lleida,63,Canejan,104,54,50
25,Lleida,904,Castell de Mur,163,83,80
25,Lleida,64,Castellar de la Ribera,162,79,83
25,Lleida,67,Castelldans,1004,548,456
25,Lleida,68,Castellnou de Seana,750,398,352
25,Lleida,69,Castelló de Farfanya,564,293,271
25,Lleida,70,Castellserà,1128,579,549
25,Lleida,71,Cava,56,34,22
25,Lleida,72,Cervera,9305,4853,4452
25,Lleida,73,Cervià de les Garrigues,873,456,417
25,Lleida,74,Ciutadilla,223,128,95
25,Lleida,75,Clariana de Cardener,146,79,67
25,Lleida,76,Cogul (El),211,117,94
25,Lleida,77,Coll de Nargó,618,333,285
25,Lleida,163,Coma i la Pedra (La),253,149,104
25,Lleida,161,Conca de Dalt,428,221,207
25,Lleida,78,Corbins,1347,733,614
25,Lleida,79,Cubells,401,203,198
25,Lleida,81,Espluga Calba (L'),452,243,209
25,Lleida,82,Espot,360,199,161
25,Lleida,88,Estamariu,117,62,55
25,Lleida,85,Estaràs,184,101,83
25,Lleida,86,Esterri d'Àneu,803,404,399
25,Lleida,87,Esterri de Cardós,69,32,37
25,Lleida,89,Farrera,104,60,44
25,Lleida,908,Fígols i Alinyà,254,137,117
25,Lleida,92,Floresta (La),185,98,87
25,Lleida,93,Fondarella,783,400,383
25,Lleida,94,Foradada,197,116,81
25,Lleida,96,Fuliola (La),1235,621,614
25,Lleida,97,Fulleda,115,61,54
25,Lleida,98,Gavet de la Conca,309,145,164
25,Lleida,912,Gimenells i el Pla de la Font,1118,588,530
25,Lleida,99,Golmés,1560,785,775
25,Lleida,100,Gósol,221,117,104
25,Lleida,101,Granadella (La),774,404,370
25,Lleida,102,Granja d'Escarp (La),1042,552,490
25,Lleida,103,Granyanella,172,89,83
25,Lleida,105,Granyena de les Garrigues,176,96,80
25,Lleida,104,Granyena de Segarra,149,77,72
25,Lleida,109,Guimerà,344,180,164
25,Lleida,903,Guingueta d'Àneu (La),360,190,170
25,Lleida,110,Guissona,5139,2783,2356
25,Lleida,111,Guixers,137,82,55
25,Lleida,115,Isona i Conca Dellà,1139,613,526
25,Lleida,112,Ivars de Noguera,357,190,167
25,Lleida,113,Ivars d'Urgell,1858,983,875
25,Lleida,114,Ivorra,144,68,76
25,Lleida,910,Josa i Tuixén,176,91,85
25,Lleida,118,Juncosa,546,301,245
25,Lleida,119,Juneda,3264,1711,1553
25,Lleida,121,Les,903,445,458
25,Lleida,122,Linyola,2583,1313,1270
25,Lleida,123,Lladorre,211,101,110
25,Lleida,124,Lladurs,207,112,95
25,Lleida,125,Llardecans,562,291,271
25,Lleida,126,Llavorsí,334,173,161
25,Lleida,120,Lleida,125677,62347,63330
25,Lleida,127,Lles de Cerdanya,227,134,93
25,Lleida,128,Llimiana,158,87,71
25,Lleida,129,Llobera,222,118,104
25,Lleida,133,Maials,973,494,479
25,Lleida,130,Maldà,285,152,133
25,Lleida,131,Massalcoreig,635,346,289
25,Lleida,132,Massoteres,225,123,102
25,Lleida,134,Menàrguens,863,450,413
25,Lleida,135,Miralcamp,1310,659,651
25,Lleida,137,Mollerussa,12569,6555,6014
25,Lleida,136,Molsosa (La),127,60,67
25,Lleida,139,Montellà i Martinet,606,324,282
25,Lleida,140,Montferrer i Castellbò,944,512,432
25,Lleida,138,Montgai,772,387,385
25,Lleida,142,Montoliu de Lleida,498,258,240
25,Lleida,141,Montoliu de Segarra,186,106,80
25,Lleida,143,Montornès de Segarra,105,50,55
25,Lleida,145,Nalec,102,49,53
25,Lleida,25,Naut Aran,1732,918,814
25,Lleida,146,Navès,262,127,135
25,Lleida,148,Odèn,275,158,117
25,Lleida,149,Oliana,1939,983,956
25,Lleida,150,Oliola,246,142,104
25,Lleida,151,Olius,686,345,341
25,Lleida,152,Oluges (Les),174,91,83
25,Lleida,153,Omellons (Els),252,131,121
25,Lleida,154,Omells de na Gaia (Els),159,94,65
25,Lleida,155,Organyà,961,476,485
25,Lleida,156,Os de Balaguer,924,494,430
25,Lleida,157,Ossó de Sió,236,118,118
25,Lleida,158,Palau d'Anglesola (El),1883,961,922
25,Lleida,164,Penelles,525,297,228
25,Lleida,165,Peramola,377,203,174
25,Lleida,166,Pinell de Solsonès,204,110,94
25,Lleida,167,Pinós,322,179,143
25,Lleida,911,Plans de Sió (Els),570,297,273
25,Lleida,168,Poal (El),660,353,307
25,Lleida,169,Pobla de Cérvoles (La),250,138,112
25,Lleida,171,Pobla de Segur (La),3050,1554,1496
25,Lleida,30,Pont de Bar (El),193,109,84
25,Lleida,173,Pont de Suert (El),2317,1201,1116
25,Lleida,172,Ponts,2567,1287,1280
25,Lleida,174,Portella (La),796,457,339
25,Lleida,175,Prats i Sansor,226,133,93
25,Lleida,176,Preixana,422,217,205
25,Lleida,177,Preixens,514,256,258
25,Lleida,179,Prullans,224,110,114
25,Lleida,180,Puiggròs,298,160,138
25,Lleida,181,Puigverd d'Agramunt,268,147,121
25,Lleida,182,Puigverd de Lleida,1259,640,619
25,Lleida,183,Rialp,649,341,308
25,Lleida,905,Ribera d'Ondara,476,255,221
25,Lleida,185,Ribera d'Urgellet,971,515,456
25,Lleida,186,Riner,274,137,137
25,Lleida,913,Riu de Cerdanya,94,47,47
25,Lleida,189,Rosselló,2478,1308,1170
25,Lleida,190,Salàs de Pallars,330,168,162
25,Lleida,191,Sanaüja,448,229,219
25,Lleida,196,Sant Esteve de la Sarga,155,99,56
25,Lleida,192,Sant Guim de Freixenet,1057,524,533
25,Lleida,197,Sant Guim de la Plana,199,107,92
25,Lleida,193,Sant Llorenç de Morunys,950,494,456
25,Lleida,902,Sant Martí de Riucorb,709,376,333
25,Lleida,194,Sant Ramon,565,302,263
25,Lleida,201,Sarroca de Bellera,142,78,64
25,Lleida,200,Sarroca de Lleida,446,230,216
25,Lleida,202,Senterada,126,66,60
25,Lleida,35,Sentiu de Sió (La),478,232,246
25,Lleida,204,Seròs,1909,1098,811
25,Lleida,203,Seu d'Urgell (La),12533,6189,6344
25,Lleida,205,Sidamon,688,355,333
25,Lleida,206,Soleràs (El),382,201,181
25,Lleida,207,Solsona,8823,4506,4317
25,Lleida,208,Soriguera,337,179,158
25,Lleida,209,Sort,2238,1151,1087
25,Lleida,210,Soses,1643,897,746
25,Lleida,211,Sudanell,805,437,368
25,Lleida,212,Sunyer,283,145,138
25,Lleida,215,Talarn,339,163,176
25,Lleida,216,Talavera,303,167,136
25,Lleida,217,Tàrrega,15155,7696,7459
25,Lleida,218,Tarrés,111,56,55
25,Lleida,219,Tarroja de Segarra,175,92,83
25,Lleida,220,Térmens,1531,763,768
25,Lleida,221,Tírvia,120,64,56
25,Lleida,222,Tiurana,48,26,22
25,Lleida,223,Torà,1327,686,641
25,Lleida,224,Torms (Els),189,101,88
25,Lleida,225,Tornabous,823,441,382
25,Lleida,227,Torre de Cabdella (La),722,370,352
25,Lleida,226,Torrebesses,305,155,150
25,Lleida,228,Torrefarrera,3051,1575,1476
25,Lleida,907,Torrefeta i Florejacs,650,329,321
25,Lleida,230,Torregrossa,2302,1164,1138
25,Lleida,231,Torrelameu,628,357,271
25,Lleida,232,Torres de Segre,2054,1066,988
25,Lleida,233,Torre-serona,341,177,164
25,Lleida,234,Tremp,5401,2668,2733
25,Lleida,43,Vall de Boí (La),1079,582,497
25,Lleida,901,Vall de Cardós,393,218,175
25,Lleida,238,Vallbona de les Monges,247,127,120
25,Lleida,240,Vallfogona de Balaguer,1601,802,799
25,Lleida,906,Valls d'Aguilar (Les),314,172,142
25,Lleida,239,Valls de Valira (Les),744,405,339
25,Lleida,909,Vansa i Fórnols (La),196,108,88
25,Lleida,242,Verdú,1027,504,523
25,Lleida,243,Vielha e Mijaran,5239,2776,2463
25,Lleida,244,Vilagrassa,467,243,224
25,Lleida,245,Vilaller,678,388,290
25,Lleida,247,Vilamòs,173,94,79
25,Lleida,248,Vilanova de Bellpuig,1100,568,532
25,Lleida,254,Vilanova de la Barca,1122,576,546
25,Lleida,249,Vilanova de l'Aguda,246,123,123
25,Lleida,250,Vilanova de Meià,432,226,206
25,Lleida,251,Vilanova de Segrià,809,427,382
25,Lleida,252,Vila-sana,611,305,306
25,Lleida,253,Vilosell (El),202,99,103
25,Lleida,255,Vinaixa,604,307,297
26,La Rioja,1,Ábalos,339,201,138
26,La Rioja,2,Agoncillo,1138,626,512
26,La Rioja,3,Aguilar del Río Alhama,629,317,312
26,La Rioja,4,Ajamil,82,60,22
26,La Rioja,5,Albelda de Iregua,2794,1435,1359
26,La Rioja,6,Alberite,2369,1206,1163
26,La Rioja,7,Alcanadre,722,378,344
26,La Rioja,8,Aldeanueva de Ebro,2652,1408,1244
26,La Rioja,9,Alesanco,488,261,227
26,La Rioja,10,Alesón,129,70,59
26,La Rioja,11,Alfaro,9550,4888,4662
26,La Rioja,12,Almarza de Cameros,28,18,10
26,La Rioja,13,Anguciana,442,257,185
26,La Rioja,14,Anguiano,546,307,239
26,La Rioja,15,Arenzana de Abajo,251,125,126
26,La Rioja,16,Arenzana de Arriba,39,24,15
26,La Rioja,17,Arnedillo,469,224,245
26,La Rioja,18,Arnedo,14245,7170,7075
26,La Rioja,19,Arrúbal,464,239,225
26,La Rioja,20,Ausejo,772,454,318
26,La Rioja,21,Autol,3946,2055,1891
26,La Rioja,22,Azofra,273,154,119
26,La Rioja,23,Badarán,666,342,324
26,La Rioja,24,Bañares,334,162,172
26,La Rioja,26,Baños de Río Tobía,1737,882,855
26,La Rioja,25,Baños de Rioja,97,57,40
26,La Rioja,27,Berceo,196,121,75
26,La Rioja,28,Bergasa,142,80,62
26,La Rioja,29,Bergasillas Bajera,28,14,14
26,La Rioja,30,Bezares,21,12,9
26,La Rioja,31,Bobadilla,124,69,55
26,La Rioja,32,Brieva de Cameros,59,36,23
26,La Rioja,33,Briñas,251,131,120
26,La Rioja,34,Briones,878,478,400
26,La Rioja,35,Cabezón de Cameros,23,19,4
26,La Rioja,36,Calahorra,23708,11765,11943
26,La Rioja,37,Camprovín,188,107,81
26,La Rioja,38,Canales de la Sierra,86,53,33
26,La Rioja,39,Canillas de Río Tuerto,42,19,23
26,La Rioja,40,Cañas,112,61,51
26,La Rioja,41,Cárdenas,197,93,104
26,La Rioja,42,Casalarreina,1315,732,583
26,La Rioja,43,Castañares de Rioja,384,185,199
26,La Rioja,44,Castroviejo,53,31,22
26,La Rioja,45,Cellorigo,18,9,9
26,La Rioja,46,Cenicero,2084,1091,993
26,La Rioja,47,Cervera del Río Alhama,2984,1549,1435
26,La Rioja,48,Cidamón,33,17,16
26,La Rioja,49,Cihuri,182,98,84
26,La Rioja,50,Cirueña,123,74,49
26,La Rioja,51,Clavijo,269,148,121
26,La Rioja,52,Cordovín,215,117,98
26,La Rioja,53,Corera,267,140,127
26,La Rioja,54,Cornago,510,279,231
26,La Rioja,55,Corporales,46,25,21
26,La Rioja,56,Cuzcurrita de Río Tirón,487,259,228
26,La Rioja,57,Daroca de Rioja,48,26,22
26,La Rioja,58,Enciso,159,96,63
26,La Rioja,59,Entrena,1289,695,594
26,La Rioja,60,Estollo,127,74,53
26,La Rioja,61,Ezcaray,2010,1084,926
26,La Rioja,62,Foncea,108,57,51
26,La Rioja,63,Fonzaleche,161,105,56
26,La Rioja,64,Fuenmayor,2998,1529,1469
26,La Rioja,65,Galbárruli,64,38,26
26,La Rioja,66,Galilea,314,160,154
26,La Rioja,67,Gallinero de Cameros,23,15,8
26,La Rioja,68,Gimileo,149,93,56
26,La Rioja,69,Grañón,360,196,164
26,La Rioja,70,Grávalos,239,125,114
26,La Rioja,71,Haro,10965,5597,5368
26,La Rioja,72,Herce,381,202,179
26,La Rioja,73,Herramélluri,112,60,52
26,La Rioja,74,Hervías,121,63,58
26,La Rioja,75,Hormilla,439,230,209
26,La Rioja,76,Hormilleja,171,92,79
26,La Rioja,77,Hornillos de Cameros,14,5,9
26,La Rioja,78,Hornos de Moncalvillo,80,42,38
26,La Rioja,79,Huércanos,882,471,411
26,La Rioja,80,Igea,689,385,304
26,La Rioja,81,Jalón de Cameros,39,26,13
26,La Rioja,82,Laguna de Cameros,148,91,57
26,La Rioja,83,Lagunilla del Jubera,376,206,170
26,La Rioja,84,Lardero,6832,3488,3344
26,La Rioja,86,Ledesma de la Cogolla,27,17,10
26,La Rioja,87,Leiva,265,132,133
26,La Rioja,88,Leza de Río Leza,40,22,18
26,La Rioja,89,Logroño,147036,71617,75419
26,La Rioja,91,Lumbreras,121,73,48
26,La Rioja,92,Manjarrés,151,86,65
26,La Rioja,93,Mansilla de la Sierra,72,49,23
26,La Rioja,94,Manzanares de Rioja,106,61,45
26,La Rioja,95,Matute,162,76,86
26,La Rioja,96,Medrano,188,95,93
26,La Rioja,98,Munilla,121,59,62
26,La Rioja,99,Murillo de Río Leza,1626,870,756
26,La Rioja,100,Muro de Aguas,65,39,26
26,La Rioja,101,Muro en Cameros,34,20,14
26,La Rioja,102,Nájera,7911,3984,3927
26,La Rioja,103,Nalda,1015,563,452
26,La Rioja,104,Navajún,18,14,4
26,La Rioja,105,Navarrete,2660,1399,1261
26,La Rioja,106,Nestares,69,40,29
26,La Rioja,107,Nieva de Cameros,120,69,51
26,La Rioja,109,Ochánduri,76,43,33
26,La Rioja,108,Ocón,322,196,126
26,La Rioja,110,Ojacastro,214,127,87
26,La Rioja,111,Ollauri,324,177,147
26,La Rioja,112,Ortigosa de Cameros,295,164,131
26,La Rioja,113,Pazuengos,40,27,13
26,La Rioja,114,Pedroso,101,58,43
26,La Rioja,115,Pinillos,19,10,9
26,La Rioja,117,Pradejón,3794,2074,1720
26,La Rioja,118,Pradillo,61,31,30
26,La Rioja,119,Préjano,200,96,104
26,La Rioja,120,Quel,1986,1048,938
26,La Rioja,121,Rabanera,45,33,12
26,La Rioja,122,Rasillo de Cameros (El),112,51,61
26,La Rioja,123,Redal (El),186,101,85
26,La Rioja,124,Ribafrecha,1008,550,458
26,La Rioja,125,Rincón de Soto,3464,1838,1626
26,La Rioja,126,Robres del Castillo,31,18,13
26,La Rioja,127,Rodezno,320,181,139
26,La Rioja,128,Sajazarra,136,69,67
26,La Rioja,129,San Asensio,1322,706,616
26,La Rioja,130,San Millán de la Cogolla,302,189,113
26,La Rioja,131,San Millán de Yécora,64,43,21
26,La Rioja,132,San Román de Cameros,164,91,73
26,La Rioja,139,San Torcuato,104,62,42
26,La Rioja,142,San Vicente de la Sonsierra,1190,656,534
26,La Rioja,134,Santa Coloma,151,91,60
26,La Rioja,135,Santa Engracia del Jubera,195,115,80
26,La Rioja,136,Santa Eulalia Bajera,119,65,54
26,La Rioja,138,Santo Domingo de la Calzada,6385,3326,3059
26,La Rioja,140,Santurde de Rioja,325,173,152
26,La Rioja,141,Santurdejo,175,100,75
26,La Rioja,143,Sojuela,124,69,55
26,La Rioja,144,Sorzano,263,143,120
26,La Rioja,145,Sotés,267,153,114
26,La Rioja,146,Soto en Cameros,178,93,85
26,La Rioja,147,Terroba,30,18,12
26,La Rioja,148,Tirgo,242,136,106
26,La Rioja,149,Tobía,75,41,34
26,La Rioja,150,Tormantos,194,116,78
26,La Rioja,153,Torre en Cameros,18,15,3
26,La Rioja,151,Torrecilla en Cameros,549,291,258
26,La Rioja,152,Torrecilla sobre Alesanco,49,22,27
26,La Rioja,154,Torremontalbo,20,9,11
26,La Rioja,155,Treviana,218,123,95
26,La Rioja,157,Tricio,431,216,215
26,La Rioja,158,Tudelilla,410,226,184
26,La Rioja,160,Uruñuela,849,444,405
26,La Rioja,161,Valdemadera,10,7,3
26,La Rioja,162,Valgañón,149,80,69
26,La Rioja,163,Ventosa,143,81,62
26,La Rioja,164,Ventrosa,69,41,28
26,La Rioja,165,Viguera,405,236,169
26,La Rioja,166,Villalba de Rioja,154,93,61
26,La Rioja,167,Villalobar de Rioja,79,50,29
26,La Rioja,168,Villamediana de Iregua,4668,2433,2235
26,La Rioja,169,Villanueva de Cameros,109,65,44
26,La Rioja,170,Villar de Arnedo (El),625,318,307
26,La Rioja,171,Villar de Torre,272,142,130
26,La Rioja,172,Villarejo,40,28,12
26,La Rioja,173,Villarroya,11,5,6
26,La Rioja,174,Villarta-Quintana,165,84,81
26,La Rioja,175,Villavelayo,69,43,26
26,La Rioja,176,Villaverde de Rioja,71,41,30
26,La Rioja,177,Villoslada de Cameros,376,230,146
26,La Rioja,178,Viniegra de Abajo,98,54,44
26,La Rioja,179,Viniegra de Arriba,46,30,16
26,La Rioja,180,Zarratón,255,147,108
26,La Rioja,181,Zarzosa,12,9,3
26,La Rioja,183,Zorraquín,73,47,26
27,Lugo,1,Abadín,3141,1511,1630
27,Lugo,2,Alfoz,2216,1070,1146
27,Lugo,3,Antas de Ulla,2573,1231,1342
27,Lugo,4,Baleira,1684,879,805
27,Lugo,901,Baralla,3100,1572,1528
27,Lugo,5,Barreiros,3291,1573,1718
27,Lugo,6,Becerreá,3334,1684,1650
27,Lugo,7,Begonte,3587,1800,1787
27,Lugo,8,Bóveda,1767,875,892
27,Lugo,902,Burela,8755,4370,4385
27,Lugo,9,Carballedo,2929,1453,1476
27,Lugo,10,Castro de Rei,5785,2879,2906
27,Lugo,11,Castroverde,3187,1624,1563
27,Lugo,12,Cervantes,1914,1067,847
27,Lugo,13,Cervo,4847,2398,2449
27,Lugo,16,Chantada,9249,4498,4751
27,Lugo,14,Corgo (O),4192,2093,2099
27,Lugo,15,Cospeito,5409,2629,2780
27,Lugo,17,Folgoso do Courel,1310,671,639
27,Lugo,18,Fonsagrada (A),4856,2552,2304
27,Lugo,19,Foz,9754,4755,4999
27,Lugo,20,Friol,4490,2218,2272
27,Lugo,22,Guitiriz,5972,2921,3051
27,Lugo,23,Guntín,3248,1640,1608
27,Lugo,24,Incio (O),2236,1067,1169
27,Lugo,26,Láncara,3047,1546,1501
27,Lugo,27,Lourenzá,2629,1294,1335
27,Lugo,28,Lugo,93450,43682,49768
27,Lugo,29,Meira,1774,872,902
27,Lugo,30,Mondoñedo,4770,2210,2560
27,Lugo,31,Monforte de Lemos,19412,9217,10195
27,Lugo,32,Monterroso,4140,2069,2071
27,Lugo,33,Muras,926,466,460
27,Lugo,34,Navia de Suarna,1615,867,748
27,Lugo,35,Negueira de Muñiz,213,111,102
27,Lugo,37,Nogais (As),1441,746,695
27,Lugo,38,Ourol,1301,635,666
27,Lugo,39,Outeiro de Rei,4695,2408,2287
27,Lugo,40,Palas de Rei,3759,1842,1917
27,Lugo,41,Pantón,3147,1492,1655
27,Lugo,42,Paradela,2307,1163,1144
27,Lugo,43,Páramo (O),1823,921,902
27,Lugo,44,Pastoriza (A),3726,1856,1870
27,Lugo,45,Pedrafita do Cebreiro,1414,755,659
27,Lugo,47,Pobra do Brollón (A),2291,1114,1177
27,Lugo,46,Pol,1945,955,990
27,Lugo,48,Pontenova (A),3016,1484,1532
27,Lugo,49,Portomarín,1910,953,957
27,Lugo,50,Quiroga,4035,1936,2099
27,Lugo,56,Rábade,1668,840,828
27,Lugo,51,Ribadeo,9619,4520,5099
27,Lugo,52,Ribas de Sil,1245,604,641
27,Lugo,53,Ribeira de Piquín,771,387,384
27,Lugo,54,Riotorto,1634,804,830
27,Lugo,55,Samos,1820,942,878
27,Lugo,57,Sarria,13352,6532,6820
27,Lugo,58,Saviñao (O),4758,2337,2421
27,Lugo,59,Sober,2895,1368,1527
27,Lugo,60,Taboada,3614,1719,1895
27,Lugo,61,Trabada,1479,720,759
27,Lugo,62,Triacastela,821,409,412
27,Lugo,63,Valadouro (O),2233,1099,1134
27,Lugo,64,Vicedo (O),2090,1012,1078
27,Lugo,65,Vilalba,15455,7577,7878
27,Lugo,66,Viveiro,15576,7518,8058
27,Lugo,21,Xermade,2339,1151,1188
27,Lugo,25,Xove,3614,1804,1810
28,Madrid,1,Acebeda (La),59,31,28
28,Madrid,2,Ajalvir,3231,1681,1550
28,Madrid,3,Alameda del Valle,236,141,95
28,Madrid,4,Álamo (El),6937,3714,3223
28,Madrid,5,Alcalá de Henares,201380,101351,100029
28,Madrid,6,Alcobendas,104118,50765,53353
28,Madrid,7,Alcorcón,164633,81380,83253
28,Madrid,8,Aldea del Fresno,2124,1132,992
28,Madrid,9,Algete,18176,9076,9100
28,Madrid,10,Alpedrete,11588,5810,5778
28,Madrid,11,Ambite,394,213,181
28,Madrid,12,Anchuelo,856,445,411
28,Madrid,13,Aranjuez,46283,22583,23700
28,Madrid,14,Arganda del Rey,45085,23262,21823
28,Madrid,15,Arroyomolinos,9020,4652,4368
28,Madrid,16,Atazar (El),116,62,54
28,Madrid,17,Batres,1417,735,682
28,Madrid,18,Becerril de la Sierra,4762,2428,2334
28,Madrid,19,Belmonte de Tajo,1266,640,626
28,Madrid,21,Berrueco (El),543,284,259
28,Madrid,20,Berzosa del Lozoya,179,93,86
28,Madrid,22,Boadilla del Monte,37926,18802,19124
28,Madrid,23,Boalo (El),5577,2934,2643
28,Madrid,24,Braojos,176,97,79
28,Madrid,25,Brea de Tajo,516,266,250
28,Madrid,26,Brunete,8645,4333,4312
28,Madrid,27,Buitrago del Lozoya,1937,967,970
28,Madrid,28,Bustarviejo,1936,980,956
28,Madrid,29,Cabanillas de la Sierra,648,345,303
28,Madrid,30,Cabrera (La),2247,1146,1101
28,Madrid,31,Cadalso de los Vidrios,2741,1442,1299
28,Madrid,32,Camarma de Esteruelas,5317,2717,2600
28,Madrid,33,Campo Real,4124,2088,2036
28,Madrid,34,Canencia,403,219,184
28,Madrid,35,Carabaña,1526,777,749
28,Madrid,36,Casarrubuelos,2576,1312,1264
28,Madrid,37,Cenicientos,1965,973,992
28,Madrid,38,Cercedilla,6802,3400,3402
28,Madrid,39,Cervera de Buitrago,150,85,65
28,Madrid,51,Chapinería,1788,928,860
28,Madrid,52,Chinchón,4943,2499,2444
28,Madrid,40,Ciempozuelos,18764,9589,9175
28,Madrid,41,Cobeña,4293,2127,2166
28,Madrid,46,Collado Mediano,6159,3125,3034
28,Madrid,47,Collado Villalba,52083,25867,26216
28,Madrid,43,Colmenar de Oreja,7247,3643,3604
28,Madrid,42,Colmenar del Arroyo,1227,611,616
28,Madrid,45,Colmenar Viejo,40878,20503,20375
28,Madrid,44,Colmenarejo,7308,3657,3651
28,Madrid,48,Corpa,502,263,239
28,Madrid,49,Coslada,83233,41449,41784
28,Madrid,50,Cubas de la Sagra,3164,1596,1568
28,Madrid,53,Daganzo de Arriba,7340,3735,3605
28,Madrid,54,Escorial (El),14113,6926,7187
28,Madrid,55,Estremera,1297,685,612
28,Madrid,56,Fresnedillas de la Oliva,1194,611,583
28,Madrid,57,Fresno de Torote,1611,868,743
28,Madrid,58,Fuenlabrada,193715,98089,95626
28,Madrid,59,Fuente el Saz de Jarama,5789,2988,2801
28,Madrid,60,Fuentidueña de Tajo,1799,909,890
28,Madrid,61,Galapagar,28924,14505,14419
28,Madrid,62,Garganta de los Montes,395,213,182
28,Madrid,63,Gargantilla del Lozoya y Pinilla de Buitrago,367,211,156
28,Madrid,64,Gascones,147,81,66
28,Madrid,65,Getafe,156320,77584,78736
28,Madrid,66,Griñón,8236,4213,4023
28,Madrid,67,Guadalix de la Sierra,5099,2629,2470
28,Madrid,68,Guadarrama,13025,6527,6498
28,Madrid,69,Hiruela (La),76,42,34
28,Madrid,70,Horcajo de la Sierra,167,90,77
28,Madrid,71,Horcajuelo de la Sierra,107,47,60
28,Madrid,72,Hoyo de Manzanares,7210,3608,3602
28,Madrid,73,Humanes de Madrid,15589,8070,7519
28,Madrid,74,Leganés,182471,90850,91621
28,Madrid,75,Loeches,5450,2732,2718
28,Madrid,76,Lozoya,620,331,289
28,Madrid,901,Lozoyuela-Navas-Sieteiglesias,979,506,473
28,Madrid,78,Madarcos,41,26,15
28,Madrid,79,Madrid,3128600,1469284,1659316
28,Madrid,80,Majadahonda,62270,29694,32576
28,Madrid,82,Manzanares el Real,6376,3304,3072
28,Madrid,83,Meco,11094,5732,5362
28,Madrid,84,Mejorada del Campo,21052,10618,10434
28,Madrid,85,Miraflores de la Sierra,5344,2680,2664
28,Madrid,86,Molar (El),5373,2812,2561
28,Madrid,87,Molinos (Los),4322,2250,2072
28,Madrid,88,Montejo de la Sierra,330,167,163
28,Madrid,89,Moraleja de Enmedio,4390,2202,2188
28,Madrid,90,Moralzarzal,10604,5404,5200
28,Madrid,91,Morata de Tajuña,6548,3305,3243
28,Madrid,92,Móstoles,206301,102998,103303
28,Madrid,93,Navacerrada,2484,1225,1259
28,Madrid,94,Navalafuente,828,451,377
28,Madrid,95,Navalagamella,2020,1085,935
28,Madrid,96,Navalcarnero,17567,8893,8674
28,Madrid,97,Navarredonda y San Mamés,144,79,65
28,Madrid,99,Navas del Rey,2430,1304,1126
28,Madrid,100,Nuevo Baztán,5683,2900,2783
28,Madrid,101,Olmeda de las Fuentes,212,118,94
28,Madrid,102,Orusco de Tajuña,1017,511,506
28,Madrid,104,Paracuellos de Jarama,7586,3923,3663
28,Madrid,106,Parla,95087,48751,46336
28,Madrid,107,Patones,441,228,213
28,Madrid,108,Pedrezuela,2881,1501,1380
28,Madrid,109,Pelayos de la Presa,2209,1149,1060
28,Madrid,110,Perales de Tajuña,2469,1241,1228
28,Madrid,111,Pezuela de las Torres,652,338,314
28,Madrid,112,Pinilla del Valle,204,109,95
28,Madrid,113,Pinto,39432,19895,19537
28,Madrid,114,Piñuécar-Gandullas,184,92,92
28,Madrid,115,Pozuelo de Alarcón,79581,38291,41290
28,Madrid,116,Pozuelo del Rey,331,175,156
28,Madrid,117,Prádena del Rincón,107,62,45
28,Madrid,118,Puebla de la Sierra,103,58,45
28,Madrid,902,Puentes Viejas,456,266,190
28,Madrid,119,Quijorna,2177,1141,1036
28,Madrid,120,Rascafría,1892,1017,875
28,Madrid,121,Redueña,229,125,104
28,Madrid,122,Ribatejada,504,274,230
28,Madrid,123,Rivas-Vaciamadrid,53459,26929,26530
28,Madrid,124,Robledillo de la Jara,122,63,59
28,Madrid,125,Robledo de Chavela,3319,1668,1651
28,Madrid,126,Robregordo,66,35,31
28,Madrid,127,Rozas de Madrid (Las),75719,36904,38815
28,Madrid,128,Rozas de Puerto Real,368,212,156
28,Madrid,129,San Agustín del Guadalix,8832,4445,4387
28,Madrid,130,San Fernando de Henares,40048,20120,19928
28,Madrid,131,San Lorenzo de El Escorial,16005,7758,8247
28,Madrid,132,San Martín de la Vega,15677,8237,7440
28,Madrid,133,San Martín de Valdeiglesias,7403,3725,3678
28,Madrid,134,San Sebastián de los Reyes,67351,33245,34106
28,Madrid,135,Santa María de la Alameda,1039,557,482
28,Madrid,136,Santorcaz,746,394,352
28,Madrid,137,Santos de la Humosa (Los),1444,725,719
28,Madrid,138,Serna del Monte (La),108,57,51
28,Madrid,140,Serranillos del Valle,3006,1507,1499
28,Madrid,141,Sevilla la Nueva,6731,3449,3282
28,Madrid,143,Somosierra,116,62,54
28,Madrid,144,Soto del Real,7865,3897,3968
28,Madrid,145,Talamanca de Jarama,2097,1074,1023
28,Madrid,146,Tielmes,2468,1278,1190
28,Madrid,147,Titulcia,914,467,447
28,Madrid,148,Torrejón de Ardoz,112114,55605,56509
28,Madrid,149,Torrejón de la Calzada,5866,2931,2935
28,Madrid,150,Torrejón de Velasco,3532,1823,1709
28,Madrid,151,Torrelaguna,4060,2067,1993
28,Madrid,152,Torrelodones,19843,9647,10196
28,Madrid,153,Torremocha de Jarama,609,315,294
28,Madrid,154,Torres de la Alameda,6359,3246,3113
28,Madrid,903,Tres Cantos,39826,19531,20295
28,Madrid,155,Valdaracete,604,299,305
28,Madrid,156,Valdeavero,900,477,423
28,Madrid,157,Valdelaguna,741,398,343
28,Madrid,158,Valdemanco,823,442,381
28,Madrid,159,Valdemaqueda,827,427,400
28,Madrid,160,Valdemorillo,9824,5095,4729
28,Madrid,161,Valdemoro,48517,24346,24171
28,Madrid,162,Valdeolmos-Alalpardo,2389,1227,1162
28,Madrid,163,Valdepiélagos,412,216,196
28,Madrid,164,Valdetorres de Jarama,3280,1710,1570
28,Madrid,165,Valdilecha,2326,1191,1135
28,Madrid,166,Valverde de Alcalá,388,211,177
28,Madrid,167,Velilla de San Antonio,9406,4816,4590
28,Madrid,168,Vellón (El),1304,679,625
28,Madrid,169,Venturada,1451,759,692
28,Madrid,171,Villa del Prado,5788,3045,2743
28,Madrid,170,Villaconejos,3070,1576,1494
28,Madrid,172,Villalbilla,7761,3934,3827
28,Madrid,173,Villamanrique de Tajo,701,360,341
28,Madrid,174,Villamanta,2107,1080,1027
28,Madrid,175,Villamantilla,570,292,278
28,Madrid,176,Villanueva de la Cañada,14809,7200,7609
28,Madrid,178,Villanueva de Perales,1033,559,474
28,Madrid,177,Villanueva del Pardillo,12879,6396,6483
28,Madrid,179,Villar del Olmo,1947,1022,925
28,Madrid,180,Villarejo de Salvanés,6713,3392,3321
28,Madrid,181,Villaviciosa de Odón,26076,12731,13345
28,Madrid,182,Villavieja del Lozoya,214,112,102
28,Madrid,183,Zarzalejo,1412,743,669
29,Málaga,1,Alameda,5314,2645,2669
29,Málaga,2,Alcaucín,2086,1061,1025
29,Málaga,3,Alfarnate,1386,714,672
29,Málaga,4,Alfarnatejo,448,232,216
29,Málaga,5,Algarrobo,5668,2859,2809
29,Málaga,6,Algatocín,942,485,457
29,Málaga,7,Alhaurín de la Torre,30281,15165,15116
29,Málaga,8,Alhaurín el Grande,21070,10620,10450
29,Málaga,9,Almáchar,1906,981,925
29,Málaga,10,Almargen,2118,1051,1067
29,Málaga,11,Almogía,4309,2204,2105
29,Málaga,12,Álora,13204,6627,6577
29,Málaga,13,Alozaina,2223,1153,1070
29,Málaga,14,Alpandeire,285,136,149
29,Málaga,15,Antequera,44032,21689,22343
29,Málaga,16,Árchez,427,218,209
29,Málaga,17,Archidona,8672,4290,4382
29,Málaga,18,Ardales,2558,1274,1284
29,Málaga,19,Arenas,1339,737,602
29,Málaga,20,Arriate,3906,1924,1982
29,Málaga,21,Atajate,142,77,65
29,Málaga,22,Benadalid,258,134,124
29,Málaga,23,Benahavís,2860,1460,1400
29,Málaga,24,Benalauría,468,243,225
29,Málaga,25,Benalmádena,50298,24940,25358
29,Málaga,26,Benamargosa,1608,821,787
29,Málaga,27,Benamocarra,2952,1509,1443
29,Málaga,28,Benaoján,1612,808,804
29,Málaga,29,Benarrabá,538,287,251
29,Málaga,30,Borge (El),1035,539,496
29,Málaga,31,Burgo (El),2049,1032,1017
29,Málaga,32,Campillos,8183,4089,4094
29,Málaga,33,Canillas de Aceituno,2324,1177,1147
29,Málaga,34,Canillas de Albaida,813,422,391
29,Málaga,35,Cañete la Real,2051,1058,993
29,Málaga,36,Carratraca,887,440,447
29,Málaga,37,Cartajima,251,127,124
29,Málaga,38,Cártama,17690,9024,8666
29,Málaga,39,Casabermeja,3364,1750,1614
29,Málaga,40,Casarabonela,2666,1378,1288
29,Málaga,41,Casares,4283,2248,2035
29,Málaga,42,Coín,20551,10671,9880
29,Málaga,43,Colmenar,3384,1687,1697
29,Málaga,44,Comares,1522,810,712
29,Málaga,45,Cómpeta,3582,1874,1708
29,Málaga,46,Cortes de la Frontera,3758,1906,1852
29,Málaga,47,Cuevas Bajas,1430,718,712
29,Málaga,49,Cuevas de San Marcos,4007,1987,2020
29,Málaga,48,Cuevas del Becerro,1847,917,930
29,Málaga,50,Cútar,642,318,324
29,Málaga,51,Estepona,58603,29628,28975
29,Málaga,52,Faraján,289,137,152
29,Málaga,53,Frigiliana,2691,1338,1353
29,Málaga,54,Fuengirola,63899,31774,32125
29,Málaga,55,Fuente de Piedra,2209,1104,1105
29,Málaga,56,Gaucín,1878,980,898
29,Málaga,57,Genalguacil,502,258,244
29,Málaga,58,Guaro,2228,1112,1116
29,Málaga,59,Humilladero,3016,1512,1504
29,Málaga,60,Igualeja,948,472,476
29,Málaga,61,Istán,1432,724,708
29,Málaga,62,Iznate,859,445,414
29,Málaga,63,Jimera de Líbar,421,210,211
29,Málaga,64,Jubrique,765,383,382
29,Málaga,65,Júzcar,193,108,85
29,Málaga,66,Macharaviaya,385,197,188
29,Málaga,67,Málaga,560631,270672,289959
29,Málaga,68,Manilva,11181,5981,5200
29,Málaga,69,Marbella,125519,61899,63620
29,Málaga,70,Mijas,61147,30779,30368
29,Málaga,71,Moclinejo,1198,611,587
29,Málaga,72,Mollina,4370,2171,2199
29,Málaga,73,Monda,2094,1086,1008
29,Málaga,74,Montejaque,1013,506,507
29,Málaga,75,Nerja,20361,10071,10290
29,Málaga,76,Ojén,2491,1276,1215
29,Málaga,77,Parauta,226,115,111
29,Málaga,79,Periana,3524,1821,1703
29,Málaga,80,Pizarra,7812,3911,3901
29,Málaga,81,Pujerra,316,170,146
29,Málaga,82,Rincón de la Victoria,33817,16841,16976
29,Málaga,83,Riogordo,3032,1576,1456
29,Málaga,84,Ronda,35836,17868,17968
29,Málaga,85,Salares,191,100,91
29,Málaga,86,Sayalonga,1460,748,712
29,Málaga,87,Sedella,646,352,294
29,Málaga,88,Sierra de Yeguas,3418,1723,1695
29,Málaga,89,Teba,4278,2172,2106
29,Málaga,90,Tolox,2336,1183,1153
29,Málaga,901,Torremolinos,58683,29816,28867
29,Málaga,91,Torrox,14925,7482,7443
29,Málaga,92,Totalán,707,374,333
29,Málaga,93,Valle de Abdalajís,2955,1428,1527
29,Málaga,94,Vélez-Málaga,67697,33807,33890
29,Málaga,95,Villanueva de Algaidas,4493,2300,2193
29,Málaga,98,Villanueva de Tapia,1673,845,828
29,Málaga,96,Villanueva del Rosario,3470,1721,1749
29,Málaga,97,Villanueva del Trabuco,5219,2637,2582
29,Málaga,99,Viñuela,1737,866,871
29,Málaga,100,Yunquera,3284,1702,1582
30,Murcia,1,Abanilla,6333,3212,3121
30,Murcia,2,Abarán,12919,6535,6384
30,Murcia,3,Águilas,32450,16324,16126
30,Murcia,4,Albudeite,1402,713,689
30,Murcia,5,Alcantarilla,38584,19312,19272
30,Murcia,902,Alcázares (Los),13355,7060,6295
30,Murcia,6,Aledo,1045,535,510
30,Murcia,7,Alguazas,8177,4229,3948
30,Murcia,8,Alhama de Murcia,18779,9687,9092
30,Murcia,9,Archena,16707,8532,8175
30,Murcia,10,Beniel,10085,5350,4735
30,Murcia,11,Blanca,6103,3086,3017
30,Murcia,12,Bullas,11852,6021,5831
30,Murcia,13,Calasparra,9969,5066,4903
30,Murcia,14,Campos del Río,2132,1046,1086
30,Murcia,15,Caravaca de la Cruz,25257,12707,12550
30,Murcia,16,Cartagena,208609,106497,102112
30,Murcia,17,Cehegín,15553,7817,7736
30,Murcia,18,Ceutí,8910,4583,4327
30,Murcia,19,Cieza,34735,17478,17257
30,Murcia,20,Fortuna,8665,4580,4085
30,Murcia,21,Fuente Álamo de Murcia,14261,7642,6619
30,Murcia,22,Jumilla,24124,12421,11703
30,Murcia,23,Librilla,4243,2139,2104
30,Murcia,24,Lorca,89936,47370,42566
30,Murcia,25,Lorquí,6493,3369,3124
30,Murcia,26,Mazarrón,30841,16459,14382
30,Murcia,27,Molina de Segura,57431,29012,28419
30,Murcia,28,Moratalla,8414,4286,4128
30,Murcia,29,Mula,16283,8397,7886
30,Murcia,30,Murcia,416996,207800,209196
30,Murcia,31,Ojós,559,287,272
30,Murcia,32,Pliego,3713,1939,1774
30,Murcia,33,Puerto Lumbreras,12881,6423,6458
30,Murcia,34,Ricote,1527,762,765
30,Murcia,35,San Javier,27622,14280,13342
30,Murcia,36,San Pedro del Pinatar,21234,10834,10400
30,Murcia,901,Santomera,13919,7094,6825
30,Murcia,37,Torre-Pacheco,28152,15059,13093
30,Murcia,38,Torres de Cotillas (Las),18842,9645,9197
30,Murcia,39,Totana,28360,14716,13644
30,Murcia,40,Ulea,955,494,461
30,Murcia,41,Unión (La),16082,8089,7993
30,Murcia,42,Villanueva del Río Segura,1853,902,951
30,Murcia,43,Yecla,33964,17238,16726
31,Navarra,1,Abáigar,104,57,47
31,Navarra,2,Abárzuza,563,282,281
31,Navarra,3,Abaurregaina/Abaurrea Alta,147,92,55
31,Navarra,4,Abaurrepea/Abaurrea Baja,40,28,12
31,Navarra,5,Aberin,331,176,155
31,Navarra,6,Ablitas,2440,1248,1192
31,Navarra,7,Adiós,171,94,77
31,Navarra,8,Aguilar de Codés,106,53,53
31,Navarra,9,Aibar/Oibar,925,496,429
31,Navarra,11,Allín,805,425,380
31,Navarra,12,Allo,1068,533,535
31,Navarra,10,Altsasu/Alsasua,7501,3853,3648
31,Navarra,13,Améscoa Baja,826,439,387
31,Navarra,14,Ancín,373,210,163
31,Navarra,15,Andosilla,2771,1432,1339
31,Navarra,16,Ansoáin,9952,5019,4933
31,Navarra,17,Anue,388,226,162
31,Navarra,18,Añorbe,531,286,245
31,Navarra,19,Aoiz/Agoitz,2175,1081,1094
31,Navarra,20,Araitz,588,350,238
31,Navarra,25,Arakil,882,483,399
31,Navarra,21,Aranarache,79,44,35
31,Navarra,23,Aranguren,6133,3128,3005
31,Navarra,24,Arano,141,74,67
31,Navarra,22,Arantza,657,367,290
31,Navarra,26,Aras,202,109,93
31,Navarra,27,Arbizu,1006,529,477
31,Navarra,28,Arce/Artzi,272,161,111
31,Navarra,29,Arcos (Los),1272,633,639
31,Navarra,30,Arellano,188,106,82
31,Navarra,31,Areso,293,157,136
31,Navarra,32,Arguedas,2362,1208,1154
31,Navarra,33,Aria,63,37,26
31,Navarra,34,Aribe,62,31,31
31,Navarra,35,Armañanzas,74,38,36
31,Navarra,36,Arróniz,1147,609,538
31,Navarra,37,Arruazu,107,58,49
31,Navarra,38,Artajona,1715,886,829
31,Navarra,39,Artazu,106,55,51
31,Navarra,40,Atez,246,146,100
31,Navarra,58,Auritz/Burguete,306,145,161
31,Navarra,41,Ayegui,1469,781,688
31,Navarra,42,Azagra,3793,1943,1850
31,Navarra,43,Azuelo,42,21,21
31,Navarra,44,Bakaiku,337,184,153
31,Navarra,901,Barañain,22401,11073,11328
31,Navarra,45,Barásoain,554,288,266
31,Navarra,46,Barbarin,85,42,43
31,Navarra,47,Bargota,359,178,181
31,Navarra,48,Barillas,194,101,93
31,Navarra,49,Basaburua,799,460,339
31,Navarra,50,Baztan,7827,4005,3822
31,Navarra,137,Beintza-Labaien,258,154,104
31,Navarra,51,Beire,306,144,162
31,Navarra,52,Belascoáin,115,57,58
31,Navarra,250,Bera/Vera de Bidasoa,3727,1863,1864
31,Navarra,53,Berbinzana,717,372,345
31,Navarra,905,Beriáin,3125,1556,1569
31,Navarra,902,Berrioplano,2347,1210,1137
31,Navarra,903,Berriozar,8555,4396,4159
31,Navarra,54,Bertizarana,676,344,332
31,Navarra,55,Betelu,346,189,157
31,Navarra,253,Bidaurreta,125,76,49
31,Navarra,56,Biurrun-Olcoz,200,117,83
31,Navarra,57,Buñuel,2410,1215,1195
31,Navarra,59,Burgui/Burgi,229,131,98
31,Navarra,60,Burlada/Burlata,18388,9050,9338
31,Navarra,61,Busto (El),83,45,38
31,Navarra,62,Cabanillas,1488,763,725
31,Navarra,63,Cabredo,97,51,46
31,Navarra,64,Cadreita,2098,1099,999
31,Navarra,65,Caparroso,2602,1297,1305
31,Navarra,66,Cárcar,1230,623,607
31,Navarra,67,Carcastillo,2602,1360,1242
31,Navarra,68,Cascante,3957,1989,1968
31,Navarra,69,Cáseda,1054,526,528
31,Navarra,70,Castejón,3887,2018,1869
31,Navarra,71,Castillonuevo,18,13,5
31,Navarra,72,Cintruénigo,6783,3450,3333
31,Navarra,74,Cirauqui,480,276,204
31,Navarra,75,Ciriza,101,59,42
31,Navarra,76,Cizur,2238,1122,1116
31,Navarra,77,Corella,7713,3966,3747
31,Navarra,78,Cortes,3362,1760,1602
31,Navarra,79,Desojo,114,61,53
31,Navarra,80,Dicastillo,683,358,325
31,Navarra,81,Donamaria,414,207,207
31,Navarra,221,Doneztebe/Santesteban,1494,756,738
31,Navarra,83,Echarri,67,38,29
31,Navarra,86,Egüés,5379,2718,2661
31,Navarra,87,Elgorriaga,226,119,107
31,Navarra,89,Enériz,252,131,121
31,Navarra,90,Eratsun,172,111,61
31,Navarra,91,Ergoiena,437,236,201
31,Navarra,92,Erro,745,424,321
31,Navarra,94,Eslava,154,81,73
31,Navarra,95,Esparza de Salazar,98,50,48
31,Navarra,96,Espronceda,151,87,64
31,Navarra,97,Estella/Lizarra,13892,6778,7114
31,Navarra,98,Esteribar,1652,884,768
31,Navarra,99,Etayo,86,43,43
31,Navarra,82,Etxalar,799,418,381
31,Navarra,84,Etxarri-Aranatz,2434,1250,1184
31,Navarra,85,Etxauri,493,256,237
31,Navarra,100,Eulate,346,176,170
31,Navarra,101,Ezcabarte,1540,850,690
31,Navarra,93,Ezcároz/Ezkaroze,352,181,171
31,Navarra,102,Ezkurra,193,123,70
31,Navarra,103,Ezprogui,60,32,28
31,Navarra,104,Falces,2597,1318,1279
31,Navarra,105,Fitero,2257,1161,1096
31,Navarra,106,Fontellas,856,445,411
31,Navarra,107,Funes,2396,1278,1118
31,Navarra,108,Fustiñana,2546,1298,1248
31,Navarra,109,Galar,1456,761,695
31,Navarra,110,Gallipienzo,147,73,74
31,Navarra,111,Gallués/Galoze,109,68,41
31,Navarra,112,Garaioa,124,70,54
31,Navarra,113,Garde,182,109,73
31,Navarra,114,Garínoain,480,263,217
31,Navarra,115,Garralda,195,97,98
31,Navarra,116,Genevilla,106,63,43
31,Navarra,117,Goizueta,809,442,367
31,Navarra,118,Goñi,192,118,74
31,Navarra,119,Güesa/Gorza,64,36,28
31,Navarra,120,Guesálaz,472,284,188
31,Navarra,121,Guirguillano,96,52,44
31,Navarra,256,Hiriberri/Villanueva de Aezkoa,137,81,56
31,Navarra,122,Huarte/Uharte,4671,2366,2305
31,Navarra,124,Ibargoiti,235,138,97
31,Navarra,259,Igantzi,607,318,289
31,Navarra,125,Igúzquiza,348,174,174
31,Navarra,126,Imotz,427,234,193
31,Navarra,127,Irañeta,157,88,69
31,Navarra,904,Irurtzun,2192,1141,1051
31,Navarra,128,Isaba/Izaba,487,240,247
31,Navarra,129,Ituren,481,244,237
31,Navarra,130,Iturmendi,379,195,184
31,Navarra,131,Iza,843,450,393
31,Navarra,132,Izagaondoa,167,106,61
31,Navarra,133,Izalzu/Itzaltzu,47,28,19
31,Navarra,134,Jaurrieta,222,115,107
31,Navarra,135,Javier,100,41,59
31,Navarra,136,Juslapeña,524,286,238
31,Navarra,138,Lakuntza,1103,568,535
31,Navarra,139,Lana,206,120,86
31,Navarra,140,Lantz,115,75,40
31,Navarra,141,Lapoblación,160,94,66
31,Navarra,142,Larraga,2021,1119,902
31,Navarra,143,Larraona,136,68,68
31,Navarra,144,Larraun,1071,601,470
31,Navarra,145,Lazagurría,205,105,100
31,Navarra,146,Leache,46,27,19
31,Navarra,147,Legarda,105,59,46
31,Navarra,148,Legaria,117,58,59
31,Navarra,149,Leitza,2895,1543,1352
31,Navarra,908,Lekunberri,1085,546,539
31,Navarra,150,Leoz,278,176,102
31,Navarra,151,Lerga,71,40,31
31,Navarra,152,Lerín,1848,948,900
31,Navarra,153,Lesaka,2736,1413,1323
31,Navarra,154,Lezáun,262,154,108
31,Navarra,155,Liédena,318,152,166
31,Navarra,156,Lizoáin,283,171,112
31,Navarra,157,Lodosa,4746,2421,2325
31,Navarra,158,Lónguida/Longida,312,170,142
31,Navarra,159,Lumbier,1383,738,645
31,Navarra,160,Luquin,132,69,63
31,Navarra,248,Luzaide/Valcarlos,423,208,215
31,Navarra,161,Mañeru,359,187,172
31,Navarra,162,Marañón,61,32,29
31,Navarra,163,Marcilla,2660,1361,1299
31,Navarra,164,Mélida,766,381,385
31,Navarra,165,Mendavia,3773,1929,1844
31,Navarra,166,Mendaza,333,157,176
31,Navarra,167,Mendigorría,1061,553,508
31,Navarra,168,Metauten,292,167,125
31,Navarra,169,Milagro,3054,1571,1483
31,Navarra,170,Mirafuentes,48,25,23
31,Navarra,171,Miranda de Arga,979,499,480
31,Navarra,172,Monreal,413,215,198
31,Navarra,173,Monteagudo,1146,580,566
31,Navarra,174,Morentin,167,89,78
31,Navarra,175,Mues,99,57,42
31,Navarra,176,Murchante,3363,1664,1699
31,Navarra,177,Murieta,317,171,146
31,Navarra,178,Murillo el Cuende,657,347,310
31,Navarra,179,Murillo el Fruto,755,391,364
31,Navarra,180,Muruzábal,304,144,160
31,Navarra,181,Navascués,202,121,81
31,Navarra,182,Nazar,55,35,20
31,Navarra,88,Noáin (Valle de Elorz)/Noain (Elortzibar),4789,2407,2382
31,Navarra,183,Obanos,889,434,455
31,Navarra,185,Ochagavía,648,331,317
31,Navarra,184,Oco,78,44,34
31,Navarra,186,Odieta,341,186,155
31,Navarra,187,Oitz,150,90,60
31,Navarra,188,Olaibar,203,105,98
31,Navarra,189,Olazti/Olazagutía,1762,921,841
31,Navarra,190,Olejua,55,27,28
31,Navarra,191,Olite,3494,1776,1718
31,Navarra,194,Ollo,309,178,131
31,Navarra,192,Olóriz,194,113,81
31,Navarra,193,Olza,1535,777,758
31,Navarra,195,Orbaitzeta,208,109,99
31,Navarra,196,Orbara,54,26,28
31,Navarra,197,Orísoain,84,46,38
31,Navarra,906,Orkoien,2251,1176,1075
31,Navarra,198,Oronz,56,31,25
31,Navarra,199,Oroz-Betelu,205,108,97
31,Navarra,211,Orreaga/Roncesvalles,25,11,14
31,Navarra,200,Oteiza,946,511,435
31,Navarra,201,Pamplona/Iruña,195769,93775,101994
31,Navarra,202,Peralta,5833,2954,2879
31,Navarra,203,Petilla de Aragón,33,20,13
31,Navarra,204,Piedramillera,62,42,20
31,Navarra,205,Pitillas,588,288,300
31,Navarra,206,Puente la Reina/Gares,2630,1328,1302
31,Navarra,207,Pueyo,323,179,144
31,Navarra,208,Ribaforada,3478,1785,1693
31,Navarra,209,Romanzado,154,87,67
31,Navarra,210,Roncal/Erronkari,296,159,137
31,Navarra,212,Sada,211,113,98
31,Navarra,213,Saldías,120,73,47
31,Navarra,214,Salinas de Oro,115,63,52
31,Navarra,215,San Adrián,5958,2961,2997
31,Navarra,217,San Martín de Unx,447,237,210
31,Navarra,216,Sangüesa/Zangoza,5093,2618,2475
31,Navarra,219,Sansol,123,63,60
31,Navarra,220,Santacara,1005,504,501
31,Navarra,222,Sarriés/Sartze,78,49,29
31,Navarra,223,Sartaguda,1395,713,682
31,Navarra,224,Sesma,1340,677,663
31,Navarra,225,Sorlada,39,19,20
31,Navarra,226,Sunbilla,662,341,321
31,Navarra,227,Tafalla,11040,5463,5577
31,Navarra,228,Tiebas-Muruarte de Reta,559,301,258
31,Navarra,229,Tirapu,61,38,23
31,Navarra,230,Torralba del Río,134,68,66
31,Navarra,231,Torres del Río,165,80,85
31,Navarra,232,Tudela,32802,16472,16330
31,Navarra,233,Tulebras,107,38,69
31,Navarra,234,Ucar,153,89,64
31,Navarra,123,Uharte-Arakil,775,419,356
31,Navarra,235,Ujué,225,120,105
31,Navarra,236,Ultzama,1624,793,831
31,Navarra,237,Unciti,218,132,86
31,Navarra,238,Unzué,137,81,56
31,Navarra,239,Urdazubi/Urdax,359,176,183
31,Navarra,240,Urdiain,605,316,289
31,Navarra,241,Urraul Alto,164,97,67
31,Navarra,242,Urraul Bajo,283,128,155
31,Navarra,244,Urrotz,182,112,70
31,Navarra,243,Urroz-Villa,378,202,176
31,Navarra,245,Urzainqui,104,58,46
31,Navarra,246,Uterga,166,84,82
31,Navarra,247,Uztárroz/Uztarroze,214,101,113
31,Navarra,249,Valtierra,2516,1243,1273
31,Navarra,251,Viana,3661,1879,1782
31,Navarra,252,Vidángoz/Bidankoze,111,60,51
31,Navarra,254,Villafranca,2881,1458,1423
31,Navarra,255,Villamayor de Monjardín,140,71,69
31,Navarra,257,Villatuerta,983,496,487
31,Navarra,258,Villava/Atarrabia,10295,5100,5195
31,Navarra,260,Yerri,1561,818,743
31,Navarra,261,Yesa,249,135,114
31,Navarra,262,Zabalza,188,96,92
31,Navarra,73,Ziordia,351,166,185
31,Navarra,907,Zizur Mayor/Zizur Nagusia,13197,6560,6637
31,Navarra,263,Zubieta,297,166,131
31,Navarra,264,Zugarramurdi,223,116,107
31,Navarra,265,Zúñiga,181,111,70
32,Ourense,1,Allariz,5433,2632,2801
32,Ourense,2,Amoeiro,2371,1161,1210
32,Ourense,3,Arnoia (A),1184,574,610
32,Ourense,4,Avión,2730,1240,1490
32,Ourense,5,Baltar,1149,578,571
32,Ourense,6,Bande,2217,1030,1187
32,Ourense,7,Baños de Molgas,1970,962,1008
32,Ourense,8,Barbadás,8426,4160,4266
32,Ourense,9,Barco de Valdeorras (O),13800,6872,6928
32,Ourense,10,Beade,553,277,276
32,Ourense,11,Beariz,1372,642,730
32,Ourense,12,Blancos (Os),1089,556,533
32,Ourense,13,Boborás,3149,1461,1688
32,Ourense,14,Bola (A),1517,721,796
32,Ourense,15,Bolo (O),1223,602,621
32,Ourense,16,Calvos de Randín,1167,580,587
32,Ourense,18,Carballeda de Avia,1551,739,812
32,Ourense,17,Carballeda de Valdeorras,2010,989,1021
32,Ourense,19,Carballiño (O),13716,6454,7262
32,Ourense,20,Cartelle,3507,1694,1813
32,Ourense,22,Castrelo de Miño,2008,1000,1008
32,Ourense,21,Castrelo do Val,1234,617,617
32,Ourense,23,Castro Caldelas,1714,872,842
32,Ourense,24,Celanova,6137,2923,3214
32,Ourense,25,Cenlle,1542,733,809
32,Ourense,29,Chandrexa de Queixa,766,423,343
32,Ourense,26,Coles,3285,1621,1664
32,Ourense,27,Cortegada,1385,672,713
32,Ourense,28,Cualedro,2161,1068,1093
32,Ourense,30,Entrimo,1352,633,719
32,Ourense,31,Esgos,1283,640,643
32,Ourense,33,Gomesende,1078,516,562
32,Ourense,34,Gudiña (A),1596,799,797
32,Ourense,35,Irixo (O),1971,929,1042
32,Ourense,38,Larouco,571,276,295
32,Ourense,39,Laza,1730,845,885
32,Ourense,40,Leiro,1893,914,979
32,Ourense,41,Lobeira,1117,545,572
32,Ourense,42,Lobios,2361,1140,1221
32,Ourense,43,Maceda,3162,1554,1608
32,Ourense,44,Manzaneda,1098,554,544
32,Ourense,45,Maside,3064,1442,1622
32,Ourense,46,Melón,1554,695,859
32,Ourense,47,Merca (A),2323,1105,1218
32,Ourense,48,Mezquita (A),1385,723,662
32,Ourense,49,Montederramo,1109,564,545
32,Ourense,50,Monterrei,3098,1550,1548
32,Ourense,51,Muíños,2004,981,1023
32,Ourense,52,Nogueira de Ramuín,2500,1209,1291
32,Ourense,53,Oímbra,1941,973,968
32,Ourense,54,Ourense,108137,50362,57775
32,Ourense,55,Paderne de Allariz,1602,783,819
32,Ourense,56,Padrenda,2383,1156,1227
32,Ourense,57,Parada de Sil,750,365,385
32,Ourense,58,Pereiro de Aguiar (O),5647,2853,2794
32,Ourense,59,Peroxa (A),2406,1157,1249
32,Ourense,60,Petín,1073,526,547
32,Ourense,61,Piñor,1469,721,748
32,Ourense,63,Pobra de Trives (A),2664,1340,1324
32,Ourense,64,Pontedeva,621,296,325
32,Ourense,62,Porqueira,1103,541,562
32,Ourense,65,Punxín,930,439,491
32,Ourense,66,Quintela de Leirado,795,361,434
32,Ourense,67,Rairiz de Veiga,1759,855,904
32,Ourense,68,Ramirás,2024,936,1088
32,Ourense,69,Ribadavia,5401,2569,2832
32,Ourense,71,Riós,2064,1015,1049
32,Ourense,72,Rúa (A),4978,2426,2552
32,Ourense,73,Rubiá,1638,802,836
32,Ourense,74,San Amaro,1326,659,667
32,Ourense,75,San Cibrao das Viñas,4103,2004,2099
32,Ourense,76,San Cristovo de Cea,2877,1425,1452
32,Ourense,70,San Xoán de Río,846,408,438
32,Ourense,77,Sandiás,1528,703,825
32,Ourense,78,Sarreaus,1755,866,889
32,Ourense,79,Taboadela,1712,848,864
32,Ourense,80,Teixeira (A),529,256,273
32,Ourense,81,Toén,2627,1330,1297
32,Ourense,82,Trasmiras,1763,866,897
32,Ourense,83,Veiga (A),1238,610,628
32,Ourense,84,Verea,1315,636,679
32,Ourense,85,Verín,13944,6780,7164
32,Ourense,86,Viana do Bolo,3517,1745,1772
32,Ourense,87,Vilamarín,2320,1137,1183
32,Ourense,88,Vilamartín de Valdeorras,2321,1137,1184
32,Ourense,89,Vilar de Barrio,1835,903,932
32,Ourense,90,Vilar de Santos,1025,500,525
32,Ourense,91,Vilardevós,2500,1248,1252
32,Ourense,92,Vilariño de Conso,727,408,319
32,Ourense,32,Xinzo de Limia,9999,4953,5046
32,Ourense,36,Xunqueira de Ambía,1863,933,930
32,Ourense,37,Xunqueira de Espadanedo,1001,487,514
33,Asturias,1,Allande,2181,1105,1076
33,Asturias,2,Aller,13421,6590,6831
33,Asturias,3,Amieva,850,462,388
33,Asturias,4,Avilés,83538,40023,43515
33,Asturias,5,Belmonte de Miranda,1957,1008,949
33,Asturias,6,Bimenes,1909,897,1012
33,Asturias,7,Boal,2121,1053,1068
33,Asturias,8,Cabrales,2257,1147,1110
33,Asturias,9,Cabranes,1086,549,537
33,Asturias,10,Candamo,2294,1122,1172
33,Asturias,12,Cangas de Onís,6616,3259,3357
33,Asturias,11,Cangas del Narcea,15437,7745,7692
33,Asturias,13,Caravia,553,280,273
33,Asturias,14,Carreño,10842,5297,5545
33,Asturias,15,Caso,1961,1047,914
33,Asturias,16,Castrillón,22855,11112,11743
33,Asturias,17,Castropol,3931,1867,2064
33,Asturias,18,Coaña,3495,1695,1800
33,Asturias,19,Colunga,3838,1896,1942
33,Asturias,20,Corvera de Asturias,15787,7731,8056
33,Asturias,21,Cudillero,5932,2907,3025
33,Asturias,22,Degaña,1324,702,622
33,Asturias,23,Franco (El),4065,1996,2069
33,Asturias,24,Gijón,274472,130229,144243
33,Asturias,25,Gozón,10742,5246,5496
33,Asturias,26,Grado,10997,5347,5650
33,Asturias,27,Grandas de Salime,1156,595,561
33,Asturias,28,Ibias,1847,993,854
33,Asturias,29,Illano,526,278,248
33,Asturias,30,Illas,1018,542,476
33,Asturias,31,Langreo,46076,21948,24128
33,Asturias,32,Laviana,14373,6974,7399
33,Asturias,33,Lena,13109,6338,6771
33,Asturias,35,Llanera,13283,6611,6672
33,Asturias,36,Llanes,13271,6425,6846
33,Asturias,37,Mieres,45645,21775,23870
33,Asturias,38,Morcín,3005,1494,1511
33,Asturias,39,Muros de Nalón,1989,922,1067
33,Asturias,40,Nava,5475,2695,2780
33,Asturias,41,Navia,9068,4370,4698
33,Asturias,42,Noreña,5013,2407,2606
33,Asturias,43,Onís,830,429,401
33,Asturias,44,Oviedo,214883,100072,114811
33,Asturias,45,Parres,5736,2819,2917
33,Asturias,46,Peñamellera Alta,651,323,328
33,Asturias,47,Peñamellera Baja,1442,721,721
33,Asturias,48,Pesoz,204,96,108
33,Asturias,49,Piloña,8448,4133,4315
33,Asturias,50,Ponga,694,413,281
33,Asturias,51,Pravia,9180,4474,4706
33,Asturias,52,Proaza,795,423,372
33,Asturias,53,Quirós,1416,755,661
33,Asturias,54,Regueras (Las),2048,1017,1031
33,Asturias,55,Ribadedeva,1907,933,974
33,Asturias,56,Ribadesella,6211,2938,3273
33,Asturias,57,Ribera de Arriba,2009,1019,990
33,Asturias,58,Riosa,2307,1182,1125
33,Asturias,59,Salas,6195,3027,3168
33,Asturias,61,San Martín de Oscos,466,239,227
33,Asturias,60,San Martín del Rey Aurelio,19430,9372,10058
33,Asturias,63,San Tirso de Abres,590,292,298
33,Asturias,62,Santa Eulalia de Oscos,547,282,265
33,Asturias,64,Santo Adriano,280,137,143
33,Asturias,65,Sariego,1345,650,695
33,Asturias,66,Siero,49376,23941,25435
33,Asturias,67,Sobrescobio,876,464,412
33,Asturias,68,Somiedo,1544,851,693
33,Asturias,69,Soto del Barco,4150,2024,2126
33,Asturias,70,Tapia de Casariego,4268,2048,2220
33,Asturias,71,Taramundi,800,389,411
33,Asturias,72,Teverga,1973,1028,945
33,Asturias,73,Tineo,11801,5995,5806
33,Asturias,34,Valdés,14038,6840,7198
33,Asturias,74,Vegadeo,4367,2094,2273
33,Asturias,75,Villanueva de Oscos,406,208,198
33,Asturias,76,Villaviciosa,14457,7090,7367
33,Asturias,77,Villayón,1721,854,867
33,Asturias,78,Yernes y Tameza,190,96,94
34,Palencia,1,Abarca de Campos,44,25,19
34,Palencia,3,Abia de las Torres,173,90,83
34,Palencia,4,Aguilar de Campoo,7303,3559,3744
34,Palencia,5,Alar del Rey,1107,532,575
34,Palencia,6,Alba de Cerrato,102,50,52
34,Palencia,9,Amayuelas de Arriba,40,25,15
34,Palencia,10,Ampudia,651,341,310
34,Palencia,11,Amusco,491,268,223
34,Palencia,12,Antigüedad,384,210,174
34,Palencia,15,Arconada,43,24,19
34,Palencia,17,Astudillo,1163,597,566
34,Palencia,18,Autilla del Pino,229,126,103
34,Palencia,19,Autillo de Campos,180,86,94
34,Palencia,20,Ayuela,65,39,26
34,Palencia,22,Baltanás,1403,728,675
34,Palencia,24,Baquerín de Campos,25,13,12
34,Palencia,25,Bárcena de Campos,63,29,34
34,Palencia,27,Barruelo de Santullán,1510,722,788
34,Palencia,28,Báscones de Ojeda,193,103,90
34,Palencia,29,Becerril de Campos,987,495,492
34,Palencia,31,Belmonte de Campos,37,17,20
34,Palencia,32,Berzosilla,57,28,29
34,Palencia,33,Boada de Campos,21,12,9
34,Palencia,35,Boadilla de Rioseco,146,76,70
34,Palencia,34,Boadilla del Camino,148,78,70
34,Palencia,36,Brañosera,267,140,127
34,Palencia,37,Buenavista de Valdavia,413,210,203
34,Palencia,38,Bustillo de la Vega,343,180,163
34,Palencia,39,Bustillo del Páramo de Carrión,78,47,31
34,Palencia,41,Calahorra de Boedo,123,65,58
34,Palencia,42,Calzada de los Molinos,374,209,165
34,Palencia,45,Capillas,105,54,51
34,Palencia,46,Cardeñosa de Volpejera,43,22,21
34,Palencia,47,Carrión de los Condes,2305,1109,1196
34,Palencia,48,Castil de Vela,89,41,48
34,Palencia,49,Castrejón de la Peña,526,274,252
34,Palencia,50,Castrillo de Don Juan,293,159,134
34,Palencia,51,Castrillo de Onielo,137,71,66
34,Palencia,52,Castrillo de Villavega,234,121,113
34,Palencia,53,Castromocho,238,125,113
34,Palencia,55,Cervatos de la Cueza,325,176,149
34,Palencia,56,Cervera de Pisuerga,2623,1300,1323
34,Palencia,57,Cevico de la Torre,555,277,278
34,Palencia,58,Cevico Navero,241,127,114
34,Palencia,59,Cisneros,516,264,252
34,Palencia,60,Cobos de Cerrato,206,109,97
34,Palencia,61,Collazos de Boedo,146,78,68
34,Palencia,62,Congosto de Valdavia,230,133,97
34,Palencia,63,Cordovilla la Real,109,57,52
34,Palencia,66,Cubillas de Cerrato,78,40,38
34,Palencia,67,Dehesa de Montejo,173,96,77
34,Palencia,68,Dehesa de Romanos,37,22,15
34,Palencia,69,Dueñas,3052,1602,1450
34,Palencia,70,Espinosa de Cerrato,212,109,103
34,Palencia,71,Espinosa de Villagonzalo,224,112,112
34,Palencia,72,Frechilla,238,122,116
34,Palencia,73,Fresno del Río,185,100,85
34,Palencia,74,Frómista,876,443,433
34,Palencia,76,Fuentes de Nava,778,397,381
34,Palencia,77,Fuentes de Valdepero,237,129,108
34,Palencia,79,Grijota,1208,599,609
34,Palencia,80,Guardo,7835,3902,3933
34,Palencia,81,Guaza de Campos,59,29,30
34,Palencia,82,Hérmedes de Cerrato,116,59,57
34,Palencia,83,Herrera de Pisuerga,2406,1165,1241
34,Palencia,84,Herrera de Valdecañas,175,92,83
34,Palencia,86,Hontoria de Cerrato,103,53,50
34,Palencia,87,Hornillos de Cerrato,117,58,59
34,Palencia,88,Husillos,229,132,97
34,Palencia,89,Itero de la Vega,205,104,101
34,Palencia,91,Lagartos,147,83,64
34,Palencia,92,Lantadilla,419,203,216
34,Palencia,94,Ledigos,89,49,40
34,Palencia,903,Loma de Ucieza,281,152,129
34,Palencia,96,Lomas,52,25,27
34,Palencia,98,Magaz de Pisuerga,801,415,386
34,Palencia,99,Manquillos,70,38,32
34,Palencia,100,Mantinos,164,88,76
34,Palencia,101,Marcilla de Campos,52,22,30
34,Palencia,102,Mazariegos,257,142,115
34,Palencia,103,Mazuecos de Valdeginate,116,60,56
34,Palencia,104,Melgar de Yuso,326,183,143
34,Palencia,106,Meneses de Campos,149,76,73
34,Palencia,107,Micieces de Ojeda,104,59,45
34,Palencia,108,Monzón de Campos,667,350,317
34,Palencia,109,Moratinos,79,43,36
34,Palencia,110,Mudá,98,48,50
34,Palencia,112,Nogal de las Huertas,56,30,26
34,Palencia,113,Olea de Boedo,42,19,23
34,Palencia,114,Olmos de Ojeda,280,162,118
34,Palencia,116,Osornillo,72,37,35
34,Palencia,901,Osorno la Mayor,1539,807,732
34,Palencia,120,Palencia,82263,38863,43400
34,Palencia,121,Palenzuela,269,145,124
34,Palencia,122,Páramo de Boedo,105,56,49
34,Palencia,123,Paredes de Nava,2178,1093,1085
34,Palencia,124,Payo de Ojeda,81,47,34
34,Palencia,125,Pedraza de Campos,106,57,49
34,Palencia,126,Pedrosa de la Vega,352,186,166
34,Palencia,127,Perales,146,69,77
34,Palencia,904,Pernía (La),418,236,182
34,Palencia,129,Pino del Río,253,149,104
34,Palencia,130,Piña de Campos,257,133,124
34,Palencia,131,Población de Arroyo,81,44,37
34,Palencia,132,Población de Campos,159,85,74
34,Palencia,133,Población de Cerrato,127,70,57
34,Palencia,134,Polentinos,69,35,34
34,Palencia,135,Pomar de Valdivia,516,274,242
34,Palencia,136,Poza de la Vega,252,138,114
34,Palencia,137,Pozo de Urama,37,20,17
34,Palencia,139,Prádanos de Ojeda,217,116,101
34,Palencia,140,Puebla de Valdavia (La),134,65,69
34,Palencia,141,Quintana del Puente,231,121,110
34,Palencia,143,Quintanilla de Onsoña,213,114,99
34,Palencia,146,Reinoso de Cerrato,71,39,32
34,Palencia,147,Renedo de la Vega,244,140,104
34,Palencia,149,Requena de Campos,37,15,22
34,Palencia,151,Respenda de la Peña,225,122,103
34,Palencia,152,Revenga de Campos,158,80,78
34,Palencia,154,Revilla de Collazos,82,47,35
34,Palencia,155,Ribas de Campos,181,95,86
34,Palencia,156,Riberos de la Cueza,80,46,34
34,Palencia,157,Saldaña,3038,1540,1498
34,Palencia,158,Salinas de Pisuerga,325,163,162
34,Palencia,159,San Cebrián de Campos,453,258,195
34,Palencia,160,San Cebrián de Mudá,165,80,85
34,Palencia,161,San Cristóbal de Boedo,31,18,13
34,Palencia,163,San Mamés de Campos,84,36,48
34,Palencia,165,San Román de la Cuba,113,56,57
34,Palencia,167,Santa Cecilia del Alcor,152,86,66
34,Palencia,168,Santa Cruz de Boedo,57,34,23
34,Palencia,169,Santervás de la Vega,535,292,243
34,Palencia,170,Santibáñez de Ecla,89,41,48
34,Palencia,171,Santibáñez de la Peña,1335,656,679
34,Palencia,174,Santoyo,249,124,125
34,Palencia,175,Serna (La),113,68,45
34,Palencia,177,Soto de Cerrato,196,107,89
34,Palencia,176,Sotobañado y Priorato,177,98,79
34,Palencia,178,Tabanera de Cerrato,131,75,56
34,Palencia,179,Tabanera de Valdavia,47,21,26
34,Palencia,180,Támara de Campos,84,42,42
34,Palencia,181,Tariego de Cerrato,526,271,255
34,Palencia,182,Torquemada,1083,567,516
34,Palencia,184,Torremormojón,71,38,33
34,Palencia,185,Triollo,71,39,32
34,Palencia,186,Valbuena de Pisuerga,63,37,26
34,Palencia,189,Valdeolmillos,74,40,34
34,Palencia,190,Valderrábano,61,35,26
34,Palencia,192,Valde-Ucieza,113,62,51
34,Palencia,196,Valle de Cerrato,108,59,49
34,Palencia,902,Valle del Retortillo,172,88,84
34,Palencia,199,Velilla del Río Carrión,1573,793,780
34,Palencia,23,Venta de Baños,5880,2862,3018
34,Palencia,201,Vertavillo,205,113,92
34,Palencia,93,Vid de Ojeda (La),126,75,51
34,Palencia,202,Villabasta de Valdavia,38,16,22
34,Palencia,204,Villacidaler,69,35,34
34,Palencia,205,Villaconancio,79,48,31
34,Palencia,206,Villada,1134,562,572
34,Palencia,208,Villaeles de Valdavia,75,42,33
34,Palencia,210,Villahán,113,61,52
34,Palencia,211,Villaherreros,237,119,118
34,Palencia,213,Villalaco,69,27,42
34,Palencia,214,Villalba de Guardo,216,119,97
34,Palencia,215,Villalcázar de Sirga,207,95,112
34,Palencia,216,Villalcón,82,39,43
34,Palencia,217,Villalobón,776,395,381
34,Palencia,218,Villaluenga de la Vega,630,360,270
34,Palencia,220,Villamartín de Campos,139,74,65
34,Palencia,221,Villamediana,215,117,98
34,Palencia,222,Villameriel,133,77,56
34,Palencia,223,Villamoronta,312,178,134
34,Palencia,224,Villamuera de la Cueza,62,35,27
34,Palencia,225,Villamuriel de Cerrato,5598,2912,2686
34,Palencia,227,Villanueva del Rebollar,104,55,49
34,Palencia,228,Villanuño de Valdavia,113,64,49
34,Palencia,229,Villaprovedo,79,50,29
34,Palencia,230,Villarmentero de Campos,15,11,4
34,Palencia,231,Villarrabé,238,121,117
34,Palencia,232,Villarramiel,998,528,470
34,Palencia,233,Villasarracino,205,106,99
34,Palencia,234,Villasila de Valdavia,84,54,30
34,Palencia,236,Villaturde,213,105,108
34,Palencia,237,Villaumbrales,805,415,390
34,Palencia,238,Villaviudas,401,191,210
34,Palencia,240,Villerías de Campos,114,65,49
34,Palencia,241,Villodre,33,24,9
34,Palencia,242,Villodrigo,120,59,61
34,Palencia,243,Villoldo,425,223,202
34,Palencia,245,Villota del Páramo,387,228,159
34,Palencia,246,Villovieco,106,53,53
35,Las Palmas,1,Agaete,5638,2878,2760
35,Las Palmas,2,Agüimes,26593,13672,12921
35,Las Palmas,20,Aldea de San Nicolás (La),8409,4345,4064
35,Las Palmas,3,Antigua,8206,4538,3668
35,Las Palmas,4,Arrecife,55203,28471,26732
35,Las Palmas,5,Artenara,1306,695,611
35,Las Palmas,6,Arucas,34874,17525,17349
35,Las Palmas,7,Betancuria,705,352,353
35,Las Palmas,8,Firgas,7188,3663,3525
35,Las Palmas,9,Gáldar,23453,11802,11651
35,Las Palmas,10,Haría,5004,2612,2392
35,Las Palmas,11,Ingenio,27934,14239,13695
35,Las Palmas,12,Mogán,16569,8791,7778
35,Las Palmas,13,Moya,7808,3954,3854
35,Las Palmas,14,Oliva (La),18884,10307,8577
35,Las Palmas,15,Pájara,18494,10284,8210
35,Las Palmas,16,Palmas de Gran Canaria (Las),377056,184295,192761
35,Las Palmas,17,Puerto del Rosario,30555,16080,14475
35,Las Palmas,18,San Bartolomé,17610,9141,8469
35,Las Palmas,19,San Bartolomé de Tirajana,47922,25001,22921
35,Las Palmas,21,Santa Brígida,18760,9360,9400
35,Las Palmas,22,Santa Lucía de Tirajana,57211,29124,28087
35,Las Palmas,23,Santa María de Guía de Gran Canaria,14048,7014,7034
35,Las Palmas,24,Teguise,16616,8496,8120
35,Las Palmas,25,Tejeda,2286,1198,1088
35,Las Palmas,26,Telde,97525,48745,48780
35,Las Palmas,27,Teror,12175,6169,6006
35,Las Palmas,28,Tías,17884,9334,8550
35,Las Palmas,29,Tinajo,5476,2893,2583
35,Las Palmas,30,Tuineje,12836,6811,6025
35,Las Palmas,32,Valleseco,4050,2128,1922
35,Las Palmas,31,Valsequillo de Gran Canaria,8583,4382,4201
35,Las Palmas,33,Vega de San Mateo,7661,3979,3682
35,Las Palmas,34,Yaiza,9664,5386,4278
36,Pontevedra,20,Agolada,3286,1602,1684
36,Pontevedra,1,Arbo,3955,1979,1976
36,Pontevedra,3,Baiona,11653,5751,5902
36,Pontevedra,2,Barro,3402,1659,1743
36,Pontevedra,4,Bueu,12537,6165,6372
36,Pontevedra,5,Caldas de Reis,9730,4678,5052
36,Pontevedra,6,Cambados,13562,6603,6959
36,Pontevedra,7,Campo Lameiro,2132,1018,1114
36,Pontevedra,8,Cangas,25202,12533,12669
36,Pontevedra,9,Cañiza (A),6714,3239,3475
36,Pontevedra,10,Catoira,3482,1696,1786
36,Pontevedra,11,Cerdedo,2330,1047,1283
36,Pontevedra,12,Cotobade,4608,2131,2477
36,Pontevedra,13,Covelo,3602,1711,1891
36,Pontevedra,14,Crecente,2677,1239,1438
36,Pontevedra,15,Cuntis,5267,2464,2803
36,Pontevedra,16,Dozón,1947,948,999
36,Pontevedra,17,Estrada (A),22013,10420,11593
36,Pontevedra,18,Forcarei,4505,2111,2394
36,Pontevedra,19,Fornelos de Montes,2042,944,1098
36,Pontevedra,21,Gondomar,12888,6400,6488
36,Pontevedra,22,Grove (O),11225,5548,5677
36,Pontevedra,23,Guarda (A),10254,5014,5240
36,Pontevedra,901,Illa de Arousa (A),4849,2419,2430
36,Pontevedra,24,Lalín,20779,10049,10730
36,Pontevedra,25,Lama (A),3022,1395,1627
36,Pontevedra,26,Marín,26190,13154,13036
36,Pontevedra,27,Meaño,5494,2643,2851
36,Pontevedra,28,Meis,5001,2376,2625
36,Pontevedra,29,Moaña,18432,9015,9417
36,Pontevedra,30,Mondariz,5354,2552,2802
36,Pontevedra,31,Mondariz-Balneario,740,368,372
36,Pontevedra,32,Moraña,4274,2029,2245
36,Pontevedra,33,Mos,14283,7008,7275
36,Pontevedra,34,Neves (As),4473,2186,2287
36,Pontevedra,35,Nigrán,17631,8717,8914
36,Pontevedra,36,Oia,3140,1609,1531
36,Pontevedra,37,Pazos de Borbén,3179,1482,1697
36,Pontevedra,41,Poio,15201,7496,7705
36,Pontevedra,43,Ponte Caldelas,6513,3185,3328
36,Pontevedra,42,Ponteareas,21993,10734,11259
36,Pontevedra,44,Pontecesures,3120,1543,1577
36,Pontevedra,38,Pontevedra,80096,38075,42021
36,Pontevedra,39,Porriño (O),16617,8097,8520
36,Pontevedra,40,Portas,3174,1498,1676
36,Pontevedra,45,Redondela,30029,14635,15394
36,Pontevedra,46,Ribadumia,4529,2160,2369
36,Pontevedra,47,Rodeiro,3317,1688,1629
36,Pontevedra,48,Rosal (O),6326,3094,3232
36,Pontevedra,49,Salceda de Caselas,7402,3754,3648
36,Pontevedra,50,Salvaterra de Miño,8505,4203,4302
36,Pontevedra,51,Sanxenxo,16914,8301,8613
36,Pontevedra,52,Silleda,9058,4370,4688
36,Pontevedra,53,Soutomaior,6110,2988,3122
36,Pontevedra,54,Tomiño,12278,6083,6195
36,Pontevedra,55,Tui,16925,8100,8825
36,Pontevedra,56,Valga,6116,3003,3113
36,Pontevedra,57,Vigo,293255,139869,153386
36,Pontevedra,59,Vila de Cruces,6644,3315,3329
36,Pontevedra,58,Vilaboa,6030,2947,3083
36,Pontevedra,60,Vilagarcía de Arousa,36519,17605,18914
36,Pontevedra,61,Vilanova de Arousa,10592,5140,5452
37,Salamanca,1,Abusejo,253,133,120
37,Salamanca,2,Agallas,184,96,88
37,Salamanca,3,Ahigal de los Aceiteros,167,84,83
37,Salamanca,4,Ahigal de Villarino,41,20,21
37,Salamanca,5,Alameda de Gardón (La),124,59,65
37,Salamanca,6,Alamedilla (La),204,106,98
37,Salamanca,7,Alaraz,609,317,292
37,Salamanca,8,Alba de Tormes,5021,2474,2547
37,Salamanca,9,Alba de Yeltes,253,127,126
37,Salamanca,10,Alberca (La),1138,571,567
37,Salamanca,11,Alberguería de Argañán (La),176,94,82
37,Salamanca,12,Alconada,197,105,92
37,Salamanca,15,Aldea del Obispo,356,191,165
37,Salamanca,13,Aldeacipreste,168,90,78
37,Salamanca,14,Aldeadávila de la Ribera,1470,756,714
37,Salamanca,16,Aldealengua,567,289,278
37,Salamanca,17,Aldeanueva de Figueroa,315,158,157
37,Salamanca,18,Aldeanueva de la Sierra,118,65,53
37,Salamanca,19,Aldearrodrigo,184,99,85
37,Salamanca,20,Aldearrubia,504,274,230
37,Salamanca,21,Aldeaseca de Alba,102,48,54
37,Salamanca,22,Aldeaseca de la Frontera,334,175,159
37,Salamanca,23,Aldeatejada,942,471,471
37,Salamanca,24,Aldeavieja de Tormes,121,62,59
37,Salamanca,25,Aldehuela de la Bóveda,340,174,166
37,Salamanca,26,Aldehuela de Yeltes,265,136,129
37,Salamanca,27,Almenara de Tormes,263,134,129
37,Salamanca,28,Almendra,210,106,104
37,Salamanca,29,Anaya de Alba,268,141,127
37,Salamanca,30,Añover de Tormes,105,57,48
37,Salamanca,31,Arabayona de Mógica,482,259,223
37,Salamanca,32,Arapiles,494,251,243
37,Salamanca,33,Arcediano,100,52,48
37,Salamanca,34,Arco (El),110,62,48
37,Salamanca,35,Armenteros,574,318,256
37,Salamanca,37,Atalaya (La),138,77,61
37,Salamanca,38,Babilafuente,965,517,448
37,Salamanca,39,Bañobárez,368,193,175
37,Salamanca,40,Barbadillo,490,247,243
37,Salamanca,41,Barbalos,103,55,48
37,Salamanca,42,Barceo,57,28,29
37,Salamanca,44,Barruecopardo,504,260,244
37,Salamanca,45,Bastida (La),32,18,14
37,Salamanca,46,Béjar,14948,7111,7837
37,Salamanca,47,Beleña,146,71,75
37,Salamanca,49,Bermellar,184,90,94
37,Salamanca,50,Berrocal de Huebra,96,51,45
37,Salamanca,51,Berrocal de Salvatierra,110,54,56
37,Salamanca,52,Boada,356,176,180
37,Salamanca,54,Bodón (El),296,149,147
37,Salamanca,55,Bogajo,182,97,85
37,Salamanca,56,Bouza (La),69,36,33
37,Salamanca,57,Bóveda del Río Almar,281,148,133
37,Salamanca,58,Brincones,83,40,43
37,Salamanca,59,Buenamadre,151,86,65
37,Salamanca,60,Buenavista,159,82,77
37,Salamanca,61,Cabaco (El),293,149,144
37,Salamanca,63,Cabeza de Béjar (La),101,52,49
37,Salamanca,65,Cabeza del Caballo,437,222,215
37,Salamanca,62,Cabezabellosa de la Calzada,120,65,55
37,Salamanca,67,Cabrerizos,3281,1664,1617
37,Salamanca,68,Cabrillas,478,236,242
37,Salamanca,69,Calvarrasa de Abajo,1086,544,542
37,Salamanca,70,Calvarrasa de Arriba,658,345,313
37,Salamanca,71,Calzada de Béjar (La),102,51,51
37,Salamanca,72,Calzada de Don Diego,203,106,97
37,Salamanca,73,Calzada de Valdunciel,651,336,315
37,Salamanca,74,Campillo de Azaba,223,110,113
37,Salamanca,77,Campo de Peñaranda (El),333,179,154
37,Salamanca,78,Candelario,1012,507,505
37,Salamanca,79,Canillas de Abajo,100,59,41
37,Salamanca,80,Cantagallo,259,124,135
37,Salamanca,81,Cantalapiedra,1194,596,598
37,Salamanca,82,Cantalpino,1069,582,487
37,Salamanca,83,Cantaracillo,231,127,104
37,Salamanca,85,Carbajosa de la Sagrada,4078,2088,1990
37,Salamanca,86,Carpio de Azaba,108,58,50
37,Salamanca,87,Carrascal de Barregas,643,337,306
37,Salamanca,88,Carrascal del Obispo,233,122,111
37,Salamanca,89,Casafranca,78,37,41
37,Salamanca,90,Casas del Conde (Las),72,38,34
37,Salamanca,91,Casillas de Flores,215,105,110
37,Salamanca,92,Castellanos de Moriscos,706,348,358
37,Salamanca,185,Castellanos de Villiquera,582,306,276
37,Salamanca,96,Castillejo de Martín Viejo,307,166,141
37,Salamanca,97,Castraz,56,31,25
37,Salamanca,98,Cepeda,451,218,233
37,Salamanca,99,Cereceda de la Sierra,91,42,49
37,Salamanca,100,Cerezal de Peñahorcada,112,64,48
37,Salamanca,101,Cerralbo,240,125,115
37,Salamanca,102,Cerro (El),512,271,241
37,Salamanca,103,Cespedosa de Tormes,585,320,265
37,Salamanca,114,Chagarcía Medianero,119,65,54
37,Salamanca,104,Cilleros de la Bastida,43,24,19
37,Salamanca,106,Cipérez,357,176,181
37,Salamanca,107,Ciudad Rodrigo,14035,6786,7249
37,Salamanca,108,Coca de Alba,124,56,68
37,Salamanca,109,Colmenar de Montemayor,236,132,104
37,Salamanca,110,Cordovilla,136,79,57
37,Salamanca,112,Cristóbal,188,95,93
37,Salamanca,113,Cubo de Don Sancho (El),532,275,257
37,Salamanca,115,Dios le Guarde,175,95,80
37,Salamanca,116,Doñinos de Ledesma,91,47,44
37,Salamanca,117,Doñinos de Salamanca,924,472,452
37,Salamanca,118,Ejeme,170,91,79
37,Salamanca,119,Encina (La),142,79,63
37,Salamanca,120,Encina de San Silvestre,128,64,64
37,Salamanca,121,Encinas de Abajo,638,332,306
37,Salamanca,122,Encinas de Arriba,274,131,143
37,Salamanca,123,Encinasola de los Comendadores,256,133,123
37,Salamanca,124,Endrinal,294,162,132
37,Salamanca,125,Escurial de la Sierra,289,155,134
37,Salamanca,126,Espadaña,44,23,21
37,Salamanca,127,Espeja,296,151,145
37,Salamanca,128,Espino de la Orbada,323,168,155
37,Salamanca,129,Florida de Liébana,286,147,139
37,Salamanca,130,Forfoleda,225,116,109
37,Salamanca,131,Frades de la Sierra,239,127,112
37,Salamanca,132,Fregeneda (La),458,228,230
37,Salamanca,133,Fresnedoso,127,68,59
37,Salamanca,134,Fresno Alhándiga,282,147,135
37,Salamanca,135,Fuente de San Esteban (La),1438,730,708
37,Salamanca,136,Fuenteguinaldo,833,438,395
37,Salamanca,137,Fuenteliante,145,64,81
37,Salamanca,138,Fuenterroble de Salvatierra,275,136,139
37,Salamanca,139,Fuentes de Béjar,265,124,141
37,Salamanca,140,Fuentes de Oñoro,1331,651,680
37,Salamanca,141,Gajates,189,90,99
37,Salamanca,142,Galindo y Perahuy,597,335,262
37,Salamanca,143,Galinduste,542,266,276
37,Salamanca,144,Galisancho,460,253,207
37,Salamanca,145,Gallegos de Argañán,369,195,174
37,Salamanca,146,Gallegos de Solmirón,158,77,81
37,Salamanca,147,Garcibuey,224,125,99
37,Salamanca,148,Garcihernández,576,292,284
37,Salamanca,149,Garcirrey,92,50,42
37,Salamanca,150,Gejuelo del Barro,47,27,20
37,Salamanca,151,Golpejas,182,92,90
37,Salamanca,152,Gomecello,533,285,248
37,Salamanca,154,Guadramiro,180,104,76
37,Salamanca,155,Guijo de Ávila,105,67,38
37,Salamanca,156,Guijuelo,5412,2747,2665
37,Salamanca,157,Herguijuela de Ciudad Rodrigo,128,67,61
37,Salamanca,158,Herguijuela de la Sierra,301,154,147
37,Salamanca,159,Herguijuela del Campo,109,48,61
37,Salamanca,160,Hinojosa de Duero,767,390,377
37,Salamanca,161,Horcajo de Montemayor,193,99,94
37,Salamanca,162,Horcajo Medianero,304,155,149
37,Salamanca,163,Hoya (La),30,21,9
37,Salamanca,164,Huerta,294,163,131
37,Salamanca,165,Iruelos,47,21,26
37,Salamanca,166,Ituero de Azaba,274,153,121
37,Salamanca,167,Juzbado,179,90,89
37,Salamanca,168,Lagunilla,553,300,253
37,Salamanca,169,Larrodrigo,272,149,123
37,Salamanca,170,Ledesma,1869,941,928
37,Salamanca,171,Ledrada,558,279,279
37,Salamanca,172,Linares de Riofrío,992,515,477
37,Salamanca,173,Lumbrales,1996,974,1022
37,Salamanca,175,Machacón,508,262,246
37,Salamanca,174,Macotera,1497,774,723
37,Salamanca,176,Madroñal,159,84,75
37,Salamanca,177,Maíllo (El),358,190,168
37,Salamanca,178,Malpartida,126,73,53
37,Salamanca,179,Mancera de Abajo,303,152,151
37,Salamanca,180,Manzano (El),101,55,46
37,Salamanca,181,Martiago,346,179,167
37,Salamanca,183,Martín de Yeltes,512,265,247
37,Salamanca,182,Martinamor,82,43,39
37,Salamanca,184,Masueco,401,207,194
37,Salamanca,186,Mata de Ledesma (La),128,67,61
37,Salamanca,187,Matilla de los Caños del Río,666,342,324
37,Salamanca,188,Maya (La),239,137,102
37,Salamanca,189,Membribe de la Sierra,115,71,44
37,Salamanca,190,Mieza,303,153,150
37,Salamanca,191,Milano (El),152,83,69
37,Salamanca,192,Miranda de Azán,402,204,198
37,Salamanca,193,Miranda del Castañar,565,288,277
37,Salamanca,194,Mogarraz,317,162,155
37,Salamanca,195,Molinillo,67,34,33
37,Salamanca,196,Monforte de la Sierra,99,59,40
37,Salamanca,197,Monleón,115,65,50
37,Salamanca,198,Monleras,269,127,142
37,Salamanca,199,Monsagro,195,108,87
37,Salamanca,200,Montejo,223,115,108
37,Salamanca,201,Montemayor del Río,322,163,159
37,Salamanca,202,Monterrubio de Armuña,763,412,351
37,Salamanca,203,Monterrubio de la Sierra,150,82,68
37,Salamanca,204,Morasverdes,364,182,182
37,Salamanca,205,Morille,240,125,115
37,Salamanca,206,Moríñigo,125,61,64
37,Salamanca,207,Moriscos,140,63,77
37,Salamanca,208,Moronta,118,61,57
37,Salamanca,209,Mozárbez,416,222,194
37,Salamanca,211,Narros de Matalayegua,257,133,124
37,Salamanca,213,Nava de Béjar,117,62,55
37,Salamanca,214,Nava de Francia,149,78,71
37,Salamanca,215,Nava de Sotrobal,200,113,87
37,Salamanca,212,Navacarros,142,84,58
37,Salamanca,216,Navales,354,202,152
37,Salamanca,217,Navalmoral de Béjar,57,25,32
37,Salamanca,218,Navamorales,115,66,49
37,Salamanca,219,Navarredonda de la Rinconada,254,126,128
37,Salamanca,221,Navasfrías,614,314,300
37,Salamanca,222,Negrilla de Palencia,119,66,53
37,Salamanca,223,Olmedo de Camaces,154,77,77
37,Salamanca,224,Orbada (La),274,141,133
37,Salamanca,225,Pajares de la Laguna,149,76,73
37,Salamanca,226,Palacios del Arzobispo,200,102,98
37,Salamanca,228,Palaciosrubios,491,268,223
37,Salamanca,229,Palencia de Negrilla,171,91,80
37,Salamanca,230,Parada de Arriba,243,129,114
37,Salamanca,231,Parada de Rubiales,318,165,153
37,Salamanca,232,Paradinas de San Juan,547,303,244
37,Salamanca,233,Pastores,57,33,24
37,Salamanca,234,Payo (El),425,214,211
37,Salamanca,235,Pedraza de Alba,288,146,142
37,Salamanca,236,Pedrosillo de Alba,204,105,99
37,Salamanca,237,Pedrosillo de los Aires,391,216,175
37,Salamanca,238,Pedrosillo el Ralo,130,66,64
37,Salamanca,239,Pedroso de la Armuña (El),279,133,146
37,Salamanca,240,Pelabravo,892,462,430
37,Salamanca,241,Pelarrodríguez,200,115,85
37,Salamanca,242,Pelayos,120,63,57
37,Salamanca,243,Peña (La),128,57,71
37,Salamanca,244,Peñacaballera,188,93,95
37,Salamanca,245,Peñaparda,440,236,204
37,Salamanca,246,Peñaranda de Bracamonte,6427,3155,3272
37,Salamanca,247,Peñarandilla,254,131,123
37,Salamanca,248,Peralejos de Abajo,191,98,93
37,Salamanca,249,Peralejos de Arriba,57,35,22
37,Salamanca,250,Pereña de la Ribera,462,251,211
37,Salamanca,251,Peromingo,144,67,77
37,Salamanca,252,Pinedas,167,91,76
37,Salamanca,253,Pino de Tormes (El),170,89,81
37,Salamanca,254,Pitiegua,240,128,112
37,Salamanca,255,Pizarral,80,42,38
37,Salamanca,256,Poveda de las Cintas,304,168,136
37,Salamanca,257,Pozos de Hinojo,74,40,34
37,Salamanca,258,Puebla de Azaba,243,128,115
37,Salamanca,259,Puebla de San Medel,50,28,22
37,Salamanca,260,Puebla de Yeltes,204,107,97
37,Salamanca,261,Puente del Congosto,276,141,135
37,Salamanca,262,Puertas,87,51,36
37,Salamanca,263,Puerto de Béjar,424,201,223
37,Salamanca,264,Puerto Seguro,90,48,42
37,Salamanca,265,Rágama,280,146,134
37,Salamanca,266,Redonda (La),96,51,45
37,Salamanca,267,Retortillo,253,120,133
37,Salamanca,268,Rinconada de la Sierra (La),161,89,72
37,Salamanca,269,Robleda,541,286,255
37,Salamanca,270,Robliza de Cojos,235,125,110
37,Salamanca,271,Rollán,529,261,268
37,Salamanca,272,Saelices el Chico,154,75,79
37,Salamanca,273,Sagrada (La),159,79,80
37,Salamanca,303,Sahugo (El),247,128,119
37,Salamanca,274,Salamanca,159754,74349,85405
37,Salamanca,275,Saldeana,147,84,63
37,Salamanca,276,Salmoral,250,140,110
37,Salamanca,277,Salvatierra de Tormes,64,33,31
37,Salamanca,278,San Cristóbal de la Cuesta,593,321,272
37,Salamanca,284,San Esteban de la Sierra,401,205,196
37,Salamanca,285,San Felices de los Gallegos,544,283,261
37,Salamanca,286,San Martín del Castañar,261,135,126
37,Salamanca,287,San Miguel de Valero,374,194,180
37,Salamanca,36,San Miguel del Robledo,89,40,49
37,Salamanca,288,San Morales,244,136,108
37,Salamanca,289,San Muñoz,310,162,148
37,Salamanca,291,San Pedro de Rozados,355,182,173
37,Salamanca,290,San Pedro del Valle,141,74,67
37,Salamanca,292,San Pelayo de Guareña,118,61,57
37,Salamanca,280,Sanchón de la Ribera,112,60,52
37,Salamanca,281,Sanchón de la Sagrada,45,26,19
37,Salamanca,282,Sanchotello,260,134,126
37,Salamanca,279,Sancti-Spíritus,976,498,478
37,Salamanca,283,Sando,181,98,83
37,Salamanca,293,Santa María de Sando,146,72,74
37,Salamanca,294,Santa Marta de Tormes,13602,6774,6828
37,Salamanca,296,Santiago de la Puebla,459,232,227
37,Salamanca,297,Santibáñez de Béjar,589,297,292
37,Salamanca,298,Santibáñez de la Sierra,251,128,123
37,Salamanca,299,Santiz,276,139,137
37,Salamanca,300,Santos (Los),690,351,339
37,Salamanca,301,Sardón de los Frailes,103,56,47
37,Salamanca,302,Saucelle,402,210,192
37,Salamanca,304,Sepulcro-Hilario,222,115,107
37,Salamanca,305,Sequeros,239,111,128
37,Salamanca,306,Serradilla del Arroyo,411,215,196
37,Salamanca,307,Serradilla del Llano,217,109,108
37,Salamanca,309,Sierpe (La),51,32,19
37,Salamanca,310,Sieteiglesias de Tormes,168,80,88
37,Salamanca,311,Sobradillo,320,162,158
37,Salamanca,312,Sorihuela,355,179,176
37,Salamanca,313,Sotoserrano,678,351,327
37,Salamanca,314,Tabera de Abajo,100,53,47
37,Salamanca,315,Tala (La),112,61,51
37,Salamanca,316,Tamames,975,496,479
37,Salamanca,317,Tarazona de Guareña,395,214,181
37,Salamanca,318,Tardáguila,237,125,112
37,Salamanca,319,Tejado (El),147,77,70
37,Salamanca,320,Tejeda y Segoyuela,126,66,60
37,Salamanca,321,Tenebrón,201,102,99
37,Salamanca,322,Terradillos,3283,1693,1590
37,Salamanca,323,Topas,687,355,332
37,Salamanca,324,Tordillos,510,267,243
37,Salamanca,325,Tornadizo (El),122,66,56
37,Salamanca,327,Torresmenudas,217,111,106
37,Salamanca,328,Trabanca,251,130,121
37,Salamanca,329,Tremedal de Tormes,37,19,18
37,Salamanca,330,Valdecarros,399,205,194
37,Salamanca,331,Valdefuentes de Sangusín,286,148,138
37,Salamanca,332,Valdehijaderos,102,54,48
37,Salamanca,333,Valdelacasa,311,170,141
37,Salamanca,334,Valdelageve,105,56,49
37,Salamanca,335,Valdelosa,547,257,290
37,Salamanca,336,Valdemierque,51,27,24
37,Salamanca,337,Valderrodrigo,171,84,87
37,Salamanca,338,Valdunciel,97,47,50
37,Salamanca,339,Valero,409,210,199
37,Salamanca,343,Vallejera de Riofrío,65,33,32
37,Salamanca,340,Valsalabroso,187,104,83
37,Salamanca,341,Valverde de Valdelacasa,64,35,29
37,Salamanca,342,Valverdón,278,145,133
37,Salamanca,344,Vecinos,313,157,156
37,Salamanca,345,Vega de Tirados,227,112,115
37,Salamanca,346,Veguillas (Las),285,137,148
37,Salamanca,347,Vellés (La),444,241,203
37,Salamanca,348,Ventosa del Río Almar,129,65,64
37,Salamanca,349,Vídola (La),144,68,76
37,Salamanca,351,Villaflores,383,195,188
37,Salamanca,352,Villagonzalo de Tormes,204,109,95
37,Salamanca,353,Villalba de los Llanos,175,100,75
37,Salamanca,354,Villamayor,5359,2755,2604
37,Salamanca,355,Villanueva del Conde,203,107,96
37,Salamanca,356,Villar de Argañán,101,51,50
37,Salamanca,357,Villar de Ciervo,350,182,168
37,Salamanca,358,Villar de Gallimazo,183,91,92
37,Salamanca,359,Villar de la Yegua,242,118,124
37,Salamanca,360,Villar de Peralonso,309,140,169
37,Salamanca,361,Villar de Samaniego,112,57,55
37,Salamanca,362,Villares de la Reina,4523,2261,2262
37,Salamanca,363,Villares de Yeltes,152,74,78
37,Salamanca,364,Villarino de los Aires,1020,509,511
37,Salamanca,365,Villarmayor,220,117,103
37,Salamanca,366,Villarmuerto,50,33,17
37,Salamanca,367,Villasbuenas,270,143,127
37,Salamanca,368,Villasdardo,23,8,15
37,Salamanca,369,Villaseco de los Gamitos,189,105,84
37,Salamanca,370,Villaseco de los Reyes,410,226,184
37,Salamanca,371,Villasrubias,285,158,127
37,Salamanca,372,Villaverde de Guareña,183,97,86
37,Salamanca,373,Villavieja de Yeltes,989,498,491
37,Salamanca,374,Villoria,1415,703,712
37,Salamanca,375,Villoruela,972,487,485
37,Salamanca,350,Vilvestre,534,260,274
37,Salamanca,376,Vitigudino,2918,1437,1481
37,Salamanca,377,Yecla de Yeltes,324,168,156
37,Salamanca,378,Zamarra,137,73,64
37,Salamanca,379,Zamayón,193,108,85
37,Salamanca,380,Zarapicos,79,39,40
37,Salamanca,381,Zarza de Pumareda (La),160,89,71
37,Salamanca,382,Zorita de la Frontera,252,127,125
38,Santa Cruz de Tenerife,1,Adeje,36764,19264,17500
38,Santa Cruz de Tenerife,2,Agulo,1166,576,590
38,Santa Cruz de Tenerife,3,Alajeró,2054,1108,946
38,Santa Cruz de Tenerife,4,Arafo,5257,2533,2724
38,Santa Cruz de Tenerife,5,Arico,7104,3670,3434
38,Santa Cruz de Tenerife,6,Arona,69100,36072,33028
38,Santa Cruz de Tenerife,7,Barlovento,2506,1265,1241
38,Santa Cruz de Tenerife,8,Breña Alta,7158,3517,3641
38,Santa Cruz de Tenerife,9,Breña Baja,4470,2263,2207
38,Santa Cruz de Tenerife,10,Buenavista del Norte,5225,2664,2561
38,Santa Cruz de Tenerife,11,Candelaria,21415,10603,10812
38,Santa Cruz de Tenerife,12,Fasnia,2697,1378,1319
38,Santa Cruz de Tenerife,13,Frontera,5733,2899,2834
38,Santa Cruz de Tenerife,14,Fuencaliente de la Palma,1935,989,946
38,Santa Cruz de Tenerife,15,Garachico,5543,2750,2793
38,Santa Cruz de Tenerife,16,Garafía,1886,973,913
38,Santa Cruz de Tenerife,17,Granadilla de Abona,34595,17893,16702
38,Santa Cruz de Tenerife,18,Guancha (La),5420,2659,2761
38,Santa Cruz de Tenerife,19,Guía de Isora,19320,9801,9519
38,Santa Cruz de Tenerife,20,Güímar,16603,8204,8399
38,Santa Cruz de Tenerife,21,Hermigua,2147,1095,1052
38,Santa Cruz de Tenerife,22,Icod de los Vinos,24179,12000,12179
38,Santa Cruz de Tenerife,24,Llanos de Aridane (Los),20173,9942,10231
38,Santa Cruz de Tenerife,25,Matanza de Acentejo (La),7972,4049,3923
38,Santa Cruz de Tenerife,26,Orotava (La),40644,20088,20556
38,Santa Cruz de Tenerife,27,Paso (El),7505,3802,3703
38,Santa Cruz de Tenerife,28,Puerto de la Cruz,30585,14835,15750
38,Santa Cruz de Tenerife,29,Puntagorda,1962,990,972
38,Santa Cruz de Tenerife,30,Puntallana,2368,1174,1194
38,Santa Cruz de Tenerife,31,Realejos (Los),36746,18228,18518
38,Santa Cruz de Tenerife,32,Rosario (El),16111,8442,7669
38,Santa Cruz de Tenerife,33,San Andrés y Sauces,5020,2540,2480
38,Santa Cruz de Tenerife,23,San Cristóbal de La Laguna,142161,69995,72166
38,Santa Cruz de Tenerife,34,San Juan de la Rambla,5096,2523,2573
38,Santa Cruz de Tenerife,35,San Miguel de Abona,12609,6479,6130
38,Santa Cruz de Tenerife,36,San Sebastián de la Gomera,8451,4276,4175
38,Santa Cruz de Tenerife,37,Santa Cruz de la Palma,17640,8644,8996
38,Santa Cruz de Tenerife,38,Santa Cruz de Tenerife,223148,107638,115510
38,Santa Cruz de Tenerife,39,Santa Úrsula,12835,6431,6404
38,Santa Cruz de Tenerife,40,Santiago del Teide,11379,5776,5603
38,Santa Cruz de Tenerife,41,Sauzal (El),8514,4238,4276
38,Santa Cruz de Tenerife,42,Silos (Los),5456,2744,2712
38,Santa Cruz de Tenerife,43,Tacoronte,22695,11378,11317
38,Santa Cruz de Tenerife,44,Tanque (El),3042,1514,1528
38,Santa Cruz de Tenerife,45,Tazacorte,5830,2948,2882
38,Santa Cruz de Tenerife,46,Tegueste,10393,5157,5236
38,Santa Cruz de Tenerife,47,Tijarafe,2720,1389,1331
38,Santa Cruz de Tenerife,49,Valle Gran Rey,5040,2578,2462
38,Santa Cruz de Tenerife,50,Vallehermoso,3094,1569,1525
38,Santa Cruz de Tenerife,48,Valverde,4955,2523,2432
38,Santa Cruz de Tenerife,51,Victoria de Acentejo (La),8432,4212,4220
38,Santa Cruz de Tenerife,52,Vilaflor,1905,980,925
38,Santa Cruz de Tenerife,53,Villa de Mazo,4889,2472,2417
39,Cantabria,1,Alfoz de Lloredo,2560,1302,1258
39,Cantabria,2,Ampuero,3837,1940,1897
39,Cantabria,3,Anievas,376,185,191
39,Cantabria,4,Arenas de Iguña,1882,954,928
39,Cantabria,5,Argoños,1444,751,693
39,Cantabria,6,Arnuero,2026,1029,997
39,Cantabria,7,Arredondo,547,311,236
39,Cantabria,8,Astillero (El),16032,7795,8237
39,Cantabria,9,Bárcena de Cicero,3139,1618,1521
39,Cantabria,10,Bárcena de Pie de Concha,800,384,416
39,Cantabria,11,Bareyo,1895,975,920
39,Cantabria,12,Cabezón de la Sal,8032,3945,4087
39,Cantabria,13,Cabezón de Liébana,686,393,293
39,Cantabria,14,Cabuérniga,1096,582,514
39,Cantabria,15,Camaleño,1088,570,518
39,Cantabria,16,Camargo,30024,14963,15061
39,Cantabria,27,Campoo de Enmedio,3932,2017,1915
39,Cantabria,17,Campoo de Yuso,715,368,347
39,Cantabria,18,Cartes,4268,2186,2082
39,Cantabria,19,Castañeda,1744,879,865
39,Cantabria,20,Castro-Urdiales,28542,14424,14118
39,Cantabria,21,Cieza,660,326,334
39,Cantabria,22,Cillorigo de Liébana,1215,649,566
39,Cantabria,23,Colindres,7368,3685,3683
39,Cantabria,24,Comillas,2469,1177,1292
39,Cantabria,25,Corrales de Buelna (Los),11091,5530,5561
39,Cantabria,26,Corvera de Toranzo,2199,1106,1093
39,Cantabria,28,Entrambasaguas,2901,1472,1429
39,Cantabria,29,Escalante,800,418,382
39,Cantabria,30,Guriezo,2101,1104,997
39,Cantabria,31,Hazas de Cesto,1254,638,616
39,Cantabria,32,Hermandad de Campoo de Suso,1946,1075,871
39,Cantabria,33,Herrerías,700,393,307
39,Cantabria,34,Lamasón,326,199,127
39,Cantabria,35,Laredo,13090,6366,6724
39,Cantabria,36,Liendo,1099,567,532
39,Cantabria,37,Liérganes,2403,1208,1195
39,Cantabria,38,Limpias,1479,744,735
39,Cantabria,39,Luena,820,442,378
39,Cantabria,40,Marina de Cudeyo,5065,2570,2495
39,Cantabria,41,Mazcuerras,2018,1050,968
39,Cantabria,42,Medio Cudeyo,7201,3545,3656
39,Cantabria,43,Meruelo,1416,721,695
39,Cantabria,44,Miengo,3986,2004,1982
39,Cantabria,45,Miera,468,242,226
39,Cantabria,46,Molledo,1770,861,909
39,Cantabria,47,Noja,2292,1168,1124
39,Cantabria,48,Penagos,1679,847,832
39,Cantabria,49,Peñarrubia,380,189,191
39,Cantabria,50,Pesaguero,360,200,160
39,Cantabria,51,Pesquera,79,42,37
39,Cantabria,52,Piélagos,16578,8356,8222
39,Cantabria,53,Polaciones,251,163,88
39,Cantabria,54,Polanco,3993,1996,1997
39,Cantabria,55,Potes,1499,758,741
39,Cantabria,56,Puente Viesgo,2522,1284,1238
39,Cantabria,57,Ramales de la Victoria,2333,1202,1131
39,Cantabria,58,Rasines,999,538,461
39,Cantabria,59,Reinosa,10370,4941,5429
39,Cantabria,60,Reocín,7702,3815,3887
39,Cantabria,61,Ribamontán al Mar,4115,2098,2017
39,Cantabria,62,Ribamontán al Monte,2046,1042,1004
39,Cantabria,63,Rionansa,1215,691,524
39,Cantabria,64,Riotuerto,1536,746,790
39,Cantabria,65,Rozas de Valdearroyo (Las),292,163,129
39,Cantabria,66,Ruente,1001,541,460
39,Cantabria,67,Ruesga,1109,578,531
39,Cantabria,68,Ruiloba,762,394,368
39,Cantabria,69,San Felices de Buelna,2239,1112,1127
39,Cantabria,70,San Miguel de Aguayo,142,71,71
39,Cantabria,71,San Pedro del Romeral,561,305,256
39,Cantabria,72,San Roque de Riomiera,461,266,195
39,Cantabria,80,San Vicente de la Barquera,4491,2283,2208
39,Cantabria,73,Santa Cruz de Bezana,10314,5079,5235
39,Cantabria,74,Santa María de Cayón,7377,3726,3651
39,Cantabria,75,Santander,182926,85243,97683
39,Cantabria,76,Santillana del Mar,3983,1935,2048
39,Cantabria,77,Santiurde de Reinosa,325,186,139
39,Cantabria,78,Santiurde de Toranzo,1359,678,681
39,Cantabria,79,Santoña,11534,5722,5812
39,Cantabria,81,Saro,510,266,244
39,Cantabria,82,Selaya,1981,1005,976
39,Cantabria,83,Soba,1462,772,690
39,Cantabria,84,Solórzano,1052,549,503
39,Cantabria,85,Suances,7393,3685,3708
39,Cantabria,86,Tojos (Los),412,238,174
39,Cantabria,87,Torrelavega,56143,26995,29148
39,Cantabria,88,Tresviso,76,46,30
39,Cantabria,89,Tudanca,201,126,75
39,Cantabria,90,Udías,843,437,406
39,Cantabria,95,Val de San Vicente,2670,1389,1281
39,Cantabria,91,Valdáliga,2414,1262,1152
39,Cantabria,92,Valdeolea,1301,658,643
39,Cantabria,93,Valdeprado del Río,291,162,129
39,Cantabria,94,Valderredible,1127,606,521
39,Cantabria,101,Valle de Villaverde,373,195,178
39,Cantabria,96,Vega de Liébana,936,505,431
39,Cantabria,97,Vega de Pas,909,481,428
39,Cantabria,98,Villacarriedo,1736,915,821
39,Cantabria,99,Villaescusa,3481,1762,1719
39,Cantabria,100,Villafufre,1078,558,520
39,Cantabria,102,Voto,2367,1236,1131
40,Segovia,1,Abades,887,453,434
40,Segovia,2,Adrada de Pirón,45,24,21
40,Segovia,3,Adrados,208,115,93
40,Segovia,4,Aguilafuente,761,367,394
40,Segovia,5,Alconada de Maderuelo,53,31,22
40,Segovia,12,Aldea Real,374,198,176
40,Segovia,6,Aldealcorvo,18,9,9
40,Segovia,7,Aldealengua de Pedraza,102,58,44
40,Segovia,8,Aldealengua de Santa María,85,50,35
40,Segovia,9,Aldeanueva de la Serrezuela,50,31,19
40,Segovia,10,Aldeanueva del Codonal,179,95,84
40,Segovia,13,Aldeasoña,81,43,38
40,Segovia,14,Aldehorno,59,29,30
40,Segovia,15,Aldehuela del Codonal,39,21,18
40,Segovia,16,Aldeonte,91,44,47
40,Segovia,17,Anaya,143,76,67
40,Segovia,18,Añe,116,64,52
40,Segovia,19,Arahuetes,59,32,27
40,Segovia,20,Arcones,254,132,122
40,Segovia,21,Arevalillo de Cega,44,22,22
40,Segovia,22,Armuña,241,130,111
40,Segovia,24,Ayllón,1244,632,612
40,Segovia,25,Barbolla,212,116,96
40,Segovia,26,Basardilla,147,67,80
40,Segovia,28,Bercial,113,55,58
40,Segovia,29,Bercimuel,75,36,39
40,Segovia,30,Bernardos,628,329,299
40,Segovia,31,Bernuy de Porreros,455,241,214
40,Segovia,32,Boceguillas,689,344,345
40,Segovia,33,Brieva,76,50,26
40,Segovia,34,Caballar,101,48,53
40,Segovia,35,Cabañas de Polendos,129,69,60
40,Segovia,36,Cabezuela,692,364,328
40,Segovia,37,Calabazas de Fuentidueña,60,30,30
40,Segovia,39,Campo de San Pedro,367,215,152
40,Segovia,40,Cantalejo,3671,1859,1812
40,Segovia,41,Cantimpalos,1371,718,653
40,Segovia,43,Carbonero el Mayor,2449,1238,1211
40,Segovia,44,Carrascal del Río,200,106,94
40,Segovia,45,Casla,153,80,73
40,Segovia,46,Castillejo de Mesleón,157,95,62
40,Segovia,47,Castro de Fuentidueña,66,35,31
40,Segovia,48,Castrojimeno,41,25,16
40,Segovia,49,Castroserna de Abajo,48,25,23
40,Segovia,51,Castroserracín,43,27,16
40,Segovia,52,Cedillo de la Torre,108,51,57
40,Segovia,53,Cerezo de Abajo,180,92,88
40,Segovia,54,Cerezo de Arriba,213,115,98
40,Segovia,65,Chañe,766,404,362
40,Segovia,55,Cilleruelo de San Mamés,42,19,23
40,Segovia,56,Cobos de Fuentidueña,50,21,29
40,Segovia,57,Coca,2103,999,1104
40,Segovia,58,Codorniz,432,213,219
40,Segovia,59,Collado Hermoso,162,81,81
40,Segovia,60,Condado de Castilnovo,126,67,59
40,Segovia,61,Corral de Ayllón,89,49,40
40,Segovia,902,Cozuelos de Fuentidueña,160,90,70
40,Segovia,62,Cubillo,55,32,23
40,Segovia,63,Cuéllar,9540,4866,4674
40,Segovia,905,Cuevas de Provanco,166,86,80
40,Segovia,68,Domingo García,48,25,23
40,Segovia,69,Donhierro,110,56,54
40,Segovia,70,Duruelo,138,78,60
40,Segovia,71,Encinas,60,31,29
40,Segovia,72,Encinillas,87,49,38
40,Segovia,73,Escalona del Prado,593,317,276
40,Segovia,74,Escarabajosa de Cabezas,353,201,152
40,Segovia,75,Escobar de Polendos,229,119,110
40,Segovia,76,Espinar (El),8230,4256,3974
40,Segovia,77,Espirdo,539,293,246
40,Segovia,78,Fresneda de Cuéllar,210,112,98
40,Segovia,79,Fresno de Cantespino,281,156,125
40,Segovia,80,Fresno de la Fuente,108,61,47
40,Segovia,81,Frumales,185,89,96
40,Segovia,82,Fuente de Santa Cruz,156,77,79
40,Segovia,83,Fuente el Olmo de Fuentidueña,118,63,55
40,Segovia,84,Fuente el Olmo de Íscar,89,50,39
40,Segovia,86,Fuentepelayo,1001,519,482
40,Segovia,87,Fuentepiñel,135,71,64
40,Segovia,88,Fuenterrebollo,375,197,178
40,Segovia,89,Fuentesaúco de Fuentidueña,310,161,149
40,Segovia,91,Fuentesoto,153,83,70
40,Segovia,92,Fuentidueña,143,76,67
40,Segovia,93,Gallegos,96,49,47
40,Segovia,94,Garcillán,410,215,195
40,Segovia,95,Gomezserracín,705,364,341
40,Segovia,97,Grajera,117,62,55
40,Segovia,99,Honrubia de la Cuesta,88,49,39
40,Segovia,100,Hontalbilla,377,204,173
40,Segovia,101,Hontanares de Eresma,428,245,183
40,Segovia,103,Huertos (Los),146,74,72
40,Segovia,104,Ituero y Lama,131,76,55
40,Segovia,105,Juarros de Riomoros,79,45,34
40,Segovia,106,Juarros de Voltoya,274,137,137
40,Segovia,107,Labajos,144,80,64
40,Segovia,108,Laguna de Contreras,152,88,64
40,Segovia,109,Languilla,106,56,50
40,Segovia,110,Lastras de Cuéllar,454,236,218
40,Segovia,111,Lastras del Pozo,91,43,48
40,Segovia,112,Lastrilla (La),2649,1377,1272
40,Segovia,113,Losa (La),488,257,231
40,Segovia,115,Maderuelo,140,74,66
40,Segovia,903,Marazoleja,128,73,55
40,Segovia,118,Marazuela,59,32,27
40,Segovia,119,Martín Miguel,199,112,87
40,Segovia,120,Martín Muñoz de la Dehesa,182,97,85
40,Segovia,121,Martín Muñoz de las Posadas,393,185,208
40,Segovia,122,Marugán,553,307,246
40,Segovia,124,Mata de Cuéllar,313,165,148
40,Segovia,123,Matabuena,220,117,103
40,Segovia,125,Matilla (La),115,63,52
40,Segovia,126,Melque de Cercos,101,50,51
40,Segovia,127,Membibre de la Hoz,48,25,23
40,Segovia,128,Migueláñez,168,75,93
40,Segovia,129,Montejo de Arévalo,258,141,117
40,Segovia,130,Montejo de la Vega de la Serrezuela,174,95,79
40,Segovia,131,Monterrubio,63,35,28
40,Segovia,132,Moral de Hornuez,100,57,43
40,Segovia,134,Mozoncillo,1051,540,511
40,Segovia,135,Muñopedro,370,197,173
40,Segovia,136,Muñoveros,202,105,97
40,Segovia,138,Nava de la Asunción,2881,1471,1410
40,Segovia,139,Navafría,354,187,167
40,Segovia,140,Navalilla,123,61,62
40,Segovia,141,Navalmanzano,1150,592,558
40,Segovia,142,Navares de Ayuso,66,37,29
40,Segovia,143,Navares de Enmedio,120,66,54
40,Segovia,144,Navares de las Cuevas,34,22,12
40,Segovia,145,Navas de Oro,1468,747,721
40,Segovia,904,Navas de Riofrío,353,171,182
40,Segovia,146,Navas de San Antonio,324,170,154
40,Segovia,148,Nieva,337,179,158
40,Segovia,149,Olombrada,750,404,346
40,Segovia,150,Orejana,83,53,30
40,Segovia,151,Ortigosa de Pestaño,121,65,56
40,Segovia,901,Ortigosa del Monte,476,250,226
40,Segovia,152,Otero de Herreros,926,466,460
40,Segovia,154,Pajarejos,41,21,20
40,Segovia,155,Palazuelos de Eresma,3142,1656,1486
40,Segovia,156,Pedraza,477,264,213
40,Segovia,157,Pelayos del Arroyo,60,30,30
40,Segovia,158,Perosillo,24,15,9
40,Segovia,159,Pinarejos,158,92,66
40,Segovia,160,Pinarnegrillo,159,90,69
40,Segovia,161,Pradales,64,35,29
40,Segovia,162,Prádena,615,339,276
40,Segovia,163,Puebla de Pedraza,85,44,41
40,Segovia,164,Rapariegos,255,133,122
40,Segovia,165,Rebollo,120,66,54
40,Segovia,166,Remondo,335,162,173
40,Segovia,168,Riaguas de San Bartolomé,67,39,28
40,Segovia,170,Riaza,2224,1219,1005
40,Segovia,171,Ribota,39,22,17
40,Segovia,172,Riofrío de Riaza,51,24,27
40,Segovia,173,Roda de Eresma,147,86,61
40,Segovia,174,Sacramenia,517,269,248
40,Segovia,176,Samboal,531,267,264
40,Segovia,177,San Cristóbal de Cuéllar,206,107,99
40,Segovia,178,San Cristóbal de la Vega,145,73,72
40,Segovia,906,San Cristóbal de Segovia,2596,1319,1277
40,Segovia,181,San Ildefonso,5468,2671,2797
40,Segovia,182,San Martín y Mudrián,259,129,130
40,Segovia,183,San Miguel de Bernuy,195,99,96
40,Segovia,184,San Pedro de Gaíllos,343,177,166
40,Segovia,179,Sanchonuño,833,413,420
40,Segovia,180,Sangarcía,459,234,225
40,Segovia,185,Santa María la Real de Nieva,1289,671,618
40,Segovia,186,Santa Marta del Cerro,53,25,28
40,Segovia,188,Santiuste de Pedraza,122,67,55
40,Segovia,189,Santiuste de San Juan Bautista,704,371,333
40,Segovia,190,Santo Domingo de Pirón,63,31,32
40,Segovia,191,Santo Tomé del Puerto,331,186,145
40,Segovia,192,Sauquillo de Cabezas,218,118,100
40,Segovia,193,Sebúlcor,264,146,118
40,Segovia,194,Segovia,55476,26628,28848
40,Segovia,195,Sepúlveda,1316,681,635
40,Segovia,196,Sequera de Fresno,65,36,29
40,Segovia,198,Sotillo,36,18,18
40,Segovia,199,Sotosalbos,105,59,46
40,Segovia,200,Tabanera la Luenga,77,41,36
40,Segovia,201,Tolocirio,57,28,29
40,Segovia,206,Torre Val de San Pedro,192,106,86
40,Segovia,202,Torreadrada,110,48,62
40,Segovia,203,Torrecaballeros,872,444,428
40,Segovia,204,Torrecilla del Pinar,267,132,135
40,Segovia,205,Torreiglesias,369,194,175
40,Segovia,207,Trescasas,569,298,271
40,Segovia,208,Turégano,1158,584,574
40,Segovia,210,Urueñas,110,61,49
40,Segovia,211,Valdeprados,113,57,56
40,Segovia,212,Valdevacas de Montejo,33,20,13
40,Segovia,213,Valdevacas y Guijar,148,78,70
40,Segovia,218,Valle de Tabladillo,144,77,67
40,Segovia,219,Vallelado,814,417,397
40,Segovia,220,Valleruela de Pedraza,88,46,42
40,Segovia,221,Valleruela de Sepúlveda,65,30,35
40,Segovia,214,Valseca,310,164,146
40,Segovia,215,Valtiendas,153,86,67
40,Segovia,216,Valverde del Majano,680,343,337
40,Segovia,222,Veganzones,294,154,140
40,Segovia,223,Vegas de Matute,269,163,106
40,Segovia,224,Ventosilla y Tejadilla,42,27,15
40,Segovia,225,Villacastín,1600,832,768
40,Segovia,228,Villaverde de Íscar,672,343,329
40,Segovia,229,Villaverde de Montejo,58,37,21
40,Segovia,230,Villeguillo,135,74,61
40,Segovia,231,Yanguas de Eresma,186,91,95
40,Segovia,233,Zarzuela del Monte,546,288,258
40,Segovia,234,Zarzuela del Pinar,553,291,262
41,Sevilla,1,Aguadulce,2010,1013,997
41,Sevilla,2,Alanís,1890,946,944
41,Sevilla,3,Albaida del Aljarafe,2351,1199,1152
41,Sevilla,4,Alcalá de Guadaíra,64990,32421,32569
41,Sevilla,5,Alcalá del Río,9484,4825,4659
41,Sevilla,6,Alcolea del Río,3356,1660,1696
41,Sevilla,7,Algaba (La),13764,6893,6871
41,Sevilla,8,Algámitas,1330,685,645
41,Sevilla,9,Almadén de la Plata,1649,840,809
41,Sevilla,10,Almensilla,4927,2501,2426
41,Sevilla,11,Arahal,18861,9348,9513
41,Sevilla,12,Aznalcázar,3793,1925,1868
41,Sevilla,13,Aznalcóllar,6094,3135,2959
41,Sevilla,14,Badolatosa,3200,1647,1553
41,Sevilla,15,Benacazón,5921,3025,2896
41,Sevilla,16,Bollullos de la Mitación,7084,3515,3569
41,Sevilla,17,Bormujos,15741,7872,7869
41,Sevilla,18,Brenes,11820,5956,5864
41,Sevilla,19,Burguillos,4510,2286,2224
41,Sevilla,20,Cabezas de San Juan (Las),16139,8237,7902
41,Sevilla,21,Camas,25706,12567,13139
41,Sevilla,22,Campana (La),5260,2630,2630
41,Sevilla,23,Cantillana,9744,4986,4758
41,Sevilla,901,Cañada Rosal,3103,1536,1567
41,Sevilla,24,Carmona,27221,13751,13470
41,Sevilla,25,Carrión de los Céspedes,2267,1082,1185
41,Sevilla,26,Casariche,5414,2738,2676
41,Sevilla,27,Castilblanco de los Arroyos,4870,2445,2425
41,Sevilla,28,Castilleja de Guzmán,2512,1295,1217
41,Sevilla,29,Castilleja de la Cuesta,16878,8303,8575
41,Sevilla,30,Castilleja del Campo,651,321,330
41,Sevilla,31,Castillo de las Guardas (El),1627,830,797
41,Sevilla,32,Cazalla de la Sierra,5153,2558,2595
41,Sevilla,33,Constantina,6757,3327,3430
41,Sevilla,34,Coria del Río,26499,13283,13216
41,Sevilla,35,Coripe,1436,740,696
41,Sevilla,36,Coronil (El),5033,2552,2481
41,Sevilla,37,Corrales (Los),4088,2088,2000
41,Sevilla,903,Cuervo de Sevilla (El),8301,4232,4069
41,Sevilla,38,Dos Hermanas,114672,56871,57801
41,Sevilla,39,Écija,39295,19361,19934
41,Sevilla,40,Espartinas,9177,4604,4573
41,Sevilla,41,Estepa,12296,6087,6209
41,Sevilla,42,Fuentes de Andalucía,7353,3662,3691
41,Sevilla,43,Garrobo (El),812,414,398
41,Sevilla,44,Gelves,8325,4138,4187
41,Sevilla,45,Gerena,5887,2948,2939
41,Sevilla,46,Gilena,3898,1961,1937
41,Sevilla,47,Gines,12338,6089,6249
41,Sevilla,48,Guadalcanal,2970,1475,1495
41,Sevilla,49,Guillena,9318,4691,4627
41,Sevilla,50,Herrera,6342,3146,3196
41,Sevilla,51,Huévar del Aljarafe,2461,1271,1190
41,Sevilla,902,Isla Mayor,5798,2908,2890
41,Sevilla,52,Lantejuela (La),3795,1941,1854
41,Sevilla,53,Lebrija,25165,12689,12476
41,Sevilla,54,Lora de Estepa,831,415,416
41,Sevilla,55,Lora del Río,19077,9495,9582
41,Sevilla,56,Luisiana (La),4523,2285,2238
41,Sevilla,57,Madroño (El),361,190,171
41,Sevilla,58,Mairena del Alcor,18710,9358,9352
41,Sevilla,59,Mairena del Aljarafe,39065,19565,19500
41,Sevilla,60,Marchena,19089,9500,9589
41,Sevilla,61,Marinaleda,2689,1362,1327
41,Sevilla,62,Martín de la Jara,2737,1415,1322
41,Sevilla,63,Molares (Los),2947,1519,1428
41,Sevilla,64,Montellano,6983,3506,3477
41,Sevilla,65,Morón de la Frontera,28295,14103,14192
41,Sevilla,66,Navas de la Concepción (Las),1794,887,907
41,Sevilla,67,Olivares,8814,4447,4367
41,Sevilla,68,Osuna,17594,8682,8912
41,Sevilla,69,Palacios y Villafranca (Los),35225,17812,17413
41,Sevilla,70,Palomares del Río,5115,2580,2535
41,Sevilla,71,Paradas,7027,3516,3511
41,Sevilla,72,Pedrera,5136,2545,2591
41,Sevilla,73,Pedroso (El),2296,1128,1168
41,Sevilla,74,Peñaflor,3719,1881,1838
41,Sevilla,75,Pilas,12171,6120,6051
41,Sevilla,76,Pruna,3006,1547,1459
41,Sevilla,77,Puebla de Cazalla (La),10952,5466,5486
41,Sevilla,78,Puebla de los Infantes (La),3292,1648,1644
41,Sevilla,79,Puebla del Río (La),11570,5759,5811
41,Sevilla,80,Real de la Jara (El),1637,782,855
41,Sevilla,81,Rinconada (La),33370,16783,16587
41,Sevilla,82,Roda de Andalucía (La),4382,2185,2197
41,Sevilla,83,Ronquillo (El),1392,717,675
41,Sevilla,84,Rubio (El),3566,1771,1795
41,Sevilla,85,Salteras,4391,2156,2235
41,Sevilla,86,San Juan de Aznalfarache,20121,9764,10357
41,Sevilla,88,San Nicolás del Puerto,682,339,343
41,Sevilla,87,Sanlúcar la Mayor,11945,5949,5996
41,Sevilla,89,Santiponce,7742,3875,3867
41,Sevilla,90,Saucejo (El),4379,2194,2185
41,Sevilla,91,Sevilla,704414,335792,368622
41,Sevilla,92,Tocina,9166,4551,4615
41,Sevilla,93,Tomares,20705,10276,10429
41,Sevilla,94,Umbrete,6385,3194,3191
41,Sevilla,95,Utrera,48222,24380,23842
41,Sevilla,96,Valencina de la Concepción,7650,3830,3820
41,Sevilla,97,Villamanrique de la Condesa,3936,1930,2006
41,Sevilla,100,Villanueva de San Juan,1420,709,711
41,Sevilla,98,Villanueva del Ariscal,5724,2822,2902
41,Sevilla,99,Villanueva del Río y Minas,5217,2543,2674
41,Sevilla,101,Villaverde del Río,6780,3452,3328
41,Sevilla,102,Viso del Alcor (El),17497,8793,8704
42,Soria,1,Abejar,406,212,194
42,Soria,3,Adradas,79,45,34
42,Soria,4,Ágreda,3212,1617,1595
42,Soria,6,Alconaba,165,99,66
42,Soria,7,Alcubilla de Avellaneda,177,88,89
42,Soria,8,Alcubilla de las Peñas,67,34,33
42,Soria,9,Aldealafuente,120,64,56
42,Soria,10,Aldealices,29,13,16
42,Soria,11,Aldealpozo,26,13,13
42,Soria,12,Aldealseñor,43,25,18
42,Soria,13,Aldehuela de Periáñez,49,26,23
42,Soria,14,Aldehuelas (Las),102,53,49
42,Soria,15,Alentisque,38,18,20
42,Soria,16,Aliud,25,14,11
42,Soria,17,Almajano,211,116,95
42,Soria,18,Almaluez,234,124,110
42,Soria,19,Almarza,637,357,280
42,Soria,20,Almazán,5727,2854,2873
42,Soria,21,Almazul,121,64,57
42,Soria,22,Almenar de Soria,338,181,157
42,Soria,23,Alpanseque,93,48,45
42,Soria,24,Arancón,105,63,42
42,Soria,25,Arcos de Jalón,1863,953,910
42,Soria,26,Arenillas,29,18,11
42,Soria,27,Arévalo de la Sierra,80,48,32
42,Soria,28,Ausejo de la Sierra,64,33,31
42,Soria,29,Baraona,198,106,92
42,Soria,30,Barca,113,72,41
42,Soria,31,Barcones,35,20,15
42,Soria,32,Bayubas de Abajo,240,129,111
42,Soria,33,Bayubas de Arriba,63,34,29
42,Soria,34,Beratón,45,28,17
42,Soria,35,Berlanga de Duero,1080,543,537
42,Soria,36,Blacos,67,35,32
42,Soria,37,Bliecos,41,25,16
42,Soria,38,Borjabad,49,29,20
42,Soria,39,Borobia,334,174,160
42,Soria,41,Buberos,43,24,19
42,Soria,42,Buitrago,55,25,30
42,Soria,43,Burgo de Osma-Ciudad de Osma,5055,2513,2542
42,Soria,44,Cabrejas del Campo,75,39,36
42,Soria,45,Cabrejas del Pinar,432,239,193
42,Soria,46,Calatañazor,61,34,27
42,Soria,48,Caltojar,97,54,43
42,Soria,49,Candilichera,185,97,88
42,Soria,50,Cañamaque,36,23,13
42,Soria,51,Carabantes,31,16,15
42,Soria,52,Caracena,20,15,5
42,Soria,53,Carrascosa de Abajo,34,20,14
42,Soria,54,Carrascosa de la Sierra,14,9,5
42,Soria,55,Casarejos,244,126,118
42,Soria,56,Castilfrío de la Sierra,28,20,8
42,Soria,58,Castillejo de Robledo,160,91,69
42,Soria,57,Castilruiz,258,130,128
42,Soria,59,Centenera de Andaluz,25,9,16
42,Soria,60,Cerbón,42,24,18
42,Soria,61,Cidones,346,197,149
42,Soria,62,Cigudosa,50,30,20
42,Soria,63,Cihuela,80,41,39
42,Soria,64,Ciria,105,54,51
42,Soria,65,Cirujales del Río,33,17,16
42,Soria,68,Coscurita,124,68,56
42,Soria,69,Covaleda,1992,1028,964
42,Soria,70,Cubilla,61,32,29
42,Soria,71,Cubo de la Solana,232,123,109
42,Soria,73,Cueva de Ágreda,91,48,43
42,Soria,75,Dévanos,108,57,51
42,Soria,76,Deza,320,158,162
42,Soria,78,Duruelo de la Sierra,1391,699,692
42,Soria,79,Escobosa de Almazán,39,23,16
42,Soria,80,Espeja de San Marcelino,224,131,93
42,Soria,81,Espejón,208,107,101
42,Soria,82,Estepa de San Juan,10,5,5
42,Soria,83,Frechilla de Almazán,32,16,16
42,Soria,84,Fresno de Caracena,31,17,14
42,Soria,85,Fuentearmegil,268,144,124
42,Soria,86,Fuentecambrón,56,30,26
42,Soria,87,Fuentecantos,57,28,29
42,Soria,88,Fuentelmonge,105,61,44
42,Soria,89,Fuentelsaz de Soria,57,26,31
42,Soria,90,Fuentepinilla,130,73,57
42,Soria,92,Fuentes de Magaña,75,38,37
42,Soria,93,Fuentestrún,61,37,24
42,Soria,94,Garray,500,280,220
42,Soria,95,Golmayo,1527,822,705
42,Soria,96,Gómara,407,215,192
42,Soria,97,Gormaz,19,6,13
42,Soria,98,Herrera de Soria,15,10,5
42,Soria,100,Hinojosa del Campo,37,24,13
42,Soria,103,Langa de Duero,864,479,385
42,Soria,105,Liceras,57,28,29
42,Soria,106,Losilla (La),13,9,4
42,Soria,107,Magaña,102,55,47
42,Soria,108,Maján,14,8,6
42,Soria,110,Matalebreras,111,55,56
42,Soria,111,Matamala de Almazán,372,196,176
42,Soria,113,Medinaceli,710,353,357
42,Soria,115,Miño de Medinaceli,104,55,49
42,Soria,116,Miño de San Esteban,73,41,32
42,Soria,117,Molinos de Duero,185,96,89
42,Soria,118,Momblona,36,21,15
42,Soria,119,Monteagudo de las Vicarías,252,138,114
42,Soria,120,Montejo de Tiermes,255,147,108
42,Soria,121,Montenegro de Cameros,100,61,39
42,Soria,123,Morón de Almazán,239,107,132
42,Soria,124,Muriel de la Fuente,79,48,31
42,Soria,125,Muriel Viejo,66,32,34
42,Soria,127,Nafría de Ucero,75,41,34
42,Soria,128,Narros,48,24,24
42,Soria,129,Navaleno,964,495,469
42,Soria,130,Nepas,79,49,30
42,Soria,131,Nolay,77,42,35
42,Soria,132,Noviercas,206,108,98
42,Soria,134,Ólvega,3484,1808,1676
42,Soria,135,Oncala,104,63,41
42,Soria,139,Pinilla del Campo,21,12,9
42,Soria,140,Portillo de Soria,19,11,8
42,Soria,141,Póveda de Soria (La),128,68,60
42,Soria,142,Pozalmuro,105,54,51
42,Soria,144,Quintana Redonda,567,297,270
42,Soria,145,Quintanas de Gormaz,174,94,80
42,Soria,148,Quiñonería,14,5,9
42,Soria,149,Rábanos (Los),463,271,192
42,Soria,151,Rebollar,55,26,29
42,Soria,152,Recuerda,102,56,46
42,Soria,153,Rello,31,16,15
42,Soria,154,Renieblas,116,65,51
42,Soria,155,Retortillo de Soria,252,129,123
42,Soria,156,Reznos,39,26,13
42,Soria,157,Riba de Escalote (La),24,14,10
42,Soria,158,Rioseco de Soria,129,70,59
42,Soria,159,Rollamienta,42,26,16
42,Soria,160,Royo (El),320,171,149
42,Soria,161,Salduero,188,101,87
42,Soria,162,San Esteban de Gormaz,3263,1685,1578
42,Soria,163,San Felices,70,37,33
42,Soria,164,San Leonardo de Yagüe,2294,1181,1113
42,Soria,165,San Pedro Manrique,562,305,257
42,Soria,166,Santa Cruz de Yanguas,64,39,25
42,Soria,167,Santa María de Huerta,396,215,181
42,Soria,168,Santa María de las Hoyas,183,98,85
42,Soria,171,Serón de Nágima,262,139,123
42,Soria,172,Soliedra,38,20,18
42,Soria,173,Soria,38004,18182,19822
42,Soria,174,Sotillo del Rincón,207,108,99
42,Soria,175,Suellacabras,32,21,11
42,Soria,176,Tajahuerce,37,18,19
42,Soria,177,Tajueco,102,54,48
42,Soria,178,Talveila,172,92,80
42,Soria,181,Tardelcuende,557,274,283
42,Soria,182,Taroda,69,34,35
42,Soria,183,Tejado,176,88,88
42,Soria,184,Torlengua,100,49,51
42,Soria,185,Torreblacos,31,16,15
42,Soria,187,Torrubia de Soria,85,47,38
42,Soria,188,Trévago,68,27,41
42,Soria,189,Ucero,102,50,52
42,Soria,190,Vadillo,132,64,68
42,Soria,191,Valdeavellano de Tera,245,130,115
42,Soria,192,Valdegeña,54,33,21
42,Soria,193,Valdelagua del Cerro,17,10,7
42,Soria,194,Valdemaluque,262,128,134
42,Soria,195,Valdenebro,138,70,68
42,Soria,196,Valdeprado,15,9,6
42,Soria,197,Valderrodilla,101,54,47
42,Soria,198,Valtajeros,24,15,9
42,Soria,200,Velamazán,118,73,45
42,Soria,201,Velilla de la Sierra,31,16,15
42,Soria,202,Velilla de los Ajos,38,22,16
42,Soria,204,Viana de Duero,72,44,28
42,Soria,205,Villaciervos,115,65,50
42,Soria,206,Villanueva de Gormaz,19,11,8
42,Soria,207,Villar del Ala,61,31,30
42,Soria,208,Villar del Campo,29,18,11
42,Soria,209,Villar del Río,189,103,86
42,Soria,211,Villares de Soria (Los),102,55,47
42,Soria,212,Villasayas,100,64,36
42,Soria,213,Villaseca de Arciel,41,24,17
42,Soria,215,Vinuesa,1014,548,466
42,Soria,216,Vizmanos,33,21,12
42,Soria,217,Vozmediano,48,28,20
42,Soria,218,Yanguas,124,65,59
42,Soria,219,Yelo,58,31,27
43,Tarragona,1,Aiguamúrcia,797,429,368
43,Tarragona,2,Albinyana,2140,1104,1036
43,Tarragona,3,Albiol (L'),348,184,164
43,Tarragona,4,Alcanar,9620,4975,4645
43,Tarragona,5,Alcover,4500,2323,2177
43,Tarragona,904,Aldea (L'),3795,1995,1800
43,Tarragona,6,Aldover,893,441,452
43,Tarragona,7,Aleixar (L'),815,409,406
43,Tarragona,8,Alfara de Carles,341,183,158
43,Tarragona,9,Alforja,1584,821,763
43,Tarragona,10,Alió,376,197,179
43,Tarragona,11,Almoster,1241,631,610
43,Tarragona,12,Altafulla,4274,2142,2132
43,Tarragona,13,Ametlla de Mar (L'),6744,3453,3291
43,Tarragona,906,Ampolla (L'),2613,1333,1280
43,Tarragona,14,Amposta,19142,9721,9421
43,Tarragona,16,Arboç (L'),4802,2586,2216
43,Tarragona,15,Arbolí,105,57,48
43,Tarragona,17,Argentera (L'),155,89,66
43,Tarragona,18,Arnes,510,267,243
43,Tarragona,19,Ascó,1602,812,790
43,Tarragona,20,Banyeres del Penedès,2557,1333,1224
43,Tarragona,21,Barberà de la Conca,503,263,240
43,Tarragona,22,Batea,2106,1083,1023
43,Tarragona,23,Bellmunt del Priorat,324,163,161
43,Tarragona,24,Bellvei,1748,931,817
43,Tarragona,25,Benifallet,790,392,398
43,Tarragona,26,Benissanet,1205,634,571
43,Tarragona,27,Bisbal de Falset (La),266,138,128
43,Tarragona,28,Bisbal del Penedès (La),2815,1476,1339
43,Tarragona,29,Blancafort,414,220,194
43,Tarragona,30,Bonastre,534,282,252
43,Tarragona,31,Borges del Camp (Les),1914,960,954
43,Tarragona,32,Bot,736,379,357
43,Tarragona,33,Botarell,963,513,450
43,Tarragona,34,Bràfim,650,341,309
43,Tarragona,35,Cabacés,342,183,159
43,Tarragona,36,Cabra del Camp,944,508,436
43,Tarragona,37,Calafell,20521,10488,10033
43,Tarragona,903,Camarles,3371,1735,1636
43,Tarragona,38,Cambrils,27848,13915,13933
43,Tarragona,39,Capafonts,114,60,54
43,Tarragona,40,Capçanes,408,199,209
43,Tarragona,41,Caseres,311,152,159
43,Tarragona,42,Castellvell del Camp,2474,1246,1228
43,Tarragona,43,Catllar (El),3519,1833,1686
43,Tarragona,45,Colldejou,190,105,85
43,Tarragona,46,Conesa,141,79,62
43,Tarragona,47,Constantí,5813,3119,2694
43,Tarragona,48,Corbera d'Ebre,1128,603,525
43,Tarragona,49,Cornudella de Montsant,979,513,466
43,Tarragona,50,Creixell,2758,1417,1341
43,Tarragona,51,Cunit,10033,5195,4838
43,Tarragona,901,Deltebre,10811,5457,5354
43,Tarragona,53,Duesaigües,211,128,83
43,Tarragona,54,Espluga de Francolí (L'),3857,1915,1942
43,Tarragona,55,Falset,2717,1373,1344
43,Tarragona,56,Fatarella (La),1160,585,575
43,Tarragona,57,Febró (La),58,35,23
43,Tarragona,58,Figuera (La),165,87,78
43,Tarragona,59,Figuerola del Camp,336,153,183
43,Tarragona,60,Flix,3960,2024,1936
43,Tarragona,61,Forès,57,32,25
43,Tarragona,62,Freginals,444,236,208
43,Tarragona,63,Galera (La),824,411,413
43,Tarragona,64,Gandesa,3091,1604,1487
43,Tarragona,65,Garcia,534,279,255
43,Tarragona,66,Garidells (Els),196,100,96
43,Tarragona,67,Ginestar,965,514,451
43,Tarragona,68,Godall,771,399,372
43,Tarragona,69,Gratallops,246,135,111
43,Tarragona,70,Guiamets (Els),330,175,155
43,Tarragona,71,Horta de Sant Joan,1238,667,571
43,Tarragona,72,Lloar (El),111,61,50
43,Tarragona,73,Llorac,116,59,57
43,Tarragona,74,Llorenç del Penedès,2073,1016,1057
43,Tarragona,76,Marçà,653,328,325
43,Tarragona,75,Margalef,128,70,58
43,Tarragona,77,Mas de Barberans,679,342,337
43,Tarragona,78,Masdenverge,1077,569,508
43,Tarragona,79,Masllorenç,500,258,242
43,Tarragona,80,Masó (La),280,135,145
43,Tarragona,81,Maspujols,529,271,258
43,Tarragona,82,Masroig (El),538,272,266
43,Tarragona,83,Milà (El),180,84,96
43,Tarragona,84,Miravet,796,419,377
43,Tarragona,85,Molar (El),302,166,136
43,Tarragona,86,Montblanc,6767,3422,3345
43,Tarragona,88,Montbrió del Camp,1774,916,858
43,Tarragona,89,Montferri,258,138,120
43,Tarragona,90,Montmell (El),1175,637,538
43,Tarragona,91,Mont-ral,179,99,80
43,Tarragona,92,Mont-roig del Camp,9456,4884,4572
43,Tarragona,93,Móra d'Ebre,5098,2518,2580
43,Tarragona,94,Móra la Nova,3216,1667,1549
43,Tarragona,95,Morell (El),2704,1415,1289
43,Tarragona,96,Morera de Montsant (La),165,95,70
43,Tarragona,97,Nou de Gaià (La),449,229,220
43,Tarragona,98,Nulles,382,192,190
43,Tarragona,100,Pallaresos (Els),3346,1727,1619
43,Tarragona,99,Palma d'Ebre (La),398,190,208
43,Tarragona,101,Passanant i Belltall,174,93,81
43,Tarragona,102,Paüls,602,301,301
43,Tarragona,103,Perafort,901,480,421
43,Tarragona,104,Perelló (El),2504,1327,1177
43,Tarragona,105,Piles (Les),196,112,84
43,Tarragona,106,Pinell de Brai (El),1112,571,541
43,Tarragona,107,Pira,475,236,239
43,Tarragona,108,Pla de Santa Maria (El),2009,1061,948
43,Tarragona,109,Pobla de Mafumet (La),1465,724,741
43,Tarragona,110,Pobla de Massaluca (La),407,216,191
43,Tarragona,111,Pobla de Montornès (La),2339,1238,1101
43,Tarragona,112,Poboleda,353,200,153
43,Tarragona,113,Pont d'Armentera (El),580,296,284
43,Tarragona,141,Pontils,139,71,68
43,Tarragona,114,Porrera,488,266,222
43,Tarragona,115,Pradell de la Teixeta,178,88,90
43,Tarragona,116,Prades,622,323,299
43,Tarragona,117,Prat de Comte,196,97,99
43,Tarragona,118,Pratdip,715,383,332
43,Tarragona,119,Puigpelat,829,436,393
43,Tarragona,120,Querol,416,218,198
43,Tarragona,121,Rasquera,934,480,454
43,Tarragona,122,Renau,93,44,49
43,Tarragona,123,Reus,101767,50697,51070
43,Tarragona,124,Riba (La),682,373,309
43,Tarragona,125,Riba-roja d'Ebre,1353,706,647
43,Tarragona,126,Riera de Gaià (La),1332,685,647
43,Tarragona,127,Riudecanyes,878,447,431
43,Tarragona,128,Riudecols,1133,590,543
43,Tarragona,129,Riudoms,5925,3009,2916
43,Tarragona,130,Rocafort de Queralt,264,138,126
43,Tarragona,131,Roda de Barà,5196,2747,2449
43,Tarragona,132,Rodonyà,474,249,225
43,Tarragona,133,Roquetes,7444,3891,3553
43,Tarragona,134,Rourell (El),354,177,177
43,Tarragona,135,Salomó,439,228,211
43,Tarragona,905,Salou,22162,11890,10272
43,Tarragona,136,Sant Carles de la Ràpita,13488,6737,6751
43,Tarragona,137,Sant Jaume dels Domenys,1998,1046,952
43,Tarragona,902,Sant Jaume d'Enveja,3368,1711,1657
43,Tarragona,138,Santa Bàrbara,3715,1883,1832
43,Tarragona,139,Santa Coloma de Queralt,3035,1518,1517
43,Tarragona,140,Santa Oliva,2907,1545,1362
43,Tarragona,142,Sarral,1596,826,770
43,Tarragona,143,Savallà del Comtat,72,38,34
43,Tarragona,144,Secuita (La),1269,653,616
43,Tarragona,145,Selva del Camp (La),4983,2515,2468
43,Tarragona,146,Senan,46,33,13
43,Tarragona,44,Sénia (La),5976,3090,2886
43,Tarragona,147,Solivella,630,317,313
43,Tarragona,148,Tarragona,131158,64783,66375
43,Tarragona,149,Tivenys,916,471,445
43,Tarragona,150,Tivissa,1788,903,885
43,Tarragona,151,Torre de Fontaubella (La),134,66,68
43,Tarragona,152,Torre de l'Espanyol (La),714,374,340
43,Tarragona,153,Torredembarra,14044,7088,6956
43,Tarragona,154,Torroja del Priorat,142,82,60
43,Tarragona,155,Tortosa,34266,17496,16770
43,Tarragona,156,Ulldecona,6229,3198,3031
43,Tarragona,157,Ulldemolins,508,274,234
43,Tarragona,158,Vallclara,108,62,46
43,Tarragona,159,Vallfogona de Riucorb,159,87,72
43,Tarragona,160,Vallmoll,1469,784,685
43,Tarragona,161,Valls,23315,11698,11617
43,Tarragona,162,Vandellòs i l'Hospitalet de l'Infant,5134,2627,2507
43,Tarragona,163,Vendrell (El),31953,16140,15813
43,Tarragona,164,Vespella de Gaià,339,185,154
43,Tarragona,165,Vilabella,787,403,384
43,Tarragona,175,Vilalba dels Arcs,720,380,340
43,Tarragona,166,Vilallonga del Camp,1539,765,774
43,Tarragona,168,Vilanova de Prades,149,80,69
43,Tarragona,167,Vilanova d'Escornalbou,466,252,214
43,Tarragona,169,Vilaplana,584,297,287
43,Tarragona,170,Vila-rodona,1088,582,506
43,Tarragona,171,Vila-seca,17305,8814,8491
43,Tarragona,172,Vilaverd,438,223,215
43,Tarragona,173,Vilella Alta (La),121,68,53
43,Tarragona,174,Vilella Baixa (La),198,105,93
43,Tarragona,176,Vimbodí,1052,595,457
43,Tarragona,177,Vinebre,483,250,233
43,Tarragona,178,Vinyols i els Arcs,1553,803,750
43,Tarragona,52,Xerta,1278,643,635
44,Teruel,1,Ababuj,84,51,33
44,Teruel,2,Abejuela,61,39,22
44,Teruel,3,Aguatón,24,10,14
44,Teruel,4,Aguaviva,691,346,345
44,Teruel,5,Aguilar del Alfambra,75,41,34
44,Teruel,6,Alacón,406,204,202
44,Teruel,7,Alba,251,124,127
44,Teruel,8,Albalate del Arzobispo,2200,1121,1079
44,Teruel,9,Albarracín,1076,546,530
44,Teruel,10,Albentosa,317,173,144
44,Teruel,11,Alcaine,84,56,28
44,Teruel,12,Alcalá de la Selva,512,286,226
44,Teruel,13,Alcañiz,15447,7770,7677
44,Teruel,14,Alcorisa,3633,1881,1752
44,Teruel,16,Alfambra,740,390,350
44,Teruel,17,Aliaga,409,227,182
44,Teruel,21,Allepuz,141,67,74
44,Teruel,22,Alloza,695,344,351
44,Teruel,23,Allueva,12,10,2
44,Teruel,18,Almohaja,30,21,9
44,Teruel,19,Alobras,79,44,35
44,Teruel,20,Alpeñés,26,18,8
44,Teruel,24,Anadón,20,13,7
44,Teruel,25,Andorra,8034,4164,3870
44,Teruel,26,Arcos de las Salinas,128,63,65
44,Teruel,27,Arens de Lledó,227,103,124
44,Teruel,28,Argente,243,114,129
44,Teruel,29,Ariño,826,431,395
44,Teruel,31,Azaila,151,87,64
44,Teruel,32,Bádenas,30,17,13
44,Teruel,33,Báguena,409,218,191
44,Teruel,34,Bañón,173,99,74
44,Teruel,35,Barrachina,156,86,70
44,Teruel,36,Bea,38,23,15
44,Teruel,37,Beceite,598,307,291
44,Teruel,39,Bello,323,153,170
44,Teruel,38,Belmonte de San José,144,71,73
44,Teruel,40,Berge,246,123,123
44,Teruel,41,Bezas,70,42,28
44,Teruel,42,Blancas,173,100,73
44,Teruel,43,Blesa,122,75,47
44,Teruel,44,Bordón,139,80,59
44,Teruel,45,Bronchales,458,256,202
44,Teruel,46,Bueña,74,39,35
44,Teruel,47,Burbáguena,290,135,155
44,Teruel,48,Cabra de Mora,110,63,47
44,Teruel,49,Calaceite,1143,599,544
44,Teruel,50,Calamocha,4473,2297,2176
44,Teruel,51,Calanda,3709,1893,1816
44,Teruel,52,Calomarde,78,46,32
44,Teruel,53,Camañas,130,77,53
44,Teruel,54,Camarena de la Sierra,160,93,67
44,Teruel,55,Camarillas,109,68,41
44,Teruel,56,Caminreal,751,386,365
44,Teruel,59,Cantavieja,748,412,336
44,Teruel,60,Cañada de Benatanduz,50,30,20
44,Teruel,61,Cañada de Verich (La),104,58,46
44,Teruel,62,Cañada Vellida,46,33,13
44,Teruel,63,Cañizar del Olivar,106,56,50
44,Teruel,64,Cascante del Río,97,57,40
44,Teruel,65,Castejón de Tornos,74,42,32
44,Teruel,66,Castel de Cabra,141,74,67
44,Teruel,70,Castellar (El),80,48,32
44,Teruel,71,Castellote,817,433,384
44,Teruel,67,Castelnou,122,66,56
44,Teruel,68,Castelserás,828,448,380
44,Teruel,74,Cedrillas,547,286,261
44,Teruel,75,Celadas,418,229,189
44,Teruel,76,Cella,2935,1560,1375
44,Teruel,77,Cerollera (La),121,63,58
44,Teruel,80,Codoñera (La),351,185,166
44,Teruel,82,Corbalán,83,49,34
44,Teruel,84,Cortes de Aragón,103,56,47
44,Teruel,85,Cosa,87,45,42
44,Teruel,86,Cretas,630,330,300
44,Teruel,87,Crivillén,110,59,51
44,Teruel,88,Cuba (La),51,26,25
44,Teruel,89,Cubla,54,30,24
44,Teruel,90,Cucalón,91,51,40
44,Teruel,92,Cuervo (El),121,62,59
44,Teruel,93,Cuevas de Almudén,116,68,48
44,Teruel,94,Cuevas Labradas,146,77,69
44,Teruel,96,Ejulve,215,104,111
44,Teruel,97,Escorihuela,200,103,97
44,Teruel,99,Escucha,1104,622,482
44,Teruel,100,Estercuel,276,147,129
44,Teruel,101,Ferreruela de Huerva,72,39,33
44,Teruel,102,Fonfría,26,14,12
44,Teruel,103,Formiche Alto,203,102,101
44,Teruel,105,Fórnoles,105,53,52
44,Teruel,106,Fortanete,203,109,94
44,Teruel,107,Foz-Calanda,297,164,133
44,Teruel,108,Fresneda (La),462,261,201
44,Teruel,109,Frías de Albarracín,181,101,80
44,Teruel,110,Fuenferrada,43,23,20
44,Teruel,111,Fuentes Calientes,117,66,51
44,Teruel,112,Fuentes Claras,641,351,290
44,Teruel,113,Fuentes de Rubielos,126,70,56
44,Teruel,114,Fuentespalda,347,169,178
44,Teruel,115,Galve,145,77,68
44,Teruel,116,Gargallo,101,50,51
44,Teruel,117,Gea de Albarracín,435,223,212
44,Teruel,118,Ginebrosa (La),239,141,98
44,Teruel,119,Griegos,136,83,53
44,Teruel,120,Guadalaviar,275,142,133
44,Teruel,121,Gúdar,101,55,46
44,Teruel,122,Híjar,1898,955,943
44,Teruel,123,Hinojosa de Jarque,148,83,65
44,Teruel,124,Hoz de la Vieja (La),100,50,50
44,Teruel,125,Huesa del Común,106,62,44
44,Teruel,126,Iglesuela del Cid (La),498,272,226
44,Teruel,127,Jabaloyas,82,43,39
44,Teruel,128,Jarque de la Val,99,54,45
44,Teruel,129,Jatiel,63,30,33
44,Teruel,130,Jorcas,41,26,15
44,Teruel,131,Josa,39,26,13
44,Teruel,132,Lagueruela,59,30,29
44,Teruel,133,Lanzuela,27,20,7
44,Teruel,135,Libros,142,77,65
44,Teruel,136,Lidón,74,36,38
44,Teruel,137,Linares de Mora,307,184,123
44,Teruel,141,Lledó,181,98,83
44,Teruel,138,Loscos,185,110,75
44,Teruel,142,Maicas,36,18,18
44,Teruel,143,Manzanera,524,295,229
44,Teruel,144,Martín del Río,472,233,239
44,Teruel,145,Mas de las Matas,1450,750,700
44,Teruel,146,Mata de los Olmos (La),268,135,133
44,Teruel,147,Mazaleón,589,314,275
44,Teruel,148,Mezquita de Jarque,125,68,57
44,Teruel,149,Mirambel,134,76,58
44,Teruel,150,Miravete de la Sierra,41,24,17
44,Teruel,151,Molinos,312,175,137
44,Teruel,152,Monforte de Moyuela,81,53,28
44,Teruel,153,Monreal del Campo,2558,1291,1267
44,Teruel,154,Monroyo,307,165,142
44,Teruel,155,Montalbán,1486,769,717
44,Teruel,156,Monteagudo del Castillo,67,40,27
44,Teruel,157,Monterde de Albarracín,54,26,28
44,Teruel,158,Mora de Rubielos,1609,873,736
44,Teruel,159,Moscardón,61,33,28
44,Teruel,160,Mosqueruela,694,385,309
44,Teruel,161,Muniesa,723,386,337
44,Teruel,163,Noguera de Albarracín,149,75,74
44,Teruel,164,Nogueras,32,25,7
44,Teruel,165,Nogueruelas,239,128,111
44,Teruel,167,Obón,72,40,32
44,Teruel,168,Odón,245,117,128
44,Teruel,169,Ojos Negros,496,257,239
44,Teruel,171,Olba,236,125,111
44,Teruel,172,Oliete,460,234,226
44,Teruel,173,Olmos (Los),145,76,69
44,Teruel,174,Orihuela del Tremedal,578,303,275
44,Teruel,175,Orrios,173,87,86
44,Teruel,176,Palomar de Arroyos,219,125,94
44,Teruel,177,Pancrudo,113,62,51
44,Teruel,178,Parras de Castellote (Las),80,41,39
44,Teruel,179,Peñarroya de Tastavins,488,253,235
44,Teruel,180,Peracense,129,86,43
44,Teruel,181,Peralejos,84,43,41
44,Teruel,182,Perales del Alfambra,286,157,129
44,Teruel,183,Pitarque,108,49,59
44,Teruel,184,Plou,58,36,22
44,Teruel,185,Pobo (El),133,80,53
44,Teruel,187,Portellada (La),274,144,130
44,Teruel,189,Pozondón,94,45,49
44,Teruel,190,Pozuel del Campo,105,57,48
44,Teruel,191,Puebla de Híjar (La),1016,508,508
44,Teruel,192,Puebla de Valverde (La),538,297,241
44,Teruel,193,Puertomingalvo,229,151,78
44,Teruel,194,Ráfales,156,84,72
44,Teruel,195,Rillo,111,63,48
44,Teruel,196,Riodeva,201,96,105
44,Teruel,197,Ródenas,88,48,40
44,Teruel,198,Royuela,224,121,103
44,Teruel,199,Rubiales,53,30,23
44,Teruel,200,Rubielos de la Cérida,53,26,27
44,Teruel,201,Rubielos de Mora,710,365,345
44,Teruel,203,Salcedillo,10,7,3
44,Teruel,204,Saldón,29,16,13
44,Teruel,205,Samper de Calanda,1007,494,513
44,Teruel,206,San Agustín,159,101,58
44,Teruel,207,San Martín del Río,234,115,119
44,Teruel,208,Santa Cruz de Nogueras,38,22,16
44,Teruel,209,Santa Eulalia,1170,570,600
44,Teruel,210,Sarrión,1104,596,508
44,Teruel,211,Segura de los Baños,39,25,14
44,Teruel,212,Seno,46,26,20
44,Teruel,213,Singra,98,54,44
44,Teruel,215,Terriente,185,113,72
44,Teruel,216,Teruel,33673,16361,17312
44,Teruel,217,Toril y Masegoso,35,24,11
44,Teruel,218,Tormón,32,19,13
44,Teruel,219,Tornos,250,132,118
44,Teruel,220,Torralba de los Sisones,197,106,91
44,Teruel,223,Torre de Arcas,93,47,46
44,Teruel,224,Torre de las Arcas,37,20,17
44,Teruel,225,Torre del Compte,168,84,84
44,Teruel,227,Torre los Negros,109,54,55
44,Teruel,221,Torrecilla de Alcañiz,445,233,212
44,Teruel,222,Torrecilla del Rebollar,165,85,80
44,Teruel,226,Torrelacárcel,224,119,105
44,Teruel,228,Torremocha de Jiloca,147,77,70
44,Teruel,229,Torres de Albarracín,147,80,67
44,Teruel,230,Torrevelilla,204,103,101
44,Teruel,231,Torrijas,73,36,37
44,Teruel,232,Torrijo del Campo,485,251,234
44,Teruel,234,Tramacastiel,115,69,46
44,Teruel,235,Tramacastilla,125,62,63
44,Teruel,236,Tronchón,94,51,43
44,Teruel,237,Urrea de Gaén,546,265,281
44,Teruel,238,Utrillas,3289,1718,1571
44,Teruel,239,Valacloche,20,13,7
44,Teruel,240,Valbona,229,124,105
44,Teruel,241,Valdealgorfa,680,329,351
44,Teruel,243,Valdecuenca,35,22,13
44,Teruel,244,Valdelinares,125,70,55
44,Teruel,245,Valdeltormo,349,190,159
44,Teruel,246,Valderrobres,2142,1156,986
44,Teruel,247,Valjunquera,414,214,200
44,Teruel,249,Vallecillo (El),51,28,23
44,Teruel,250,Veguillas de la Sierra,25,15,10
44,Teruel,251,Villafranca del Campo,349,181,168
44,Teruel,252,Villahermosa del Campo,89,49,40
44,Teruel,256,Villanueva del Rebollar de la Sierra,50,27,23
44,Teruel,257,Villar del Cobo,213,110,103
44,Teruel,258,Villar del Salz,95,55,40
44,Teruel,260,Villarluengo,207,121,86
44,Teruel,261,Villarquemado,924,483,441
44,Teruel,262,Villarroya de los Pinares,194,108,86
44,Teruel,263,Villastar,347,185,162
44,Teruel,264,Villel,347,207,140
44,Teruel,265,Vinaceite,249,125,124
44,Teruel,266,Visiedo,164,73,91
44,Teruel,267,Vivel del Río Martín,96,48,48
44,Teruel,268,Zoma (La),24,10,14
45,Toledo,1,Ajofrín,2279,1173,1106
45,Toledo,2,Alameda de la Sagra,3183,1692,1491
45,Toledo,3,Albarreal de Tajo,659,338,321
45,Toledo,4,Alcabón,707,356,351
45,Toledo,5,Alcañizo,336,184,152
45,Toledo,6,Alcaudete de la Jara,1976,974,1002
45,Toledo,7,Alcolea de Tajo,843,435,408
45,Toledo,8,Aldea en Cabo,206,118,88
45,Toledo,9,Aldeanueva de Barbarroya,703,349,354
45,Toledo,10,Aldeanueva de San Bartolomé,530,260,270
45,Toledo,11,Almendral de la Cañada,368,189,179
45,Toledo,12,Almonacid de Toledo,813,425,388
45,Toledo,13,Almorox,2371,1267,1104
45,Toledo,14,Añover de Tajo,5095,2623,2472
45,Toledo,15,Arcicóllar,720,365,355
45,Toledo,16,Argés,4309,2170,2139
45,Toledo,17,Azután,305,156,149
45,Toledo,18,Barcience,214,117,97
45,Toledo,19,Bargas,7963,4060,3903
45,Toledo,20,Belvís de la Jara,1735,884,851
45,Toledo,21,Borox,2640,1353,1287
45,Toledo,22,Buenaventura,464,233,231
45,Toledo,23,Burguillos de Toledo,1993,1028,965
45,Toledo,24,Burujón,1376,725,651
45,Toledo,25,Cabañas de la Sagra,1739,903,836
45,Toledo,26,Cabañas de Yepes,265,134,131
45,Toledo,27,Cabezamesada,469,243,226
45,Toledo,28,Calera y Chozas,4157,2113,2044
45,Toledo,29,Caleruela,295,148,147
45,Toledo,30,Calzada de Oropesa,574,295,279
45,Toledo,31,Camarena,2838,1473,1365
45,Toledo,32,Camarenilla,563,296,267
45,Toledo,33,Campillo de la Jara (El),434,232,202
45,Toledo,34,Camuñas,1856,942,914
45,Toledo,35,Cardiel de los Montes,256,138,118
45,Toledo,36,Carmena,860,459,401
45,Toledo,37,Carpio de Tajo (El),2191,1084,1107
45,Toledo,38,Carranque,2761,1433,1328
45,Toledo,39,Carriches,296,155,141
45,Toledo,40,Casar de Escalona (El),1589,843,746
45,Toledo,41,Casarrubios del Monte,4321,2315,2006
45,Toledo,42,Casasbuenas,232,115,117
45,Toledo,43,Castillo de Bayuela,1054,541,513
45,Toledo,45,Cazalegas,1561,812,749
45,Toledo,46,Cebolla,3336,1688,1648
45,Toledo,47,Cedillo del Condado,2207,1142,1065
45,Toledo,48,Cerralbos (Los),413,215,198
45,Toledo,49,Cervera de los Montes,329,171,158
45,Toledo,56,Chozas de Canales,2084,1092,992
45,Toledo,57,Chueca,255,133,122
45,Toledo,50,Ciruelos,494,265,229
45,Toledo,51,Cobeja,2047,1049,998
45,Toledo,52,Cobisa,3207,1655,1552
45,Toledo,53,Consuegra,10538,5299,5239
45,Toledo,54,Corral de Almaguer,5966,3047,2919
45,Toledo,55,Cuerva,1421,725,696
45,Toledo,58,Domingo Pérez,498,252,246
45,Toledo,59,Dosbarrios,2280,1164,1116
45,Toledo,60,Erustes,209,104,105
45,Toledo,61,Escalona,3053,1571,1482
45,Toledo,62,Escalonilla,1505,764,741
45,Toledo,63,Espinoso del Rey,588,314,274
45,Toledo,64,Esquivias,4812,2433,2379
45,Toledo,65,Estrella (La),322,162,160
45,Toledo,66,Fuensalida,9164,4670,4494
45,Toledo,67,Gálvez,3383,1722,1661
45,Toledo,68,Garciotum,148,74,74
45,Toledo,69,Gerindote,2179,1126,1053
45,Toledo,70,Guadamur,1774,912,862
45,Toledo,71,Guardia (La),2329,1166,1163
45,Toledo,72,Herencias (Las),759,409,350
45,Toledo,73,Herreruela de Oropesa,445,224,221
45,Toledo,74,Hinojosa de San Vicente,481,265,216
45,Toledo,75,Hontanar,132,78,54
45,Toledo,76,Hormigos,480,261,219
45,Toledo,77,Huecas,506,268,238
45,Toledo,78,Huerta de Valdecarábanos,1784,883,901
45,Toledo,79,Iglesuela (La),411,210,201
45,Toledo,80,Illán de Vacas,6,4,2
45,Toledo,81,Illescas,15830,8021,7809
45,Toledo,82,Lagartera,1556,777,779
45,Toledo,83,Layos,378,183,195
45,Toledo,84,Lillo,2762,1411,1351
45,Toledo,85,Lominchar,1429,750,679
45,Toledo,86,Lucillos,508,252,256
45,Toledo,87,Madridejos,11030,5545,5485
45,Toledo,88,Magán,1989,1038,951
45,Toledo,89,Malpica de Tajo,1991,1004,987
45,Toledo,90,Manzaneque,455,225,230
45,Toledo,91,Maqueda,560,289,271
45,Toledo,92,Marjaliza,302,155,147
45,Toledo,93,Marrupe,155,82,73
45,Toledo,94,Mascaraque,495,249,246
45,Toledo,95,Mata (La),953,485,468
45,Toledo,96,Mazarambroz,1314,676,638
45,Toledo,97,Mejorada,1323,673,650
45,Toledo,98,Menasalbas,3206,1738,1468
45,Toledo,99,Méntrida,3521,1857,1664
45,Toledo,100,Mesegar de Tajo,246,128,118
45,Toledo,101,Miguel Esteban,5435,2784,2651
45,Toledo,102,Mocejón,4539,2334,2205
45,Toledo,103,Mohedas de la Jara,522,276,246
45,Toledo,104,Montearagón,549,288,261
45,Toledo,105,Montesclaros,406,214,192
45,Toledo,106,Mora,10072,5094,4978
45,Toledo,107,Nambroca,2967,1561,1406
45,Toledo,108,Nava de Ricomalillo (La),702,359,343
45,Toledo,109,Navahermosa,4209,2158,2051
45,Toledo,110,Navalcán,2238,1179,1059
45,Toledo,111,Navalmoralejo,63,31,32
45,Toledo,112,Navalmorales (Los),2636,1340,1296
45,Toledo,113,Navalucillos (Los),2670,1348,1322
45,Toledo,114,Navamorcuende,708,370,338
45,Toledo,115,Noblejas,3332,1729,1603
45,Toledo,116,Noez,806,413,393
45,Toledo,117,Nombela,981,507,474
45,Toledo,118,Novés,1911,1003,908
45,Toledo,119,Numancia de la Sagra,3713,1956,1757
45,Toledo,120,Nuño Gómez,198,102,96
45,Toledo,121,Ocaña,7180,3615,3565
45,Toledo,122,Olías del Rey,5691,2922,2769
45,Toledo,123,Ontígola,2113,1132,981
45,Toledo,124,Orgaz,2732,1368,1364
45,Toledo,125,Oropesa,2860,1397,1463
45,Toledo,126,Otero,244,112,132
45,Toledo,127,Palomeque,739,388,351
45,Toledo,128,Pantoja,3155,1599,1556
45,Toledo,129,Paredes de Escalona,145,64,81
45,Toledo,130,Parrillas,410,208,202
45,Toledo,131,Pelahustán,372,201,171
45,Toledo,132,Pepino,1804,946,858
45,Toledo,133,Polán,3758,1893,1865
45,Toledo,134,Portillo de Toledo,2097,1089,1008
45,Toledo,135,Puebla de Almoradiel (La),5770,2941,2829
45,Toledo,136,Puebla de Montalbán (La),7840,3962,3878
45,Toledo,137,Pueblanueva (La),2145,1088,1057
45,Toledo,138,Puente del Arzobispo (El),1431,703,728
45,Toledo,139,Puerto de San Vicente,248,132,116
45,Toledo,140,Pulgar,1460,775,685
45,Toledo,141,Quero,1284,661,623
45,Toledo,142,Quintanar de la Orden,10471,5274,5197
45,Toledo,143,Quismondo,1533,752,781
45,Toledo,144,Real de San Vicente (El),1050,543,507
45,Toledo,145,Recas,3138,1709,1429
45,Toledo,146,Retamoso de la Jara,132,70,62
45,Toledo,147,Rielves,626,314,312
45,Toledo,148,Robledo del Mazo,399,210,189
45,Toledo,149,Romeral (El),807,399,408
45,Toledo,150,San Bartolomé de las Abiertas,447,236,211
45,Toledo,151,San Martín de Montalbán,748,362,386
45,Toledo,152,San Martín de Pusa,825,435,390
45,Toledo,153,San Pablo de los Montes,2282,1149,1133
45,Toledo,154,San Román de los Montes,1369,730,639
45,Toledo,155,Santa Ana de Pusa,411,216,195
45,Toledo,156,Santa Cruz de la Zarza,4814,2463,2351
45,Toledo,157,Santa Cruz del Retamar,2555,1311,1244
45,Toledo,158,Santa Olalla,3111,1600,1511
45,Toledo,901,Santo Domingo-Caudilla,801,416,385
45,Toledo,159,Sartajada,127,76,51
45,Toledo,160,Segurilla,1132,576,556
45,Toledo,161,Seseña,10854,5708,5146
45,Toledo,162,Sevilleja de la Jara,907,486,421
45,Toledo,163,Sonseca,10685,5416,5269
45,Toledo,164,Sotillo de las Palomas,211,101,110
45,Toledo,165,Talavera de la Reina,83793,40911,42882
45,Toledo,166,Tembleque,2271,1155,1116
45,Toledo,167,Toboso (El),2177,1102,1075
45,Toledo,168,Toledo,77601,37325,40276
45,Toledo,169,Torralba de Oropesa,298,146,152
45,Toledo,171,Torre de Esteban Hambrán (La),1759,916,843
45,Toledo,170,Torrecilla de la Jara,303,152,151
45,Toledo,172,Torrico,831,439,392
45,Toledo,173,Torrijos,11607,5752,5855
45,Toledo,174,Totanés,417,210,207
45,Toledo,175,Turleque,944,463,481
45,Toledo,176,Ugena,3942,2067,1875
45,Toledo,177,Urda,3164,1595,1569
45,Toledo,179,Valdeverdeja,740,346,394
45,Toledo,180,Valmojado,3109,1602,1507
45,Toledo,181,Velada,2436,1264,1172
45,Toledo,182,Ventas con Peña Aguilera (Las),1351,693,658
45,Toledo,183,Ventas de Retamosa (Las),1782,940,842
45,Toledo,184,Ventas de San Julián (Las),233,101,132
45,Toledo,186,Villa de Don Fadrique (La),4177,2092,2085
45,Toledo,185,Villacañas,10208,5109,5099
45,Toledo,187,Villafranca de los Caballeros,5327,2665,2662
45,Toledo,188,Villaluenga de la Sagra,3216,1610,1606
45,Toledo,189,Villamiel de Toledo,753,387,366
45,Toledo,190,Villaminaya,586,294,292
45,Toledo,191,Villamuelas,737,372,365
45,Toledo,192,Villanueva de Alcardete,3773,1984,1789
45,Toledo,193,Villanueva de Bogas,805,420,385
45,Toledo,194,Villarejo de Montalbán,76,40,36
45,Toledo,195,Villarrubia de Santiago,2893,1472,1421
45,Toledo,196,Villaseca de la Sagra,1581,782,799
45,Toledo,197,Villasequilla,2515,1317,1198
45,Toledo,198,Villatobas,2481,1271,1210
45,Toledo,199,Viso de San Juan (El),2339,1262,1077
45,Toledo,200,Yébenes (Los),6341,3242,3099
45,Toledo,201,Yeles,3113,1712,1401
45,Toledo,202,Yepes,4729,2426,2303
45,Toledo,203,Yuncler,2684,1377,1307
45,Toledo,204,Yunclillos,706,373,333
45,Toledo,205,Yuncos,6603,3449,3154
46,Valencia/València,1,Ademuz,1183,614,569
46,Valencia/València,2,Ador,1398,721,677
46,Valencia/València,4,Agullent,2334,1136,1198
46,Valencia/València,42,Aielo de Malferit,4502,2222,2280
46,Valencia/València,43,Aielo de Rugat,202,108,94
46,Valencia/València,5,Alaquàs,30104,14988,15116
46,Valencia/València,6,Albaida,6273,3118,3155
46,Valencia/València,7,Albal,14505,7323,7182
46,Valencia/València,8,Albalat de la Ribera,3321,1644,1677
46,Valencia/València,9,Albalat dels Sorells,3624,1780,1844
46,Valencia/València,10,Albalat dels Tarongers,864,447,417
46,Valencia/València,11,Alberic,10234,5097,5137
46,Valencia/València,12,Alborache,1003,509,494
46,Valencia/València,13,Alboraya,21263,10691,10572
46,Valencia/València,14,Albuixech,3529,1754,1775
46,Valencia/València,16,Alcàntera de Xúquer,1384,684,700
46,Valencia/València,15,Alcàsser,8505,4327,4178
46,Valencia/València,18,Alcublas,795,409,386
46,Valencia/València,19,Alcúdia (l'),11005,5440,5565
46,Valencia/València,20,Alcúdia de Crespins (l'),4818,2456,2362
46,Valencia/València,21,Aldaia,27704,13874,13830
46,Valencia/València,22,Alfafar,20322,10136,10186
46,Valencia/València,24,Alfara de Algimia,507,245,262
46,Valencia/València,25,Alfara del Patriarca,2764,1372,1392
46,Valencia/València,26,Alfarp,1344,671,673
46,Valencia/València,27,Alfarrasí,1302,643,659
46,Valencia/València,23,Alfauir,413,213,200
46,Valencia/València,28,Algar de Palancia,523,271,252
46,Valencia/València,29,Algemesí,27326,13625,13701
46,Valencia/València,30,Algimia de Alfara,1003,508,495
46,Valencia/València,31,Alginet,12499,6335,6164
46,Valencia/València,32,Almàssera,6883,3343,3540
46,Valencia/València,33,Almiserà,273,133,140
46,Valencia/València,34,Almoines,1874,950,924
46,Valencia/València,35,Almussafes,7836,3939,3897
46,Valencia/València,36,Alpuente,852,464,388
46,Valencia/València,37,Alqueria de la Comtessa (l'),1495,750,745
46,Valencia/València,17,Alzira,43253,21267,21986
46,Valencia/València,38,Andilla,335,199,136
46,Valencia/València,39,Anna,2673,1340,1333
46,Valencia/València,40,Antella,1427,718,709
46,Valencia/València,41,Aras de los Olmos,399,216,183
46,Valencia/València,3,Atzeneta d'Albaida,1280,668,612
46,Valencia/València,44,Ayora,5492,2806,2686
46,Valencia/València,46,Barx,1407,695,712
46,Valencia/València,45,Barxeta,1641,845,796
46,Valencia/València,47,Bèlgida,708,348,360
46,Valencia/València,48,Bellreguard,4216,2125,2091
46,Valencia/València,49,Bellús,391,197,194
46,Valencia/València,50,Benagéber,161,78,83
46,Valencia/València,51,Benaguasil,10032,5153,4879
46,Valencia/València,52,Benavites,636,309,327
46,Valencia/València,53,Beneixida,656,313,343
46,Valencia/València,54,Benetússer,13940,6943,6997
46,Valencia/València,55,Beniarjó,1550,775,775
46,Valencia/València,56,Beniatjar,249,123,126
46,Valencia/València,57,Benicolet,536,275,261
46,Valencia/València,904,Benicull de Xúquer,873,437,436
46,Valencia/València,60,Benifaió,12208,6038,6170
46,Valencia/València,59,Benifairó de la Valldigna,1683,854,829
46,Valencia/València,58,Benifairó de les Valls,1977,975,1002
46,Valencia/València,61,Beniflá,313,168,145
46,Valencia/València,62,Benigánim,5946,2999,2947
46,Valencia/València,63,Benimodo,2098,1087,1011
46,Valencia/València,64,Benimuslem,594,303,291
46,Valencia/València,65,Beniparrell,1810,938,872
46,Valencia/València,66,Benirredrà,1584,765,819
46,Valencia/València,67,Benisanó,2004,1029,975
46,Valencia/València,68,Benissoda,342,185,157
46,Valencia/València,69,Benisuera,207,107,100
46,Valencia/València,70,Bétera,18927,9491,9436
46,Valencia/València,71,Bicorp,621,310,311
46,Valencia/València,72,Bocairent,4344,2163,2181
46,Valencia/València,73,Bolbaite,1383,709,674
46,Valencia/València,74,Bonrepòs i Mirambell,2870,1415,1455
46,Valencia/València,75,Bufali,202,104,98
46,Valencia/València,76,Bugarra,837,422,415
46,Valencia/València,77,Buñol,9571,4783,4788
46,Valencia/València,78,Burjassot,37756,18478,19278
46,Valencia/València,79,Calles,405,227,178
46,Valencia/València,80,Camporrobles,1407,729,678
46,Valencia/València,81,Canals,13150,6581,6569
46,Valencia/València,82,Canet d'En Berenguer,4696,2408,2288
46,Valencia/València,83,Carcaixent,21753,10794,10959
46,Valencia/València,84,Càrcer,2030,976,1054
46,Valencia/València,85,Carlet,14952,7508,7444
46,Valencia/València,86,Carrícola,88,42,46
46,Valencia/València,87,Casas Altas,164,84,80
46,Valencia/València,88,Casas Bajas,227,124,103
46,Valencia/València,89,Casinos,2493,1277,1216
46,Valencia/València,257,Castelló de la Ribera,7379,3684,3695
46,Valencia/València,90,Castelló de Rugat,2322,1179,1143
46,Valencia/València,91,Castellonet de la Conquesta,181,102,79
46,Valencia/València,92,Castielfabib,256,139,117
46,Valencia/València,93,Catadau,2578,1299,1279
46,Valencia/València,94,Catarroja,24916,12493,12423
46,Valencia/València,95,Caudete de las Fuentes,786,411,375
46,Valencia/València,96,Cerdà,312,167,145
46,Valencia/València,107,Chella,2701,1355,1346
46,Valencia/València,106,Chelva,1877,962,915
46,Valencia/València,108,Chera,502,266,236
46,Valencia/València,109,Cheste,7425,3800,3625
46,Valencia/València,111,Chiva,12398,6386,6012
46,Valencia/València,112,Chulilla,787,406,381
46,Valencia/València,97,Cofrentes,965,483,482
46,Valencia/València,98,Corbera,3186,1569,1617
46,Valencia/València,99,Cortes de Pallás,978,505,473
46,Valencia/València,100,Cotes,365,174,191
46,Valencia/València,105,Cullera,23619,12046,11573
46,Valencia/València,113,Daimús,2652,1365,1287
46,Valencia/València,114,Domeño,644,331,313
46,Valencia/València,115,Dos Aguas,397,221,176
46,Valencia/València,116,Eliana (l'),16121,8015,8106
46,Valencia/València,117,Emperador,306,156,150
46,Valencia/València,118,Enguera,5635,2935,2700
46,Valencia/València,119,Ènova (l'),981,494,487
46,Valencia/València,120,Estivella,1235,587,648
46,Valencia/València,121,Estubeny,149,77,72
46,Valencia/València,122,Faura,3127,1557,1570
46,Valencia/València,123,Favara,1965,971,994
46,Valencia/València,126,Foios,6287,3107,3180
46,Valencia/València,128,Font de la Figuera (la),2213,1123,1090
46,Valencia/València,127,Font d'En Carròs (la),3727,1879,1848
46,Valencia/València,124,Fontanars dels Alforins,990,505,485
46,Valencia/València,125,Fortaleny,997,496,501
46,Valencia/València,129,Fuenterrobles,734,384,350
46,Valencia/València,131,Gandia,74827,37731,37096
46,Valencia/València,902,Gátova,459,219,240
46,Valencia/València,130,Gavarda,1174,583,591
46,Valencia/València,132,Genovés,2697,1365,1332
46,Valencia/València,133,Gestalgar,701,353,348
46,Valencia/València,134,Gilet,2411,1242,1169
46,Valencia/València,135,Godella,12911,6327,6584
46,Valencia/València,136,Godelleta,2911,1491,1420
46,Valencia/València,137,Granja de la Costera (la),338,167,171
46,Valencia/València,138,Guadasequies,399,207,192
46,Valencia/València,139,Guadassuar,5830,2935,2895
46,Valencia/València,140,Guardamar de la Safor,316,168,148
46,Valencia/València,141,Higueruelas,537,281,256
46,Valencia/València,142,Jalance,1016,508,508
46,Valencia/València,144,Jarafuel,861,448,413
46,Valencia/València,154,Llanera de Ranes,1064,538,526
46,Valencia/València,155,Llaurí,1245,628,617
46,Valencia/València,147,Llíria,21078,10705,10373
46,Valencia/València,152,Llocnou de la Corona,102,52,50
46,Valencia/València,153,Llocnou de Sant Jeroni,590,282,308
46,Valencia/València,151,Llocnou d'En Fenollet,844,435,409
46,Valencia/València,156,Llombai,2382,1217,1165
46,Valencia/València,157,Llosa de Ranes (la),3627,1875,1752
46,Valencia/València,150,Llutxent,2574,1320,1254
46,Valencia/València,148,Loriguilla,1259,655,604
46,Valencia/València,149,Losa del Obispo,514,265,249
46,Valencia/València,158,Macastre,1201,614,587
46,Valencia/València,159,Manises,29717,14836,14881
46,Valencia/València,160,Manuel,2533,1238,1295
46,Valencia/València,161,Marines,1526,778,748
46,Valencia/València,162,Masalavés,1629,856,773
46,Valencia/València,163,Massalfassar,1688,848,840
46,Valencia/València,164,Massamagrell,14388,7147,7241
46,Valencia/València,165,Massanassa,8127,4058,4069
46,Valencia/València,166,Meliana,9622,4785,4837
46,Valencia/València,167,Millares,530,258,272
46,Valencia/València,168,Miramar,1895,977,918
46,Valencia/València,169,Mislata,43363,21348,22015
46,Valencia/València,170,Mogente/Moixent,4559,2319,2240
46,Valencia/València,171,Moncada,20815,10370,10445
46,Valencia/València,173,Montaverner,1825,908,917
46,Valencia/València,174,Montesa,1446,746,700
46,Valencia/València,175,Montichelvo,611,311,300
46,Valencia/València,176,Montroy,2154,1145,1009
46,Valencia/València,172,Montserrat,4921,2632,2289
46,Valencia/València,177,Museros,4728,2386,2342
46,Valencia/València,178,Náquera,4468,2316,2152
46,Valencia/València,179,Navarrés,2918,1500,1418
46,Valencia/València,180,Novelé/Novetlè,742,353,389
46,Valencia/València,181,Oliva,26844,13580,13264
46,Valencia/València,183,Olleria (l'),7984,4073,3911
46,Valencia/València,182,Olocau,1265,656,609
46,Valencia/València,184,Ontinyent,36368,18276,18092
46,Valencia/València,185,Otos,526,273,253
46,Valencia/València,186,Paiporta,21846,11051,10795
46,Valencia/València,187,Palma de Gandía,1683,846,837
46,Valencia/València,188,Palmera,710,352,358
46,Valencia/València,189,Palomar (el),528,256,272
46,Valencia/València,190,Paterna,57343,28737,28606
46,Valencia/València,191,Pedralba,2476,1323,1153
46,Valencia/València,192,Petrés,924,459,465
46,Valencia/València,193,Picanya,10278,5117,5161
46,Valencia/València,194,Picassent,17848,9088,8760
46,Valencia/València,195,Piles,2573,1314,1259
46,Valencia/València,196,Pinet,187,96,91
46,Valencia/València,199,Pobla de Farnals (la),6473,3333,3140
46,Valencia/València,202,Pobla de Vallbona (la),18072,9221,8851
46,Valencia/València,200,Pobla del Duc (la),2621,1304,1317
46,Valencia/València,203,Pobla Llarga (la),4379,2158,2221
46,Valencia/València,197,Polinyà de Xúquer,2257,1123,1134
46,Valencia/València,198,Potríes,920,449,471
46,Valencia/València,205,Puçol,17249,8567,8682
46,Valencia/València,201,Puebla de San Miguel,65,38,27
46,Valencia/València,204,Puig,8006,3966,4040
46,Valencia/València,101,Quart de les Valls,1087,525,562
46,Valencia/València,102,Quart de Poblet,25430,12548,12882
46,Valencia/València,103,Quartell,1417,694,723
46,Valencia/València,104,Quatretonda,2522,1279,1243
46,Valencia/València,206,Quesa,740,386,354
46,Valencia/València,207,Rafelbuñol/Rafelbunyol,6874,3417,3457
46,Valencia/València,208,Rafelcofer,1443,693,750
46,Valencia/València,209,Rafelguaraf,2390,1169,1221
46,Valencia/València,210,Ráfol de Salem,392,193,199
46,Valencia/València,211,Real de Gandía,2030,995,1035
46,Valencia/València,212,Real de Montroi,1974,1047,927
46,Valencia/València,213,Requena,20216,10206,10010
46,Valencia/València,214,Riba-roja de Túria,18329,9305,9024
46,Valencia/València,215,Riola,1762,888,874
46,Valencia/València,216,Rocafort,6144,3010,3134
46,Valencia/València,217,Rotglà i Corberà,1059,531,528
46,Valencia/València,218,Rótova,1285,657,628
46,Valencia/València,219,Rugat,179,89,90
46,Valencia/València,220,Sagunto/Sagunt,62702,30969,31733
46,Valencia/València,221,Salem,477,244,233
46,Valencia/València,903,San Antonio de Benagéber,4702,2336,2366
46,Valencia/València,222,San Juan de Énova,391,182,209
46,Valencia/València,223,Sedaví,9344,4596,4748
46,Valencia/València,224,Segart,140,67,73
46,Valencia/València,225,Sellent,442,230,212
46,Valencia/València,226,Sempere,35,17,18
46,Valencia/València,227,Senyera,1080,532,548
46,Valencia/València,228,Serra,2655,1402,1253
46,Valencia/València,229,Siete Aguas,1256,659,597
46,Valencia/València,230,Silla,18756,9542,9214
46,Valencia/València,231,Simat de la Valldigna,3090,1589,1501
46,Valencia/València,232,Sinarcas,1213,629,584
46,Valencia/València,233,Sollana,4567,2243,2324
46,Valencia/València,234,Sot de Chera,387,191,196
46,Valencia/València,235,Sueca,27593,13728,13865
46,Valencia/València,236,Sumacàrcer,1294,659,635
46,Valencia/València,237,Tavernes Blanques,9207,4552,4655
46,Valencia/València,238,Tavernes de la Valldigna,17988,9090,8898
46,Valencia/València,239,Teresa de Cofrentes,697,356,341
46,Valencia/València,240,Terrateig,352,192,160
46,Valencia/València,241,Titaguas,535,276,259
46,Valencia/València,242,Torrebaja,414,225,189
46,Valencia/València,243,Torrella,149,81,68
46,Valencia/València,244,Torrent,74616,37364,37252
46,Valencia/València,245,Torres Torres,529,279,250
46,Valencia/València,246,Tous,1126,568,558
46,Valencia/València,247,Tuéjar,1208,631,577
46,Valencia/València,248,Turís,5788,3020,2768
46,Valencia/València,249,Utiel,12012,6015,5997
46,Valencia/València,250,Valencia,805304,388401,416903
46,Valencia/València,251,Vallada,3288,1688,1600
46,Valencia/València,252,Vallanca,168,83,85
46,Valencia/València,253,Vallés,122,65,57
46,Valencia/València,254,Venta del Moro,1507,779,728
46,Valencia/València,256,Vilamarxant,7505,3887,3618
46,Valencia/València,255,Villalonga,3984,2000,1984
46,Valencia/València,258,Villar del Arzobispo,3801,1961,1840
46,Valencia/València,259,Villargordo del Cabriel,676,351,325
46,Valencia/València,260,Vinalesa,2647,1291,1356
46,Valencia/València,145,Xàtiva,28474,14051,14423
46,Valencia/València,143,Xeraco,5671,2898,2773
46,Valencia/València,146,Xeresa,2029,1035,994
46,Valencia/València,110,Xirivella,30123,15179,14944
46,Valencia/València,261,Yátova,2083,1085,998
46,Valencia/València,262,Yesa (La),246,134,112
46,Valencia/València,263,Zarra,492,267,225
47,Valladolid,1,Adalia,67,37,30
47,Valladolid,2,Aguasal,26,17,9
47,Valladolid,3,Aguilar de Campos,330,178,152
47,Valladolid,4,Alaejos,1593,831,762
47,Valladolid,5,Alcazarén,706,378,328
47,Valladolid,6,Aldea de San Miguel,218,113,105
47,Valladolid,7,Aldeamayor de San Martín,2107,1060,1047
47,Valladolid,8,Almenara de Adaja,36,22,14
47,Valladolid,9,Amusquillo,138,83,55
47,Valladolid,10,Arroyo de la Encomienda,8039,4156,3883
47,Valladolid,11,Ataquines,786,427,359
47,Valladolid,12,Bahabón,179,88,91
47,Valladolid,13,Barcial de la Loma,142,73,69
47,Valladolid,14,Barruelo del Valle,67,41,26
47,Valladolid,15,Becilla de Valderaduey,355,192,163
47,Valladolid,16,Benafarces,101,55,46
47,Valladolid,17,Bercero,234,130,104
47,Valladolid,18,Berceruelo,43,25,18
47,Valladolid,19,Berrueces,106,62,44
47,Valladolid,20,Bobadilla del Campo,371,200,171
47,Valladolid,21,Bocigas,121,59,62
47,Valladolid,22,Bocos de Duero,67,29,38
47,Valladolid,23,Boecillo,2713,1394,1319
47,Valladolid,24,Bolaños de Campos,384,199,185
47,Valladolid,25,Brahojos de Medina,163,86,77
47,Valladolid,26,Bustillo de Chaves,102,52,50
47,Valladolid,27,Cabezón de Pisuerga,2718,1380,1338
47,Valladolid,28,Cabezón de Valderaduey,54,32,22
47,Valladolid,29,Cabreros del Monte,89,49,40
47,Valladolid,30,Campaspero,1366,716,650
47,Valladolid,31,Campillo (El),247,137,110
47,Valladolid,32,Camporredondo,177,98,79
47,Valladolid,33,Canalejas de Peñafiel,324,166,158
47,Valladolid,34,Canillas de Esgueva,106,57,49
47,Valladolid,35,Carpio,1015,550,465
47,Valladolid,36,Casasola de Arión,341,191,150
47,Valladolid,37,Castrejón de Trabancos,240,122,118
47,Valladolid,38,Castrillo de Duero,157,77,80
47,Valladolid,39,Castrillo-Tejeriego,211,114,97
47,Valladolid,40,Castrobol,83,38,45
47,Valladolid,41,Castrodeza,201,113,88
47,Valladolid,42,Castromembibre,78,42,36
47,Valladolid,43,Castromonte,369,190,179
47,Valladolid,44,Castronuevo de Esgueva,373,204,169
47,Valladolid,45,Castronuño,1024,506,518
47,Valladolid,46,Castroponce,159,91,68
47,Valladolid,47,Castroverde de Cerrato,257,156,101
47,Valladolid,48,Ceinos de Campos,282,148,134
47,Valladolid,49,Cervillego de la Cruz,131,67,64
47,Valladolid,50,Cigales,3652,1847,1805
47,Valladolid,51,Ciguñuela,393,205,188
47,Valladolid,52,Cistérniga,6680,3420,3260
47,Valladolid,53,Cogeces de Íscar,145,78,67
47,Valladolid,54,Cogeces del Monte,854,468,386
47,Valladolid,55,Corcos,246,136,110
47,Valladolid,56,Corrales de Duero,112,69,43
47,Valladolid,57,Cubillas de Santa Marta,302,168,134
47,Valladolid,58,Cuenca de Campos,259,132,127
47,Valladolid,59,Curiel de Duero,111,64,47
47,Valladolid,60,Encinas de Esgueva,325,177,148
47,Valladolid,61,Esguevillas de Esgueva,336,170,166
47,Valladolid,62,Fombellida,220,117,103
47,Valladolid,63,Fompedraza,148,84,64
47,Valladolid,64,Fontihoyuelo,38,24,14
47,Valladolid,65,Fresno el Viejo,1139,591,548
47,Valladolid,66,Fuensaldaña,1266,635,631
47,Valladolid,67,Fuente el Sol,260,138,122
47,Valladolid,68,Fuente-Olmedo,53,29,24
47,Valladolid,69,Gallegos de Hornija,144,70,74
47,Valladolid,70,Gatón de Campos,41,23,18
47,Valladolid,71,Geria,479,258,221
47,Valladolid,73,Herrín de Campos,190,92,98
47,Valladolid,74,Hornillos de Eresma,180,94,86
47,Valladolid,75,Íscar,6593,3365,3228
47,Valladolid,76,Laguna de Duero,21018,10634,10384
47,Valladolid,77,Langayo,373,211,162
47,Valladolid,79,Llano de Olmedo,81,46,35
47,Valladolid,78,Lomoviejo,213,111,102
47,Valladolid,80,Manzanillo,58,30,28
47,Valladolid,81,Marzales,62,33,29
47,Valladolid,82,Matapozuelos,1059,538,521
47,Valladolid,83,Matilla de los Caños,106,62,44
47,Valladolid,84,Mayorga,1782,879,903
47,Valladolid,86,Medina de Rioseco,5023,2465,2558
47,Valladolid,85,Medina del Campo,20767,10123,10644
47,Valladolid,87,Megeces,446,224,222
47,Valladolid,88,Melgar de Abajo,161,93,68
47,Valladolid,89,Melgar de Arriba,269,142,127
47,Valladolid,90,Mojados,3117,1583,1534
47,Valladolid,91,Monasterio de Vega,101,51,50
47,Valladolid,92,Montealegre de Campos,150,85,65
47,Valladolid,93,Montemayor de Pililla,1018,531,487
47,Valladolid,94,Moral de la Reina,216,117,99
47,Valladolid,95,Moraleja de las Panaderas,35,25,10
47,Valladolid,96,Morales de Campos,169,80,89
47,Valladolid,97,Mota del Marqués,434,219,215
47,Valladolid,98,Mucientes,659,349,310
47,Valladolid,99,Mudarra (La),215,119,96
47,Valladolid,100,Muriel,188,94,94
47,Valladolid,101,Nava del Rey,2148,1086,1062
47,Valladolid,102,Nueva Villa de las Torres,388,215,173
47,Valladolid,103,Olivares de Duero,328,178,150
47,Valladolid,104,Olmedo,3628,1770,1858
47,Valladolid,105,Olmos de Esgueva,209,118,91
47,Valladolid,106,Olmos de Peñafiel,74,39,35
47,Valladolid,109,Palazuelo de Vedija,228,117,111
47,Valladolid,110,Parrilla (La),603,298,305
47,Valladolid,111,Pedraja de Portillo (La),1145,596,549
47,Valladolid,112,Pedrajas de San Esteban,3496,1783,1713
47,Valladolid,113,Pedrosa del Rey,196,106,90
47,Valladolid,114,Peñafiel,5486,2786,2700
47,Valladolid,115,Peñaflor de Hornija,404,222,182
47,Valladolid,116,Pesquera de Duero,533,288,245
47,Valladolid,117,Piña de Esgueva,350,173,177
47,Valladolid,118,Piñel de Abajo,192,104,88
47,Valladolid,119,Piñel de Arriba,136,68,68
47,Valladolid,121,Pollos,745,391,354
47,Valladolid,122,Portillo,2513,1291,1222
47,Valladolid,123,Pozal de Gallinas,515,282,233
47,Valladolid,124,Pozaldez,540,268,272
47,Valladolid,125,Pozuelo de la Orden,67,38,29
47,Valladolid,126,Puras,63,30,33
47,Valladolid,127,Quintanilla de Arriba,220,116,104
47,Valladolid,129,Quintanilla de Onésimo,1172,603,569
47,Valladolid,130,Quintanilla de Trigueros,121,60,61
47,Valladolid,128,Quintanilla del Molar,77,35,42
47,Valladolid,131,Rábano,224,117,107
47,Valladolid,132,Ramiro,62,38,24
47,Valladolid,133,Renedo de Esgueva,1948,1016,932
47,Valladolid,134,Roales de Campos,257,128,129
47,Valladolid,135,Robladillo,103,50,53
47,Valladolid,137,Roturas,32,17,15
47,Valladolid,138,Rubí de Bracamonte,313,162,151
47,Valladolid,139,Rueda,1423,725,698
47,Valladolid,140,Saelices de Mayorga,176,95,81
47,Valladolid,141,Salvador de Zapardiel,175,98,77
47,Valladolid,142,San Cebrián de Mazote,180,98,82
47,Valladolid,143,San Llorente,166,90,76
47,Valladolid,144,San Martín de Valvení,103,56,47
47,Valladolid,145,San Miguel del Arroyo,777,397,380
47,Valladolid,146,San Miguel del Pino,244,134,110
47,Valladolid,147,San Pablo de la Moraleja,164,85,79
47,Valladolid,148,San Pedro de Latarce,597,318,279
47,Valladolid,149,San Pelayo,42,20,22
47,Valladolid,150,San Román de Hornija,427,201,226
47,Valladolid,151,San Salvador,43,25,18
47,Valladolid,156,San Vicente del Palacio,217,111,106
47,Valladolid,152,Santa Eufemia del Arroyo,120,59,61
47,Valladolid,153,Santervás de Campos,150,84,66
47,Valladolid,154,Santibáñez de Valcorba,187,93,94
47,Valladolid,155,Santovenia de Pisuerga,3079,1557,1522
47,Valladolid,157,Sardón de Duero,658,333,325
47,Valladolid,158,Seca (La),1066,551,515
47,Valladolid,159,Serrada,1104,567,537
47,Valladolid,160,Siete Iglesias de Trabancos,566,302,264
47,Valladolid,161,Simancas,4776,2451,2325
47,Valladolid,162,Tamariz de Campos,105,60,45
47,Valladolid,163,Tiedra,381,191,190
47,Valladolid,164,Tordehumos,496,252,244
47,Valladolid,165,Tordesillas,8686,4416,4270
47,Valladolid,169,Torre de Esgueva,89,43,46
47,Valladolid,170,Torre de Peñafiel,44,25,19
47,Valladolid,166,Torrecilla de la Abadesa,344,180,164
47,Valladolid,167,Torrecilla de la Orden,314,154,160
47,Valladolid,168,Torrecilla de la Torre,30,20,10
47,Valladolid,171,Torrelobatón,531,254,277
47,Valladolid,172,Torrescárcela,169,90,79
47,Valladolid,173,Traspinedo,1006,541,465
47,Valladolid,174,Trigueros del Valle,348,187,161
47,Valladolid,175,Tudela de Duero,7692,3958,3734
47,Valladolid,176,Unión de Campos (La),305,151,154
47,Valladolid,177,Urones de Castroponce,141,79,62
47,Valladolid,178,Urueña,216,112,104
47,Valladolid,179,Valbuena de Duero,507,268,239
47,Valladolid,180,Valdearcos de la Vega,103,55,48
47,Valladolid,181,Valdenebro de los Valles,214,106,108
47,Valladolid,182,Valdestillas,1770,914,856
47,Valladolid,183,Valdunquillo,186,85,101
47,Valladolid,186,Valladolid,319943,152976,166967
47,Valladolid,184,Valoria la Buena,637,334,303
47,Valladolid,185,Valverde de Campos,120,63,57
47,Valladolid,187,Vega de Ruiponce,129,69,60
47,Valladolid,188,Vega de Valdetronco,158,85,73
47,Valladolid,189,Velascálvaro,199,109,90
47,Valladolid,190,Velilla,132,67,65
47,Valladolid,191,Velliza,134,82,52
47,Valladolid,192,Ventosa de la Cuesta,138,75,63
47,Valladolid,193,Viana de Cega,1848,953,895
47,Valladolid,195,Villabáñez,489,272,217
47,Valladolid,196,Villabaruz de Campos,46,25,21
47,Valladolid,197,Villabrágima,1159,620,539
47,Valladolid,198,Villacarralón,113,56,57
47,Valladolid,199,Villacid de Campos,101,56,45
47,Valladolid,200,Villaco,115,69,46
47,Valladolid,203,Villafrades de Campos,91,40,51
47,Valladolid,204,Villafranca de Duero,367,181,186
47,Valladolid,205,Villafrechós,527,273,254
47,Valladolid,206,Villafuerte,135,71,64
47,Valladolid,207,Villagarcía de Campos,412,230,182
47,Valladolid,208,Villagómez la Nueva,80,42,38
47,Valladolid,209,Villalán de Campos,51,26,25
47,Valladolid,210,Villalar de los Comuneros,433,207,226
47,Valladolid,211,Villalba de la Loma,50,27,23
47,Valladolid,212,Villalba de los Alcores,511,270,241
47,Valladolid,213,Villalbarba,149,71,78
47,Valladolid,214,Villalón de Campos,1990,983,1007
47,Valladolid,215,Villamuriel de Campos,78,38,40
47,Valladolid,216,Villán de Tordesillas,157,79,78
47,Valladolid,217,Villanubla,1489,792,697
47,Valladolid,218,Villanueva de Duero,1121,575,546
47,Valladolid,219,Villanueva de la Condesa,43,26,17
47,Valladolid,220,Villanueva de los Caballeros,246,120,126
47,Valladolid,221,Villanueva de los Infantes,127,73,54
47,Valladolid,222,Villanueva de San Mancio,118,64,54
47,Valladolid,223,Villardefrades,206,106,100
47,Valladolid,224,Villarmentero de Esgueva,132,64,68
47,Valladolid,225,Villasexmir,110,57,53
47,Valladolid,226,Villavaquerín,199,109,90
47,Valladolid,227,Villavellid,75,41,34
47,Valladolid,228,Villaverde de Medina,547,293,254
47,Valladolid,229,Villavicencio de los Caballeros,274,133,141
47,Valladolid,194,Viloria,394,213,181
47,Valladolid,230,Wamba,369,196,173
47,Valladolid,231,Zaratán,3442,1795,1647
47,Valladolid,232,Zarza (La),150,82,68
48,Vizcaya,1,Abadiño,7163,3610,3553
48,Vizcaya,2,Abanto y Ciérvana-Abanto Zierbena,9608,4762,4846
48,Vizcaya,911,Ajangiz,441,217,224
48,Vizcaya,912,Alonsotegi,2785,1359,1426
48,Vizcaya,3,Amorebieta-Etxano,17112,8434,8678
48,Vizcaya,4,Amoroto,396,205,191
48,Vizcaya,5,Arakaldo,94,55,39
48,Vizcaya,6,Arantzazu,294,147,147
48,Vizcaya,93,Areatza,1072,495,577
48,Vizcaya,9,Arrankudiaga,824,398,426
48,Vizcaya,914,Arratzu,351,176,175
48,Vizcaya,10,Arrieta,541,275,266
48,Vizcaya,11,Arrigorriaga,12245,6064,6181
48,Vizcaya,23,Artea,675,333,342
48,Vizcaya,8,Artzentales,688,371,317
48,Vizcaya,91,Atxondo,1441,738,703
48,Vizcaya,70,Aulesti,674,339,335
48,Vizcaya,12,Bakio,2114,1064,1050
48,Vizcaya,90,Balmaseda,7073,3436,3637
48,Vizcaya,13,Barakaldo,95640,46441,49199
48,Vizcaya,14,Barrika,1375,697,678
48,Vizcaya,15,Basauri,43626,21496,22130
48,Vizcaya,92,Bedia,984,483,501
48,Vizcaya,16,Berango,6012,2977,3035
48,Vizcaya,17,Bermeo,16909,8320,8589
48,Vizcaya,18,Berriatua,1177,639,538
48,Vizcaya,19,Berriz,4676,2402,2274
48,Vizcaya,20,Bilbao,354145,167652,186493
48,Vizcaya,21,Busturia,1715,888,827
48,Vizcaya,901,Derio,5107,2547,2560
48,Vizcaya,26,Dima,1155,603,552
48,Vizcaya,27,Durango,27040,13194,13846
48,Vizcaya,28,Ea,844,436,408
48,Vizcaya,31,Elantxobe,444,203,241
48,Vizcaya,32,Elorrio,7116,3535,3581
48,Vizcaya,902,Erandio,23653,11669,11984
48,Vizcaya,33,Ereño,257,129,128
48,Vizcaya,34,Ermua,16331,8258,8073
48,Vizcaya,79,Errigoiti,501,278,223
48,Vizcaya,29,Etxebarri,7887,4032,3855
48,Vizcaya,30,Etxebarria,812,431,381
48,Vizcaya,906,Forua,975,504,471
48,Vizcaya,35,Fruiz,402,201,201
48,Vizcaya,36,Galdakao,29374,14503,14871
48,Vizcaya,37,Galdames,813,428,385
48,Vizcaya,38,Gamiz-Fika,1289,672,617
48,Vizcaya,39,Garai,279,140,139
48,Vizcaya,40,Gatika,1419,721,698
48,Vizcaya,41,Gautegiz Arteaga,882,441,441
48,Vizcaya,46,Gernika-Lumo,15959,7779,8180
48,Vizcaya,44,Getxo,82327,39038,43289
48,Vizcaya,47,Gizaburuaga,179,90,89
48,Vizcaya,42,Gordexola,1589,796,793
48,Vizcaya,43,Gorliz,5049,2500,2549
48,Vizcaya,45,Güeñes,6167,3053,3114
48,Vizcaya,48,Ibarrangelu,574,290,284
48,Vizcaya,94,Igorre,4068,2018,2050
48,Vizcaya,49,Ispaster,618,328,290
48,Vizcaya,910,Iurreta,3901,1956,1945
48,Vizcaya,50,Izurtza,251,132,119
48,Vizcaya,22,Karrantza Harana/Valle de Carranza,2838,1486,1352
48,Vizcaya,907,Kortezubi,392,201,191
48,Vizcaya,51,Lanestosa,279,138,141
48,Vizcaya,52,Larrabetzu,1663,811,852
48,Vizcaya,53,Laukiz,979,500,479
48,Vizcaya,54,Leioa,29100,14225,14875
48,Vizcaya,57,Lekeitio,7307,3614,3693
48,Vizcaya,55,Lemoa,2817,1400,1417
48,Vizcaya,56,Lemoiz,950,493,457
48,Vizcaya,81,Lezama,2352,1184,1168
48,Vizcaya,903,Loiu,2200,1140,1060
48,Vizcaya,58,Mallabia,1135,586,549
48,Vizcaya,59,Mañaria,459,239,220
48,Vizcaya,60,Markina-Xemein,4575,2349,2226
48,Vizcaya,61,Maruri-Jatabe,843,420,423
48,Vizcaya,62,Mendata,374,196,178
48,Vizcaya,63,Mendexa,400,208,192
48,Vizcaya,64,Meñaka,634,323,311
48,Vizcaya,66,Morga,404,221,183
48,Vizcaya,68,Mundaka,1879,925,954
48,Vizcaya,69,Mungia,15104,7375,7729
48,Vizcaya,7,Munitibar-Arbatzegi Gerrikaitz,380,204,176
48,Vizcaya,908,Murueta,302,153,149
48,Vizcaya,71,Muskiz,6839,3370,3469
48,Vizcaya,67,Muxika,1331,678,653
48,Vizcaya,909,Nabarniz,223,120,103
48,Vizcaya,73,Ondarroa,9277,4683,4594
48,Vizcaya,75,Orozko,2336,1178,1158
48,Vizcaya,83,Ortuella,8618,4188,4430
48,Vizcaya,72,Otxandio,1107,572,535
48,Vizcaya,77,Plentzia,4069,1965,2104
48,Vizcaya,78,Portugalete,49118,23791,25327
48,Vizcaya,82,Santurtzi,47320,23120,24200
48,Vizcaya,84,Sestao,30036,14619,15417
48,Vizcaya,904,Sondika,4389,2112,2277
48,Vizcaya,85,Sopelana,11861,5871,5990
48,Vizcaya,86,Sopuerta,2361,1200,1161
48,Vizcaya,76,Sukarrieta,354,180,174
48,Vizcaya,87,Trucios-Turtzioz,524,265,259
48,Vizcaya,88,Ubide,157,81,76
48,Vizcaya,65,Ugao-Miraballes,4035,2045,1990
48,Vizcaya,89,Urduliz,3139,1575,1564
48,Vizcaya,74,Urduña-Orduña,4096,2111,1985
48,Vizcaya,80,Valle de Trápaga-Trapagaran,12508,6157,6351
48,Vizcaya,95,Zaldibar,2876,1411,1465
48,Vizcaya,96,Zalla,8010,3930,4080
48,Vizcaya,905,Zamudio,3192,1602,1590
48,Vizcaya,97,Zaratamo,1651,823,828
48,Vizcaya,24,Zeanuri,1242,648,594
48,Vizcaya,25,Zeberio,1050,542,508
48,Vizcaya,913,Zierbena,1283,690,593
48,Vizcaya,915,Ziortza-Bolibar,383,205,178
49,Zamora,2,Abezames,90,48,42
49,Zamora,3,Alcañices,1057,523,534
49,Zamora,4,Alcubilla de Nogales,164,79,85
49,Zamora,5,Alfaraz de Sayago,190,104,86
49,Zamora,6,Algodre,173,91,82
49,Zamora,7,Almaraz de Duero,439,220,219
49,Zamora,8,Almeida de Sayago,602,305,297
49,Zamora,9,Andavías,473,244,229
49,Zamora,10,Arcenillas,316,162,154
49,Zamora,11,Arcos de la Polvorosa,274,147,127
49,Zamora,12,Argañín,85,40,45
49,Zamora,13,Argujillo,344,179,165
49,Zamora,14,Arquillinos,160,88,72
49,Zamora,15,Arrabalde,327,151,176
49,Zamora,16,Aspariegos,311,156,155
49,Zamora,17,Asturianos,298,154,144
49,Zamora,18,Ayoó de Vidriales,409,208,201
49,Zamora,19,Barcial del Barco,303,165,138
49,Zamora,20,Belver de los Montes,411,226,185
49,Zamora,21,Benavente,18675,9174,9501
49,Zamora,22,Benegiles,390,209,181
49,Zamora,23,Bermillo de Sayago,1252,669,583
49,Zamora,24,Bóveda de Toro (La),879,444,435
49,Zamora,25,Bretó,231,127,104
49,Zamora,26,Bretocino,293,156,137
49,Zamora,27,Brime de Sog,208,98,110
49,Zamora,28,Brime de Urz,152,84,68
49,Zamora,29,Burganes de Valverde,833,430,403
49,Zamora,30,Bustillo del Oro,125,65,60
49,Zamora,31,Cabañas de Sayago,190,96,94
49,Zamora,32,Calzadilla de Tera,428,203,225
49,Zamora,33,Camarzana de Tera,1012,497,515
49,Zamora,34,Cañizal,591,316,275
49,Zamora,35,Cañizo,293,154,139
49,Zamora,36,Carbajales de Alba,693,351,342
49,Zamora,37,Carbellino,243,126,117
49,Zamora,38,Casaseca de Campeán,127,73,54
49,Zamora,39,Casaseca de las Chanas,358,185,173
49,Zamora,40,Castrillo de la Guareña,148,75,73
49,Zamora,41,Castrogonzalo,532,285,247
49,Zamora,42,Castronuevo,328,166,162
49,Zamora,43,Castroverde de Campos,375,196,179
49,Zamora,44,Cazurra,90,50,40
49,Zamora,46,Cerecinos de Campos,386,198,188
49,Zamora,47,Cerecinos del Carrizal,151,85,66
49,Zamora,48,Cernadilla,180,87,93
49,Zamora,50,Cobreros,636,321,315
49,Zamora,52,Coomonte,275,139,136
49,Zamora,53,Coreses,1130,571,559
49,Zamora,54,Corrales,1055,510,545
49,Zamora,55,Cotanes del Monte,138,73,65
49,Zamora,56,Cubillos,389,198,191
49,Zamora,57,Cubo de Benavente,142,77,65
49,Zamora,58,Cubo de Tierra del Vino (El),435,237,198
49,Zamora,59,Cuelgamures,135,79,56
49,Zamora,61,Entrala,161,83,78
49,Zamora,62,Espadañedo,179,89,90
49,Zamora,63,Faramontanos de Tábara,488,255,233
49,Zamora,64,Fariza,674,331,343
49,Zamora,65,Fermoselle,1499,764,735
49,Zamora,66,Ferreras de Abajo,619,307,312
49,Zamora,67,Ferreras de Arriba,502,252,250
49,Zamora,68,Ferreruela,566,301,265
49,Zamora,69,Figueruela de Arriba,475,218,257
49,Zamora,71,Fonfría,1046,526,520
49,Zamora,75,Fresno de la Polvorosa,190,92,98
49,Zamora,76,Fresno de la Ribera,406,226,180
49,Zamora,77,Fresno de Sayago,226,112,114
49,Zamora,78,Friera de Valverde,243,124,119
49,Zamora,79,Fuente Encalada,132,68,64
49,Zamora,80,Fuentelapeña,918,472,446
49,Zamora,82,Fuentes de Ropel,541,281,260
49,Zamora,81,Fuentesaúco,1918,986,932
49,Zamora,83,Fuentesecas,83,38,45
49,Zamora,84,Fuentespreadas,357,190,167
49,Zamora,85,Galende,1381,691,690
49,Zamora,86,Gallegos del Pan,147,75,72
49,Zamora,87,Gallegos del Río,717,385,332
49,Zamora,88,Gamones,100,57,43
49,Zamora,90,Gema,254,127,127
49,Zamora,91,Granja de Moreruela,327,164,163
49,Zamora,92,Granucillo,206,106,100
49,Zamora,93,Guarrate,378,200,178
49,Zamora,94,Hermisende,364,201,163
49,Zamora,95,Hiniesta (La),353,173,180
49,Zamora,96,Jambrina,213,103,110
49,Zamora,97,Justel,132,75,57
49,Zamora,98,Losacino,286,156,130
49,Zamora,99,Losacio,120,63,57
49,Zamora,100,Lubián,371,191,180
49,Zamora,101,Luelmo,226,111,115
49,Zamora,102,Maderal (El),262,138,124
49,Zamora,103,Madridanos,525,264,261
49,Zamora,104,Mahide,466,249,217
49,Zamora,105,Maire de Castroponce,204,105,99
49,Zamora,107,Malva,191,99,92
49,Zamora,108,Manganeses de la Lampreana,665,333,332
49,Zamora,109,Manganeses de la Polvorosa,772,376,396
49,Zamora,110,Manzanal de Arriba,440,226,214
49,Zamora,112,Manzanal de los Infantes,161,85,76
49,Zamora,111,Manzanal del Barco,182,95,87
49,Zamora,113,Matilla de Arzón,226,125,101
49,Zamora,114,Matilla la Seca,59,26,33
49,Zamora,115,Mayalde,244,124,120
49,Zamora,116,Melgar de Tera,492,242,250
49,Zamora,117,Micereces de Tera,580,299,281
49,Zamora,118,Milles de la Polvorosa,244,129,115
49,Zamora,119,Molacillos,289,152,137
49,Zamora,120,Molezuelas de la Carballeda,82,38,44
49,Zamora,121,Mombuey,416,215,201
49,Zamora,122,Monfarracinos,794,411,383
49,Zamora,123,Montamarta,606,308,298
49,Zamora,124,Moral de Sayago,329,182,147
49,Zamora,126,Moraleja de Sayago,289,152,137
49,Zamora,125,Moraleja del Vino,1378,731,647
49,Zamora,128,Morales de Rey,697,349,348
49,Zamora,129,Morales de Toro,1075,532,543
49,Zamora,130,Morales de Valverde,267,132,135
49,Zamora,127,Morales del Vino,2204,1162,1042
49,Zamora,131,Moralina,344,170,174
49,Zamora,132,Moreruela de los Infanzones,431,222,209
49,Zamora,133,Moreruela de Tábara,462,245,217
49,Zamora,134,Muelas de los Caballeros,243,140,103
49,Zamora,135,Muelas del Pan,815,413,402
49,Zamora,136,Muga de Sayago,444,209,235
49,Zamora,137,Navianos de Valverde,235,124,111
49,Zamora,138,Olmillos de Castro,365,191,174
49,Zamora,139,Otero de Bodas,218,115,103
49,Zamora,141,Pajares de la Lampreana,471,233,238
49,Zamora,143,Palacios de Sanabria,299,154,145
49,Zamora,142,Palacios del Pan,225,103,122
49,Zamora,145,Pedralba de la Pradería,296,143,153
49,Zamora,146,Pego (El),385,197,188
49,Zamora,147,Peleagonzalo,354,177,177
49,Zamora,148,Peleas de Abajo,245,117,128
49,Zamora,149,Peñausende,473,236,237
49,Zamora,150,Peque,166,77,89
49,Zamora,151,Perdigón (El),785,412,373
49,Zamora,152,Pereruela,694,367,327
49,Zamora,153,Perilla de Castro,208,101,107
49,Zamora,154,Pías,185,94,91
49,Zamora,155,Piedrahita de Castro,134,75,59
49,Zamora,156,Pinilla de Toro,316,161,155
49,Zamora,157,Pino del Oro,203,108,95
49,Zamora,158,Piñero (El),265,140,125
49,Zamora,160,Pobladura de Valderaduey,67,37,30
49,Zamora,159,Pobladura del Valle,333,171,162
49,Zamora,162,Porto,273,146,127
49,Zamora,163,Pozoantiguo,283,147,136
49,Zamora,164,Pozuelo de Tábara,190,91,99
49,Zamora,165,Prado,92,49,43
49,Zamora,166,Puebla de Sanabria,1594,743,851
49,Zamora,167,Pueblica de Valverde,270,137,133
49,Zamora,170,Quintanilla de Urz,154,75,79
49,Zamora,168,Quintanilla del Monte,127,61,66
49,Zamora,169,Quintanilla del Olmo,45,23,22
49,Zamora,171,Quiruelas de Vidriales,866,412,454
49,Zamora,172,Rabanales,721,372,349
49,Zamora,173,Rábano de Aliste,428,220,208
49,Zamora,174,Requejo,177,90,87
49,Zamora,175,Revellinos,294,159,135
49,Zamora,176,Riofrío de Aliste,981,517,464
49,Zamora,177,Rionegro del Puente,356,177,179
49,Zamora,178,Roales,521,262,259
49,Zamora,179,Robleda-Cervantes,451,224,227
49,Zamora,180,Roelos de Sayago,138,71,67
49,Zamora,181,Rosinos de la Requejada,456,220,236
49,Zamora,183,Salce,121,65,56
49,Zamora,184,Samir de los Caños,210,114,96
49,Zamora,185,San Agustín del Pozo,212,113,99
49,Zamora,186,San Cebrián de Castro,325,158,167
49,Zamora,187,San Cristóbal de Entreviñas,1634,842,792
49,Zamora,188,San Esteban del Molar,169,95,74
49,Zamora,189,San Justo,311,157,154
49,Zamora,190,San Martín de Valderaduey,88,44,44
49,Zamora,191,San Miguel de la Ribera,368,188,180
49,Zamora,192,San Miguel del Valle,202,98,104
49,Zamora,193,San Pedro de Ceque,630,317,313
49,Zamora,194,San Pedro de la Nave-Almendra,440,218,222
49,Zamora,208,San Vicente de la Cabeza,524,272,252
49,Zamora,209,San Vitero,669,359,310
49,Zamora,197,Santa Clara de Avedillo,226,113,113
49,Zamora,199,Santa Colomba de las Monjas,303,150,153
49,Zamora,200,Santa Cristina de la Polvorosa,1218,616,602
49,Zamora,201,Santa Croya de Tera,415,212,203
49,Zamora,202,Santa Eufemia del Barco,270,145,125
49,Zamora,203,Santa María de la Vega,440,226,214
49,Zamora,204,Santa María de Valverde,96,47,49
49,Zamora,205,Santibáñez de Tera,559,274,285
49,Zamora,206,Santibáñez de Vidriales,1209,604,605
49,Zamora,207,Santovenia,338,159,179
49,Zamora,210,Sanzoles,636,324,312
49,Zamora,214,Tábara,965,498,467
49,Zamora,216,Tapioles,211,115,96
49,Zamora,219,Toro,9667,4734,4933
49,Zamora,220,Torre del Valle (La),186,103,83
49,Zamora,221,Torregamones,315,170,145
49,Zamora,222,Torres del Carrizal,491,255,236
49,Zamora,223,Trabazos,974,494,480
49,Zamora,224,Trefacio,216,106,110
49,Zamora,225,Uña de Quintana,207,107,100
49,Zamora,226,Vadillo de la Guareña,345,182,163
49,Zamora,227,Valcabado,335,164,171
49,Zamora,228,Valdefinjas,80,47,33
49,Zamora,229,Valdescorriel,201,103,98
49,Zamora,230,Vallesa de la Guareña,153,82,71
49,Zamora,231,Vega de Tera,456,220,236
49,Zamora,232,Vega de Villalobos,143,64,79
49,Zamora,233,Vegalatrave,144,78,66
49,Zamora,234,Venialbo,488,269,219
49,Zamora,235,Vezdemarbán,612,299,313
49,Zamora,236,Vidayanes,104,54,50
49,Zamora,237,Videmala,190,91,99
49,Zamora,238,Villabrázaro,349,177,172
49,Zamora,239,Villabuena del Puente,877,467,410
49,Zamora,240,Villadepera,260,133,127
49,Zamora,241,Villaescusa,354,176,178
49,Zamora,242,Villafáfila,607,310,297
49,Zamora,243,Villaferrueña,148,75,73
49,Zamora,244,Villageriz,53,29,24
49,Zamora,245,Villalazán,366,177,189
49,Zamora,246,Villalba de la Lampreana,282,151,131
49,Zamora,247,Villalcampo,605,311,294
49,Zamora,248,Villalobos,319,157,162
49,Zamora,249,Villalonso,112,58,54
49,Zamora,250,Villalpando,1616,793,823
49,Zamora,251,Villalube,229,117,112
49,Zamora,252,Villamayor de Campos,477,240,237
49,Zamora,255,Villamor de los Escuderos,532,270,262
49,Zamora,256,Villanázar,354,170,184
49,Zamora,257,Villanueva de Azoague,319,164,155
49,Zamora,258,Villanueva de Campeán,150,77,73
49,Zamora,259,Villanueva de las Peras,154,80,74
49,Zamora,260,Villanueva del Campo,1030,516,514
49,Zamora,263,Villar de Fallaves,87,47,40
49,Zamora,264,Villar del Buey,773,416,357
49,Zamora,261,Villaralbo,1753,882,871
49,Zamora,262,Villardeciervos,486,242,244
49,Zamora,265,Villardiegua de la Ribera,160,82,78
49,Zamora,266,Villárdiga,97,51,46
49,Zamora,267,Villardondiego,123,72,51
49,Zamora,268,Villarrín de Campos,587,307,280
49,Zamora,269,Villaseco del Pan,262,121,141
49,Zamora,270,Villavendimio,192,108,84
49,Zamora,272,Villaveza de Valverde,116,58,58
49,Zamora,271,Villaveza del Agua,246,127,119
49,Zamora,273,Viñas,247,124,123
49,Zamora,275,Zamora,66135,31242,34893
50,Zaragoza,1,Abanto,150,80,70
50,Zaragoza,2,Acered,210,116,94
50,Zaragoza,3,Agón,176,94,82
50,Zaragoza,4,Aguarón,798,403,395
50,Zaragoza,5,Aguilón,274,140,134
50,Zaragoza,6,Ainzón,1268,657,611
50,Zaragoza,7,Aladrén,62,39,23
50,Zaragoza,8,Alagón,6293,3156,3137
50,Zaragoza,9,Alarba,148,82,66
50,Zaragoza,10,Alberite de San Juan,106,66,40
50,Zaragoza,11,Albeta,144,71,73
50,Zaragoza,12,Alborge,125,64,61
50,Zaragoza,13,Alcalá de Ebro,292,143,149
50,Zaragoza,14,Alcalá de Moncayo,128,70,58
50,Zaragoza,15,Alconchel de Ariza,119,69,50
50,Zaragoza,16,Aldehuela de Liestos,31,20,11
50,Zaragoza,17,Alfajarín,1879,982,897
50,Zaragoza,18,Alfamén,1588,933,655
50,Zaragoza,19,Alforque,83,45,38
50,Zaragoza,20,Alhama de Aragón,1129,586,543
50,Zaragoza,21,Almochuel,39,21,18
50,Zaragoza,22,Almolda (La),638,328,310
50,Zaragoza,23,Almonacid de la Cuba,302,153,149
50,Zaragoza,24,Almonacid de la Sierra,853,469,384
50,Zaragoza,25,Almunia de Doña Godina (La),7023,3670,3353
50,Zaragoza,26,Alpartir,576,301,275
50,Zaragoza,27,Ambel,329,150,179
50,Zaragoza,28,Anento,157,103,54
50,Zaragoza,29,Aniñón,832,449,383
50,Zaragoza,30,Añón de Moncayo,231,141,90
50,Zaragoza,31,Aranda de Moncayo,228,128,100
50,Zaragoza,32,Arándiga,430,220,210
50,Zaragoza,33,Ardisa,86,52,34
50,Zaragoza,34,Ariza,1221,617,604
50,Zaragoza,35,Artieda,106,65,41
50,Zaragoza,36,Asín,113,61,52
50,Zaragoza,37,Atea,164,94,70
50,Zaragoza,38,Ateca,2045,1027,1018
50,Zaragoza,39,Azuara,657,358,299
50,Zaragoza,40,Badules,112,57,55
50,Zaragoza,41,Bagüés,34,20,14
50,Zaragoza,42,Balconchán,13,3,10
50,Zaragoza,43,Bárboles,331,177,154
50,Zaragoza,44,Bardallur,267,132,135
50,Zaragoza,45,Belchite,1633,846,787
50,Zaragoza,46,Belmonte de Gracián,231,122,109
50,Zaragoza,47,Berdejo,74,42,32
50,Zaragoza,48,Berrueco,46,24,22
50,Zaragoza,901,Biel,215,124,91
50,Zaragoza,50,Bijuesca,132,78,54
50,Zaragoza,51,Biota,1139,584,555
50,Zaragoza,52,Bisimbre,108,52,56
50,Zaragoza,53,Boquiñeni,1035,537,498
50,Zaragoza,54,Bordalba,95,56,39
50,Zaragoza,55,Borja,4501,2245,2256
50,Zaragoza,56,Botorrita,503,271,232
50,Zaragoza,57,Brea de Aragón,1894,963,931
50,Zaragoza,58,Bubierca,88,44,44
50,Zaragoza,59,Bujaraloz,997,520,477
50,Zaragoza,60,Bulbuente,256,132,124
50,Zaragoza,61,Bureta,288,150,138
50,Zaragoza,62,Burgo de Ebro (El),1937,1014,923
50,Zaragoza,63,Buste (El),94,47,47
50,Zaragoza,64,Cabañas de Ebro,548,282,266
50,Zaragoza,65,Cabolafuente,57,31,26
50,Zaragoza,66,Cadrete,2431,1292,1139
50,Zaragoza,67,Calatayud,20001,9900,10101
50,Zaragoza,68,Calatorao,2902,1528,1374
50,Zaragoza,69,Calcena,61,31,30
50,Zaragoza,70,Calmarza,71,39,32
50,Zaragoza,71,Campillo de Aragón,172,94,78
50,Zaragoza,72,Carenas,221,110,111
50,Zaragoza,73,Cariñena,3277,1716,1561
50,Zaragoza,74,Caspe,8486,4390,4096
50,Zaragoza,75,Castejón de Alarba,104,53,51
50,Zaragoza,76,Castejón de las Armas,111,61,50
50,Zaragoza,77,Castejón de Valdejasa,301,152,149
50,Zaragoza,78,Castiliscar,367,192,175
50,Zaragoza,79,Cervera de la Cañada,329,169,160
50,Zaragoza,80,Cerveruela,35,22,13
50,Zaragoza,81,Cetina,707,348,359
50,Zaragoza,92,Chiprana,328,162,166
50,Zaragoza,93,Chodes,146,75,71
50,Zaragoza,82,Cimballa,140,67,73
50,Zaragoza,83,Cinco Olivas,122,59,63
50,Zaragoza,84,Clarés de Ribota,102,56,46
50,Zaragoza,85,Codo,232,110,122
50,Zaragoza,86,Codos,272,165,107
50,Zaragoza,87,Contamina,43,25,18
50,Zaragoza,88,Cosuenda,377,193,184
50,Zaragoza,89,Cuarte de Huerva,3837,2019,1818
50,Zaragoza,90,Cubel,209,102,107
50,Zaragoza,91,Cuerlas (Las),85,42,43
50,Zaragoza,94,Daroca,2326,1188,1138
50,Zaragoza,95,Ejea de los Caballeros,16785,8693,8092
50,Zaragoza,96,Embid de Ariza,66,35,31
50,Zaragoza,98,Encinacorba,279,146,133
50,Zaragoza,99,Épila,4184,2179,2005
50,Zaragoza,100,Erla,434,214,220
50,Zaragoza,101,Escatrón,1155,564,591
50,Zaragoza,102,Fabara,1221,663,558
50,Zaragoza,104,Farlete,447,222,225
50,Zaragoza,105,Fayón,427,220,207
50,Zaragoza,106,Fayos (Los),172,86,86
50,Zaragoza,107,Figueruelas,1130,567,563
50,Zaragoza,108,Fombuena,51,34,17
50,Zaragoza,109,Frago (El),127,75,52
50,Zaragoza,110,Frasno (El),494,259,235
50,Zaragoza,111,Fréscano,237,125,112
50,Zaragoza,113,Fuendejalón,851,465,386
50,Zaragoza,114,Fuendetodos,167,88,79
50,Zaragoza,115,Fuentes de Ebro,4002,2094,1908
50,Zaragoza,116,Fuentes de Jiloca,296,156,140
50,Zaragoza,117,Gallocanta,155,79,76
50,Zaragoza,118,Gallur,2899,1477,1422
50,Zaragoza,119,Gelsa,1205,607,598
50,Zaragoza,120,Godojos,57,29,28
50,Zaragoza,121,Gotor,382,199,183
50,Zaragoza,122,Grisel,79,48,31
50,Zaragoza,123,Grisén,467,240,227
50,Zaragoza,124,Herrera de los Navarros,670,350,320
50,Zaragoza,125,Ibdes,501,258,243
50,Zaragoza,126,Illueca,3288,1611,1677
50,Zaragoza,128,Isuerre,50,34,16
50,Zaragoza,129,Jaraba,324,177,147
50,Zaragoza,130,Jarque,541,288,253
50,Zaragoza,131,Jaulín,316,167,149
50,Zaragoza,132,Joyosa (La),733,372,361
50,Zaragoza,133,Lagata,155,91,64
50,Zaragoza,134,Langa del Castillo,159,79,80
50,Zaragoza,135,Layana,122,65,57
50,Zaragoza,136,Lécera,758,389,369
50,Zaragoza,138,Lechón,59,35,24
50,Zaragoza,137,Leciñena,1288,646,642
50,Zaragoza,139,Letux,397,210,187
50,Zaragoza,140,Litago,187,101,86
50,Zaragoza,141,Lituénigo,128,64,64
50,Zaragoza,142,Lobera de Onsella,54,35,19
50,Zaragoza,143,Longares,879,495,384
50,Zaragoza,144,Longás,44,29,15
50,Zaragoza,146,Lucena de Jalón,274,148,126
50,Zaragoza,147,Luceni,1052,537,515
50,Zaragoza,148,Luesia,407,221,186
50,Zaragoza,149,Luesma,36,20,16
50,Zaragoza,150,Lumpiaque,970,507,463
50,Zaragoza,151,Luna,853,446,407
50,Zaragoza,152,Maella,2089,1121,968
50,Zaragoza,153,Magallón,1148,619,529
50,Zaragoza,154,Mainar,157,87,70
50,Zaragoza,155,Malanquilla,130,75,55
50,Zaragoza,156,Maleján,297,148,149
50,Zaragoza,160,Mallén,3327,1757,1570
50,Zaragoza,157,Malón,403,203,200
50,Zaragoza,159,Maluenda,1055,518,537
50,Zaragoza,161,Manchones,146,80,66
50,Zaragoza,162,Mara,199,100,99
50,Zaragoza,163,María de Huerva,2917,1576,1341
50,Zaragoza,902,Marracos,115,57,58
50,Zaragoza,164,Mediana de Aragón,500,253,247
50,Zaragoza,165,Mequinenza,2533,1287,1246
50,Zaragoza,166,Mesones de Isuela,321,162,159
50,Zaragoza,167,Mezalocha,260,146,114
50,Zaragoza,168,Mianos,45,24,21
50,Zaragoza,169,Miedes de Aragón,469,241,228
50,Zaragoza,170,Monegrillo,495,275,220
50,Zaragoza,171,Moneva,99,53,46
50,Zaragoza,172,Monreal de Ariza,239,128,111
50,Zaragoza,173,Monterde,217,123,94
50,Zaragoza,174,Montón,134,70,64
50,Zaragoza,175,Morata de Jalón,1385,686,699
50,Zaragoza,176,Morata de Jiloca,267,140,127
50,Zaragoza,177,Morés,460,239,221
50,Zaragoza,178,Moros,478,241,237
50,Zaragoza,179,Moyuela,297,158,139
50,Zaragoza,180,Mozota,126,63,63
50,Zaragoza,181,Muel,1200,616,584
50,Zaragoza,182,Muela (La),3567,1837,1730
50,Zaragoza,183,Munébrega,437,235,202
50,Zaragoza,184,Murero,146,80,66
50,Zaragoza,185,Murillo de Gállego,177,100,77
50,Zaragoza,186,Navardún,50,28,22
50,Zaragoza,187,Nigüella,89,47,42
50,Zaragoza,188,Nombrevilla,46,25,21
50,Zaragoza,189,Nonaspe,1055,546,509
50,Zaragoza,190,Novallas,818,421,397
50,Zaragoza,191,Novillas,645,333,312
50,Zaragoza,192,Nuévalos,338,181,157
50,Zaragoza,193,Nuez de Ebro,699,359,340
50,Zaragoza,194,Olvés,115,63,52
50,Zaragoza,195,Orcajo,37,20,17
50,Zaragoza,196,Orera,133,69,64
50,Zaragoza,197,Orés,104,60,44
50,Zaragoza,198,Oseja,47,27,20
50,Zaragoza,199,Osera de Ebro,395,210,185
50,Zaragoza,200,Paniza,742,402,340
50,Zaragoza,201,Paracuellos de Jiloca,507,257,250
50,Zaragoza,202,Paracuellos de la Ribera,211,98,113
50,Zaragoza,203,Pastriz,1326,650,676
50,Zaragoza,204,Pedrola,3168,1652,1516
50,Zaragoza,205,Pedrosas (Las),100,54,46
50,Zaragoza,206,Perdiguera,621,316,305
50,Zaragoza,207,Piedratajada,165,86,79
50,Zaragoza,208,Pina de Ebro,2399,1237,1162
50,Zaragoza,209,Pinseque,2724,1381,1343
50,Zaragoza,210,Pintanos (Los),52,34,18
50,Zaragoza,211,Plasencia de Jalón,350,196,154
50,Zaragoza,212,Pleitas,57,32,25
50,Zaragoza,213,Plenas,112,57,55
50,Zaragoza,214,Pomer,38,24,14
50,Zaragoza,215,Pozuel de Ariza,23,14,9
50,Zaragoza,216,Pozuelo de Aragón,331,180,151
50,Zaragoza,217,Pradilla de Ebro,644,332,312
50,Zaragoza,218,Puebla de Albortón,144,88,56
50,Zaragoza,219,Puebla de Alfindén (La),4029,2050,1979
50,Zaragoza,220,Puendeluna,64,40,24
50,Zaragoza,221,Purujosa,54,43,11
50,Zaragoza,222,Quinto,2062,1042,1020
50,Zaragoza,223,Remolinos,1202,613,589
50,Zaragoza,224,Retascón,94,50,44
50,Zaragoza,225,Ricla,2652,1454,1198
50,Zaragoza,227,Romanos,120,69,51
50,Zaragoza,228,Rueda de Jalón,372,194,178
50,Zaragoza,229,Ruesca,82,42,40
50,Zaragoza,241,Sabiñán,758,367,391
50,Zaragoza,230,Sádaba,1713,874,839
50,Zaragoza,231,Salillas de Jalón,357,192,165
50,Zaragoza,232,Salvatierra de Esca,259,125,134
50,Zaragoza,233,Samper del Salz,114,60,54
50,Zaragoza,234,San Martín de la Virgen de Moncayo,292,163,129
50,Zaragoza,235,San Mateo de Gállego,2604,1353,1251
50,Zaragoza,236,Santa Cruz de Grío,190,101,89
50,Zaragoza,237,Santa Cruz de Moncayo,109,52,57
50,Zaragoza,238,Santa Eulalia de Gállego,120,63,57
50,Zaragoza,239,Santed,69,36,33
50,Zaragoza,240,Sástago,1249,634,615
50,Zaragoza,242,Sediles,87,46,41
50,Zaragoza,243,Sestrica,446,245,201
50,Zaragoza,244,Sierra de Luna,296,154,142
50,Zaragoza,245,Sigüés,154,80,74
50,Zaragoza,246,Sisamón,54,37,17
50,Zaragoza,247,Sobradiel,851,441,410
50,Zaragoza,248,Sos del Rey Católico,716,362,354
50,Zaragoza,249,Tabuenca,447,252,195
50,Zaragoza,250,Talamantes,65,35,30
50,Zaragoza,251,Tarazona,11027,5388,5639
50,Zaragoza,252,Tauste,7503,3781,3722
50,Zaragoza,253,Terrer,560,281,279
50,Zaragoza,254,Tierga,203,111,92
50,Zaragoza,255,Tobed,251,129,122
50,Zaragoza,256,Torralba de los Frailes,101,57,44
50,Zaragoza,257,Torralba de Ribota,191,100,91
50,Zaragoza,258,Torralbilla,73,39,34
50,Zaragoza,259,Torrehermosa,92,48,44
50,Zaragoza,260,Torrelapaja,36,21,15
50,Zaragoza,261,Torrellas,304,168,136
50,Zaragoza,262,Torres de Berrellén,1449,746,703
50,Zaragoza,263,Torrijo de la Cañada,320,171,149
50,Zaragoza,264,Tosos,215,120,95
50,Zaragoza,265,Trasmoz,71,38,33
50,Zaragoza,266,Trasobares,178,102,76
50,Zaragoza,267,Uncastillo,854,415,439
50,Zaragoza,268,Undués de Lerda,66,39,27
50,Zaragoza,269,Urrea de Jalón,369,185,184
50,Zaragoza,270,Urriés,58,35,23
50,Zaragoza,271,Used,369,206,163
50,Zaragoza,272,Utebo,14920,7625,7295
50,Zaragoza,274,Val de San Martín,87,46,41
50,Zaragoza,273,Valdehorna,44,23,21
50,Zaragoza,275,Valmadrid,90,62,28
50,Zaragoza,276,Valpalmas,167,84,83
50,Zaragoza,277,Valtorres,109,55,54
50,Zaragoza,278,Velilla de Ebro,260,130,130
50,Zaragoza,279,Velilla de Jiloca,104,53,51
50,Zaragoza,280,Vera de Moncayo,431,225,206
50,Zaragoza,281,Vierlas,101,49,52
50,Zaragoza,283,Villadoz,97,56,41
50,Zaragoza,284,Villafeliche,207,102,105
50,Zaragoza,285,Villafranca de Ebro,733,364,369
50,Zaragoza,286,Villalba de Perejil,121,64,57
50,Zaragoza,287,Villalengua,378,195,183
50,Zaragoza,288,Villanueva de Gállego,3903,1963,1940
50,Zaragoza,290,Villanueva de Huerva,590,314,276
50,Zaragoza,289,Villanueva de Jiloca,77,40,37
50,Zaragoza,291,Villar de los Navarros,139,69,70
50,Zaragoza,292,Villarreal de Huerva,195,111,84
50,Zaragoza,293,Villarroya de la Sierra,611,313,298
50,Zaragoza,294,Villarroya del Campo,79,44,35
50,Zaragoza,282,Vilueña (La),103,52,51
50,Zaragoza,295,Vistabella,39,26,13
50,Zaragoza,296,Zaida (La),537,270,267
50,Zaragoza,297,Zaragoza,649181,314460,334721
50,Zaragoza,298,Zuera,6424,3311,3113
51,Ceuta,1,Ceuta,75861,38581,37280
52,Melilla,1,Melilla,66871,33962,32909
