CPRO,PROVINCIA,CMUN,NOMBRE,POB18,HOMBRES,MUJERES
2,Albacete,1,Abengibre,757,363,394
2,Albacete,2,Alatoz,529,300,229
2,Albacete,3,Albacete,173050,84613,88437
2,Albacete,4,Albatana,693,357,336
2,Albacete,5,Alborea,650,339,311
2,Albacete,6,Alcadozo,655,356,299
2,Albacete,7,Alcalá del Júcar,1199,639,560
2,Albacete,8,Alcaraz,1405,724,681
2,Albacete,9,Almansa,24537,12215,12322
2,Albacete,10,Alpera,2275,1183,1092
2,Albacete,11,Ayna,638,341,297
2,Albacete,12,Balazote,2360,1205,1155
2,Albacete,14,"Ballestero, El",409,208,201
2,Albacete,13,Balsa de Ves,150,85,65
2,Albacete,15,Barrax,1864,941,923
2,Albacete,16,Bienservida,610,326,284
2,Albacete,17,Bogarra,873,462,411
2,Albacete,18,Bonete,1057,538,519
2,Albacete,19,"Bonillo, El",2837,1447,1390
2,Albacete,20,Carcelén,508,279,229
2,Albacete,21,Casas de Juan Núñez,1275,669,606
2,Albacete,22,Casas de Lázaro,344,194,150
2,Albacete,23,Casas de Ves,588,311,277
2,Albacete,24,Casas-Ibáñez,4522,2291,2231
2,Albacete,25,Caudete,10003,5089,4914
2,Albacete,26,Cenizate,1182,601,581
2,Albacete,29,Chinchilla de Monte-Aragón,4182,2183,1999
2,Albacete,27,Corral-Rubio,330,177,153
2,Albacete,28,Cotillas,128,64,64
2,Albacete,30,Elche de la Sierra,3624,1819,1805
2,Albacete,31,Férez,674,327,347
2,Albacete,32,Fuensanta,297,168,129
2,Albacete,33,Fuente-Álamo,2489,1303,1186
2,Albacete,34,Fuentealbilla,1816,912,904
2,Albacete,35,"Gineta, La",2448,1259,1189
2,Albacete,36,Golosalvo,110,58,52
2,Albacete,37,Hellín,30268,15124,15144
2,Albacete,38,"Herrera, La",349,181,168
2,Albacete,39,Higueruela,1184,610,574
2,Albacete,40,Hoya-Gonzalo,621,332,289
2,Albacete,41,Jorquera,360,195,165
2,Albacete,42,Letur,928,448,480
2,Albacete,43,Lezuza,1398,721,677
2,Albacete,44,Liétor,1200,626,574
2,Albacete,45,Madrigueras,4665,2387,2278
2,Albacete,46,Mahora,1359,698,661
2,Albacete,47,Masegoso,113,62,51
2,Albacete,48,Minaya,1537,799,738
2,Albacete,49,Molinicos,840,435,405
2,Albacete,50,Montalvos,96,53,43
2,Albacete,51,Montealegre del Castillo,2042,1036,1006
2,Albacete,52,Motilleja,548,292,256
2,Albacete,53,Munera,3513,1793,1720
2,Albacete,54,Navas de Jorquera,518,271,247
2,Albacete,55,Nerpio,1222,676,546
2,Albacete,56,Ontur,2028,1022,1006
2,Albacete,57,Ossa de Montiel,2352,1169,1183
2,Albacete,58,Paterna del Madera,360,194,166
2,Albacete,60,Peñas de San Pedro,1420,832,588
2,Albacete,59,Peñascosa,331,181,150
2,Albacete,61,Pétrola,696,359,337
2,Albacete,62,Povedilla,446,247,199
2,Albacete,901,Pozo Cañada,2786,1401,1385
2,Albacete,63,Pozohondo,1635,853,782
2,Albacete,64,Pozo-Lorente,401,205,196
2,Albacete,65,Pozuelo,489,258,231
2,Albacete,66,"Recueja, La",254,133,121
2,Albacete,67,Riópar,1357,696,661
2,Albacete,68,Robledo,363,200,163
2,Albacete,69,"Roda, La",15515,7835,7680
2,Albacete,70,Salobre,501,265,236
2,Albacete,71,San Pedro,1153,587,566
2,Albacete,72,Socovos,1790,920,870
2,Albacete,73,Tarazona de la Mancha,6255,3198,3057
2,Albacete,74,Tobarra,7738,3955,3783
2,Albacete,75,Valdeganga,1943,1004,939
2,Albacete,76,Vianos,355,179,176
2,Albacete,77,Villa de Ves,57,34,23
2,Albacete,78,Villalgordo del Júcar,1115,585,530
2,Albacete,79,Villamalea,4112,2077,2035
2,Albacete,80,Villapalacios,589,307,282
2,Albacete,81,Villarrobledo,25241,12463,12778
2,Albacete,82,Villatoya,95,58,37
2,Albacete,83,Villavaliente,226,137,89
2,Albacete,84,Villaverde de Guadalimar,340,174,166
2,Albacete,85,Viveros,340,174,166
2,Albacete,86,Yeste,2674,1371,1303
3,Alicante/Alacant,2,Agost,4713,2344,2369
3,Alicante/Alacant,3,Agres,551,294,257
3,Alicante/Alacant,4,Aigües,936,493,443
3,Alicante/Alacant,5,Albatera,12042,6172,5870
3,Alicante/Alacant,6,Alcalalí,1298,645,653
3,Alicante/Alacant,7,Alcocer de Planes,229,115,114
3,Alicante/Alacant,8,Alcoleja,180,94,86
3,Alicante/Alacant,9,Alcoy/Alcoi,58977,28806,30171
3,Alicante/Alacant,10,Alfafara,407,198,209
3,Alicante/Alacant,11,"Alfàs del Pi, l'",20053,9947,10106
3,Alicante/Alacant,12,Algorfa,2838,1427,1411
3,Alicante/Alacant,13,Algueña,1341,671,670
3,Alicante/Alacant,14,Alicante/Alacant,331577,160595,170982
3,Alicante/Alacant,15,Almoradí,20542,10398,10144
3,Alicante/Alacant,16,Almudaina,104,54,50
3,Alicante/Alacant,17,"Alqueria d'Asnar, l'",491,237,254
3,Alicante/Alacant,18,Altea,21995,10756,11239
3,Alicante/Alacant,19,Aspe,20537,10324,10213
3,Alicante/Alacant,1,"Atzúbia, l'",661,346,315
3,Alicante/Alacant,20,Balones,122,65,57
3,Alicante/Alacant,21,Banyeres de Mariola,7113,3562,3551
3,Alicante/Alacant,22,Benasau,156,77,79
3,Alicante/Alacant,23,Beneixama,1703,866,837
3,Alicante/Alacant,24,Benejúzar,5361,2689,2672
3,Alicante/Alacant,25,Benferri,1940,1011,929
3,Alicante/Alacant,26,Beniarbeig,1983,1005,978
3,Alicante/Alacant,27,Beniardá,178,89,89
3,Alicante/Alacant,28,Beniarrés,1118,566,552
3,Alicante/Alacant,30,Benidoleig,1110,556,554
3,Alicante/Alacant,31,Benidorm,67558,33581,33977
3,Alicante/Alacant,32,Benifallim,108,59,49
3,Alicante/Alacant,33,Benifato,149,74,75
3,Alicante/Alacant,29,Benigembla,444,228,216
3,Alicante/Alacant,34,Benijófar,3357,1634,1723
3,Alicante/Alacant,35,Benilloba,742,384,358
3,Alicante/Alacant,36,Benillup,94,43,51
3,Alicante/Alacant,37,Benimantell,490,241,249
3,Alicante/Alacant,38,Benimarfull,413,205,208
3,Alicante/Alacant,39,Benimassot,96,55,41
3,Alicante/Alacant,40,Benimeli,410,190,220
3,Alicante/Alacant,41,Benissa,10768,5264,5504
3,Alicante/Alacant,42,"Benitachell/Poble Nou de Benitatxell, el",4130,2039,2091
3,Alicante/Alacant,43,Biar,3651,1792,1859
3,Alicante/Alacant,44,Bigastro,6702,3380,3322
3,Alicante/Alacant,45,Bolulla,418,221,197
3,Alicante/Alacant,46,Busot,2925,1498,1427
3,Alicante/Alacant,49,Callosa de Segura,18864,9602,9262
3,Alicante/Alacant,48,Callosa d'en Sarrià,7257,3708,3549
3,Alicante/Alacant,47,Calp,21633,10900,10733
3,Alicante/Alacant,50,"Campello, el",27893,13565,14328
3,Alicante/Alacant,51,"Campo de Mirra/Camp de Mirra, el",428,218,210
3,Alicante/Alacant,52,Cañada,1214,609,605
3,Alicante/Alacant,53,Castalla,9880,5016,4864
3,Alicante/Alacant,54,Castell de Castells,435,223,212
3,Alicante/Alacant,75,"Castell de Guadalest, el",209,104,105
3,Alicante/Alacant,55,Catral,8631,4319,4312
3,Alicante/Alacant,56,Cocentaina,11456,5822,5634
3,Alicante/Alacant,57,Confrides,208,118,90
3,Alicante/Alacant,58,Cox,7226,3698,3528
3,Alicante/Alacant,59,Crevillent,28957,14640,14317
3,Alicante/Alacant,61,Daya Nueva,1718,850,868
3,Alicante/Alacant,62,Daya Vieja,685,356,329
3,Alicante/Alacant,63,Dénia,41733,20245,21488
3,Alicante/Alacant,64,Dolores,7383,3689,3694
3,Alicante/Alacant,65,Elche/Elx,230625,114332,116293
3,Alicante/Alacant,66,Elda,52404,25549,26855
3,Alicante/Alacant,67,Facheca,101,52,49
3,Alicante/Alacant,68,Famorca,53,29,24
3,Alicante/Alacant,69,Finestrat,6381,3231,3150
3,Alicante/Alacant,77,"Fondó de les Neus, el/Hondón de las Nieves",2474,1256,1218
3,Alicante/Alacant,70,Formentera del Segura,4131,2069,2062
3,Alicante/Alacant,72,Gaianes,471,241,230
3,Alicante/Alacant,71,Gata de Gorgos,5893,2974,2919
3,Alicante/Alacant,73,Gorga,258,144,114
3,Alicante/Alacant,74,Granja de Rocamora,2489,1310,1179
3,Alicante/Alacant,76,Guardamar del Segura,15058,7358,7700
3,Alicante/Alacant,78,Hondón de los Frailes,1132,585,547
3,Alicante/Alacant,79,Ibi,23403,11720,11683
3,Alicante/Alacant,80,Jacarilla,1986,1009,977
3,Alicante/Alacant,82,Jávea/Xàbia,27224,13528,13696
3,Alicante/Alacant,83,Jijona/Xixona,6875,3342,3533
3,Alicante/Alacant,85,Llíber,1051,529,522
3,Alicante/Alacant,84,"Lorcha/Orxa, l'",596,293,303
3,Alicante/Alacant,86,Millena,229,122,107
3,Alicante/Alacant,88,Monforte del Cid,7944,4172,3772
3,Alicante/Alacant,89,Monóvar/Monòver,12175,6077,6098
3,Alicante/Alacant,903,"Montesinos, Los",4844,2453,2391
3,Alicante/Alacant,91,Murla,493,233,260
3,Alicante/Alacant,92,Muro de Alcoy,9328,4627,4701
3,Alicante/Alacant,90,Mutxamel,25009,12458,12551
3,Alicante/Alacant,93,Novelda,25725,12803,12922
3,Alicante/Alacant,94,"Nucia, la",18242,9205,9037
3,Alicante/Alacant,95,Ondara,6815,3418,3397
3,Alicante/Alacant,96,Onil,7475,3734,3741
3,Alicante/Alacant,97,Orba,2111,1036,1075
3,Alicante/Alacant,99,Orihuela,76778,38144,38634
3,Alicante/Alacant,98,Orxeta,738,373,365
3,Alicante/Alacant,100,Parcent,908,443,465
3,Alicante/Alacant,101,Pedreguer,7490,3717,3773
3,Alicante/Alacant,102,Pego,10052,5036,5016
3,Alicante/Alacant,103,Penàguila,301,158,143
3,Alicante/Alacant,104,Petrer,34479,17121,17358
3,Alicante/Alacant,902,Pilar de la Horadada,21418,10981,10437
3,Alicante/Alacant,105,"Pinós, el/Pinoso",7845,3962,3883
3,Alicante/Alacant,106,Planes,713,387,326
3,Alicante/Alacant,901,"Poblets, els",2864,1360,1504
3,Alicante/Alacant,107,Polop,4850,2499,2351
3,Alicante/Alacant,60,Quatretondeta,121,68,53
3,Alicante/Alacant,109,Rafal,4418,2207,2211
3,Alicante/Alacant,110,"Ràfol d'Almúnia, el",644,328,316
3,Alicante/Alacant,111,Redován,7797,4007,3790
3,Alicante/Alacant,112,Relleu,1147,589,558
3,Alicante/Alacant,113,Rojales,16560,8393,8167
3,Alicante/Alacant,114,"Romana, la",2376,1230,1146
3,Alicante/Alacant,115,Sagra,389,193,196
3,Alicante/Alacant,116,Salinas,1585,813,772
3,Alicante/Alacant,118,San Fulgencio,7943,4030,3913
3,Alicante/Alacant,904,San Isidro,1933,988,945
3,Alicante/Alacant,120,San Miguel de Salinas,5811,2949,2862
3,Alicante/Alacant,122,San Vicente del Raspeig/Sant Vicent del Raspeig,57785,28588,29197
3,Alicante/Alacant,117,Sanet y Negrals,648,331,317
3,Alicante/Alacant,119,Sant Joan d'Alacant,23518,11376,12142
3,Alicante/Alacant,121,Santa Pola,31745,15916,15829
3,Alicante/Alacant,123,Sax,9771,4920,4851
3,Alicante/Alacant,124,Sella,585,308,277
3,Alicante/Alacant,125,Senija,581,303,278
3,Alicante/Alacant,127,Tàrbena,627,324,303
3,Alicante/Alacant,128,Teulada,10722,5331,5391
3,Alicante/Alacant,129,Tibi,1564,824,740
3,Alicante/Alacant,130,Tollos,56,30,26
3,Alicante/Alacant,131,Tormos,336,164,172
3,Alicante/Alacant,132,"Torremanzanas/Torre de les Maçanes, la",654,348,306
3,Alicante/Alacant,133,Torrevieja,82599,41038,41561
3,Alicante/Alacant,134,"Vall d'Alcalà, la",164,90,74
3,Alicante/Alacant,136,Vall de Gallinera,589,319,270
3,Alicante/Alacant,137,"Vall de Laguar, la",820,407,413
3,Alicante/Alacant,135,"Vall d'Ebo, la",224,117,107
3,Alicante/Alacant,138,"Verger, el",4520,2247,2273
3,Alicante/Alacant,139,"Villajoyosa/Vila Joiosa, la",33969,16949,17020
3,Alicante/Alacant,140,Villena,33983,16992,16991
3,Alicante/Alacant,81,Xaló,2683,1338,1345
4,Almería,1,Abla,1235,633,602
4,Almería,2,Abrucena,1150,600,550
4,Almería,3,Adra,24859,12639,12220
4,Almería,4,Albanchez,753,384,369
4,Almería,5,Alboloduy,621,307,314
4,Almería,6,Albox,11696,6023,5673
4,Almería,7,Alcolea,814,417,397
4,Almería,8,Alcóntar,528,288,240
4,Almería,9,Alcudia de Monteagud,135,59,76
4,Almería,10,Alhabia,648,340,308
4,Almería,11,Alhama de Almería,3615,1811,1804
4,Almería,12,Alicún,212,111,101
4,Almería,13,Almería,196851,95953,100898
4,Almería,14,Almócita,176,91,85
4,Almería,15,Alsodux,133,79,54
4,Almería,16,Antas,3169,1595,1574
4,Almería,17,Arboleas,4586,2311,2275
4,Almería,18,Armuña de Almanzora,321,157,164
4,Almería,19,Bacares,232,124,108
4,Almería,904,Balanegra,2933,1528,1405
4,Almería,20,Bayárcal,284,150,134
4,Almería,21,Bayarque,206,101,105
4,Almería,22,Bédar,927,463,464
4,Almería,23,Beires,117,58,59
4,Almería,24,Benahadux,4357,2157,2200
4,Almería,26,Benitagla,68,39,29
4,Almería,27,Benizalón,248,130,118
4,Almería,28,Bentarique,243,140,103
4,Almería,29,Berja,12381,6267,6114
4,Almería,30,Canjáyar,1202,629,573
4,Almería,31,Cantoria,3228,1630,1598
4,Almería,32,Carboneras,7757,3977,3780
4,Almería,33,Castro de Filabres,121,59,62
4,Almería,36,Chercos,283,143,140
4,Almería,37,Chirivel,1525,762,763
4,Almería,34,Cóbdar,143,83,60
4,Almería,35,Cuevas del Almanzora,13776,7168,6608
4,Almería,38,Dalías,4031,1987,2044
4,Almería,902,"Ejido, El",84710,44462,40248
4,Almería,41,Enix,418,236,182
4,Almería,43,Felix,642,363,279
4,Almería,44,Fines,1992,1046,946
4,Almería,45,Fiñana,1992,1005,987
4,Almería,46,Fondón,975,512,463
4,Almería,47,Gádor,3027,1575,1452
4,Almería,48,"Gallardos, Los",2803,1417,1386
4,Almería,49,Garrucha,8838,4562,4276
4,Almería,50,Gérgal,1031,553,478
4,Almería,51,Huécija,486,236,250
4,Almería,52,Huércal de Almería,17418,8869,8549
4,Almería,53,Huércal-Overa,18816,9359,9457
4,Almería,54,Íllar,390,212,178
4,Almería,55,Instinción,429,213,216
4,Almería,56,Laroya,169,99,70
4,Almería,57,Láujar de Andarax,1538,767,771
4,Almería,58,Líjar,390,205,185
4,Almería,59,Lubrín,1431,700,731
4,Almería,60,Lucainena de las Torres,546,299,247
4,Almería,61,Lúcar,766,377,389
4,Almería,62,Macael,5539,2843,2696
4,Almería,63,María,1261,649,612
4,Almería,64,Mojácar,6301,3085,3216
4,Almería,903,"Mojonera, La",9003,5027,3976
4,Almería,65,Nacimiento,460,231,229
4,Almería,66,Níjar,30122,16618,13504
4,Almería,67,Ohanes,596,299,297
4,Almería,68,Olula de Castro,180,100,80
4,Almería,69,Olula del Río,6212,3194,3018
4,Almería,70,Oria,2238,1172,1066
4,Almería,71,Padules,419,216,203
4,Almería,72,Partaloa,1055,530,525
4,Almería,73,Paterna del Río,362,212,150
4,Almería,74,Pechina,4018,2038,1980
4,Almería,75,Pulpí,9502,4966,4536
4,Almería,76,Purchena,1621,851,770
4,Almería,77,Rágol,304,163,141
4,Almería,78,Rioja,1364,690,674
4,Almería,79,Roquetas de Mar,94925,49038,45887
4,Almería,80,Santa Cruz de Marchena,218,107,111
4,Almería,81,Santa Fe de Mondújar,432,219,213
4,Almería,82,Senés,300,157,143
4,Almería,83,Serón,2035,1035,1000
4,Almería,84,Sierro,393,206,187
4,Almería,85,Somontín,463,234,229
4,Almería,86,Sorbas,2389,1254,1135
4,Almería,87,Suflí,217,120,97
4,Almería,88,Tabernas,3704,1916,1788
4,Almería,89,Taberno,963,463,500
4,Almería,90,Tahal,324,159,165
4,Almería,91,Terque,381,192,189
4,Almería,92,Tíjola,3569,1769,1800
4,Almería,901,"Tres Villas, Las",570,307,263
4,Almería,93,Turre,3384,1734,1650
4,Almería,94,Turrillas,233,136,97
4,Almería,95,Uleila del Campo,836,415,421
4,Almería,96,Urrácal,329,172,157
4,Almería,97,Velefique,253,137,116
4,Almería,98,Vélez-Blanco,1938,995,943
4,Almería,99,Vélez-Rubio,6630,3231,3399
4,Almería,100,Vera,15837,8052,7785
4,Almería,101,Viator,5791,2939,2852
4,Almería,102,Vícar,25405,13547,11858
4,Almería,103,Zurgena,2893,1441,1452
1,Araba/Álava,51,Agurain/Salvatierra,5018,2497,2521
1,Araba/Álava,1,Alegría-Dulantzi,2887,1507,1380
1,Araba/Álava,2,Amurrio,10286,5075,5211
1,Araba/Álava,49,Añana,151,87,64
1,Araba/Álava,3,Aramaio,1483,774,709
1,Araba/Álava,6,Armiñón,219,115,104
1,Araba/Álava,37,Arraia-Maeztu,717,399,318
1,Araba/Álava,8,Arratzua-Ubarrundia,982,535,447
1,Araba/Álava,4,Artziniega,1831,912,919
1,Araba/Álava,9,Asparrena,1643,833,810
1,Araba/Álava,10,Ayala/Aiara,2967,1503,1464
1,Araba/Álava,11,Baños de Ebro/Mañueta,286,159,127
1,Araba/Álava,13,Barrundia,883,493,390
1,Araba/Álava,14,Berantevilla,443,238,205
1,Araba/Álava,16,Bernedo,511,303,208
1,Araba/Álava,17,Campezo/Kanpezu,1040,548,492
1,Araba/Álava,21,Elburgo/Burgelu,603,316,287
1,Araba/Álava,22,Elciego,1025,513,512
1,Araba/Álava,23,Elvillar/Bilar,348,170,178
1,Araba/Álava,46,Erriberagoitia/Ribera Alta,780,447,333
1,Araba/Álava,56,Harana/Valle de Arana,229,129,100
1,Araba/Álava,901,Iruña Oka/Iruña de Oca,3333,1721,1612
1,Araba/Álava,27,Iruraiz-Gauna,517,281,236
1,Araba/Álava,19,Kripan,181,96,85
1,Araba/Álava,20,Kuartango,381,222,159
1,Araba/Álava,28,Labastida/Bastida,1445,759,686
1,Araba/Álava,30,Lagrán,158,88,70
1,Araba/Álava,31,Laguardia,1505,776,729
1,Araba/Álava,32,Lanciego/Lantziego,667,341,326
1,Araba/Álava,902,Lantarón,872,491,381
1,Araba/Álava,33,Lapuebla de Labarca,857,441,416
1,Araba/Álava,36,Laudio/Llodio,18205,8979,9226
1,Araba/Álava,58,Legutio,1869,992,877
1,Araba/Álava,34,Leza,196,100,96
1,Araba/Álava,39,Moreda de Álava/Moreda Araba,229,113,116
1,Araba/Álava,41,Navaridas,209,117,92
1,Araba/Álava,42,Okondo,1162,601,561
1,Araba/Álava,43,Oyón-Oion,3368,1718,1650
1,Araba/Álava,44,Peñacerrada-Urizaharra,257,152,105
1,Araba/Álava,47,Ribera Baja/Erribera Beitia,1374,745,629
1,Araba/Álava,52,Samaniego,319,155,164
1,Araba/Álava,53,San Millán/Donemiliaga,709,390,319
1,Araba/Álava,54,Urkabustaiz,1336,688,648
1,Araba/Álava,55,Valdegovía/Gaubea,991,546,445
1,Araba/Álava,57,Villabuena de Álava/Eskuernaga,299,150,149
1,Araba/Álava,59,Vitoria-Gasteiz,249176,121358,127818
1,Araba/Álava,60,Yécora/Iekora,269,139,130
1,Araba/Álava,61,Zalduondo,186,104,82
1,Araba/Álava,62,Zambrana,400,214,186
1,Araba/Álava,18,Zigoitia,1753,952,801
1,Araba/Álava,63,Zuia,2313,1193,1120
33,Asturias,1,Allande,1697,854,843
33,Asturias,2,Aller,10808,5326,5482
33,Asturias,3,Amieva,675,379,296
33,Asturias,4,Avilés,78715,37191,41524
33,Asturias,5,Belmonte de Miranda,1522,795,727
33,Asturias,6,Bimenes,1700,810,890
33,Asturias,7,Boal,1571,791,780
33,Asturias,8,Cabrales,2002,1021,981
33,Asturias,9,Cabranes,1035,514,521
33,Asturias,10,Candamo,1985,974,1011
33,Asturias,12,Cangas de Onís,6278,3033,3245
33,Asturias,11,Cangas del Narcea,12579,6196,6383
33,Asturias,13,Caravia,477,242,235
33,Asturias,14,Carreño,10444,5043,5401
33,Asturias,15,Caso,1553,881,672
33,Asturias,16,Castrillón,22464,10894,11570
33,Asturias,17,Castropol,3470,1689,1781
33,Asturias,18,Coaña,3336,1627,1709
33,Asturias,19,Colunga,3332,1636,1696
33,Asturias,20,Corvera de Asturias,15721,7730,7991
33,Asturias,21,Cudillero,5078,2505,2573
33,Asturias,22,Degaña,949,493,456
33,Asturias,23,"Franco, El",3830,1882,1948
33,Asturias,24,Gijón,271843,128208,143635
33,Asturias,25,Gozón,10427,5088,5339
33,Asturias,26,Grado,9839,4748,5091
33,Asturias,27,Grandas de Salime,853,439,414
33,Asturias,28,Ibias,1301,736,565
33,Asturias,29,Illano,352,175,177
33,Asturias,30,Illas,1022,516,506
33,Asturias,31,Langreo,39984,19051,20933
33,Asturias,32,Laviana,13087,6269,6818
33,Asturias,33,Lena,11086,5339,5747
33,Asturias,35,Llanera,13676,6783,6893
33,Asturias,36,Llanes,13639,6621,7018
33,Asturias,37,Mieres,38428,18237,20191
33,Asturias,38,Morcín,2631,1320,1311
33,Asturias,39,Muros de Nalón,1846,883,963
33,Asturias,40,Nava,5334,2624,2710
33,Asturias,41,Navia,8409,4043,4366
33,Asturias,42,Noreña,5167,2481,2686
33,Asturias,43,Onís,740,401,339
33,Asturias,44,Oviedo,220020,101906,118114
33,Asturias,45,Parres,5353,2626,2727
33,Asturias,46,Peñamellera Alta,531,279,252
33,Asturias,47,Peñamellera Baja,1246,610,636
33,Asturias,48,Pesoz,146,81,65
33,Asturias,49,Piloña,7101,3503,3598
33,Asturias,50,Ponga,598,354,244
33,Asturias,51,Pravia,8282,3998,4284
33,Asturias,52,Proaza,737,425,312
33,Asturias,53,Quirós,1194,691,503
33,Asturias,54,"Regueras, Las",1865,964,901
33,Asturias,55,Ribadedeva,1758,845,913
33,Asturias,56,Ribadesella,5730,2738,2992
33,Asturias,57,Ribera de Arriba,1857,929,928
33,Asturias,58,Riosa,1933,971,962
33,Asturias,59,Salas,5084,2512,2572
33,Asturias,61,San Martín de Oscos,393,194,199
33,Asturias,60,San Martín del Rey Aurelio,16283,7785,8498
33,Asturias,63,San Tirso de Abres,433,212,221
33,Asturias,62,Santa Eulalia de Oscos,453,235,218
33,Asturias,64,Santo Adriano,288,142,146
33,Asturias,65,Sariego,1254,604,650
33,Asturias,66,Siero,51662,25234,26428
33,Asturias,67,Sobrescobio,818,434,384
33,Asturias,68,Somiedo,1125,650,475
33,Asturias,69,Soto del Barco,3887,1919,1968
33,Asturias,70,Tapia de Casariego,3795,1846,1949
33,Asturias,71,Taramundi,646,308,338
33,Asturias,72,Teverga,1628,871,757
33,Asturias,73,Tineo,9543,4815,4728
33,Asturias,34,Valdés,11734,5730,6004
33,Asturias,74,Vegadeo,3866,1862,2004
33,Asturias,75,Villanueva de Oscos,298,150,148
33,Asturias,76,Villaviciosa,14430,7120,7310
33,Asturias,77,Villayón,1248,649,599
33,Asturias,78,Yernes y Tameza,140,78,62
5,Ávila,1,Adanero,202,113,89
5,Ávila,2,"Adrada, La",2517,1298,1219
5,Ávila,5,Albornos,190,100,90
5,Ávila,7,Aldeanueva de Santa Cruz,119,63,56
5,Ávila,8,Aldeaseca,233,115,118
5,Ávila,10,"Aldehuela, La",168,85,83
5,Ávila,12,Amavida,135,69,66
5,Ávila,13,"Arenal, El",972,495,477
5,Ávila,14,Arenas de San Pedro,6454,3135,3319
5,Ávila,15,Arevalillo,75,35,40
5,Ávila,16,Arévalo,8069,3919,4150
5,Ávila,17,Aveinte,86,49,37
5,Ávila,18,Avellaneda,26,15,11
5,Ávila,19,Ávila,57657,27472,30185
5,Ávila,21,"Barco de Ávila, El",2368,1145,1223
5,Ávila,22,"Barraco, El",1889,976,913
5,Ávila,23,Barromán,186,103,83
5,Ávila,24,Becedas,206,108,98
5,Ávila,25,Becedillas,90,50,40
5,Ávila,26,Bercial de Zapardiel,199,106,93
5,Ávila,27,"Berlanas, Las",323,164,159
5,Ávila,29,Bernuy-Zapardiel,108,64,44
5,Ávila,30,Berrocalejo de Aragona,43,22,21
5,Ávila,33,Blascomillán,193,102,91
5,Ávila,34,Blasconuño de Matacabras,16,8,8
5,Ávila,35,Blascosancho,114,57,57
5,Ávila,36,"Bohodón, El",126,62,64
5,Ávila,37,Bohoyo,248,142,106
5,Ávila,38,Bonilla de la Sierra,120,71,49
5,Ávila,39,Brabos,44,27,17
5,Ávila,40,Bularros,65,43,22
5,Ávila,41,Burgohondo,1196,621,575
5,Ávila,42,Cabezas de Alambre,157,77,80
5,Ávila,43,Cabezas del Pozo,84,44,40
5,Ávila,44,Cabezas del Villar,275,150,125
5,Ávila,45,Cabizuela,82,43,39
5,Ávila,46,Canales,48,26,22
5,Ávila,47,Candeleda,4998,2528,2470
5,Ávila,48,Cantiveros,112,63,49
5,Ávila,49,Cardeñosa,452,239,213
5,Ávila,51,"Carrera, La",181,98,83
5,Ávila,52,Casas del Puerto,92,48,44
5,Ávila,53,Casasola,84,46,38
5,Ávila,54,Casavieja,1429,742,687
5,Ávila,55,Casillas,637,338,299
5,Ávila,56,Castellanos de Zapardiel,95,53,42
5,Ávila,57,Cebreros,3056,1576,1480
5,Ávila,58,Cepeda la Mora,76,43,33
5,Ávila,67,Chamartín,79,47,32
5,Ávila,59,Cillán,100,60,40
5,Ávila,60,Cisla,109,56,53
5,Ávila,61,"Colilla, La",329,172,157
5,Ávila,62,Collado de Contreras,179,92,87
5,Ávila,63,Collado del Mirón,32,20,12
5,Ávila,64,Constanzana,106,60,46
5,Ávila,65,Crespos,496,264,232
5,Ávila,66,Cuevas del Valle,491,271,220
5,Ávila,903,Diego del Carpio,147,83,64
5,Ávila,69,Donjimeno,79,45,34
5,Ávila,70,Donvidas,33,17,16
5,Ávila,72,Espinosa de los Caballeros,106,57,49
5,Ávila,73,Flores de Ávila,307,168,139
5,Ávila,74,Fontiveros,751,391,360
5,Ávila,75,Fresnedilla,121,56,65
5,Ávila,76,"Fresno, El",601,312,289
5,Ávila,77,Fuente el Saúz,165,88,77
5,Ávila,78,Fuentes de Año,105,59,46
5,Ávila,79,Gallegos de Altamiros,63,37,26
5,Ávila,80,Gallegos de Sobrinos,43,21,22
5,Ávila,81,Garganta del Villar,40,28,12
5,Ávila,82,Gavilanes,587,317,270
5,Ávila,83,Gemuño,155,82,73
5,Ávila,85,Gil García,36,17,19
5,Ávila,84,Gilbuena,68,40,28
5,Ávila,86,Gimialcón,77,48,29
5,Ávila,87,Gotarrendura,161,54,107
5,Ávila,88,Grandes y San Martín,31,15,16
5,Ávila,89,Guisando,511,252,259
5,Ávila,90,Gutierre-Muñoz,78,38,40
5,Ávila,92,Hernansancho,169,94,75
5,Ávila,93,Herradón de Pinares,405,230,175
5,Ávila,94,Herreros de Suso,135,74,61
5,Ávila,95,Higuera de las Dueñas,267,148,119
5,Ávila,96,"Hija de Dios, La",78,47,31
5,Ávila,97,"Horcajada, La",518,274,244
5,Ávila,99,Horcajo de las Torres,512,287,225
5,Ávila,100,"Hornillo, El",295,155,140
5,Ávila,102,"Hoyo de Pinares, El",2164,1123,1041
5,Ávila,101,Hoyocasero,290,167,123
5,Ávila,103,Hoyorredondo,67,34,33
5,Ávila,106,Hoyos de Miguel Muñoz,29,15,14
5,Ávila,104,Hoyos del Collado,34,20,14
5,Ávila,105,Hoyos del Espino,363,197,166
5,Ávila,107,Hurtumpascual,54,33,21
5,Ávila,108,Junciana,40,21,19
5,Ávila,109,Langa,487,255,232
5,Ávila,110,Lanzahíta,844,431,413
5,Ávila,113,"Llanos de Tormes, Los",64,30,34
5,Ávila,112,"Losar del Barco, El",110,56,54
5,Ávila,114,Madrigal de las Altas Torres,1440,732,708
5,Ávila,115,Maello,596,310,286
5,Ávila,116,Malpartida de Corneja,102,51,51
5,Ávila,117,Mamblas,208,119,89
5,Ávila,118,Mancera de Arriba,74,40,34
5,Ávila,119,Manjabálago y Ortigosa de Rioalmar,27,18,9
5,Ávila,120,Marlín,31,20,11
5,Ávila,121,Martiherrero,317,165,152
5,Ávila,122,Martínez,122,62,60
5,Ávila,123,Mediana de Voltoya,105,52,53
5,Ávila,124,Medinilla,99,45,54
5,Ávila,125,Mengamuñoz,61,31,30
5,Ávila,126,Mesegar de Corneja,60,36,24
5,Ávila,127,Mijares,704,394,310
5,Ávila,128,Mingorría,395,207,188
5,Ávila,129,"Mirón, El",124,73,51
5,Ávila,130,Mironcillo,95,50,45
5,Ávila,131,Mirueña de los Infanzones,92,54,38
5,Ávila,132,Mombeltrán,1006,520,486
5,Ávila,133,Monsalupe,73,38,35
5,Ávila,134,Moraleja de Matacabras,50,30,20
5,Ávila,135,Muñana,394,208,186
5,Ávila,136,Muñico,94,50,44
5,Ávila,138,Muñogalindo,334,172,162
5,Ávila,139,Muñogrande,67,37,30
5,Ávila,140,Muñomer del Peco,128,71,57
5,Ávila,141,Muñopepe,103,57,46
5,Ávila,142,Muñosancho,96,45,51
5,Ávila,143,Muñotello,62,31,31
5,Ávila,144,Narrillos del Álamo,77,42,35
5,Ávila,145,Narrillos del Rebollar,50,28,22
5,Ávila,149,Narros de Saldueña,101,59,42
5,Ávila,147,Narros del Castillo,161,91,70
5,Ávila,148,Narros del Puerto,22,11,11
5,Ávila,152,Nava de Arévalo,753,398,355
5,Ávila,153,Nava del Barco,93,50,43
5,Ávila,151,Navacepedilla de Corneja,98,50,48
5,Ávila,154,Navadijos,34,24,10
5,Ávila,155,Navaescurial,46,30,16
5,Ávila,156,Navahondilla,310,180,130
5,Ávila,157,Navalacruz,247,134,113
5,Ávila,158,Navalmoral,336,182,154
5,Ávila,159,Navalonguilla,236,116,120
5,Ávila,160,Navalosa,321,176,145
5,Ávila,161,Navalperal de Pinares,777,399,378
5,Ávila,162,Navalperal de Tormes,90,47,43
5,Ávila,163,Navaluenga,1878,924,954
5,Ávila,164,Navaquesera,16,8,8
5,Ávila,165,Navarredonda de Gredos,434,213,221
5,Ávila,166,Navarredondilla,168,92,76
5,Ávila,167,Navarrevisca,279,155,124
5,Ávila,168,"Navas del Marqués, Las",5139,2616,2523
5,Ávila,169,Navatalgordo,251,145,106
5,Ávila,170,Navatejares,55,27,28
5,Ávila,171,Neila de San Miguel,69,34,35
5,Ávila,172,Niharra,184,103,81
5,Ávila,173,Ojos-Albos,63,39,24
5,Ávila,174,Orbita,75,41,34
5,Ávila,175,"Oso, El",172,98,74
5,Ávila,176,Padiernos,272,150,122
5,Ávila,177,Pajares de Adaja,154,81,73
5,Ávila,178,Palacios de Goda,402,211,191
5,Ávila,179,Papatrigo,232,114,118
5,Ávila,180,"Parral, El",72,39,33
5,Ávila,181,Pascualcobo,43,29,14
5,Ávila,182,Pedro Bernardo,844,444,400
5,Ávila,183,Pedro-Rodríguez,140,74,66
5,Ávila,184,Peguerinos,272,152,120
5,Ávila,185,Peñalba de Ávila,113,58,55
5,Ávila,186,Piedrahíta,1811,869,942
5,Ávila,187,Piedralaves,2057,1025,1032
5,Ávila,188,Poveda,45,28,17
5,Ávila,189,Poyales del Hoyo,482,254,228
5,Ávila,190,Pozanco,49,30,19
5,Ávila,191,Pradosegar,126,64,62
5,Ávila,192,Puerto Castilla,107,66,41
5,Ávila,193,Rasueros,181,103,78
5,Ávila,194,Riocabado,146,82,64
5,Ávila,195,Riofrío,227,135,92
5,Ávila,196,Rivilla de Barajas,65,28,37
5,Ávila,197,Salobral,116,64,52
5,Ávila,198,Salvadiós,75,35,40
5,Ávila,199,San Bartolomé de Béjar,42,22,20
5,Ávila,200,San Bartolomé de Corneja,43,21,22
5,Ávila,201,San Bartolomé de Pinares,553,297,256
5,Ávila,206,San Esteban de los Patos,30,18,12
5,Ávila,208,San Esteban de Zapardiel,36,22,14
5,Ávila,207,San Esteban del Valle,747,388,359
5,Ávila,209,San García de Ingelmos,80,48,32
5,Ávila,901,San Juan de Gredos,251,137,114
5,Ávila,210,San Juan de la Encinilla,86,43,43
5,Ávila,211,San Juan de la Nava,473,251,222
5,Ávila,212,San Juan del Molinillo,199,111,88
5,Ávila,213,San Juan del Olmo,105,64,41
5,Ávila,214,San Lorenzo de Tormes,37,21,16
5,Ávila,215,San Martín de la Vega del Alberche,174,104,70
5,Ávila,216,San Martín del Pimpollar,189,109,80
5,Ávila,217,San Miguel de Corneja,55,30,25
5,Ávila,218,San Miguel de Serrezuela,125,68,57
5,Ávila,219,San Pascual,44,26,18
5,Ávila,220,San Pedro del Arroyo,428,226,202
5,Ávila,231,San Vicente de Arévalo,171,100,71
5,Ávila,204,Sanchidrián,726,373,353
5,Ávila,205,Sanchorreja,86,43,43
5,Ávila,222,Santa Cruz de Pinares,141,76,65
5,Ávila,221,Santa Cruz del Valle,365,192,173
5,Ávila,226,Santa María de los Caballeros,73,44,29
5,Ávila,224,Santa María del Arroyo,111,58,53
5,Ávila,225,Santa María del Berrocal,403,219,184
5,Ávila,902,Santa María del Cubillo,314,183,131
5,Ávila,227,Santa María del Tiétar,436,234,202
5,Ávila,228,Santiago del Collado,176,109,67
5,Ávila,904,Santiago del Tormes,122,69,53
5,Ávila,229,Santo Domingo de las Posadas,75,40,35
5,Ávila,230,Santo Tomé de Zabarcos,65,35,30
5,Ávila,232,"Serrada, La",111,58,53
5,Ávila,233,Serranillos,250,140,110
5,Ávila,234,Sigeres,43,22,21
5,Ávila,235,Sinlabajos,124,69,55
5,Ávila,236,Solana de Ávila,113,66,47
5,Ávila,237,Solana de Rioalmar,165,95,70
5,Ávila,238,Solosancho,837,446,391
5,Ávila,239,Sotalbo,251,134,117
5,Ávila,240,Sotillo de la Adrada,4542,2252,2290
5,Ávila,241,"Tiemblo, El",4097,2090,2007
5,Ávila,242,Tiñosillos,796,411,385
5,Ávila,243,Tolbaños,85,48,37
5,Ávila,244,Tormellas,41,26,15
5,Ávila,245,Tornadizos de Ávila,435,222,213
5,Ávila,247,"Torre, La",239,131,108
5,Ávila,246,Tórtoles,60,33,27
5,Ávila,249,Umbrías,105,55,50
5,Ávila,251,Vadillo de la Sierra,67,42,25
5,Ávila,252,Valdecasa,62,37,25
5,Ávila,253,Vega de Santa María,85,41,44
5,Ávila,254,Velayos,213,106,107
5,Ávila,256,Villaflor,117,62,55
5,Ávila,257,Villafranca de la Sierra,132,71,61
5,Ávila,905,Villanueva de Ávila,254,127,127
5,Ávila,258,Villanueva de Gómez,132,76,56
5,Ávila,259,Villanueva del Aceral,122,61,61
5,Ávila,260,Villanueva del Campillo,103,57,46
5,Ávila,261,Villar de Corneja,39,22,17
5,Ávila,262,Villarejo del Valle,363,191,172
5,Ávila,263,Villatoro,166,96,70
5,Ávila,264,Viñegra de Moraña,58,34,24
5,Ávila,265,Vita,87,52,35
5,Ávila,266,Zapardiel de la Cañada,97,53,44
5,Ávila,267,Zapardiel de la Ribera,115,60,55
6,Badajoz,1,Acedera,798,418,380
6,Badajoz,2,Aceuchal,5461,2706,2755
6,Badajoz,3,Ahillones,893,443,450
6,Badajoz,4,Alange,1880,945,935
6,Badajoz,5,"Albuera, La",2029,1058,971
6,Badajoz,6,Alburquerque,5340,2667,2673
6,Badajoz,7,Alconchel,1704,859,845
6,Badajoz,8,Alconera,730,359,371
6,Badajoz,9,Aljucén,245,133,112
6,Badajoz,10,Almendral,1240,607,633
6,Badajoz,11,Almendralejo,33468,16588,16880
6,Badajoz,12,Arroyo de San Serván,4126,2102,2024
6,Badajoz,13,Atalaya,293,150,143
6,Badajoz,14,Azuaga,7891,3914,3977
6,Badajoz,15,Badajoz,150530,72988,77542
6,Badajoz,16,Barcarrota,3580,1822,1758
6,Badajoz,17,Baterno,293,156,137
6,Badajoz,18,Benquerencia de la Serena,841,417,424
6,Badajoz,19,Berlanga,2360,1192,1168
6,Badajoz,20,Bienvenida,2128,1101,1027
6,Badajoz,21,Bodonal de la Sierra,1052,539,513
6,Badajoz,22,Burguillos del Cerro,3085,1524,1561
6,Badajoz,23,Cabeza del Buey,4929,2441,2488
6,Badajoz,24,Cabeza la Vaca,1331,679,652
6,Badajoz,25,Calamonte,6241,3101,3140
6,Badajoz,26,Calera de León,969,490,479
6,Badajoz,27,Calzadilla de los Barros,769,383,386
6,Badajoz,28,Campanario,4967,2442,2525
6,Badajoz,29,Campillo de Llerena,1373,693,680
6,Badajoz,30,Capilla,186,96,90
6,Badajoz,31,Carmonita,551,276,275
6,Badajoz,32,"Carrascalejo, El",67,33,34
6,Badajoz,33,Casas de Don Pedro,1483,762,721
6,Badajoz,34,Casas de Reina,191,94,97
6,Badajoz,35,Castilblanco,972,498,474
6,Badajoz,36,Castuera,5921,2919,3002
6,Badajoz,42,Cheles,1210,587,623
6,Badajoz,37,"Codosera, La",2119,1121,998
6,Badajoz,38,Cordobilla de Lácara,916,471,445
6,Badajoz,39,"Coronada, La",2182,1065,1117
6,Badajoz,40,Corte de Peleas,1238,607,631
6,Badajoz,41,Cristina,567,293,274
6,Badajoz,43,Don Álvaro,768,395,373
6,Badajoz,44,Don Benito,37010,18268,18742
6,Badajoz,45,Entrín Bajo,569,287,282
6,Badajoz,46,Esparragalejo,1459,720,739
6,Badajoz,47,Esparragosa de la Serena,1031,528,503
6,Badajoz,48,Esparragosa de Lares,938,451,487
6,Badajoz,49,Feria,1150,560,590
6,Badajoz,50,Fregenal de la Sierra,4918,2419,2499
6,Badajoz,51,Fuenlabrada de los Montes,1879,931,948
6,Badajoz,52,Fuente de Cantos,4784,2367,2417
6,Badajoz,53,Fuente del Arco,697,350,347
6,Badajoz,54,Fuente del Maestre,6774,3367,3407
6,Badajoz,55,Fuentes de León,2311,1142,1169
6,Badajoz,56,Garbayuela,522,277,245
6,Badajoz,57,Garlitos,599,312,287
6,Badajoz,58,"Garrovilla, La",2401,1206,1195
6,Badajoz,59,Granja de Torrehermosa,2041,1013,1028
6,Badajoz,903,Guadiana del Caudillo,2518,1237,1281
6,Badajoz,60,Guareña,7006,3530,3476
6,Badajoz,61,"Haba, La",1247,622,625
6,Badajoz,62,Helechosa de los Montes,653,368,285
6,Badajoz,63,Herrera del Duque,3485,1748,1737
6,Badajoz,64,Higuera de la Serena,941,492,449
6,Badajoz,65,Higuera de Llerena,343,174,169
6,Badajoz,66,Higuera de Vargas,1950,982,968
6,Badajoz,67,Higuera la Real,2264,1134,1130
6,Badajoz,68,Hinojosa del Valle,489,238,251
6,Badajoz,69,Hornachos,3639,1832,1807
6,Badajoz,70,Jerez de los Caballeros,9367,4610,4757
6,Badajoz,71,"Lapa, La",284,143,141
6,Badajoz,73,Llera,860,446,414
6,Badajoz,74,Llerena,5758,2861,2897
6,Badajoz,72,Lobón,2757,1414,1343
6,Badajoz,75,Magacela,526,280,246
6,Badajoz,76,Maguilla,970,478,492
6,Badajoz,77,Malcocinado,374,203,171
6,Badajoz,78,Malpartida de la Serena,569,294,275
6,Badajoz,79,Manchita,763,391,372
6,Badajoz,80,Medellín,2276,1134,1142
6,Badajoz,81,Medina de las Torres,1207,621,586
6,Badajoz,82,Mengabril,472,254,218
6,Badajoz,83,Mérida,59352,28958,30394
6,Badajoz,84,Mirandilla,1300,659,641
6,Badajoz,85,Monesterio,4254,2189,2065
6,Badajoz,86,Montemolín,1367,659,708
6,Badajoz,87,Monterrubio de la Serena,2415,1177,1238
6,Badajoz,88,Montijo,15614,7721,7893
6,Badajoz,89,"Morera, La",719,365,354
6,Badajoz,90,"Nava de Santiago, La",949,482,467
6,Badajoz,91,Navalvillar de Pela,4444,2258,2186
6,Badajoz,92,Nogales,666,330,336
6,Badajoz,93,Oliva de la Frontera,5195,2601,2594
6,Badajoz,94,Oliva de Mérida,1734,892,842
6,Badajoz,95,Olivenza,11986,5977,6009
6,Badajoz,96,Orellana de la Sierra,235,123,112
6,Badajoz,97,Orellana la Vieja,2729,1415,1314
6,Badajoz,98,Palomas,686,342,344
6,Badajoz,99,"Parra, La",1360,705,655
6,Badajoz,100,Peñalsordo,949,450,499
6,Badajoz,101,Peraleda del Zaucejo,512,259,253
6,Badajoz,102,Puebla de Alcocer,1188,585,603
6,Badajoz,103,Puebla de la Calzada,5876,2933,2943
6,Badajoz,104,Puebla de la Reina,745,374,371
6,Badajoz,107,Puebla de Obando,1868,938,930
6,Badajoz,108,Puebla de Sancho Pérez,2731,1377,1354
6,Badajoz,105,Puebla del Maestre,698,356,342
6,Badajoz,106,Puebla del Prior,500,256,244
6,Badajoz,902,Pueblonuevo del Guadiana,2033,1032,1001
6,Badajoz,109,Quintana de la Serena,4650,2354,2296
6,Badajoz,110,Reina,159,79,80
6,Badajoz,111,Rena,622,320,302
6,Badajoz,112,Retamal de Llerena,443,226,217
6,Badajoz,113,Ribera del Fresno,3357,1664,1693
6,Badajoz,114,Risco,141,72,69
6,Badajoz,115,"Roca de la Sierra, La",1473,727,746
6,Badajoz,116,Salvaleón,1800,907,893
6,Badajoz,117,Salvatierra de los Barros,1664,811,853
6,Badajoz,119,San Pedro de Mérida,837,433,404
6,Badajoz,123,San Vicente de Alcántara,5475,2756,2719
6,Badajoz,118,Sancti-Spíritus,175,100,75
6,Badajoz,120,Santa Amalia,4059,2056,2003
6,Badajoz,121,Santa Marta,4176,2109,2067
6,Badajoz,122,"Santos de Maimona, Los",8126,4104,4022
6,Badajoz,124,Segura de León,1921,951,970
6,Badajoz,125,Siruela,1912,962,950
6,Badajoz,126,Solana de los Barros,2645,1317,1328
6,Badajoz,127,Talarrubias,3420,1704,1716
6,Badajoz,128,Talavera la Real,5376,2681,2695
6,Badajoz,129,Táliga,681,341,340
6,Badajoz,130,Tamurejo,215,111,104
6,Badajoz,131,Torre de Miguel Sesmero,1265,648,617
6,Badajoz,132,Torremayor,973,465,508
6,Badajoz,133,Torremejía,2264,1168,1096
6,Badajoz,134,Trasierra,633,334,299
6,Badajoz,135,Trujillanos,1401,720,681
6,Badajoz,136,Usagre,1777,879,898
6,Badajoz,137,Valdecaballeros,1074,555,519
6,Badajoz,901,Valdelacalzada,2734,1398,1336
6,Badajoz,138,Valdetorres,1179,577,602
6,Badajoz,139,Valencia de las Torres,578,305,273
6,Badajoz,140,Valencia del Mombuey,731,368,363
6,Badajoz,141,Valencia del Ventoso,2008,994,1014
6,Badajoz,146,Valle de la Serena,1224,620,604
6,Badajoz,147,Valle de Matamoros,367,180,187
6,Badajoz,148,Valle de Santa Ana,1152,565,587
6,Badajoz,142,Valverde de Burguillos,281,150,131
6,Badajoz,143,Valverde de Leganés,4176,2101,2075
6,Badajoz,144,Valverde de Llerena,603,299,304
6,Badajoz,145,Valverde de Mérida,1060,534,526
6,Badajoz,149,Villafranca de los Barros,12926,6365,6561
6,Badajoz,150,Villagarcía de la Torre,913,470,443
6,Badajoz,151,Villagonzalo,1243,603,640
6,Badajoz,152,Villalba de los Barros,1504,761,743
6,Badajoz,153,Villanueva de la Serena,25759,12528,13231
6,Badajoz,154,Villanueva del Fresno,3401,1700,1701
6,Badajoz,156,Villar de Rena,1383,715,668
6,Badajoz,155,Villar del Rey,2168,1157,1011
6,Badajoz,157,Villarta de los Montes,444,226,218
6,Badajoz,158,Zafra,16776,8086,8690
6,Badajoz,159,Zahínos,2805,1399,1406
6,Badajoz,160,Zalamea de la Serena,3606,1810,1796
6,Badajoz,162,"Zarza, La",3508,1783,1725
6,Badajoz,161,Zarza-Capilla,310,157,153
7,"Balears, Illes",2,Alaior,9012,4520,4492
7,"Balears, Illes",1,Alaró,5494,2658,2836
7,"Balears, Illes",3,Alcúdia,19793,9974,9819
7,"Balears, Illes",4,Algaida,5529,2822,2707
7,"Balears, Illes",5,Andratx,11004,5470,5534
7,"Balears, Illes",901,Ariany,860,451,409
7,"Balears, Illes",6,Artà,7671,3844,3827
7,"Balears, Illes",7,Banyalbufar,503,265,238
7,"Balears, Illes",8,Binissalem,8316,4130,4186
7,"Balears, Illes",9,Búger,1054,545,509
7,"Balears, Illes",10,Bunyola,6714,3284,3430
7,"Balears, Illes",11,Calvià,49333,24727,24606
7,"Balears, Illes",12,Campanet,2612,1302,1310
7,"Balears, Illes",13,Campos,10610,5268,5342
7,"Balears, Illes",14,Capdepera,11600,5907,5693
7,"Balears, Illes",64,"Castell, Es",7348,3723,3625
7,"Balears, Illes",15,Ciutadella de Menorca,29223,14483,14740
7,"Balears, Illes",16,Consell,4008,2012,1996
7,"Balears, Illes",17,Costitx,1271,624,647
7,"Balears, Illes",18,Deià,620,293,327
7,"Balears, Illes",26,Eivissa,49727,24984,24743
7,"Balears, Illes",19,Escorca,211,129,82
7,"Balears, Illes",20,Esporles,5020,2478,2542
7,"Balears, Illes",21,Estellencs,318,171,147
7,"Balears, Illes",22,Felanitx,17497,8801,8696
7,"Balears, Illes",23,Ferreries,4695,2335,2360
7,"Balears, Illes",24,Formentera,12216,6428,5788
7,"Balears, Illes",25,Fornalutx,678,332,346
7,"Balears, Illes",27,Inca,32137,16169,15968
7,"Balears, Illes",28,Lloret de Vistalegre,1289,652,637
7,"Balears, Illes",29,Lloseta,5858,2941,2917
7,"Balears, Illes",30,Llubí,2243,1131,1112
7,"Balears, Illes",31,Llucmajor,36358,18444,17914
7,"Balears, Illes",33,Manacor,42631,21270,21361
7,"Balears, Illes",34,Mancor de la Vall,1455,738,717
7,"Balears, Illes",32,Maó-Mahón,28592,13990,14602
7,"Balears, Illes",35,Maria de la Salut,2143,1108,1035
7,"Balears, Illes",36,Marratxí,36725,18495,18230
7,"Balears, Illes",37,"Mercadal, Es",4788,2428,2360
7,"Balears, Illes",902,"Migjorn Gran, Es",1370,683,687
7,"Balears, Illes",38,Montuïri,2867,1449,1418
7,"Balears, Illes",39,Muro,6931,3504,3427
7,"Balears, Illes",40,Palma,409661,199652,210009
7,"Balears, Illes",41,Petra,2825,1399,1426
7,"Balears, Illes",44,"Pobla, Sa",13026,6623,6403
7,"Balears, Illes",42,Pollença,16189,8059,8130
7,"Balears, Illes",43,Porreres,5339,2722,2617
7,"Balears, Illes",45,Puigpunyent,1967,974,993
7,"Balears, Illes",59,"Salines, Ses",4877,2474,2403
7,"Balears, Illes",46,Sant Antoni de Portmany,25779,13529,12250
7,"Balears, Illes",49,Sant Joan,2083,1023,1060
7,"Balears, Illes",50,Sant Joan de Labritja,6200,3153,3047
7,"Balears, Illes",48,Sant Josep de sa Talaia,26496,13663,12833
7,"Balears, Illes",51,Sant Llorenç des Cardassar,8405,4151,4254
7,"Balears, Illes",52,Sant Lluís,6892,3494,3398
7,"Balears, Illes",53,Santa Eugènia,1671,831,840
7,"Balears, Illes",54,Santa Eulària des Riu,36457,18517,17940
7,"Balears, Illes",55,Santa Margalida,11958,6108,5850
7,"Balears, Illes",56,Santa María del Camí,7167,3564,3603
7,"Balears, Illes",57,Santanyí,12112,6089,6023
7,"Balears, Illes",58,Selva,3981,1994,1987
7,"Balears, Illes",47,Sencelles,3195,1615,1580
7,"Balears, Illes",60,Sineu,3764,1866,1898
7,"Balears, Illes",61,Sóller,14041,7050,6991
7,"Balears, Illes",62,Son Servera,11378,5696,5682
7,"Balears, Illes",63,Valldemossa,1945,989,956
7,"Balears, Illes",65,Vilafranca de Bonany,3176,1606,1570
8,Barcelona,1,Abrera,12334,6248,6086
8,Barcelona,2,Aguilar de Segarra,277,148,129
8,Barcelona,14,Aiguafreda,2501,1204,1297
8,Barcelona,3,Alella,9764,4751,5013
8,Barcelona,4,Alpens,273,146,127
8,Barcelona,5,"Ametlla del Vallès, L'",8496,4285,4211
8,Barcelona,6,Arenys de Mar,15533,7536,7997
8,Barcelona,7,Arenys de Munt,8838,4439,4399
8,Barcelona,8,Argençola,219,110,109
8,Barcelona,9,Argentona,12295,6053,6242
8,Barcelona,10,Artés,5648,2851,2797
8,Barcelona,11,Avià,2250,1120,1130
8,Barcelona,12,Avinyó,2250,1120,1130
8,Barcelona,13,Avinyonet del Penedès,1669,887,782
8,Barcelona,15,Badalona,217741,107092,110649
8,Barcelona,904,Badia del Vallès,13417,6565,6852
8,Barcelona,16,Bagà,2152,1075,1077
8,Barcelona,17,Balenyà,3783,1907,1876
8,Barcelona,18,Balsareny,3205,1586,1619
8,Barcelona,252,Barberà del Vallès,32839,16167,16672
8,Barcelona,19,Barcelona,1620343,765962,854381
8,Barcelona,20,Begues,6961,3440,3521
8,Barcelona,21,Bellprat,74,46,28
8,Barcelona,22,Berga,16199,7979,8220
8,Barcelona,23,Bigues i Riells,9003,4587,4416
8,Barcelona,24,Borredà,456,257,199
8,Barcelona,25,"Bruc, El",2027,1095,932
8,Barcelona,26,"Brull, El",257,142,115
8,Barcelona,27,"Cabanyes, Les",965,492,473
8,Barcelona,28,Cabrera d'Anoia,1376,726,650
8,Barcelona,29,Cabrera de Mar,4664,2346,2318
8,Barcelona,30,Cabrils,7348,3626,3722
8,Barcelona,31,Calaf,3547,1790,1757
8,Barcelona,34,Calders,946,488,458
8,Barcelona,33,Caldes de Montbui,17449,8669,8780
8,Barcelona,32,Caldes d'Estrac,2859,1380,1479
8,Barcelona,35,Calella,18728,9152,9576
8,Barcelona,37,Calldetenes,2497,1265,1232
8,Barcelona,38,Callús,2095,1025,1070
8,Barcelona,36,Calonge de Segarra,191,95,96
8,Barcelona,39,Campins,515,272,243
8,Barcelona,40,Canet de Mar,14583,7075,7508
8,Barcelona,41,Canovelles,16317,8458,7859
8,Barcelona,42,Cànoves i Samalús,2995,1521,1474
8,Barcelona,43,Canyelles,4481,2310,2171
8,Barcelona,44,Capellades,5211,2572,2639
8,Barcelona,45,Capolat,96,45,51
8,Barcelona,46,Cardedeu,18165,8892,9273
8,Barcelona,47,Cardona,4652,2271,2381
8,Barcelona,48,Carme,783,398,385
8,Barcelona,49,Casserres,1572,780,792
8,Barcelona,57,Castell de l'Areny,72,41,31
8,Barcelona,52,Castellar de n'Hug,165,86,79
8,Barcelona,50,Castellar del Riu,165,92,73
8,Barcelona,51,Castellar del Vallès,24036,11855,12181
8,Barcelona,53,Castellbell i el Vilar,3599,1841,1758
8,Barcelona,54,Castellbisbal,12332,6244,6088
8,Barcelona,55,Castellcir,728,377,351
8,Barcelona,56,Castelldefels,66375,32747,33628
8,Barcelona,58,Castellet i la Gornal,2247,1147,1100
8,Barcelona,60,Castellfollit de Riubregós,156,90,66
8,Barcelona,59,Castellfollit del Boix,446,228,218
8,Barcelona,61,Castellgalí,2053,1065,988
8,Barcelona,62,Castellnou de Bages,1319,666,653
8,Barcelona,63,Castellolí,610,295,315
8,Barcelona,64,Castellterçol,2418,1208,1210
8,Barcelona,65,Castellví de la Marca,1534,772,762
8,Barcelona,66,Castellví de Rosanes,1865,917,948
8,Barcelona,67,Centelles,7423,3643,3780
8,Barcelona,268,Cercs,1152,567,585
8,Barcelona,266,Cerdanyola del Vallès,57740,28259,29481
8,Barcelona,68,Cervelló,8970,4495,4475
8,Barcelona,69,Collbató,4458,2304,2154
8,Barcelona,70,Collsuspina,339,173,166
8,Barcelona,71,Copons,306,151,155
8,Barcelona,72,Corbera de Llobregat,14643,7357,7286
8,Barcelona,73,Cornellà de Llobregat,87173,42226,44947
8,Barcelona,74,Cubelles,14992,7554,7438
8,Barcelona,75,Dosrius,5281,2681,2600
8,Barcelona,76,Esparreguera,22045,11153,10892
8,Barcelona,77,Esplugues de Llobregat,46355,22144,24211
8,Barcelona,78,"Espunyola, L'",258,130,128
8,Barcelona,254,"Esquirol, L'",2141,1083,1058
8,Barcelona,79,"Estany, L'",393,193,200
8,Barcelona,134,Figaró-Montmany,1109,551,558
8,Barcelona,80,Fígols,42,25,17
8,Barcelona,82,Fogars de la Selva,1467,753,714
8,Barcelona,81,Fogars de Montclús,466,245,221
8,Barcelona,83,Folgueroles,2276,1156,1120
8,Barcelona,84,Fonollosa,1439,743,696
8,Barcelona,85,Font-rubí,1354,702,652
8,Barcelona,86,"Franqueses del Vallès, Les",19768,10003,9765
8,Barcelona,90,Gaià,167,93,74
8,Barcelona,87,Gallifa,169,90,79
8,Barcelona,88,"Garriga, La",16227,7861,8366
8,Barcelona,89,Gavà,46705,22916,23789
8,Barcelona,91,Gelida,7371,3700,3671
8,Barcelona,92,Gironella,4834,2396,2438
8,Barcelona,93,Gisclareny,26,15,11
8,Barcelona,94,"Granada, La",2130,1077,1053
8,Barcelona,95,Granera,80,56,24
8,Barcelona,96,Granollers,60981,30023,30958
8,Barcelona,97,Gualba,1481,750,731
8,Barcelona,99,Guardiola de Berguedà,887,458,429
8,Barcelona,100,Gurb,2654,1360,1294
8,Barcelona,101,"Hospitalet de Llobregat, L'",261068,126066,135002
8,Barcelona,162,"Hostalets de Pierola, Els",2930,1502,1428
8,Barcelona,102,Igualada,39540,19393,20147
8,Barcelona,103,Jorba,841,431,410
8,Barcelona,104,"Llacuna, La",863,469,394
8,Barcelona,105,"Llagosta, La",13367,6595,6772
8,Barcelona,107,Lliçà d'Amunt,15111,7738,7373
8,Barcelona,108,Lliçà de Vall,6480,3299,3181
8,Barcelona,106,Llinars del Vallès,9838,4907,4931
8,Barcelona,109,Lluçà,276,135,141
8,Barcelona,110,Malgrat de Mar,18439,9217,9222
8,Barcelona,111,Malla,271,140,131
8,Barcelona,112,Manlleu,20194,10068,10126
8,Barcelona,113,Manresa,76250,37311,38939
8,Barcelona,242,Marganell,258,127,131
8,Barcelona,114,Martorell,27850,14179,13671
8,Barcelona,115,Martorelles,4794,2410,2384
8,Barcelona,116,"Masies de Roda, Les",704,354,350
8,Barcelona,117,"Masies de Voltregà, Les",3124,1543,1581
8,Barcelona,118,"Masnou, El",23340,11266,12074
8,Barcelona,119,Masquefa,8641,4338,4303
8,Barcelona,120,Matadepera,9291,4666,4625
8,Barcelona,121,Mataró,126988,62945,64043
8,Barcelona,122,Mediona,2331,1170,1161
8,Barcelona,138,Moià,6190,3147,3043
8,Barcelona,123,Molins de Rei,25687,12499,13188
8,Barcelona,124,Mollet del Vallès,51133,25152,25981
8,Barcelona,128,Monistrol de Calders,677,357,320
8,Barcelona,127,Monistrol de Montserrat,2955,1501,1454
8,Barcelona,125,Montcada i Reixac,35599,17522,18077
8,Barcelona,130,Montclar,129,66,63
8,Barcelona,131,Montesquiu,968,492,476
8,Barcelona,126,Montgat,11819,5832,5987
8,Barcelona,132,Montmajor,465,237,228
8,Barcelona,133,Montmaneu,154,88,66
8,Barcelona,135,Montmeló,8784,4298,4486
8,Barcelona,136,Montornès del Vallès,16263,8167,8096
8,Barcelona,137,Montseny,321,166,155
8,Barcelona,129,Muntanyola,620,316,304
8,Barcelona,139,Mura,223,121,102
8,Barcelona,140,Navarcles,5966,2917,3049
8,Barcelona,141,Navàs,6023,2988,3035
8,Barcelona,142,"Nou de Berguedà, La",160,81,79
8,Barcelona,143,Òdena,3608,1847,1761
8,Barcelona,145,Olèrdola,3611,1855,1756
8,Barcelona,146,Olesa de Bonesvalls,1787,941,846
8,Barcelona,147,Olesa de Montserrat,23779,11860,11919
8,Barcelona,148,Olivella,3729,1962,1767
8,Barcelona,149,Olost,1188,587,601
8,Barcelona,144,Olvan,837,405,432
8,Barcelona,150,Orís,310,156,154
8,Barcelona,151,Oristà,537,268,269
8,Barcelona,152,Orpí,136,75,61
8,Barcelona,153,Òrrius,730,375,355
8,Barcelona,154,Pacs del Penedès,908,455,453
8,Barcelona,155,Palafolls,9256,4652,4604
8,Barcelona,156,Palau-solità i Plegamans,14636,7160,7476
8,Barcelona,157,Pallejà,11486,5725,5761
8,Barcelona,905,"Palma de Cervelló, La",2982,1458,1524
8,Barcelona,158,"Papiol, El",4103,2031,2072
8,Barcelona,159,Parets del Vallès,19041,9551,9490
8,Barcelona,160,Perafita,412,210,202
8,Barcelona,161,Piera,15362,7848,7514
8,Barcelona,163,Pineda de Mar,26659,13254,13405
8,Barcelona,164,"Pla del Penedès, El",1259,634,625
8,Barcelona,165,"Pobla de Claramunt, La",2177,1109,1068
8,Barcelona,166,"Pobla de Lillet, La",1101,535,566
8,Barcelona,167,Polinyà,8389,4230,4159
8,Barcelona,182,"Pont de Vilomara i Rocafort, El",3801,1959,1842
8,Barcelona,168,Pontons,458,258,200
8,Barcelona,169,"Prat de Llobregat, El",64132,31413,32719
8,Barcelona,171,Prats de Lluçanès,2537,1273,1264
8,Barcelona,170,"Prats de Rei, Els",545,288,257
8,Barcelona,230,Premià de Dalt,10429,5206,5223
8,Barcelona,172,Premià de Mar,28071,13720,14351
8,Barcelona,174,Puigdàlber,518,257,261
8,Barcelona,175,Puig-reig,4094,2024,2070
8,Barcelona,176,Pujalt,207,113,94
8,Barcelona,177,"Quar, La",60,32,28
8,Barcelona,178,Rajadell,539,274,265
8,Barcelona,179,Rellinars,747,386,361
8,Barcelona,180,Ripollet,38347,18980,19367
8,Barcelona,181,"Roca del Vallès, La",10666,5314,5352
8,Barcelona,183,Roda de Ter,6197,3039,3158
8,Barcelona,184,Rubí,76423,37840,38583
8,Barcelona,185,Rubió,232,129,103
8,Barcelona,901,Rupit i Pruit,279,139,140
8,Barcelona,187,Sabadell,211734,102927,108807
8,Barcelona,188,Sagàs,161,90,71
8,Barcelona,190,Saldes,265,154,111
8,Barcelona,191,Sallent,6636,3194,3442
8,Barcelona,194,Sant Adrià de Besòs,36669,18028,18641
8,Barcelona,195,Sant Agustí de Lluçanès,87,44,43
8,Barcelona,196,Sant Andreu de la Barca,27332,13552,13780
8,Barcelona,197,Sant Andreu de Llavaneres,10877,5370,5507
8,Barcelona,198,Sant Antoni de Vilamajor,6095,3032,3063
8,Barcelona,199,Sant Bartomeu del Grau,840,446,394
8,Barcelona,200,Sant Boi de Llobregat,82904,40601,42303
8,Barcelona,201,Sant Boi de Lluçanès,532,260,272
8,Barcelona,203,Sant Cebrià de Vallalta,3344,1743,1601
8,Barcelona,202,Sant Celoni,17754,8833,8921
8,Barcelona,204,Sant Climent de Llobregat,4107,2074,2033
8,Barcelona,205,Sant Cugat del Vallès,90664,44106,46558
8,Barcelona,206,Sant Cugat Sesgarrigues,989,474,515
8,Barcelona,207,Sant Esteve de Palautordera,2749,1359,1390
8,Barcelona,208,Sant Esteve Sesrovires,7800,3920,3880
8,Barcelona,210,Sant Feliu de Codines,6184,3132,3052
8,Barcelona,211,Sant Feliu de Llobregat,44474,21536,22938
8,Barcelona,212,Sant Feliu Sasserra,600,316,284
8,Barcelona,209,Sant Fost de Campsentelles,8722,4330,4392
8,Barcelona,213,Sant Fruitós de Bages,8593,4256,4337
8,Barcelona,215,Sant Hipòlit de Voltregà,3475,1721,1754
8,Barcelona,193,Sant Iscle de Vallalta,1313,677,636
8,Barcelona,216,Sant Jaume de Frontanyà,30,18,12
8,Barcelona,218,Sant Joan de Vilatorrada,10820,5422,5398
8,Barcelona,217,Sant Joan Despí,34084,16569,17515
8,Barcelona,903,Sant Julià de Cerdanyola,244,133,111
8,Barcelona,220,Sant Julià de Vilatorta,3096,1529,1567
8,Barcelona,221,Sant Just Desvern,17494,8361,9133
8,Barcelona,222,Sant Llorenç d'Hortons,2598,1323,1275
8,Barcelona,223,Sant Llorenç Savall,2371,1190,1181
8,Barcelona,225,Sant Martí d'Albars,113,56,57
8,Barcelona,224,Sant Martí de Centelles,1131,590,541
8,Barcelona,226,Sant Martí de Tous,1206,616,590
8,Barcelona,227,Sant Martí Sarroca,3231,1591,1640
8,Barcelona,228,Sant Martí Sesgueioles,344,179,165
8,Barcelona,229,Sant Mateu de Bages,600,300,300
8,Barcelona,231,Sant Pere de Ribes,30658,15311,15347
8,Barcelona,232,Sant Pere de Riudebitlles,2338,1161,1177
8,Barcelona,233,Sant Pere de Torelló,2419,1251,1168
8,Barcelona,234,Sant Pere de Vilamajor,4371,2168,2203
8,Barcelona,189,Sant Pere Sallavinera,155,84,71
8,Barcelona,235,Sant Pol de Mar,5178,2563,2615
8,Barcelona,236,Sant Quintí de Mediona,2179,1119,1060
8,Barcelona,237,Sant Quirze de Besora,2107,1027,1080
8,Barcelona,238,Sant Quirze del Vallès,19939,9754,10185
8,Barcelona,239,Sant Quirze Safaja,637,332,305
8,Barcelona,240,Sant Sadurní d'Anoia,12866,6322,6544
8,Barcelona,241,Sant Sadurní d'Osormort,79,46,33
8,Barcelona,98,Sant Salvador de Guardiola,3168,1624,1544
8,Barcelona,262,Sant Vicenç de Castellet,9274,4620,4654
8,Barcelona,264,Sant Vicenç de Montalt,6372,3194,3178
8,Barcelona,265,Sant Vicenç de Torelló,2014,993,1021
8,Barcelona,263,Sant Vicenç dels Horts,27901,13846,14055
8,Barcelona,243,Santa Cecília de Voltregà,187,96,91
8,Barcelona,244,Santa Coloma de Cervelló,8179,4018,4161
8,Barcelona,245,Santa Coloma de Gramenet,118821,58849,59972
8,Barcelona,246,Santa Eugènia de Berga,2226,1130,1096
8,Barcelona,247,Santa Eulàlia de Riuprimer,1309,670,639
8,Barcelona,248,Santa Eulàlia de Ronçana,7192,3601,3591
8,Barcelona,249,Santa Fe del Penedès,379,191,188
8,Barcelona,250,Santa Margarida de Montbui,9874,4940,4934
8,Barcelona,251,Santa Margarida i els Monjos,7503,3802,3701
8,Barcelona,253,Santa Maria de Besora,143,72,71
8,Barcelona,256,Santa Maria de Martorelles,882,439,443
8,Barcelona,255,Santa Maria de Merlès,183,90,93
8,Barcelona,257,Santa Maria de Miralles,128,69,59
8,Barcelona,259,Santa Maria de Palautordera,9325,4673,4652
8,Barcelona,258,Santa Maria d'Oló,1024,516,508
8,Barcelona,260,Santa Perpètua de Mogoda,25705,12933,12772
8,Barcelona,261,Santa Susanna,3381,1700,1681
8,Barcelona,192,Santpedor,7532,3739,3793
8,Barcelona,267,Sentmenat,8957,4532,4425
8,Barcelona,269,Seva,3472,1746,1726
8,Barcelona,270,Sitges,28969,14476,14493
8,Barcelona,271,Sobremunt,79,34,45
8,Barcelona,272,Sora,205,115,90
8,Barcelona,273,Subirats,3025,1556,1469
8,Barcelona,274,Súria,5895,2874,3021
8,Barcelona,276,Tagamanent,333,174,159
8,Barcelona,277,Talamanca,202,115,87
8,Barcelona,278,Taradell,6412,3188,3224
8,Barcelona,275,Tavèrnoles,320,159,161
8,Barcelona,280,Tavertet,111,58,53
8,Barcelona,281,Teià,6312,3093,3219
8,Barcelona,279,Terrassa,218535,107540,110995
8,Barcelona,282,Tiana,8709,4170,4539
8,Barcelona,283,Tona,8131,4024,4107
8,Barcelona,284,Tordera,16937,8576,8361
8,Barcelona,285,Torelló,14172,7021,7151
8,Barcelona,286,"Torre de Claramunt, La",3716,1911,1805
8,Barcelona,287,Torrelavit,1430,736,694
8,Barcelona,288,Torrelles de Foix,2281,1219,1062
8,Barcelona,289,Torrelles de Llobregat,5945,2941,3004
8,Barcelona,290,Ullastrell,2069,1038,1031
8,Barcelona,291,Vacarisses,6486,3340,3146
8,Barcelona,292,Vallbona d'Anoia,1399,729,670
8,Barcelona,293,Vallcebre,246,139,107
8,Barcelona,294,Vallgorguina,2854,1427,1427
8,Barcelona,295,Vallirana,14877,7441,7436
8,Barcelona,296,Vallromanes,2530,1297,1233
8,Barcelona,297,Veciana,170,95,75
8,Barcelona,298,Vic,45040,22626,22414
8,Barcelona,299,Vilada,430,226,204
8,Barcelona,301,Viladecans,66168,32785,33383
8,Barcelona,300,Viladecavalls,7480,3707,3773
8,Barcelona,305,Vilafranca del Penedès,40055,19552,20503
8,Barcelona,306,Vilalba Sasserra,688,343,345
8,Barcelona,303,Vilanova de Sau,308,143,165
8,Barcelona,302,Vilanova del Camí,12361,6178,6183
8,Barcelona,902,Vilanova del Vallès,5339,2701,2638
8,Barcelona,307,Vilanova i la Geltrú,66274,32079,34195
8,Barcelona,214,Vilassar de Dalt,9013,4435,4578
8,Barcelona,219,Vilassar de Mar,20764,10018,10746
8,Barcelona,304,Vilobí del Penedès,1106,582,524
8,Barcelona,308,Viver i Serrateix,164,86,78
48,Bizkaia,1,Abadiño,7533,3771,3762
48,Bizkaia,2,Abanto y Ciérvana-Abanto Zierbena,9545,4701,4844
48,Bizkaia,911,Ajangiz,482,253,229
48,Bizkaia,912,Alonsotegi,2903,1429,1474
48,Bizkaia,3,Amorebieta-Etxano,19140,9380,9760
48,Bizkaia,4,Amoroto,419,215,204
48,Bizkaia,5,Arakaldo,156,72,84
48,Bizkaia,6,Arantzazu,393,193,200
48,Bizkaia,93,Areatza,1212,579,633
48,Bizkaia,9,Arrankudiaga,970,477,493
48,Bizkaia,914,Arratzu,418,202,216
48,Bizkaia,10,Arrieta,567,290,277
48,Bizkaia,11,Arrigorriaga,12230,5957,6273
48,Bizkaia,23,Artea,735,365,370
48,Bizkaia,8,Artzentales,734,395,339
48,Bizkaia,91,Atxondo,1377,696,681
48,Bizkaia,70,Aulesti,648,319,329
48,Bizkaia,12,Bakio,2645,1339,1306
48,Bizkaia,90,Balmaseda,7684,3728,3956
48,Bizkaia,13,Barakaldo,100435,48549,51886
48,Bizkaia,14,Barrika,1541,757,784
48,Bizkaia,15,Basauri,40762,19775,20987
48,Bizkaia,92,Bedia,1041,499,542
48,Bizkaia,16,Berango,7130,3495,3635
48,Bizkaia,17,Bermeo,16688,8239,8449
48,Bizkaia,18,Berriatua,1247,685,562
48,Bizkaia,19,Berriz,4678,2338,2340
48,Bizkaia,20,Bilbao,345821,162931,182890
48,Bizkaia,21,Busturia,1637,825,812
48,Bizkaia,901,Derio,6545,3216,3329
48,Bizkaia,26,Dima,1447,750,697
48,Bizkaia,27,Durango,29636,14510,15126
48,Bizkaia,28,Ea,831,424,407
48,Bizkaia,31,Elantxobe,346,172,174
48,Bizkaia,32,Elorrio,7336,3625,3711
48,Bizkaia,902,Erandio,24222,11764,12458
48,Bizkaia,33,Ereño,239,134,105
48,Bizkaia,34,Ermua,15890,7915,7975
48,Bizkaia,79,Errigoiti,487,268,219
48,Bizkaia,29,Etxebarri,11304,5660,5644
48,Bizkaia,30,Etxebarria,772,385,387
48,Bizkaia,906,Forua,929,458,471
48,Bizkaia,35,Fruiz,545,270,275
48,Bizkaia,36,Galdakao,29288,14438,14850
48,Bizkaia,37,Galdames,829,445,384
48,Bizkaia,38,Gamiz-Fika,1375,677,698
48,Bizkaia,39,Garai,320,161,159
48,Bizkaia,40,Gatika,1673,834,839
48,Bizkaia,41,Gautegiz Arteaga,840,422,418
48,Bizkaia,46,Gernika-Lumo,16972,8179,8793
48,Bizkaia,44,Getxo,78276,36639,41637
48,Bizkaia,47,Gizaburuaga,212,111,101
48,Bizkaia,42,Gordexola,1686,854,832
48,Bizkaia,43,Gorliz,5683,2809,2874
48,Bizkaia,45,Güeñes,6681,3224,3457
48,Bizkaia,48,Ibarrangelu,636,328,308
48,Bizkaia,94,Igorre,4257,2082,2175
48,Bizkaia,49,Ispaster,725,383,342
48,Bizkaia,910,Iurreta,3643,1818,1825
48,Bizkaia,50,Izurtza,255,155,100
48,Bizkaia,22,Karrantza Harana/Valle de Carranza,2715,1408,1307
48,Bizkaia,907,Kortezubi,444,222,222
48,Bizkaia,51,Lanestosa,254,135,119
48,Bizkaia,52,Larrabetzu,2029,981,1048
48,Bizkaia,53,Laukiz,1191,593,598
48,Bizkaia,54,Leioa,31495,15366,16129
48,Bizkaia,57,Lekeitio,7258,3591,3667
48,Bizkaia,55,Lemoa,3521,1760,1761
48,Bizkaia,56,Lemoiz,1241,656,585
48,Bizkaia,81,Lezama,2429,1205,1224
48,Bizkaia,903,Loiu,2416,1212,1204
48,Bizkaia,58,Mallabia,1158,586,572
48,Bizkaia,59,Mañaria,519,271,248
48,Bizkaia,60,Markina-Xemein,4934,2508,2426
48,Bizkaia,61,Maruri-Jatabe,982,505,477
48,Bizkaia,62,Mendata,381,194,187
48,Bizkaia,63,Mendexa,432,220,212
48,Bizkaia,64,Meñaka,755,397,358
48,Bizkaia,66,Morga,423,225,198
48,Bizkaia,68,Mundaka,1835,883,952
48,Bizkaia,69,Mungia,17554,8552,9002
48,Bizkaia,7,Munitibar-Arbatzegi Gerrikaitz,460,249,211
48,Bizkaia,908,Murueta,309,156,153
48,Bizkaia,71,Muskiz,7567,3731,3836
48,Bizkaia,67,Muxika,1455,762,693
48,Bizkaia,909,Nabarniz,255,128,127
48,Bizkaia,73,Ondarroa,8397,4218,4179
48,Bizkaia,75,Orozko,2651,1297,1354
48,Bizkaia,83,Ortuella,8360,4081,4279
48,Bizkaia,72,Otxandio,1296,655,641
48,Bizkaia,77,Plentzia,4363,2134,2229
48,Bizkaia,78,Portugalete,45826,21955,23871
48,Bizkaia,82,Santurtzi,45795,22039,23756
48,Bizkaia,84,Sestao,27445,13309,14136
48,Bizkaia,904,Sondika,4495,2170,2325
48,Bizkaia,85,Sopela,13643,6716,6927
48,Bizkaia,86,Sopuerta,2569,1282,1287
48,Bizkaia,76,Sukarrieta,357,186,171
48,Bizkaia,87,Trucios-Turtzioz,511,272,239
48,Bizkaia,88,Ubide,177,92,85
48,Bizkaia,65,Ugao-Miraballes,4124,2063,2061
48,Bizkaia,89,Urduliz,4319,2136,2183
48,Bizkaia,74,Urduña/Orduña,4180,2159,2021
48,Bizkaia,80,Valle de Trápaga-Trapagaran,11953,5821,6132
48,Bizkaia,95,Zaldibar,3054,1539,1515
48,Bizkaia,96,Zalla,8379,4125,4254
48,Bizkaia,905,Zamudio,3236,1584,1652
48,Bizkaia,97,Zaratamo,1615,799,816
48,Bizkaia,24,Zeanuri,1242,624,618
48,Bizkaia,25,Zeberio,1059,544,515
48,Bizkaia,913,Zierbena,1492,792,700
48,Bizkaia,915,Ziortza-Bolibar,427,227,200
9,Burgos,1,Abajas,27,19,8
9,Burgos,3,Adrada de Haza,219,110,109
9,Burgos,6,Aguas Cándidas,57,35,22
9,Burgos,7,Aguilar de Bureba,61,38,23
9,Burgos,9,Albillos,214,111,103
9,Burgos,10,Alcocero de Mola,36,26,10
9,Burgos,11,Alfoz de Bricia,77,46,31
9,Burgos,907,Alfoz de Quintanadueñas,2007,1071,936
9,Burgos,12,Alfoz de Santa Gadea,100,57,43
9,Burgos,13,Altable,53,31,22
9,Burgos,14,"Altos, Los",186,111,75
9,Burgos,16,Ameyugo,105,60,45
9,Burgos,17,Anguix,135,74,61
9,Burgos,18,Aranda de Duero,32523,15805,16718
9,Burgos,19,Arandilla,161,99,62
9,Burgos,20,Arauzo de Miel,326,176,150
9,Burgos,21,Arauzo de Salce,56,34,22
9,Burgos,22,Arauzo de Torre,73,42,31
9,Burgos,23,Arcos,1684,895,789
9,Burgos,24,Arenillas de Riopisuerga,182,107,75
9,Burgos,25,Arija,126,65,61
9,Burgos,26,Arlanzón,408,252,156
9,Burgos,27,Arraya de Oca,49,29,20
9,Burgos,29,Atapuerca,172,98,74
9,Burgos,30,"Ausines, Los",129,75,54
9,Burgos,32,Avellanosa de Muñó,112,60,52
9,Burgos,33,Bahabón de Esgueva,73,45,28
9,Burgos,34,"Balbases, Los",311,173,138
9,Burgos,35,Baños de Valdearados,342,201,141
9,Burgos,36,Bañuelos de Bureba,34,19,15
9,Burgos,37,Barbadillo de Herreros,109,64,45
9,Burgos,38,Barbadillo del Mercado,143,76,67
9,Burgos,39,Barbadillo del Pez,67,41,26
9,Burgos,41,Barrio de Muñó,33,19,14
9,Burgos,43,"Barrios de Bureba, Los",194,115,79
9,Burgos,44,Barrios de Colina,53,28,25
9,Burgos,45,Basconcillos del Tozo,285,159,126
9,Burgos,46,Bascuñana,25,16,9
9,Burgos,47,Belbimbre,67,34,33
9,Burgos,48,Belorado,1816,926,890
9,Burgos,50,Berberana,55,31,24
9,Burgos,51,Berlangas de Roa,184,100,84
9,Burgos,52,Berzosa de Bureba,29,21,8
9,Burgos,54,Bozoó,98,61,37
9,Burgos,55,Brazacorta,55,31,24
9,Burgos,56,Briviesca,6675,3323,3352
9,Burgos,57,Bugedo,173,114,59
9,Burgos,58,Buniel,543,299,244
9,Burgos,59,Burgos,175921,83728,92193
9,Burgos,60,Busto de Bureba,149,79,70
9,Burgos,61,Cabañes de Esgueva,169,94,75
9,Burgos,62,Cabezón de la Sierra,53,26,27
9,Burgos,64,Caleruega,433,227,206
9,Burgos,65,Campillo de Aranda,162,98,64
9,Burgos,66,Campolara,61,45,16
9,Burgos,67,Canicosa de la Sierra,470,246,224
9,Burgos,68,Cantabrana,27,15,12
9,Burgos,70,Carazo,33,24,9
9,Burgos,71,Carcedo de Bureba,44,25,19
9,Burgos,72,Carcedo de Burgos,411,223,188
9,Burgos,73,Cardeñadijo,1313,722,591
9,Burgos,74,Cardeñajimeno,1101,569,532
9,Burgos,75,Cardeñuela Riopico,112,65,47
9,Burgos,76,Carrias,25,19,6
9,Burgos,77,Cascajares de Bureba,33,16,17
9,Burgos,78,Cascajares de la Sierra,37,21,16
9,Burgos,79,Castellanos de Castro,50,30,20
9,Burgos,83,Castil de Peones,32,18,14
9,Burgos,82,Castildelgado,36,21,15
9,Burgos,84,Castrillo de la Reina,185,119,66
9,Burgos,85,Castrillo de la Vega,632,345,287
9,Burgos,88,Castrillo de Riopisuerga,62,38,24
9,Burgos,86,Castrillo del Val,792,453,339
9,Burgos,90,Castrillo Mota de Judíos,52,28,24
9,Burgos,91,Castrojeriz,803,417,386
9,Burgos,63,Cavia,233,138,95
9,Burgos,93,Cayuela,177,94,83
9,Burgos,94,Cebrecos,54,33,21
9,Burgos,95,Celada del Camino,115,57,58
9,Burgos,98,Cerezo de Río Tirón,575,313,262
9,Burgos,100,Cerratón de Juarros,57,37,20
9,Burgos,101,Ciadoncha,78,46,32
9,Burgos,102,Cillaperlata,33,22,11
9,Burgos,103,Cilleruelo de Abajo,224,124,100
9,Burgos,104,Cilleruelo de Arriba,44,23,21
9,Burgos,105,Ciruelos de Cervera,101,58,43
9,Burgos,108,Cogollos,545,299,246
9,Burgos,109,Condado de Treviño,1352,768,584
9,Burgos,110,Contreras,80,50,30
9,Burgos,112,Coruña del Conde,112,69,43
9,Burgos,113,Covarrubias,545,289,256
9,Burgos,114,Cubillo del Campo,95,53,42
9,Burgos,115,Cubo de Bureba,98,55,43
9,Burgos,117,"Cueva de Roa, La",85,43,42
9,Burgos,119,Cuevas de San Clemente,45,16,29
9,Burgos,120,Encío,42,24,18
9,Burgos,122,Espinosa de Cervera,95,60,35
9,Burgos,124,Espinosa de los Monteros,1696,891,805
9,Burgos,123,Espinosa del Camino,44,27,17
9,Burgos,125,Estépar,608,363,245
9,Burgos,127,Fontioso,52,31,21
9,Burgos,128,Frandovínez,84,49,35
9,Burgos,129,Fresneda de la Sierra Tirón,101,66,35
9,Burgos,130,Fresneña,76,47,29
9,Burgos,131,Fresnillo de las Dueñas,653,342,311
9,Burgos,132,Fresno de Río Tirón,181,112,69
9,Burgos,133,Fresno de Rodilla,45,25,20
9,Burgos,134,Frías,254,133,121
9,Burgos,135,Fuentebureba,41,22,19
9,Burgos,136,Fuentecén,227,124,103
9,Burgos,137,Fuentelcésped,235,118,117
9,Burgos,138,Fuentelisendo,83,45,38
9,Burgos,139,Fuentemolinos,107,69,38
9,Burgos,140,Fuentenebro,126,77,49
9,Burgos,141,Fuentespina,775,400,375
9,Burgos,143,Galbarros,29,18,11
9,Burgos,144,"Gallega, La",45,29,16
9,Burgos,148,Grijalba,100,51,49
9,Burgos,149,Grisaleña,37,28,9
9,Burgos,151,Gumiel de Izán,548,310,238
9,Burgos,152,Gumiel de Mercado,310,171,139
9,Burgos,154,Hacinas,155,89,66
9,Burgos,155,Haza,26,16,10
9,Burgos,159,Hontanas,69,43,26
9,Burgos,160,Hontangas,91,59,32
9,Burgos,162,Hontoria de la Cantera,156,82,74
9,Burgos,164,Hontoria de Valdearados,180,109,71
9,Burgos,163,Hontoria del Pinar,669,371,298
9,Burgos,166,"Hormazas, Las",105,61,44
9,Burgos,167,Hornillos del Camino,58,36,22
9,Burgos,168,"Horra, La",337,182,155
9,Burgos,169,Hortigüela,103,69,34
9,Burgos,170,Hoyales de Roa,223,120,103
9,Burgos,172,Huérmeces,136,70,66
9,Burgos,173,Huerta de Arriba,133,75,58
9,Burgos,174,Huerta de Rey,932,507,425
9,Burgos,175,Humada,121,82,39
9,Burgos,176,Hurones,62,42,20
9,Burgos,177,Ibeas de Juarros,1405,764,641
9,Burgos,178,Ibrillos,45,29,16
9,Burgos,179,Iglesiarrubia,41,22,19
9,Burgos,180,Iglesias,137,76,61
9,Burgos,181,Isar,307,160,147
9,Burgos,182,Itero del Castillo,78,45,33
9,Burgos,183,Jaramillo de la Fuente,49,31,18
9,Burgos,184,Jaramillo Quemado,8,6,2
9,Burgos,189,Junta de Traslaloma,131,72,59
9,Burgos,190,Junta de Villalba de Losa,86,48,38
9,Burgos,191,Jurisdicción de Lara,33,20,13
9,Burgos,192,Jurisdicción de San Zadornil,55,31,24
9,Burgos,194,Lerma,2560,1281,1279
9,Burgos,195,Llano de Bureba,60,39,21
9,Burgos,196,Madrigal del Monte,147,89,58
9,Burgos,197,Madrigalejo del Monte,168,109,59
9,Burgos,198,Mahamud,112,65,47
9,Burgos,199,Mambrilla de Castrejón,100,56,44
9,Burgos,200,Mambrillas de Lara,52,31,21
9,Burgos,201,Mamolar,29,21,8
9,Burgos,202,Manciles,22,14,8
9,Burgos,206,Mazuela,56,32,24
9,Burgos,208,Mecerreyes,211,111,100
9,Burgos,209,Medina de Pomar,5816,2958,2858
9,Burgos,211,Melgar de Fernamental,1611,866,745
9,Burgos,213,Merindad de Cuesta-Urria,313,172,141
9,Burgos,214,Merindad de Montija,733,438,295
9,Burgos,906,Merindad de Río Ubierna,1443,798,645
9,Burgos,215,Merindad de Sotoscueva,402,227,175
9,Burgos,216,Merindad de Valdeporres,429,222,207
9,Burgos,217,Merindad de Valdivielso,386,222,164
9,Burgos,218,Milagros,451,244,207
9,Burgos,219,Miranda de Ebro,35477,17433,18044
9,Burgos,220,Miraveche,71,47,24
9,Burgos,221,Modúbar de la Emparedada,669,369,300
9,Burgos,223,Monasterio de la Sierra,44,29,15
9,Burgos,224,Monasterio de Rodilla,164,89,75
9,Burgos,225,Moncalvillo,87,52,35
9,Burgos,226,Monterrubio de la Demanda,59,36,23
9,Burgos,227,Montorio,148,78,70
9,Burgos,228,Moradillo de Roa,172,92,80
9,Burgos,229,Nava de Roa,224,121,103
9,Burgos,230,Navas de Bureba,35,18,17
9,Burgos,231,Nebreda,65,47,18
9,Burgos,232,Neila,158,93,65
9,Burgos,235,Olmedillo de Roa,189,110,79
9,Burgos,236,Olmillos de Muñó,37,22,15
9,Burgos,238,Oña,1024,538,486
9,Burgos,239,Oquillas,55,31,24
9,Burgos,241,Orbaneja Riopico,328,177,151
9,Burgos,242,Padilla de Abajo,78,44,34
9,Burgos,243,Padilla de Arriba,77,47,30
9,Burgos,244,Padrones de Bureba,50,25,25
9,Burgos,246,Palacios de la Sierra,721,371,350
9,Burgos,247,Palacios de Riopisuerga,24,12,12
9,Burgos,248,Palazuelos de la Sierra,82,48,34
9,Burgos,249,Palazuelos de Muñó,52,29,23
9,Burgos,250,Pampliega,282,152,130
9,Burgos,251,Pancorbo,436,239,197
9,Burgos,253,Pardilla,117,69,48
9,Burgos,255,Partido de la Sierra en Tobalina,90,52,38
9,Burgos,256,Pedrosa de Duero,438,253,185
9,Burgos,259,Pedrosa de Río Úrbel,251,149,102
9,Burgos,257,Pedrosa del Páramo,94,57,37
9,Burgos,258,Pedrosa del Príncipe,174,93,81
9,Burgos,261,Peñaranda de Duero,527,261,266
9,Burgos,262,Peral de Arlanza,167,91,76
9,Burgos,265,Piérnigas,38,22,16
9,Burgos,266,Pineda de la Sierra,103,66,37
9,Burgos,267,Pineda Trasmonte,111,66,45
9,Burgos,268,Pinilla de los Barruecos,111,62,49
9,Burgos,269,Pinilla de los Moros,36,21,15
9,Burgos,270,Pinilla Trasmonte,167,96,71
9,Burgos,272,Poza de la Sal,294,155,139
9,Burgos,273,Prádanos de Bureba,53,33,20
9,Burgos,274,Pradoluengo,1169,586,583
9,Burgos,275,Presencio,179,110,69
9,Burgos,276,"Puebla de Arganzón, La",495,269,226
9,Burgos,277,Puentedura,115,78,37
9,Burgos,279,Quemada,238,142,96
9,Burgos,281,Quintana del Pidio,154,80,74
9,Burgos,280,Quintanabureba,24,14,10
9,Burgos,283,Quintanaélez,46,24,22
9,Burgos,287,Quintanaortuño,267,154,113
9,Burgos,288,Quintanapalla,111,63,48
9,Burgos,289,Quintanar de la Sierra,1690,892,798
9,Burgos,292,Quintanavides,79,48,31
9,Burgos,294,Quintanilla de la Mata,114,69,45
9,Burgos,901,Quintanilla del Agua y Tordueles,383,200,183
9,Burgos,295,Quintanilla del Coco,57,28,29
9,Burgos,298,Quintanilla San García,87,49,38
9,Burgos,301,Quintanilla Vivar,803,426,377
9,Burgos,297,"Quintanillas, Las",376,217,159
9,Burgos,302,Rabanera del Pinar,108,66,42
9,Burgos,303,Rábanos,83,51,32
9,Burgos,304,Rabé de las Calzadas,208,111,97
9,Burgos,306,Rebolledo de la Torre,112,61,51
9,Burgos,307,Redecilla del Camino,115,72,43
9,Burgos,308,Redecilla del Campo,68,39,29
9,Burgos,309,Regumiel de la Sierra,349,185,164
9,Burgos,310,Reinoso,11,8,3
9,Burgos,311,Retuerta,59,37,22
9,Burgos,314,Revilla del Campo,94,60,34
9,Burgos,316,Revilla Vallejera,115,73,42
9,Burgos,312,"Revilla y Ahedo, La",107,60,47
9,Burgos,315,Revillarruz,523,269,254
9,Burgos,317,Rezmondo,19,7,12
9,Burgos,318,Riocavado de la Sierra,60,38,22
9,Burgos,321,Roa,2185,1104,1081
9,Burgos,323,Rojas,65,43,22
9,Burgos,325,Royuela de Río Franco,193,117,76
9,Burgos,326,Rubena,183,106,77
9,Burgos,327,Rublacedo de Abajo,36,18,18
9,Burgos,328,Rucandio,65,31,34
9,Burgos,329,Salas de Bureba,131,76,55
9,Burgos,330,Salas de los Infantes,1955,1007,948
9,Burgos,332,Saldaña de Burgos,169,92,77
9,Burgos,334,Salinillas de Bureba,51,41,10
9,Burgos,335,San Adrián de Juarros,88,55,33
9,Burgos,337,San Juan del Monte,142,79,63
9,Burgos,338,San Mamés de Burgos,298,168,130
9,Burgos,339,San Martín de Rubiales,141,82,59
9,Burgos,340,San Millán de Lara,79,56,23
9,Burgos,360,San Vicente del Valle,25,20,5
9,Burgos,343,Santa Cecilia,101,61,40
9,Burgos,345,Santa Cruz de la Salceda,140,87,53
9,Burgos,346,Santa Cruz del Valle Urbión,99,65,34
9,Burgos,347,Santa Gadea del Cid,145,74,71
9,Burgos,348,Santa Inés,141,74,67
9,Burgos,350,Santa María del Campo,537,291,246
9,Burgos,351,Santa María del Invierno,62,45,17
9,Burgos,352,Santa María del Mercadillo,104,66,38
9,Burgos,353,Santa María Rivarredonda,91,54,37
9,Burgos,354,Santa Olalla de Bureba,35,26,9
9,Burgos,355,Santibáñez de Esgueva,85,46,39
9,Burgos,356,Santibáñez del Val,45,28,17
9,Burgos,358,Santo Domingo de Silos,279,172,107
9,Burgos,361,Sargentes de la Lora,114,64,50
9,Burgos,362,Sarracín,245,135,110
9,Burgos,363,Sasamón,995,562,433
9,Burgos,365,"Sequera de Haza, La",31,22,9
9,Burgos,366,Solarana,77,45,32
9,Burgos,368,Sordillos,23,16,7
9,Burgos,369,Sotillo de la Ribera,490,255,235
9,Burgos,372,Sotragero,268,143,125
9,Burgos,373,Sotresgudo,448,258,190
9,Burgos,374,Susinos del Páramo,103,66,37
9,Burgos,375,Tamarón,38,21,17
9,Burgos,377,Tardajos,782,422,360
9,Burgos,378,Tejada,29,17,12
9,Burgos,380,Terradillos de Esgueva,80,38,42
9,Burgos,381,Tinieblas de la Sierra,34,20,14
9,Burgos,382,Tobar,24,17,7
9,Burgos,384,Tordómar,346,189,157
9,Burgos,386,Torrecilla del Monte,65,37,28
9,Burgos,387,Torregalindo,126,81,45
9,Burgos,388,Torrelara,30,16,14
9,Burgos,389,Torrepadre,68,39,29
9,Burgos,390,Torresandino,657,356,301
9,Burgos,391,Tórtoles de Esgueva,458,242,216
9,Burgos,392,Tosantos,57,32,25
9,Burgos,394,Trespaderne,809,414,395
9,Burgos,395,Tubilla del Agua,134,81,53
9,Burgos,396,Tubilla del Lago,160,85,75
9,Burgos,398,Úrbel del Castillo,79,52,27
9,Burgos,400,Vadocondes,369,201,168
9,Burgos,403,Valdeande,104,62,42
9,Burgos,405,Valdezate,136,75,61
9,Burgos,406,Valdorros,333,189,144
9,Burgos,408,Vallarta de Bureba,42,26,16
9,Burgos,904,Valle de las Navas,514,300,214
9,Burgos,908,Valle de Losa,498,290,208
9,Burgos,409,Valle de Manzanedo,126,67,59
9,Burgos,410,Valle de Mena,3739,1911,1828
9,Burgos,411,Valle de Oca,157,96,61
9,Burgos,902,Valle de Santibáñez,480,277,203
9,Burgos,905,Valle de Sedano,427,244,183
9,Burgos,412,Valle de Tobalina,948,515,433
9,Burgos,413,Valle de Valdebezana,477,247,230
9,Burgos,414,Valle de Valdelaguna,195,114,81
9,Burgos,415,Valle de Valdelucio,321,176,145
9,Burgos,416,Valle de Zamanzas,50,28,22
9,Burgos,417,Vallejera,42,24,18
9,Burgos,418,Valles de Palenzuela,83,42,41
9,Burgos,419,Valluércanes,76,48,28
9,Burgos,407,Valmala,29,17,12
9,Burgos,422,"Vid de Bureba, La",17,9,8
9,Burgos,421,"Vid y Barrios, La",239,139,100
9,Burgos,423,Vileña,29,19,10
9,Burgos,427,Villadiego,1527,843,684
9,Burgos,428,Villaescusa de Roa,105,61,44
9,Burgos,429,Villaescusa la Sombría,59,44,15
9,Burgos,430,Villaespasa,24,15,9
9,Burgos,431,Villafranca Montes de Oca,119,73,46
9,Burgos,432,Villafruela,191,110,81
9,Burgos,433,Villagalijo,61,39,22
9,Burgos,434,Villagonzalo Pedernales,1785,938,847
9,Burgos,437,Villahoz,309,167,142
9,Burgos,438,Villalba de Duero,673,354,319
9,Burgos,439,Villalbilla de Burgos,1406,763,643
9,Burgos,440,Villalbilla de Gumiel,88,54,34
9,Burgos,441,Villaldemiro,71,42,29
9,Burgos,442,Villalmanzo,438,236,202
9,Burgos,443,Villamayor de los Montes,175,85,90
9,Burgos,444,Villamayor de Treviño,68,35,33
9,Burgos,445,Villambistia,45,32,13
9,Burgos,446,Villamedianilla,12,7,5
9,Burgos,447,Villamiel de la Sierra,46,28,18
9,Burgos,448,Villangómez,217,133,84
9,Burgos,449,Villanueva de Argaño,108,63,45
9,Burgos,450,Villanueva de Carazo,30,19,11
9,Burgos,451,Villanueva de Gumiel,278,144,134
9,Burgos,454,Villanueva de Teba,41,27,14
9,Burgos,455,Villaquirán de la Puebla,45,28,17
9,Burgos,456,Villaquirán de los Infantes,150,80,70
9,Burgos,903,Villarcayo de Merindad de Castilla la Vieja,4207,2152,2055
9,Burgos,458,Villariezo,644,358,286
9,Burgos,460,Villasandino,189,112,77
9,Burgos,463,Villasur de Herreros,276,170,106
9,Burgos,464,Villatuelda,40,23,17
9,Burgos,466,Villaverde del Monte,112,65,47
9,Burgos,467,Villaverde-Mogina,75,50,25
9,Burgos,471,Villayerno Morquillas,194,98,96
9,Burgos,472,Villazopeque,58,36,22
9,Burgos,473,Villegas,87,50,37
9,Burgos,476,Villoruebo,74,47,27
9,Burgos,424,Viloria de Rioja,42,25,17
9,Burgos,425,Vilviestre del Pinar,549,301,248
9,Burgos,478,Vizcaínos,43,30,13
9,Burgos,480,Zael,112,58,54
9,Burgos,482,Zarzosa de Río Pisuerga,31,19,12
9,Burgos,483,Zazuar,226,117,109
9,Burgos,485,Zuñeda,58,36,22
10,Cáceres,1,Abadía,335,189,146
10,Cáceres,2,Abertura,403,207,196
10,Cáceres,3,Acebo,580,294,286
10,Cáceres,4,Acehúche,801,399,402
10,Cáceres,5,Aceituna,607,312,295
10,Cáceres,6,Ahigal,1401,723,678
10,Cáceres,903,Alagón del Río,934,467,467
10,Cáceres,7,Albalá,663,337,326
10,Cáceres,8,Alcántara,1480,738,742
10,Cáceres,9,Alcollarín,225,112,113
10,Cáceres,10,Alcuéscar,2646,1384,1262
10,Cáceres,12,Aldea del Cano,620,288,332
10,Cáceres,13,"Aldea del Obispo, La",305,163,142
10,Cáceres,11,Aldeacentenera,576,289,287
10,Cáceres,14,Aldeanueva de la Vera,2085,1026,1059
10,Cáceres,15,Aldeanueva del Camino,753,367,386
10,Cáceres,16,Aldehuela de Jerte,370,194,176
10,Cáceres,17,Alía,831,416,415
10,Cáceres,18,Aliseda,1850,948,902
10,Cáceres,19,Almaraz,1765,902,863
10,Cáceres,20,Almoharín,1838,901,937
10,Cáceres,21,Arroyo de la Luz,5851,2912,2939
10,Cáceres,23,Arroyomolinos,736,390,346
10,Cáceres,22,Arroyomolinos de la Vera,444,222,222
10,Cáceres,24,Baños de Montemayor,776,365,411
10,Cáceres,25,Barrado,407,209,198
10,Cáceres,26,Belvís de Monroy,729,378,351
10,Cáceres,27,Benquerencia,77,43,34
10,Cáceres,28,Berrocalejo,91,50,41
10,Cáceres,29,Berzocana,437,232,205
10,Cáceres,30,Bohonal de Ibor,500,260,240
10,Cáceres,31,Botija,187,106,81
10,Cáceres,32,Brozas,1867,926,941
10,Cáceres,33,Cabañas del Castillo,434,232,202
10,Cáceres,34,Cabezabellosa,349,176,173
10,Cáceres,35,Cabezuela del Valle,2151,1104,1047
10,Cáceres,36,Cabrero,345,189,156
10,Cáceres,37,Cáceres,96068,46051,50017
10,Cáceres,38,Cachorrilla,78,39,39
10,Cáceres,39,Cadalso,428,217,211
10,Cáceres,40,Calzadilla,490,252,238
10,Cáceres,41,Caminomorisco,1185,621,564
10,Cáceres,42,Campillo de Deleitosa,62,25,37
10,Cáceres,43,Campo Lugar,856,421,435
10,Cáceres,44,Cañamero,1634,860,774
10,Cáceres,45,Cañaveral,1019,500,519
10,Cáceres,46,Carbajo,208,110,98
10,Cáceres,47,Carcaboso,1110,552,558
10,Cáceres,48,Carrascalejo,230,113,117
10,Cáceres,49,Casar de Cáceres,4500,2217,2283
10,Cáceres,50,Casar de Palomero,1124,571,553
10,Cáceres,51,Casares de las Hurdes,386,194,192
10,Cáceres,52,Casas de Don Antonio,163,81,82
10,Cáceres,53,Casas de Don Gómez,301,164,137
10,Cáceres,56,Casas de Millán,585,293,292
10,Cáceres,57,Casas de Miravete,140,85,55
10,Cáceres,54,Casas del Castañar,581,285,296
10,Cáceres,55,Casas del Monte,815,420,395
10,Cáceres,58,Casatejada,1381,715,666
10,Cáceres,59,Casillas de Coria,375,182,193
10,Cáceres,60,Castañar de Ibor,1053,542,511
10,Cáceres,61,Ceclavín,1854,950,904
10,Cáceres,62,Cedillo,449,236,213
10,Cáceres,63,Cerezo,170,84,86
10,Cáceres,64,Cilleros,1650,838,812
10,Cáceres,65,Collado de la Vera,190,105,85
10,Cáceres,66,Conquista de la Sierra,185,109,76
10,Cáceres,67,Coria,12531,6164,6367
10,Cáceres,68,Cuacos de Yuste,846,442,404
10,Cáceres,69,"Cumbre, La",864,435,429
10,Cáceres,70,Deleitosa,728,364,364
10,Cáceres,71,Descargamaría,120,71,49
10,Cáceres,72,Eljas,915,466,449
10,Cáceres,73,Escurial,849,445,404
10,Cáceres,75,Fresnedoso de Ibor,275,150,125
10,Cáceres,76,Galisteo,953,478,475
10,Cáceres,77,Garciaz,725,375,350
10,Cáceres,79,Garganta la Olla,984,518,466
10,Cáceres,78,"Garganta, La",392,214,178
10,Cáceres,80,Gargantilla,403,208,195
10,Cáceres,81,Gargüera,128,71,57
10,Cáceres,82,Garrovillas de Alconétar,2054,1020,1034
10,Cáceres,83,Garvín,98,52,46
10,Cáceres,84,Gata,1493,774,719
10,Cáceres,85,"Gordo, El",363,186,177
10,Cáceres,86,"Granja, La",335,175,160
10,Cáceres,87,Guadalupe,1887,931,956
10,Cáceres,88,Guijo de Coria,204,107,97
10,Cáceres,89,Guijo de Galisteo,1529,770,759
10,Cáceres,90,Guijo de Granadilla,536,281,255
10,Cáceres,91,Guijo de Santa Bárbara,387,203,184
10,Cáceres,92,Herguijuela,299,155,144
10,Cáceres,93,Hernán-Pérez,457,228,229
10,Cáceres,94,Herrera de Alcántara,255,131,124
10,Cáceres,95,Herreruela,342,176,166
10,Cáceres,96,Hervás,4052,1992,2060
10,Cáceres,97,Higuera,102,62,40
10,Cáceres,98,Hinojal,396,206,190
10,Cáceres,99,Holguera,647,322,325
10,Cáceres,100,Hoyos,906,444,462
10,Cáceres,101,Huélaga,216,108,108
10,Cáceres,102,Ibahernando,564,276,288
10,Cáceres,103,Jaraicejo,489,242,247
10,Cáceres,104,Jaraíz de la Vera,6477,3232,3245
10,Cáceres,105,Jarandilla de la Vera,2868,1429,1439
10,Cáceres,106,Jarilla,141,73,68
10,Cáceres,107,Jerte,1266,636,630
10,Cáceres,108,Ladrillar,201,106,95
10,Cáceres,109,Logrosán,2007,1008,999
10,Cáceres,110,Losar de la Vera,2749,1420,1329
10,Cáceres,111,Madrigal de la Vera,1595,836,759
10,Cáceres,112,Madrigalejo,1759,875,884
10,Cáceres,113,Madroñera,2595,1290,1305
10,Cáceres,114,Majadas,1328,665,663
10,Cáceres,115,Malpartida de Cáceres,4156,2089,2067
10,Cáceres,116,Malpartida de Plasencia,4602,2275,2327
10,Cáceres,117,Marchagaz,217,112,105
10,Cáceres,118,Mata de Alcántara,309,159,150
10,Cáceres,119,Membrío,634,314,320
10,Cáceres,120,Mesas de Ibor,175,90,85
10,Cáceres,121,Miajadas,9685,4818,4867
10,Cáceres,122,Millanes,256,128,128
10,Cáceres,123,Mirabel,653,327,326
10,Cáceres,124,Mohedas de Granadilla,827,412,415
10,Cáceres,125,Monroy,969,497,472
10,Cáceres,126,Montánchez,1732,875,857
10,Cáceres,127,Montehermoso,5731,2918,2813
10,Cáceres,128,Moraleja,6792,3384,3408
10,Cáceres,129,Morcillo,378,176,202
10,Cáceres,130,Navaconcejo,2003,1008,995
10,Cáceres,131,Navalmoral de la Mata,17170,8274,8896
10,Cáceres,132,Navalvillar de Ibor,416,207,209
10,Cáceres,133,Navas del Madroño,1336,669,667
10,Cáceres,134,Navezuelas,646,330,316
10,Cáceres,135,Nuñomoral,1311,691,620
10,Cáceres,136,Oliva de Plasencia,310,178,132
10,Cáceres,137,Palomero,411,220,191
10,Cáceres,138,Pasarón de la Vera,641,309,332
10,Cáceres,139,Pedroso de Acim,85,47,38
10,Cáceres,140,Peraleda de la Mata,1390,708,682
10,Cáceres,141,Peraleda de San Román,277,143,134
10,Cáceres,142,Perales del Puerto,941,483,458
10,Cáceres,143,Pescueza,151,66,85
10,Cáceres,144,"Pesga, La",1065,554,511
10,Cáceres,145,Piedras Albas,149,70,79
10,Cáceres,146,Pinofranqueado,1748,928,820
10,Cáceres,147,Piornal,1530,771,759
10,Cáceres,148,Plasencia,40141,19421,20720
10,Cáceres,149,Plasenzuela,487,244,243
10,Cáceres,150,Portaje,362,187,175
10,Cáceres,151,Portezuelo,225,118,107
10,Cáceres,152,Pozuelo de Zarzón,471,237,234
10,Cáceres,905,Pueblonuevo de Miramontes,814,417,397
10,Cáceres,153,Puerto de Santa Cruz,323,168,155
10,Cáceres,154,Rebollar,213,107,106
10,Cáceres,155,Riolobos,1248,649,599
10,Cáceres,156,Robledillo de Gata,91,49,42
10,Cáceres,157,Robledillo de la Vera,272,143,129
10,Cáceres,158,Robledillo de Trujillo,369,186,183
10,Cáceres,159,Robledollano,315,174,141
10,Cáceres,160,Romangordo,259,127,132
10,Cáceres,901,Rosalejo,1362,715,647
10,Cáceres,161,Ruanes,65,36,29
10,Cáceres,162,Salorino,581,302,279
10,Cáceres,163,Salvatierra de Santiago,323,165,158
10,Cáceres,164,San Martín de Trevejo,788,388,400
10,Cáceres,165,Santa Ana,249,136,113
10,Cáceres,166,Santa Cruz de la Sierra,324,161,163
10,Cáceres,167,Santa Cruz de Paniagua,315,174,141
10,Cáceres,168,Santa Marta de Magasca,271,138,133
10,Cáceres,169,Santiago de Alcántara,522,256,266
10,Cáceres,170,Santiago del Campo,259,132,127
10,Cáceres,171,Santibáñez el Alto,382,205,177
10,Cáceres,172,Santibáñez el Bajo,763,392,371
10,Cáceres,173,Saucedilla,858,452,406
10,Cáceres,174,Segura de Toro,187,91,96
10,Cáceres,175,Serradilla,1568,790,778
10,Cáceres,176,Serrejón,420,220,200
10,Cáceres,177,Sierra de Fuentes,1996,1015,981
10,Cáceres,178,Talaván,832,432,400
10,Cáceres,179,Talaveruela de la Vera,306,163,143
10,Cáceres,180,Talayuela,7345,3968,3377
10,Cáceres,181,Tejeda de Tiétar,806,430,376
10,Cáceres,904,Tiétar,921,485,436
10,Cáceres,182,Toril,164,104,60
10,Cáceres,183,Tornavacas,1143,608,535
10,Cáceres,184,"Torno, El",884,463,421
10,Cáceres,187,Torre de Don Miguel,461,246,215
10,Cáceres,188,Torre de Santa María,532,267,265
10,Cáceres,185,Torrecilla de los Ángeles,622,330,292
10,Cáceres,186,Torrecillas de la Tiesa,1071,543,528
10,Cáceres,190,Torrejón el Rubio,571,286,285
10,Cáceres,189,Torrejoncillo,2975,1451,1524
10,Cáceres,191,Torremenga,610,324,286
10,Cáceres,192,Torremocha,840,420,420
10,Cáceres,193,Torreorgaz,1677,816,861
10,Cáceres,194,Torrequemada,570,272,298
10,Cáceres,195,Trujillo,9193,4477,4716
10,Cáceres,196,Valdastillas,334,175,159
10,Cáceres,197,Valdecañas de Tajo,99,55,44
10,Cáceres,198,Valdefuentes,1230,605,625
10,Cáceres,199,Valdehúncar,178,96,82
10,Cáceres,200,Valdelacasa de Tajo,361,188,173
10,Cáceres,201,Valdemorales,197,97,100
10,Cáceres,202,Valdeobispo,664,322,342
10,Cáceres,203,Valencia de Alcántara,5439,2662,2777
10,Cáceres,204,Valverde de la Vera,460,233,227
10,Cáceres,205,Valverde del Fresno,2349,1183,1166
10,Cáceres,902,Vegaviana,868,446,422
10,Cáceres,206,Viandar de la Vera,233,122,111
10,Cáceres,207,Villa del Campo,502,239,263
10,Cáceres,208,Villa del Rey,136,69,67
10,Cáceres,209,Villamesías,260,135,125
10,Cáceres,210,Villamiel,426,214,212
10,Cáceres,211,Villanueva de la Sierra,433,217,216
10,Cáceres,212,Villanueva de la Vera,2046,1027,1019
10,Cáceres,214,Villar de Plasencia,234,125,109
10,Cáceres,213,Villar del Pedroso,618,317,301
10,Cáceres,215,Villasbuenas de Gata,341,170,171
10,Cáceres,216,Zarza de Granadilla,1823,917,906
10,Cáceres,217,Zarza de Montánchez,550,275,275
10,Cáceres,218,Zarza la Mayor,1258,629,629
10,Cáceres,219,Zorita,1377,697,680
11,Cádiz,1,Alcalá de los Gazules,5242,2701,2541
11,Cádiz,2,Alcalá del Valle,5123,2572,2551
11,Cádiz,3,Algar,1413,730,683
11,Cádiz,4,Algeciras,121414,59852,61562
11,Cádiz,5,Algodonales,5590,2842,2748
11,Cádiz,6,Arcos de la Frontera,30741,15346,15395
11,Cádiz,7,Barbate,22551,11305,11246
11,Cádiz,8,"Barrios, Los",23513,11745,11768
11,Cádiz,901,Benalup-Casas Viejas,6969,3546,3423
11,Cádiz,9,Benaocaz,680,364,316
11,Cádiz,10,Bornos,7750,3882,3868
11,Cádiz,11,"Bosque, El",2167,1097,1070
11,Cádiz,12,Cádiz,116979,55374,61605
11,Cádiz,13,Castellar de la Frontera,3013,1506,1507
11,Cádiz,15,Chiclana de la Frontera,83831,41968,41863
11,Cádiz,16,Chipiona,19068,9564,9504
11,Cádiz,14,Conil de la Frontera,22427,11304,11123
11,Cádiz,17,Espera,3903,1964,1939
11,Cádiz,18,"Gastor, El",1726,892,834
11,Cádiz,19,Grazalema,2053,1018,1035
11,Cádiz,20,Jerez de la Frontera,212879,104084,108795
11,Cádiz,21,Jimena de la Frontera,9773,5045,4728
11,Cádiz,22,"Línea de la Concepción, La",62940,30895,32045
11,Cádiz,23,Medina-Sidonia,11658,5934,5724
11,Cádiz,24,Olvera,8124,3983,4141
11,Cádiz,25,Paterna de Rivera,5530,2856,2674
11,Cádiz,26,Prado del Rey,5636,2815,2821
11,Cádiz,27,"Puerto de Santa María, El",88364,43326,45038
11,Cádiz,28,Puerto Real,41650,20922,20728
11,Cádiz,29,Puerto Serrano,6996,3537,3459
11,Cádiz,30,Rota,28848,14403,14445
11,Cádiz,31,San Fernando,95174,46602,48572
11,Cádiz,902,San José del Valle,4402,2255,2147
11,Cádiz,33,San Roque,30472,15209,15263
11,Cádiz,32,Sanlúcar de Barrameda,68037,33868,34169
11,Cádiz,34,Setenil de las Bodegas,2732,1401,1331
11,Cádiz,35,Tarifa,18169,9151,9018
11,Cádiz,36,Torre Alháquime,804,401,403
11,Cádiz,37,Trebujena,7054,3522,3532
11,Cádiz,38,Ubrique,16615,8207,8408
11,Cádiz,39,Vejer de la Frontera,12739,6349,6390
11,Cádiz,40,Villaluenga del Rosario,438,229,209
11,Cádiz,41,Villamartín,12127,6078,6049
11,Cádiz,42,Zahara,1400,713,687
39,Cantabria,1,Alfoz de Lloredo,2408,1233,1175
39,Cantabria,2,Ampuero,4219,2139,2080
39,Cantabria,3,Anievas,279,149,130
39,Cantabria,4,Arenas de Iguña,1676,864,812
39,Cantabria,5,Argoños,1723,885,838
39,Cantabria,6,Arnuero,2108,1074,1034
39,Cantabria,7,Arredondo,470,267,203
39,Cantabria,8,"Astillero, El",18108,8840,9268
39,Cantabria,9,Bárcena de Cicero,4186,2178,2008
39,Cantabria,10,Bárcena de Pie de Concha,680,343,337
39,Cantabria,11,Bareyo,1972,1005,967
39,Cantabria,12,Cabezón de la Sal,8349,4021,4328
39,Cantabria,13,Cabezón de Liébana,592,338,254
39,Cantabria,14,Cabuérniga,999,546,453
39,Cantabria,15,Camaleño,946,535,411
39,Cantabria,16,Camargo,30263,14811,15452
39,Cantabria,27,Campoo de Enmedio,3750,1925,1825
39,Cantabria,17,Campoo de Yuso,668,360,308
39,Cantabria,18,Cartes,5778,2901,2877
39,Cantabria,19,Castañeda,2809,1443,1366
39,Cantabria,20,Castro-Urdiales,31977,15843,16134
39,Cantabria,21,Cieza,539,274,265
39,Cantabria,22,Cillorigo de Liébana,1337,695,642
39,Cantabria,23,Colindres,8453,4145,4308
39,Cantabria,24,Comillas,2156,1021,1135
39,Cantabria,25,"Corrales de Buelna, Los",10910,5331,5579
39,Cantabria,26,Corvera de Toranzo,2041,1038,1003
39,Cantabria,28,Entrambasaguas,5090,2571,2519
39,Cantabria,29,Escalante,771,399,372
39,Cantabria,30,Guriezo,2347,1204,1143
39,Cantabria,31,Hazas de Cesto,1541,773,768
39,Cantabria,32,Hermandad de Campoo de Suso,1627,899,728
39,Cantabria,33,Herrerías,609,344,265
39,Cantabria,34,Lamasón,287,182,105
39,Cantabria,35,Laredo,11148,5301,5847
39,Cantabria,36,Liendo,1194,613,581
39,Cantabria,37,Liérganes,2370,1169,1201
39,Cantabria,38,Limpias,1867,932,935
39,Cantabria,39,Luena,601,329,272
39,Cantabria,40,Marina de Cudeyo,5118,2550,2568
39,Cantabria,41,Mazcuerras,2120,1086,1034
39,Cantabria,42,Medio Cudeyo,7520,3632,3888
39,Cantabria,43,Meruelo,1982,995,987
39,Cantabria,44,Miengo,4713,2380,2333
39,Cantabria,45,Miera,389,201,188
39,Cantabria,46,Molledo,1544,774,770
39,Cantabria,47,Noja,2539,1268,1271
39,Cantabria,48,Penagos,2108,1068,1040
39,Cantabria,49,Peñarrubia,321,176,145
39,Cantabria,50,Pesaguero,285,165,120
39,Cantabria,51,Pesquera,68,43,25
39,Cantabria,52,Piélagos,25223,12484,12739
39,Cantabria,53,Polaciones,238,151,87
39,Cantabria,54,Polanco,5845,2891,2954
39,Cantabria,55,Potes,1350,653,697
39,Cantabria,56,Puente Viesgo,2868,1460,1408
39,Cantabria,57,Ramales de la Victoria,2881,1446,1435
39,Cantabria,58,Rasines,952,493,459
39,Cantabria,59,Reinosa,9095,4266,4829
39,Cantabria,60,Reocín,8381,4124,4257
39,Cantabria,61,Ribamontán al Mar,4447,2243,2204
39,Cantabria,62,Ribamontán al Monte,2257,1170,1087
39,Cantabria,63,Rionansa,1038,584,454
39,Cantabria,64,Riotuerto,1609,767,842
39,Cantabria,65,"Rozas de Valdearroyo, Las",268,154,114
39,Cantabria,66,Ruente,1026,552,474
39,Cantabria,67,Ruesga,872,473,399
39,Cantabria,68,Ruiloba,732,373,359
39,Cantabria,69,San Felices de Buelna,2387,1198,1189
39,Cantabria,70,San Miguel de Aguayo,147,76,71
39,Cantabria,71,San Pedro del Romeral,466,260,206
39,Cantabria,72,San Roque de Riomiera,370,220,150
39,Cantabria,80,San Vicente de la Barquera,4158,2062,2096
39,Cantabria,73,Santa Cruz de Bezana,12964,6383,6581
39,Cantabria,74,Santa María de Cayón,9060,4554,4506
39,Cantabria,75,Santander,172044,79371,92673
39,Cantabria,76,Santillana del Mar,4172,2051,2121
39,Cantabria,77,Santiurde de Reinosa,257,151,106
39,Cantabria,78,Santiurde de Toranzo,1623,845,778
39,Cantabria,79,Santoña,11050,5388,5662
39,Cantabria,81,Saro,512,267,245
39,Cantabria,82,Selaya,1891,947,944
39,Cantabria,83,Soba,1193,662,531
39,Cantabria,84,Solórzano,1050,557,493
39,Cantabria,85,Suances,8716,4294,4422
39,Cantabria,86,"Tojos, Los",400,233,167
39,Cantabria,87,Torrelavega,51687,24341,27346
39,Cantabria,88,Tresviso,64,44,20
39,Cantabria,89,Tudanca,140,98,42
39,Cantabria,90,Udías,925,473,452
39,Cantabria,95,Val de San Vicente,2772,1441,1331
39,Cantabria,91,Valdáliga,2191,1137,1054
39,Cantabria,92,Valdeolea,967,512,455
39,Cantabria,93,Valdeprado del Río,316,181,135
39,Cantabria,94,Valderredible,974,549,425
39,Cantabria,101,Valle de Villaverde,286,155,131
39,Cantabria,96,Vega de Liébana,745,389,356
39,Cantabria,97,Vega de Pas,775,406,369
39,Cantabria,98,Villacarriedo,1604,840,764
39,Cantabria,99,Villaescusa,3912,1941,1971
39,Cantabria,100,Villafufre,1029,532,497
39,Cantabria,102,Voto,2745,1464,1281
12,Castellón/Castelló,2,Aín,125,66,59
12,Castellón/Castelló,3,Albocàsser,1234,615,619
12,Castellón/Castelló,4,Alcalà de Xivert,6679,3440,3239
12,Castellón/Castelló,5,"Alcora, l'",10430,5262,5168
12,Castellón/Castelló,6,Alcudia de Veo,201,108,93
12,Castellón/Castelló,7,Alfondeguilla,862,438,424
12,Castellón/Castelló,8,Algimia de Almonacid,259,146,113
12,Castellón/Castelló,9,Almassora,25831,12984,12847
12,Castellón/Castelló,10,Almedíjar,256,141,115
12,Castellón/Castelló,11,Almenara,5900,2958,2942
12,Castellón/Castelló,901,"Alqueries, les/Alquerías del Niño Perdido",4460,2220,2240
12,Castellón/Castelló,12,Altura,3509,1791,1718
12,Castellón/Castelló,13,Arañuel,146,72,74
12,Castellón/Castelló,14,Ares del Maestrat,190,107,83
12,Castellón/Castelló,15,Argelita,113,69,44
12,Castellón/Castelló,16,Artana,1958,992,966
12,Castellón/Castelló,1,Atzeneta del Maestrat,1271,643,628
12,Castellón/Castelló,17,Ayódar,164,88,76
12,Castellón/Castelló,18,Azuébar,324,172,152
12,Castellón/Castelló,20,Barracas,169,93,76
12,Castellón/Castelló,22,Bejís,373,214,159
12,Castellón/Castelló,24,Benafer,156,82,74
12,Castellón/Castelló,25,Benafigos,149,84,65
12,Castellón/Castelló,26,Benassal,1084,560,524
12,Castellón/Castelló,27,Benicarló,26744,13326,13418
12,Castellón/Castelló,28,Benicasim/Benicàssim,18055,9015,9040
12,Castellón/Castelló,29,Benlloch,1036,524,512
12,Castellón/Castelló,21,Betxí,5709,2815,2894
12,Castellón/Castelló,32,Borriana/Burriana,34544,17121,17423
12,Castellón/Castelló,31,Borriol,5322,2696,2626
12,Castellón/Castelló,33,Cabanes,2889,1468,1421
12,Castellón/Castelló,34,Càlig,1945,995,950
12,Castellón/Castelló,36,Canet lo Roig,696,338,358
12,Castellón/Castelló,37,Castell de Cabres,19,10,9
12,Castellón/Castelló,38,Castellfort,192,104,88
12,Castellón/Castelló,39,Castellnovo,946,479,467
12,Castellón/Castelló,40,Castellón de la Plana/Castelló de la Plana,170888,82695,88193
12,Castellón/Castelló,41,Castillo de Villamalefa,101,66,35
12,Castellón/Castelló,42,Catí,742,370,372
12,Castellón/Castelló,43,Caudiel,647,334,313
12,Castellón/Castelló,44,Cervera del Maestre,599,292,307
12,Castellón/Castelló,53,Chilches/Xilxes,2670,1377,1293
12,Castellón/Castelló,55,Chodos/Xodos,113,66,47
12,Castellón/Castelló,56,Chóvar,297,155,142
12,Castellón/Castelló,45,Cinctorres,399,193,206
12,Castellón/Castelló,46,Cirat,206,113,93
12,Castellón/Castelló,48,Cortes de Arenoso,317,173,144
12,Castellón/Castelló,49,Costur,511,272,239
12,Castellón/Castelló,50,"Coves de Vinromà, les",1822,914,908
12,Castellón/Castelló,51,Culla,504,261,243
12,Castellón/Castelló,57,Eslida,776,397,379
12,Castellón/Castelló,58,Espadilla,72,41,31
12,Castellón/Castelló,59,Fanzara,276,139,137
12,Castellón/Castelló,60,Figueroles,525,266,259
12,Castellón/Castelló,61,Forcall,453,223,230
12,Castellón/Castelló,63,Fuente la Reina,49,27,22
12,Castellón/Castelló,64,Fuentes de Ayódar,94,53,41
12,Castellón/Castelló,65,Gaibiel,193,103,90
12,Castellón/Castelló,67,Geldo,633,314,319
12,Castellón/Castelló,68,Herbés,49,27,22
12,Castellón/Castelló,69,Higueras,62,37,25
12,Castellón/Castelló,70,"Jana, la",666,334,332
12,Castellón/Castelló,71,Jérica,1553,803,750
12,Castellón/Castelló,74,"Llosa, la",940,467,473
12,Castellón/Castelló,72,Llucena/Lucena del Cid,1319,664,655
12,Castellón/Castelló,73,Ludiente,155,86,69
12,Castellón/Castelló,75,"Mata de Morella, la",162,85,77
12,Castellón/Castelló,76,Matet,84,43,41
12,Castellón/Castelló,77,Moncofa,6278,3257,3021
12,Castellón/Castelló,78,Montán,359,172,187
12,Castellón/Castelló,79,Montanejos,548,286,262
12,Castellón/Castelló,80,Morella,2437,1197,1240
12,Castellón/Castelló,81,Navajas,712,373,339
12,Castellón/Castelló,82,Nules,13170,6584,6586
12,Castellón/Castelló,83,Olocau del Rey,117,65,52
12,Castellón/Castelló,84,Onda,24850,12464,12386
12,Castellón/Castelló,85,Oropesa del Mar/Orpesa,8830,4544,4286
12,Castellón/Castelló,87,Palanques,31,17,14
12,Castellón/Castelló,88,Pavías,62,39,23
12,Castellón/Castelló,89,Peníscola/Peñíscola,7447,3747,3700
12,Castellón/Castelló,90,Pina de Montalgrao,114,59,55
12,Castellón/Castelló,93,"Pobla de Benifassà, la",197,110,87
12,Castellón/Castelló,94,"Pobla Tornesa, la",1208,628,580
12,Castellón/Castelló,91,Portell de Morella,197,97,100
12,Castellón/Castelló,92,Puebla de Arenoso,144,77,67
12,Castellón/Castelló,95,Ribesalbes,1180,605,575
12,Castellón/Castelló,96,Rossell,952,500,452
12,Castellón/Castelló,97,Sacañet,59,39,20
12,Castellón/Castelló,98,"Salzadella, la",729,366,363
12,Castellón/Castelló,101,San Rafael del Río,462,230,232
12,Castellón/Castelló,902,Sant Joan de Moró,3099,1618,1481
12,Castellón/Castelló,99,Sant Jordi/San Jorge,935,486,449
12,Castellón/Castelló,100,Sant Mateu,1974,973,1001
12,Castellón/Castelló,102,Santa Magdalena de Pulpis,761,407,354
12,Castellón/Castelló,104,Segorbe,8878,4351,4527
12,Castellón/Castelló,103,"Serratella, la",101,49,52
12,Castellón/Castelló,105,Sierra Engarcerán,1023,542,481
12,Castellón/Castelló,106,Soneja,1439,702,737
12,Castellón/Castelló,107,Sot de Ferrer,428,220,208
12,Castellón/Castelló,108,Sueras/Suera,520,270,250
12,Castellón/Castelló,109,Tales,814,408,406
12,Castellón/Castelló,110,Teresa,249,131,118
12,Castellón/Castelló,111,Tírig,435,220,215
12,Castellón/Castelló,112,Todolella,138,81,57
12,Castellón/Castelló,113,Toga,100,54,46
12,Castellón/Castelló,114,Torás,229,120,109
12,Castellón/Castelló,115,"Toro, El",253,138,115
12,Castellón/Castelló,116,Torralba del Pinar,54,26,28
12,Castellón/Castelló,119,"Torre d'En Besora, la",157,87,70
12,Castellón/Castelló,120,"Torre d'en Doménec, la",191,96,95
12,Castellón/Castelló,117,Torreblanca,5461,2754,2707
12,Castellón/Castelló,118,Torrechiva,74,45,29
12,Castellón/Castelló,121,Traiguera,1375,692,683
12,Castellón/Castelló,122,"Useras/Useres, les",966,503,463
12,Castellón/Castelló,124,Vall d'Alba,2817,1471,1346
12,Castellón/Castelló,125,Vall de Almonacid,281,140,141
12,Castellón/Castelló,126,"Vall d'Uixó, la",31552,15577,15975
12,Castellón/Castelló,123,Vallat,49,23,26
12,Castellón/Castelló,127,Vallibona,75,42,33
12,Castellón/Castelló,128,Vilafamés,1833,982,851
12,Castellón/Castelló,132,Vilanova d'Alcolea,575,298,277
12,Castellón/Castelló,134,Vilar de Canes,172,90,82
12,Castellón/Castelló,135,Vila-real,50577,25125,25452
12,Castellón/Castelló,136,"Vilavella, la",3226,1611,1615
12,Castellón/Castelló,129,Villafranca del Cid/Vilafranca,2227,1102,1125
12,Castellón/Castelló,130,Villahermosa del Río,462,252,210
12,Castellón/Castelló,131,Villamalur,63,38,25
12,Castellón/Castelló,133,Villanueva de Viver,66,34,32
12,Castellón/Castelló,137,Villores,42,23,19
12,Castellón/Castelló,138,Vinaròs,28438,14011,14427
12,Castellón/Castelló,139,Vistabella del Maestrat,342,190,152
12,Castellón/Castelló,140,Viver,1538,796,742
12,Castellón/Castelló,52,Xert,725,344,381
12,Castellón/Castelló,141,Zorita del Maestrazgo,112,58,54
12,Castellón/Castelló,142,Zucaina,172,97,75
13,Ciudad Real,1,Abenójar,1395,715,680
13,Ciudad Real,2,Agudo,1687,846,841
13,Ciudad Real,3,Alamillo,507,260,247
13,Ciudad Real,4,Albaladejo,1185,615,570
13,Ciudad Real,5,Alcázar de San Juan,30686,14982,15704
13,Ciudad Real,6,Alcoba,602,302,300
13,Ciudad Real,7,Alcolea de Calatrava,1455,739,716
13,Ciudad Real,8,Alcubillas,485,247,238
13,Ciudad Real,9,Aldea del Rey,1660,844,816
13,Ciudad Real,10,Alhambra,1000,506,494
13,Ciudad Real,11,Almadén,5461,2614,2847
13,Ciudad Real,12,Almadenejos,417,218,199
13,Ciudad Real,13,Almagro,8922,4388,4534
13,Ciudad Real,14,Almedina,526,277,249
13,Ciudad Real,15,Almodóvar del Campo,6139,3084,3055
13,Ciudad Real,16,Almuradiel,799,394,405
13,Ciudad Real,17,Anchuras,327,164,163
13,Ciudad Real,903,Arenales de San Gregorio,595,308,287
13,Ciudad Real,18,Arenas de San Juan,1043,536,507
13,Ciudad Real,19,Argamasilla de Alba,6901,3466,3435
13,Ciudad Real,20,Argamasilla de Calatrava,5921,3000,2921
13,Ciudad Real,21,Arroba de los Montes,449,242,207
13,Ciudad Real,22,Ballesteros de Calatrava,387,193,194
13,Ciudad Real,23,Bolaños de Calatrava,11884,6033,5851
13,Ciudad Real,24,Brazatortas,1000,520,480
13,Ciudad Real,25,Cabezarados,311,168,143
13,Ciudad Real,26,Cabezarrubias del Puerto,487,255,232
13,Ciudad Real,27,Calzada de Calatrava,3802,1892,1910
13,Ciudad Real,28,Campo de Criptana,13597,6780,6817
13,Ciudad Real,29,Cañada de Calatrava,92,56,36
13,Ciudad Real,30,Caracuel de Calatrava,139,83,56
13,Ciudad Real,31,Carrión de Calatrava,3080,1544,1536
13,Ciudad Real,32,Carrizosa,1225,627,598
13,Ciudad Real,33,Castellar de Santiago,1918,965,953
13,Ciudad Real,38,Chillón,1831,888,943
13,Ciudad Real,34,Ciudad Real,74743,35421,39322
13,Ciudad Real,35,Corral de Calatrava,1129,554,575
13,Ciudad Real,36,"Cortijos, Los",882,468,414
13,Ciudad Real,37,Cózar,973,483,490
13,Ciudad Real,39,Daimiel,18051,9004,9047
13,Ciudad Real,40,Fernán Caballero,1022,504,518
13,Ciudad Real,41,Fontanarejo,261,142,119
13,Ciudad Real,42,Fuencaliente,1031,546,485
13,Ciudad Real,43,Fuenllana,217,112,105
13,Ciudad Real,44,Fuente el Fresno,3253,1677,1576
13,Ciudad Real,45,Granátula de Calatrava,731,359,372
13,Ciudad Real,46,Guadalmez,731,362,369
13,Ciudad Real,47,Herencia,8425,4303,4122
13,Ciudad Real,48,Hinojosas de Calatrava,532,271,261
13,Ciudad Real,49,Horcajo de los Montes,903,457,446
13,Ciudad Real,50,"Labores, Las",569,282,287
13,Ciudad Real,904,Llanos del Caudillo,719,354,365
13,Ciudad Real,51,Luciana,374,202,172
13,Ciudad Real,52,Malagón,8129,4021,4108
13,Ciudad Real,53,Manzanares,18043,8930,9113
13,Ciudad Real,54,Membrilla,6016,3028,2988
13,Ciudad Real,55,Mestanza,688,346,342
13,Ciudad Real,56,Miguelturra,15316,7705,7611
13,Ciudad Real,57,Montiel,1330,701,629
13,Ciudad Real,58,Moral de Calatrava,5279,2672,2607
13,Ciudad Real,59,Navalpino,219,113,106
13,Ciudad Real,60,Navas de Estena,223,123,100
13,Ciudad Real,61,Pedro Muñoz,7385,3707,3678
13,Ciudad Real,62,Picón,654,340,314
13,Ciudad Real,63,Piedrabuena,4459,2271,2188
13,Ciudad Real,64,Poblete,2571,1320,1251
13,Ciudad Real,65,Porzuna,3571,1825,1746
13,Ciudad Real,66,Pozuelo de Calatrava,3443,1760,1683
13,Ciudad Real,67,"Pozuelos de Calatrava, Los",370,198,172
13,Ciudad Real,68,Puebla de Don Rodrigo,1200,658,542
13,Ciudad Real,69,Puebla del Príncipe,701,357,344
13,Ciudad Real,70,Puerto Lápice,937,463,474
13,Ciudad Real,71,Puertollano,47881,23165,24716
13,Ciudad Real,72,Retuerta del Bullaque,978,539,439
13,Ciudad Real,901,"Robledo, El",1111,588,523
13,Ciudad Real,902,Ruidera,548,276,272
13,Ciudad Real,73,Saceruela,577,307,270
13,Ciudad Real,74,San Carlos del Valle,1128,581,547
13,Ciudad Real,75,San Lorenzo de Calatrava,213,114,99
13,Ciudad Real,76,Santa Cruz de los Cáñamos,523,254,269
13,Ciudad Real,77,Santa Cruz de Mudela,4154,2060,2094
13,Ciudad Real,78,Socuéllamos,12268,6184,6084
13,Ciudad Real,80,Solana del Pino,333,176,157
13,Ciudad Real,79,"Solana, La",15523,7832,7691
13,Ciudad Real,81,Terrinches,697,360,337
13,Ciudad Real,82,Tomelloso,36091,17867,18224
13,Ciudad Real,83,Torralba de Calatrava,2959,1479,1480
13,Ciudad Real,84,Torre de Juan Abad,1018,495,523
13,Ciudad Real,85,Torrenueva,2752,1395,1357
13,Ciudad Real,86,Valdemanco del Esteras,169,88,81
13,Ciudad Real,87,Valdepeñas,30210,14762,15448
13,Ciudad Real,88,Valenzuela de Calatrava,692,324,368
13,Ciudad Real,89,Villahermosa,1854,895,959
13,Ciudad Real,90,Villamanrique,1180,572,608
13,Ciudad Real,91,Villamayor de Calatrava,602,303,299
13,Ciudad Real,92,Villanueva de la Fuente,2123,1083,1040
13,Ciudad Real,93,Villanueva de los Infantes,5030,2477,2553
13,Ciudad Real,94,Villanueva de San Carlos,295,159,136
13,Ciudad Real,95,Villar del Pozo,86,46,40
13,Ciudad Real,96,Villarrubia de los Ojos,9902,4915,4987
13,Ciudad Real,97,Villarta de San Juan,2845,1426,1419
13,Ciudad Real,98,Viso del Marqués,2363,1144,1219
14,Córdoba,1,Adamuz,4185,2155,2030
14,Córdoba,2,Aguilar de la Frontera,13438,6738,6700
14,Córdoba,3,Alcaracejos,1473,713,760
14,Córdoba,4,Almedinilla,2409,1204,1205
14,Córdoba,5,Almodóvar del Río,7964,3987,3977
14,Córdoba,6,Añora,1524,754,770
14,Córdoba,7,Baena,19338,9868,9470
14,Córdoba,8,Belalcázar,3273,1571,1702
14,Córdoba,9,Belmez,2964,1435,1529
14,Córdoba,10,Benamejí,4975,2492,2483
14,Córdoba,11,"Blázquez, Los",681,351,330
14,Córdoba,12,Bujalance,7537,3752,3785
14,Córdoba,13,Cabra,20417,9961,10456
14,Córdoba,14,Cañete de las Torres,2969,1526,1443
14,Córdoba,15,Carcabuey,2454,1251,1203
14,Córdoba,16,Cardeña,1503,744,759
14,Córdoba,17,"Carlota, La",14067,7026,7041
14,Córdoba,18,"Carpio, El",4457,2204,2253
14,Córdoba,19,Castro del Río,7834,3889,3945
14,Córdoba,20,Conquista,401,196,205
14,Córdoba,21,Córdoba,325708,156417,169291
14,Córdoba,22,Doña Mencía,4684,2282,2402
14,Córdoba,23,Dos Torres,2416,1199,1217
14,Córdoba,24,Encinas Reales,2285,1130,1155
14,Córdoba,25,Espejo,3333,1673,1660
14,Córdoba,26,Espiel,2438,1227,1211
14,Córdoba,27,Fernán-Núñez,9668,4856,4812
14,Córdoba,28,Fuente la Lancha,350,183,167
14,Córdoba,29,Fuente Obejuna,4651,2398,2253
14,Córdoba,30,Fuente Palmera,10817,5425,5392
14,Córdoba,31,Fuente-Tójar,680,327,353
14,Córdoba,32,"Granjuela, La",456,233,223
14,Córdoba,33,Guadalcázar,1578,788,790
14,Córdoba,34,"Guijo, El",353,182,171
14,Córdoba,35,Hinojosa del Duque,6868,3365,3503
14,Córdoba,36,Hornachuelos,4541,2266,2275
14,Córdoba,37,Iznájar,4343,2175,2168
14,Córdoba,38,Lucena,42530,21212,21318
14,Córdoba,39,Luque,3037,1532,1505
14,Córdoba,40,Montalbán de Córdoba,4429,2202,2227
14,Córdoba,41,Montemayor,3874,1947,1927
14,Córdoba,42,Montilla,23031,11423,11608
14,Córdoba,43,Montoro,9436,4641,4795
14,Córdoba,44,Monturque,1964,976,988
14,Córdoba,45,Moriles,3726,1870,1856
14,Córdoba,46,Nueva Carteya,5393,2733,2660
14,Córdoba,47,Obejo,1990,1043,947
14,Córdoba,48,Palenciana,1481,743,738
14,Córdoba,49,Palma del Río,21159,10540,10619
14,Córdoba,50,Pedro Abad,2834,1434,1400
14,Córdoba,51,Pedroche,1529,738,791
14,Córdoba,52,Peñarroya-Pueblonuevo,10870,5245,5625
14,Córdoba,53,Posadas,7343,3648,3695
14,Córdoba,54,Pozoblanco,17222,8382,8840
14,Córdoba,55,Priego de Córdoba,22585,11008,11577
14,Córdoba,56,Puente Genil,30241,15058,15183
14,Córdoba,57,"Rambla, La",7508,3731,3777
14,Córdoba,58,Rute,9857,4906,4951
14,Córdoba,59,San Sebastián de los Ballesteros,814,404,410
14,Córdoba,61,Santa Eufemia,768,384,384
14,Córdoba,60,Santaella,6014,3039,2975
14,Córdoba,62,Torrecampo,1063,517,546
14,Córdoba,63,Valenzuela,1157,578,579
14,Córdoba,64,Valsequillo,368,178,190
14,Córdoba,65,"Victoria, La",2284,1138,1146
14,Córdoba,66,Villa del Río,7200,3603,3597
14,Córdoba,67,Villafranca de Córdoba,4861,2481,2380
14,Córdoba,68,Villaharta,643,314,329
14,Córdoba,69,Villanueva de Córdoba,8774,4340,4434
14,Córdoba,70,Villanueva del Duque,1494,753,741
14,Córdoba,71,Villanueva del Rey,1068,520,548
14,Córdoba,72,Villaralto,1154,577,577
14,Córdoba,73,Villaviciosa de Córdoba,3298,1700,1598
14,Córdoba,74,"Viso, El",2568,1278,1290
14,Córdoba,75,Zuheros,641,326,315
15,"Coruña, A",1,Abegondo,5454,2684,2770
15,"Coruña, A",2,Ames,31278,15015,16263
15,"Coruña, A",3,Aranga,1894,984,910
15,"Coruña, A",4,Ares,5671,2798,2873
15,"Coruña, A",5,Arteixo,31917,15853,16064
15,"Coruña, A",6,Arzúa,6053,3010,3043
15,"Coruña, A",7,"Baña, A",3505,1659,1846
15,"Coruña, A",8,Bergondo,6602,3222,3380
15,"Coruña, A",9,Betanzos,12916,6131,6785
15,"Coruña, A",10,Boimorto,2022,1026,996
15,"Coruña, A",11,Boiro,18844,9191,9653
15,"Coruña, A",12,Boqueixón,4215,2069,2146
15,"Coruña, A",13,Brión,7748,3727,4021
15,"Coruña, A",14,Cabana de Bergantiños,4337,2091,2246
15,"Coruña, A",15,Cabanas,3318,1628,1690
15,"Coruña, A",16,Camariñas,5322,2605,2717
15,"Coruña, A",17,Cambre,24603,12027,12576
15,"Coruña, A",18,"Capela, A",1238,617,621
15,"Coruña, A",19,Carballo,31261,15299,15962
15,"Coruña, A",901,Cariño,3945,1959,1986
15,"Coruña, A",20,Carnota,4031,1915,2116
15,"Coruña, A",21,Carral,6294,3096,3198
15,"Coruña, A",22,Cedeira,6794,3373,3421
15,"Coruña, A",23,Cee,7576,3627,3949
15,"Coruña, A",24,Cerceda,5023,2478,2545
15,"Coruña, A",25,Cerdido,1126,551,575
15,"Coruña, A",27,Coirós,1824,896,928
15,"Coruña, A",28,Corcubión,1578,764,814
15,"Coruña, A",29,Coristanco,6177,2955,3222
15,"Coruña, A",30,"Coruña, A",244850,113613,131237
15,"Coruña, A",31,Culleredo,30221,14586,15635
15,"Coruña, A",32,Curtis,3958,1979,1979
15,"Coruña, A",33,Dodro,2791,1357,1434
15,"Coruña, A",34,Dumbría,3040,1467,1573
15,"Coruña, A",35,Fene,13013,6214,6799
15,"Coruña, A",36,Ferrol,66799,31319,35480
15,"Coruña, A",37,Fisterra,4701,2375,2326
15,"Coruña, A",38,Frades,2385,1182,1203
15,"Coruña, A",39,Irixoa,1333,664,669
15,"Coruña, A",41,"Laracha, A",11302,5564,5738
15,"Coruña, A",40,Laxe,3084,1543,1541
15,"Coruña, A",42,Lousame,3386,1658,1728
15,"Coruña, A",43,Malpica de Bergantiños,5447,2646,2801
15,"Coruña, A",44,Mañón,1363,670,693
15,"Coruña, A",45,Mazaricos,3947,1887,2060
15,"Coruña, A",46,Melide,7443,3659,3784
15,"Coruña, A",47,Mesía,2582,1271,1311
15,"Coruña, A",48,Miño,6056,3024,3032
15,"Coruña, A",49,Moeche,1226,576,650
15,"Coruña, A",50,Monfero,1962,1014,948
15,"Coruña, A",51,Mugardos,5307,2582,2725
15,"Coruña, A",53,Muros,8695,4205,4490
15,"Coruña, A",52,Muxía,4736,2297,2439
15,"Coruña, A",54,Narón,39115,18891,20224
15,"Coruña, A",55,Neda,5112,2478,2634
15,"Coruña, A",56,Negreira,6877,3325,3552
15,"Coruña, A",57,Noia,14271,6839,7432
15,"Coruña, A",58,Oleiros,35559,17193,18366
15,"Coruña, A",59,Ordes,12632,6157,6475
15,"Coruña, A",60,Oroso,7452,3700,3752
15,"Coruña, A",61,Ortigueira,5804,2773,3031
15,"Coruña, A",62,Outes,6412,3081,3331
15,"Coruña, A",902,Oza-Cesuras,5155,2596,2559
15,"Coruña, A",64,Paderne,2419,1179,1240
15,"Coruña, A",65,Padrón,8386,4025,4361
15,"Coruña, A",66,"Pino, O",4656,2333,2323
15,"Coruña, A",67,"Pobra do Caramiñal, A",9390,4568,4822
15,"Coruña, A",68,Ponteceso,5565,2794,2771
15,"Coruña, A",69,Pontedeume,7884,3775,4109
15,"Coruña, A",70,"Pontes de García Rodríguez, As",10237,4999,5238
15,"Coruña, A",71,Porto do Son,9243,4596,4647
15,"Coruña, A",72,Rianxo,11104,5421,5683
15,"Coruña, A",73,Ribeira,27067,13355,13712
15,"Coruña, A",74,Rois,4564,2177,2387
15,"Coruña, A",75,Sada,15495,7574,7921
15,"Coruña, A",76,San Sadurniño,2828,1401,1427
15,"Coruña, A",77,Santa Comba,9450,4576,4874
15,"Coruña, A",78,Santiago de Compostela,96405,44780,51625
15,"Coruña, A",79,Santiso,1610,825,785
15,"Coruña, A",80,Sobrado,1799,927,872
15,"Coruña, A",81,"Somozas, As",1103,553,550
15,"Coruña, A",82,Teo,18525,9115,9410
15,"Coruña, A",83,Toques,1151,599,552
15,"Coruña, A",84,Tordoia,3361,1581,1780
15,"Coruña, A",85,Touro,3620,1806,1814
15,"Coruña, A",86,Trazo,3148,1551,1597
15,"Coruña, A",88,Val do Dubra,3925,1884,2041
15,"Coruña, A",87,Valdoviño,6613,3209,3404
15,"Coruña, A",89,Vedra,5046,2485,2561
15,"Coruña, A",91,Vilarmaior,1231,629,602
15,"Coruña, A",90,Vilasantar,1225,645,580
15,"Coruña, A",92,Vimianzo,7138,3421,3717
15,"Coruña, A",93,Zas,4581,2219,2362
16,Cuenca,1,Abia de la Obispalía,64,39,25
16,Cuenca,2,"Acebrón, El",234,116,118
16,Cuenca,3,Alarcón,153,70,83
16,Cuenca,4,Albaladejo del Cuende,252,134,118
16,Cuenca,5,Albalate de las Nogueras,268,142,126
16,Cuenca,6,Albendea,125,58,67
16,Cuenca,7,"Alberca de Záncara, La",1590,802,788
16,Cuenca,8,Alcalá de la Vega,90,50,40
16,Cuenca,9,Alcantud,56,32,24
16,Cuenca,10,Alcázar del Rey,137,65,72
16,Cuenca,11,Alcohujate,30,16,14
16,Cuenca,12,Alconchel de la Estrella,90,52,38
16,Cuenca,13,Algarra,25,14,11
16,Cuenca,14,Aliaguilla,659,342,317
16,Cuenca,15,"Almarcha, La",375,208,167
16,Cuenca,16,Almendros,225,131,94
16,Cuenca,17,Almodóvar del Pinar,390,212,178
16,Cuenca,18,Almonacid del Marquesado,431,221,210
16,Cuenca,19,Altarejos,195,104,91
16,Cuenca,20,Arandilla del Arroyo,10,5,5
16,Cuenca,905,Arcas,1665,847,818
16,Cuenca,22,Arcos de la Sierra,85,49,36
16,Cuenca,24,Arguisuelas,147,81,66
16,Cuenca,25,Arrancacepas,26,14,12
16,Cuenca,26,Atalaya del Cañavate,95,48,47
16,Cuenca,27,Barajas de Melo,903,482,421
16,Cuenca,29,Barchín del Hoyo,87,54,33
16,Cuenca,30,Bascuñana de San Pedro,19,14,5
16,Cuenca,31,Beamud,35,19,16
16,Cuenca,32,Belinchón,328,169,159
16,Cuenca,33,Belmonte,1938,972,966
16,Cuenca,34,Belmontejo,165,95,70
16,Cuenca,35,Beteta,279,133,146
16,Cuenca,36,Boniches,144,69,75
16,Cuenca,38,Buciegas,40,26,14
16,Cuenca,39,Buenache de Alarcón,446,235,211
16,Cuenca,40,Buenache de la Sierra,90,53,37
16,Cuenca,41,Buendía,414,221,193
16,Cuenca,42,Campillo de Altobuey,1344,665,679
16,Cuenca,43,Campillos-Paravientos,113,63,50
16,Cuenca,44,Campillos-Sierra,40,19,21
16,Cuenca,901,Campos del Paraíso,767,380,387
16,Cuenca,45,Canalejas del Arroyo,219,121,98
16,Cuenca,46,Cañada del Hoyo,247,126,121
16,Cuenca,47,Cañada Juncosa,252,134,118
16,Cuenca,48,Cañamares,467,255,212
16,Cuenca,49,"Cañavate, El",151,80,71
16,Cuenca,50,Cañaveras,267,134,133
16,Cuenca,51,Cañaveruelas,138,71,67
16,Cuenca,52,Cañete,769,395,374
16,Cuenca,53,Cañizares,456,251,205
16,Cuenca,55,Carboneras de Guadazaón,785,404,381
16,Cuenca,56,Cardenete,495,265,230
16,Cuenca,57,Carrascosa,75,45,30
16,Cuenca,58,Carrascosa de Haro,111,57,54
16,Cuenca,60,Casas de Benítez,877,427,450
16,Cuenca,61,Casas de Fernando Alonso,1210,637,573
16,Cuenca,62,Casas de Garcimolina,27,18,9
16,Cuenca,63,Casas de Guijarro,111,59,52
16,Cuenca,64,Casas de Haro,836,441,395
16,Cuenca,65,Casas de los Pinos,459,229,230
16,Cuenca,66,Casasimarro,3072,1604,1468
16,Cuenca,67,Castejón,155,79,76
16,Cuenca,68,Castillejo de Iniesta,150,82,68
16,Cuenca,70,Castillejo-Sierra,30,16,14
16,Cuenca,72,Castillo de Garcimuñoz,139,80,59
16,Cuenca,71,Castillo-Albaráñez,21,10,11
16,Cuenca,73,Cervera del Llano,216,111,105
16,Cuenca,23,Chillarón de Cuenca,602,316,286
16,Cuenca,81,Chumillas,57,33,24
16,Cuenca,74,"Cierva, La",30,17,13
16,Cuenca,78,Cuenca,54898,26154,28744
16,Cuenca,79,Cueva del Hierro,29,21,8
16,Cuenca,82,Enguídanos,321,170,151
16,Cuenca,83,Fresneda de Altarejos,49,25,24
16,Cuenca,84,Fresneda de la Sierra,48,27,21
16,Cuenca,85,"Frontera, La",169,90,79
16,Cuenca,86,Fuente de Pedro Naharro,1212,629,583
16,Cuenca,87,Fuentelespino de Haro,248,130,118
16,Cuenca,88,Fuentelespino de Moya,105,56,49
16,Cuenca,904,Fuentenava de Jábaga,525,275,250
16,Cuenca,89,Fuentes,454,239,215
16,Cuenca,91,Fuertescusa,70,39,31
16,Cuenca,92,Gabaldón,183,106,77
16,Cuenca,93,Garaballa,68,37,31
16,Cuenca,94,Gascueña,154,84,70
16,Cuenca,95,Graja de Campalbo,93,52,41
16,Cuenca,96,Graja de Iniesta,365,193,172
16,Cuenca,97,Henarejos,145,73,72
16,Cuenca,98,"Herrumblar, El",678,346,332
16,Cuenca,99,"Hinojosa, La",195,98,97
16,Cuenca,100,"Hinojosos, Los",789,386,403
16,Cuenca,101,"Hito, El",142,78,64
16,Cuenca,102,Honrubia,1597,800,797
16,Cuenca,103,Hontanaya,263,142,121
16,Cuenca,104,Hontecillas,53,29,24
16,Cuenca,106,Horcajo de Santiago,3526,1789,1737
16,Cuenca,107,Huélamo,98,57,41
16,Cuenca,108,Huelves,51,27,24
16,Cuenca,109,Huérguina,52,29,23
16,Cuenca,110,Huerta de la Obispalía,124,72,52
16,Cuenca,111,Huerta del Marquesado,190,108,82
16,Cuenca,112,Huete,1777,919,858
16,Cuenca,113,Iniesta,4299,2131,2168
16,Cuenca,115,Laguna del Marquesado,45,26,19
16,Cuenca,116,Lagunaseca,65,39,26
16,Cuenca,117,Landete,1216,613,603
16,Cuenca,118,Ledaña,1584,782,802
16,Cuenca,119,Leganiel,189,95,94
16,Cuenca,121,"Majadas, Las",251,130,121
16,Cuenca,122,Mariana,293,150,143
16,Cuenca,123,Masegosa,70,41,29
16,Cuenca,124,"Mesas, Las",2328,1178,1150
16,Cuenca,125,Minglanilla,2211,1130,1081
16,Cuenca,126,Mira,926,459,467
16,Cuenca,128,Monreal del Llano,67,36,31
16,Cuenca,129,Montalbanejo,106,54,52
16,Cuenca,130,Montalbo,626,334,292
16,Cuenca,131,Monteagudo de las Salinas,110,64,46
16,Cuenca,132,Mota de Altarejos,36,23,13
16,Cuenca,133,Mota del Cuervo,6030,2995,3035
16,Cuenca,134,Motilla del Palancar,5959,2972,2987
16,Cuenca,135,Moya,138,78,60
16,Cuenca,137,Narboneta,43,21,22
16,Cuenca,139,Olivares de Júcar,334,176,158
16,Cuenca,140,Olmeda de la Cuesta,21,11,10
16,Cuenca,141,Olmeda del Rey,133,68,65
16,Cuenca,142,Olmedilla de Alarcón,151,87,64
16,Cuenca,143,Olmedilla de Eliz,15,11,4
16,Cuenca,145,Osa de la Vega,485,249,236
16,Cuenca,146,Pajarón,81,41,40
16,Cuenca,147,Pajaroncillo,67,41,26
16,Cuenca,148,Palomares del Campo,625,323,302
16,Cuenca,149,Palomera,159,81,78
16,Cuenca,150,Paracuellos,101,53,48
16,Cuenca,151,Paredes,58,33,25
16,Cuenca,152,"Parra de las Vegas, La",34,22,12
16,Cuenca,153,"Pedernoso, El",1127,569,558
16,Cuenca,154,"Pedroñeras, Las",6548,3345,3203
16,Cuenca,155,"Peral, El",611,334,277
16,Cuenca,156,"Peraleja, La",96,57,39
16,Cuenca,157,"Pesquera, La",215,118,97
16,Cuenca,158,"Picazo, El",679,337,342
16,Cuenca,159,Pinarejo,213,105,108
16,Cuenca,160,Pineda de Gigüela,59,35,24
16,Cuenca,161,Piqueras del Castillo,53,29,24
16,Cuenca,162,Portalrubio de Guadamejud,27,13,14
16,Cuenca,163,Portilla,64,35,29
16,Cuenca,165,Poyatos,60,31,29
16,Cuenca,166,Pozoamargo,290,156,134
16,Cuenca,908,Pozorrubielos de la Mancha,188,89,99
16,Cuenca,167,Pozorrubio de Santiago,305,144,161
16,Cuenca,169,"Pozuelo, El",51,33,18
16,Cuenca,170,Priego,920,469,451
16,Cuenca,171,"Provencio, El",2418,1195,1223
16,Cuenca,172,Puebla de Almenara,345,181,164
16,Cuenca,174,Puebla del Salvador,183,103,80
16,Cuenca,175,Quintanar del Rey,7589,3914,3675
16,Cuenca,176,Rada de Haro,46,26,20
16,Cuenca,177,Reíllo,118,62,56
16,Cuenca,181,Rozalén del Monte,67,31,36
16,Cuenca,185,Saceda-Trasierra,38,28,10
16,Cuenca,186,Saelices,505,260,245
16,Cuenca,187,Salinas del Manzano,81,48,33
16,Cuenca,188,Salmeroncillos,100,58,42
16,Cuenca,189,Salvacañete,296,158,138
16,Cuenca,190,San Clemente,7107,3586,3521
16,Cuenca,191,San Lorenzo de la Parrilla,1040,522,518
16,Cuenca,192,San Martín de Boniches,46,24,22
16,Cuenca,193,San Pedro Palmiches,55,32,23
16,Cuenca,194,Santa Cruz de Moya,227,122,105
16,Cuenca,196,Santa María de los Llanos,688,357,331
16,Cuenca,195,Santa María del Campo Rus,590,289,301
16,Cuenca,197,Santa María del Val,68,41,27
16,Cuenca,198,Sisante,1643,831,812
16,Cuenca,199,Solera de Gabaldón,23,11,12
16,Cuenca,909,Sotorribas,756,389,367
16,Cuenca,202,Talayuelas,884,470,414
16,Cuenca,203,Tarancón,14990,7425,7565
16,Cuenca,204,Tébar,280,148,132
16,Cuenca,205,Tejadillos,124,61,63
16,Cuenca,206,Tinajas,195,103,92
16,Cuenca,209,Torralba,114,69,45
16,Cuenca,211,Torrejoncillo del Rey,363,187,176
16,Cuenca,212,Torrubia del Campo,257,126,131
16,Cuenca,213,Torrubia del Castillo,39,24,15
16,Cuenca,215,Tragacete,259,143,116
16,Cuenca,216,Tresjuncos,302,160,142
16,Cuenca,217,Tribaldos,96,53,43
16,Cuenca,218,Uclés,223,117,106
16,Cuenca,219,Uña,89,46,43
16,Cuenca,906,"Valdecolmenas, Los",75,48,27
16,Cuenca,224,Valdemeca,88,49,39
16,Cuenca,225,Valdemorillo de la Sierra,66,41,25
16,Cuenca,227,Valdemoro-Sierra,113,67,46
16,Cuenca,228,Valdeolivas,203,125,78
16,Cuenca,902,Valdetórtola,130,74,56
16,Cuenca,903,"Valeras, Las",1516,801,715
16,Cuenca,231,Valhermoso de la Fuente,48,27,21
16,Cuenca,173,"Valle de Altomira, El",216,121,95
16,Cuenca,234,Valsalobre,28,16,12
16,Cuenca,236,Valverde de Júcar,1071,537,534
16,Cuenca,237,Valverdejo,102,54,48
16,Cuenca,238,Vara de Rey,501,257,244
16,Cuenca,239,Vega del Codorno,134,85,49
16,Cuenca,240,Vellisca,100,57,43
16,Cuenca,242,Villaconejos de Trabaque,348,172,176
16,Cuenca,243,Villaescusa de Haro,470,241,229
16,Cuenca,244,Villagarcía del Llano,745,380,365
16,Cuenca,245,Villalba de la Sierra,476,232,244
16,Cuenca,246,Villalba del Rey,515,285,230
16,Cuenca,247,Villalgordo del Marquesado,76,39,37
16,Cuenca,248,Villalpardo,1016,504,512
16,Cuenca,249,Villamayor de Santiago,2522,1281,1241
16,Cuenca,250,Villanueva de Guadamejud,70,43,27
16,Cuenca,251,Villanueva de la Jara,2304,1164,1140
16,Cuenca,253,Villar de Cañas,378,202,176
16,Cuenca,254,Villar de Domingo García,229,113,116
16,Cuenca,255,Villar de la Encina,165,88,77
16,Cuenca,263,Villar de Olalla,1258,673,585
16,Cuenca,258,Villar del Humo,189,101,88
16,Cuenca,259,Villar del Infantado,47,27,20
16,Cuenca,910,Villar y Velasco,82,47,35
16,Cuenca,264,Villarejo de Fuentes,454,232,222
16,Cuenca,265,Villarejo de la Peñuela,21,9,12
16,Cuenca,266,Villarejo-Periesteban,385,191,194
16,Cuenca,269,Villares del Saz,466,231,235
16,Cuenca,270,Villarrubio,196,104,92
16,Cuenca,271,Villarta,821,408,413
16,Cuenca,272,Villas de la Ventosa,233,139,94
16,Cuenca,273,Villaverde y Pasaconsol,337,179,158
16,Cuenca,274,Víllora,128,67,61
16,Cuenca,275,Vindel,10,6,4
16,Cuenca,276,Yémeda,22,14,8
16,Cuenca,277,Zafra de Záncara,124,67,57
16,Cuenca,278,Zafrilla,64,32,32
16,Cuenca,279,Zarza de Tajo,229,129,100
16,Cuenca,280,Zarzuela,181,96,85
20,Gipuzkoa,1,Abaltzisketa,320,173,147
20,Gipuzkoa,2,Aduna,469,256,213
20,Gipuzkoa,16,Aia,2081,1098,983
20,Gipuzkoa,3,Aizarnazabal,777,394,383
20,Gipuzkoa,4,Albiztur,309,160,149
20,Gipuzkoa,5,Alegia,1726,884,842
20,Gipuzkoa,6,Alkiza,374,183,191
20,Gipuzkoa,906,Altzaga,179,87,92
20,Gipuzkoa,7,Altzo,427,223,204
20,Gipuzkoa,8,Amezketa,939,508,431
20,Gipuzkoa,9,Andoain,14618,7209,7409
20,Gipuzkoa,10,Anoeta,2034,1052,982
20,Gipuzkoa,11,Antzuola,2136,1070,1066
20,Gipuzkoa,12,Arama,205,100,105
20,Gipuzkoa,13,Aretxabaleta,6987,3514,3473
20,Gipuzkoa,55,Arrasate/Mondragón,22019,10822,11197
20,Gipuzkoa,14,Asteasu,1533,802,731
20,Gipuzkoa,903,Astigarraga,6272,3204,3068
20,Gipuzkoa,15,Ataun,1669,863,806
20,Gipuzkoa,17,Azkoitia,11609,5768,5841
20,Gipuzkoa,18,Azpeitia,14786,7387,7399
20,Gipuzkoa,904,Baliarrain,137,75,62
20,Gipuzkoa,19,Beasain,13881,6938,6943
20,Gipuzkoa,20,Beizama,151,90,61
20,Gipuzkoa,21,Belauntza,239,129,110
20,Gipuzkoa,22,Berastegi,1081,559,522
20,Gipuzkoa,74,Bergara,14596,7257,7339
20,Gipuzkoa,23,Berrobi,602,315,287
20,Gipuzkoa,24,Bidania-Goiatz,508,279,229
20,Gipuzkoa,29,Deba,5457,2717,2740
20,Gipuzkoa,69,Donostia/San Sebastián,186665,87764,98901
20,Gipuzkoa,30,Eibar,27406,13294,14112
20,Gipuzkoa,31,Elduain,239,123,116
20,Gipuzkoa,33,Elgeta,1135,572,563
20,Gipuzkoa,32,Elgoibar,11582,5730,5852
20,Gipuzkoa,67,Errenteria,39355,19037,20318
20,Gipuzkoa,66,Errezil,589,311,278
20,Gipuzkoa,34,Eskoriatza,4087,2052,2035
20,Gipuzkoa,35,Ezkio-Itsaso,575,296,279
20,Gipuzkoa,38,Gabiria,488,256,232
20,Gipuzkoa,37,Gaintza,129,74,55
20,Gipuzkoa,907,Gaztelu,153,83,70
20,Gipuzkoa,39,Getaria,2818,1428,1390
20,Gipuzkoa,40,Hernani,20222,9890,10332
20,Gipuzkoa,41,Hernialde,313,165,148
20,Gipuzkoa,36,Hondarribia,17018,8462,8556
20,Gipuzkoa,42,Ibarra,4172,2082,2090
20,Gipuzkoa,43,Idiazabal,2305,1170,1135
20,Gipuzkoa,44,Ikaztegieta,488,248,240
20,Gipuzkoa,45,Irun,61983,30306,31677
20,Gipuzkoa,46,Irura,1862,961,901
20,Gipuzkoa,47,Itsasondo,641,327,314
20,Gipuzkoa,48,Larraul,253,139,114
20,Gipuzkoa,902,Lasarte-Oria,18253,8873,9380
20,Gipuzkoa,49,Lazkao,5646,2838,2808
20,Gipuzkoa,50,Leaburu,377,195,182
20,Gipuzkoa,51,Legazpi,8384,4251,4133
20,Gipuzkoa,52,Legorreta,1430,728,702
20,Gipuzkoa,68,Leintz-Gatzaga,232,129,103
20,Gipuzkoa,53,Lezo,6045,3006,3039
20,Gipuzkoa,54,Lizartza,602,312,290
20,Gipuzkoa,901,Mendaro,2010,1014,996
20,Gipuzkoa,57,Mutiloa,252,139,113
20,Gipuzkoa,56,Mutriku,5354,2712,2642
20,Gipuzkoa,63,Oiartzun,10276,5103,5173
20,Gipuzkoa,58,Olaberria,945,478,467
20,Gipuzkoa,59,Oñati,11335,5601,5734
20,Gipuzkoa,76,Ordizia,10150,4996,5154
20,Gipuzkoa,905,Orendain,218,112,106
20,Gipuzkoa,60,Orexa,123,67,56
20,Gipuzkoa,61,Orio,5948,2998,2950
20,Gipuzkoa,62,Ormaiztegi,1302,661,641
20,Gipuzkoa,64,Pasaia,16128,7739,8389
20,Gipuzkoa,70,Segura,1432,720,712
20,Gipuzkoa,65,Soraluze-Placencia de las Armas,3894,1945,1949
20,Gipuzkoa,71,Tolosa,19525,9431,10094
20,Gipuzkoa,72,Urnieta,6170,3080,3090
20,Gipuzkoa,77,Urretxu,6730,3319,3411
20,Gipuzkoa,73,Usurbil,6165,3092,3073
20,Gipuzkoa,75,Villabona,5881,2938,2943
20,Gipuzkoa,78,Zaldibia,1613,827,786
20,Gipuzkoa,79,Zarautz,23223,11308,11915
20,Gipuzkoa,25,Zegama,1519,773,746
20,Gipuzkoa,26,Zerain,252,120,132
20,Gipuzkoa,27,Zestoa,3725,1955,1770
20,Gipuzkoa,28,Zizurkil,2976,1489,1487
20,Gipuzkoa,81,Zumaia,10044,5004,5040
20,Gipuzkoa,80,Zumarraga,9834,4857,4977
17,Girona,1,Agullana,841,418,423
17,Girona,2,Aiguaviva,767,388,379
17,Girona,3,Albanyà,139,72,67
17,Girona,4,Albons,765,396,369
17,Girona,6,Alp,1559,809,750
17,Girona,7,Amer,2256,1106,1150
17,Girona,8,Anglès,5519,2735,2784
17,Girona,9,Arbúcies,6515,3378,3137
17,Girona,10,Argelaguer,423,219,204
17,Girona,11,"Armentera, L'",937,468,469
17,Girona,12,Avinyonet de Puigventós,1604,803,801
17,Girona,15,Banyoles,19615,9741,9874
17,Girona,16,Bàscara,1000,521,479
17,Girona,13,Begur,3934,1972,1962
17,Girona,18,Bellcaire d'Empordà,671,328,343
17,Girona,19,Besalú,2467,1161,1306
17,Girona,20,Bescanó,4941,2493,2448
17,Girona,21,Beuda,187,101,86
17,Girona,22,"Bisbal d'Empordà, La",10859,5407,5452
17,Girona,234,Biure,238,120,118
17,Girona,23,Blanes,38790,19272,19518
17,Girona,29,Boadella i les Escaules,269,139,130
17,Girona,24,Bolvir,383,200,183
17,Girona,25,Bordils,1701,851,850
17,Girona,26,Borrassà,702,369,333
17,Girona,27,Breda,3733,1855,1878
17,Girona,28,Brunyola,369,185,184
17,Girona,31,Cabanelles,273,153,120
17,Girona,30,Cabanes,944,502,442
17,Girona,32,Cadaqués,2752,1344,1408
17,Girona,33,Caldes de Malavella,7458,3716,3742
17,Girona,34,Calonge,10897,5457,5440
17,Girona,35,Camós,690,347,343
17,Girona,36,Campdevànol,3204,1556,1648
17,Girona,37,Campelles,133,70,63
17,Girona,38,Campllong,535,263,272
17,Girona,39,Camprodon,2261,1111,1150
17,Girona,40,Canet d'Adri,708,364,344
17,Girona,41,Cantallops,313,155,158
17,Girona,42,Capmany,613,308,305
17,Girona,44,Cassà de la Selva,10359,5285,5074
17,Girona,46,Castellfollit de la Roca,956,486,470
17,Girona,47,Castelló d'Empúries,10820,5495,5325
17,Girona,48,Castell-Platja d'Aro,10585,5215,5370
17,Girona,189,"Cellera de Ter, La",1976,981,995
17,Girona,49,Celrà,5390,2708,2682
17,Girona,50,Cervià de Ter,948,487,461
17,Girona,51,Cistella,300,148,152
17,Girona,54,Colera,465,235,230
17,Girona,55,Colomers,176,88,88
17,Girona,57,Corçà,1253,642,611
17,Girona,56,Cornellà del Terri,2322,1182,1140
17,Girona,58,Crespià,251,130,121
17,Girona,901,"Cruïlles, Monells i Sant Sadurní de l'Heura",1274,639,635
17,Girona,60,Darnius,557,276,281
17,Girona,61,Das,227,122,105
17,Girona,62,"Escala, L'",10417,5308,5109
17,Girona,63,Espinelves,206,106,100
17,Girona,64,Espolla,425,210,215
17,Girona,65,Esponellà,433,222,211
17,Girona,5,"Far d'Empordà, El",576,287,289
17,Girona,66,Figueres,46381,22917,23464
17,Girona,67,Flaçà,1081,525,556
17,Girona,68,Foixà,305,159,146
17,Girona,69,Fontanals de Cerdanya,455,231,224
17,Girona,70,Fontanilles,138,76,62
17,Girona,71,Fontcoberta,1474,733,741
17,Girona,902,Forallac,1713,843,870
17,Girona,73,Fornells de la Selva,2649,1316,1333
17,Girona,74,Fortià,732,362,370
17,Girona,75,Garrigàs,439,226,213
17,Girona,76,Garrigoles,175,94,81
17,Girona,77,Garriguella,840,416,424
17,Girona,78,Ger,429,213,216
17,Girona,79,Girona,100266,48030,52236
17,Girona,80,Gombrèn,186,94,92
17,Girona,81,Gualta,392,220,172
17,Girona,82,Guils de Cerdanya,529,278,251
17,Girona,83,Hostalric,4139,2096,2043
17,Girona,84,Isòvol,278,159,119
17,Girona,85,Jafre,390,206,184
17,Girona,86,"Jonquera, La",3233,1620,1613
17,Girona,87,Juià,335,180,155
17,Girona,88,Lladó,787,386,401
17,Girona,89,Llagostera,8297,4240,4057
17,Girona,90,Llambilles,693,353,340
17,Girona,91,Llanars,514,267,247
17,Girona,92,Llançà,4868,2412,2456
17,Girona,93,Llers,1239,617,622
17,Girona,94,Llívia,1428,764,664
17,Girona,95,Lloret de Mar,37350,19099,18251
17,Girona,96,"Llosses, Les",219,122,97
17,Girona,102,Maçanet de Cabrenys,681,336,345
17,Girona,103,Maçanet de la Selva,6919,3561,3358
17,Girona,97,Madremanya,282,136,146
17,Girona,98,Maià de Montcal,413,217,196
17,Girona,100,Masarac,272,140,132
17,Girona,101,Massanes,730,394,336
17,Girona,99,Meranges,98,58,40
17,Girona,105,Mieres,312,159,153
17,Girona,106,Mollet de Peralada,190,98,92
17,Girona,107,Molló,328,159,169
17,Girona,109,Montagut i Oix,899,475,424
17,Girona,110,Mont-ras,1691,858,833
17,Girona,111,Navata,1313,647,666
17,Girona,112,Ogassa,226,129,97
17,Girona,114,Olot,34486,17139,17347
17,Girona,115,Ordis,382,202,180
17,Girona,116,Osor,416,217,199
17,Girona,117,Palafrugell,22860,11322,11538
17,Girona,118,Palamós,17898,8742,9156
17,Girona,119,Palau de Santa Eulàlia,95,56,39
17,Girona,121,Palau-sator,295,160,135
17,Girona,120,Palau-saverdera,1439,718,721
17,Girona,123,Palol de Revardit,467,229,238
17,Girona,124,Pals,2461,1246,1215
17,Girona,125,Pardines,162,90,72
17,Girona,126,Parlavà,394,200,194
17,Girona,128,Pau,547,278,269
17,Girona,129,Pedret i Marzà,195,101,94
17,Girona,130,"Pera, La",447,216,231
17,Girona,132,Peralada,1868,916,952
17,Girona,133,"Planes d'Hostoles, Les",1660,843,817
17,Girona,134,Planoles,303,170,133
17,Girona,135,Pont de Molins,530,265,265
17,Girona,136,Pontós,247,135,112
17,Girona,137,Porqueres,4595,2281,2314
17,Girona,140,"Port de la Selva, El",980,502,478
17,Girona,138,Portbou,1077,525,552
17,Girona,139,"Preses, Les",1763,873,890
17,Girona,141,Puigcerdà,8981,4475,4506
17,Girona,142,Quart,3640,1825,1815
17,Girona,43,Queralbs,186,103,83
17,Girona,143,Rabós,179,90,89
17,Girona,144,Regencós,276,142,134
17,Girona,145,Ribes de Freser,1766,879,887
17,Girona,146,Riells i Viabrea,4002,2060,1942
17,Girona,147,Ripoll,10632,5251,5381
17,Girona,148,Riudarenes,2181,1125,1056
17,Girona,149,Riudaura,462,224,238
17,Girona,150,Riudellots de la Selva,2059,1053,1006
17,Girona,151,Riumors,263,132,131
17,Girona,152,Roses,19319,9713,9606
17,Girona,153,Rupià,269,135,134
17,Girona,154,Sales de Llierca,151,76,75
17,Girona,155,Salt,30622,16048,14574
17,Girona,157,Sant Andreu Salou,156,82,74
17,Girona,183,Sant Aniol de Finestres,351,186,165
17,Girona,158,Sant Climent Sescebes,635,368,267
17,Girona,159,Sant Feliu de Buixalleu,804,419,385
17,Girona,160,Sant Feliu de Guíxols,21824,10761,11063
17,Girona,161,Sant Feliu de Pallerols,1343,648,695
17,Girona,162,Sant Ferriol,245,125,120
17,Girona,163,Sant Gregori,3740,1916,1824
17,Girona,164,Sant Hilari Sacalm,5591,2818,2773
17,Girona,165,Sant Jaume de Llierca,840,406,434
17,Girona,167,Sant Joan de les Abadesses,3224,1606,1618
17,Girona,168,Sant Joan de Mollet,502,241,261
17,Girona,185,Sant Joan les Fonts,2966,1506,1460
17,Girona,166,Sant Jordi Desvalls,731,359,372
17,Girona,169,Sant Julià de Ramis,3461,1749,1712
17,Girona,903,Sant Julià del Llor i Bonmatí,1275,656,619
17,Girona,171,Sant Llorenç de la Muga,251,131,120
17,Girona,172,Sant Martí de Llémena,626,324,302
17,Girona,173,Sant Martí Vell,249,127,122
17,Girona,174,Sant Miquel de Campmajor,228,120,108
17,Girona,175,Sant Miquel de Fluvià,746,395,351
17,Girona,176,Sant Mori,177,93,84
17,Girona,177,Sant Pau de Segúries,707,349,358
17,Girona,178,Sant Pere Pescador,2039,1088,951
17,Girona,180,Santa Coloma de Farners,12894,6490,6404
17,Girona,181,Santa Cristina d'Aro,5203,2608,2595
17,Girona,182,Santa Llogaia d'Àlguema,363,191,172
17,Girona,184,Santa Pau,1573,794,779
17,Girona,186,Sarrià de Ter,5114,2513,2601
17,Girona,187,"Saus, Camallera i Llampaies",848,419,429
17,Girona,188,"Selva de Mar, La",187,106,81
17,Girona,190,Serinyà,1108,570,538
17,Girona,191,Serra de Daró,210,117,93
17,Girona,192,Setcases,168,89,79
17,Girona,193,Sils,5969,3023,2946
17,Girona,52,Siurana,162,77,85
17,Girona,194,Susqueda,97,56,41
17,Girona,195,"Tallada d'Empordà, La",459,234,225
17,Girona,196,Terrades,314,149,165
17,Girona,197,Torrent,165,90,75
17,Girona,198,Torroella de Fluvià,723,365,358
17,Girona,199,Torroella de Montgrí,11537,5842,5695
17,Girona,200,Tortellà,801,390,411
17,Girona,201,Toses,165,100,65
17,Girona,202,Tossa de Mar,5584,2816,2768
17,Girona,204,Ullà,1139,625,514
17,Girona,205,Ullastret,286,141,145
17,Girona,203,Ultramort,214,117,97
17,Girona,206,Urús,178,84,94
17,Girona,14,"Vajol, La",85,46,39
17,Girona,208,"Vall de Bianya, La",1286,651,635
17,Girona,207,"Vall d'en Bas, La",3029,1528,1501
17,Girona,170,Vallfogona de Ripollès,212,115,97
17,Girona,209,Vall-llobrega,912,454,458
17,Girona,210,Ventalló,854,432,422
17,Girona,211,Verges,1189,582,607
17,Girona,212,Vidrà,173,88,85
17,Girona,213,Vidreres,7740,3995,3745
17,Girona,214,Vilabertran,951,486,465
17,Girona,215,Vilablareix,2789,1383,1406
17,Girona,217,Viladamat,466,246,220
17,Girona,216,Viladasens,204,108,96
17,Girona,218,Vilademuls,823,432,391
17,Girona,220,Viladrau,1026,505,521
17,Girona,221,Vilafant,5443,2658,2785
17,Girona,223,Vilajuïga,1112,552,560
17,Girona,224,Vilallonga de Ter,404,211,193
17,Girona,225,Vilamacolum,312,167,145
17,Girona,226,Vilamalla,1157,581,576
17,Girona,227,Vilamaniscle,208,116,92
17,Girona,228,Vilanant,399,198,201
17,Girona,230,Vila-sacra,709,348,361
17,Girona,222,Vilaür,147,77,70
17,Girona,233,Vilobí d'Onyar,3196,1660,1536
17,Girona,232,Vilopriu,205,109,96
18,Granada,1,Agrón,288,141,147
18,Granada,2,Alamedilla,599,307,292
18,Granada,3,Albolote,18746,9329,9417
18,Granada,4,Albondón,729,403,326
18,Granada,5,Albuñán,415,214,201
18,Granada,6,Albuñol,7128,3879,3249
18,Granada,7,Albuñuelas,830,419,411
18,Granada,10,Aldeire,628,331,297
18,Granada,11,Alfacar,5378,2735,2643
18,Granada,12,Algarinejo,2591,1333,1258
18,Granada,13,Alhama de Granada,5980,3201,2779
18,Granada,14,Alhendín,9168,4630,4538
18,Granada,15,Alicún de Ortega,475,235,240
18,Granada,16,Almegíjar,346,186,160
18,Granada,17,Almuñécar,26377,13032,13345
18,Granada,904,Alpujarra de la Sierra,978,550,428
18,Granada,18,Alquife,624,311,313
18,Granada,20,Arenas del Rey,1178,613,565
18,Granada,21,Armilla,23968,11936,12032
18,Granada,22,Atarfe,18554,9254,9300
18,Granada,23,Baza,20519,10210,10309
18,Granada,24,Beas de Granada,985,518,467
18,Granada,25,Beas de Guadix,340,171,169
18,Granada,27,Benalúa,3285,1636,1649
18,Granada,28,Benalúa de las Villas,1065,551,514
18,Granada,29,Benamaurel,2297,1155,1142
18,Granada,30,Bérchules,719,387,332
18,Granada,32,Bubión,302,158,144
18,Granada,33,Busquístar,279,146,133
18,Granada,34,Cacín,578,292,286
18,Granada,35,Cádiar,1469,768,701
18,Granada,36,Cájar,5070,2445,2625
18,Granada,114,"Calahorra, La",661,330,331
18,Granada,37,Calicasas,609,305,304
18,Granada,38,Campotéjar,1253,643,610
18,Granada,39,Caniles,4060,2085,1975
18,Granada,40,Cáñar,343,184,159
18,Granada,42,Capileira,558,278,280
18,Granada,43,Carataunas,178,96,82
18,Granada,44,Cástaras,244,144,100
18,Granada,45,Castilléjar,1337,692,645
18,Granada,46,Castril,2124,1098,1026
18,Granada,47,Cenes de la Vega,7928,3969,3959
18,Granada,59,Chauchina,5546,2741,2805
18,Granada,61,Chimeneas,1291,673,618
18,Granada,62,Churriana de la Vega,14851,7407,7444
18,Granada,48,Cijuela,3243,1657,1586
18,Granada,49,Cogollos de Guadix,656,362,294
18,Granada,50,Cogollos de la Vega,2044,1018,1026
18,Granada,51,Colomera,1350,706,644
18,Granada,53,Cortes de Baza,1901,945,956
18,Granada,54,Cortes y Graena,993,526,467
18,Granada,912,Cuevas del Campo,1774,886,888
18,Granada,56,Cúllar,4171,2084,2087
18,Granada,57,Cúllar Vega,7378,3732,3646
18,Granada,63,Darro,1583,805,778
18,Granada,64,Dehesas de Guadix,420,213,207
18,Granada,65,Dehesas Viejas,723,367,356
18,Granada,66,Deifontes,2616,1311,1305
18,Granada,67,Diezma,755,391,364
18,Granada,68,Dílar,2032,1017,1015
18,Granada,69,Dólar,621,337,284
18,Granada,915,Domingo Pérez de Granada,890,465,425
18,Granada,70,Dúdar,320,170,150
18,Granada,71,Dúrcal,6975,3467,3508
18,Granada,72,Escúzar,789,404,385
18,Granada,74,Ferreira,300,155,145
18,Granada,76,Fonelas,993,517,476
18,Granada,78,Freila,900,460,440
18,Granada,79,Fuente Vaqueros,4387,2197,2190
18,Granada,905,"Gabias, Las",20703,10547,10156
18,Granada,82,Galera,1090,549,541
18,Granada,83,Gobernador,233,110,123
18,Granada,84,Gójar,5703,2898,2805
18,Granada,85,Gor,736,377,359
18,Granada,86,Gorafe,379,196,183
18,Granada,87,Granada,232208,107414,124794
18,Granada,88,Guadahortuna,1924,993,931
18,Granada,89,Guadix,18718,9264,9454
18,Granada,906,"Guájares, Los",1028,538,490
18,Granada,93,Gualchos,5210,2787,2423
18,Granada,94,Güéjar Sierra,2849,1517,1332
18,Granada,95,Güevéjar,2541,1336,1205
18,Granada,96,Huélago,388,203,185
18,Granada,97,Huéneja,1151,614,537
18,Granada,98,Huéscar,7367,3643,3724
18,Granada,99,Huétor de Santillán,1882,970,912
18,Granada,100,Huétor Tájar,10286,5182,5104
18,Granada,101,Huétor Vega,11966,6014,5952
18,Granada,102,Íllora,10135,5063,5072
18,Granada,103,Ítrabo,1002,503,499
18,Granada,105,Iznalloz,5085,2605,2480
18,Granada,106,Játar,599,326,273
18,Granada,107,Jayena,1104,561,543
18,Granada,108,Jérez del Marquesado,977,511,466
18,Granada,109,Jete,909,478,431
18,Granada,111,Jun,3785,1932,1853
18,Granada,112,Juviles,142,68,74
18,Granada,115,Láchar,3354,1721,1633
18,Granada,116,Lanjarón,3485,1738,1747
18,Granada,117,Lanteira,576,310,266
18,Granada,119,Lecrín,2103,1068,1035
18,Granada,120,Lentegí,328,172,156
18,Granada,121,Lobras,148,78,70
18,Granada,122,Loja,20371,10143,10228
18,Granada,123,Lugros,332,177,155
18,Granada,124,Lújar,462,252,210
18,Granada,126,"Malahá, La",1827,915,912
18,Granada,127,Maracena,22047,10849,11198
18,Granada,128,Marchal,409,193,216
18,Granada,132,Moclín,3723,1857,1866
18,Granada,133,Molvízar,2759,1411,1348
18,Granada,134,Monachil,7826,4033,3793
18,Granada,135,Montefrío,5479,2763,2716
18,Granada,136,Montejícar,2163,1112,1051
18,Granada,137,Montillana,1157,610,547
18,Granada,138,Moraleda de Zafayona,3159,1592,1567
18,Granada,909,Morelábor,619,334,285
18,Granada,140,Motril,60592,29831,30761
18,Granada,141,Murtas,464,259,205
18,Granada,903,Nevada,1079,556,523
18,Granada,143,Nigüelas,1182,604,578
18,Granada,144,Nívar,996,524,472
18,Granada,145,Ogíjares,14025,6940,7085
18,Granada,146,Orce,1198,609,589
18,Granada,147,Órgiva,5649,2837,2812
18,Granada,148,Otívar,1029,523,506
18,Granada,150,Padul,8396,4220,4176
18,Granada,151,Pampaneira,321,160,161
18,Granada,152,Pedro Martínez,1134,556,578
18,Granada,153,Peligros,11286,5603,5683
18,Granada,154,"Peza, La",1177,600,577
18,Granada,910,"Pinar, El",919,475,444
18,Granada,157,Pinos Genil,1449,762,687
18,Granada,158,Pinos Puente,10144,5101,5043
18,Granada,159,Píñar,1120,608,512
18,Granada,161,Polícar,236,127,109
18,Granada,162,Polopos,1703,929,774
18,Granada,163,Pórtugos,389,199,190
18,Granada,164,Puebla de Don Fadrique,2292,1176,1116
18,Granada,165,Pulianas,5348,2656,2692
18,Granada,167,Purullena,2312,1176,1136
18,Granada,168,Quéntar,916,468,448
18,Granada,170,Rubite,382,212,170
18,Granada,171,Salar,2639,1330,1309
18,Granada,173,Salobreña,12396,6173,6223
18,Granada,174,Santa Cruz del Comercio,541,281,260
18,Granada,175,Santa Fe,14986,7368,7618
18,Granada,176,Soportújar,266,144,122
18,Granada,177,Sorvilán,545,299,246
18,Granada,901,"Taha, La",653,343,310
18,Granada,178,Torre-Cardela,759,402,357
18,Granada,179,Torvizcón,663,347,316
18,Granada,180,Trevélez,742,386,356
18,Granada,181,Turón,255,153,102
18,Granada,182,Ugíjar,2521,1240,1281
18,Granada,914,Valderrubio,2086,1020,1066
18,Granada,907,Valle del Zalabí,2145,1094,1051
18,Granada,902,"Valle, El",935,465,470
18,Granada,183,Válor,672,344,328
18,Granada,911,Vegas del Genil,10981,5609,5372
18,Granada,184,Vélez de Benaudalla,2870,1425,1445
18,Granada,185,Ventas de Huelma,610,332,278
18,Granada,149,Villa de Otura,6917,3478,3439
18,Granada,908,Villamena,950,477,473
18,Granada,187,Villanueva de las Torres,585,310,275
18,Granada,188,Villanueva Mesía,2024,997,1027
18,Granada,189,Víznar,980,509,471
18,Granada,192,Zafarraya,2057,1097,960
18,Granada,913,Zagra,855,432,423
18,Granada,193,"Zubia, La",18995,9374,9621
18,Granada,194,Zújar,2597,1338,1259
19,Guadalajara,1,Abánades,53,29,24
19,Guadalajara,2,Ablanque,60,34,26
19,Guadalajara,3,Adobes,31,17,14
19,Guadalajara,4,Alaminos,62,27,35
19,Guadalajara,5,Alarilla,156,101,55
19,Guadalajara,6,Albalate de Zorita,918,517,401
19,Guadalajara,7,Albares,540,271,269
19,Guadalajara,8,Albendiego,46,31,15
19,Guadalajara,9,Alcocer,326,168,158
19,Guadalajara,10,Alcolea de las Peñas,12,8,4
19,Guadalajara,11,Alcolea del Pinar,321,174,147
19,Guadalajara,13,Alcoroches,125,79,46
19,Guadalajara,15,Aldeanueva de Guadalajara,84,49,35
19,Guadalajara,16,Algar de Mesa,59,42,17
19,Guadalajara,17,Algora,77,46,31
19,Guadalajara,18,Alhóndiga,157,90,67
19,Guadalajara,19,Alique,16,8,8
19,Guadalajara,20,Almadrones,58,38,20
19,Guadalajara,21,Almoguera,1306,686,620
19,Guadalajara,22,Almonacid de Zorita,720,352,368
19,Guadalajara,23,Alocén,177,88,89
19,Guadalajara,24,Alovera,12570,6383,6187
19,Guadalajara,27,Alustante,157,89,68
19,Guadalajara,31,Angón,10,8,2
19,Guadalajara,32,Anguita,163,83,80
19,Guadalajara,33,Anquela del Ducado,51,29,22
19,Guadalajara,34,Anquela del Pedregal,23,17,6
19,Guadalajara,36,Aranzueque,390,205,185
19,Guadalajara,37,Arbancón,158,93,65
19,Guadalajara,38,Arbeteta,26,19,7
19,Guadalajara,39,Argecilla,65,44,21
19,Guadalajara,40,Armallones,51,32,19
19,Guadalajara,41,Armuña de Tajuña,226,124,102
19,Guadalajara,42,Arroyo de las Fraguas,22,12,10
19,Guadalajara,43,Atanzón,92,59,33
19,Guadalajara,44,Atienza,431,247,184
19,Guadalajara,45,Auñón,146,81,65
19,Guadalajara,46,Azuqueca de Henares,34685,17550,17135
19,Guadalajara,47,Baides,55,29,26
19,Guadalajara,48,Baños de Tajo,17,12,5
19,Guadalajara,49,Bañuelos,14,12,2
19,Guadalajara,50,Barriopedro,16,11,5
19,Guadalajara,51,Berninches,50,34,16
19,Guadalajara,52,"Bodera, La",26,16,10
19,Guadalajara,53,Brihuega,2399,1252,1147
19,Guadalajara,54,Budia,208,122,86
19,Guadalajara,55,Bujalaro,43,21,22
19,Guadalajara,57,Bustares,76,46,30
19,Guadalajara,58,Cabanillas del Campo,10123,5138,4985
19,Guadalajara,59,Campillo de Dueñas,79,45,34
19,Guadalajara,60,Campillo de Ranas,147,94,53
19,Guadalajara,61,Campisábalos,52,38,14
19,Guadalajara,64,Canredondo,63,40,23
19,Guadalajara,65,Cantalojas,144,88,56
19,Guadalajara,66,Cañizar,58,33,25
19,Guadalajara,67,"Cardoso de la Sierra, El",64,40,24
19,Guadalajara,70,Casa de Uceda,93,51,42
19,Guadalajara,71,"Casar, El",11812,6009,5803
19,Guadalajara,73,Casas de San Galindo,18,15,3
19,Guadalajara,74,Caspueñas,83,49,34
19,Guadalajara,75,Castejón de Henares,63,39,24
19,Guadalajara,76,Castellar de la Muela,26,14,12
19,Guadalajara,78,Castilforte,56,36,20
19,Guadalajara,79,Castilnuevo,9,5,4
19,Guadalajara,80,Cendejas de Enmedio,71,39,32
19,Guadalajara,81,Cendejas de la Torre,24,15,9
19,Guadalajara,82,Centenera,107,57,50
19,Guadalajara,103,Checa,273,163,110
19,Guadalajara,104,Chequilla,17,9,8
19,Guadalajara,106,Chillarón del Rey,92,53,39
19,Guadalajara,105,Chiloeches,3508,1819,1689
19,Guadalajara,86,Cifuentes,1697,896,801
19,Guadalajara,87,Cincovillas,23,12,11
19,Guadalajara,88,Ciruelas,104,59,45
19,Guadalajara,89,Ciruelos del Pinar,32,20,12
19,Guadalajara,90,Cobeta,115,59,56
19,Guadalajara,91,Cogollor,30,17,13
19,Guadalajara,92,Cogolludo,549,323,226
19,Guadalajara,95,Condemios de Abajo,14,9,5
19,Guadalajara,96,Condemios de Arriba,105,60,45
19,Guadalajara,97,Congostrina,16,12,4
19,Guadalajara,98,Copernal,24,17,7
19,Guadalajara,99,Corduente,345,188,157
19,Guadalajara,102,"Cubillo de Uceda, El",118,61,57
19,Guadalajara,107,Driebes,339,182,157
19,Guadalajara,108,Durón,109,58,51
19,Guadalajara,109,Embid,35,20,15
19,Guadalajara,110,Escamilla,60,32,28
19,Guadalajara,111,Escariche,171,105,66
19,Guadalajara,112,Escopete,50,20,30
19,Guadalajara,113,Espinosa de Henares,665,343,322
19,Guadalajara,114,Esplegares,38,26,12
19,Guadalajara,115,Establés,30,17,13
19,Guadalajara,116,Estriégana,13,8,5
19,Guadalajara,117,Fontanar,2364,1232,1132
19,Guadalajara,118,Fuembellida,8,5,3
19,Guadalajara,119,Fuencemillán,88,56,32
19,Guadalajara,120,Fuentelahiguera de Albatages,131,73,58
19,Guadalajara,121,Fuentelencina,284,160,124
19,Guadalajara,122,Fuentelsaz,89,49,40
19,Guadalajara,123,Fuentelviejo,43,24,19
19,Guadalajara,124,Fuentenovilla,526,290,236
19,Guadalajara,125,Gajanejos,49,33,16
19,Guadalajara,126,Galápagos,2416,1292,1124
19,Guadalajara,127,Galve de Sorbe,107,58,49
19,Guadalajara,129,Gascueña de Bornova,29,17,12
19,Guadalajara,130,Guadalajara,84910,40835,44075
19,Guadalajara,132,Henche,100,52,48
19,Guadalajara,133,Heras de Ayuso,272,165,107
19,Guadalajara,134,Herrería,19,12,7
19,Guadalajara,135,Hiendelaencina,118,67,51
19,Guadalajara,136,Hijes,19,10,9
19,Guadalajara,138,Hita,307,169,138
19,Guadalajara,139,Hombrados,29,18,11
19,Guadalajara,142,Hontoba,299,178,121
19,Guadalajara,143,Horche,2538,1288,1250
19,Guadalajara,145,Hortezuela de Océn,43,26,17
19,Guadalajara,146,"Huerce, La",44,28,16
19,Guadalajara,147,Huérmeces del Cerro,42,29,13
19,Guadalajara,148,Huertahernando,53,34,19
19,Guadalajara,150,Hueva,130,81,49
19,Guadalajara,151,Humanes,1487,731,756
19,Guadalajara,152,Illana,654,365,289
19,Guadalajara,153,Iniéstola,21,13,8
19,Guadalajara,154,"Inviernas, Las",63,42,21
19,Guadalajara,155,Irueste,73,49,24
19,Guadalajara,156,Jadraque,1434,752,682
19,Guadalajara,157,Jirueque,55,39,16
19,Guadalajara,159,Ledanca,99,52,47
19,Guadalajara,160,Loranca de Tajuña,1199,658,541
19,Guadalajara,161,Lupiana,250,130,120
19,Guadalajara,162,Luzaga,72,41,31
19,Guadalajara,163,Luzón,67,34,33
19,Guadalajara,165,Majaelrayo,55,31,24
19,Guadalajara,166,Málaga del Fresno,183,101,82
19,Guadalajara,167,Malaguilla,156,87,69
19,Guadalajara,168,Mandayona,297,149,148
19,Guadalajara,169,Mantiel,37,22,15
19,Guadalajara,170,Maranchón,222,120,102
19,Guadalajara,171,Marchamalo,7229,3626,3603
19,Guadalajara,172,Masegoso de Tajuña,51,29,22
19,Guadalajara,173,Matarrubia,61,38,23
19,Guadalajara,174,Matillas,106,54,52
19,Guadalajara,175,Mazarete,37,17,20
19,Guadalajara,176,Mazuecos,257,136,121
19,Guadalajara,177,Medranda,72,37,35
19,Guadalajara,178,Megina,30,19,11
19,Guadalajara,179,Membrillera,88,51,37
19,Guadalajara,181,Miedes de Atienza,60,37,23
19,Guadalajara,182,"Mierla, La",40,26,14
19,Guadalajara,184,Millana,102,63,39
19,Guadalajara,183,Milmarcos,77,47,30
19,Guadalajara,185,"Miñosa, La",28,19,9
19,Guadalajara,186,Mirabueno,83,49,34
19,Guadalajara,187,Miralrío,55,32,23
19,Guadalajara,188,Mochales,48,27,21
19,Guadalajara,189,Mohernando,172,91,81
19,Guadalajara,190,Molina de Aragón,3295,1654,1641
19,Guadalajara,191,Monasterio,14,6,8
19,Guadalajara,192,Mondéjar,2637,1356,1281
19,Guadalajara,193,Montarrón,26,15,11
19,Guadalajara,194,Moratilla de los Meleros,100,57,43
19,Guadalajara,195,Morenilla,38,23,15
19,Guadalajara,196,Muduex,102,55,47
19,Guadalajara,197,"Navas de Jadraque, Las",28,19,9
19,Guadalajara,198,Negredo,17,9,8
19,Guadalajara,199,Ocentejo,18,13,5
19,Guadalajara,200,"Olivar, El",75,43,32
19,Guadalajara,201,Olmeda de Cobeta,64,35,29
19,Guadalajara,202,"Olmeda de Jadraque, La",9,5,4
19,Guadalajara,203,"Ordial, El",27,16,11
19,Guadalajara,204,Orea,177,109,68
19,Guadalajara,208,Pálmaces de Jadraque,41,25,16
19,Guadalajara,209,Pardos,44,25,19
19,Guadalajara,210,Paredes de Sigüenza,19,10,9
19,Guadalajara,211,Pareja,389,228,161
19,Guadalajara,212,Pastrana,873,439,434
19,Guadalajara,213,"Pedregal, El",77,47,30
19,Guadalajara,214,Peñalén,76,44,32
19,Guadalajara,215,Peñalver,152,98,54
19,Guadalajara,216,Peralejos de las Truchas,156,83,73
19,Guadalajara,217,Peralveche,49,34,15
19,Guadalajara,218,Pinilla de Jadraque,52,27,25
19,Guadalajara,219,Pinilla de Molina,11,9,2
19,Guadalajara,220,Pioz,3770,1978,1792
19,Guadalajara,221,Piqueras,56,36,20
19,Guadalajara,222,"Pobo de Dueñas, El",111,57,54
19,Guadalajara,223,Poveda de la Sierra,120,62,58
19,Guadalajara,224,Pozo de Almoguera,106,65,41
19,Guadalajara,225,Pozo de Guadalajara,1269,676,593
19,Guadalajara,226,Prádena de Atienza,42,29,13
19,Guadalajara,227,Prados Redondos,61,40,21
19,Guadalajara,228,Puebla de Beleña,36,21,15
19,Guadalajara,229,Puebla de Valles,60,33,27
19,Guadalajara,230,Quer,778,406,372
19,Guadalajara,231,Rebollosa de Jadraque,12,8,4
19,Guadalajara,232,"Recuenco, El",60,38,22
19,Guadalajara,233,Renera,92,54,38
19,Guadalajara,234,Retiendas,42,28,14
19,Guadalajara,235,Riba de Saelices,87,50,37
19,Guadalajara,237,Rillo de Gallo,44,25,19
19,Guadalajara,238,Riofrío del Llano,49,29,20
19,Guadalajara,239,Robledillo de Mohernando,106,53,53
19,Guadalajara,240,Robledo de Corpes,45,27,18
19,Guadalajara,241,Romanillos de Atienza,42,25,17
19,Guadalajara,242,Romanones,100,53,47
19,Guadalajara,243,Rueda de la Sierra,40,30,10
19,Guadalajara,244,Sacecorbo,85,47,38
19,Guadalajara,245,Sacedón,1519,792,727
19,Guadalajara,246,Saelices de la Sal,44,23,21
19,Guadalajara,247,Salmerón,155,87,68
19,Guadalajara,248,San Andrés del Congosto,72,46,26
19,Guadalajara,249,San Andrés del Rey,35,19,16
19,Guadalajara,250,Santiuste,18,10,8
19,Guadalajara,251,Saúca,53,31,22
19,Guadalajara,252,Sayatón,81,47,34
19,Guadalajara,254,Selas,47,22,25
19,Guadalajara,901,Semillas,40,23,17
19,Guadalajara,255,Setiles,76,45,31
19,Guadalajara,256,Sienes,53,31,22
19,Guadalajara,257,Sigüenza,4356,2154,2202
19,Guadalajara,258,Solanillos del Extremo,96,56,40
19,Guadalajara,259,Somolinos,35,16,19
19,Guadalajara,260,"Sotillo, El",41,22,19
19,Guadalajara,261,Sotodosos,34,18,16
19,Guadalajara,262,Tamajón,123,67,56
19,Guadalajara,263,Taragudo,44,22,22
19,Guadalajara,264,Taravilla,33,21,12
19,Guadalajara,265,Tartanedo,149,88,61
19,Guadalajara,266,Tendilla,304,166,138
19,Guadalajara,267,Terzaga,22,12,10
19,Guadalajara,268,Tierzo,30,20,10
19,Guadalajara,269,"Toba, La",96,55,41
19,Guadalajara,271,Tordellego,50,28,22
19,Guadalajara,270,Tordelrábano,13,10,3
19,Guadalajara,272,Tordesilos,96,54,42
19,Guadalajara,274,Torija,1424,741,683
19,Guadalajara,279,Torre del Burgo,502,268,234
19,Guadalajara,277,Torrecuadrada de Molina,19,13,6
19,Guadalajara,278,Torrecuadradilla,25,15,10
19,Guadalajara,280,Torrejón del Rey,5300,2754,2546
19,Guadalajara,281,Torremocha de Jadraque,23,15,8
19,Guadalajara,282,Torremocha del Campo,175,102,73
19,Guadalajara,283,Torremocha del Pinar,40,19,21
19,Guadalajara,284,Torremochuela,11,7,4
19,Guadalajara,285,Torrubia,22,12,10
19,Guadalajara,286,Tórtola de Henares,1012,561,451
19,Guadalajara,287,Tortuera,206,115,91
19,Guadalajara,288,Tortuero,18,12,6
19,Guadalajara,289,Traíd,27,19,8
19,Guadalajara,290,Trijueque,1172,626,546
19,Guadalajara,291,Trillo,1319,693,626
19,Guadalajara,293,Uceda,2573,1334,1239
19,Guadalajara,294,Ujados,28,16,12
19,Guadalajara,296,Utande,35,24,11
19,Guadalajara,297,Valdarachas,35,18,17
19,Guadalajara,298,Valdearenas,79,52,27
19,Guadalajara,299,Valdeavellano,108,57,51
19,Guadalajara,300,Valdeaveruelo,1062,556,506
19,Guadalajara,301,Valdeconcha,40,24,16
19,Guadalajara,302,Valdegrudas,57,35,22
19,Guadalajara,303,Valdelcubo,49,35,14
19,Guadalajara,304,Valdenuño Fernández,253,140,113
19,Guadalajara,305,Valdepeñas de la Sierra,168,99,69
19,Guadalajara,306,Valderrebollo,22,12,10
19,Guadalajara,307,Valdesotos,25,16,9
19,Guadalajara,308,Valfermoso de Tajuña,59,41,18
19,Guadalajara,309,Valhermoso,25,12,13
19,Guadalajara,310,Valtablado del Río,8,5,3
19,Guadalajara,311,Valverde de los Arroyos,82,44,38
19,Guadalajara,314,Viana de Jadraque,48,32,16
19,Guadalajara,317,Villanueva de Alcorón,162,89,73
19,Guadalajara,318,Villanueva de Argecilla,29,19,10
19,Guadalajara,319,Villanueva de la Torre,6568,3298,3270
19,Guadalajara,321,Villares de Jadraque,47,30,17
19,Guadalajara,322,Villaseca de Henares,27,13,14
19,Guadalajara,323,Villaseca de Uceda,36,21,15
19,Guadalajara,324,Villel de Mesa,185,103,82
19,Guadalajara,325,Viñuelas,137,70,67
19,Guadalajara,326,Yebes,3518,1836,1682
19,Guadalajara,327,Yebra,444,236,208
19,Guadalajara,329,Yélamos de Abajo,63,33,30
19,Guadalajara,330,Yélamos de Arriba,77,46,31
19,Guadalajara,331,Yunquera de Henares,3937,1995,1942
19,Guadalajara,332,"Yunta, La",86,50,36
19,Guadalajara,333,Zaorejas,125,82,43
19,Guadalajara,334,Zarzuela de Jadraque,37,21,16
19,Guadalajara,335,Zorita de los Canes,70,36,34
21,Huelva,1,Alájar,763,385,378
21,Huelva,2,Aljaraque,21054,10466,10588
21,Huelva,3,"Almendro, El",837,439,398
21,Huelva,4,Almonaster la Real,1837,984,853
21,Huelva,5,Almonte,24013,11642,12371
21,Huelva,6,Alosno,3942,1926,2016
21,Huelva,7,Aracena,8040,3959,4081
21,Huelva,8,Aroche,3109,1553,1556
21,Huelva,9,Arroyomolinos de León,965,502,463
21,Huelva,10,Ayamonte,20883,10483,10400
21,Huelva,11,Beas,4236,2135,2101
21,Huelva,12,Berrocal,319,160,159
21,Huelva,13,Bollullos Par del Condado,14114,7016,7098
21,Huelva,14,Bonares,6060,3017,3043
21,Huelva,15,Cabezas Rubias,741,387,354
21,Huelva,16,Cala,1184,600,584
21,Huelva,17,Calañas,4077,2068,2009
21,Huelva,18,"Campillo, El",2036,986,1050
21,Huelva,19,Campofrío,702,356,346
21,Huelva,20,Cañaveral de León,411,209,202
21,Huelva,21,Cartaya,19433,9974,9459
21,Huelva,22,Castaño del Robledo,209,118,91
21,Huelva,23,"Cerro de Andévalo, El",2389,1187,1202
21,Huelva,30,Chucena,2232,1136,1096
21,Huelva,24,Corteconcepción,543,274,269
21,Huelva,25,Cortegana,4735,2406,2329
21,Huelva,26,Cortelazor,305,147,158
21,Huelva,27,Cumbres de Enmedio,57,34,23
21,Huelva,28,Cumbres de San Bartolomé,373,186,187
21,Huelva,29,Cumbres Mayores,1785,882,903
21,Huelva,31,Encinasola,1332,669,663
21,Huelva,32,Escacena del Campo,2278,1109,1169
21,Huelva,33,Fuenteheridos,623,314,309
21,Huelva,34,Galaroza,1401,685,716
21,Huelva,35,Gibraleón,12548,6259,6289
21,Huelva,36,"Granada de Río-Tinto, La",235,123,112
21,Huelva,37,"Granado, El",519,277,242
21,Huelva,38,Higuera de la Sierra,1293,666,627
21,Huelva,39,Hinojales,307,151,156
21,Huelva,40,Hinojos,3909,1962,1947
21,Huelva,41,Huelva,144258,69336,74922
21,Huelva,42,Isla Cristina,21077,10540,10537
21,Huelva,43,Jabugo,2258,1136,1122
21,Huelva,44,Lepe,27047,13951,13096
21,Huelva,45,Linares de la Sierra,262,129,133
21,Huelva,46,Lucena del Puerto,3395,1778,1617
21,Huelva,47,Manzanilla,2079,1056,1023
21,Huelva,48,"Marines, Los",402,215,187
21,Huelva,49,Minas de Riotinto,3866,1870,1996
21,Huelva,50,Moguer,21699,10862,10837
21,Huelva,51,"Nava, La",253,132,121
21,Huelva,52,Nerva,5303,2555,2748
21,Huelva,53,Niebla,4103,2071,2032
21,Huelva,54,"Palma del Condado, La",10762,5357,5405
21,Huelva,55,Palos de la Frontera,11112,5613,5499
21,Huelva,56,Paterna del Campo,3484,1760,1724
21,Huelva,57,Paymogo,1167,590,577
21,Huelva,58,Puebla de Guzmán,3142,1612,1530
21,Huelva,59,Puerto Moral,281,138,143
21,Huelva,60,Punta Umbría,15134,7715,7419
21,Huelva,61,Rociana del Condado,7751,3927,3824
21,Huelva,62,Rosal de la Frontera,1707,849,858
21,Huelva,63,San Bartolomé de la Torre,3679,1828,1851
21,Huelva,64,San Juan del Puerto,9198,4635,4563
21,Huelva,66,San Silvestre de Guzmán,607,316,291
21,Huelva,65,Sanlúcar de Guadiana,396,196,200
21,Huelva,67,Santa Ana la Real,480,229,251
21,Huelva,68,Santa Bárbara de Casa,1054,519,535
21,Huelva,69,Santa Olalla del Cala,2004,1039,965
21,Huelva,70,Trigueros,7782,3868,3914
21,Huelva,71,Valdelarco,243,112,131
21,Huelva,72,Valverde del Camino,12780,6285,6495
21,Huelva,73,Villablanca,2839,1398,1441
21,Huelva,74,Villalba del Alcor,3283,1623,1660
21,Huelva,75,Villanueva de las Cruces,382,180,202
21,Huelva,76,Villanueva de los Castillejos,2761,1383,1378
21,Huelva,77,Villarrasa,2152,1083,1069
21,Huelva,78,Zalamea la Real,3090,1563,1527
21,Huelva,79,Zufre,831,432,399
22,Huesca,1,Abiego,237,124,113
22,Huesca,2,Abizanda,151,76,75
22,Huesca,3,Adahuesca,172,91,81
22,Huesca,4,Agüero,130,78,52
22,Huesca,907,Aínsa-Sobrarbe,2151,1084,1067
22,Huesca,6,Aisa,321,174,147
22,Huesca,7,Albalate de Cinca,1102,586,516
22,Huesca,8,Albalatillo,181,102,79
22,Huesca,9,Albelda,721,376,345
22,Huesca,11,Albero Alto,105,63,42
22,Huesca,12,Albero Bajo,141,76,65
22,Huesca,13,Alberuela de Tubo,309,158,151
22,Huesca,14,Alcalá de Gurrea,246,130,116
22,Huesca,15,Alcalá del Obispo,325,179,146
22,Huesca,16,Alcampell,652,320,332
22,Huesca,17,Alcolea de Cinca,1160,614,546
22,Huesca,18,Alcubierre,363,194,169
22,Huesca,19,Alerre,201,101,100
22,Huesca,20,Alfántega,127,66,61
22,Huesca,21,Almudévar,2394,1228,1166
22,Huesca,22,Almunia de San Juan,654,338,316
22,Huesca,23,Almuniente,471,236,235
22,Huesca,24,Alquézar,296,158,138
22,Huesca,25,Altorricón,1409,743,666
22,Huesca,27,Angüés,367,196,171
22,Huesca,28,Ansó,431,217,214
22,Huesca,29,Antillón,149,75,74
22,Huesca,32,Aragüés del Puerto,116,64,52
22,Huesca,35,Arén,318,173,145
22,Huesca,36,Argavieso,96,56,40
22,Huesca,37,Arguis,129,70,59
22,Huesca,39,Ayerbe,1041,516,525
22,Huesca,40,Azanuy-Alins,176,83,93
22,Huesca,41,Azara,174,85,89
22,Huesca,42,Azlor,153,70,83
22,Huesca,43,Baélls,104,59,45
22,Huesca,44,Bailo,279,166,113
22,Huesca,45,Baldellou,77,44,33
22,Huesca,46,Ballobar,823,424,399
22,Huesca,47,Banastás,292,153,139
22,Huesca,48,Barbastro,16944,8236,8708
22,Huesca,49,Barbués,77,44,33
22,Huesca,50,Barbuñales,95,49,46
22,Huesca,51,Bárcabo,105,59,46
22,Huesca,52,Belver de Cinca,1292,733,559
22,Huesca,53,Benabarre,1107,569,538
22,Huesca,54,Benasque,2157,1150,1007
22,Huesca,246,Beranuy,78,46,32
22,Huesca,55,Berbegal,345,177,168
22,Huesca,57,Bielsa,476,254,222
22,Huesca,58,Bierge,231,130,101
22,Huesca,59,Biescas,1479,776,703
22,Huesca,60,Binaced,1555,828,727
22,Huesca,61,Binéfar,9435,4935,4500
22,Huesca,62,Bisaurri,181,98,83
22,Huesca,63,Biscarrués,189,102,87
22,Huesca,64,Blecua y Torres,183,104,79
22,Huesca,66,Boltaña,986,534,452
22,Huesca,67,Bonansa,86,50,36
22,Huesca,68,Borau,80,48,32
22,Huesca,69,Broto,531,301,230
22,Huesca,72,Caldearenas,218,129,89
22,Huesca,74,Campo,323,171,152
22,Huesca,75,Camporrélls,137,72,65
22,Huesca,76,Canal de Berdún,321,178,143
22,Huesca,77,Candasnos,317,168,149
22,Huesca,78,Canfranc,532,294,238
22,Huesca,79,Capdesaso,174,77,97
22,Huesca,80,Capella,354,186,168
22,Huesca,81,Casbas de Huesca,269,145,124
22,Huesca,83,Castejón de Monegros,531,284,247
22,Huesca,84,Castejón de Sos,753,387,366
22,Huesca,82,Castejón del Puente,315,164,151
22,Huesca,85,Castelflorite,108,58,50
22,Huesca,86,Castiello de Jaca,267,140,127
22,Huesca,87,Castigaleu,86,51,35
22,Huesca,88,Castillazuelo,169,85,84
22,Huesca,89,Castillonroy,312,167,145
22,Huesca,94,Chalamera,108,55,53
22,Huesca,95,Chía,86,54,32
22,Huesca,96,Chimillas,391,200,191
22,Huesca,90,Colungo,114,64,50
22,Huesca,99,Esplús,541,266,275
22,Huesca,102,Estada,204,117,87
22,Huesca,103,Estadilla,794,383,411
22,Huesca,105,Estopiñán del Castillo,126,69,57
22,Huesca,106,Fago,23,12,11
22,Huesca,107,Fanlo,97,61,36
22,Huesca,109,Fiscal,327,182,145
22,Huesca,110,Fonz,870,432,438
22,Huesca,111,Foradada del Toscar,173,92,81
22,Huesca,112,Fraga,14979,7594,7385
22,Huesca,113,"Fueva, La",597,314,283
22,Huesca,114,Gistaín,149,81,68
22,Huesca,115,"Grado, El",426,228,198
22,Huesca,116,Grañén,1753,907,846
22,Huesca,117,Graus,3305,1617,1688
22,Huesca,119,Gurrea de Gállego,1476,755,721
22,Huesca,122,Hoz de Jaca,76,37,39
22,Huesca,908,Hoz y Costean,226,131,95
22,Huesca,124,Huerto,218,118,100
22,Huesca,125,Huesca,52463,25023,27440
22,Huesca,126,Ibieca,97,55,42
22,Huesca,127,Igriés,705,366,339
22,Huesca,128,Ilche,212,110,102
22,Huesca,129,Isábena,238,126,112
22,Huesca,130,Jaca,12813,6302,6511
22,Huesca,131,Jasa,92,53,39
22,Huesca,133,Labuerda,162,91,71
22,Huesca,135,Laluenga,194,103,91
22,Huesca,136,Lalueza,913,475,438
22,Huesca,137,Lanaja,1202,637,565
22,Huesca,139,Laperdiguera,91,48,43
22,Huesca,141,Lascellas-Ponzano,126,80,46
22,Huesca,142,Lascuarre,136,70,66
22,Huesca,143,Laspaúles,230,134,96
22,Huesca,144,Laspuña,291,160,131
22,Huesca,149,Loarre,331,184,147
22,Huesca,150,Loporzano,522,296,226
22,Huesca,151,Loscorrales,106,52,54
22,Huesca,905,Lupiñén-Ortilla,341,171,170
22,Huesca,155,Monesma y Cajigar,73,39,34
22,Huesca,156,Monflorite-Lascasas,403,220,183
22,Huesca,157,Montanuy,215,121,94
22,Huesca,158,Monzón,17061,8614,8447
22,Huesca,160,Naval,269,141,128
22,Huesca,162,Novales,155,75,80
22,Huesca,163,Nueno,532,292,240
22,Huesca,164,Olvena,50,24,26
22,Huesca,165,Ontiñena,533,269,264
22,Huesca,167,Osso de Cinca,687,377,310
22,Huesca,168,Palo,27,14,13
22,Huesca,170,Panticosa,786,404,382
22,Huesca,172,Peñalba,622,315,307
22,Huesca,173,"Peñas de Riglos, Las",251,158,93
22,Huesca,174,Peralta de Alcofea,562,295,267
22,Huesca,175,Peralta de Calasanz,219,125,94
22,Huesca,176,Peraltilla,199,99,100
22,Huesca,177,Perarrúa,109,58,51
22,Huesca,178,Pertusa,110,63,47
22,Huesca,181,Piracés,98,54,44
22,Huesca,182,Plan,287,145,142
22,Huesca,184,Poleñino,200,108,92
22,Huesca,186,Pozán de Vero,218,104,114
22,Huesca,187,"Puebla de Castro, La",372,185,187
22,Huesca,188,Puente de Montañana,93,40,53
22,Huesca,902,Puente la Reina de Jaca,260,130,130
22,Huesca,189,Puértolas,215,121,94
22,Huesca,190,"Pueyo de Araguás, El",154,89,65
22,Huesca,193,Pueyo de Santa Cruz,314,158,156
22,Huesca,195,Quicena,283,138,145
22,Huesca,197,Robres,541,274,267
22,Huesca,199,Sabiñánigo,9245,4621,4624
22,Huesca,200,Sahún,294,153,141
22,Huesca,201,Salas Altas,308,159,149
22,Huesca,202,Salas Bajas,167,81,86
22,Huesca,203,Salillas,96,54,42
22,Huesca,204,Sallent de Gállego,1463,728,735
22,Huesca,205,San Esteban de Litera,506,257,249
22,Huesca,207,San Juan de Plan,152,86,66
22,Huesca,903,San Miguel del Cinca,813,419,394
22,Huesca,206,Sangarrén,219,118,101
22,Huesca,208,Santa Cilia,231,124,107
22,Huesca,209,Santa Cruz de la Serós,180,109,71
22,Huesca,906,Santa María de Dulcis,208,112,96
22,Huesca,212,Santaliestra y San Quílez,81,43,38
22,Huesca,213,Sariñena,4168,2167,2001
22,Huesca,214,Secastilla,146,67,79
22,Huesca,215,Seira,150,83,67
22,Huesca,217,Sena,489,261,228
22,Huesca,218,Senés de Alcubierre,41,20,21
22,Huesca,220,Sesa,167,94,73
22,Huesca,221,Sesué,127,68,59
22,Huesca,222,Siétamo,664,366,298
22,Huesca,223,Sopeira,94,50,44
22,Huesca,904,"Sotonera, La",894,472,422
22,Huesca,225,Tamarite de Litera,3528,1819,1709
22,Huesca,226,Tardienta,952,474,478
22,Huesca,227,Tella-Sin,226,126,100
22,Huesca,228,Tierz,758,378,380
22,Huesca,229,Tolva,123,67,56
22,Huesca,230,Torla-Ordesa,298,155,143
22,Huesca,232,Torralba de Aragón,103,57,46
22,Huesca,233,Torre la Ribera,102,54,48
22,Huesca,234,Torrente de Cinca,1148,577,571
22,Huesca,235,Torres de Alcanadre,92,56,36
22,Huesca,236,Torres de Barbués,266,134,132
22,Huesca,239,Tramaced,99,62,37
22,Huesca,242,Valfarta,69,43,26
22,Huesca,243,Valle de Bardají,34,20,14
22,Huesca,901,Valle de Hecho,839,442,397
22,Huesca,244,Valle de Lierp,46,23,23
22,Huesca,245,Velilla de Cinca,463,244,219
22,Huesca,909,Vencillón,399,210,189
22,Huesca,247,Viacamp y Litera,36,24,12
22,Huesca,248,Vicién,116,68,48
22,Huesca,249,Villanova,159,79,80
22,Huesca,250,Villanúa,447,237,210
22,Huesca,251,Villanueva de Sigena,394,199,195
22,Huesca,252,Yebra de Basa,147,85,62
22,Huesca,253,Yésero,60,36,24
22,Huesca,254,Zaidín,1774,939,835
23,Jaén,1,Albanchez de Mágina,1027,536,491
23,Jaén,2,Alcalá la Real,21708,10678,11030
23,Jaén,3,Alcaudete,10558,5193,5365
23,Jaén,4,Aldeaquemada,501,270,231
23,Jaén,5,Andújar,37113,18179,18934
23,Jaén,6,Arjona,5595,2756,2839
23,Jaén,7,Arjonilla,3610,1820,1790
23,Jaén,8,Arquillos,1767,884,883
23,Jaén,905,Arroyo del Ojanco,2323,1182,1141
23,Jaén,9,Baeza,15902,7898,8004
23,Jaén,10,Bailén,17820,8842,8978
23,Jaén,11,Baños de la Encina,2611,1343,1268
23,Jaén,12,Beas de Segura,5191,2700,2491
23,Jaén,902,Bedmar y Garcíez,2682,1342,1340
23,Jaén,14,Begíjar,3075,1550,1525
23,Jaén,15,Bélmez de la Moraleda,1567,789,778
23,Jaén,16,Benatae,457,238,219
23,Jaén,17,Cabra del Santo Cristo,1840,965,875
23,Jaén,18,Cambil,2739,1427,1312
23,Jaén,19,Campillo de Arenas,1784,919,865
23,Jaén,20,Canena,1882,963,919
23,Jaén,21,Carboneros,606,313,293
23,Jaén,901,Cárcheles,1373,717,656
23,Jaén,24,"Carolina, La",15306,7569,7737
23,Jaén,25,Castellar,3364,1697,1667
23,Jaén,26,Castillo de Locubín,4120,2038,2082
23,Jaén,27,Cazalilla,829,410,419
23,Jaén,28,Cazorla,7574,3690,3884
23,Jaén,29,Chiclana de Segura,962,491,471
23,Jaén,30,Chilluévar,1459,704,755
23,Jaén,31,Escañuela,949,472,477
23,Jaén,32,Espeluy,643,317,326
23,Jaén,33,Frailes,1592,799,793
23,Jaén,34,Fuensanta de Martos,3086,1531,1555
23,Jaén,35,Fuerte del Rey,1387,715,672
23,Jaén,37,Génave,614,332,282
23,Jaén,38,"Guardia de Jaén, La",4965,2527,2438
23,Jaén,39,Guarromán,2779,1395,1384
23,Jaén,41,Higuera de Calatrava,616,329,287
23,Jaén,42,Hinojares,335,175,160
23,Jaén,43,Hornos,620,312,308
23,Jaén,44,Huelma,5845,2905,2940
23,Jaén,45,Huesa,2527,1270,1257
23,Jaén,46,Ibros,2884,1448,1436
23,Jaén,47,"Iruela, La",1935,964,971
23,Jaén,48,Iznatoraf,995,514,481
23,Jaén,49,Jabalquinto,2070,1042,1028
23,Jaén,50,Jaén,113457,54533,58924
23,Jaén,51,Jamilena,3327,1684,1643
23,Jaén,52,Jimena,1286,622,664
23,Jaén,53,Jódar,11805,5877,5928
23,Jaén,40,Lahiguera,1742,852,890
23,Jaén,54,Larva,482,244,238
23,Jaén,55,Linares,57811,28279,29532
23,Jaén,56,Lopera,3673,1849,1824
23,Jaén,57,Lupión,852,415,437
23,Jaén,58,Mancha Real,11322,5627,5695
23,Jaén,59,Marmolejo,6877,3429,3448
23,Jaén,60,Martos,24207,12006,12201
23,Jaén,61,Mengíbar,9927,4941,4986
23,Jaén,62,Montizón,1716,882,834
23,Jaén,63,Navas de San Juan,4555,2280,2275
23,Jaén,64,Noalejo,1948,983,965
23,Jaén,65,Orcera,1835,928,907
23,Jaén,66,Peal de Becerro,5277,2607,2670
23,Jaén,67,Pegalajar,2916,1464,1452
23,Jaén,69,Porcuna,6283,3171,3112
23,Jaén,70,Pozo Alcón,4708,2391,2317
23,Jaén,71,Puente de Génave,2179,1091,1088
23,Jaén,72,"Puerta de Segura, La",2339,1163,1176
23,Jaén,73,Quesada,5303,2689,2614
23,Jaén,74,Rus,3580,1828,1752
23,Jaén,75,Sabiote,3958,1953,2005
23,Jaén,76,Santa Elena,913,483,430
23,Jaén,77,Santiago de Calatrava,697,367,330
23,Jaén,904,Santiago-Pontones,3060,1573,1487
23,Jaén,79,Santisteban del Puerto,4520,2324,2196
23,Jaén,80,Santo Tomé,2154,1079,1075
23,Jaén,81,Segura de la Sierra,1782,876,906
23,Jaén,82,Siles,2262,1134,1128
23,Jaén,84,Sorihuela del Guadalimar,1124,583,541
23,Jaén,85,Torreblascopedro,2564,1297,1267
23,Jaén,86,Torredelcampo,14335,7168,7167
23,Jaén,87,Torredonjimeno,13731,6747,6984
23,Jaén,88,Torreperogil,7286,3554,3732
23,Jaén,90,Torres,1434,720,714
23,Jaén,91,Torres de Albánchez,804,417,387
23,Jaén,92,Úbeda,34602,16960,17642
23,Jaén,93,Valdepeñas de Jaén,3799,1875,1924
23,Jaén,94,Vilches,4519,2274,2245
23,Jaén,95,Villacarrillo,10795,5417,5378
23,Jaén,96,Villanueva de la Reina,3146,1582,1564
23,Jaén,97,Villanueva del Arzobispo,8301,4264,4037
23,Jaén,98,Villardompardo,966,490,476
23,Jaén,99,"Villares, Los",5980,2991,2989
23,Jaén,101,Villarrodrigo,416,221,195
23,Jaén,903,Villatorres,4357,2215,2142
24,León,1,Acebedo,202,117,85
24,León,2,Algadefe,286,145,141
24,León,3,Alija del Infantado,671,338,333
24,León,4,Almanza,558,321,237
24,León,5,"Antigua, La",377,220,157
24,León,6,Ardón,533,292,241
24,León,7,Arganza,802,403,399
24,León,8,Astorga,11029,5204,5825
24,León,9,Balboa,308,166,142
24,León,10,"Bañeza, La",10307,4976,5331
24,León,11,Barjas,194,108,86
24,León,12,"Barrios de Luna, Los",313,178,135
24,León,14,Bembibre,8979,4372,4607
24,León,15,Benavides,2497,1228,1269
24,León,16,Benuza,489,279,210
24,León,17,Bercianos del Páramo,580,297,283
24,León,18,Bercianos del Real Camino,193,97,96
24,León,19,Berlanga del Bierzo,360,169,191
24,León,20,Boca de Huérgano,475,281,194
24,León,21,Boñar,1850,942,908
24,León,22,Borrenes,319,169,150
24,León,23,Brazuelo,287,154,133
24,León,24,"Burgo Ranero, El",733,388,345
24,León,25,Burón,304,177,127
24,León,26,Bustillo del Páramo,1184,610,574
24,León,27,Cabañas Raras,1330,688,642
24,León,28,Cabreros del Río,412,226,186
24,León,29,Cabrillanes,775,404,371
24,León,30,Cacabelos,5132,2551,2581
24,León,31,Calzada del Coto,231,134,97
24,León,32,Campazas,123,55,68
24,León,33,Campo de Villavidel,203,112,91
24,León,34,Camponaraya,4062,2018,2044
24,León,36,Candín,273,149,124
24,León,37,Cármenes,357,197,160
24,León,38,Carracedelo,3472,1728,1744
24,León,39,Carrizo,2269,1146,1123
24,León,40,Carrocera,465,250,215
24,León,41,Carucedo,557,283,274
24,León,42,Castilfalé,65,38,27
24,León,43,Castrillo de Cabrera,122,71,51
24,León,44,Castrillo de la Valduerna,164,72,92
24,León,46,Castrocalbón,979,504,475
24,León,47,Castrocontrigo,794,423,371
24,León,49,Castropodame,1658,851,807
24,León,50,Castrotierra de Valmadrigal,113,59,54
24,León,51,Cea,426,221,205
24,León,52,Cebanico,153,94,59
24,León,53,Cebrones del Río,461,251,210
24,León,65,Chozas de Abajo,2564,1344,1220
24,León,54,Cimanes de la Vega,472,244,228
24,León,55,Cimanes del Tejar,740,396,344
24,León,56,Cistierna,3150,1555,1595
24,León,57,Congosto,1533,767,766
24,León,58,Corbillos de los Oteros,209,119,90
24,León,59,Corullón,914,468,446
24,León,60,Crémenes,544,290,254
24,León,61,Cuadros,2018,1027,991
24,León,62,Cubillas de los Oteros,147,84,63
24,León,63,Cubillas de Rueda,404,214,190
24,León,64,Cubillos del Sil,1839,973,866
24,León,66,Destriana,495,235,260
24,León,67,Encinedo,686,358,328
24,León,68,"Ercina, La",462,241,221
24,León,69,Escobar de Campos,42,24,18
24,León,70,Fabero,4551,2230,2321
24,León,71,Folgoso de la Ribera,1108,539,569
24,León,73,Fresno de la Vega,500,258,242
24,León,74,Fuentes de Carbajal,95,49,46
24,León,76,Garrafe de Torío,1475,807,668
24,León,77,Gordaliza del Pino,244,119,125
24,León,78,Gordoncillo,406,206,200
24,León,79,Gradefes,944,514,430
24,León,80,Grajal de Campos,223,108,115
24,León,81,Gusendos de los Oteros,128,66,62
24,León,82,Hospital de Órbigo,987,497,490
24,León,83,Igüeña,1142,593,549
24,León,84,Izagre,174,86,88
24,León,86,Joarilla de las Matas,298,159,139
24,León,87,Laguna Dalga,666,356,310
24,León,88,Laguna de Negrillos,1066,549,517
24,León,89,León,124772,56536,68236
24,León,92,Llamas de la Ribera,831,432,399
24,León,90,Lucillo,383,201,182
24,León,91,Luyego,645,341,304
24,León,93,Magaz de Cepeda,362,187,175
24,León,94,Mansilla de las Mulas,1743,875,868
24,León,95,Mansilla Mayor,333,179,154
24,León,96,Maraña,118,70,48
24,León,97,Matadeón de los Oteros,232,123,109
24,León,98,Matallana de Torío,1306,687,619
24,León,99,Matanza,175,92,83
24,León,100,Molinaseca,872,480,392
24,León,101,Murias de Paredes,395,196,199
24,León,102,Noceda del Bierzo,680,344,336
24,León,103,Oencia,278,164,114
24,León,104,"Omañas, Las",271,147,124
24,León,105,Onzonilla,1835,945,890
24,León,106,Oseja de Sajambre,240,138,102
24,León,107,Pajares de los Oteros,279,169,110
24,León,108,Palacios de la Valduerna,382,185,197
24,León,109,Palacios del Sil,989,526,463
24,León,110,Páramo del Sil,1293,662,631
24,León,112,Peranzanes,317,185,132
24,León,113,Pobladura de Pelayo García,382,197,185
24,León,114,"Pola de Gordón, La",3325,1689,1636
24,León,115,Ponferrada,65239,31021,34218
24,León,116,Posada de Valdeón,433,253,180
24,León,117,Pozuelo del Páramo,439,221,218
24,León,118,Prado de la Guzpeña,122,68,54
24,León,119,Priaranza del Bierzo,793,404,389
24,León,120,Prioro,355,205,150
24,León,121,Puebla de Lillo,671,379,292
24,León,122,Puente de Domingo Flórez,1511,789,722
24,León,123,Quintana del Castillo,748,415,333
24,León,124,Quintana del Marco,381,208,173
24,León,125,Quintana y Congosto,354,178,176
24,León,127,Regueras de Arriba,293,159,134
24,León,129,Reyero,123,67,56
24,León,130,Riaño,474,277,197
24,León,131,Riego de la Vega,772,410,362
24,León,132,Riello,622,352,270
24,León,133,Rioseco de Tapia,379,209,170
24,León,134,"Robla, La",3884,1935,1949
24,León,136,Roperuelos del Páramo,550,278,272
24,León,137,Sabero,1161,589,572
24,León,139,Sahagún,2517,1237,1280
24,León,141,San Adrián del Valle,106,59,47
24,León,142,San Andrés del Rabanedo,30820,14748,16072
24,León,144,San Cristóbal de la Polantera,716,365,351
24,León,145,San Emiliano,665,362,303
24,León,146,San Esteban de Nogales,261,134,127
24,León,148,San Justo de la Vega,1875,964,911
24,León,149,San Millán de los Caballeros,168,88,80
24,León,150,San Pedro Bercianos,237,128,109
24,León,143,Sancedo,561,278,283
24,León,151,Santa Colomba de Curueño,490,261,229
24,León,152,Santa Colomba de Somoza,504,273,231
24,León,153,Santa Cristina de Valmadrigal,273,142,131
24,León,154,Santa Elena de Jamuz,1092,568,524
24,León,155,Santa María de la Isla,492,257,235
24,León,158,Santa María de Ordás,326,170,156
24,León,156,Santa María del Monte de Cea,233,129,104
24,León,157,Santa María del Páramo,3096,1521,1575
24,León,159,Santa Marina del Rey,1939,967,972
24,León,160,Santas Martas,757,401,356
24,León,161,Santiago Millas,334,186,148
24,León,162,Santovenia de la Valdoncina,2108,1068,1040
24,León,163,Sariegos,5040,2511,2529
24,León,164,Sena de Luna,385,191,194
24,León,165,Sobrado,324,162,162
24,León,166,Soto de la Vega,1557,813,744
24,León,167,Soto y Amío,801,414,387
24,León,168,Toral de los Guzmanes,508,276,232
24,León,206,Toral de los Vados,1887,928,959
24,León,169,Toreno,3157,1569,1588
24,León,170,Torre del Bierzo,2162,1102,1060
24,León,171,Trabadelo,353,199,154
24,León,172,Truchas,413,213,200
24,León,173,Turcia,1005,510,495
24,León,174,Urdiales del Páramo,503,267,236
24,León,185,Val de San Lorenzo,515,256,259
24,León,175,Valdefresno,2177,1117,1060
24,León,176,Valdefuentes del Páramo,335,176,159
24,León,177,Valdelugueros,509,289,220
24,León,178,Valdemora,73,33,40
24,León,179,Valdepiélago,337,196,141
24,León,180,Valdepolo,1224,652,572
24,León,181,Valderas,1661,854,807
24,León,182,Valderrey,436,214,222
24,León,183,Valderrueda,853,445,408
24,León,184,Valdesamario,196,109,87
24,León,187,Valdevimbre,1003,528,475
24,León,188,Valencia de Don Juan,5302,2593,2709
24,León,191,Vallecillo,124,76,48
24,León,189,Valverde de la Virgen,7294,3768,3526
24,León,190,Valverde-Enrique,159,81,78
24,León,193,"Vecilla, La",393,209,184
24,León,196,Vega de Espinareda,2137,1080,1057
24,León,197,Vega de Infanzones,854,434,420
24,León,198,Vega de Valcarce,604,314,290
24,León,194,Vegacervera,284,147,137
24,León,199,Vegaquemada,437,241,196
24,León,201,Vegas del Condado,1117,650,467
24,León,202,Villablino,8919,4383,4536
24,León,203,Villabraz,93,55,38
24,León,205,Villadangos del Páramo,1094,562,532
24,León,207,Villademor de la Vega,336,183,153
24,León,209,Villafranca del Bierzo,2974,1430,1544
24,León,210,Villagatón,588,319,269
24,León,211,Villamandos,308,170,138
24,León,901,Villamanín,936,480,456
24,León,212,Villamañán,1155,566,589
24,León,213,Villamartín de Don Sancho,152,87,65
24,León,214,Villamejil,696,370,326
24,León,215,Villamol,162,82,80
24,León,216,Villamontán de la Valduerna,736,386,350
24,León,217,Villamoratiel de las Matas,158,90,68
24,León,218,Villanueva de las Manzanas,485,256,229
24,León,219,Villaobispo de Otero,563,307,256
24,León,902,Villaornate y Castro,371,185,186
24,León,221,Villaquejida,896,455,441
24,León,222,Villaquilambre,18676,9223,9453
24,León,223,Villarejo de Órbigo,3001,1470,1531
24,León,224,Villares de Órbigo,615,323,292
24,León,225,Villasabariego,1135,601,534
24,León,226,Villaselán,196,111,85
24,León,227,Villaturiel,1877,981,896
24,León,228,Villazala,673,358,315
24,León,229,Villazanzo de Valderaduey,429,250,179
24,León,230,Zotes del Páramo,439,242,197
25,Lleida,1,Abella de la Conca,181,99,82
25,Lleida,2,Àger,611,324,287
25,Lleida,3,Agramunt,5393,2700,2693
25,Lleida,38,Aitona,2545,1328,1217
25,Lleida,4,"Alamús, Els",796,421,375
25,Lleida,5,Alàs i Cerc,342,174,168
25,Lleida,6,"Albagés, L'",375,199,176
25,Lleida,7,Albatàrrec,2335,1205,1130
25,Lleida,8,Albesa,1576,862,714
25,Lleida,9,"Albi, L'",762,393,369
25,Lleida,10,Alcanó,232,118,114
25,Lleida,11,Alcarràs,9422,4876,4546
25,Lleida,12,Alcoletge,3419,1772,1647
25,Lleida,13,Alfarràs,2822,1480,1342
25,Lleida,14,Alfés,313,163,150
25,Lleida,15,Algerri,399,216,183
25,Lleida,16,Alguaire,2937,1552,1385
25,Lleida,17,Alins,290,153,137
25,Lleida,19,Almacelles,6789,3554,3235
25,Lleida,20,Almatret,314,174,140
25,Lleida,21,Almenar,3453,1824,1629
25,Lleida,22,Alòs de Balaguer,131,77,54
25,Lleida,23,Alpicat,6230,3129,3101
25,Lleida,24,Alt Àneu,406,228,178
25,Lleida,27,Anglesola,1328,670,658
25,Lleida,29,Arbeca,2162,1101,1061
25,Lleida,31,Arres,63,40,23
25,Lleida,32,Arsèguel,85,48,37
25,Lleida,33,Artesa de Lleida,1538,804,734
25,Lleida,34,Artesa de Segre,3447,1770,1677
25,Lleida,36,Aspa,217,109,108
25,Lleida,37,"Avellanes i Santa Linya, Les",455,261,194
25,Lleida,39,Baix Pallars,330,175,155
25,Lleida,40,Balaguer,16841,8519,8322
25,Lleida,41,Barbens,939,505,434
25,Lleida,42,"Baronia de Rialb, La",231,121,110
25,Lleida,44,Bassella,231,113,118
25,Lleida,45,Bausen,64,34,30
25,Lleida,46,Belianes,525,265,260
25,Lleida,170,Bellaguarda,301,160,141
25,Lleida,47,Bellcaire d'Urgell,1252,634,618
25,Lleida,48,Bell-lloc d'Urgell,2289,1129,1160
25,Lleida,49,Bellmunt d'Urgell,193,94,99
25,Lleida,50,Bellpuig,5060,2635,2425
25,Lleida,51,Bellver de Cerdanya,1979,1021,958
25,Lleida,52,Bellvís,2266,1149,1117
25,Lleida,53,Benavent de Segrià,1468,768,700
25,Lleida,55,Biosca,181,97,84
25,Lleida,57,"Bòrdes, Es",266,145,121
25,Lleida,58,"Borges Blanques, Les",6002,3054,2948
25,Lleida,59,Bossòst,1110,544,566
25,Lleida,56,Bovera,257,139,118
25,Lleida,60,Cabanabona,76,33,43
25,Lleida,61,Cabó,97,52,45
25,Lleida,62,Camarasa,842,432,410
25,Lleida,63,Canejan,84,48,36
25,Lleida,904,Castell de Mur,165,91,74
25,Lleida,64,Castellar de la Ribera,137,70,67
25,Lleida,67,Castelldans,931,502,429
25,Lleida,68,Castellnou de Seana,687,361,326
25,Lleida,69,Castelló de Farfanya,538,290,248
25,Lleida,70,Castellserà,1000,496,504
25,Lleida,71,Cava,46,28,18
25,Lleida,72,Cervera,9066,4594,4472
25,Lleida,73,Cervià de les Garrigues,648,345,303
25,Lleida,74,Ciutadilla,206,109,97
25,Lleida,75,Clariana de Cardener,147,74,73
25,Lleida,76,"Cogul, El",161,88,73
25,Lleida,77,Coll de Nargó,549,284,265
25,Lleida,163,"Coma i la Pedra, La",265,160,105
25,Lleida,161,Conca de Dalt,428,220,208
25,Lleida,78,Corbins,1431,777,654
25,Lleida,79,Cubells,358,184,174
25,Lleida,81,"Espluga Calba, L'",357,181,176
25,Lleida,82,Espot,352,190,162
25,Lleida,88,Estamariu,119,69,50
25,Lleida,85,Estaràs,160,85,75
25,Lleida,86,Esterri d'Àneu,756,363,393
25,Lleida,87,Esterri de Cardós,69,36,33
25,Lleida,89,Farrera,122,69,53
25,Lleida,908,Fígols i Alinyà,253,141,112
25,Lleida,92,"Floresta, La",154,83,71
25,Lleida,93,Fondarella,792,388,404
25,Lleida,94,Foradada,173,103,70
25,Lleida,96,"Fuliola, La",1217,606,611
25,Lleida,97,Fulleda,84,43,41
25,Lleida,98,Gavet de la Conca,274,133,141
25,Lleida,912,Gimenells i el Pla de la Font,1108,587,521
25,Lleida,99,Golmés,1864,937,927
25,Lleida,100,Gósol,209,120,89
25,Lleida,101,"Granadella, La",728,388,340
25,Lleida,102,"Granja d'Escarp, La",956,519,437
25,Lleida,103,Granyanella,140,79,61
25,Lleida,105,Granyena de les Garrigues,144,87,57
25,Lleida,104,Granyena de Segarra,147,76,71
25,Lleida,109,Guimerà,270,146,124
25,Lleida,903,"Guingueta d'Àneu, La",298,160,138
25,Lleida,110,Guissona,7034,3746,3288
25,Lleida,111,Guixers,138,88,50
25,Lleida,115,Isona i Conca Dellà,1028,546,482
25,Lleida,112,Ivars de Noguera,337,174,163
25,Lleida,113,Ivars d'Urgell,1557,817,740
25,Lleida,114,Ivorra,104,57,47
25,Lleida,910,Josa i Tuixén,118,66,52
25,Lleida,118,Juncosa,393,211,182
25,Lleida,119,Juneda,3409,1785,1624
25,Lleida,121,Les,954,480,474
25,Lleida,122,Linyola,2660,1340,1320
25,Lleida,123,Lladorre,227,111,116
25,Lleida,124,Lladurs,179,95,84
25,Lleida,125,Llardecans,460,239,221
25,Lleida,126,Llavorsí,352,171,181
25,Lleida,120,Lleida,137856,68070,69786
25,Lleida,127,Lles de Cerdanya,255,146,109
25,Lleida,128,Llimiana,142,86,56
25,Lleida,129,Llobera,195,107,88
25,Lleida,133,Maials,931,511,420
25,Lleida,130,Maldà,225,115,110
25,Lleida,131,Massalcoreig,585,334,251
25,Lleida,132,Massoteres,232,122,110
25,Lleida,134,Menàrguens,801,450,351
25,Lleida,135,Miralcamp,1347,676,671
25,Lleida,137,Mollerussa,14740,7543,7197
25,Lleida,136,"Molsosa, La",109,54,55
25,Lleida,139,Montellà i Martinet,554,307,247
25,Lleida,140,Montferrer i Castellbò,1074,578,496
25,Lleida,138,Montgai,635,327,308
25,Lleida,142,Montoliu de Lleida,469,236,233
25,Lleida,141,Montoliu de Segarra,190,105,85
25,Lleida,143,Montornès de Segarra,98,46,52
25,Lleida,145,Nalec,93,52,41
25,Lleida,25,Naut Aran,1790,928,862
25,Lleida,146,Navès,291,147,144
25,Lleida,148,Odèn,260,153,107
25,Lleida,149,Oliana,1787,900,887
25,Lleida,150,Oliola,202,108,94
25,Lleida,151,Olius,961,508,453
25,Lleida,152,"Oluges, Les",172,90,82
25,Lleida,153,"Omellons, Els",212,114,98
25,Lleida,154,"Omells de na Gaia, Els",134,73,61
25,Lleida,155,Organyà,792,396,396
25,Lleida,156,Os de Balaguer,1009,512,497
25,Lleida,157,Ossó de Sió,205,104,101
25,Lleida,158,"Palau d'Anglesola, El",2163,1070,1093
25,Lleida,164,Penelles,462,266,196
25,Lleida,165,Peramola,353,175,178
25,Lleida,166,Pinell de Solsonès,203,119,84
25,Lleida,167,Pinós,298,155,143
25,Lleida,911,"Plans de Sió, Els",507,269,238
25,Lleida,168,"Poal, El",626,325,301
25,Lleida,169,"Pobla de Cérvoles, La",191,107,84
25,Lleida,171,"Pobla de Segur, La",2939,1448,1491
25,Lleida,30,"Pont de Bar, El",171,97,74
25,Lleida,173,"Pont de Suert, El",2216,1107,1109
25,Lleida,172,Ponts,2604,1299,1305
25,Lleida,174,"Portella, La",703,399,304
25,Lleida,175,Prats i Sansor,231,121,110
25,Lleida,176,Preixana,385,198,187
25,Lleida,177,Preixens,428,217,211
25,Lleida,179,Prullans,224,109,115
25,Lleida,180,Puiggròs,272,136,136
25,Lleida,181,Puigverd d'Agramunt,231,131,100
25,Lleida,182,Puigverd de Lleida,1363,700,663
25,Lleida,183,Rialp,663,338,325
25,Lleida,905,Ribera d'Ondara,422,215,207
25,Lleida,185,Ribera d'Urgellet,923,478,445
25,Lleida,186,Riner,261,130,131
25,Lleida,913,Riu de Cerdanya,94,55,39
25,Lleida,189,Rosselló,3130,1571,1559
25,Lleida,190,Salàs de Pallars,324,174,150
25,Lleida,191,Sanaüja,393,206,187
25,Lleida,196,Sant Esteve de la Sarga,129,78,51
25,Lleida,192,Sant Guim de Freixenet,1040,546,494
25,Lleida,197,Sant Guim de la Plana,177,101,76
25,Lleida,193,Sant Llorenç de Morunys,934,457,477
25,Lleida,902,Sant Martí de Riucorb,648,337,311
25,Lleida,194,Sant Ramon,495,262,233
25,Lleida,201,Sarroca de Bellera,120,69,51
25,Lleida,200,Sarroca de Lleida,361,198,163
25,Lleida,202,Senterada,139,80,59
25,Lleida,35,"Sentiu de Sió, La",427,223,204
25,Lleida,204,Seròs,1889,1012,877
25,Lleida,203,"Seu d'Urgell, La",12041,5834,6207
25,Lleida,205,Sidamon,733,385,348
25,Lleida,206,"Soleràs, El",328,175,153
25,Lleida,207,Solsona,9014,4465,4549
25,Lleida,208,Soriguera,399,215,184
25,Lleida,209,Sort,2164,1076,1088
25,Lleida,210,Soses,1764,926,838
25,Lleida,211,Sudanell,851,470,381
25,Lleida,212,Sunyer,355,208,147
25,Lleida,215,Talarn,651,456,195
25,Lleida,216,Talavera,247,142,105
25,Lleida,217,Tàrrega,16795,8323,8472
25,Lleida,218,Tarrés,99,53,46
25,Lleida,219,Tarroja de Segarra,183,100,83
25,Lleida,220,Térmens,1383,705,678
25,Lleida,221,Tírvia,134,66,68
25,Lleida,222,Tiurana,74,38,36
25,Lleida,223,Torà,1244,624,620
25,Lleida,224,"Torms, Els",151,83,68
25,Lleida,225,Tornabous,879,473,406
25,Lleida,227,"Torre de Cabdella, La",747,379,368
25,Lleida,226,Torrebesses,289,153,136
25,Lleida,228,Torrefarrera,4630,2353,2277
25,Lleida,907,Torrefeta i Florejacs,590,316,274
25,Lleida,230,Torregrossa,2190,1124,1066
25,Lleida,231,Torrelameu,742,426,316
25,Lleida,232,Torres de Segre,2307,1195,1112
25,Lleida,233,Torre-serona,386,202,184
25,Lleida,234,Tremp,5824,2847,2977
25,Lleida,43,"Vall de Boí, La",1022,546,476
25,Lleida,901,Vall de Cardós,372,195,177
25,Lleida,238,Vallbona de les Monges,234,123,111
25,Lleida,240,Vallfogona de Balaguer,1884,942,942
25,Lleida,906,"Valls d'Aguilar, Les",272,151,121
25,Lleida,239,"Valls de Valira, Les",803,418,385
25,Lleida,909,"Vansa i Fórnols, La",168,87,81
25,Lleida,242,Verdú,905,434,471
25,Lleida,243,Vielha e Mijaran,5493,2787,2706
25,Lleida,244,Vilagrassa,510,261,249
25,Lleida,245,Vilaller,536,281,255
25,Lleida,247,Vilamòs,159,90,69
25,Lleida,248,Vilanova de Bellpuig,1170,582,588
25,Lleida,254,Vilanova de la Barca,1039,531,508
25,Lleida,249,Vilanova de l'Aguda,202,101,101
25,Lleida,250,Vilanova de Meià,395,225,170
25,Lleida,251,Vilanova de Segrià,945,494,451
25,Lleida,252,Vila-sana,717,358,359
25,Lleida,253,"Vilosell, El",168,85,83
25,Lleida,255,Vinaixa,482,252,230
27,Lugo,1,Abadín,2428,1195,1233
27,Lugo,2,Alfoz,1757,847,910
27,Lugo,3,Antas de Ulla,2008,985,1023
27,Lugo,4,Baleira,1268,672,596
27,Lugo,901,Baralla,2566,1348,1218
27,Lugo,5,Barreiros,2941,1408,1533
27,Lugo,6,Becerreá,2827,1422,1405
27,Lugo,7,Begonte,3037,1527,1510
27,Lugo,8,Bóveda,1503,777,726
27,Lugo,902,Burela,9566,4753,4813
27,Lugo,9,Carballedo,2235,1126,1109
27,Lugo,10,Castro de Rei,5011,2468,2543
27,Lugo,11,Castroverde,2675,1382,1293
27,Lugo,12,Cervantes,1377,788,589
27,Lugo,13,Cervo,4227,2076,2151
27,Lugo,16,Chantada,8324,4024,4300
27,Lugo,14,"Corgo, O",3487,1768,1719
27,Lugo,15,Cospeito,4596,2226,2370
27,Lugo,17,Folgoso do Courel,1018,529,489
27,Lugo,18,"Fonsagrada, A",3589,1867,1722
27,Lugo,19,Foz,10002,4865,5137
27,Lugo,20,Friol,3772,1903,1869
27,Lugo,22,Guitiriz,5505,2739,2766
27,Lugo,23,Guntín,2718,1393,1325
27,Lugo,24,"Incio, O",1609,806,803
27,Lugo,26,Láncara,2637,1338,1299
27,Lugo,27,Lourenzá,2181,1059,1122
27,Lugo,28,Lugo,98025,45456,52569
27,Lugo,29,Meira,1711,852,859
27,Lugo,30,Mondoñedo,3639,1712,1927
27,Lugo,31,Monforte de Lemos,18599,8827,9772
27,Lugo,32,Monterroso,3667,1827,1840
27,Lugo,33,Muras,636,314,322
27,Lugo,34,Navia de Suarna,1103,622,481
27,Lugo,35,Negueira de Muñiz,218,112,106
27,Lugo,37,"Nogais, As",1114,591,523
27,Lugo,38,Ourol,1018,517,501
27,Lugo,39,Outeiro de Rei,5093,2624,2469
27,Lugo,40,Palas de Rei,3414,1731,1683
27,Lugo,41,Pantón,2539,1232,1307
27,Lugo,42,Paradela,1820,916,904
27,Lugo,43,"Páramo, O",1388,693,695
27,Lugo,44,"Pastoriza, A",3056,1543,1513
27,Lugo,45,Pedrafita do Cebreiro,1032,563,469
27,Lugo,47,"Pobra do Brollón, A",1685,842,843
27,Lugo,46,Pol,1616,800,816
27,Lugo,48,"Pontenova, A",2283,1104,1179
27,Lugo,49,Portomarín,1487,767,720
27,Lugo,50,Quiroga,3257,1559,1698
27,Lugo,56,Rábade,1501,755,746
27,Lugo,51,Ribadeo,9900,4733,5167
27,Lugo,52,Ribas de Sil,970,483,487
27,Lugo,53,Ribeira de Piquín,543,278,265
27,Lugo,54,Riotorto,1255,616,639
27,Lugo,55,Samos,1293,691,602
27,Lugo,57,Sarria,13345,6524,6821
27,Lugo,58,"Saviñao, O",3743,1889,1854
27,Lugo,59,Sober,2301,1133,1168
27,Lugo,60,Taboada,2830,1341,1489
27,Lugo,61,Trabada,1121,546,575
27,Lugo,62,Triacastela,643,317,326
27,Lugo,63,"Valadouro, O",2004,963,1041
27,Lugo,64,"Vicedo, O",1723,844,879
27,Lugo,65,Vilalba,14226,6894,7332
27,Lugo,66,Viveiro,15510,7606,7904
27,Lugo,21,Xermade,1841,892,949
27,Lugo,25,Xove,3314,1647,1667
28,Madrid,1,"Acebeda, La",65,35,30
28,Madrid,2,Ajalvir,4559,2374,2185
28,Madrid,3,Alameda del Valle,195,117,78
28,Madrid,4,"Álamo, El",9353,4617,4736
28,Madrid,5,Alcalá de Henares,193751,94359,99392
28,Madrid,6,Alcobendas,116037,55613,60424
28,Madrid,7,Alcorcón,169502,81750,87752
28,Madrid,8,Aldea del Fresno,2698,1408,1290
28,Madrid,9,Algete,20473,10091,10382
28,Madrid,10,Alpedrete,14364,7037,7327
28,Madrid,11,Ambite,601,301,300
28,Madrid,12,Anchuelo,1272,661,611
28,Madrid,13,Aranjuez,59037,28775,30262
28,Madrid,14,Arganda del Rey,54554,27377,27177
28,Madrid,15,Arroyomolinos,30052,15097,14955
28,Madrid,16,"Atazar, El",93,53,40
28,Madrid,17,Batres,1638,840,798
28,Madrid,18,Becerril de la Sierra,5564,2787,2777
28,Madrid,19,Belmonte de Tajo,1627,861,766
28,Madrid,21,"Berrueco, El",741,379,362
28,Madrid,20,Berzosa del Lozoya,198,115,83
28,Madrid,22,Boadilla del Monte,52626,25703,26923
28,Madrid,23,"Boalo, El",7399,3724,3675
28,Madrid,24,Braojos,205,122,83
28,Madrid,25,Brea de Tajo,525,302,223
28,Madrid,26,Brunete,10596,5209,5387
28,Madrid,27,Buitrago del Lozoya,1875,910,965
28,Madrid,28,Bustarviejo,2486,1240,1246
28,Madrid,29,Cabanillas de la Sierra,712,365,347
28,Madrid,30,"Cabrera, La",2613,1281,1332
28,Madrid,31,Cadalso de los Vidrios,3049,1595,1454
28,Madrid,32,Camarma de Esteruelas,7226,3658,3568
28,Madrid,33,Campo Real,6075,3058,3017
28,Madrid,34,Canencia,423,227,196
28,Madrid,35,Carabaña,1905,947,958
28,Madrid,36,Casarrubuelos,3707,1877,1830
28,Madrid,37,Cenicientos,1980,977,1003
28,Madrid,38,Cercedilla,6948,3403,3545
28,Madrid,39,Cervera de Buitrago,149,89,60
28,Madrid,51,Chapinería,2240,1137,1103
28,Madrid,52,Chinchón,5239,2641,2598
28,Madrid,40,Ciempozuelos,24087,12125,11962
28,Madrid,41,Cobeña,7280,3594,3686
28,Madrid,46,Collado Mediano,6781,3358,3423
28,Madrid,47,Collado Villalba,63074,30723,32351
28,Madrid,43,Colmenar de Oreja,7902,4002,3900
28,Madrid,42,Colmenar del Arroyo,1685,881,804
28,Madrid,45,Colmenar Viejo,49498,24456,25042
28,Madrid,44,Colmenarejo,9124,4464,4660
28,Madrid,48,Corpa,697,364,333
28,Madrid,49,Coslada,81860,40106,41754
28,Madrid,50,Cubas de la Sagra,6310,3128,3182
28,Madrid,53,Daganzo de Arriba,10061,5009,5052
28,Madrid,54,"Escorial, El",15842,7821,8021
28,Madrid,55,Estremera,1236,636,600
28,Madrid,56,Fresnedillas de la Oliva,1554,785,769
28,Madrid,57,Fresno de Torote,2181,1137,1044
28,Madrid,58,Fuenlabrada,193586,95433,98153
28,Madrid,59,Fuente el Saz de Jarama,6541,3319,3222
28,Madrid,60,Fuentidueña de Tajo,1985,1003,982
28,Madrid,61,Galapagar,33379,16373,17006
28,Madrid,62,Garganta de los Montes,348,191,157
28,Madrid,63,Gargantilla del Lozoya y Pinilla de Buitrago,318,174,144
28,Madrid,64,Gascones,188,109,79
28,Madrid,65,Getafe,180747,88464,92283
28,Madrid,66,Griñón,10178,5048,5130
28,Madrid,67,Guadalix de la Sierra,6119,3089,3030
28,Madrid,68,Guadarrama,15785,7779,8006
28,Madrid,69,"Hiruela, La",48,32,16
28,Madrid,70,Horcajo de la Sierra-Aoslos,148,82,66
28,Madrid,71,Horcajuelo de la Sierra,89,46,43
28,Madrid,72,Hoyo de Manzanares,8222,4125,4097
28,Madrid,73,Humanes de Madrid,19587,9838,9749
28,Madrid,74,Leganés,188425,91463,96962
28,Madrid,75,Loeches,8673,4359,4314
28,Madrid,76,Lozoya,559,294,265
28,Madrid,901,Lozoyuela-Navas-Sieteiglesias,1266,656,610
28,Madrid,78,Madarcos,47,31,16
28,Madrid,79,Madrid,3223334,1500190,1723144
28,Madrid,80,Majadahonda,71785,34020,37765
28,Madrid,82,Manzanares el Real,8597,4358,4239
28,Madrid,83,Meco,13959,7052,6907
28,Madrid,84,Mejorada del Campo,23241,11551,11690
28,Madrid,85,Miraflores de la Sierra,5897,3041,2856
28,Madrid,86,"Molar, El",8666,4384,4282
28,Madrid,87,"Molinos, Los",4328,2145,2183
28,Madrid,88,Montejo de la Sierra,363,186,177
28,Madrid,89,Moraleja de Enmedio,5021,2501,2520
28,Madrid,90,Moralzarzal,12697,6342,6355
28,Madrid,91,Morata de Tajuña,7553,3768,3785
28,Madrid,92,Móstoles,207095,100930,106165
28,Madrid,93,Navacerrada,2911,1445,1466
28,Madrid,94,Navalafuente,1397,717,680
28,Madrid,95,Navalagamella,2601,1342,1259
28,Madrid,96,Navalcarnero,28305,14148,14157
28,Madrid,97,Navarredonda y San Mamés,122,77,45
28,Madrid,99,Navas del Rey,2819,1500,1319
28,Madrid,100,Nuevo Baztán,6154,3124,3030
28,Madrid,101,Olmeda de las Fuentes,346,183,163
28,Madrid,102,Orusco de Tajuña,1202,612,590
28,Madrid,104,Paracuellos de Jarama,24521,12396,12125
28,Madrid,106,Parla,128256,63838,64418
28,Madrid,107,Patones,523,251,272
28,Madrid,108,Pedrezuela,5746,2880,2866
28,Madrid,109,Pelayos de la Presa,2475,1260,1215
28,Madrid,110,Perales de Tajuña,2831,1431,1400
28,Madrid,111,Pezuela de las Torres,821,426,395
28,Madrid,112,Pinilla del Valle,187,111,76
28,Madrid,113,Pinto,51541,25524,26017
28,Madrid,114,Piñuécar-Gandullas,171,91,80
28,Madrid,115,Pozuelo de Alarcón,86172,41290,44882
28,Madrid,116,Pozuelo del Rey,1120,592,528
28,Madrid,117,Prádena del Rincón,117,68,49
28,Madrid,118,Puebla de la Sierra,60,36,24
28,Madrid,902,Puentes Viejas,642,348,294
28,Madrid,119,Quijorna,3357,1695,1662
28,Madrid,120,Rascafría,1663,913,750
28,Madrid,121,Redueña,247,131,116
28,Madrid,122,Ribatejada,706,358,348
28,Madrid,123,Rivas-Vaciamadrid,85893,42616,43277
28,Madrid,124,Robledillo de la Jara,87,46,41
28,Madrid,125,Robledo de Chavela,4159,2164,1995
28,Madrid,126,Robregordo,48,29,19
28,Madrid,127,"Rozas de Madrid, Las",95550,46246,49304
28,Madrid,128,Rozas de Puerto Real,527,300,227
28,Madrid,129,San Agustín del Guadalix,13273,6506,6767
28,Madrid,130,San Fernando de Henares,39466,19207,20259
28,Madrid,131,San Lorenzo de El Escorial,18088,8660,9428
28,Madrid,132,San Martín de la Vega,18784,9569,9215
28,Madrid,133,San Martín de Valdeiglesias,8318,4133,4185
28,Madrid,134,San Sebastián de los Reyes,87724,42854,44870
28,Madrid,135,Santa María de la Alameda,1182,619,563
28,Madrid,136,Santorcaz,850,427,423
28,Madrid,137,"Santos de la Humosa, Los",2542,1288,1254
28,Madrid,138,"Serna del Monte, La",74,40,34
28,Madrid,140,Serranillos del Valle,4066,2025,2041
28,Madrid,141,Sevilla la Nueva,9095,4451,4644
28,Madrid,143,Somosierra,80,46,34
28,Madrid,144,Soto del Real,8694,4268,4426
28,Madrid,145,Talamanca de Jarama,3725,1850,1875
28,Madrid,146,Tielmes,2604,1333,1271
28,Madrid,147,Titulcia,1304,671,633
28,Madrid,148,Torrejón de Ardoz,129729,63910,65819
28,Madrid,149,Torrejón de la Calzada,8582,4246,4336
28,Madrid,150,Torrejón de Velasco,4298,2131,2167
28,Madrid,151,Torrelaguna,4724,2389,2335
28,Madrid,152,Torrelodones,23361,11239,12122
28,Madrid,153,Torremocha de Jarama,975,497,478
28,Madrid,154,Torres de la Alameda,7760,3956,3804
28,Madrid,903,Tres Cantos,46750,22694,24056
28,Madrid,155,Valdaracete,626,321,305
28,Madrid,156,Valdeavero,1510,783,727
28,Madrid,157,Valdelaguna,903,449,454
28,Madrid,158,Valdemanco,927,496,431
28,Madrid,159,Valdemaqueda,761,396,365
28,Madrid,160,Valdemorillo,12280,6183,6097
28,Madrid,161,Valdemoro,74745,36984,37761
28,Madrid,162,Valdeolmos-Alalpardo,4039,2077,1962
28,Madrid,163,Valdepiélagos,574,310,264
28,Madrid,164,Valdetorres de Jarama,4384,2233,2151
28,Madrid,165,Valdilecha,2840,1469,1371
28,Madrid,166,Valverde de Alcalá,432,224,208
28,Madrid,167,Velilla de San Antonio,12193,6146,6047
28,Madrid,168,"Vellón, El",1942,1013,929
28,Madrid,169,Venturada,2081,1102,979
28,Madrid,171,Villa del Prado,6409,3233,3176
28,Madrid,170,Villaconejos,3363,1712,1651
28,Madrid,172,Villalbilla,13421,6785,6636
28,Madrid,173,Villamanrique de Tajo,699,353,346
28,Madrid,174,Villamanta,2501,1274,1227
28,Madrid,175,Villamantilla,1420,700,720
28,Madrid,176,Villanueva de la Cañada,21000,10238,10762
28,Madrid,178,Villanueva de Perales,1547,789,758
28,Madrid,177,Villanueva del Pardillo,17127,8331,8796
28,Madrid,179,Villar del Olmo,1967,983,984
28,Madrid,180,Villarejo de Salvanés,7291,3674,3617
28,Madrid,181,Villaviciosa de Odón,27596,13352,14244
28,Madrid,182,Villavieja del Lozoya,258,141,117
28,Madrid,183,Zarzalejo,1620,847,773
29,Málaga,1,Alameda,5366,2716,2650
29,Málaga,2,Alcaucín,2239,1148,1091
29,Málaga,3,Alfarnate,1105,575,530
29,Málaga,4,Alfarnatejo,394,204,190
29,Málaga,5,Algarrobo,6367,3191,3176
29,Málaga,6,Algatocín,778,411,367
29,Málaga,7,Alhaurín de la Torre,39911,19830,20081
29,Málaga,8,Alhaurín el Grande,24123,12066,12057
29,Málaga,9,Almáchar,1802,930,872
29,Málaga,10,Almargen,1984,1013,971
29,Málaga,11,Almogía,3770,1950,1820
29,Málaga,12,Álora,12951,6533,6418
29,Málaga,13,Alozaina,2015,1029,986
29,Málaga,14,Alpandeire,252,129,123
29,Málaga,15,Antequera,41154,20161,20993
29,Málaga,16,Árchez,391,200,191
29,Málaga,17,Archidona,8288,4233,4055
29,Málaga,18,Ardales,2493,1272,1221
29,Málaga,19,Arenas,1177,619,558
29,Málaga,20,Arriate,4147,2051,2096
29,Málaga,21,Atajate,169,91,78
29,Málaga,22,Benadalid,225,110,115
29,Málaga,23,Benahavís,7989,4024,3965
29,Málaga,24,Benalauría,443,227,216
29,Málaga,25,Benalmádena,67746,33385,34361
29,Málaga,26,Benamargosa,1496,772,724
29,Málaga,27,Benamocarra,2999,1511,1488
29,Málaga,28,Benaoján,1488,775,713
29,Málaga,29,Benarrabá,458,229,229
29,Málaga,30,"Borge, El",933,490,443
29,Málaga,31,"Burgo, El",1823,934,889
29,Málaga,32,Campillos,8517,4319,4198
29,Málaga,33,Canillas de Aceituno,1620,861,759
29,Málaga,34,Canillas de Albaida,732,363,369
29,Málaga,35,Cañete la Real,1691,849,842
29,Málaga,36,Carratraca,748,391,357
29,Málaga,37,Cartajima,247,133,114
29,Málaga,38,Cártama,25758,13011,12747
29,Málaga,39,Casabermeja,3507,1822,1685
29,Málaga,40,Casarabonela,2510,1336,1174
29,Málaga,41,Casares,6121,3151,2970
29,Málaga,42,Coín,21716,10911,10805
29,Málaga,43,Colmenar,3392,1743,1649
29,Málaga,44,Comares,1323,719,604
29,Málaga,45,Cómpeta,3745,1872,1873
29,Málaga,46,Cortes de la Frontera,3181,1636,1545
29,Málaga,47,Cuevas Bajas,1392,694,698
29,Málaga,49,Cuevas de San Marcos,3671,1849,1822
29,Málaga,48,Cuevas del Becerro,1595,791,804
29,Málaga,50,Cútar,614,317,297
29,Málaga,51,Estepona,67012,32918,34094
29,Málaga,52,Faraján,248,127,121
29,Málaga,53,Frigiliana,3086,1558,1528
29,Málaga,54,Fuengirola,75396,36690,38706
29,Málaga,55,Fuente de Piedra,2554,1306,1248
29,Málaga,56,Gaucín,1573,827,746
29,Málaga,57,Genalguacil,393,199,194
29,Málaga,58,Guaro,2182,1090,1092
29,Málaga,59,Humilladero,3310,1647,1663
29,Málaga,60,Igualeja,762,381,381
29,Málaga,61,Istán,1458,729,729
29,Málaga,62,Iznate,863,446,417
29,Málaga,63,Jimera de Líbar,376,190,186
29,Málaga,64,Jubrique,559,283,276
29,Málaga,65,Júzcar,225,130,95
29,Málaga,66,Macharaviaya,442,235,207
29,Málaga,67,Málaga,571026,274373,296653
29,Málaga,68,Manilva,14977,7651,7326
29,Málaga,69,Marbella,141463,68073,73390
29,Málaga,70,Mijas,80630,40267,40363
29,Málaga,71,Moclinejo,1230,642,588
29,Málaga,72,Mollina,5020,2526,2494
29,Málaga,73,Monda,2523,1296,1227
29,Málaga,903,Montecorto,585,313,272
29,Málaga,74,Montejaque,970,476,494
29,Málaga,75,Nerja,21061,10397,10664
29,Málaga,76,Ojén,3568,1820,1748
29,Málaga,77,Parauta,253,125,128
29,Málaga,79,Periana,3068,1614,1454
29,Málaga,80,Pizarra,9118,4600,4518
29,Málaga,81,Pujerra,294,153,141
29,Málaga,82,Rincón de la Victoria,46093,22646,23447
29,Málaga,83,Riogordo,2701,1423,1278
29,Málaga,84,Ronda,33978,16530,17448
29,Málaga,85,Salares,174,89,85
29,Málaga,86,Sayalonga,1658,849,809
29,Málaga,87,Sedella,606,344,262
29,Málaga,904,Serrato,477,241,236
29,Málaga,88,Sierra de Yeguas,3356,1698,1658
29,Málaga,89,Teba,3818,1927,1891
29,Málaga,90,Tolox,2083,1057,1026
29,Málaga,901,Torremolinos,68262,34079,34183
29,Málaga,91,Torrox,16465,8374,8091
29,Málaga,92,Totalán,715,376,339
29,Málaga,93,Valle de Abdalajís,2568,1303,1265
29,Málaga,94,Vélez-Málaga,80817,39900,40917
29,Málaga,95,Villanueva de Algaidas,4218,2170,2048
29,Málaga,902,Villanueva de la Concepción,3288,1609,1679
29,Málaga,98,Villanueva de Tapia,1490,756,734
29,Málaga,96,Villanueva del Rosario,3373,1647,1726
29,Málaga,97,Villanueva del Trabuco,5300,2663,2637
29,Málaga,99,Viñuela,2020,1051,969
29,Málaga,100,Yunquera,2880,1467,1413
30,Murcia,1,Abanilla,6063,3060,3003
30,Murcia,2,Abarán,13030,6527,6503
30,Murcia,3,Águilas,35031,17490,17541
30,Murcia,4,Albudeite,1361,689,672
30,Murcia,5,Alcantarilla,41622,20539,21083
30,Murcia,902,"Alcázares, Los",15674,7994,7680
30,Murcia,6,Aledo,1022,508,514
30,Murcia,7,Alguazas,9525,4896,4629
30,Murcia,8,Alhama de Murcia,21657,10934,10723
30,Murcia,9,Archena,19053,9978,9075
30,Murcia,10,Beniel,11274,5819,5455
30,Murcia,11,Blanca,6564,3354,3210
30,Murcia,12,Bullas,11547,5804,5743
30,Murcia,13,Calasparra,10165,5158,5007
30,Murcia,14,Campos del Río,2045,973,1072
30,Murcia,15,Caravaca de la Cruz,25730,12859,12871
30,Murcia,16,Cartagena,213943,106701,107242
30,Murcia,17,Cehegín,15022,7550,7472
30,Murcia,18,Ceutí,11565,5824,5741
30,Murcia,19,Cieza,34889,17486,17403
30,Murcia,20,Fortuna,10060,5363,4697
30,Murcia,21,Fuente Álamo de Murcia,16184,8459,7725
30,Murcia,22,Jumilla,25547,13334,12213
30,Murcia,23,Librilla,5196,2654,2542
30,Murcia,24,Lorca,93079,47660,45419
30,Murcia,25,Lorquí,7002,3543,3459
30,Murcia,26,Mazarrón,31562,16308,15254
30,Murcia,27,Molina de Segura,70964,35392,35572
30,Murcia,28,Moratalla,7954,4051,3903
30,Murcia,29,Mula,16790,8619,8171
30,Murcia,30,Murcia,447182,218511,228671
30,Murcia,31,Ojós,500,262,238
30,Murcia,32,Pliego,3842,1989,1853
30,Murcia,33,Puerto Lumbreras,14981,7519,7462
30,Murcia,34,Ricote,1301,688,613
30,Murcia,35,San Javier,31905,16033,15872
30,Murcia,36,San Pedro del Pinatar,25167,12733,12434
30,Murcia,901,Santomera,16105,8093,8012
30,Murcia,37,Torre-Pacheco,35614,18542,17072
30,Murcia,38,"Torres de Cotillas, Las",21375,10868,10507
30,Murcia,39,Totana,31639,16299,15340
30,Murcia,40,Ulea,879,451,428
30,Murcia,41,"Unión, La",19907,10085,9822
30,Murcia,42,Villanueva del Río Segura,2758,1387,1371
30,Murcia,43,Yecla,34234,17157,17077
31,Navarra,1,Abáigar,87,51,36
31,Navarra,2,Abárzuza/Abartzuza,550,269,281
31,Navarra,3,Abaurregaina/Abaurrea Alta,121,76,45
31,Navarra,4,Abaurrepea/Abaurrea Baja,33,20,13
31,Navarra,5,Aberin,356,193,163
31,Navarra,6,Ablitas,2483,1260,1223
31,Navarra,7,Adiós,156,87,69
31,Navarra,8,Aguilar de Codés,72,40,32
31,Navarra,9,Aibar/Oibar,791,421,370
31,Navarra,11,Allín/Allin,850,455,395
31,Navarra,12,Allo,983,490,493
31,Navarra,10,Altsasu/Alsasua,7407,3740,3667
31,Navarra,13,Améscoa Baja,730,391,339
31,Navarra,14,Ancín/Antzin,340,192,148
31,Navarra,15,Andosilla,2715,1356,1359
31,Navarra,16,Ansoáin/Antsoain,10739,5285,5454
31,Navarra,17,Anue,485,258,227
31,Navarra,18,Añorbe,568,312,256
31,Navarra,19,Aoiz/Agoitz,2624,1330,1294
31,Navarra,20,Araitz,525,292,233
31,Navarra,25,Arakil,949,493,456
31,Navarra,21,Aranarache/Aranaratxe,70,40,30
31,Navarra,23,Aranguren,10512,5296,5216
31,Navarra,24,Arano,116,63,53
31,Navarra,22,Arantza,614,324,290
31,Navarra,26,Aras,157,84,73
31,Navarra,27,Arbizu,1124,573,551
31,Navarra,28,Arce/Artzi,264,143,121
31,Navarra,29,"Arcos, Los",1117,551,566
31,Navarra,30,Arellano,157,85,72
31,Navarra,31,Areso,275,143,132
31,Navarra,32,Arguedas,2315,1187,1128
31,Navarra,33,Aria,53,30,23
31,Navarra,34,Aribe,36,19,17
31,Navarra,35,Armañanzas,55,31,24
31,Navarra,36,Arróniz,1047,555,492
31,Navarra,37,Arruazu,106,57,49
31,Navarra,38,Artajona,1669,847,822
31,Navarra,39,Artazu,118,60,58
31,Navarra,40,Atez/Atetz,212,119,93
31,Navarra,58,Auritz/Burguete,242,120,122
31,Navarra,41,Ayegui/Aiegi,2331,1214,1117
31,Navarra,42,Azagra,3853,1967,1886
31,Navarra,43,Azuelo,32,13,19
31,Navarra,44,Bakaiku,345,180,165
31,Navarra,901,Barañáin/Barañain,20039,9674,10365
31,Navarra,45,Barásoain,639,346,293
31,Navarra,46,Barbarin,58,28,30
31,Navarra,47,Bargota,262,126,136
31,Navarra,48,Barillas,219,117,102
31,Navarra,49,Basaburua,839,478,361
31,Navarra,50,Baztan,7749,3920,3829
31,Navarra,137,Beintza-Labaien,227,132,95
31,Navarra,51,Beire,275,146,129
31,Navarra,52,Belascoáin,125,62,63
31,Navarra,250,Bera,3761,1855,1906
31,Navarra,53,Berbinzana,610,313,297
31,Navarra,905,Beriáin,3941,1932,2009
31,Navarra,902,Berrioplano/Berriobeiti,7011,3583,3428
31,Navarra,903,Berriozar,10167,5129,5038
31,Navarra,54,Bertizarana,607,295,312
31,Navarra,55,Betelu,352,187,165
31,Navarra,253,Bidaurreta,171,93,78
31,Navarra,56,Biurrun-Olcoz,204,113,91
31,Navarra,57,Buñuel,2223,1087,1136
31,Navarra,59,Burgui/Burgi,208,119,89
31,Navarra,60,Burlada/Burlata,18934,9152,9782
31,Navarra,61,"Busto, El",57,26,31
31,Navarra,62,Cabanillas,1364,720,644
31,Navarra,63,Cabredo,97,55,42
31,Navarra,64,Cadreita,1993,1021,972
31,Navarra,65,Caparroso,2702,1423,1279
31,Navarra,66,Cárcar,1039,523,516
31,Navarra,67,Carcastillo,2455,1245,1210
31,Navarra,68,Cascante,3818,1889,1929
31,Navarra,69,Cáseda,980,490,490
31,Navarra,70,Castejón,4109,2041,2068
31,Navarra,71,Castillonuevo,17,13,4
31,Navarra,193,Cendea de Olza/Oltza Zendea,1842,915,927
31,Navarra,72,Cintruénigo,7823,4013,3810
31,Navarra,74,Cirauqui/Zirauki,490,260,230
31,Navarra,75,Ciriza/Ziritza,141,66,75
31,Navarra,76,Cizur,3850,1976,1874
31,Navarra,77,Corella,7707,3884,3823
31,Navarra,78,Cortes,3148,1588,1560
31,Navarra,79,Desojo,75,43,32
31,Navarra,80,Dicastillo,599,308,291
31,Navarra,81,Donamaria,431,215,216
31,Navarra,221,Doneztebe/Santesteban,1729,883,846
31,Navarra,83,Echarri/Etxarri,77,37,40
31,Navarra,87,Elgorriaga,219,111,108
31,Navarra,89,Enériz/Eneritz,298,157,141
31,Navarra,90,Eratsun,152,93,59
31,Navarra,91,Ergoiena,384,205,179
31,Navarra,92,Erro,789,441,348
31,Navarra,94,Eslava,119,58,61
31,Navarra,95,Esparza de Salazar/Espartza Zaraitzu,76,40,36
31,Navarra,96,Espronceda,103,57,46
31,Navarra,97,Estella-Lizarra,13673,6555,7118
31,Navarra,98,Esteribar,2600,1348,1252
31,Navarra,99,Etayo,65,36,29
31,Navarra,82,Etxalar,805,428,377
31,Navarra,84,Etxarri Aranatz,2503,1303,1200
31,Navarra,85,Etxauri,633,331,302
31,Navarra,100,Eulate,284,160,124
31,Navarra,101,Ezcabarte,1804,935,869
31,Navarra,93,Ezcároz/Ezkaroze,306,165,141
31,Navarra,102,Ezkurra,150,98,52
31,Navarra,103,Ezprogui,42,21,21
31,Navarra,104,Falces,2306,1167,1139
31,Navarra,105,Fitero,2017,1020,997
31,Navarra,106,Fontellas,983,495,488
31,Navarra,107,Funes,2485,1328,1157
31,Navarra,108,Fustiñana,2487,1228,1259
31,Navarra,109,Galar,2213,1164,1049
31,Navarra,110,Gallipienzo/Galipentzu,100,56,44
31,Navarra,111,Gallués/Galoze,95,63,32
31,Navarra,112,Garaioa,89,52,37
31,Navarra,113,Garde,146,89,57
31,Navarra,114,Garínoain,479,252,227
31,Navarra,115,Garralda,189,99,90
31,Navarra,116,Genevilla,74,46,28
31,Navarra,117,Goizueta,705,377,328
31,Navarra,118,Goñi,163,107,56
31,Navarra,119,Güesa/Gorza,40,23,17
31,Navarra,120,Guesálaz/Gesalatz,444,263,181
31,Navarra,121,Guirguillano,78,41,37
31,Navarra,256,Hiriberri/Villanueva de Aezkoa,106,57,49
31,Navarra,122,Huarte/Uharte,7014,3542,3472
31,Navarra,124,Ibargoiti,253,148,105
31,Navarra,259,Igantzi,622,325,297
31,Navarra,125,Igúzquiza,325,171,154
31,Navarra,126,Imotz,425,227,198
31,Navarra,127,Irañeta,176,95,81
31,Navarra,904,Irurtzun,2209,1138,1071
31,Navarra,128,Isaba/Izaba,420,209,211
31,Navarra,129,Ituren,504,258,246
31,Navarra,130,Iturmendi,382,193,189
31,Navarra,131,Iza/Itza,1199,649,550
31,Navarra,132,Izagaondoa,176,115,61
31,Navarra,133,Izalzu/Itzaltzu,44,27,17
31,Navarra,134,Jaurrieta,191,107,84
31,Navarra,135,Javier,106,30,76
31,Navarra,136,Juslapeña,550,298,252
31,Navarra,138,Lakuntza,1272,668,604
31,Navarra,139,Lana,172,98,74
31,Navarra,140,Lantz,147,88,59
31,Navarra,141,Lapoblación,119,67,52
31,Navarra,142,Larraga,2060,1087,973
31,Navarra,143,Larraona,103,51,52
31,Navarra,144,Larraun,967,525,442
31,Navarra,145,Lazagurría,187,95,92
31,Navarra,146,Leache/Leatxe,31,18,13
31,Navarra,147,Legarda,113,63,50
31,Navarra,148,Legaria,110,49,61
31,Navarra,149,Leitza,2898,1505,1393
31,Navarra,908,Lekunberri,1535,762,773
31,Navarra,150,Leoz/Leotz,232,146,86
31,Navarra,151,Lerga,60,38,22
31,Navarra,152,Lerín,1725,891,834
31,Navarra,153,Lesaka,2735,1414,1321
31,Navarra,154,Lezáun,242,145,97
31,Navarra,155,Liédena,291,145,146
31,Navarra,156,Lizoáin-Arriasgoiti,297,173,124
31,Navarra,157,Lodosa,4764,2414,2350
31,Navarra,158,Lónguida/Longida,294,158,136
31,Navarra,159,Lumbier,1317,716,601
31,Navarra,160,Luquin,130,70,60
31,Navarra,248,Luzaide/Valcarlos,358,206,152
31,Navarra,161,Mañeru,437,233,204
31,Navarra,162,Marañón,52,26,26
31,Navarra,163,Marcilla,2862,1440,1422
31,Navarra,164,Mélida,747,384,363
31,Navarra,165,Mendavia,3534,1815,1719
31,Navarra,166,Mendaza,292,152,140
31,Navarra,167,Mendigorría,1057,554,503
31,Navarra,168,Metauten,277,155,122
31,Navarra,169,Milagro,3397,1766,1631
31,Navarra,170,Mirafuentes,56,27,29
31,Navarra,171,Miranda de Arga,850,442,408
31,Navarra,172,Monreal/Elo,466,253,213
31,Navarra,173,Monteagudo,1088,541,547
31,Navarra,174,Morentin,120,60,60
31,Navarra,175,Mues,77,41,36
31,Navarra,176,Murchante,4088,2055,2033
31,Navarra,177,Murieta,327,173,154
31,Navarra,178,Murillo el Cuende,646,339,307
31,Navarra,179,Murillo el Fruto,639,340,299
31,Navarra,180,Muruzábal,239,101,138
31,Navarra,181,Navascués/Nabaskoze,142,85,57
31,Navarra,182,Nazar,34,20,14
31,Navarra,88,Noáin (Valle de Elorz)/Noain (Elortzibar),8224,4143,4081
31,Navarra,183,Obanos,912,459,453
31,Navarra,185,Ochagavía/Otsagabia,530,284,246
31,Navarra,184,Oco,77,39,38
31,Navarra,186,Odieta,369,202,167
31,Navarra,187,Oiz,121,72,49
31,Navarra,188,Olaibar,363,207,156
31,Navarra,189,Olazti/Olazagutía,1497,762,735
31,Navarra,190,Olejua,51,28,23
31,Navarra,191,Olite/Erriberri,3931,1991,1940
31,Navarra,192,Olóriz/Oloritz,204,112,92
31,Navarra,195,Orbaizeta,197,98,99
31,Navarra,196,Orbara,36,19,17
31,Navarra,197,Orísoain,79,44,35
31,Navarra,906,Orkoien,3996,2008,1988
31,Navarra,198,Oronz/Orontze,48,25,23
31,Navarra,199,Oroz-Betelu/Orotz-Betelu,147,85,62
31,Navarra,211,Orreaga/Roncesvalles,21,11,10
31,Navarra,200,Oteiza,919,490,429
31,Navarra,201,Pamplona/Iruña,199066,94124,104942
31,Navarra,202,Peralta/Azkoien,5823,2930,2893
31,Navarra,203,Petilla de Aragón,31,18,13
31,Navarra,204,Piedramillera,37,24,13
31,Navarra,205,Pitillas,493,248,245
31,Navarra,206,Puente la Reina/Gares,2843,1437,1406
31,Navarra,207,Pueyo,349,192,157
31,Navarra,208,Ribaforada,3742,1956,1786
31,Navarra,209,Romanzado,174,94,80
31,Navarra,210,Roncal/Erronkari,208,108,100
31,Navarra,212,Sada,144,79,65
31,Navarra,213,Saldías,116,66,50
31,Navarra,214,Salinas de Oro/Jaitz,110,62,48
31,Navarra,215,San Adrián,6241,3097,3144
31,Navarra,217,San Martín de Unx,398,203,195
31,Navarra,216,Sangüesa/Zangoza,4960,2523,2437
31,Navarra,219,Sansol,100,55,45
31,Navarra,220,Santacara,886,461,425
31,Navarra,222,Sarriés/Sartze,62,40,22
31,Navarra,223,Sartaguda,1294,669,625
31,Navarra,224,Sesma,1180,606,574
31,Navarra,225,Sorlada,57,34,23
31,Navarra,226,Sunbilla,671,350,321
31,Navarra,227,Tafalla,10605,5222,5383
31,Navarra,228,Tiebas-Muruarte de Reta,598,307,291
31,Navarra,229,Tirapu,42,27,15
31,Navarra,230,Torralba del Río,104,54,50
31,Navarra,231,Torres del Río,122,59,63
31,Navarra,232,Tudela,35593,17497,18096
31,Navarra,233,Tulebras,134,59,75
31,Navarra,234,Ucar,177,99,78
31,Navarra,123,Uharte Arakil,805,426,379
31,Navarra,235,Ujué/Uxue,177,102,75
31,Navarra,236,Ultzama,1655,857,798
31,Navarra,237,Unciti,212,121,91
31,Navarra,238,Unzué/Untzue,137,72,65
31,Navarra,239,Urdazubi/Urdax,355,175,180
31,Navarra,240,Urdiain,675,347,328
31,Navarra,241,Urraul Alto,133,87,46
31,Navarra,242,Urraul Bajo,308,138,170
31,Navarra,244,Urroz,180,103,77
31,Navarra,243,Urroz-Villa,374,198,176
31,Navarra,245,Urzainqui/Urzainki,88,56,32
31,Navarra,246,Uterga,164,92,72
31,Navarra,247,Uztárroz/Uztarroze,160,82,78
31,Navarra,86,Valle de Egüés/Eguesibar,20774,10457,10317
31,Navarra,194,Valle de Ollo/Ollaran,415,224,191
31,Navarra,260,Valle de Yerri/Deierri,1508,785,723
31,Navarra,249,Valtierra,2373,1186,1187
31,Navarra,251,Viana,4156,2099,2057
31,Navarra,252,Vidángoz/Bidankoze,95,52,43
31,Navarra,254,Villafranca,2841,1423,1418
31,Navarra,255,Villamayor de Monjardín,120,64,56
31,Navarra,257,Villatuerta,1186,595,591
31,Navarra,258,Villava/Atarrabia,10150,4970,5180
31,Navarra,261,Yesa,297,174,123
31,Navarra,262,Zabalza/Zabaltza,295,160,135
31,Navarra,73,Ziordia,361,186,175
31,Navarra,907,Zizur Mayor/Zizur Nagusia,14891,7285,7606
31,Navarra,263,Zubieta,316,164,152
31,Navarra,264,Zugarramurdi,225,112,113
31,Navarra,265,Zúñiga,112,70,42
32,Ourense,1,Allariz,6110,3078,3032
32,Ourense,2,Amoeiro,2265,1129,1136
32,Ourense,3,"Arnoia, A",995,496,499
32,Ourense,4,Avión,1806,831,975
32,Ourense,5,Baltar,968,525,443
32,Ourense,6,Bande,1591,771,820
32,Ourense,7,Baños de Molgas,1547,773,774
32,Ourense,8,Barbadás,10951,5343,5608
32,Ourense,9,"Barco de Valdeorras, O",13463,6552,6911
32,Ourense,10,Beade,404,215,189
32,Ourense,11,Beariz,973,428,545
32,Ourense,12,"Blancos, Os",809,442,367
32,Ourense,13,Boborás,2299,1094,1205
32,Ourense,14,"Bola, A",1199,567,632
32,Ourense,15,"Bolo, O",917,467,450
32,Ourense,16,Calvos de Randín,779,382,397
32,Ourense,18,Carballeda de Avia,1317,637,680
32,Ourense,17,Carballeda de Valdeorras,1574,813,761
32,Ourense,19,"Carballiño, O",13939,6539,7400
32,Ourense,20,Cartelle,2643,1294,1349
32,Ourense,22,Castrelo de Miño,1380,690,690
32,Ourense,21,Castrelo do Val,1001,509,492
32,Ourense,23,Castro Caldelas,1224,622,602
32,Ourense,24,Celanova,5533,2626,2907
32,Ourense,25,Cenlle,1140,568,572
32,Ourense,29,Chandrexa de Queixa,466,262,204
32,Ourense,26,Coles,3049,1534,1515
32,Ourense,27,Cortegada,1105,533,572
32,Ourense,28,Cualedro,1700,870,830
32,Ourense,30,Entrimo,1166,551,615
32,Ourense,31,Esgos,1134,577,557
32,Ourense,33,Gomesende,750,361,389
32,Ourense,34,"Gudiña, A",1308,681,627
32,Ourense,35,"Irixo, O",1477,709,768
32,Ourense,38,Larouco,455,220,235
32,Ourense,39,Laza,1287,666,621
32,Ourense,40,Leiro,1583,761,822
32,Ourense,41,Lobeira,807,383,424
32,Ourense,42,Lobios,1732,868,864
32,Ourense,43,Maceda,2890,1417,1473
32,Ourense,44,Manzaneda,890,435,455
32,Ourense,45,Maside,2767,1353,1414
32,Ourense,46,Melón,1227,587,640
32,Ourense,47,"Merca, A",1911,932,979
32,Ourense,48,"Mezquita, A",1039,537,502
32,Ourense,49,Montederramo,722,376,346
32,Ourense,50,Monterrei,2602,1337,1265
32,Ourense,51,Muíños,1486,758,728
32,Ourense,52,Nogueira de Ramuín,2011,1017,994
32,Ourense,53,Oímbra,1766,961,805
32,Ourense,54,Ourense,105505,47962,57543
32,Ourense,55,Paderne de Allariz,1383,689,694
32,Ourense,56,Padrenda,1759,849,910
32,Ourense,57,Parada de Sil,564,307,257
32,Ourense,58,"Pereiro de Aguiar, O",6254,3205,3049
32,Ourense,59,"Peroxa, A",1871,920,951
32,Ourense,60,Petín,889,435,454
32,Ourense,61,Piñor,1140,576,564
32,Ourense,63,"Pobra de Trives, A",2118,1063,1055
32,Ourense,64,Pontedeva,554,276,278
32,Ourense,62,Porqueira,830,404,426
32,Ourense,65,Punxín,699,344,355
32,Ourense,66,Quintela de Leirado,611,268,343
32,Ourense,67,Rairiz de Veiga,1282,654,628
32,Ourense,68,Ramirás,1540,703,837
32,Ourense,69,Ribadavia,5028,2453,2575
32,Ourense,71,Riós,1568,802,766
32,Ourense,72,"Rúa, A",4359,2138,2221
32,Ourense,73,Rubiá,1448,705,743
32,Ourense,74,San Amaro,1091,532,559
32,Ourense,75,San Cibrao das Viñas,5249,2660,2589
32,Ourense,76,San Cristovo de Cea,2191,1075,1116
32,Ourense,70,San Xoán de Río,549,271,278
32,Ourense,77,Sandiás,1213,561,652
32,Ourense,78,Sarreaus,1189,598,591
32,Ourense,79,Taboadela,1443,741,702
32,Ourense,80,"Teixeira, A",332,167,165
32,Ourense,81,Toén,2368,1219,1149
32,Ourense,82,Trasmiras,1288,645,643
32,Ourense,83,"Veiga, A",904,463,441
32,Ourense,84,Verea,933,447,486
32,Ourense,85,Verín,13817,6634,7183
32,Ourense,86,Viana do Bolo,2929,1480,1449
32,Ourense,87,Vilamarín,1904,974,930
32,Ourense,88,Vilamartín de Valdeorras,1746,894,852
32,Ourense,89,Vilar de Barrio,1317,675,642
32,Ourense,90,Vilar de Santos,829,404,425
32,Ourense,91,Vilardevós,1912,999,913
32,Ourense,92,Vilariño de Conso,535,311,224
32,Ourense,32,Xinzo de Limia,9836,4763,5073
32,Ourense,36,Xunqueira de Ambía,1418,717,701
32,Ourense,37,Xunqueira de Espadanedo,741,366,375
34,Palencia,1,Abarca de Campos,42,26,16
34,Palencia,3,Abia de las Torres,164,91,73
34,Palencia,4,Aguilar de Campoo,6842,3312,3530
34,Palencia,5,Alar del Rey,928,453,475
34,Palencia,6,Alba de Cerrato,86,46,40
34,Palencia,9,Amayuelas de Arriba,35,22,13
34,Palencia,10,Ampudia,622,319,303
34,Palencia,11,Amusco,423,234,189
34,Palencia,12,Antigüedad,369,196,173
34,Palencia,15,Arconada,42,26,16
34,Palencia,17,Astudillo,1004,506,498
34,Palencia,18,Autilla del Pino,221,125,96
34,Palencia,19,Autillo de Campos,131,71,60
34,Palencia,20,Ayuela,52,32,20
34,Palencia,22,Baltanás,1216,641,575
34,Palencia,24,Baquerín de Campos,28,18,10
34,Palencia,25,Bárcena de Campos,53,24,29
34,Palencia,27,Barruelo de Santullán,1183,589,594
34,Palencia,28,Báscones de Ojeda,144,77,67
34,Palencia,29,Becerril de Campos,754,392,362
34,Palencia,31,Belmonte de Campos,33,18,15
34,Palencia,32,Berzosilla,41,22,19
34,Palencia,33,Boada de Campos,17,13,4
34,Palencia,35,Boadilla de Rioseco,111,65,46
34,Palencia,34,Boadilla del Camino,115,65,50
34,Palencia,36,Brañosera,246,140,106
34,Palencia,37,Buenavista de Valdavia,264,147,117
34,Palencia,38,Bustillo de la Vega,306,167,139
34,Palencia,39,Bustillo del Páramo de Carrión,61,37,24
34,Palencia,41,Calahorra de Boedo,92,43,49
34,Palencia,42,Calzada de los Molinos,326,182,144
34,Palencia,45,Capillas,77,40,37
34,Palencia,46,Cardeñosa de Volpejera,43,25,18
34,Palencia,47,Carrión de los Condes,2096,996,1100
34,Palencia,48,Castil de Vela,63,30,33
34,Palencia,49,Castrejón de la Peña,360,193,167
34,Palencia,50,Castrillo de Don Juan,220,124,96
34,Palencia,51,Castrillo de Onielo,101,53,48
34,Palencia,52,Castrillo de Villavega,183,100,83
34,Palencia,53,Castromocho,230,119,111
34,Palencia,55,Cervatos de la Cueza,262,144,118
34,Palencia,56,Cervera de Pisuerga,2316,1165,1151
34,Palencia,57,Cevico de la Torre,490,243,247
34,Palencia,58,Cevico Navero,198,112,86
34,Palencia,59,Cisneros,448,220,228
34,Palencia,60,Cobos de Cerrato,139,76,63
34,Palencia,61,Collazos de Boedo,105,61,44
34,Palencia,62,Congosto de Valdavia,165,101,64
34,Palencia,63,Cordovilla la Real,93,55,38
34,Palencia,66,Cubillas de Cerrato,63,36,27
34,Palencia,67,Dehesa de Montejo,136,78,58
34,Palencia,68,Dehesa de Romanos,42,25,17
34,Palencia,69,Dueñas,2633,1343,1290
34,Palencia,70,Espinosa de Cerrato,149,79,70
34,Palencia,71,Espinosa de Villagonzalo,179,94,85
34,Palencia,72,Frechilla,153,75,78
34,Palencia,73,Fresno del Río,194,97,97
34,Palencia,74,Frómista,770,397,373
34,Palencia,76,Fuentes de Nava,659,340,319
34,Palencia,77,Fuentes de Valdepero,429,226,203
34,Palencia,79,Grijota,2269,1184,1085
34,Palencia,80,Guardo,6153,3057,3096
34,Palencia,81,Guaza de Campos,58,36,22
34,Palencia,82,Hérmedes de Cerrato,78,41,37
34,Palencia,83,Herrera de Pisuerga,2006,977,1029
34,Palencia,84,Herrera de Valdecañas,146,83,63
34,Palencia,86,Hontoria de Cerrato,103,53,50
34,Palencia,87,Hornillos de Cerrato,143,78,65
34,Palencia,88,Husillos,313,180,133
34,Palencia,89,Itero de la Vega,157,88,69
34,Palencia,91,Lagartos,136,77,59
34,Palencia,92,Lantadilla,291,154,137
34,Palencia,94,Ledigos,63,36,27
34,Palencia,903,Loma de Ucieza,198,114,84
34,Palencia,96,Lomas,51,32,19
34,Palencia,98,Magaz de Pisuerga,993,528,465
34,Palencia,99,Manquillos,82,44,38
34,Palencia,100,Mantinos,144,81,63
34,Palencia,101,Marcilla de Campos,41,19,22
34,Palencia,102,Mazariegos,217,126,91
34,Palencia,103,Mazuecos de Valdeginate,102,62,40
34,Palencia,104,Melgar de Yuso,259,148,111
34,Palencia,106,Meneses de Campos,122,66,56
34,Palencia,107,Micieces de Ojeda,74,42,32
34,Palencia,108,Monzón de Campos,610,318,292
34,Palencia,109,Moratinos,59,35,24
34,Palencia,110,Mudá,82,46,36
34,Palencia,112,Nogal de las Huertas,46,25,21
34,Palencia,113,Olea de Boedo,39,14,25
34,Palencia,114,Olmos de Ojeda,198,121,77
34,Palencia,116,Osornillo,57,32,25
34,Palencia,901,Osorno la Mayor,1225,654,571
34,Palencia,120,Palencia,78629,37076,41553
34,Palencia,121,Palenzuela,211,120,91
34,Palencia,122,Páramo de Boedo,121,68,53
34,Palencia,123,Paredes de Nava,1930,986,944
34,Palencia,124,Payo de Ojeda,66,39,27
34,Palencia,125,Pedraza de Campos,88,43,45
34,Palencia,126,Pedrosa de la Vega,324,180,144
34,Palencia,127,Perales,90,49,41
34,Palencia,904,"Pernía, La",320,184,136
34,Palencia,129,Pino del Río,179,108,71
34,Palencia,130,Piña de Campos,220,114,106
34,Palencia,131,Población de Arroyo,61,32,29
34,Palencia,132,Población de Campos,131,72,59
34,Palencia,133,Población de Cerrato,110,64,46
34,Palencia,134,Polentinos,42,23,19
34,Palencia,135,Pomar de Valdivia,463,260,203
34,Palencia,136,Poza de la Vega,184,109,75
34,Palencia,137,Pozo de Urama,24,16,8
34,Palencia,139,Prádanos de Ojeda,194,102,92
34,Palencia,140,"Puebla de Valdavia, La",105,57,48
34,Palencia,141,Quintana del Puente,252,142,110
34,Palencia,143,Quintanilla de Onsoña,184,110,74
34,Palencia,146,Reinoso de Cerrato,53,35,18
34,Palencia,147,Renedo de la Vega,198,109,89
34,Palencia,149,Requena de Campos,21,10,11
34,Palencia,151,Respenda de la Peña,154,90,64
34,Palencia,152,Revenga de Campos,151,82,69
34,Palencia,154,Revilla de Collazos,80,46,34
34,Palencia,155,Ribas de Campos,146,73,73
34,Palencia,156,Riberos de la Cueza,52,34,18
34,Palencia,157,Saldaña,3004,1528,1476
34,Palencia,158,Salinas de Pisuerga,317,165,152
34,Palencia,159,San Cebrián de Campos,433,238,195
34,Palencia,160,San Cebrián de Mudá,162,88,74
34,Palencia,161,San Cristóbal de Boedo,23,14,9
34,Palencia,163,San Mamés de Campos,51,26,25
34,Palencia,165,San Román de la Cuba,65,38,27
34,Palencia,167,Santa Cecilia del Alcor,120,68,52
34,Palencia,168,Santa Cruz de Boedo,52,32,20
34,Palencia,169,Santervás de la Vega,459,259,200
34,Palencia,170,Santibáñez de Ecla,54,30,24
34,Palencia,171,Santibáñez de la Peña,1044,514,530
34,Palencia,174,Santoyo,197,109,88
34,Palencia,175,"Serna, La",100,62,38
34,Palencia,177,Soto de Cerrato,191,109,82
34,Palencia,176,Sotobañado y Priorato,145,86,59
34,Palencia,178,Tabanera de Cerrato,137,73,64
34,Palencia,179,Tabanera de Valdavia,25,15,10
34,Palencia,180,Támara de Campos,71,37,34
34,Palencia,181,Tariego de Cerrato,490,260,230
34,Palencia,182,Torquemada,968,526,442
34,Palencia,184,Torremormojón,45,25,20
34,Palencia,185,Triollo,64,35,29
34,Palencia,186,Valbuena de Pisuerga,47,25,22
34,Palencia,189,Valdeolmillos,61,36,25
34,Palencia,190,Valderrábano,51,28,23
34,Palencia,192,Valde-Ucieza,96,57,39
34,Palencia,196,Valle de Cerrato,88,52,36
34,Palencia,902,Valle del Retortillo,174,107,67
34,Palencia,199,Velilla del Río Carrión,1299,666,633
34,Palencia,23,Venta de Baños,6363,3195,3168
34,Palencia,201,Vertavillo,184,99,85
34,Palencia,93,"Vid de Ojeda, La",98,57,41
34,Palencia,202,Villabasta de Valdavia,32,18,14
34,Palencia,204,Villacidaler,48,28,20
34,Palencia,205,Villaconancio,63,36,27
34,Palencia,206,Villada,963,491,472
34,Palencia,208,Villaeles de Valdavia,58,34,24
34,Palencia,210,Villahán,104,52,52
34,Palencia,211,Villaherreros,193,97,96
34,Palencia,213,Villalaco,57,31,26
34,Palencia,214,Villalba de Guardo,196,104,92
34,Palencia,215,Villalcázar de Sirga,169,88,81
34,Palencia,216,Villalcón,66,39,27
34,Palencia,217,Villalobón,1652,832,820
34,Palencia,218,Villaluenga de la Vega,589,333,256
34,Palencia,220,Villamartín de Campos,177,99,78
34,Palencia,221,Villamediana,175,97,78
34,Palencia,222,Villameriel,118,64,54
34,Palencia,223,Villamoronta,235,138,97
34,Palencia,224,Villamuera de la Cueza,45,30,15
34,Palencia,225,Villamuriel de Cerrato,6503,3360,3143
34,Palencia,227,Villanueva del Rebollar,75,37,38
34,Palencia,228,Villanuño de Valdavia,90,51,39
34,Palencia,229,Villaprovedo,62,41,21
34,Palencia,230,Villarmentero de Campos,16,11,5
34,Palencia,231,Villarrabé,207,111,96
34,Palencia,232,Villarramiel,826,451,375
34,Palencia,233,Villasarracino,143,84,59
34,Palencia,234,Villasila de Valdavia,71,48,23
34,Palencia,236,Villaturde,155,82,73
34,Palencia,237,Villaumbrales,665,335,330
34,Palencia,238,Villaviudas,365,177,188
34,Palencia,240,Villerías de Campos,97,52,45
34,Palencia,241,Villodre,17,10,7
34,Palencia,242,Villodrigo,109,57,52
34,Palencia,243,Villoldo,369,194,175
34,Palencia,245,Villota del Páramo,327,183,144
34,Palencia,246,Villovieco,75,39,36
35,"Palmas, Las",1,Agaete,5573,2783,2790
35,"Palmas, Las",2,Agüimes,31152,15777,15375
35,"Palmas, Las",20,"Aldea de San Nicolás, La",7608,3882,3726
35,"Palmas, Las",3,Antigua,11948,6370,5578
35,"Palmas, Las",4,Arrecife,61351,30724,30627
35,"Palmas, Las",5,Artenara,1090,589,501
35,"Palmas, Las",6,Arucas,37691,18735,18956
35,"Palmas, Las",7,Betancuria,731,385,346
35,"Palmas, Las",8,Firgas,7491,3766,3725
35,"Palmas, Las",9,Gáldar,24209,12118,12091
35,"Palmas, Las",10,Haría,4969,2532,2437
35,"Palmas, Las",11,Ingenio,30831,15532,15299
35,"Palmas, Las",12,Mogán,19657,10146,9511
35,"Palmas, Las",13,Moya,7728,3933,3795
35,"Palmas, Las",14,"Oliva, La",25884,13505,12379
35,"Palmas, Las",15,Pájara,20539,10661,9878
35,"Palmas, Las",16,"Palmas de Gran Canaria, Las",378517,183034,195483
35,"Palmas, Las",17,Puerto del Rosario,39382,19989,19393
35,"Palmas, Las",18,San Bartolomé,18327,9181,9146
35,"Palmas, Las",19,San Bartolomé de Tirajana,53588,27932,25656
35,"Palmas, Las",21,Santa Brígida,18314,9102,9212
35,"Palmas, Las",22,Santa Lucía de Tirajana,71863,35916,35947
35,"Palmas, Las",23,Santa María de Guía de Gran Canaria,13924,6928,6996
35,"Palmas, Las",24,Teguise,22122,11179,10943
35,"Palmas, Las",25,Tejeda,1921,1041,880
35,"Palmas, Las",26,Telde,102424,50411,52013
35,"Palmas, Las",27,Teror,12449,6392,6057
35,"Palmas, Las",28,Tías,20006,10259,9747
35,"Palmas, Las",29,Tinajo,6119,3176,2943
35,"Palmas, Las",30,Tuineje,14791,7559,7232
35,"Palmas, Las",32,Valleseco,3784,1974,1810
35,"Palmas, Las",31,Valsequillo de Gran Canaria,9278,4670,4608
35,"Palmas, Las",33,Vega de San Mateo,7625,3938,3687
35,"Palmas, Las",34,Yaiza,16289,8436,7853
36,Pontevedra,20,Agolada,2370,1182,1188
36,Pontevedra,1,Arbo,2637,1348,1289
36,Pontevedra,3,Baiona,12134,5984,6150
36,Pontevedra,2,Barro,3716,1846,1870
36,Pontevedra,4,Bueu,12148,5983,6165
36,Pontevedra,5,Caldas de Reis,9860,4748,5112
36,Pontevedra,6,Cambados,13814,6673,7141
36,Pontevedra,7,Campo Lameiro,1806,848,958
36,Pontevedra,8,Cangas,26487,13078,13409
36,Pontevedra,9,"Cañiza, A",5173,2527,2646
36,Pontevedra,10,Catoira,3349,1623,1726
36,Pontevedra,902,Cerdedo-Cotobade,5815,2795,3020
36,Pontevedra,13,Covelo,2417,1224,1193
36,Pontevedra,14,Crecente,2032,981,1051
36,Pontevedra,15,Cuntis,4710,2243,2467
36,Pontevedra,16,Dozón,1110,579,531
36,Pontevedra,17,"Estrada, A",20661,9912,10749
36,Pontevedra,18,Forcarei,3451,1649,1802
36,Pontevedra,19,Fornelos de Montes,1640,783,857
36,Pontevedra,21,Gondomar,14236,7074,7162
36,Pontevedra,22,"Grove, O",10700,5289,5411
36,Pontevedra,23,"Guarda, A",10013,4875,5138
36,Pontevedra,901,"Illa de Arousa, A",4958,2459,2499
36,Pontevedra,24,Lalín,20103,9743,10360
36,Pontevedra,25,"Lama, A",2430,1192,1238
36,Pontevedra,26,Marín,24362,12175,12187
36,Pontevedra,27,Meaño,5315,2595,2720
36,Pontevedra,28,Meis,4776,2279,2497
36,Pontevedra,29,Moaña,19448,9435,10013
36,Pontevedra,30,Mondariz,4496,2232,2264
36,Pontevedra,31,Mondariz-Balneario,618,317,301
36,Pontevedra,32,Moraña,4200,2025,2175
36,Pontevedra,33,Mos,15142,7490,7652
36,Pontevedra,34,"Neves, As",3892,1881,2011
36,Pontevedra,35,Nigrán,17723,8701,9022
36,Pontevedra,36,Oia,3018,1513,1505
36,Pontevedra,37,Pazos de Borbén,2980,1461,1519
36,Pontevedra,41,Poio,17018,8441,8577
36,Pontevedra,43,Ponte Caldelas,5491,2642,2849
36,Pontevedra,42,Ponteareas,22854,11091,11763
36,Pontevedra,44,Pontecesures,3037,1505,1532
36,Pontevedra,38,Pontevedra,82802,39189,43613
36,Pontevedra,39,"Porriño, O",19740,9735,10005
36,Pontevedra,40,Portas,2984,1431,1553
36,Pontevedra,45,Redondela,29194,14219,14975
36,Pontevedra,46,Ribadumia,5069,2478,2591
36,Pontevedra,47,Rodeiro,2509,1274,1235
36,Pontevedra,48,"Rosal, O",6249,3070,3179
36,Pontevedra,49,Salceda de Caselas,9146,4557,4589
36,Pontevedra,50,Salvaterra de Miño,9691,4846,4845
36,Pontevedra,51,Sanxenxo,17212,8487,8725
36,Pontevedra,52,Silleda,8698,4237,4461
36,Pontevedra,53,Soutomaior,7305,3622,3683
36,Pontevedra,54,Tomiño,13464,6782,6682
36,Pontevedra,55,Tui,16902,8164,8738
36,Pontevedra,56,Valga,5927,2914,3013
36,Pontevedra,57,Vigo,293642,138980,154662
36,Pontevedra,59,Vila de Cruces,5273,2589,2684
36,Pontevedra,58,Vilaboa,5954,2899,3055
36,Pontevedra,60,Vilagarcía de Arousa,37519,17970,19549
36,Pontevedra,61,Vilanova de Arousa,10352,5035,5317
26,"Rioja, La",1,Ábalos,255,150,105
26,"Rioja, La",2,Agoncillo,1105,599,506
26,"Rioja, La",3,Aguilar del Río Alhama,470,233,237
26,"Rioja, La",4,Ajamil de Cameros,62,44,18
26,"Rioja, La",5,Albelda de Iregua,3462,1762,1700
26,"Rioja, La",6,Alberite,2433,1229,1204
26,"Rioja, La",7,Alcanadre,644,338,306
26,"Rioja, La",8,Aldeanueva de Ebro,2732,1427,1305
26,"Rioja, La",9,Alesanco,502,269,233
26,"Rioja, La",10,Alesón,102,61,41
26,"Rioja, La",11,Alfaro,9460,4763,4697
26,"Rioja, La",12,Almarza de Cameros,28,16,12
26,"Rioja, La",13,Anguciana,434,237,197
26,"Rioja, La",14,Anguiano,509,287,222
26,"Rioja, La",15,Arenzana de Abajo,226,117,109
26,"Rioja, La",16,Arenzana de Arriba,30,20,10
26,"Rioja, La",17,Arnedillo,426,210,216
26,"Rioja, La",18,Arnedo,14815,7373,7442
26,"Rioja, La",19,Arrúbal,488,261,227
26,"Rioja, La",20,Ausejo,754,399,355
26,"Rioja, La",21,Autol,4469,2218,2251
26,"Rioja, La",22,Azofra,200,106,94
26,"Rioja, La",23,Badarán,502,256,246
26,"Rioja, La",24,Bañares,234,124,110
26,"Rioja, La",26,Baños de Río Tobía,1590,792,798
26,"Rioja, La",25,Baños de Rioja,86,53,33
26,"Rioja, La",27,Berceo,159,101,58
26,"Rioja, La",28,Bergasa,142,78,64
26,"Rioja, La",29,Bergasillas Bajera,39,21,18
26,"Rioja, La",30,Bezares,19,9,10
26,"Rioja, La",31,Bobadilla,104,53,51
26,"Rioja, La",32,Brieva de Cameros,51,30,21
26,"Rioja, La",33,Briñas,201,89,112
26,"Rioja, La",34,Briones,766,409,357
26,"Rioja, La",35,Cabezón de Cameros,20,14,6
26,"Rioja, La",36,Calahorra,23923,11741,12182
26,"Rioja, La",37,Camprovín,151,82,69
26,"Rioja, La",38,Canales de la Sierra,85,57,28
26,"Rioja, La",39,Canillas de Río Tuerto,40,20,20
26,"Rioja, La",40,Cañas,97,51,46
26,"Rioja, La",41,Cárdenas,147,80,67
26,"Rioja, La",42,Casalarreina,1145,583,562
26,"Rioja, La",43,Castañares de Rioja,424,204,220
26,"Rioja, La",44,Castroviejo,50,30,20
26,"Rioja, La",45,Cellorigo,12,5,7
26,"Rioja, La",46,Cenicero,2036,1043,993
26,"Rioja, La",47,Cervera del Río Alhama,2298,1193,1105
26,"Rioja, La",48,Cidamón,24,12,12
26,"Rioja, La",49,Cihuri,197,106,91
26,"Rioja, La",50,Cirueña,142,92,50
26,"Rioja, La",51,Clavijo,273,162,111
26,"Rioja, La",52,Cordovín,157,78,79
26,"Rioja, La",53,Corera,252,132,120
26,"Rioja, La",54,Cornago,319,185,134
26,"Rioja, La",55,Corporales,39,23,16
26,"Rioja, La",56,Cuzcurrita de Río Tirón,488,266,222
26,"Rioja, La",57,Daroca de Rioja,47,32,15
26,"Rioja, La",58,Enciso,167,103,64
26,"Rioja, La",59,Entrena,1519,800,719
26,"Rioja, La",60,Estollo,93,62,31
26,"Rioja, La",61,Ezcaray,2027,1045,982
26,"Rioja, La",62,Foncea,96,55,41
26,"Rioja, La",63,Fonzaleche,134,85,49
26,"Rioja, La",64,Fuenmayor,3108,1569,1539
26,"Rioja, La",65,Galbárruli,50,32,18
26,"Rioja, La",66,Galilea,332,168,164
26,"Rioja, La",67,Gallinero de Cameros,18,12,6
26,"Rioja, La",68,Gimileo,116,63,53
26,"Rioja, La",69,Grañón,255,146,109
26,"Rioja, La",70,Grávalos,179,92,87
26,"Rioja, La",71,Haro,11309,5543,5766
26,"Rioja, La",72,Herce,330,172,158
26,"Rioja, La",73,Herramélluri,110,60,50
26,"Rioja, La",74,Hervías,120,62,58
26,"Rioja, La",75,Hormilla,440,236,204
26,"Rioja, La",76,Hormilleja,130,66,64
26,"Rioja, La",77,Hornillos de Cameros,18,8,10
26,"Rioja, La",78,Hornos de Moncalvillo,92,53,39
26,"Rioja, La",79,Huércanos,818,443,375
26,"Rioja, La",80,Igea,608,344,264
26,"Rioja, La",81,Jalón de Cameros,18,10,8
26,"Rioja, La",82,Laguna de Cameros,116,71,45
26,"Rioja, La",83,Lagunilla del Jubera,293,161,132
26,"Rioja, La",84,Lardero,10193,5124,5069
26,"Rioja, La",86,Ledesma de la Cogolla,15,12,3
26,"Rioja, La",87,Leiva,238,123,115
26,"Rioja, La",88,Leza de Río Leza,33,18,15
26,"Rioja, La",89,Logroño,151113,71860,79253
26,"Rioja, La",91,Lumbreras,168,111,57
26,"Rioja, La",92,Manjarrés,117,72,45
26,"Rioja, La",93,Mansilla de la Sierra,55,41,14
26,"Rioja, La",94,Manzanares de Rioja,72,42,30
26,"Rioja, La",95,Matute,93,49,44
26,"Rioja, La",96,Medrano,321,174,147
26,"Rioja, La",98,Munilla,108,61,47
26,"Rioja, La",99,Murillo de Río Leza,1654,847,807
26,"Rioja, La",100,Muro de Aguas,59,34,25
26,"Rioja, La",101,Muro en Cameros,39,23,16
26,"Rioja, La",102,Nájera,8047,3948,4099
26,"Rioja, La",103,Nalda,988,528,460
26,"Rioja, La",104,Navajún,15,10,5
26,"Rioja, La",105,Navarrete,2952,1500,1452
26,"Rioja, La",106,Nestares,86,48,38
26,"Rioja, La",107,Nieva de Cameros,92,61,31
26,"Rioja, La",109,Ochánduri,82,49,33
26,"Rioja, La",108,Ocón,282,173,109
26,"Rioja, La",110,Ojacastro,175,105,70
26,"Rioja, La",111,Ollauri,286,151,135
26,"Rioja, La",112,Ortigosa de Cameros,246,145,101
26,"Rioja, La",113,Pazuengos,31,24,7
26,"Rioja, La",114,Pedroso,76,53,23
26,"Rioja, La",115,Pinillos,15,9,6
26,"Rioja, La",117,Pradejón,3822,1954,1868
26,"Rioja, La",118,Pradillo,71,36,35
26,"Rioja, La",119,Préjano,217,121,96
26,"Rioja, La",120,Quel,2032,1065,967
26,"Rioja, La",121,Rabanera,32,23,9
26,"Rioja, La",122,"Rasillo de Cameros, El",130,67,63
26,"Rioja, La",123,"Redal, El",138,77,61
26,"Rioja, La",124,Ribafrecha,961,503,458
26,"Rioja, La",125,Rincón de Soto,3722,1892,1830
26,"Rioja, La",126,Robres del Castillo,29,19,10
26,"Rioja, La",127,Rodezno,229,122,107
26,"Rioja, La",128,Sajazarra,130,65,65
26,"Rioja, La",129,San Asensio,1124,598,526
26,"Rioja, La",130,San Millán de la Cogolla,222,149,73
26,"Rioja, La",131,San Millán de Yécora,35,24,11
26,"Rioja, La",132,San Román de Cameros,142,85,57
26,"Rioja, La",139,San Torcuato,64,32,32
26,"Rioja, La",142,San Vicente de la Sonsierra,1015,529,486
26,"Rioja, La",134,Santa Coloma,88,55,33
26,"Rioja, La",135,Santa Engracia del Jubera,154,99,55
26,"Rioja, La",136,Santa Eulalia Bajera,107,58,49
26,"Rioja, La",138,Santo Domingo de la Calzada,6231,3123,3108
26,"Rioja, La",140,Santurde de Rioja,288,153,135
26,"Rioja, La",141,Santurdejo,109,68,41
26,"Rioja, La",143,Sojuela,296,167,129
26,"Rioja, La",144,Sorzano,232,135,97
26,"Rioja, La",145,Sotés,297,167,130
26,"Rioja, La",146,Soto en Cameros,87,50,37
26,"Rioja, La",147,Terroba,30,16,14
26,"Rioja, La",148,Tirgo,186,93,93
26,"Rioja, La",149,Tobía,47,28,19
26,"Rioja, La",150,Tormantos,139,81,58
26,"Rioja, La",153,Torre en Cameros,10,8,2
26,"Rioja, La",151,Torrecilla en Cameros,464,253,211
26,"Rioja, La",152,Torrecilla sobre Alesanco,30,19,11
26,"Rioja, La",154,Torremontalbo,10,6,4
26,"Rioja, La",155,Treviana,168,91,77
26,"Rioja, La",157,Tricio,358,177,181
26,"Rioja, La",158,Tudelilla,359,195,164
26,"Rioja, La",160,Uruñuela,988,504,484
26,"Rioja, La",161,Valdemadera,8,5,3
26,"Rioja, La",162,Valgañón,133,81,52
26,"Rioja, La",163,Ventosa,169,87,82
26,"Rioja, La",164,Ventrosa,59,33,26
26,"Rioja, La",165,Viguera,390,220,170
26,"Rioja, La",166,Villalba de Rioja,154,95,59
26,"Rioja, La",167,Villalobar de Rioja,67,44,23
26,"Rioja, La",168,Villamediana de Iregua,7973,4019,3954
26,"Rioja, La",169,Villanueva de Cameros,72,40,32
26,"Rioja, La",170,"Villar de Arnedo, El",597,309,288
26,"Rioja, La",171,Villar de Torre,163,98,65
26,"Rioja, La",172,Villarejo,27,21,6
26,"Rioja, La",173,Villarroya,5,3,2
26,"Rioja, La",174,Villarta-Quintana,140,83,57
26,"Rioja, La",175,Villavelayo,48,31,17
26,"Rioja, La",176,Villaverde de Rioja,57,32,25
26,"Rioja, La",177,Villoslada de Cameros,325,199,126
26,"Rioja, La",178,Viniegra de Abajo,78,45,33
26,"Rioja, La",179,Viniegra de Arriba,42,29,13
26,"Rioja, La",180,Zarratón,258,141,117
26,"Rioja, La",181,Zarzosa,14,10,4
26,"Rioja, La",183,Zorraquín,91,45,46
37,Salamanca,1,Abusejo,193,102,91
37,Salamanca,2,Agallas,146,75,71
37,Salamanca,3,Ahigal de los Aceiteros,120,65,55
37,Salamanca,4,Ahigal de Villarino,34,19,15
37,Salamanca,5,"Alameda de Gardón, La",76,39,37
37,Salamanca,6,"Alamedilla, La",138,69,69
37,Salamanca,7,Alaraz,463,241,222
37,Salamanca,8,Alba de Tormes,5166,2591,2575
37,Salamanca,9,Alba de Yeltes,220,119,101
37,Salamanca,10,"Alberca, La",1107,547,560
37,Salamanca,11,"Alberguería de Argañán, La",116,58,58
37,Salamanca,12,Alconada,155,83,72
37,Salamanca,15,Aldea del Obispo,266,141,125
37,Salamanca,13,Aldeacipreste,116,61,55
37,Salamanca,14,Aldeadávila de la Ribera,1239,624,615
37,Salamanca,16,Aldealengua,696,349,347
37,Salamanca,17,Aldeanueva de Figueroa,256,136,120
37,Salamanca,18,Aldeanueva de la Sierra,113,65,48
37,Salamanca,19,Aldearrodrigo,141,78,63
37,Salamanca,20,Aldearrubia,486,263,223
37,Salamanca,21,Aldeaseca de Alba,74,35,39
37,Salamanca,22,Aldeaseca de la Frontera,269,138,131
37,Salamanca,23,Aldeatejada,1989,995,994
37,Salamanca,24,Aldeavieja de Tormes,102,53,49
37,Salamanca,25,Aldehuela de la Bóveda,290,155,135
37,Salamanca,26,Aldehuela de Yeltes,195,104,91
37,Salamanca,27,Almenara de Tormes,254,143,111
37,Salamanca,28,Almendra,157,92,65
37,Salamanca,29,Anaya de Alba,215,122,93
37,Salamanca,30,Añover de Tormes,93,50,43
37,Salamanca,31,Arabayona de Mógica,372,208,164
37,Salamanca,32,Arapiles,644,346,298
37,Salamanca,33,Arcediano,102,55,47
37,Salamanca,34,"Arco, El",86,42,44
37,Salamanca,35,Armenteros,200,114,86
37,Salamanca,37,"Atalaya, La",113,64,49
37,Salamanca,38,Babilafuente,911,469,442
37,Salamanca,39,Bañobárez,309,158,151
37,Salamanca,40,Barbadillo,410,217,193
37,Salamanca,41,Barbalos,75,42,33
37,Salamanca,42,Barceo,46,30,16
37,Salamanca,44,Barruecopardo,442,238,204
37,Salamanca,45,"Bastida, La",26,14,12
37,Salamanca,46,Béjar,12961,6133,6828
37,Salamanca,47,Beleña,223,121,102
37,Salamanca,49,Bermellar,132,66,66
37,Salamanca,50,Berrocal de Huebra,69,40,29
37,Salamanca,51,Berrocal de Salvatierra,85,48,37
37,Salamanca,52,Boada,315,155,160
37,Salamanca,54,"Bodón, El",286,150,136
37,Salamanca,55,Bogajo,137,74,63
37,Salamanca,56,"Bouza, La",53,24,29
37,Salamanca,57,Bóveda del Río Almar,231,127,104
37,Salamanca,58,Brincones,56,29,27
37,Salamanca,59,Buenamadre,132,69,63
37,Salamanca,60,Buenavista,351,189,162
37,Salamanca,61,"Cabaco, El",232,117,115
37,Salamanca,63,"Cabeza de Béjar, La",67,41,26
37,Salamanca,65,Cabeza del Caballo,291,157,134
37,Salamanca,62,Cabezabellosa de la Calzada,77,45,32
37,Salamanca,67,Cabrerizos,4256,2129,2127
37,Salamanca,68,Cabrillas,383,195,188
37,Salamanca,69,Calvarrasa de Abajo,1152,610,542
37,Salamanca,70,Calvarrasa de Arriba,600,324,276
37,Salamanca,71,"Calzada de Béjar, La",86,46,40
37,Salamanca,72,Calzada de Don Diego,161,84,77
37,Salamanca,73,Calzada de Valdunciel,676,340,336
37,Salamanca,74,Campillo de Azaba,164,96,68
37,Salamanca,77,"Campo de Peñaranda, El",266,153,113
37,Salamanca,78,Candelario,906,458,448
37,Salamanca,79,Canillas de Abajo,77,54,23
37,Salamanca,80,Cantagallo,260,139,121
37,Salamanca,81,Cantalapiedra,986,518,468
37,Salamanca,82,Cantalpino,878,482,396
37,Salamanca,83,Cantaracillo,195,108,87
37,Salamanca,85,Carbajosa de la Sagrada,6947,3456,3491
37,Salamanca,86,Carpio de Azaba,100,57,43
37,Salamanca,87,Carrascal de Barregas,1188,622,566
37,Salamanca,88,Carrascal del Obispo,217,117,100
37,Salamanca,89,Casafranca,68,37,31
37,Salamanca,90,"Casas del Conde, Las",61,28,33
37,Salamanca,91,Casillas de Flores,191,94,97
37,Salamanca,92,Castellanos de Moriscos,2615,1339,1276
37,Salamanca,185,Castellanos de Villiquera,633,343,290
37,Salamanca,96,Castillejo de Martín Viejo,216,127,89
37,Salamanca,97,Castraz,42,27,15
37,Salamanca,98,Cepeda,331,166,165
37,Salamanca,99,Cereceda de la Sierra,66,34,32
37,Salamanca,100,Cerezal de Peñahorcada,76,41,35
37,Salamanca,101,Cerralbo,154,86,68
37,Salamanca,102,"Cerro, El",409,204,205
37,Salamanca,103,Cespedosa de Tormes,490,262,228
37,Salamanca,114,Chagarcía Medianero,78,42,36
37,Salamanca,104,Cilleros de la Bastida,25,12,13
37,Salamanca,106,Cipérez,279,146,133
37,Salamanca,107,Ciudad Rodrigo,12513,6031,6482
37,Salamanca,108,Coca de Alba,108,50,58
37,Salamanca,109,Colmenar de Montemayor,182,103,79
37,Salamanca,110,Cordovilla,123,63,60
37,Salamanca,112,Cristóbal,155,89,66
37,Salamanca,113,"Cubo de Don Sancho, El",450,242,208
37,Salamanca,115,Dios le Guarde,127,69,58
37,Salamanca,116,Doñinos de Ledesma,73,39,34
37,Salamanca,117,Doñinos de Salamanca,2050,1072,978
37,Salamanca,118,Éjeme,126,72,54
37,Salamanca,120,Encina de San Silvestre,110,53,57
37,Salamanca,119,"Encina, La",103,61,42
37,Salamanca,121,Encinas de Abajo,635,337,298
37,Salamanca,122,Encinas de Arriba,233,118,115
37,Salamanca,123,Encinasola de los Comendadores,170,92,78
37,Salamanca,124,Endrinal,225,122,103
37,Salamanca,125,Escurial de la Sierra,235,136,99
37,Salamanca,126,Espadaña,34,20,14
37,Salamanca,127,Espeja,231,118,113
37,Salamanca,128,Espino de la Orbada,279,152,127
37,Salamanca,129,Florida de Liébana,272,147,125
37,Salamanca,130,Forfoleda,193,106,87
37,Salamanca,131,Frades de la Sierra,191,105,86
37,Salamanca,132,"Fregeneda, La",362,182,180
37,Salamanca,133,Fresnedoso,109,64,45
37,Salamanca,134,Fresno Alhándiga,217,120,97
37,Salamanca,135,"Fuente de San Esteban, La",1336,668,668
37,Salamanca,136,Fuenteguinaldo,680,336,344
37,Salamanca,137,Fuenteliante,108,54,54
37,Salamanca,138,Fuenterroble de Salvatierra,248,127,121
37,Salamanca,139,Fuentes de Béjar,232,116,116
37,Salamanca,140,Fuentes de Oñoro,1188,626,562
37,Salamanca,141,Gajates,160,74,86
37,Salamanca,142,Galindo y Perahuy,690,396,294
37,Salamanca,143,Galinduste,429,210,219
37,Salamanca,144,Galisancho,385,208,177
37,Salamanca,145,Gallegos de Argañán,280,140,140
37,Salamanca,146,Gallegos de Solmirón,115,65,50
37,Salamanca,147,Garcibuey,187,108,79
37,Salamanca,148,Garcihernández,464,245,219
37,Salamanca,149,Garcirrey,64,37,27
37,Salamanca,150,Gejuelo del Barro,38,22,16
37,Salamanca,151,Golpejas,154,79,75
37,Salamanca,152,Gomecello,444,238,206
37,Salamanca,154,Guadramiro,145,85,60
37,Salamanca,155,Guijo de Ávila,68,41,27
37,Salamanca,156,Guijuelo,5660,2825,2835
37,Salamanca,157,Herguijuela de Ciudad Rodrigo,78,47,31
37,Salamanca,158,Herguijuela de la Sierra,264,149,115
37,Salamanca,159,Herguijuela del Campo,83,40,43
37,Salamanca,160,Hinojosa de Duero,669,337,332
37,Salamanca,161,Horcajo de Montemayor,140,75,65
37,Salamanca,162,Horcajo Medianero,222,116,106
37,Salamanca,163,"Hoya, La",37,21,16
37,Salamanca,164,Huerta,299,167,132
37,Salamanca,165,Iruelos,34,15,19
37,Salamanca,166,Ituero de Azaba,224,116,108
37,Salamanca,167,Juzbado,191,100,91
37,Salamanca,168,Lagunilla,486,262,224
37,Salamanca,169,Larrodrigo,192,110,82
37,Salamanca,170,Ledesma,1636,826,810
37,Salamanca,171,Ledrada,478,241,237
37,Salamanca,172,Linares de Riofrío,963,526,437
37,Salamanca,173,Lumbrales,1619,819,800
37,Salamanca,175,Machacón,459,237,222
37,Salamanca,174,Macotera,1085,563,522
37,Salamanca,176,Madroñal,140,77,63
37,Salamanca,177,"Maíllo, El",266,149,117
37,Salamanca,178,Malpartida,100,56,44
37,Salamanca,179,Mancera de Abajo,212,112,100
37,Salamanca,180,"Manzano, El",72,39,33
37,Salamanca,181,Martiago,285,153,132
37,Salamanca,183,Martín de Yeltes,421,218,203
37,Salamanca,182,Martinamor,84,50,34
37,Salamanca,184,Masueco,289,145,144
37,Salamanca,186,"Mata de Ledesma, La",103,57,46
37,Salamanca,187,Matilla de los Caños del Río,627,314,313
37,Salamanca,188,"Maya, La",176,106,70
37,Salamanca,189,Membribe de la Sierra,114,68,46
37,Salamanca,190,Mieza,208,103,105
37,Salamanca,191,"Milano, El",115,68,47
37,Salamanca,192,Miranda de Azán,426,224,202
37,Salamanca,193,Miranda del Castañar,399,214,185
37,Salamanca,194,Mogarraz,275,142,133
37,Salamanca,195,Molinillo,44,26,18
37,Salamanca,196,Monforte de la Sierra,70,38,32
37,Salamanca,197,Monleón,91,52,39
37,Salamanca,198,Monleras,226,106,120
37,Salamanca,199,Monsagro,142,75,67
37,Salamanca,200,Montejo,221,125,96
37,Salamanca,201,Montemayor del Río,266,142,124
37,Salamanca,202,Monterrubio de Armuña,1323,696,627
37,Salamanca,203,Monterrubio de la Sierra,158,90,68
37,Salamanca,204,Morasverdes,263,143,120
37,Salamanca,205,Morille,230,125,105
37,Salamanca,206,Moríñigo,100,55,45
37,Salamanca,207,Moriscos,384,213,171
37,Salamanca,208,Moronta,74,46,28
37,Salamanca,209,Mozárbez,493,262,231
37,Salamanca,211,Narros de Matalayegua,231,129,102
37,Salamanca,213,Nava de Béjar,98,55,43
37,Salamanca,214,Nava de Francia,131,72,59
37,Salamanca,215,Nava de Sotrobal,158,91,67
37,Salamanca,212,Navacarros,98,53,45
37,Salamanca,216,Navales,332,182,150
37,Salamanca,217,Navalmoral de Béjar,60,27,33
37,Salamanca,218,Navamorales,56,37,19
37,Salamanca,219,Navarredonda de la Rinconada,177,90,87
37,Salamanca,221,Navasfrías,460,240,220
37,Salamanca,222,Negrilla de Palencia,90,52,38
37,Salamanca,223,Olmedo de Camaces,100,53,47
37,Salamanca,224,"Orbada, La",207,108,99
37,Salamanca,225,Pajares de la Laguna,113,60,53
37,Salamanca,226,Palacios del Arzobispo,161,78,83
37,Salamanca,228,Palaciosrubios,354,189,165
37,Salamanca,229,Palencia de Negrilla,157,90,67
37,Salamanca,230,Parada de Arriba,249,127,122
37,Salamanca,231,Parada de Rubiales,259,138,121
37,Salamanca,232,Paradinas de San Juan,406,239,167
37,Salamanca,233,Pastores,56,33,23
37,Salamanca,234,"Payo, El",335,164,171
37,Salamanca,235,Pedraza de Alba,238,125,113
37,Salamanca,236,Pedrosillo de Alba,142,82,60
37,Salamanca,237,Pedrosillo de los Aires,360,201,159
37,Salamanca,238,Pedrosillo el Ralo,126,66,60
37,Salamanca,239,"Pedroso de la Armuña, El",216,111,105
37,Salamanca,240,Pelabravo,1232,660,572
37,Salamanca,241,Pelarrodríguez,172,103,69
37,Salamanca,242,Pelayos,85,51,34
37,Salamanca,243,"Peña, La",100,48,52
37,Salamanca,244,Peñacaballera,146,70,76
37,Salamanca,245,Peñaparda,364,182,182
37,Salamanca,246,Peñaranda de Bracamonte,6308,3096,3212
37,Salamanca,247,Peñarandilla,182,98,84
37,Salamanca,248,Peralejos de Abajo,157,83,74
37,Salamanca,249,Peralejos de Arriba,39,25,14
37,Salamanca,250,Pereña de la Ribera,341,181,160
37,Salamanca,251,Peromingo,122,58,64
37,Salamanca,252,Pinedas,113,64,49
37,Salamanca,253,"Pino de Tormes, El",159,84,75
37,Salamanca,254,Pitiegua,188,105,83
37,Salamanca,255,Pizarral,47,30,17
37,Salamanca,256,Poveda de las Cintas,223,127,96
37,Salamanca,257,Pozos de Hinojo,46,25,21
37,Salamanca,258,Puebla de Azaba,177,94,83
37,Salamanca,259,Puebla de San Medel,38,23,15
37,Salamanca,260,Puebla de Yeltes,149,77,72
37,Salamanca,261,Puente del Congosto,227,127,100
37,Salamanca,262,Puertas,79,44,35
37,Salamanca,263,Puerto de Béjar,370,181,189
37,Salamanca,264,Puerto Seguro,59,29,30
37,Salamanca,265,Rágama,223,117,106
37,Salamanca,266,"Redonda, La",79,46,33
37,Salamanca,267,Retortillo,198,110,88
37,Salamanca,268,"Rinconada de la Sierra, La",117,66,51
37,Salamanca,269,Robleda,499,268,231
37,Salamanca,270,Robliza de Cojos,196,100,96
37,Salamanca,271,Rollán,376,207,169
37,Salamanca,272,Saelices el Chico,147,81,66
37,Salamanca,273,"Sagrada, La",99,56,43
37,Salamanca,303,"Sahugo, El",193,106,87
37,Salamanca,274,Salamanca,143978,65278,78700
37,Salamanca,275,Saldeana,109,60,49
37,Salamanca,276,Salmoral,137,83,54
37,Salamanca,277,Salvatierra de Tormes,75,36,39
37,Salamanca,278,San Cristóbal de la Cuesta,1015,538,477
37,Salamanca,284,San Esteban de la Sierra,347,195,152
37,Salamanca,285,San Felices de los Gallegos,413,214,199
37,Salamanca,286,San Martín del Castañar,219,118,101
37,Salamanca,287,San Miguel de Valero,347,180,167
37,Salamanca,36,San Miguel del Robledo,56,32,24
37,Salamanca,288,San Morales,337,187,150
37,Salamanca,289,San Muñoz,239,122,117
37,Salamanca,291,San Pedro de Rozados,301,166,135
37,Salamanca,290,San Pedro del Valle,145,80,65
37,Salamanca,292,San Pelayo de Guareña,89,49,40
37,Salamanca,280,Sanchón de la Ribera,84,44,40
37,Salamanca,281,Sanchón de la Sagrada,39,23,16
37,Salamanca,282,Sanchotello,222,119,103
37,Salamanca,279,Sancti-Spíritus,826,448,378
37,Salamanca,283,Sando,125,76,49
37,Salamanca,293,Santa María de Sando,114,59,55
37,Salamanca,294,Santa Marta de Tormes,14732,7249,7483
37,Salamanca,296,Santiago de la Puebla,324,170,154
37,Salamanca,297,Santibáñez de Béjar,467,234,233
37,Salamanca,298,Santibáñez de la Sierra,186,102,84
37,Salamanca,299,Santiz,244,129,115
37,Salamanca,300,"Santos, Los",614,315,299
37,Salamanca,301,Sardón de los Frailes,91,52,39
37,Salamanca,302,Saucelle,283,145,138
37,Salamanca,304,Sepulcro-Hilario,178,101,77
37,Salamanca,305,Sequeros,239,116,123
37,Salamanca,306,Serradilla del Arroyo,270,146,124
37,Salamanca,307,Serradilla del Llano,154,80,74
37,Salamanca,309,"Sierpe, La",44,20,24
37,Salamanca,310,Sieteiglesias de Tormes,187,91,96
37,Salamanca,311,Sobradillo,232,117,115
37,Salamanca,312,Sorihuela,273,142,131
37,Salamanca,313,Sotoserrano,580,307,273
37,Salamanca,314,Tabera de Abajo,107,62,45
37,Salamanca,315,"Tala, La",88,49,39
37,Salamanca,316,Tamames,804,408,396
37,Salamanca,317,Tarazona de Guareña,317,170,147
37,Salamanca,318,Tardáguila,212,123,89
37,Salamanca,319,"Tejado, El",104,56,48
37,Salamanca,320,Tejeda y Segoyuela,90,50,40
37,Salamanca,321,Tenebrón,151,74,77
37,Salamanca,322,Terradillos,3051,1537,1514
37,Salamanca,323,Topas,530,287,243
37,Salamanca,324,Tordillos,362,196,166
37,Salamanca,325,"Tornadizo, El",98,55,43
37,Salamanca,327,Torresmenudas,191,96,95
37,Salamanca,328,Trabanca,200,98,102
37,Salamanca,329,Tremedal de Tormes,43,23,20
37,Salamanca,330,Valdecarros,351,179,172
37,Salamanca,331,Valdefuentes de Sangusín,203,115,88
37,Salamanca,332,Valdehijaderos,79,43,36
37,Salamanca,333,Valdelacasa,214,127,87
37,Salamanca,334,Valdelageve,73,37,36
37,Salamanca,335,Valdelosa,407,199,208
37,Salamanca,336,Valdemierque,65,41,24
37,Salamanca,337,Valderrodrigo,152,74,78
37,Salamanca,338,Valdunciel,100,50,50
37,Salamanca,339,Valero,330,184,146
37,Salamanca,343,Vallejera de Riofrío,76,35,41
37,Salamanca,340,Valsalabroso,149,83,66
37,Salamanca,341,Valverde de Valdelacasa,74,43,31
37,Salamanca,342,Valverdón,288,150,138
37,Salamanca,344,Vecinos,264,133,131
37,Salamanca,345,Vega de Tirados,168,91,77
37,Salamanca,346,"Veguillas, Las",285,134,151
37,Salamanca,347,"Vellés, La",554,302,252
37,Salamanca,348,Ventosa del Río Almar,112,65,47
37,Salamanca,349,"Vídola, La",116,56,60
37,Salamanca,351,Villaflores,282,145,137
37,Salamanca,352,Villagonzalo de Tormes,206,120,86
37,Salamanca,353,Villalba de los Llanos,133,75,58
37,Salamanca,354,Villamayor,7207,3605,3602
37,Salamanca,355,Villanueva del Conde,159,80,79
37,Salamanca,356,Villar de Argañán,95,49,46
37,Salamanca,357,Villar de Ciervo,279,142,137
37,Salamanca,358,Villar de Gallimazo,201,127,74
37,Salamanca,359,Villar de la Yegua,179,94,85
37,Salamanca,360,Villar de Peralonso,229,115,114
37,Salamanca,361,Villar de Samaniego,89,50,39
37,Salamanca,362,Villares de la Reina,6316,3134,3182
37,Salamanca,363,Villares de Yeltes,123,59,64
37,Salamanca,364,Villarino de los Aires,805,417,388
37,Salamanca,365,Villarmayor,197,111,86
37,Salamanca,366,Villarmuerto,43,28,15
37,Salamanca,367,Villasbuenas,191,106,85
37,Salamanca,368,Villasdardo,23,8,15
37,Salamanca,369,Villaseco de los Gamitos,135,79,56
37,Salamanca,370,Villaseco de los Reyes,324,186,138
37,Salamanca,371,Villasrubias,283,155,128
37,Salamanca,372,Villaverde de Guareña,145,82,63
37,Salamanca,373,Villavieja de Yeltes,785,410,375
37,Salamanca,374,Villoria,1358,687,671
37,Salamanca,375,Villoruela,780,392,388
37,Salamanca,350,Vilvestre,422,210,212
37,Salamanca,376,Vitigudino,2538,1237,1301
37,Salamanca,377,Yecla de Yeltes,244,129,115
37,Salamanca,378,Zamarra,98,57,41
37,Salamanca,379,Zamayón,206,126,80
37,Salamanca,380,Zarapicos,59,33,26
37,Salamanca,381,"Zarza de Pumareda, La",148,83,65
37,Salamanca,382,Zorita de la Frontera,160,83,77
38,Santa Cruz de Tenerife,1,Adeje,47280,23844,23436
38,Santa Cruz de Tenerife,2,Agulo,1067,545,522
38,Santa Cruz de Tenerife,3,Alajeró,2006,1060,946
38,Santa Cruz de Tenerife,4,Arafo,5562,2733,2829
38,Santa Cruz de Tenerife,5,Arico,7831,4092,3739
38,Santa Cruz de Tenerife,6,Arona,79448,40638,38810
38,Santa Cruz de Tenerife,7,Barlovento,1855,941,914
38,Santa Cruz de Tenerife,8,Breña Alta,7154,3499,3655
38,Santa Cruz de Tenerife,9,Breña Baja,5498,2790,2708
38,Santa Cruz de Tenerife,10,Buenavista del Norte,4755,2405,2350
38,Santa Cruz de Tenerife,11,Candelaria,27641,13426,14215
38,Santa Cruz de Tenerife,12,Fasnia,2768,1444,1324
38,Santa Cruz de Tenerife,13,Frontera,4018,2022,1996
38,Santa Cruz de Tenerife,14,Fuencaliente de la Palma,1709,872,837
38,Santa Cruz de Tenerife,15,Garachico,4819,2411,2408
38,Santa Cruz de Tenerife,16,Garafía,1626,853,773
38,Santa Cruz de Tenerife,17,Granadilla de Abona,48374,24156,24218
38,Santa Cruz de Tenerife,18,"Guancha, La",5428,2647,2781
38,Santa Cruz de Tenerife,19,Guía de Isora,20991,10485,10506
38,Santa Cruz de Tenerife,20,Güímar,19739,9792,9947
38,Santa Cruz de Tenerife,21,Hermigua,1805,927,878
38,Santa Cruz de Tenerife,22,Icod de los Vinos,22749,11198,11551
38,Santa Cruz de Tenerife,24,"Llanos de Aridane, Los",20171,9769,10402
38,Santa Cruz de Tenerife,25,"Matanza de Acentejo, La",8956,4507,4449
38,Santa Cruz de Tenerife,26,"Orotava, La",41833,20512,21321
38,Santa Cruz de Tenerife,27,"Paso, El",7543,3747,3796
38,Santa Cruz de Tenerife,901,"Pinar de El Hierro, El",1825,963,862
38,Santa Cruz de Tenerife,28,Puerto de la Cruz,30483,14902,15581
38,Santa Cruz de Tenerife,29,Puntagorda,2073,1055,1018
38,Santa Cruz de Tenerife,30,Puntallana,2493,1234,1259
38,Santa Cruz de Tenerife,31,"Realejos, Los",36405,17868,18537
38,Santa Cruz de Tenerife,32,"Rosario, El",17352,8772,8580
38,Santa Cruz de Tenerife,33,San Andrés y Sauces,4112,2065,2047
38,Santa Cruz de Tenerife,23,San Cristóbal de La Laguna,155549,75361,80188
38,Santa Cruz de Tenerife,34,San Juan de la Rambla,4799,2380,2419
38,Santa Cruz de Tenerife,35,San Miguel de Abona,19672,9895,9777
38,Santa Cruz de Tenerife,36,San Sebastián de la Gomera,8945,4481,4464
38,Santa Cruz de Tenerife,37,Santa Cruz de la Palma,15674,7588,8086
38,Santa Cruz de Tenerife,38,Santa Cruz de Tenerife,204856,97841,107015
38,Santa Cruz de Tenerife,39,Santa Úrsula,14445,7223,7222
38,Santa Cruz de Tenerife,40,Santiago del Teide,10755,5347,5408
38,Santa Cruz de Tenerife,41,"Sauzal, El",8947,4407,4540
38,Santa Cruz de Tenerife,42,"Silos, Los",4757,2374,2383
38,Santa Cruz de Tenerife,43,Tacoronte,23961,11908,12053
38,Santa Cruz de Tenerife,44,"Tanque, El",2670,1293,1377
38,Santa Cruz de Tenerife,45,Tazacorte,4600,2350,2250
38,Santa Cruz de Tenerife,46,Tegueste,11203,5531,5672
38,Santa Cruz de Tenerife,47,Tijarafe,2564,1298,1266
38,Santa Cruz de Tenerife,49,Valle Gran Rey,4484,2256,2228
38,Santa Cruz de Tenerife,50,Vallehermoso,2829,1471,1358
38,Santa Cruz de Tenerife,48,Valverde,4955,2500,2455
38,Santa Cruz de Tenerife,51,"Victoria de Acentejo, La",9040,4540,4500
38,Santa Cruz de Tenerife,52,Vilaflor de Chasna,1645,851,794
38,Santa Cruz de Tenerife,53,Villa de Mazo,4791,2408,2383
40,Segovia,1,Abades,845,420,425
40,Segovia,2,Adrada de Pirón,44,23,21
40,Segovia,3,Adrados,139,78,61
40,Segovia,4,Aguilafuente,587,287,300
40,Segovia,5,Alconada de Maderuelo,27,18,9
40,Segovia,12,Aldea Real,301,159,142
40,Segovia,6,Aldealcorvo,22,13,9
40,Segovia,7,Aldealengua de Pedraza,76,48,28
40,Segovia,8,Aldealengua de Santa María,56,30,26
40,Segovia,9,Aldeanueva de la Serrezuela,48,34,14
40,Segovia,10,Aldeanueva del Codonal,123,64,59
40,Segovia,13,Aldeasoña,57,33,24
40,Segovia,14,Aldehorno,57,33,24
40,Segovia,15,Aldehuela del Codonal,25,14,11
40,Segovia,16,Aldeonte,55,28,27
40,Segovia,17,Anaya,131,60,71
40,Segovia,18,Añe,79,45,34
40,Segovia,19,Arahuetes,32,23,9
40,Segovia,20,Arcones,175,83,92
40,Segovia,21,Arevalillo de Cega,21,12,9
40,Segovia,22,Armuña,229,131,98
40,Segovia,24,Ayllón,1203,623,580
40,Segovia,25,Barbolla,169,91,78
40,Segovia,26,Basardilla,149,62,87
40,Segovia,28,Bercial,111,60,51
40,Segovia,29,Bercimuel,25,13,12
40,Segovia,30,Bernardos,494,271,223
40,Segovia,31,Bernuy de Porreros,760,406,354
40,Segovia,32,Boceguillas,716,369,347
40,Segovia,33,Brieva,86,48,38
40,Segovia,34,Caballar,85,47,38
40,Segovia,35,Cabañas de Polendos,186,100,86
40,Segovia,36,Cabezuela,671,345,326
40,Segovia,37,Calabazas de Fuentidueña,30,16,14
40,Segovia,39,Campo de San Pedro,258,137,121
40,Segovia,40,Cantalejo,3543,1759,1784
40,Segovia,41,Cantimpalos,1321,695,626
40,Segovia,161,Carabias,49,32,17
40,Segovia,43,Carbonero el Mayor,2529,1309,1220
40,Segovia,44,Carrascal del Río,147,78,69
40,Segovia,45,Casla,157,85,72
40,Segovia,46,Castillejo de Mesleón,130,72,58
40,Segovia,47,Castro de Fuentidueña,29,19,10
40,Segovia,48,Castrojimeno,36,19,17
40,Segovia,49,Castroserna de Abajo,50,28,22
40,Segovia,51,Castroserracín,45,26,19
40,Segovia,52,Cedillo de la Torre,95,51,44
40,Segovia,53,Cerezo de Abajo,117,62,55
40,Segovia,54,Cerezo de Arriba,138,78,60
40,Segovia,65,Chañe,754,380,374
40,Segovia,55,Cilleruelo de San Mamés,35,22,13
40,Segovia,56,Cobos de Fuentidueña,34,17,17
40,Segovia,57,Coca,1774,892,882
40,Segovia,58,Codorniz,334,167,167
40,Segovia,59,Collado Hermoso,123,60,63
40,Segovia,60,Condado de Castilnovo,95,53,42
40,Segovia,61,Corral de Ayllón,78,47,31
40,Segovia,902,Cozuelos de Fuentidueña,129,70,59
40,Segovia,62,Cubillo,77,47,30
40,Segovia,63,Cuéllar,9584,4838,4746
40,Segovia,905,Cuevas de Provanco,135,75,60
40,Segovia,68,Domingo García,27,17,10
40,Segovia,69,Donhierro,91,51,40
40,Segovia,70,Duruelo,178,106,72
40,Segovia,71,Encinas,43,22,21
40,Segovia,72,Encinillas,273,148,125
40,Segovia,73,Escalona del Prado,501,263,238
40,Segovia,74,Escarabajosa de Cabezas,300,164,136
40,Segovia,75,Escobar de Polendos,173,92,81
40,Segovia,76,"Espinar, El",9061,4602,4459
40,Segovia,77,Espirdo,1301,689,612
40,Segovia,78,Fresneda de Cuéllar,166,93,73
40,Segovia,79,Fresno de Cantespino,262,144,118
40,Segovia,80,Fresno de la Fuente,71,39,32
40,Segovia,81,Frumales,116,62,54
40,Segovia,82,Fuente de Santa Cruz,119,65,54
40,Segovia,83,Fuente el Olmo de Fuentidueña,172,78,94
40,Segovia,84,Fuente el Olmo de Íscar,60,35,25
40,Segovia,86,Fuentepelayo,852,449,403
40,Segovia,87,Fuentepiñel,96,53,43
40,Segovia,88,Fuenterrebollo,343,176,167
40,Segovia,89,Fuentesaúco de Fuentidueña,241,128,113
40,Segovia,91,Fuentesoto,103,57,46
40,Segovia,92,Fuentidueña,142,82,60
40,Segovia,93,Gallegos,94,52,42
40,Segovia,94,Garcillán,450,233,217
40,Segovia,95,Gomezserracín,688,362,326
40,Segovia,97,Grajera,223,127,96
40,Segovia,99,Honrubia de la Cuesta,58,34,24
40,Segovia,100,Hontalbilla,308,169,139
40,Segovia,101,Hontanares de Eresma,1404,733,671
40,Segovia,103,"Huertos, Los",179,103,76
40,Segovia,104,Ituero y Lama,361,192,169
40,Segovia,105,Juarros de Riomoros,43,23,20
40,Segovia,106,Juarros de Voltoya,208,103,105
40,Segovia,107,Labajos,116,66,50
40,Segovia,108,Laguna de Contreras,111,65,46
40,Segovia,109,Languilla,82,50,32
40,Segovia,110,Lastras de Cuéllar,355,184,171
40,Segovia,111,Lastras del Pozo,67,35,32
40,Segovia,112,"Lastrilla, La",3773,1911,1862
40,Segovia,113,"Losa, La",523,293,230
40,Segovia,115,Maderuelo,97,56,41
40,Segovia,903,Marazoleja,106,70,36
40,Segovia,118,Marazuela,53,30,23
40,Segovia,119,Martín Miguel,225,133,92
40,Segovia,120,Martín Muñoz de la Dehesa,222,115,107
40,Segovia,121,Martín Muñoz de las Posadas,288,149,139
40,Segovia,122,Marugán,617,334,283
40,Segovia,124,Mata de Cuéllar,264,139,125
40,Segovia,123,Matabuena,178,97,81
40,Segovia,125,"Matilla, La",89,53,36
40,Segovia,126,Melque de Cercos,77,40,37
40,Segovia,127,Membibre de la Hoz,29,16,13
40,Segovia,128,Migueláñez,137,75,62
40,Segovia,129,Montejo de Arévalo,185,100,85
40,Segovia,130,Montejo de la Vega de la Serrezuela,148,88,60
40,Segovia,131,Monterrubio,61,35,26
40,Segovia,132,Moral de Hornuez,54,31,23
40,Segovia,134,Mozoncillo,904,488,416
40,Segovia,135,Muñopedro,306,166,140
40,Segovia,136,Muñoveros,154,75,79
40,Segovia,138,Nava de la Asunción,2790,1414,1376
40,Segovia,139,Navafría,291,156,135
40,Segovia,140,Navalilla,106,56,50
40,Segovia,141,Navalmanzano,1062,553,509
40,Segovia,142,Navares de Ayuso,53,27,26
40,Segovia,143,Navares de Enmedio,91,55,36
40,Segovia,144,Navares de las Cuevas,25,16,9
40,Segovia,145,Navas de Oro,1347,684,663
40,Segovia,904,Navas de Riofrío,395,191,204
40,Segovia,146,Navas de San Antonio,322,166,156
40,Segovia,148,Nieva,265,138,127
40,Segovia,149,Olombrada,561,298,263
40,Segovia,150,Orejana,60,36,24
40,Segovia,151,Ortigosa de Pestaño,54,29,25
40,Segovia,901,Ortigosa del Monte,568,308,260
40,Segovia,152,Otero de Herreros,963,485,478
40,Segovia,154,Pajarejos,12,8,4
40,Segovia,155,Palazuelos de Eresma,5308,2738,2570
40,Segovia,156,Pedraza,359,204,155
40,Segovia,157,Pelayos del Arroyo,46,27,19
40,Segovia,158,Perosillo,15,12,3
40,Segovia,159,Pinarejos,188,109,79
40,Segovia,160,Pinarnegrillo,100,55,45
40,Segovia,162,Prádena,520,275,245
40,Segovia,163,Puebla de Pedraza,46,24,22
40,Segovia,164,Rapariegos,202,103,99
40,Segovia,181,Real Sitio de San Ildefonso,5267,2610,2657
40,Segovia,165,Rebollo,84,45,39
40,Segovia,166,Remondo,305,160,145
40,Segovia,168,Riaguas de San Bartolomé,28,18,10
40,Segovia,170,Riaza,2099,1120,979
40,Segovia,171,Ribota,39,31,8
40,Segovia,172,Riofrío de Riaza,38,25,13
40,Segovia,173,Roda de Eresma,185,99,86
40,Segovia,174,Sacramenia,372,196,176
40,Segovia,176,Samboal,463,249,214
40,Segovia,177,San Cristóbal de Cuéllar,148,81,67
40,Segovia,178,San Cristóbal de la Vega,104,57,47
40,Segovia,906,San Cristóbal de Segovia,3021,1519,1502
40,Segovia,182,San Martín y Mudrián,239,114,125
40,Segovia,183,San Miguel de Bernuy,135,68,67
40,Segovia,184,San Pedro de Gaíllos,297,158,139
40,Segovia,179,Sanchonuño,930,450,480
40,Segovia,180,Sangarcía,321,178,143
40,Segovia,185,Santa María la Real de Nieva,999,547,452
40,Segovia,186,Santa Marta del Cerro,39,20,19
40,Segovia,188,Santiuste de Pedraza,94,62,32
40,Segovia,189,Santiuste de San Juan Bautista,556,307,249
40,Segovia,190,Santo Domingo de Pirón,61,35,26
40,Segovia,191,Santo Tomé del Puerto,259,142,117
40,Segovia,192,Sauquillo de Cabezas,154,86,68
40,Segovia,193,Sebúlcor,260,137,123
40,Segovia,194,Segovia,51683,24207,27476
40,Segovia,195,Sepúlveda,1065,550,515
40,Segovia,196,Sequera de Fresno,34,23,11
40,Segovia,198,Sotillo,25,14,11
40,Segovia,199,Sotosalbos,113,60,53
40,Segovia,200,Tabanera la Luenga,51,24,27
40,Segovia,201,Tolocirio,50,24,26
40,Segovia,206,Torre Val de San Pedro,187,96,91
40,Segovia,202,Torreadrada,57,25,32
40,Segovia,203,Torrecaballeros,1323,691,632
40,Segovia,204,Torrecilla del Pinar,194,108,86
40,Segovia,205,Torreiglesias,260,139,121
40,Segovia,207,Trescasas,1052,544,508
40,Segovia,208,Turégano,979,486,493
40,Segovia,210,Urueñas,107,66,41
40,Segovia,211,Valdeprados,70,39,31
40,Segovia,212,Valdevacas de Montejo,30,15,15
40,Segovia,213,Valdevacas y Guijar,91,49,42
40,Segovia,218,Valle de Tabladillo,94,56,38
40,Segovia,219,Vallelado,704,377,327
40,Segovia,220,Valleruela de Pedraza,73,37,36
40,Segovia,221,Valleruela de Sepúlveda,54,27,27
40,Segovia,214,Valseca,241,136,105
40,Segovia,215,Valtiendas,80,46,34
40,Segovia,216,Valverde del Majano,1096,566,530
40,Segovia,222,Veganzones,230,127,103
40,Segovia,223,Vegas de Matute,260,156,104
40,Segovia,224,Ventosilla y Tejadilla,20,12,8
40,Segovia,225,Villacastín,1493,783,710
40,Segovia,228,Villaverde de Íscar,621,327,294
40,Segovia,229,Villaverde de Montejo,27,16,11
40,Segovia,230,Villeguillo,111,65,46
40,Segovia,231,Yanguas de Eresma,134,68,66
40,Segovia,233,Zarzuela del Monte,505,263,242
40,Segovia,234,Zarzuela del Pinar,444,231,213
41,Sevilla,1,Aguadulce,2026,1006,1020
41,Sevilla,2,Alanís,1746,881,865
41,Sevilla,3,Albaida del Aljarafe,3193,1604,1589
41,Sevilla,4,Alcalá de Guadaíra,75256,37383,37873
41,Sevilla,5,Alcalá del Río,11927,6072,5855
41,Sevilla,6,Alcolea del Río,3387,1690,1697
41,Sevilla,7,"Algaba, La",16301,8081,8220
41,Sevilla,8,Algámitas,1248,642,606
41,Sevilla,9,Almadén de la Plata,1379,716,663
41,Sevilla,10,Almensilla,6008,2999,3009
41,Sevilla,11,Arahal,19565,9682,9883
41,Sevilla,12,Aznalcázar,4495,2257,2238
41,Sevilla,13,Aznalcóllar,6092,3106,2986
41,Sevilla,14,Badolatosa,3094,1594,1500
41,Sevilla,15,Benacazón,7177,3613,3564
41,Sevilla,16,Bollullos de la Mitación,10647,5336,5311
41,Sevilla,17,Bormujos,21964,10895,11069
41,Sevilla,18,Brenes,12608,6278,6330
41,Sevilla,19,Burguillos,6618,3313,3305
41,Sevilla,20,"Cabezas de San Juan, Las",16379,8193,8186
41,Sevilla,21,Camas,27463,13434,14029
41,Sevilla,22,"Campana, La",5281,2632,2649
41,Sevilla,23,Cantillana,10661,5443,5218
41,Sevilla,901,Cañada Rosal,3307,1632,1675
41,Sevilla,24,Carmona,28620,14379,14241
41,Sevilla,25,Carrión de los Céspedes,2500,1221,1279
41,Sevilla,26,Casariche,5530,2821,2709
41,Sevilla,27,Castilblanco de los Arroyos,4810,2420,2390
41,Sevilla,28,Castilleja de Guzmán,2826,1455,1371
41,Sevilla,29,Castilleja de la Cuesta,17350,8428,8922
41,Sevilla,30,Castilleja del Campo,625,324,301
41,Sevilla,31,"Castillo de las Guardas, El",1439,741,698
41,Sevilla,32,Cazalla de la Sierra,4789,2360,2429
41,Sevilla,33,Constantina,5954,2943,3011
41,Sevilla,34,Coria del Río,30657,15304,15353
41,Sevilla,35,Coripe,1290,637,653
41,Sevilla,36,"Coronil, El",4807,2415,2392
41,Sevilla,37,"Corrales, Los",3958,2012,1946
41,Sevilla,903,"Cuervo de Sevilla, El",8628,4346,4282
41,Sevilla,38,Dos Hermanas,133168,65541,67627
41,Sevilla,39,Écija,39882,19662,20220
41,Sevilla,40,Espartinas,15683,7865,7818
41,Sevilla,41,Estepa,12503,6238,6265
41,Sevilla,42,Fuentes de Andalucía,7139,3557,3582
41,Sevilla,43,"Garrobo, El",789,400,389
41,Sevilla,44,Gelves,10054,5007,5047
41,Sevilla,45,Gerena,7541,3791,3750
41,Sevilla,46,Gilena,3790,1902,1888
41,Sevilla,47,Gines,13471,6625,6846
41,Sevilla,48,Guadalcanal,2646,1318,1328
41,Sevilla,49,Guillena,12650,6399,6251
41,Sevilla,50,Herrera,6485,3214,3271
41,Sevilla,51,Huévar del Aljarafe,2944,1508,1436
41,Sevilla,902,Isla Mayor,5857,2923,2934
41,Sevilla,52,Lantejuela,3834,1969,1865
41,Sevilla,53,Lebrija,27432,13695,13737
41,Sevilla,54,Lora de Estepa,860,435,425
41,Sevilla,55,Lora del Río,18861,9351,9510
41,Sevilla,56,"Luisiana, La",4572,2307,2265
41,Sevilla,57,"Madroño, El",282,141,141
41,Sevilla,58,Mairena del Alcor,23473,11744,11729
41,Sevilla,59,Mairena del Aljarafe,45890,22348,23542
41,Sevilla,60,Marchena,19580,9781,9799
41,Sevilla,61,Marinaleda,2626,1340,1286
41,Sevilla,62,Martín de la Jara,2720,1405,1315
41,Sevilla,63,"Molares, Los",3460,1759,1701
41,Sevilla,64,Montellano,7081,3542,3539
41,Sevilla,65,Morón de la Frontera,27844,13728,14116
41,Sevilla,66,"Navas de la Concepción, Las",1581,782,799
41,Sevilla,67,Olivares,9390,4710,4680
41,Sevilla,68,Osuna,17622,8780,8842
41,Sevilla,69,"Palacios y Villafranca, Los",38246,19220,19026
41,Sevilla,70,Palomares del Río,8552,4311,4241
41,Sevilla,71,Paradas,6924,3446,3478
41,Sevilla,72,Pedrera,5205,2579,2626
41,Sevilla,73,"Pedroso, El",2037,1006,1031
41,Sevilla,74,Peñaflor,3669,1844,1825
41,Sevilla,75,Pilas,13949,7021,6928
41,Sevilla,76,Pruna,2658,1360,1298
41,Sevilla,77,"Puebla de Cazalla, La",11033,5492,5541
41,Sevilla,78,"Puebla de los Infantes, La",3013,1495,1518
41,Sevilla,79,"Puebla del Río, La",11879,5879,6000
41,Sevilla,80,"Real de la Jara, El",1507,746,761
41,Sevilla,81,"Rinconada, La",38406,19013,19393
41,Sevilla,82,"Roda de Andalucía, La",4243,2106,2137
41,Sevilla,83,"Ronquillo, El",1360,684,676
41,Sevilla,84,"Rubio, El",3445,1701,1744
41,Sevilla,85,Salteras,5477,2655,2822
41,Sevilla,86,San Juan de Aznalfarache,21195,10194,11001
41,Sevilla,88,San Nicolás del Puerto,599,310,289
41,Sevilla,87,Sanlúcar la Mayor,13683,6774,6909
41,Sevilla,89,Santiponce,8442,4189,4253
41,Sevilla,90,"Saucejo, El",4301,2131,2170
41,Sevilla,91,Sevilla,688711,326935,361776
41,Sevilla,92,Tocina,9578,4755,4823
41,Sevilla,93,Tomares,25220,12451,12769
41,Sevilla,94,Umbrete,8768,4406,4362
41,Sevilla,95,Utrera,52617,26140,26477
41,Sevilla,96,Valencina de la Concepción,7803,3828,3975
41,Sevilla,97,Villamanrique de la Condesa,4478,2214,2264
41,Sevilla,100,Villanueva de San Juan,1155,562,593
41,Sevilla,98,Villanueva del Ariscal,6571,3208,3363
41,Sevilla,99,Villanueva del Río y Minas,4860,2438,2422
41,Sevilla,101,Villaverde del Río,7797,3943,3854
41,Sevilla,102,"Viso del Alcor, El",19191,9608,9583
42,Soria,1,Abejar,302,162,140
42,Soria,3,Adradas,44,25,19
42,Soria,4,Ágreda,3008,1535,1473
42,Soria,6,Alconaba,189,119,70
42,Soria,7,Alcubilla de Avellaneda,108,57,51
42,Soria,8,Alcubilla de las Peñas,59,35,24
42,Soria,9,Aldealafuente,87,46,41
42,Soria,10,Aldealices,34,21,13
42,Soria,11,Aldealpozo,18,8,10
42,Soria,12,Aldealseñor,30,16,14
42,Soria,13,Aldehuela de Periáñez,36,21,15
42,Soria,14,"Aldehuelas, Las",64,35,29
42,Soria,15,Alentisque,33,20,13
42,Soria,16,Aliud,18,13,5
42,Soria,17,Almajano,183,96,87
42,Soria,18,Almaluez,139,78,61
42,Soria,19,Almarza,572,336,236
42,Soria,20,Almazán,5526,2807,2719
42,Soria,21,Almazul,70,42,28
42,Soria,22,Almenar de Soria,236,138,98
42,Soria,23,Alpanseque,63,38,25
42,Soria,24,Arancón,85,58,27
42,Soria,25,Arcos de Jalón,1489,789,700
42,Soria,26,Arenillas,24,12,12
42,Soria,27,Arévalo de la Sierra,81,50,31
42,Soria,28,Ausejo de la Sierra,90,48,42
42,Soria,29,Baraona,142,82,60
42,Soria,30,Barca,103,63,40
42,Soria,31,Barcones,23,16,7
42,Soria,32,Bayubas de Abajo,147,82,65
42,Soria,33,Bayubas de Arriba,51,31,20
42,Soria,34,Beratón,29,18,11
42,Soria,35,Berlanga de Duero,877,444,433
42,Soria,36,Blacos,44,24,20
42,Soria,37,Bliecos,35,19,16
42,Soria,38,Borjabad,34,21,13
42,Soria,39,Borobia,240,129,111
42,Soria,41,Buberos,33,18,15
42,Soria,42,Buitrago,59,32,27
42,Soria,43,Burgo de Osma-Ciudad de Osma,4926,2452,2474
42,Soria,44,Cabrejas del Campo,56,34,22
42,Soria,45,Cabrejas del Pinar,357,203,154
42,Soria,46,Calatañazor,51,28,23
42,Soria,48,Caltojar,57,38,19
42,Soria,49,Candilichera,115,68,47
42,Soria,50,Cañamaque,32,24,8
42,Soria,51,Carabantes,16,8,8
42,Soria,52,Caracena,15,11,4
42,Soria,53,Carrascosa de Abajo,23,15,8
42,Soria,54,Carrascosa de la Sierra,17,12,5
42,Soria,55,Casarejos,169,87,82
42,Soria,56,Castilfrío de la Sierra,27,19,8
42,Soria,58,Castillejo de Robledo,109,62,47
42,Soria,57,Castilruiz,169,91,78
42,Soria,59,Centenera de Andaluz,21,10,11
42,Soria,60,Cerbón,30,20,10
42,Soria,61,Cidones,298,181,117
42,Soria,62,Cigudosa,18,11,7
42,Soria,63,Cihuela,50,28,22
42,Soria,64,Ciria,86,43,43
42,Soria,65,Cirujales del Río,22,16,6
42,Soria,68,Coscurita,79,49,30
42,Soria,69,Covaleda,1720,890,830
42,Soria,70,Cubilla,35,21,14
42,Soria,71,Cubo de la Solana,198,109,89
42,Soria,73,Cueva de Ágreda,72,45,27
42,Soria,75,Dévanos,83,47,36
42,Soria,76,Deza,216,114,102
42,Soria,78,Duruelo de la Sierra,1111,568,543
42,Soria,79,Escobosa de Almazán,22,15,7
42,Soria,80,Espeja de San Marcelino,168,99,69
42,Soria,81,Espejón,168,89,79
42,Soria,82,Estepa de San Juan,6,5,1
42,Soria,83,Frechilla de Almazán,24,13,11
42,Soria,84,Fresno de Caracena,18,13,5
42,Soria,85,Fuentearmegil,181,105,76
42,Soria,86,Fuentecambrón,36,22,14
42,Soria,87,Fuentecantos,53,27,26
42,Soria,88,Fuentelmonge,65,38,27
42,Soria,89,Fuentelsaz de Soria,65,32,33
42,Soria,90,Fuentepinilla,88,57,31
42,Soria,92,Fuentes de Magaña,61,36,25
42,Soria,93,Fuentestrún,40,27,13
42,Soria,94,Garray,736,398,338
42,Soria,95,Golmayo,2568,1349,1219
42,Soria,96,Gómara,317,175,142
42,Soria,97,Gormaz,21,14,7
42,Soria,98,Herrera de Soria,9,7,2
42,Soria,100,Hinojosa del Campo,31,20,11
42,Soria,103,Langa de Duero,719,399,320
42,Soria,105,Liceras,52,26,26
42,Soria,106,"Losilla, La",14,10,4
42,Soria,107,Magaña,73,43,30
42,Soria,108,Maján,13,7,6
42,Soria,110,Matalebreras,63,38,25
42,Soria,111,Matamala de Almazán,301,156,145
42,Soria,113,Medinaceli,721,358,363
42,Soria,115,Miño de Medinaceli,84,50,34
42,Soria,116,Miño de San Esteban,48,31,17
42,Soria,117,Molinos de Duero,161,84,77
42,Soria,118,Momblona,23,16,7
42,Soria,119,Monteagudo de las Vicarías,193,101,92
42,Soria,120,Montejo de Tiermes,153,101,52
42,Soria,121,Montenegro de Cameros,57,36,21
42,Soria,123,Morón de Almazán,200,104,96
42,Soria,124,Muriel de la Fuente,60,35,25
42,Soria,125,Muriel Viejo,86,56,30
42,Soria,127,Nafría de Ucero,31,20,11
42,Soria,128,Narros,49,27,22
42,Soria,129,Navaleno,776,413,363
42,Soria,130,Nepas,53,36,17
42,Soria,131,Nolay,56,30,26
42,Soria,132,Noviercas,150,80,70
42,Soria,134,Ólvega,3626,1879,1747
42,Soria,135,Oncala,70,41,29
42,Soria,139,Pinilla del Campo,20,11,9
42,Soria,140,Portillo de Soria,14,9,5
42,Soria,141,"Póveda de Soria, La",106,68,38
42,Soria,142,Pozalmuro,57,27,30
42,Soria,144,Quintana Redonda,488,274,214
42,Soria,145,Quintanas de Gormaz,154,96,58
42,Soria,148,Quiñonería,8,4,4
42,Soria,149,"Rábanos, Los",477,267,210
42,Soria,151,Rebollar,38,17,21
42,Soria,152,Recuerda,87,50,37
42,Soria,153,Rello,14,9,5
42,Soria,154,Renieblas,106,65,41
42,Soria,155,Retortillo de Soria,163,96,67
42,Soria,156,Reznos,30,20,10
42,Soria,157,"Riba de Escalote, La",9,7,2
42,Soria,158,Rioseco de Soria,126,74,52
42,Soria,159,Rollamienta,39,26,13
42,Soria,160,"Royo, El",265,146,119
42,Soria,161,Salduero,144,80,64
42,Soria,162,San Esteban de Gormaz,3010,1580,1430
42,Soria,163,San Felices,55,33,22
42,Soria,164,San Leonardo de Yagüe,2047,1037,1010
42,Soria,165,San Pedro Manrique,617,341,276
42,Soria,166,Santa Cruz de Yanguas,58,36,22
42,Soria,167,Santa María de Huerta,267,148,119
42,Soria,168,Santa María de las Hoyas,102,57,45
42,Soria,171,Serón de Nágima,138,78,60
42,Soria,172,Soliedra,32,17,15
42,Soria,173,Soria,39112,18426,20686
42,Soria,174,Sotillo del Rincón,180,96,84
42,Soria,175,Suellacabras,25,15,10
42,Soria,176,Tajahuerce,28,16,12
42,Soria,177,Tajueco,66,37,29
42,Soria,178,Talveila,118,69,49
42,Soria,181,Tardelcuende,430,229,201
42,Soria,182,Taroda,43,25,18
42,Soria,183,Tejado,106,60,46
42,Soria,184,Torlengua,58,31,27
42,Soria,185,Torreblacos,25,13,12
42,Soria,187,Torrubia de Soria,66,46,20
42,Soria,188,Trévago,52,22,30
42,Soria,189,Ucero,52,28,24
42,Soria,190,Vadillo,90,49,41
42,Soria,191,Valdeavellano de Tera,193,105,88
42,Soria,192,Valdegeña,42,30,12
42,Soria,193,Valdelagua del Cerro,20,11,9
42,Soria,194,Valdemaluque,159,70,89
42,Soria,195,Valdenebro,109,63,46
42,Soria,196,Valdeprado,9,6,3
42,Soria,197,Valderrodilla,71,40,31
42,Soria,198,Valtajeros,25,15,10
42,Soria,200,Velamazán,86,55,31
42,Soria,201,Velilla de la Sierra,25,15,10
42,Soria,202,Velilla de los Ajos,21,11,10
42,Soria,204,Viana de Duero,53,39,14
42,Soria,205,Villaciervos,90,55,35
42,Soria,206,Villanueva de Gormaz,8,6,2
42,Soria,207,Villar del Ala,50,26,24
42,Soria,208,Villar del Campo,22,15,7
42,Soria,209,Villar del Río,145,90,55
42,Soria,211,"Villares de Soria, Los",87,51,36
42,Soria,212,Villasayas,70,46,24
42,Soria,213,Villaseca de Arciel,34,19,15
42,Soria,215,Vinuesa,874,468,406
42,Soria,216,Vizmanos,27,19,8
42,Soria,217,Vozmediano,36,23,13
42,Soria,218,Yanguas,92,58,34
42,Soria,219,Yelo,38,23,15
43,Tarragona,1,Aiguamúrcia,893,457,436
43,Tarragona,2,Albinyana,2371,1202,1169
43,Tarragona,3,"Albiol, L'",464,238,226
43,Tarragona,4,Alcanar,9402,4754,4648
43,Tarragona,5,Alcover,5108,2533,2575
43,Tarragona,904,"Aldea, L'",4137,2186,1951
43,Tarragona,6,Aldover,838,420,418
43,Tarragona,7,"Aleixar, L'",864,442,422
43,Tarragona,8,Alfara de Carles,368,195,173
43,Tarragona,9,Alforja,1788,916,872
43,Tarragona,10,Alió,426,200,226
43,Tarragona,11,Almoster,1342,671,671
43,Tarragona,12,Altafulla,5120,2491,2629
43,Tarragona,13,"Ametlla de Mar, L'",6801,3398,3403
43,Tarragona,906,"Ampolla, L'",3280,1670,1610
43,Tarragona,14,Amposta,20606,10351,10255
43,Tarragona,16,"Arboç, L'",5505,2836,2669
43,Tarragona,15,Arbolí,116,68,48
43,Tarragona,17,"Argentera, L'",129,74,55
43,Tarragona,18,Arnes,466,232,234
43,Tarragona,19,Ascó,1674,871,803
43,Tarragona,20,Banyeres del Penedès,3128,1583,1545
43,Tarragona,21,Barberà de la Conca,476,258,218
43,Tarragona,22,Batea,1898,944,954
43,Tarragona,23,Bellmunt del Priorat,300,156,144
43,Tarragona,24,Bellvei,2190,1120,1070
43,Tarragona,25,Benifallet,714,342,372
43,Tarragona,26,Benissanet,1142,620,522
43,Tarragona,27,"Bisbal de Falset, La",219,119,100
43,Tarragona,28,"Bisbal del Penedès, La",3464,1836,1628
43,Tarragona,29,Blancafort,379,198,181
43,Tarragona,30,Bonastre,687,350,337
43,Tarragona,31,"Borges del Camp, Les",2080,1060,1020
43,Tarragona,32,Bot,601,305,296
43,Tarragona,33,Botarell,1070,554,516
43,Tarragona,34,Bràfim,673,333,340
43,Tarragona,35,Cabacés,305,159,146
43,Tarragona,36,Cabra del Camp,1141,597,544
43,Tarragona,37,Calafell,25444,12767,12677
43,Tarragona,903,Camarles,3278,1666,1612
43,Tarragona,38,Cambrils,33362,16307,17055
43,Tarragona,907,"Canonja, La",5842,2858,2984
43,Tarragona,39,Capafonts,96,51,45
43,Tarragona,40,Capçanes,398,200,198
43,Tarragona,41,Caseres,235,116,119
43,Tarragona,42,Castellvell del Camp,2868,1438,1430
43,Tarragona,43,"Catllar, El",4344,2253,2091
43,Tarragona,45,Colldejou,170,90,80
43,Tarragona,46,Conesa,103,54,49
43,Tarragona,47,Constantí,6516,3411,3105
43,Tarragona,48,Corbera d'Ebre,1023,531,492
43,Tarragona,49,Cornudella de Montsant,964,510,454
43,Tarragona,50,Creixell,3526,1788,1738
43,Tarragona,51,Cunit,12326,6016,6310
43,Tarragona,901,Deltebre,11505,5792,5713
43,Tarragona,53,Duesaigües,237,137,100
43,Tarragona,54,"Espluga de Francolí, L'",3742,1810,1932
43,Tarragona,55,Falset,2807,1405,1402
43,Tarragona,56,"Fatarella, La",965,475,490
43,Tarragona,57,"Febró, La",42,27,15
43,Tarragona,58,"Figuera, La",104,59,45
43,Tarragona,59,Figuerola del Camp,315,156,159
43,Tarragona,60,Flix,3491,1751,1740
43,Tarragona,61,Forès,42,25,17
43,Tarragona,62,Freginals,369,188,181
43,Tarragona,63,"Galera, La",719,372,347
43,Tarragona,64,Gandesa,3009,1534,1475
43,Tarragona,65,Garcia,525,269,256
43,Tarragona,66,"Garidells, Els",201,97,104
43,Tarragona,67,Ginestar,762,403,359
43,Tarragona,68,Godall,591,291,300
43,Tarragona,69,Gratallops,226,126,100
43,Tarragona,70,"Guiamets, Els",270,125,145
43,Tarragona,71,Horta de Sant Joan,1146,598,548
43,Tarragona,72,"Lloar, El",118,62,56
43,Tarragona,73,Llorac,100,56,44
43,Tarragona,74,Llorenç del Penedès,2327,1146,1181
43,Tarragona,76,Marçà,599,320,279
43,Tarragona,75,Margalef,94,57,37
43,Tarragona,77,Mas de Barberans,577,285,292
43,Tarragona,78,Masdenverge,1066,544,522
43,Tarragona,79,Masllorenç,498,275,223
43,Tarragona,80,"Masó, La",276,150,126
43,Tarragona,81,Maspujols,799,410,389
43,Tarragona,82,"Masroig, El",498,275,223
43,Tarragona,83,"Milà, El",183,90,93
43,Tarragona,84,Miravet,706,380,326
43,Tarragona,85,"Molar, El",281,147,134
43,Tarragona,86,Montblanc,7384,3738,3646
43,Tarragona,88,Montbrió del Camp,2828,1456,1372
43,Tarragona,89,Montferri,383,206,177
43,Tarragona,90,"Montmell, El",1437,764,673
43,Tarragona,91,Mont-ral,167,98,69
43,Tarragona,92,Mont-roig del Camp,11809,6140,5669
43,Tarragona,93,Móra d'Ebre,5642,2798,2844
43,Tarragona,94,Móra la Nova,3071,1525,1546
43,Tarragona,95,"Morell, El",3649,1848,1801
43,Tarragona,96,"Morera de Montsant, La",157,87,70
43,Tarragona,97,"Nou de Gaià, La",570,282,288
43,Tarragona,98,Nulles,477,256,221
43,Tarragona,100,"Pallaresos, Els",4739,2384,2355
43,Tarragona,99,"Palma d'Ebre, La",353,168,185
43,Tarragona,101,Passanant i Belltall,150,87,63
43,Tarragona,102,Paüls,561,274,287
43,Tarragona,103,Perafort,1265,657,608
43,Tarragona,104,"Perelló, El",2863,1478,1385
43,Tarragona,105,"Piles, Les",210,115,95
43,Tarragona,106,"Pinell de Brai, El",998,501,497
43,Tarragona,107,Pira,503,268,235
43,Tarragona,108,"Pla de Santa Maria, El",2305,1195,1110
43,Tarragona,109,"Pobla de Mafumet, La",3893,1981,1912
43,Tarragona,110,"Pobla de Massaluca, La",328,180,148
43,Tarragona,111,"Pobla de Montornès, La",2828,1485,1343
43,Tarragona,112,Poboleda,335,182,153
43,Tarragona,113,"Pont d'Armentera, El",512,259,253
43,Tarragona,141,Pontils,114,63,51
43,Tarragona,114,Porrera,441,232,209
43,Tarragona,115,Pradell de la Teixeta,159,71,88
43,Tarragona,116,Prades,589,307,282
43,Tarragona,117,Prat de Comte,179,96,83
43,Tarragona,118,Pratdip,709,374,335
43,Tarragona,119,Puigpelat,1151,586,565
43,Tarragona,120,Querol,521,296,225
43,Tarragona,121,Rasquera,787,387,400
43,Tarragona,122,Renau,153,80,73
43,Tarragona,123,Reus,103477,50030,53447
43,Tarragona,124,"Riba, La",576,318,258
43,Tarragona,125,Riba-roja d'Ebre,1112,589,523
43,Tarragona,126,"Riera de Gaià, La",1701,845,856
43,Tarragona,127,Riudecanyes,1131,591,540
43,Tarragona,128,Riudecols,1186,622,564
43,Tarragona,129,Riudoms,6565,3375,3190
43,Tarragona,130,Rocafort de Queralt,260,140,120
43,Tarragona,131,Roda de Berà,6461,3305,3156
43,Tarragona,132,Rodonyà,480,258,222
43,Tarragona,133,Roquetes,7961,4111,3850
43,Tarragona,134,"Rourell, El",384,197,187
43,Tarragona,135,Salomó,564,298,266
43,Tarragona,905,Salou,26775,13856,12919
43,Tarragona,136,Sant Carles de la Ràpita,14611,7123,7488
43,Tarragona,137,Sant Jaume dels Domenys,2551,1314,1237
43,Tarragona,902,Sant Jaume d'Enveja,3481,1734,1747
43,Tarragona,138,Santa Bàrbara,3777,1916,1861
43,Tarragona,139,Santa Coloma de Queralt,2697,1336,1361
43,Tarragona,140,Santa Oliva,3328,1681,1647
43,Tarragona,142,Sarral,1544,779,765
43,Tarragona,143,Savallà del Comtat,60,32,28
43,Tarragona,144,"Secuita, La",1697,846,851
43,Tarragona,145,"Selva del Camp, La",5632,2824,2808
43,Tarragona,146,Senan,47,32,15
43,Tarragona,44,"Sénia, La",5644,2840,2804
43,Tarragona,147,Solivella,619,318,301
43,Tarragona,148,Tarragona,132299,64282,68017
43,Tarragona,149,Tivenys,882,451,431
43,Tarragona,150,Tivissa,1639,816,823
43,Tarragona,151,"Torre de Fontaubella, La",137,71,66
43,Tarragona,152,"Torre de l'Espanyol, La",628,325,303
43,Tarragona,153,Torredembarra,15992,7821,8171
43,Tarragona,154,Torroja del Priorat,148,82,66
43,Tarragona,155,Tortosa,33510,16607,16903
43,Tarragona,156,Ulldecona,6240,3209,3031
43,Tarragona,157,Ulldemolins,402,229,173
43,Tarragona,158,Vallclara,98,59,39
43,Tarragona,159,Vallfogona de Riucorb,85,51,34
43,Tarragona,160,Vallmoll,1738,879,859
43,Tarragona,161,Valls,24156,12031,12125
43,Tarragona,162,Vandellòs i l'Hospitalet de l'Infant,6386,3195,3191
43,Tarragona,163,"Vendrell, El",37153,18452,18701
43,Tarragona,164,Vespella de Gaià,410,229,181
43,Tarragona,165,Vilabella,746,386,360
43,Tarragona,175,Vilalba dels Arcs,635,321,314
43,Tarragona,166,Vilallonga del Camp,2339,1185,1154
43,Tarragona,168,Vilanova de Prades,117,63,54
43,Tarragona,167,Vilanova d'Escornalbou,549,285,264
43,Tarragona,169,Vilaplana,579,299,280
43,Tarragona,170,Vila-rodona,1253,655,598
43,Tarragona,171,Vila-seca,22107,11083,11024
43,Tarragona,172,Vilaverd,456,237,219
43,Tarragona,173,"Vilella Alta, La",132,74,58
43,Tarragona,174,"Vilella Baixa, La",202,111,91
43,Tarragona,176,Vimbodí i Poblet,917,505,412
43,Tarragona,177,Vinebre,432,222,210
43,Tarragona,178,Vinyols i els Arcs,1974,1030,944
43,Tarragona,52,Xerta,1170,570,600
44,Teruel,1,Ababuj,76,48,28
44,Teruel,2,Abejuela,49,31,18
44,Teruel,3,Aguatón,18,6,12
44,Teruel,4,Aguaviva,522,258,264
44,Teruel,5,Aguilar del Alfambra,63,36,27
44,Teruel,6,Alacón,264,134,130
44,Teruel,7,Alba,178,98,80
44,Teruel,8,Albalate del Arzobispo,2004,1023,981
44,Teruel,9,Albarracín,1016,517,499
44,Teruel,10,Albentosa,257,137,120
44,Teruel,11,Alcaine,63,38,25
44,Teruel,12,Alcalá de la Selva,347,193,154
44,Teruel,13,Alcañiz,15939,7919,8020
44,Teruel,14,Alcorisa,3276,1656,1620
44,Teruel,16,Alfambra,531,281,250
44,Teruel,17,Aliaga,358,200,158
44,Teruel,21,Allepuz,126,63,63
44,Teruel,22,Alloza,582,295,287
44,Teruel,23,Allueva,29,16,13
44,Teruel,18,Almohaja,16,11,5
44,Teruel,19,Alobras,62,37,25
44,Teruel,20,Alpeñés,22,13,9
44,Teruel,24,Anadón,27,17,10
44,Teruel,25,Andorra,7633,3847,3786
44,Teruel,26,Arcos de las Salinas,105,61,44
44,Teruel,27,Arens de Lledó,206,103,103
44,Teruel,28,Argente,198,96,102
44,Teruel,29,Ariño,708,355,353
44,Teruel,31,Azaila,94,46,48
44,Teruel,32,Bádenas,20,12,8
44,Teruel,33,Báguena,311,172,139
44,Teruel,34,Bañón,153,86,67
44,Teruel,35,Barrachina,118,64,54
44,Teruel,36,Bea,31,18,13
44,Teruel,37,Beceite,541,273,268
44,Teruel,39,Bello,225,107,118
44,Teruel,38,Belmonte de San José,113,54,59
44,Teruel,40,Berge,244,125,119
44,Teruel,41,Bezas,70,44,26
44,Teruel,42,Blancas,125,74,51
44,Teruel,43,Blesa,95,62,33
44,Teruel,44,Bordón,106,57,49
44,Teruel,45,Bronchales,443,252,191
44,Teruel,46,Bueña,63,34,29
44,Teruel,47,Burbáguena,243,130,113
44,Teruel,48,Cabra de Mora,55,31,24
44,Teruel,49,Calaceite,1011,503,508
44,Teruel,50,Calamocha,4319,2138,2181
44,Teruel,51,Calanda,3708,1842,1866
44,Teruel,52,Calomarde,74,45,29
44,Teruel,53,Camañas,124,69,55
44,Teruel,54,Camarena de la Sierra,113,71,42
44,Teruel,55,Camarillas,86,52,34
44,Teruel,56,Caminreal,619,321,298
44,Teruel,59,Cantavieja,714,373,341
44,Teruel,60,Cañada de Benatanduz,39,25,14
44,Teruel,61,"Cañada de Verich, La",87,53,34
44,Teruel,62,Cañada Vellida,35,25,10
44,Teruel,63,Cañizar del Olivar,98,52,46
44,Teruel,64,Cascante del Río,71,43,28
44,Teruel,65,Castejón de Tornos,62,39,23
44,Teruel,66,Castel de Cabra,104,58,46
44,Teruel,70,"Castellar, El",52,34,18
44,Teruel,71,Castellote,676,349,327
44,Teruel,67,Castelnou,160,82,78
44,Teruel,68,Castelserás,831,432,399
44,Teruel,74,Cedrillas,630,310,320
44,Teruel,75,Celadas,396,227,169
44,Teruel,76,Cella,2606,1351,1255
44,Teruel,77,"Cerollera, La",100,62,38
44,Teruel,80,"Codoñera, La",344,183,161
44,Teruel,82,Corbalán,109,58,51
44,Teruel,84,Cortes de Aragón,61,27,34
44,Teruel,85,Cosa,52,31,21
44,Teruel,86,Cretas,571,289,282
44,Teruel,87,Crivillén,68,33,35
44,Teruel,88,"Cuba, La",41,26,15
44,Teruel,89,Cubla,54,36,18
44,Teruel,90,Cucalón,80,46,34
44,Teruel,92,"Cuervo, El",86,47,39
44,Teruel,93,Cuevas de Almudén,122,69,53
44,Teruel,94,Cuevas Labradas,131,70,61
44,Teruel,96,Ejulve,180,91,89
44,Teruel,97,Escorihuela,139,68,71
44,Teruel,99,Escucha,885,472,413
44,Teruel,100,Estercuel,210,115,95
44,Teruel,101,Ferreruela de Huerva,63,35,28
44,Teruel,102,Fonfría,28,16,12
44,Teruel,103,Formiche Alto,151,86,65
44,Teruel,105,Fórnoles,75,39,36
44,Teruel,106,Fortanete,205,113,92
44,Teruel,107,Foz-Calanda,238,130,108
44,Teruel,108,"Fresneda, La",443,247,196
44,Teruel,109,Frías de Albarracín,116,67,49
44,Teruel,110,Fuenferrada,42,24,18
44,Teruel,111,Fuentes Calientes,101,58,43
44,Teruel,112,Fuentes Claras,461,249,212
44,Teruel,113,Fuentes de Rubielos,114,60,54
44,Teruel,114,Fuentespalda,286,145,141
44,Teruel,115,Galve,161,83,78
44,Teruel,116,Gargallo,89,48,41
44,Teruel,117,Gea de Albarracín,376,200,176
44,Teruel,118,"Ginebrosa, La",200,108,92
44,Teruel,119,Griegos,143,85,58
44,Teruel,120,Guadalaviar,242,138,104
44,Teruel,121,Gúdar,72,39,33
44,Teruel,122,Híjar,1709,866,843
44,Teruel,123,Hinojosa de Jarque,119,67,52
44,Teruel,124,"Hoz de la Vieja, La",85,44,41
44,Teruel,125,Huesa del Común,67,41,26
44,Teruel,126,"Iglesuela del Cid, La",414,216,198
44,Teruel,127,Jabaloyas,65,37,28
44,Teruel,128,Jarque de la Val,70,37,33
44,Teruel,129,Jatiel,40,25,15
44,Teruel,130,Jorcas,34,19,15
44,Teruel,131,Josa,34,20,14
44,Teruel,132,Lagueruela,78,42,36
44,Teruel,133,Lanzuela,24,17,7
44,Teruel,135,Libros,101,63,38
44,Teruel,136,Lidón,55,29,26
44,Teruel,137,Linares de Mora,249,144,105
44,Teruel,141,Lledó,172,90,82
44,Teruel,138,Loscos,129,78,51
44,Teruel,142,Maicas,27,15,12
44,Teruel,143,Manzanera,519,274,245
44,Teruel,144,Martín del Río,417,210,207
44,Teruel,145,Mas de las Matas,1272,664,608
44,Teruel,146,"Mata de los Olmos, La",265,131,134
44,Teruel,147,Mazaleón,539,285,254
44,Teruel,148,Mezquita de Jarque,98,58,40
44,Teruel,149,Mirambel,116,67,49
44,Teruel,150,Miravete de la Sierra,35,23,12
44,Teruel,151,Molinos,243,125,118
44,Teruel,152,Monforte de Moyuela,65,46,19
44,Teruel,153,Monreal del Campo,2433,1208,1225
44,Teruel,154,Monroyo,340,201,139
44,Teruel,155,Montalbán,1243,623,620
44,Teruel,156,Monteagudo del Castillo,50,27,23
44,Teruel,157,Monterde de Albarracín,63,35,28
44,Teruel,158,Mora de Rubielos,1541,769,772
44,Teruel,159,Moscardón,55,30,25
44,Teruel,160,Mosqueruela,551,300,251
44,Teruel,161,Muniesa,599,311,288
44,Teruel,163,Noguera de Albarracín,133,72,61
44,Teruel,164,Nogueras,25,16,9
44,Teruel,165,Nogueruelas,217,123,94
44,Teruel,167,Obón,45,24,21
44,Teruel,168,Odón,205,108,97
44,Teruel,169,Ojos Negros,377,206,171
44,Teruel,171,Olba,226,129,97
44,Teruel,172,Oliete,364,190,174
44,Teruel,173,"Olmos, Los",122,67,55
44,Teruel,174,Orihuela del Tremedal,487,267,220
44,Teruel,175,Orrios,126,68,58
44,Teruel,176,Palomar de Arroyos,169,99,70
44,Teruel,177,Pancrudo,110,64,46
44,Teruel,178,"Parras de Castellote, Las",53,30,23
44,Teruel,179,Peñarroya de Tastavins,439,242,197
44,Teruel,180,Peracense,76,42,34
44,Teruel,181,Peralejos,88,49,39
44,Teruel,182,Perales del Alfambra,221,118,103
44,Teruel,183,Pitarque,79,42,37
44,Teruel,184,Plou,43,28,15
44,Teruel,185,"Pobo, El",114,73,41
44,Teruel,187,"Portellada, La",243,121,122
44,Teruel,189,Pozondón,48,29,19
44,Teruel,190,Pozuel del Campo,68,36,32
44,Teruel,191,"Puebla de Híjar, La",908,456,452
44,Teruel,192,"Puebla de Valverde, La",453,253,200
44,Teruel,193,Puertomingalvo,112,58,54
44,Teruel,194,Ráfales,143,84,59
44,Teruel,195,Rillo,93,54,39
44,Teruel,196,Riodeva,144,67,77
44,Teruel,197,Ródenas,61,33,28
44,Teruel,198,Royuela,206,113,93
44,Teruel,199,Rubiales,50,28,22
44,Teruel,200,Rubielos de la Cérida,38,23,15
44,Teruel,201,Rubielos de Mora,627,327,300
44,Teruel,203,Salcedillo,17,11,6
44,Teruel,204,Saldón,26,17,9
44,Teruel,205,Samper de Calanda,783,395,388
44,Teruel,206,San Agustín,125,79,46
44,Teruel,207,San Martín del Río,148,78,70
44,Teruel,208,Santa Cruz de Nogueras,37,18,19
44,Teruel,209,Santa Eulalia,1037,528,509
44,Teruel,210,Sarrión,1133,591,542
44,Teruel,211,Segura de los Baños,39,25,14
44,Teruel,212,Seno,39,17,22
44,Teruel,213,Singra,80,45,35
44,Teruel,215,Terriente,183,103,80
44,Teruel,216,Teruel,35691,16974,18717
44,Teruel,217,Toril y Masegoso,30,25,5
44,Teruel,218,Tormón,31,19,12
44,Teruel,219,Tornos,213,112,101
44,Teruel,220,Torralba de los Sisones,156,86,70
44,Teruel,223,Torre de Arcas,89,43,46
44,Teruel,224,Torre de las Arcas,28,15,13
44,Teruel,225,Torre del Compte,132,63,69
44,Teruel,227,Torre los Negros,88,45,43
44,Teruel,221,Torrecilla de Alcañiz,423,218,205
44,Teruel,222,Torrecilla del Rebollar,127,83,44
44,Teruel,226,Torrelacárcel,154,81,73
44,Teruel,228,Torremocha de Jiloca,107,60,47
44,Teruel,229,Torres de Albarracín,183,105,78
44,Teruel,230,Torrevelilla,189,95,94
44,Teruel,231,Torrijas,38,15,23
44,Teruel,232,Torrijo del Campo,447,237,210
44,Teruel,234,Tramacastiel,64,39,25
44,Teruel,235,Tramacastilla,106,53,53
44,Teruel,236,Tronchón,65,32,33
44,Teruel,237,Urrea de Gaén,436,217,219
44,Teruel,238,Utrillas,2970,1534,1436
44,Teruel,239,Valacloche,21,11,10
44,Teruel,240,Valbona,174,97,77
44,Teruel,241,Valdealgorfa,622,308,314
44,Teruel,243,Valdecuenca,35,21,14
44,Teruel,244,Valdelinares,87,50,37
44,Teruel,245,Valdeltormo,279,135,144
44,Teruel,246,Valderrobres,2388,1207,1181
44,Teruel,247,Valjunquera,325,164,161
44,Teruel,249,"Vallecillo, El",48,28,20
44,Teruel,250,Veguillas de la Sierra,20,12,8
44,Teruel,251,Villafranca del Campo,297,153,144
44,Teruel,252,Villahermosa del Campo,94,60,34
44,Teruel,256,Villanueva del Rebollar de la Sierra,47,27,20
44,Teruel,257,Villar del Cobo,164,96,68
44,Teruel,258,Villar del Salz,60,37,23
44,Teruel,260,Villarluengo,177,105,72
44,Teruel,261,Villarquemado,862,448,414
44,Teruel,262,Villarroya de los Pinares,160,86,74
44,Teruel,263,Villastar,494,252,242
44,Teruel,264,Villel,327,182,145
44,Teruel,265,Vinaceite,249,133,116
44,Teruel,266,Visiedo,125,54,71
44,Teruel,267,Vivel del Río Martín,79,38,41
44,Teruel,268,"Zoma, La",16,5,11
45,Toledo,1,Ajofrín,2244,1116,1128
45,Toledo,2,Alameda de la Sagra,3562,1874,1688
45,Toledo,3,Albarreal de Tajo,692,359,333
45,Toledo,4,Alcabón,669,347,322
45,Toledo,5,Alcañizo,275,139,136
45,Toledo,6,Alcaudete de la Jara,1703,843,860
45,Toledo,7,Alcolea de Tajo,797,394,403
45,Toledo,8,Aldea en Cabo,162,87,75
45,Toledo,9,Aldeanueva de Barbarroya,542,273,269
45,Toledo,10,Aldeanueva de San Bartolomé,434,218,216
45,Toledo,11,Almendral de la Cañada,305,160,145
45,Toledo,12,Almonacid de Toledo,783,388,395
45,Toledo,13,Almorox,2159,1133,1026
45,Toledo,14,Añover de Tajo,5032,2571,2461
45,Toledo,15,Arcicóllar,829,411,418
45,Toledo,16,Argés,6341,3166,3175
45,Toledo,17,Azután,289,142,147
45,Toledo,18,Barcience,856,445,411
45,Toledo,19,Bargas,10092,5061,5031
45,Toledo,20,Belvís de la Jara,1529,763,766
45,Toledo,21,Borox,3706,1936,1770
45,Toledo,22,Buenaventura,430,220,210
45,Toledo,23,Burguillos de Toledo,3184,1641,1543
45,Toledo,24,Burujón,1308,672,636
45,Toledo,25,Cabañas de la Sagra,1789,922,867
45,Toledo,26,Cabañas de Yepes,240,124,116
45,Toledo,27,Cabezamesada,347,187,160
45,Toledo,28,Calera y Chozas,4640,2351,2289
45,Toledo,29,Caleruela,210,103,107
45,Toledo,30,Calzada de Oropesa,539,300,239
45,Toledo,31,Camarena,3745,1950,1795
45,Toledo,32,Camarenilla,556,282,274
45,Toledo,33,"Campillo de la Jara, El",364,190,174
45,Toledo,34,Camuñas,1740,893,847
45,Toledo,35,Cardiel de los Montes,342,183,159
45,Toledo,36,Carmena,731,373,358
45,Toledo,37,"Carpio de Tajo, El",1872,944,928
45,Toledo,38,Carranque,4761,2469,2292
45,Toledo,39,Carriches,271,136,135
45,Toledo,40,"Casar de Escalona, El",1743,935,808
45,Toledo,41,Casarrubios del Monte,5422,2853,2569
45,Toledo,42,Casasbuenas,208,103,105
45,Toledo,43,Castillo de Bayuela,917,455,462
45,Toledo,45,Cazalegas,1725,898,827
45,Toledo,46,Cebolla,3263,1650,1613
45,Toledo,47,Cedillo del Condado,3687,1915,1772
45,Toledo,48,"Cerralbos, Los",418,230,188
45,Toledo,49,Cervera de los Montes,509,258,251
45,Toledo,56,Chozas de Canales,3765,1969,1796
45,Toledo,57,Chueca,261,139,122
45,Toledo,50,Ciruelos,532,281,251
45,Toledo,51,Cobeja,2206,1141,1065
45,Toledo,52,Cobisa,4269,2150,2119
45,Toledo,53,Consuegra,10098,5101,4997
45,Toledo,54,Corral de Almaguer,5355,2755,2600
45,Toledo,55,Cuerva,1335,693,642
45,Toledo,58,Domingo Pérez,404,209,195
45,Toledo,59,Dosbarrios,2201,1132,1069
45,Toledo,60,Erustes,207,107,100
45,Toledo,61,Escalona,3199,1648,1551
45,Toledo,62,Escalonilla,1437,715,722
45,Toledo,63,Espinoso del Rey,439,244,195
45,Toledo,64,Esquivias,5449,2744,2705
45,Toledo,65,"Estrella, La",233,122,111
45,Toledo,66,Fuensalida,11032,5580,5452
45,Toledo,67,Gálvez,3016,1508,1508
45,Toledo,68,Garciotum,187,98,89
45,Toledo,69,Gerindote,2289,1158,1131
45,Toledo,70,Guadamur,1781,897,884
45,Toledo,71,"Guardia, La",2236,1127,1109
45,Toledo,72,"Herencias, Las",798,428,370
45,Toledo,73,Herreruela de Oropesa,334,169,165
45,Toledo,74,Hinojosa de San Vicente,394,217,177
45,Toledo,75,Hontanar,152,92,60
45,Toledo,76,Hormigos,680,361,319
45,Toledo,77,Huecas,683,351,332
45,Toledo,78,Huerta de Valdecarábanos,1681,827,854
45,Toledo,79,"Iglesuela, La",406,211,195
45,Toledo,80,Illán de Vacas,5,4,1
45,Toledo,81,Illescas,28064,14238,13826
45,Toledo,82,Lagartera,1405,699,706
45,Toledo,83,Layos,685,339,346
45,Toledo,84,Lillo,2600,1353,1247
45,Toledo,85,Lominchar,2345,1228,1117
45,Toledo,86,Lucillos,573,304,269
45,Toledo,87,Madridejos,10532,5281,5251
45,Toledo,88,Magán,3401,1739,1662
45,Toledo,89,Malpica de Tajo,1732,889,843
45,Toledo,90,Manzaneque,396,191,205
45,Toledo,91,Maqueda,461,227,234
45,Toledo,92,Marjaliza,255,125,130
45,Toledo,93,Marrupe,153,80,73
45,Toledo,94,Mascaraque,439,223,216
45,Toledo,95,"Mata, La",853,427,426
45,Toledo,96,Mazarambroz,1258,647,611
45,Toledo,97,Mejorada,1265,652,613
45,Toledo,98,Menasalbas,2702,1423,1279
45,Toledo,99,Méntrida,4957,2545,2412
45,Toledo,100,Mesegar de Tajo,222,118,104
45,Toledo,101,Miguel Esteban,4908,2453,2455
45,Toledo,102,Mocejón,4829,2436,2393
45,Toledo,103,Mohedas de la Jara,407,226,181
45,Toledo,104,Montearagón,506,268,238
45,Toledo,105,Montesclaros,408,218,190
45,Toledo,106,Mora,9737,4889,4848
45,Toledo,107,Nambroca,4610,2361,2249
45,Toledo,108,"Nava de Ricomalillo, La",538,278,260
45,Toledo,109,Navahermosa,3647,1882,1765
45,Toledo,110,Navalcán,2042,1080,962
45,Toledo,111,Navalmoralejo,62,32,30
45,Toledo,112,"Navalmorales, Los",2567,1351,1216
45,Toledo,113,"Navalucillos, Los",2171,1111,1060
45,Toledo,114,Navamorcuende,626,315,311
45,Toledo,115,Noblejas,3486,1771,1715
45,Toledo,116,Noez,881,448,433
45,Toledo,117,Nombela,883,466,417
45,Toledo,118,Novés,2767,1419,1348
45,Toledo,119,Numancia de la Sagra,4846,2534,2312
45,Toledo,120,Nuño Gómez,131,74,57
45,Toledo,121,Ocaña,11067,5593,5474
45,Toledo,122,Olías del Rey,7657,3936,3721
45,Toledo,123,Ontígola,4279,2269,2010
45,Toledo,124,Orgaz,2624,1311,1313
45,Toledo,125,Oropesa,2658,1308,1350
45,Toledo,126,Otero,338,177,161
45,Toledo,127,Palomeque,907,487,420
45,Toledo,128,Pantoja,3238,1629,1609
45,Toledo,129,Paredes de Escalona,119,58,61
45,Toledo,130,Parrillas,343,184,159
45,Toledo,131,Pelahustán,305,174,131
45,Toledo,132,Pepino,2907,1502,1405
45,Toledo,133,Polán,3788,1891,1897
45,Toledo,134,Portillo de Toledo,2188,1098,1090
45,Toledo,135,"Puebla de Almoradiel, La",5278,2676,2602
45,Toledo,136,"Puebla de Montalbán, La",7811,3969,3842
45,Toledo,137,"Pueblanueva, La",2188,1103,1085
45,Toledo,138,"Puente del Arzobispo, El",1246,620,626
45,Toledo,139,Puerto de San Vicente,161,86,75
45,Toledo,140,Pulgar,1521,776,745
45,Toledo,141,Quero,1006,513,493
45,Toledo,142,Quintanar de la Orden,10918,5413,5505
45,Toledo,143,Quismondo,1511,773,738
45,Toledo,144,"Real de San Vicente, El",945,509,436
45,Toledo,145,Recas,4206,2311,1895
45,Toledo,146,Retamoso de la Jara,105,54,51
45,Toledo,147,Rielves,741,375,366
45,Toledo,148,Robledo del Mazo,289,163,126
45,Toledo,149,"Romeral, El",594,295,299
45,Toledo,150,San Bartolomé de las Abiertas,438,235,203
45,Toledo,151,San Martín de Montalbán,726,360,366
45,Toledo,152,San Martín de Pusa,694,362,332
45,Toledo,153,San Pablo de los Montes,1805,907,898
45,Toledo,154,San Román de los Montes,1871,996,875
45,Toledo,155,Santa Ana de Pusa,365,206,159
45,Toledo,156,Santa Cruz de la Zarza,4238,2142,2096
45,Toledo,157,Santa Cruz del Retamar,2946,1546,1400
45,Toledo,158,Santa Olalla,3217,1649,1568
45,Toledo,901,Santo Domingo-Caudilla,1024,534,490
45,Toledo,159,Sartajada,100,60,40
45,Toledo,160,Segurilla,1353,678,675
45,Toledo,161,Seseña,24255,12499,11756
45,Toledo,162,Sevilleja de la Jara,698,379,319
45,Toledo,163,Sonseca,11021,5558,5463
45,Toledo,164,Sotillo de las Palomas,193,103,90
45,Toledo,165,Talavera de la Reina,83009,39867,43142
45,Toledo,166,Tembleque,1996,1014,982
45,Toledo,167,"Toboso, El",1783,890,893
45,Toledo,168,Toledo,84282,40242,44040
45,Toledo,169,Torralba de Oropesa,213,110,103
45,Toledo,171,"Torre de Esteban Hambrán, La",1702,866,836
45,Toledo,170,Torrecilla de la Jara,225,122,103
45,Toledo,172,Torrico,731,373,358
45,Toledo,173,Torrijos,13278,6544,6734
45,Toledo,174,Totanés,346,174,172
45,Toledo,175,Turleque,768,394,374
45,Toledo,176,Ugena,5336,2755,2581
45,Toledo,177,Urda,2558,1274,1284
45,Toledo,179,Valdeverdeja,586,283,303
45,Toledo,180,Valmojado,4218,2136,2082
45,Toledo,181,Velada,2865,1490,1375
45,Toledo,182,"Ventas con Peña Aguilera, Las",1127,572,555
45,Toledo,183,"Ventas de Retamosa, Las",3268,1716,1552
45,Toledo,184,"Ventas de San Julián, Las",229,113,116
45,Toledo,186,"Villa de Don Fadrique, La",3723,1853,1870
45,Toledo,185,Villacañas,9689,4823,4866
45,Toledo,187,Villafranca de los Caballeros,4929,2454,2475
45,Toledo,188,Villaluenga de la Sagra,3769,1887,1882
45,Toledo,189,Villamiel de Toledo,867,445,422
45,Toledo,190,Villaminaya,539,272,267
45,Toledo,191,Villamuelas,620,325,295
45,Toledo,192,Villanueva de Alcardete,3298,1717,1581
45,Toledo,193,Villanueva de Bogas,728,375,353
45,Toledo,194,Villarejo de Montalbán,73,38,35
45,Toledo,195,Villarrubia de Santiago,2582,1282,1300
45,Toledo,196,Villaseca de la Sagra,1793,897,896
45,Toledo,197,Villasequilla,2496,1279,1217
45,Toledo,198,Villatobas,2390,1227,1163
45,Toledo,199,"Viso de San Juan, El",4351,2334,2017
45,Toledo,200,"Yébenes, Los",5983,3061,2922
45,Toledo,201,Yeles,5164,2706,2458
45,Toledo,202,Yepes,5083,2621,2462
45,Toledo,203,Yuncler,3759,1916,1843
45,Toledo,204,Yunclillos,809,419,390
45,Toledo,205,Yuncos,10968,5618,5350
46,Valencia/València,1,Ademuz,1046,557,489
46,Valencia/València,2,Ador,1393,739,654
46,Valencia/València,4,Agullent,2413,1203,1210
46,Valencia/València,42,Aielo de Malferit,4646,2327,2319
46,Valencia/València,43,Aielo de Rugat,155,84,71
46,Valencia/València,5,Alaquàs,29341,14382,14959
46,Valencia/València,6,Albaida,5908,2933,2975
46,Valencia/València,7,Albal,16270,8138,8132
46,Valencia/València,8,Albalat de la Ribera,3329,1669,1660
46,Valencia/València,9,Albalat dels Sorells,3944,1933,2011
46,Valencia/València,10,Albalat dels Tarongers,1202,632,570
46,Valencia/València,11,Alberic,10556,5230,5326
46,Valencia/València,12,Alborache,1127,593,534
46,Valencia/València,13,Alboraia/Alboraya,24222,11838,12384
46,Valencia/València,14,Albuixech,3983,1947,2036
46,Valencia/València,16,Alcàntera de Xúquer,1297,646,651
46,Valencia/València,15,Alcàsser,9908,4975,4933
46,Valencia/València,18,Alcublas,654,350,304
46,Valencia/València,20,"Alcúdia de Crespins, l'",5188,2586,2602
46,Valencia/València,19,"Alcúdia, l'",11938,5850,6088
46,Valencia/València,21,Aldaia,31492,15691,15801
46,Valencia/València,22,Alfafar,20763,10174,10589
46,Valencia/València,24,Alfara de la Baronia,539,267,272
46,Valencia/València,25,Alfara del Patriarca,3314,1604,1710
46,Valencia/València,26,Alfarp,1532,792,740
46,Valencia/València,27,Alfarrasí,1262,625,637
46,Valencia/València,23,Alfauir,440,226,214
46,Valencia/València,28,Algar de Palancia,470,245,225
46,Valencia/València,29,Algemesí,27285,13559,13726
46,Valencia/València,30,Algimia de Alfara,1019,510,509
46,Valencia/València,31,Alginet,13100,6634,6466
46,Valencia/València,32,Almàssera,7295,3558,3737
46,Valencia/València,33,Almiserà,258,133,125
46,Valencia/València,34,Almoines,2379,1200,1179
46,Valencia/València,35,Almussafes,8932,4465,4467
46,Valencia/València,36,Alpuente,637,353,284
46,Valencia/València,37,"Alqueria de la Comtessa, l'",1418,687,731
46,Valencia/València,17,Alzira,44393,21685,22708
46,Valencia/València,38,Andilla,303,198,105
46,Valencia/València,39,Anna,2638,1321,1317
46,Valencia/València,40,Antella,1209,592,617
46,Valencia/València,41,Aras de los Olmos,374,211,163
46,Valencia/València,3,Atzeneta d'Albaida,1162,586,576
46,Valencia/València,44,Ayora,5276,2624,2652
46,Valencia/València,46,Barx,1229,638,591
46,Valencia/València,45,Barxeta,1604,822,782
46,Valencia/València,47,Bèlgida,672,326,346
46,Valencia/València,48,Bellreguard,4549,2274,2275
46,Valencia/València,49,Bellús,314,165,149
46,Valencia/València,50,Benagéber,190,108,82
46,Valencia/València,51,Benaguasil,10878,5555,5323
46,Valencia/València,52,Benavites,594,280,314
46,Valencia/València,53,Beneixida,648,327,321
46,Valencia/València,54,Benetússer,14668,7128,7540
46,Valencia/València,55,Beniarjó,1746,880,866
46,Valencia/València,56,Beniatjar,224,117,107
46,Valencia/València,57,Benicolet,582,291,291
46,Valencia/València,904,Benicull de Xúquer,974,483,491
46,Valencia/València,60,Benifaió,11930,5918,6012
46,Valencia/València,59,Benifairó de la Valldigna,1580,789,791
46,Valencia/València,58,Benifairó de les Valls,2168,1084,1084
46,Valencia/València,61,Beniflá,455,234,221
46,Valencia/València,62,Benigànim,5899,2986,2913
46,Valencia/València,63,Benimodo,2241,1137,1104
46,Valencia/València,64,Benimuslem,660,346,314
46,Valencia/València,65,Beniparrell,1931,985,946
46,Valencia/València,66,Benirredrà,1576,769,807
46,Valencia/València,67,Benissanó,2224,1113,1111
46,Valencia/València,68,Benissoda,418,226,192
46,Valencia/València,69,Benissuera,180,88,92
46,Valencia/València,70,Bétera,23647,11817,11830
46,Valencia/València,71,Bicorp,524,264,260
46,Valencia/València,72,Bocairent,4214,2131,2083
46,Valencia/València,73,Bolbaite,1347,677,670
46,Valencia/València,74,Bonrepòs i Mirambell,3645,1792,1853
46,Valencia/València,75,Bufali,159,85,74
46,Valencia/València,76,Bugarra,715,367,348
46,Valencia/València,77,Buñol,9517,4759,4758
46,Valencia/València,78,Burjassot,37584,18125,19459
46,Valencia/València,79,Calles,342,193,149
46,Valencia/València,80,Camporrobles,1195,613,582
46,Valencia/València,81,Canals,13588,6799,6789
46,Valencia/València,82,Canet d'En Berenguer,6575,3367,3208
46,Valencia/València,83,Carcaixent,20424,10107,10317
46,Valencia/València,84,Càrcer,1876,889,987
46,Valencia/València,85,Carlet,15514,7726,7788
46,Valencia/València,86,Carrícola,93,49,44
46,Valencia/València,87,Casas Altas,136,73,63
46,Valencia/València,88,Casas Bajas,172,89,83
46,Valencia/València,89,Casinos,2773,1429,1344
46,Valencia/València,90,Castelló de Rugat,2275,1157,1118
46,Valencia/València,91,Castellonet de la Conquesta,145,77,68
46,Valencia/València,92,Castielfabib,306,160,146
46,Valencia/València,93,Catadau,2830,1416,1414
46,Valencia/València,94,Catarroja,27827,13736,14091
46,Valencia/València,95,Caudete de las Fuentes,696,360,336
46,Valencia/València,96,Cerdà,334,180,154
46,Valencia/València,107,Chella,2469,1221,1248
46,Valencia/València,106,Chelva,1498,773,725
46,Valencia/València,108,Chera,494,267,227
46,Valencia/València,109,Cheste,8319,4249,4070
46,Valencia/València,111,Chiva,14941,7673,7268
46,Valencia/València,112,Chulilla,615,325,290
46,Valencia/València,97,Cofrentes,1125,573,552
46,Valencia/València,98,Corbera,3160,1564,1596
46,Valencia/València,99,Cortes de Pallás,818,450,368
46,Valencia/València,100,Cotes,332,170,162
46,Valencia/València,105,Cullera,21918,10910,11008
46,Valencia/València,113,Daimús,3128,1554,1574
46,Valencia/València,114,Domeño,704,362,342
46,Valencia/València,115,Dos Aguas,355,203,152
46,Valencia/València,116,"Eliana, l'",18050,8780,9270
46,Valencia/València,117,Emperador,692,358,334
46,Valencia/València,118,Enguera,4800,2369,2431
46,Valencia/València,119,"Ènova, l'",903,458,445
46,Valencia/València,120,Estivella,1432,693,739
46,Valencia/València,121,Estubeny,122,61,61
46,Valencia/València,122,Faura,3547,1783,1764
46,Valencia/València,123,Favara,2490,1269,1221
46,Valencia/València,126,Foios,7342,3626,3716
46,Valencia/València,128,"Font de la Figuera, la",2038,1021,1017
46,Valencia/València,127,"Font d'En Carròs, la",3790,1882,1908
46,Valencia/València,124,Fontanars dels Alforins,979,496,483
46,Valencia/València,125,Fortaleny,1030,513,517
46,Valencia/València,129,Fuenterrobles,682,376,306
46,Valencia/València,131,Gandia,73829,36295,37534
46,Valencia/València,902,Gátova,392,184,208
46,Valencia/València,130,Gavarda,1058,510,548
46,Valencia/València,132,Genovés,2828,1427,1401
46,Valencia/València,133,Gestalgar,554,297,257
46,Valencia/València,134,Gilet,3276,1704,1572
46,Valencia/València,135,Godella,13058,6334,6724
46,Valencia/València,136,Godelleta,3462,1771,1691
46,Valencia/València,137,"Granja de la Costera, la",297,145,152
46,Valencia/València,138,Guadasséquies,444,232,212
46,Valencia/València,139,Guadassuar,5914,2904,3010
46,Valencia/València,140,Guardamar de la Safor,491,257,234
46,Valencia/València,141,Higueruelas,508,270,238
46,Valencia/València,142,Jalance,845,433,412
46,Valencia/València,144,Jarafuel,776,404,372
46,Valencia/València,154,Llanera de Ranes,1049,525,524
46,Valencia/València,155,Llaurí,1209,623,586
46,Valencia/València,147,Llíria,22972,11633,11339
46,Valencia/València,152,Llocnou de la Corona,118,62,56
46,Valencia/València,153,Llocnou de Sant Jeroni,542,271,271
46,Valencia/València,151,Llocnou d'En Fenollet,893,466,427
46,Valencia/València,156,Llombai,2686,1344,1342
46,Valencia/València,157,"Llosa de Ranes, la",3585,1832,1753
46,Valencia/València,150,Llutxent,2373,1221,1152
46,Valencia/València,148,Loriguilla,1984,1018,966
46,Valencia/València,149,Losa del Obispo,504,263,241
46,Valencia/València,158,Macastre,1240,657,583
46,Valencia/València,159,Manises,30693,15128,15565
46,Valencia/València,160,Manuel,2439,1193,1246
46,Valencia/València,161,Marines,1828,959,869
46,Valencia/València,162,Massalavés,1575,833,742
46,Valencia/València,163,Massalfassar,2480,1232,1248
46,Valencia/València,164,Massamagrell,15752,7800,7952
46,Valencia/València,165,Massanassa,9538,4741,4797
46,Valencia/València,166,Meliana,10662,5231,5431
46,Valencia/València,167,Millares,346,180,166
46,Valencia/València,168,Miramar,2599,1342,1257
46,Valencia/València,169,Mislata,43278,21001,22277
46,Valencia/València,170,Mogente/Moixent,4318,2161,2157
46,Valencia/València,171,Moncada,21802,10668,11134
46,Valencia/València,173,Montaverner,1631,820,811
46,Valencia/València,174,Montesa,1180,601,579
46,Valencia/València,175,Montitxelvo/Montichelvo,605,301,304
46,Valencia/València,176,Montroi/Montroy,2822,1509,1313
46,Valencia/València,172,Montserrat,7583,3939,3644
46,Valencia/València,177,Museros,6291,3187,3104
46,Valencia/València,178,Náquera,6205,3240,2965
46,Valencia/València,179,Navarrés,2975,1500,1475
46,Valencia/València,180,Novelé/Novetlè,838,415,423
46,Valencia/València,181,Oliva,25199,12380,12819
46,Valencia/València,183,"Olleria, l'",8225,4124,4101
46,Valencia/València,182,Olocau,1766,932,834
46,Valencia/València,184,Ontinyent,35395,17493,17902
46,Valencia/València,185,Otos,446,226,220
46,Valencia/València,186,Paiporta,25309,12536,12773
46,Valencia/València,187,Palma de Gandía,1543,797,746
46,Valencia/València,188,Palmera,1047,544,503
46,Valencia/València,189,"Palomar, el",576,292,284
46,Valencia/València,190,Paterna,69156,34254,34902
46,Valencia/València,191,Pedralba,2777,1460,1317
46,Valencia/València,192,Petrés,969,481,488
46,Valencia/València,193,Picanya,11409,5652,5757
46,Valencia/València,194,Picassent,20709,10439,10270
46,Valencia/València,195,Piles,2688,1359,1329
46,Valencia/València,196,Pinet,156,77,79
46,Valencia/València,199,"Pobla de Farnals, la",7840,3940,3900
46,Valencia/València,202,"Pobla de Vallbona, la",24068,12112,11956
46,Valencia/València,200,"Pobla del Duc, la",2537,1236,1301
46,Valencia/València,203,"Pobla Llarga, la",4482,2254,2228
46,Valencia/València,197,Polinyà de Xúquer,2459,1237,1222
46,Valencia/València,198,Potries,1014,513,501
46,Valencia/València,205,Puçol,19455,9561,9894
46,Valencia/València,201,Puebla de San Miguel,61,38,23
46,Valencia/València,204,"Puig de Santa Maria, el",8566,4180,4386
46,Valencia/València,101,Quart de les Valls,992,473,519
46,Valencia/València,102,Quart de Poblet,24536,11978,12558
46,Valencia/València,103,Quartell,1561,746,815
46,Valencia/València,104,Quatretonda,2239,1127,1112
46,Valencia/València,206,Quesa,662,348,314
46,Valencia/València,207,Rafelbunyol,8929,4392,4537
46,Valencia/València,208,Rafelcofer,1358,668,690
46,Valencia/València,209,Rafelguaraf,2370,1180,1190
46,Valencia/València,210,Ráfol de Salem,440,217,223
46,Valencia/València,212,Real,2152,1105,1047
46,Valencia/València,211,"Real de Gandia, el",2395,1170,1225
46,Valencia/València,213,Requena,20227,10093,10134
46,Valencia/València,214,Riba-roja de Túria,21992,11157,10835
46,Valencia/València,215,Riola,1734,880,854
46,Valencia/València,216,Rocafort,7160,3504,3656
46,Valencia/València,217,Rotglà i Corberà,1114,560,554
46,Valencia/València,218,Rótova,1262,645,617
46,Valencia/València,219,Rugat,162,84,78
46,Valencia/València,220,Sagunto/Sagunt,65669,32173,33496
46,Valencia/València,221,Salem,433,220,213
46,Valencia/València,903,San Antonio de Benagéber,8846,4374,4472
46,Valencia/València,222,Sant Joanet,486,240,246
46,Valencia/València,223,Sedaví,10245,4990,5255
46,Valencia/València,224,Segart,158,82,76
46,Valencia/València,225,Sellent,379,190,189
46,Valencia/València,226,Sempere,35,18,17
46,Valencia/València,227,Senyera,1143,571,572
46,Valencia/València,228,Serra,3091,1585,1506
46,Valencia/València,229,Siete Aguas,1171,633,538
46,Valencia/València,230,Silla,18467,9170,9297
46,Valencia/València,231,Simat de la Valldigna,3325,1657,1668
46,Valencia/València,232,Sinarcas,1124,583,541
46,Valencia/València,233,Sollana,4884,2381,2503
46,Valencia/València,234,Sot de Chera,352,192,160
46,Valencia/València,235,Sueca,27460,13531,13929
46,Valencia/València,236,Sumacàrcer,1109,555,554
46,Valencia/València,237,Tavernes Blanques,9117,4477,4640
46,Valencia/València,238,Tavernes de la Valldigna,17158,8554,8604
46,Valencia/València,239,Teresa de Cofrentes,650,334,316
46,Valencia/València,240,Terrateig,280,144,136
46,Valencia/València,241,Titaguas,459,241,218
46,Valencia/València,242,Torrebaja,397,213,184
46,Valencia/València,243,Torrella,148,83,65
46,Valencia/València,244,Torrent,81245,40037,41208
46,Valencia/València,245,Torres Torres,640,334,306
46,Valencia/València,246,Tous,1254,629,625
46,Valencia/València,247,Tuéjar,1132,599,533
46,Valencia/València,248,Turís,6623,3470,3153
46,Valencia/València,249,Utiel,11540,5759,5781
46,Valencia/València,250,València,791413,376748,414665
46,Valencia/València,251,Vallada,3036,1538,1498
46,Valencia/València,252,Vallanca,126,65,61
46,Valencia/València,253,Vallés,157,85,72
46,Valencia/València,254,Venta del Moro,1242,665,577
46,Valencia/València,255,Vilallonga/Villalonga,4303,2095,2208
46,Valencia/València,256,Vilamarxant,9550,4952,4598
46,Valencia/València,257,Villanueva de Castellón,7095,3501,3594
46,Valencia/València,258,Villar del Arzobispo,3579,1815,1764
46,Valencia/València,259,Villargordo del Cabriel,586,307,279
46,Valencia/València,260,Vinalesa,3380,1643,1737
46,Valencia/València,145,Xàtiva,29045,14194,14851
46,Valencia/València,143,Xeraco,5702,2880,2822
46,Valencia/València,146,Xeresa,2145,1103,1042
46,Valencia/València,110,Xirivella,29108,14385,14723
46,Valencia/València,261,Yátova,2073,1068,1005
46,Valencia/València,262,"Yesa, La",227,120,107
46,Valencia/València,263,Zarra,365,200,165
47,Valladolid,1,Adalia,58,36,22
47,Valladolid,2,Aguasal,23,16,7
47,Valladolid,3,Aguilar de Campos,244,142,102
47,Valladolid,4,Alaejos,1382,740,642
47,Valladolid,5,Alcazarén,640,345,295
47,Valladolid,6,Aldea de San Miguel,222,120,102
47,Valladolid,7,Aldeamayor de San Martín,5455,2816,2639
47,Valladolid,8,Almenara de Adaja,21,10,11
47,Valladolid,9,Amusquillo,105,68,37
47,Valladolid,10,Arroyo de la Encomienda,19632,9884,9748
47,Valladolid,11,Ataquines,549,306,243
47,Valladolid,12,Bahabón,108,50,58
47,Valladolid,13,Barcial de la Loma,96,54,42
47,Valladolid,14,Barruelo del Valle,56,36,20
47,Valladolid,15,Becilla de Valderaduey,244,134,110
47,Valladolid,16,Benafarces,68,35,33
47,Valladolid,17,Bercero,210,115,95
47,Valladolid,18,Berceruelo,39,24,15
47,Valladolid,19,Berrueces,95,53,42
47,Valladolid,20,Bobadilla del Campo,298,169,129
47,Valladolid,21,Bocigas,84,47,37
47,Valladolid,22,Bocos de Duero,61,26,35
47,Valladolid,23,Boecillo,4154,2124,2030
47,Valladolid,24,Bolaños de Campos,304,164,140
47,Valladolid,25,Brahojos de Medina,120,62,58
47,Valladolid,26,Bustillo de Chaves,68,40,28
47,Valladolid,27,Cabezón de Pisuerga,3693,1878,1815
47,Valladolid,28,Cabezón de Valderaduey,36,20,16
47,Valladolid,29,Cabreros del Monte,58,33,25
47,Valladolid,30,Campaspero,1102,602,500
47,Valladolid,31,"Campillo, El",228,135,93
47,Valladolid,32,Camporredondo,155,90,65
47,Valladolid,33,Canalejas de Peñafiel,228,128,100
47,Valladolid,34,Canillas de Esgueva,72,43,29
47,Valladolid,35,Carpio,1024,542,482
47,Valladolid,36,Casasola de Arión,244,137,107
47,Valladolid,37,Castrejón de Trabancos,174,84,90
47,Valladolid,38,Castrillo de Duero,110,65,45
47,Valladolid,39,Castrillo-Tejeriego,179,102,77
47,Valladolid,40,Castrobol,63,33,30
47,Valladolid,41,Castrodeza,161,94,67
47,Valladolid,42,Castromembibre,65,42,23
47,Valladolid,43,Castromonte,309,178,131
47,Valladolid,44,Castronuevo de Esgueva,372,198,174
47,Valladolid,45,Castronuño,861,430,431
47,Valladolid,46,Castroponce,147,82,65
47,Valladolid,47,Castroverde de Cerrato,225,140,85
47,Valladolid,48,Ceinos de Campos,225,123,102
47,Valladolid,49,Cervillego de la Cruz,94,54,40
47,Valladolid,50,Cigales,5160,2634,2526
47,Valladolid,51,Ciguñuela,381,201,180
47,Valladolid,52,Cistérniga,9049,4572,4477
47,Valladolid,53,Cogeces de Íscar,144,71,73
47,Valladolid,54,Cogeces del Monte,691,373,318
47,Valladolid,55,Corcos,209,114,95
47,Valladolid,56,Corrales de Duero,100,58,42
47,Valladolid,57,Cubillas de Santa Marta,307,176,131
47,Valladolid,58,Cuenca de Campos,226,116,110
47,Valladolid,59,Curiel de Duero,126,79,47
47,Valladolid,60,Encinas de Esgueva,257,151,106
47,Valladolid,61,Esguevillas de Esgueva,272,145,127
47,Valladolid,62,Fombellida,173,99,74
47,Valladolid,63,Fompedraza,110,57,53
47,Valladolid,64,Fontihoyuelo,34,20,14
47,Valladolid,65,Fresno el Viejo,913,487,426
47,Valladolid,66,Fuensaldaña,1640,844,796
47,Valladolid,67,Fuente el Sol,156,81,75
47,Valladolid,68,Fuente-Olmedo,35,17,18
47,Valladolid,69,Gallegos de Hornija,129,67,62
47,Valladolid,70,Gatón de Campos,34,18,16
47,Valladolid,71,Geria,524,248,276
47,Valladolid,73,Herrín de Campos,127,63,64
47,Valladolid,74,Hornillos de Eresma,166,97,69
47,Valladolid,75,Íscar,6370,3191,3179
47,Valladolid,76,Laguna de Duero,22645,11251,11394
47,Valladolid,77,Langayo,246,158,88
47,Valladolid,79,Llano de Olmedo,61,32,29
47,Valladolid,78,Lomoviejo,175,94,81
47,Valladolid,80,Manzanillo,55,27,28
47,Valladolid,81,Marzales,48,24,24
47,Valladolid,82,Matapozuelos,1045,536,509
47,Valladolid,83,Matilla de los Caños,107,63,44
47,Valladolid,84,Mayorga,1590,797,793
47,Valladolid,86,Medina de Rioseco,4716,2311,2405
47,Valladolid,85,Medina del Campo,20583,9976,10607
47,Valladolid,87,Megeces,428,224,204
47,Valladolid,88,Melgar de Abajo,110,59,51
47,Valladolid,89,Melgar de Arriba,157,86,71
47,Valladolid,90,Mojados,3252,1708,1544
47,Valladolid,91,Monasterio de Vega,78,42,36
47,Valladolid,92,Montealegre de Campos,116,69,47
47,Valladolid,93,Montemayor de Pililla,884,480,404
47,Valladolid,94,Moral de la Reina,158,89,69
47,Valladolid,95,Moraleja de las Panaderas,41,26,15
47,Valladolid,96,Morales de Campos,142,74,68
47,Valladolid,97,Mota del Marqués,366,193,173
47,Valladolid,98,Mucientes,669,340,329
47,Valladolid,99,"Mudarra, La",159,80,79
47,Valladolid,100,Muriel,139,78,61
47,Valladolid,101,Nava del Rey,2039,1043,996
47,Valladolid,102,Nueva Villa de las Torres,294,165,129
47,Valladolid,103,Olivares de Duero,313,173,140
47,Valladolid,104,Olmedo,3654,1797,1857
47,Valladolid,105,Olmos de Esgueva,212,115,97
47,Valladolid,106,Olmos de Peñafiel,57,31,26
47,Valladolid,109,Palazuelo de Vedija,190,100,90
47,Valladolid,110,"Parrilla, La",484,244,240
47,Valladolid,111,"Pedraja de Portillo, La",1142,580,562
47,Valladolid,112,Pedrajas de San Esteban,3322,1705,1617
47,Valladolid,113,Pedrosa del Rey,185,103,82
47,Valladolid,114,Peñafiel,5090,2540,2550
47,Valladolid,115,Peñaflor de Hornija,298,170,128
47,Valladolid,116,Pesquera de Duero,457,251,206
47,Valladolid,117,Piña de Esgueva,330,170,160
47,Valladolid,118,Piñel de Abajo,167,95,72
47,Valladolid,119,Piñel de Arriba,91,50,41
47,Valladolid,121,Pollos,593,313,280
47,Valladolid,122,Portillo,2454,1291,1163
47,Valladolid,123,Pozal de Gallinas,541,302,239
47,Valladolid,124,Pozaldez,496,261,235
47,Valladolid,125,Pozuelo de la Orden,55,31,24
47,Valladolid,126,Puras,48,27,21
47,Valladolid,127,Quintanilla de Arriba,158,88,70
47,Valladolid,129,Quintanilla de Onésimo,1019,535,484
47,Valladolid,130,Quintanilla de Trigueros,105,54,51
47,Valladolid,128,Quintanilla del Molar,61,28,33
47,Valladolid,131,Rábano,182,97,85
47,Valladolid,132,Ramiro,47,27,20
47,Valladolid,133,Renedo de Esgueva,3764,1922,1842
47,Valladolid,134,Roales de Campos,161,88,73
47,Valladolid,135,Robladillo,97,56,41
47,Valladolid,137,Roturas,32,19,13
47,Valladolid,138,Rubí de Bracamonte,235,132,103
47,Valladolid,139,Rueda,1285,663,622
47,Valladolid,140,Saelices de Mayorga,114,73,41
47,Valladolid,141,Salvador de Zapardiel,130,74,56
47,Valladolid,142,San Cebrián de Mazote,140,86,54
47,Valladolid,143,San Llorente,117,65,52
47,Valladolid,144,San Martín de Valvení,86,48,38
47,Valladolid,145,San Miguel del Arroyo,671,355,316
47,Valladolid,146,San Miguel del Pino,339,178,161
47,Valladolid,147,San Pablo de la Moraleja,113,60,53
47,Valladolid,148,San Pedro de Latarce,495,263,232
47,Valladolid,149,San Pelayo,51,25,26
47,Valladolid,150,San Román de Hornija,328,161,167
47,Valladolid,151,San Salvador,29,15,14
47,Valladolid,156,San Vicente del Palacio,168,89,79
47,Valladolid,152,Santa Eufemia del Arroyo,91,50,41
47,Valladolid,153,Santervás de Campos,115,60,55
47,Valladolid,154,Santibáñez de Valcorba,158,90,68
47,Valladolid,155,Santovenia de Pisuerga,4346,2231,2115
47,Valladolid,157,Sardón de Duero,583,310,273
47,Valladolid,158,"Seca, La",1094,555,539
47,Valladolid,159,Serrada,1135,595,540
47,Valladolid,160,Siete Iglesias de Trabancos,431,229,202
47,Valladolid,161,Simancas,5242,2659,2583
47,Valladolid,162,Tamariz de Campos,55,31,24
47,Valladolid,163,Tiedra,294,142,152
47,Valladolid,164,Tordehumos,433,233,200
47,Valladolid,165,Tordesillas,8825,4477,4348
47,Valladolid,169,Torre de Esgueva,71,36,35
47,Valladolid,170,Torre de Peñafiel,42,24,18
47,Valladolid,166,Torrecilla de la Abadesa,275,134,141
47,Valladolid,167,Torrecilla de la Orden,247,127,120
47,Valladolid,168,Torrecilla de la Torre,33,21,12
47,Valladolid,171,Torrelobatón,425,223,202
47,Valladolid,172,Torrescárcela,150,79,71
47,Valladolid,173,Traspinedo,1089,589,500
47,Valladolid,174,Trigueros del Valle,298,164,134
47,Valladolid,175,Tudela de Duero,8547,4364,4183
47,Valladolid,176,"Unión de Campos, La",238,122,116
47,Valladolid,177,Urones de Castroponce,102,61,41
47,Valladolid,178,Urueña,188,104,84
47,Valladolid,179,Valbuena de Duero,471,251,220
47,Valladolid,180,Valdearcos de la Vega,61,32,29
47,Valladolid,181,Valdenebro de los Valles,197,103,94
47,Valladolid,182,Valdestillas,1657,863,794
47,Valladolid,183,Valdunquillo,133,67,66
47,Valladolid,186,Valladolid,298866,140382,158484
47,Valladolid,184,Valoria la Buena,647,348,299
47,Valladolid,185,Valverde de Campos,100,60,40
47,Valladolid,187,Vega de Ruiponce,94,57,37
47,Valladolid,188,Vega de Valdetronco,108,59,49
47,Valladolid,189,Velascálvaro,162,90,72
47,Valladolid,190,Velilla,113,54,59
47,Valladolid,191,Velliza,108,69,39
47,Valladolid,192,Ventosa de la Cuesta,108,63,45
47,Valladolid,193,Viana de Cega,2038,1065,973
47,Valladolid,195,Villabáñez,504,277,227
47,Valladolid,196,Villabaruz de Campos,34,15,19
47,Valladolid,197,Villabrágima,1033,546,487
47,Valladolid,198,Villacarralón,82,47,35
47,Valladolid,199,Villacid de Campos,74,47,27
47,Valladolid,200,Villaco,83,54,29
47,Valladolid,203,Villafrades de Campos,65,35,30
47,Valladolid,204,Villafranca de Duero,274,137,137
47,Valladolid,205,Villafrechós,505,274,231
47,Valladolid,206,Villafuerte,82,46,36
47,Valladolid,207,Villagarcía de Campos,309,180,129
47,Valladolid,208,Villagómez la Nueva,67,34,33
47,Valladolid,209,Villalán de Campos,35,23,12
47,Valladolid,210,Villalar de los Comuneros,458,221,237
47,Valladolid,211,Villalba de la Loma,55,30,25
47,Valladolid,212,Villalba de los Alcores,400,217,183
47,Valladolid,213,Villalbarba,123,62,61
47,Valladolid,214,Villalón de Campos,1606,791,815
47,Valladolid,215,Villamuriel de Campos,53,27,26
47,Valladolid,216,Villán de Tordesillas,128,75,53
47,Valladolid,217,Villanubla,2692,1392,1300
47,Valladolid,218,Villanueva de Duero,1170,610,560
47,Valladolid,219,Villanueva de la Condesa,58,31,27
47,Valladolid,220,Villanueva de los Caballeros,172,90,82
47,Valladolid,221,Villanueva de los Infantes,107,65,42
47,Valladolid,222,Villanueva de San Mancio,85,46,39
47,Valladolid,223,Villardefrades,167,94,73
47,Valladolid,224,Villarmentero de Esgueva,103,55,48
47,Valladolid,225,Villasexmir,83,47,36
47,Valladolid,226,Villavaquerín,167,96,71
47,Valladolid,227,Villavellid,60,37,23
47,Valladolid,228,Villaverde de Medina,514,273,241
47,Valladolid,229,Villavicencio de los Caballeros,239,113,126
47,Valladolid,194,Viloria,337,175,162
47,Valladolid,230,Wamba,328,174,154
47,Valladolid,231,Zaratán,6212,3181,3031
47,Valladolid,232,"Zarza, La",114,63,51
49,Zamora,2,Abezames,60,30,30
49,Zamora,3,Alcañices,1074,547,527
49,Zamora,4,Alcubilla de Nogales,123,67,56
49,Zamora,5,Alfaraz de Sayago,130,75,55
49,Zamora,6,Algodre,145,79,66
49,Zamora,7,Almaraz de Duero,402,208,194
49,Zamora,8,Almeida de Sayago,462,245,217
49,Zamora,9,Andavías,438,226,212
49,Zamora,10,Arcenillas,405,204,201
49,Zamora,11,Arcos de la Polvorosa,229,127,102
49,Zamora,12,Argañín,76,36,40
49,Zamora,13,Argujillo,247,121,126
49,Zamora,14,Arquillinos,116,58,58
49,Zamora,15,Arrabalde,232,113,119
49,Zamora,16,Aspariegos,260,121,139
49,Zamora,17,Asturianos,261,131,130
49,Zamora,18,Ayoó de Vidriales,317,159,158
49,Zamora,19,Barcial del Barco,258,137,121
49,Zamora,20,Belver de los Montes,281,153,128
49,Zamora,21,Benavente,18095,8752,9343
49,Zamora,22,Benegiles,325,172,153
49,Zamora,23,Bermillo de Sayago,1037,553,484
49,Zamora,24,"Bóveda de Toro, La",736,369,367
49,Zamora,25,Bretó,184,109,75
49,Zamora,26,Bretocino,228,121,107
49,Zamora,27,Brime de Sog,134,66,68
49,Zamora,28,Brime de Urz,108,64,44
49,Zamora,29,Burganes de Valverde,656,341,315
49,Zamora,30,Bustillo del Oro,85,44,41
49,Zamora,31,Cabañas de Sayago,160,85,75
49,Zamora,32,Calzadilla de Tera,305,142,163
49,Zamora,33,Camarzana de Tera,813,407,406
49,Zamora,34,Cañizal,455,235,220
49,Zamora,35,Cañizo,236,126,110
49,Zamora,36,Carbajales de Alba,556,283,273
49,Zamora,37,Carbellino,202,110,92
49,Zamora,38,Casaseca de Campeán,104,56,48
49,Zamora,39,Casaseca de las Chanas,390,209,181
49,Zamora,40,Castrillo de la Guareña,121,61,60
49,Zamora,41,Castrogonzalo,478,261,217
49,Zamora,42,Castronuevo,232,113,119
49,Zamora,43,Castroverde de Campos,303,155,148
49,Zamora,44,Cazurra,87,48,39
49,Zamora,46,Cerecinos de Campos,275,152,123
49,Zamora,47,Cerecinos del Carrizal,121,68,53
49,Zamora,48,Cernadilla,116,60,56
49,Zamora,50,Cobreros,576,306,270
49,Zamora,52,Coomonte,194,107,87
49,Zamora,53,Coreses,1057,543,514
49,Zamora,54,Corrales del Vino,982,486,496
49,Zamora,55,Cotanes del Monte,106,56,50
49,Zamora,56,Cubillos,310,157,153
49,Zamora,57,Cubo de Benavente,115,64,51
49,Zamora,58,"Cubo de Tierra del Vino, El",320,170,150
49,Zamora,59,Cuelgamures,86,54,32
49,Zamora,61,Entrala,156,87,69
49,Zamora,62,Espadañedo,110,54,56
49,Zamora,63,Faramontanos de Tábara,344,177,167
49,Zamora,64,Fariza,524,274,250
49,Zamora,65,Fermoselle,1225,622,603
49,Zamora,66,Ferreras de Abajo,519,265,254
49,Zamora,67,Ferreras de Arriba,376,205,171
49,Zamora,68,Ferreruela,476,261,215
49,Zamora,69,Figueruela de Arriba,339,161,178
49,Zamora,71,Fonfría,761,400,361
49,Zamora,75,Fresno de la Polvorosa,138,74,64
49,Zamora,76,Fresno de la Ribera,375,200,175
49,Zamora,77,Fresno de Sayago,180,94,86
49,Zamora,78,Friera de Valverde,160,87,73
49,Zamora,79,Fuente Encalada,110,60,50
49,Zamora,80,Fuentelapeña,702,376,326
49,Zamora,82,Fuentes de Ropel,379,192,187
49,Zamora,81,Fuentesaúco,1491,741,750
49,Zamora,83,Fuentesecas,51,24,27
49,Zamora,84,Fuentespreadas,310,164,146
49,Zamora,85,Galende,1058,536,522
49,Zamora,86,Gallegos del Pan,112,66,46
49,Zamora,87,Gallegos del Río,497,271,226
49,Zamora,88,Gamones,96,56,40
49,Zamora,90,Gema,222,108,114
49,Zamora,91,Granja de Moreruela,280,145,135
49,Zamora,92,Granucillo,122,59,63
49,Zamora,93,Guarrate,324,166,158
49,Zamora,94,Hermisende,247,129,118
49,Zamora,95,"Hiniesta, La",320,166,154
49,Zamora,96,Jambrina,162,87,75
49,Zamora,97,Justel,80,46,34
49,Zamora,98,Losacino,218,120,98
49,Zamora,99,Losacio,98,58,40
49,Zamora,100,Lubián,302,164,138
49,Zamora,101,Luelmo,159,84,75
49,Zamora,102,"Maderal, El",195,103,92
49,Zamora,103,Madridanos,471,247,224
49,Zamora,104,Mahide,316,177,139
49,Zamora,105,Maire de Castroponce,151,79,72
49,Zamora,107,Malva,131,58,73
49,Zamora,108,Manganeses de la Lampreana,482,242,240
49,Zamora,109,Manganeses de la Polvorosa,669,324,345
49,Zamora,110,Manzanal de Arriba,358,192,166
49,Zamora,112,Manzanal de los Infantes,128,73,55
49,Zamora,111,Manzanal del Barco,126,66,60
49,Zamora,113,Matilla de Arzón,169,98,71
49,Zamora,114,Matilla la Seca,41,23,18
49,Zamora,115,Mayalde,194,105,89
49,Zamora,116,Melgar de Tera,391,201,190
49,Zamora,117,Micereces de Tera,469,240,229
49,Zamora,118,Milles de la Polvorosa,224,121,103
49,Zamora,119,Molacillos,256,142,114
49,Zamora,120,Molezuelas de la Carballeda,64,32,32
49,Zamora,121,Mombuey,409,223,186
49,Zamora,122,Monfarracinos,980,504,476
49,Zamora,123,Montamarta,603,315,288
49,Zamora,124,Moral de Sayago,261,150,111
49,Zamora,126,Moraleja de Sayago,274,143,131
49,Zamora,125,Moraleja del Vino,1705,871,834
49,Zamora,128,Morales de Rey,576,289,287
49,Zamora,129,Morales de Toro,1003,532,471
49,Zamora,130,Morales de Valverde,176,91,85
49,Zamora,127,Morales del Vino,2907,1516,1391
49,Zamora,131,Moralina,263,137,126
49,Zamora,132,Moreruela de los Infanzones,352,182,170
49,Zamora,133,Moreruela de Tábara,306,161,145
49,Zamora,134,Muelas de los Caballeros,179,102,77
49,Zamora,135,Muelas del Pan,639,328,311
49,Zamora,136,Muga de Sayago,342,165,177
49,Zamora,137,Navianos de Valverde,185,104,81
49,Zamora,138,Olmillos de Castro,230,126,104
49,Zamora,139,Otero de Bodas,164,89,75
49,Zamora,141,Pajares de la Lampreana,336,171,165
49,Zamora,143,Palacios de Sanabria,238,117,121
49,Zamora,142,Palacios del Pan,271,139,132
49,Zamora,145,Pedralba de la Pradería,232,124,108
49,Zamora,146,"Pego, El",292,145,147
49,Zamora,147,Peleagonzalo,255,128,127
49,Zamora,148,Peleas de Abajo,274,129,145
49,Zamora,149,Peñausende,399,199,200
49,Zamora,150,Peque,133,57,76
49,Zamora,151,"Perdigón, El",692,364,328
49,Zamora,152,Pereruela,540,287,253
49,Zamora,153,Perilla de Castro,167,86,81
49,Zamora,154,Pías,123,71,52
49,Zamora,155,Piedrahita de Castro,85,45,40
49,Zamora,156,Pinilla de Toro,226,117,109
49,Zamora,157,Pino del Oro,200,108,92
49,Zamora,158,"Piñero, El",237,125,112
49,Zamora,160,Pobladura de Valderaduey,37,20,17
49,Zamora,159,Pobladura del Valle,288,150,138
49,Zamora,162,Porto,165,90,75
49,Zamora,163,Pozoantiguo,207,105,102
49,Zamora,164,Pozuelo de Tábara,162,80,82
49,Zamora,165,Prado,55,30,25
49,Zamora,166,Puebla de Sanabria,1409,694,715
49,Zamora,167,Pueblica de Valverde,194,108,86
49,Zamora,170,Quintanilla de Urz,103,54,49
49,Zamora,168,Quintanilla del Monte,105,55,50
49,Zamora,169,Quintanilla del Olmo,38,19,19
49,Zamora,171,Quiruelas de Vidriales,668,347,321
49,Zamora,172,Rabanales,528,275,253
49,Zamora,173,Rábano de Aliste,385,190,195
49,Zamora,174,Requejo,146,70,76
49,Zamora,175,Revellinos,267,138,129
49,Zamora,176,Riofrío de Aliste,684,382,302
49,Zamora,177,Rionegro del Puente,278,145,133
49,Zamora,178,Roales,923,487,436
49,Zamora,179,Robleda-Cervantes,417,226,191
49,Zamora,180,Roelos de Sayago,156,76,80
49,Zamora,181,Rosinos de la Requejada,365,196,169
49,Zamora,183,Salce,103,47,56
49,Zamora,184,Samir de los Caños,180,99,81
49,Zamora,185,San Agustín del Pozo,185,95,90
49,Zamora,186,San Cebrián de Castro,250,122,128
49,Zamora,187,San Cristóbal de Entreviñas,1401,734,667
49,Zamora,188,San Esteban del Molar,133,77,56
49,Zamora,189,San Justo,219,120,99
49,Zamora,190,San Martín de Valderaduey,52,28,24
49,Zamora,191,San Miguel de la Ribera,286,142,144
49,Zamora,192,San Miguel del Valle,141,69,72
49,Zamora,193,San Pedro de Ceque,463,240,223
49,Zamora,194,San Pedro de la Nave-Almendra,347,178,169
49,Zamora,208,San Vicente de la Cabeza,395,209,186
49,Zamora,209,San Vitero,520,291,229
49,Zamora,197,Santa Clara de Avedillo,170,86,84
49,Zamora,199,Santa Colomba de las Monjas,262,126,136
49,Zamora,200,Santa Cristina de la Polvorosa,1075,551,524
49,Zamora,201,Santa Croya de Tera,307,154,153
49,Zamora,202,Santa Eufemia del Barco,184,107,77
49,Zamora,203,Santa María de la Vega,308,160,148
49,Zamora,204,Santa María de Valverde,55,25,30
49,Zamora,205,Santibáñez de Tera,389,200,189
49,Zamora,206,Santibáñez de Vidriales,977,490,487
49,Zamora,207,Santovenia,259,129,130
49,Zamora,210,Sanzoles,506,254,252
49,Zamora,214,Tábara,762,393,369
49,Zamora,216,Tapioles,158,93,65
49,Zamora,219,Toro,8789,4302,4487
49,Zamora,220,"Torre del Valle, La",146,78,68
49,Zamora,221,Torregamones,277,144,133
49,Zamora,222,Torres del Carrizal,403,205,198
49,Zamora,223,Trabazos,872,455,417
49,Zamora,224,Trefacio,187,92,95
49,Zamora,225,Uña de Quintana,140,74,66
49,Zamora,226,Vadillo de la Guareña,264,141,123
49,Zamora,227,Valcabado,353,183,170
49,Zamora,228,Valdefinjas,47,28,19
49,Zamora,229,Valdescorriel,134,66,68
49,Zamora,230,Vallesa de la Guareña,89,48,41
49,Zamora,231,Vega de Tera,346,166,180
49,Zamora,232,Vega de Villalobos,107,50,57
49,Zamora,233,Vegalatrave,92,52,40
49,Zamora,234,Venialbo,429,231,198
49,Zamora,235,Vezdemarbán,383,195,188
49,Zamora,236,Vidayanes,89,47,42
49,Zamora,237,Videmala,156,82,74
49,Zamora,238,Villabrázaro,205,107,98
49,Zamora,239,Villabuena del Puente,705,362,343
49,Zamora,240,Villadepera,205,110,95
49,Zamora,241,Villaescusa,254,140,114
49,Zamora,242,Villafáfila,483,252,231
49,Zamora,243,Villaferrueña,109,56,53
49,Zamora,244,Villageriz,48,29,19
49,Zamora,245,Villalazán,278,137,141
49,Zamora,246,Villalba de la Lampreana,233,130,103
49,Zamora,247,Villalcampo,444,218,226
49,Zamora,248,Villalobos,253,123,130
49,Zamora,249,Villalonso,75,41,34
49,Zamora,250,Villalpando,1519,755,764
49,Zamora,251,Villalube,158,85,73
49,Zamora,252,Villamayor de Campos,324,162,162
49,Zamora,255,Villamor de los Escuderos,398,211,187
49,Zamora,256,Villanázar,280,144,136
49,Zamora,257,Villanueva de Azoague,336,168,168
49,Zamora,258,Villanueva de Campeán,115,67,48
49,Zamora,259,Villanueva de las Peras,77,41,36
49,Zamora,260,Villanueva del Campo,857,425,432
49,Zamora,263,Villar de Fallaves,44,24,20
49,Zamora,264,Villar del Buey,579,298,281
49,Zamora,261,Villaralbo,1858,942,916
49,Zamora,262,Villardeciervos,418,211,207
49,Zamora,265,Villardiegua de la Ribera,126,65,61
49,Zamora,266,Villárdiga,75,42,33
49,Zamora,267,Villardondiego,104,58,46
49,Zamora,268,Villarrín de Campos,404,217,187
49,Zamora,269,Villaseco del Pan,238,111,127
49,Zamora,270,Villavendimio,168,103,65
49,Zamora,272,Villaveza de Valverde,82,42,40
49,Zamora,271,Villaveza del Agua,194,108,86
49,Zamora,273,Viñas,190,97,93
49,Zamora,275,Zamora,61827,28759,33068
50,Zaragoza,1,Abanto,97,58,39
50,Zaragoza,2,Acered,165,96,69
50,Zaragoza,3,Agón,146,81,65
50,Zaragoza,4,Aguarón,631,332,299
50,Zaragoza,5,Aguilón,235,128,107
50,Zaragoza,6,Ainzón,1085,545,540
50,Zaragoza,7,Aladrén,52,34,18
50,Zaragoza,8,Alagón,7094,3526,3568
50,Zaragoza,9,Alarba,133,77,56
50,Zaragoza,10,Alberite de San Juan,72,41,31
50,Zaragoza,11,Albeta,132,68,64
50,Zaragoza,12,Alborge,108,57,51
50,Zaragoza,13,Alcalá de Ebro,251,122,129
50,Zaragoza,14,Alcalá de Moncayo,144,83,61
50,Zaragoza,15,Alconchel de Ariza,63,36,27
50,Zaragoza,16,Aldehuela de Liestos,49,32,17
50,Zaragoza,17,Alfajarín,2312,1190,1122
50,Zaragoza,18,Alfamén,1441,760,681
50,Zaragoza,19,Alforque,62,33,29
50,Zaragoza,20,Alhama de Aragón,1036,545,491
50,Zaragoza,21,Almochuel,29,12,17
50,Zaragoza,22,"Almolda, La",567,289,278
50,Zaragoza,23,Almonacid de la Cuba,252,124,128
50,Zaragoza,24,Almonacid de la Sierra,691,382,309
50,Zaragoza,25,"Almunia de Doña Godina, La",7819,3978,3841
50,Zaragoza,26,Alpartir,579,288,291
50,Zaragoza,27,Ambel,256,123,133
50,Zaragoza,28,Anento,95,62,33
50,Zaragoza,29,Aniñón,708,383,325
50,Zaragoza,30,Añón de Moncayo,213,129,84
50,Zaragoza,31,Aranda de Moncayo,160,99,61
50,Zaragoza,32,Arándiga,309,166,143
50,Zaragoza,33,Ardisa,72,45,27
50,Zaragoza,34,Ariza,1139,579,560
50,Zaragoza,35,Artieda,73,43,30
50,Zaragoza,36,Asín,96,52,44
50,Zaragoza,37,Atea,156,96,60
50,Zaragoza,38,Ateca,1793,925,868
50,Zaragoza,39,Azuara,543,310,233
50,Zaragoza,40,Badules,83,47,36
50,Zaragoza,41,Bagüés,12,8,4
50,Zaragoza,42,Balconchán,17,7,10
50,Zaragoza,43,Bárboles,300,164,136
50,Zaragoza,44,Bardallur,261,123,138
50,Zaragoza,45,Belchite,1528,768,760
50,Zaragoza,46,Belmonte de Gracián,198,110,88
50,Zaragoza,47,Berdejo,47,33,14
50,Zaragoza,48,Berrueco,33,18,15
50,Zaragoza,901,Biel,140,87,53
50,Zaragoza,50,Bijuesca,98,61,37
50,Zaragoza,51,Biota,948,480,468
50,Zaragoza,52,Bisimbre,97,58,39
50,Zaragoza,53,Boquiñeni,808,407,401
50,Zaragoza,54,Bordalba,56,36,20
50,Zaragoza,55,Borja,4922,2509,2413
50,Zaragoza,56,Botorrita,498,271,227
50,Zaragoza,57,Brea de Aragón,1665,847,818
50,Zaragoza,58,Bubierca,63,33,30
50,Zaragoza,59,Bujaraloz,1005,527,478
50,Zaragoza,60,Bulbuente,217,119,98
50,Zaragoza,61,Bureta,217,111,106
50,Zaragoza,62,"Burgo de Ebro, El",2432,1233,1199
50,Zaragoza,63,"Buste, El",72,41,31
50,Zaragoza,64,Cabañas de Ebro,498,263,235
50,Zaragoza,65,Cabolafuente,32,19,13
50,Zaragoza,66,Cadrete,3891,2055,1836
50,Zaragoza,67,Calatayud,20035,9865,10170
50,Zaragoza,68,Calatorao,2861,1500,1361
50,Zaragoza,69,Calcena,75,44,31
50,Zaragoza,70,Calmarza,59,33,26
50,Zaragoza,71,Campillo de Aragón,149,80,69
50,Zaragoza,72,Carenas,177,93,84
50,Zaragoza,73,Cariñena,3276,1655,1621
50,Zaragoza,74,Caspe,9525,4918,4607
50,Zaragoza,75,Castejón de Alarba,92,58,34
50,Zaragoza,76,Castejón de las Armas,90,51,39
50,Zaragoza,77,Castejón de Valdejasa,221,114,107
50,Zaragoza,78,Castiliscar,265,140,125
50,Zaragoza,79,Cervera de la Cañada,271,150,121
50,Zaragoza,80,Cerveruela,35,22,13
50,Zaragoza,81,Cetina,592,310,282
50,Zaragoza,92,Chiprana,508,265,243
50,Zaragoza,93,Chodes,113,62,51
50,Zaragoza,82,Cimballa,93,51,42
50,Zaragoza,83,Cinco Olivas,112,53,59
50,Zaragoza,84,Clarés de Ribota,65,38,27
50,Zaragoza,85,Codo,198,103,95
50,Zaragoza,86,Codos,183,115,68
50,Zaragoza,87,Contamina,37,21,16
50,Zaragoza,88,Cosuenda,367,195,172
50,Zaragoza,89,Cuarte de Huerva,13055,6674,6381
50,Zaragoza,90,Cubel,168,82,86
50,Zaragoza,91,"Cuerlas, Las",39,20,19
50,Zaragoza,94,Daroca,1996,983,1013
50,Zaragoza,95,Ejea de los Caballeros,16605,8453,8152
50,Zaragoza,96,Embid de Ariza,36,19,17
50,Zaragoza,98,Encinacorba,189,96,93
50,Zaragoza,99,Épila,4402,2277,2125
50,Zaragoza,100,Erla,345,175,170
50,Zaragoza,101,Escatrón,1026,512,514
50,Zaragoza,102,Fabara,1152,619,533
50,Zaragoza,104,Farlete,386,188,198
50,Zaragoza,105,Fayón,354,179,175
50,Zaragoza,106,"Fayos, Los",141,80,61
50,Zaragoza,107,Figueruelas,1240,615,625
50,Zaragoza,108,Fombuena,54,35,19
50,Zaragoza,109,"Frago, El",99,61,38
50,Zaragoza,110,"Frasno, El",384,211,173
50,Zaragoza,111,Fréscano,202,111,91
50,Zaragoza,113,Fuendejalón,793,422,371
50,Zaragoza,114,Fuendetodos,121,68,53
50,Zaragoza,115,Fuentes de Ebro,4543,2353,2190
50,Zaragoza,116,Fuentes de Jiloca,229,122,107
50,Zaragoza,117,Gallocanta,154,86,68
50,Zaragoza,118,Gallur,2628,1324,1304
50,Zaragoza,119,Gelsa,995,524,471
50,Zaragoza,120,Godojos,54,30,24
50,Zaragoza,121,Gotor,306,161,145
50,Zaragoza,122,Grisel,67,40,27
50,Zaragoza,123,Grisén,597,310,287
50,Zaragoza,124,Herrera de los Navarros,506,274,232
50,Zaragoza,125,Ibdes,404,212,192
50,Zaragoza,126,Illueca,2964,1460,1504
50,Zaragoza,128,Isuerre,31,19,12
50,Zaragoza,129,Jaraba,280,147,133
50,Zaragoza,130,Jarque,436,241,195
50,Zaragoza,131,Jaulín,237,128,109
50,Zaragoza,132,"Joyosa, La",1072,558,514
50,Zaragoza,133,Lagata,111,59,52
50,Zaragoza,134,Langa del Castillo,132,67,65
50,Zaragoza,135,Layana,100,53,47
50,Zaragoza,136,Lécera,661,362,299
50,Zaragoza,138,Lechón,53,31,22
50,Zaragoza,137,Leciñena,1162,585,577
50,Zaragoza,139,Letux,342,190,152
50,Zaragoza,140,Litago,166,92,74
50,Zaragoza,141,Lituénigo,127,64,63
50,Zaragoza,142,Lobera de Onsella,28,14,14
50,Zaragoza,143,Longares,763,440,323
50,Zaragoza,144,Longás,35,24,11
50,Zaragoza,146,Lucena de Jalón,237,129,108
50,Zaragoza,147,Luceni,945,473,472
50,Zaragoza,148,Luesia,310,168,142
50,Zaragoza,149,Luesma,34,21,13
50,Zaragoza,150,Lumpiaque,827,423,404
50,Zaragoza,151,Luna,701,368,333
50,Zaragoza,152,Maella,2007,1078,929
50,Zaragoza,153,Magallón,1133,587,546
50,Zaragoza,154,Mainar,151,84,67
50,Zaragoza,155,Malanquilla,100,63,37
50,Zaragoza,156,Maleján,259,134,125
50,Zaragoza,160,Mallén,3083,1612,1471
50,Zaragoza,157,Malón,323,168,155
50,Zaragoza,159,Maluenda,942,461,481
50,Zaragoza,161,Manchones,98,55,43
50,Zaragoza,162,Mara,181,91,90
50,Zaragoza,163,María de Huerva,5663,2894,2769
50,Zaragoza,902,Marracos,86,50,36
50,Zaragoza,164,Mediana de Aragón,465,229,236
50,Zaragoza,165,Mequinenza,2301,1167,1134
50,Zaragoza,166,Mesones de Isuela,271,138,133
50,Zaragoza,167,Mezalocha,240,137,103
50,Zaragoza,168,Mianos,32,19,13
50,Zaragoza,169,Miedes de Aragón,432,231,201
50,Zaragoza,170,Monegrillo,413,231,182
50,Zaragoza,171,Moneva,94,58,36
50,Zaragoza,172,Monreal de Ariza,212,121,91
50,Zaragoza,173,Monterde,159,101,58
50,Zaragoza,174,Montón,94,53,41
50,Zaragoza,175,Morata de Jalón,1097,537,560
50,Zaragoza,176,Morata de Jiloca,282,162,120
50,Zaragoza,177,Morés,334,178,156
50,Zaragoza,178,Moros,362,186,176
50,Zaragoza,179,Moyuela,245,132,113
50,Zaragoza,180,Mozota,130,64,66
50,Zaragoza,181,Muel,1333,684,649
50,Zaragoza,182,"Muela, La",5479,2855,2624
50,Zaragoza,183,Munébrega,385,209,176
50,Zaragoza,184,Murero,107,62,45
50,Zaragoza,185,Murillo de Gállego,174,104,70
50,Zaragoza,186,Navardún,40,25,15
50,Zaragoza,187,Nigüella,66,41,25
50,Zaragoza,188,Nombrevilla,29,18,11
50,Zaragoza,189,Nonaspe,962,521,441
50,Zaragoza,190,Novallas,850,449,401
50,Zaragoza,191,Novillas,540,269,271
50,Zaragoza,192,Nuévalos,325,177,148
50,Zaragoza,193,Nuez de Ebro,827,413,414
50,Zaragoza,194,Olvés,106,64,42
50,Zaragoza,195,Orcajo,59,38,21
50,Zaragoza,196,Orera,118,62,56
50,Zaragoza,197,Orés,104,63,41
50,Zaragoza,198,Oseja,52,33,19
50,Zaragoza,199,Osera de Ebro,395,201,194
50,Zaragoza,200,Paniza,634,333,301
50,Zaragoza,201,Paracuellos de Jiloca,601,310,291
50,Zaragoza,202,Paracuellos de la Ribera,158,83,75
50,Zaragoza,203,Pastriz,1293,625,668
50,Zaragoza,204,Pedrola,3509,1787,1722
50,Zaragoza,205,"Pedrosas, Las",90,44,46
50,Zaragoza,206,Perdiguera,577,308,269
50,Zaragoza,207,Piedratajada,97,49,48
50,Zaragoza,208,Pina de Ebro,2373,1217,1156
50,Zaragoza,209,Pinseque,3908,2009,1899
50,Zaragoza,210,"Pintanos, Los",37,23,14
50,Zaragoza,211,Plasencia de Jalón,303,172,131
50,Zaragoza,212,Pleitas,36,14,22
50,Zaragoza,213,Plenas,101,54,47
50,Zaragoza,214,Pomer,22,15,7
50,Zaragoza,215,Pozuel de Ariza,21,12,9
50,Zaragoza,216,Pozuelo de Aragón,284,152,132
50,Zaragoza,217,Pradilla de Ebro,574,301,273
50,Zaragoza,218,Puebla de Albortón,120,74,46
50,Zaragoza,219,"Puebla de Alfindén, La",6173,3162,3011
50,Zaragoza,220,Puendeluna,44,26,18
50,Zaragoza,221,Purujosa,36,26,10
50,Zaragoza,222,Quinto,1948,990,958
50,Zaragoza,223,Remolinos,1081,551,530
50,Zaragoza,224,Retascón,74,45,29
50,Zaragoza,225,Ricla,2815,1486,1329
50,Zaragoza,227,Romanos,119,59,60
50,Zaragoza,228,Rueda de Jalón,325,174,151
50,Zaragoza,229,Ruesca,72,37,35
50,Zaragoza,241,Sabiñán,691,374,317
50,Zaragoza,230,Sádaba,1324,663,661
50,Zaragoza,231,Salillas de Jalón,304,155,149
50,Zaragoza,232,Salvatierra de Esca,198,95,103
50,Zaragoza,233,Samper del Salz,112,63,49
50,Zaragoza,234,San Martín de la Virgen de Moncayo,286,161,125
50,Zaragoza,235,San Mateo de Gállego,3134,1605,1529
50,Zaragoza,236,Santa Cruz de Grío,108,63,45
50,Zaragoza,237,Santa Cruz de Moncayo,125,67,58
50,Zaragoza,238,Santa Eulalia de Gállego,98,53,45
50,Zaragoza,239,Santed,61,39,22
50,Zaragoza,240,Sástago,1170,589,581
50,Zaragoza,242,Sediles,95,58,37
50,Zaragoza,243,Sestrica,370,208,162
50,Zaragoza,244,Sierra de Luna,253,136,117
50,Zaragoza,245,Sigüés,88,47,41
50,Zaragoza,246,Sisamón,31,20,11
50,Zaragoza,247,Sobradiel,1089,523,566
50,Zaragoza,248,Sos del Rey Católico,588,312,276
50,Zaragoza,249,Tabuenca,323,187,136
50,Zaragoza,250,Talamantes,63,32,31
50,Zaragoza,251,Tarazona,10509,5203,5306
50,Zaragoza,252,Tauste,6914,3447,3467
50,Zaragoza,253,Terrer,485,261,224
50,Zaragoza,254,Tierga,192,104,88
50,Zaragoza,255,Tobed,214,113,101
50,Zaragoza,256,Torralba de los Frailes,86,46,40
50,Zaragoza,257,Torralba de Ribota,172,97,75
50,Zaragoza,258,Torralbilla,61,35,26
50,Zaragoza,259,Torrehermosa,63,35,28
50,Zaragoza,260,Torrelapaja,32,21,11
50,Zaragoza,261,Torrellas,250,130,120
50,Zaragoza,262,Torres de Berrellén,1446,745,701
50,Zaragoza,263,Torrijo de la Cañada,206,118,88
50,Zaragoza,264,Tosos,180,102,78
50,Zaragoza,265,Trasmoz,89,53,36
50,Zaragoza,266,Trasobares,120,74,46
50,Zaragoza,267,Uncastillo,650,307,343
50,Zaragoza,268,Undués de Lerda,55,32,23
50,Zaragoza,269,Urrea de Jalón,418,231,187
50,Zaragoza,270,Urriés,38,20,18
50,Zaragoza,271,Used,271,148,123
50,Zaragoza,272,Utebo,18602,9258,9344
50,Zaragoza,274,Val de San Martín,64,36,28
50,Zaragoza,273,Valdehorna,30,15,15
50,Zaragoza,275,Valmadrid,112,69,43
50,Zaragoza,276,Valpalmas,142,68,74
50,Zaragoza,277,Valtorres,68,33,35
50,Zaragoza,278,Velilla de Ebro,215,114,101
50,Zaragoza,279,Velilla de Jiloca,90,43,47
50,Zaragoza,280,Vera de Moncayo,360,183,177
50,Zaragoza,281,Vierlas,74,40,34
50,Zaragoza,283,Villadoz,88,51,37
50,Zaragoza,284,Villafeliche,170,94,76
50,Zaragoza,285,Villafranca de Ebro,830,404,426
50,Zaragoza,286,Villalba de Perejil,99,48,51
50,Zaragoza,287,Villalengua,319,175,144
50,Zaragoza,903,Villamayor de Gállego,2696,1350,1346
50,Zaragoza,288,Villanueva de Gállego,4661,2350,2311
50,Zaragoza,290,Villanueva de Huerva,463,239,224
50,Zaragoza,289,Villanueva de Jiloca,46,24,22
50,Zaragoza,291,Villar de los Navarros,102,56,46
50,Zaragoza,292,Villarreal de Huerva,274,154,120
50,Zaragoza,293,Villarroya de la Sierra,466,246,220
50,Zaragoza,294,Villarroya del Campo,68,36,32
50,Zaragoza,282,"Vilueña, La",77,39,38
50,Zaragoza,295,Vistabella,49,28,21
50,Zaragoza,296,"Zaida, La",455,228,227
50,Zaragoza,297,Zaragoza,666880,319177,347703
50,Zaragoza,298,Zuera,8365,4330,4035
51,Ceuta,1,Ceuta,85144,43177,41967
52,Melilla,1,Melilla,86384,43765,42619
