CPRO,PROVINCIA,CMUN,NOMBRE,AMBOS SEXOS,VARONES,MUJERES
1,Araba/Álava,1,Alegría-Dulantzi,2803,1466,1337
1,Araba/Álava,2,Amurrio,10014,5030,4984
1,Araba/Álava,3,Aramaio,1496,784,712
1,Araba/Álava,4,Artziniega,1843,916,927
1,Araba/Álava,6,Armiñón,229,112,117
1,Araba/Álava,8,Arrazua-Ubarrundia,951,508,443
1,Araba/Álava,9,Asparrena,1684,851,833
1,Araba/Álava,10,Ayala/Aiara,2880,1436,1444
1,Araba/Álava,11,Baños de Ebro/Mañueta,324,180,144
1,Araba/Álava,13,Barrundia,906,497,409
1,Araba/Álava,14,Berantevilla,494,255,239
1,Araba/Álava,16,Bernedo,565,329,236
1,Araba/Álava,17,Campezo/Kanpezu,1123,592,531
1,Araba/Álava,18,Zigoitia,1729,928,801
1,Araba/Álava,19,Kripan,197,106,91
1,Araba/Álava,20,Kuartango,351,201,150
1,Araba/Álava,21,Elburgo/Burgelu,623,324,299
1,Araba/Álava,22,Elciego,1045,517,528
1,Araba/Álava,23,Elvillar/Bilar,361,181,180
1,Araba/Álava,27,Iruraiz-Gauna,534,291,243
1,Araba/Álava,28,Labastida/Bastida,1470,766,704
1,Araba/Álava,30,Lagrán,184,96,88
1,Araba/Álava,31,Laguardia,1546,803,743
1,Araba/Álava,32,Lanciego/Lantziego,682,365,317
1,Araba/Álava,33,Lapuebla de Labarca,867,444,423
1,Araba/Álava,34,Leza,213,112,101
1,Araba/Álava,36,Laudio/Llodio,18494,9135,9359
1,Araba/Álava,37,Arraia-Maeztu,722,402,320
1,Araba/Álava,39,Moreda de Álava,249,126,123
1,Araba/Álava,41,Navaridas,213,116,97
1,Araba/Álava,42,Okondo,1155,608,547
1,Araba/Álava,43,Oyón-Oion,3284,1684,1600
1,Araba/Álava,44,Peñacerrada-Urizaharra,287,169,118
1,Araba/Álava,46,Erriberagoitia/Ribera Alta,781,440,341
1,Araba/Álava,47,Ribera Baja/Erribera Beitia,1314,720,594
1,Araba/Álava,49,Añana,168,86,82
1,Araba/Álava,51,Salvatierra/Agurain,4884,2478,2406
1,Araba/Álava,52,Samaniego,336,187,149
1,Araba/Álava,53,San Millán/Donemiliaga,725,401,324
1,Araba/Álava,54,Urkabustaiz,1325,711,614
1,Araba/Álava,55,Valdegovía/Gaubea,1098,604,494
1,Araba/Álava,56,Harana/Valle de Arana,287,170,117
1,Araba/Álava,57,Villabuena de Álava/Eskuernaga,325,165,160
1,Araba/Álava,58,Legutio,1698,891,807
1,Araba/Álava,59,Vitoria-Gasteiz,239562,118085,121477
1,Araba/Álava,60,Yécora/Iekora,287,154,133
1,Araba/Álava,61,Zalduondo,197,109,88
1,Araba/Álava,62,Zambrana,403,216,187
1,Araba/Álava,63,Zuia,2424,1249,1175
1,Araba/Álava,901,Iruña Oka/Iruña de Oca,2966,1529,1437
1,Araba/Álava,902,Lantarón,929,516,413
2,Albacete,1,Abengibre,902,457,445
2,Albacete,2,Alatoz,604,340,264
2,Albacete,3,Albacete,171390,84288,87102
2,Albacete,4,Albatana,794,403,391
2,Albacete,5,Alborea,848,439,409
2,Albacete,6,Alcadozo,734,382,352
2,Albacete,7,Alcalá del Júcar,1350,709,641
2,Albacete,8,Alcaraz,1608,800,808
2,Albacete,9,Almansa,25432,12631,12801
2,Albacete,10,Alpera,2438,1261,1177
2,Albacete,11,Ayna,806,432,374
2,Albacete,12,Balazote,2461,1272,1189
2,Albacete,13,Balsa de Ves,213,114,99
2,Albacete,14,"Ballestero, El",473,241,232
2,Albacete,15,Barrax,2063,1064,999
2,Albacete,16,Bienservida,729,375,354
2,Albacete,17,Bogarra,1009,522,487
2,Albacete,18,Bonete,1220,616,604
2,Albacete,19,"Bonillo, El",3033,1537,1496
2,Albacete,20,Carcelén,668,351,317
2,Albacete,21,Casas de Juan Núñez,1461,747,714
2,Albacete,22,Casas de Lázaro,475,259,216
2,Albacete,23,Casas de Ves,748,395,353
2,Albacete,24,Casas-Ibáñez,4818,2486,2332
2,Albacete,25,Caudete,10477,5300,5177
2,Albacete,26,Cenizate,1307,695,612
2,Albacete,27,Corral-Rubio,406,206,200
2,Albacete,28,Cotillas,161,87,74
2,Albacete,29,Chinchilla de Monte-Aragón,4015,2095,1920
2,Albacete,30,Elche de la Sierra,3951,1984,1967
2,Albacete,31,Férez,756,375,381
2,Albacete,32,Fuensanta,369,202,167
2,Albacete,33,Fuente-Álamo,2643,1397,1246
2,Albacete,34,Fuentealbilla,2029,1036,993
2,Albacete,35,"Gineta, La",2563,1316,1247
2,Albacete,36,Golosalvo,121,60,61
2,Albacete,37,Hellín,31199,15608,15591
2,Albacete,38,"Herrera, La",356,181,175
2,Albacete,39,Higueruela,1306,669,637
2,Albacete,40,Hoya-Gonzalo,752,388,364
2,Albacete,41,Jorquera,440,231,209
2,Albacete,42,Letur,1081,538,543
2,Albacete,43,Lezuza,1612,815,797
2,Albacete,44,Liétor,1421,728,693
2,Albacete,45,Madrigueras,4834,2467,2367
2,Albacete,46,Mahora,1435,718,717
2,Albacete,47,Masegoso,117,62,55
2,Albacete,48,Minaya,1682,856,826
2,Albacete,49,Molinicos,1050,532,518
2,Albacete,50,Montalvos,125,70,55
2,Albacete,51,Montealegre del Castillo,2284,1171,1113
2,Albacete,52,Motilleja,600,304,296
2,Albacete,53,Munera,3812,1924,1888
2,Albacete,54,Navas de Jorquera,551,286,265
2,Albacete,55,Nerpio,1512,818,694
2,Albacete,56,Ontur,2281,1139,1142
2,Albacete,57,Ossa de Montiel,2641,1321,1320
2,Albacete,58,Paterna del Madera,452,237,215
2,Albacete,59,Peñascosa,399,205,194
2,Albacete,60,Peñas de San Pedro,1356,772,584
2,Albacete,61,Pétrola,843,452,391
2,Albacete,62,Povedilla,543,285,258
2,Albacete,63,Pozohondo,1794,946,848
2,Albacete,64,Pozo-Lorente,467,238,229
2,Albacete,65,Pozuelo,598,314,284
2,Albacete,66,"Recueja, La",301,152,149
2,Albacete,67,Riópar,1481,758,723
2,Albacete,68,Robledo,463,238,225
2,Albacete,69,"Roda, La",16414,8332,8082
2,Albacete,70,Salobre,604,319,285
2,Albacete,71,San Pedro,1304,672,632
2,Albacete,72,Socovos,1983,1000,983
2,Albacete,73,Tarazona de la Mancha,6647,3346,3301
2,Albacete,74,Tobarra,8205,4178,4027
2,Albacete,75,Valdeganga,1943,975,968
2,Albacete,76,Vianos,414,208,206
2,Albacete,77,Villa de Ves,56,28,28
2,Albacete,78,Villalgordo del Júcar,1277,657,620
2,Albacete,79,Villamalea,4051,2055,1996
2,Albacete,80,Villapalacios,703,365,338
2,Albacete,81,Villarrobledo,26485,13190,13295
2,Albacete,82,Villatoya,136,74,62
2,Albacete,83,Villavaliente,274,152,122
2,Albacete,84,Villaverde de Guadalimar,417,222,195
2,Albacete,85,Viveros,379,194,185
2,Albacete,86,Yeste,3268,1674,1594
2,Albacete,901,Pozo Cañada,2895,1462,1433
3,Alicante/Alacant,1,Adsubia,730,377,353
3,Alicante/Alacant,2,Agost,4831,2451,2380
3,Alicante/Alacant,3,Agres,610,315,295
3,Alicante/Alacant,4,Aigües,1118,582,536
3,Alicante/Alacant,5,Albatera,11901,6110,5791
3,Alicante/Alacant,6,Alcalalí,1433,724,709
3,Alicante/Alacant,7,Alcocer de Planes,231,116,115
3,Alicante/Alacant,8,Alcoleja,193,100,93
3,Alicante/Alacant,9,Alcoy/Alcoi,61093,29762,31331
3,Alicante/Alacant,10,Alfafara,424,205,219
3,Alicante/Alacant,11,"Alfàs del Pi, l'",21670,10864,10806
3,Alicante/Alacant,12,Algorfa,4625,2302,2323
3,Alicante/Alacant,13,Algueña,1503,763,740
3,Alicante/Alacant,14,Alicante/Alacant,334329,162212,172117
3,Alicante/Alacant,15,Almoradí,19371,9850,9521
3,Alicante/Alacant,16,Almudaina,131,71,60
3,Alicante/Alacant,17,"Alqueria d'Asnar, l'",508,234,274
3,Alicante/Alacant,18,Altea,24056,11934,12122
3,Alicante/Alacant,19,Aspe,20292,10247,10045
3,Alicante/Alacant,20,Balones,162,82,80
3,Alicante/Alacant,21,Banyeres de Mariola,7200,3598,3602
3,Alicante/Alacant,22,Benasau,178,84,94
3,Alicante/Alacant,23,Beneixama,1817,917,900
3,Alicante/Alacant,24,Benejúzar,5459,2701,2758
3,Alicante/Alacant,25,Benferri,1925,1016,909
3,Alicante/Alacant,26,Beniarbeig,1883,939,944
3,Alicante/Alacant,27,Beniardá,222,121,101
3,Alicante/Alacant,28,Beniarrés,1295,644,651
3,Alicante/Alacant,29,Benigembla,606,309,297
3,Alicante/Alacant,30,Benidoleig,1305,642,663
3,Alicante/Alacant,31,Benidorm,72062,36282,35780
3,Alicante/Alacant,32,Benifallim,115,57,58
3,Alicante/Alacant,33,Benifato,201,103,98
3,Alicante/Alacant,34,Benijófar,4153,2065,2088
3,Alicante/Alacant,35,Benilloba,811,405,406
3,Alicante/Alacant,36,Benillup,97,41,56
3,Alicante/Alacant,37,Benimantell,512,243,269
3,Alicante/Alacant,38,Benimarfull,408,203,205
3,Alicante/Alacant,39,Benimassot,129,71,58
3,Alicante/Alacant,40,Benimeli,420,205,215
3,Alicante/Alacant,41,Benissa,13536,6781,6755
3,Alicante/Alacant,42,"Benitachell/Poble Nou de Benitatxell, el",5568,2792,2776
3,Alicante/Alacant,43,Biar,3738,1825,1913
3,Alicante/Alacant,44,Bigastro,6788,3473,3315
3,Alicante/Alacant,45,Bolulla,454,234,220
3,Alicante/Alacant,46,Busot,3314,1658,1656
3,Alicante/Alacant,47,Calp,29718,15112,14606
3,Alicante/Alacant,48,Callosa d'En Sarrià,7894,4048,3846
3,Alicante/Alacant,49,Callosa de Segura,17979,9105,8874
3,Alicante/Alacant,50,"Campello, el",27345,13567,13778
3,Alicante/Alacant,51,"Campo de Mirra/Camp de Mirra, el",438,221,217
3,Alicante/Alacant,52,Cañada,1235,604,631
3,Alicante/Alacant,53,Castalla,10541,5335,5206
3,Alicante/Alacant,54,Castell de Castells,516,259,257
3,Alicante/Alacant,55,Catral,9092,4647,4445
3,Alicante/Alacant,56,Cocentaina,11601,5844,5757
3,Alicante/Alacant,57,Confrides,315,178,137
3,Alicante/Alacant,58,Cox,7029,3595,3434
3,Alicante/Alacant,59,Crevillent,28362,14502,13860
3,Alicante/Alacant,60,Quatretondeta,114,55,59
3,Alicante/Alacant,61,Daya Nueva,1988,1003,985
3,Alicante/Alacant,62,Daya Vieja,726,370,356
3,Alicante/Alacant,63,Dénia,44726,22048,22678
3,Alicante/Alacant,64,Dolores,7398,3687,3711
3,Alicante/Alacant,65,Elche/Elx,230354,114904,115450
3,Alicante/Alacant,66,Elda,54610,26783,27827
3,Alicante/Alacant,67,Facheca,108,53,55
3,Alicante/Alacant,68,Famorca,62,31,31
3,Alicante/Alacant,69,Finestrat,6807,3489,3318
3,Alicante/Alacant,70,Formentera del Segura,4389,2246,2143
3,Alicante/Alacant,71,Gata de Gorgos,6283,3206,3077
3,Alicante/Alacant,72,Gaianes,442,231,211
3,Alicante/Alacant,73,Gorga,254,135,119
3,Alicante/Alacant,74,Granja de Rocamora,2463,1297,1166
3,Alicante/Alacant,75,"Castell de Guadalest, el",240,123,117
3,Alicante/Alacant,76,Guardamar del Segura,16863,8472,8391
3,Alicante/Alacant,77,"Fondó de les Neus, el/Hondón de las Nieves",3010,1528,1482
3,Alicante/Alacant,78,Hondón de los Frailes,1217,641,576
3,Alicante/Alacant,79,Ibi,23683,11870,11813
3,Alicante/Alacant,80,Jacarilla,2102,1048,1054
3,Alicante/Alacant,81,Xaló,3320,1677,1643
3,Alicante/Alacant,82,Jávea/Xàbia,32469,16277,16192
3,Alicante/Alacant,83,Jijona/Xixona,7429,3596,3833
3,Alicante/Alacant,84,"Lorcha/Orxa, l'",754,381,373
3,Alicante/Alacant,85,Llíber,1070,527,543
3,Alicante/Alacant,86,Millena,215,107,108
3,Alicante/Alacant,88,Monforte del Cid,7771,4111,3660
3,Alicante/Alacant,89,Monóvar/Monòver,12873,6398,6475
3,Alicante/Alacant,90,Mutxamel,23522,11827,11695
3,Alicante/Alacant,91,Murla,609,292,317
3,Alicante/Alacant,92,Muro de Alcoy,9005,4477,4528
3,Alicante/Alacant,93,Novelda,26873,13377,13496
3,Alicante/Alacant,94,"Nucia, la",18593,9459,9134
3,Alicante/Alacant,95,Ondara,6644,3335,3309
3,Alicante/Alacant,96,Onil,7753,3914,3839
3,Alicante/Alacant,97,Orba,2606,1292,1314
3,Alicante/Alacant,98,Orxeta,898,461,437
3,Alicante/Alacant,99,Orihuela,88714,44716,43998
3,Alicante/Alacant,100,Parcent,1123,547,576
3,Alicante/Alacant,101,Pedreguer,7659,3781,3878
3,Alicante/Alacant,102,Pego,11116,5694,5422
3,Alicante/Alacant,103,Penàguila,332,177,155
3,Alicante/Alacant,104,Petrer,34726,17324,17402
3,Alicante/Alacant,105,"Pinós, el/Pinoso",7904,4014,3890
3,Alicante/Alacant,106,Planes,836,430,406
3,Alicante/Alacant,107,Polop,4474,2287,2187
3,Alicante/Alacant,109,Rafal,4162,2111,2051
3,Alicante/Alacant,110,"Ràfol d'Almúnia, el",746,365,381
3,Alicante/Alacant,111,Redován,7522,3889,3633
3,Alicante/Alacant,112,Relleu,1338,674,664
3,Alicante/Alacant,113,Rojales,21583,11026,10557
3,Alicante/Alacant,114,"Romana, la",2554,1334,1220
3,Alicante/Alacant,115,Sagra,454,233,221
3,Alicante/Alacant,116,Salinas,1559,799,760
3,Alicante/Alacant,117,Sanet y Negrals,717,354,363
3,Alicante/Alacant,118,San Fulgencio,12354,6249,6105
3,Alicante/Alacant,119,Sant Joan d'Alacant,22554,10973,11581
3,Alicante/Alacant,120,San Miguel de Salinas,7862,3967,3895
3,Alicante/Alacant,121,Santa Pola,33372,16924,16448
3,Alicante/Alacant,122,San Vicente del Raspeig/Sant Vicent del Raspeig,54531,27141,27390
3,Alicante/Alacant,123,Sax,10041,5060,4981
3,Alicante/Alacant,124,Sella,636,340,296
3,Alicante/Alacant,125,Senija,661,343,318
3,Alicante/Alacant,127,Tàrbena,809,417,392
3,Alicante/Alacant,128,Teulada,14722,7418,7304
3,Alicante/Alacant,129,Tibi,1763,919,844
3,Alicante/Alacant,130,Tollos,49,24,25
3,Alicante/Alacant,131,Tormos,383,196,187
3,Alicante/Alacant,132,"Torremanzanas/Torre de les Maçanes, la",802,419,383
3,Alicante/Alacant,133,Torrevieja,102136,51446,50690
3,Alicante/Alacant,134,"Vall d'Alcalà, la",187,96,91
3,Alicante/Alacant,135,"Vall d'Ebo, la",284,141,143
3,Alicante/Alacant,136,Vall de Gallinera,694,360,334
3,Alicante/Alacant,137,"Vall de Laguar, la",961,458,503
3,Alicante/Alacant,138,"Verger, el",4899,2510,2389
3,Alicante/Alacant,139,"Villajoyosa/Vila Joiosa, la",32733,16364,16369
3,Alicante/Alacant,140,Villena,34966,17458,17508
3,Alicante/Alacant,901,"Poblets, els",3394,1647,1747
3,Alicante/Alacant,902,Pilar de la Horadada,22967,11866,11101
3,Alicante/Alacant,903,"Montesinos, Los",5199,2615,2584
3,Alicante/Alacant,904,San Isidro,1934,999,935
4,Almería,1,Abla,1480,769,711
4,Almería,2,Abrucena,1391,711,680
4,Almería,3,Adra,24512,12464,12048
4,Almería,4,Albánchez,823,422,401
4,Almería,5,Alboloduy,698,349,349
4,Almería,6,Albox,11091,5644,5447
4,Almería,7,Alcolea,916,492,424
4,Almería,8,Alcóntar,605,323,282
4,Almería,9,Alcudia de Monteagud,161,80,81
4,Almería,10,Alhabia,706,361,345
4,Almería,11,Alhama de Almería,3835,1943,1892
4,Almería,12,Alicún,278,144,134
4,Almería,13,Almería,190349,92741,97608
4,Almería,14,Almócita,191,95,96
4,Almería,15,Alsodux,153,83,70
4,Almería,16,Antas,3375,1696,1679
4,Almería,17,Arboleas,4863,2443,2420
4,Almería,18,Armuña de Almanzora,342,170,172
4,Almería,19,Bacares,305,156,149
4,Almería,20,Bayárcal,403,217,186
4,Almería,21,Bayarque,229,114,115
4,Almería,22,Bédar,1061,538,523
4,Almería,23,Beires,118,56,62
4,Almería,24,Benahadux,4166,2095,2071
4,Almería,26,Benitagla,84,48,36
4,Almería,27,Benizalón,299,158,141
4,Almería,28,Bentarique,277,151,126
4,Almería,29,Berja,15388,7802,7586
4,Almería,30,Canjáyar,1451,745,706
4,Almería,31,Cantoria,4039,2065,1974
4,Almería,32,Carboneras,8189,4250,3939
4,Almería,33,Castro de Filabres,162,84,78
4,Almería,34,Cóbdar,170,90,80
4,Almería,35,Cuevas del Almanzora,13148,6858,6290
4,Almería,36,Chercos,303,153,150
4,Almería,37,Chirivel,1846,943,903
4,Almería,38,Dalías,3991,1977,2014
4,Almería,41,Enix,453,257,196
4,Almería,43,Felix,661,359,302
4,Almería,44,Fines,2371,1263,1108
4,Almería,45,Fiñana,2387,1211,1176
4,Almería,46,Fondón,976,504,472
4,Almería,47,Gádor,3275,1707,1568
4,Almería,48,"Gallardos, Los",3818,1962,1856
4,Almería,49,Garrucha,8626,4483,4143
4,Almería,50,Gérgal,1116,595,521
4,Almería,51,Huécija,530,260,270
4,Almería,52,Huércal de Almería,16074,8260,7814
4,Almería,53,Huércal-Overa,18580,9271,9309
4,Almería,54,Illar,452,242,210
4,Almería,55,Instinción,484,230,254
4,Almería,56,Laroya,184,99,85
4,Almería,57,Láujar de Andarax,1819,902,917
4,Almería,58,Líjar,478,244,234
4,Almería,59,Lubrín,1738,858,880
4,Almería,60,Lucainena de las Torres,665,359,306
4,Almería,61,Lúcar,919,463,456
4,Almería,62,Macael,6018,3105,2913
4,Almería,63,María,1432,730,702
4,Almería,64,Mojácar,8090,4081,4009
4,Almería,65,Nacimiento,511,273,238
4,Almería,66,Níjar,29284,16379,12905
4,Almería,67,Ohanes,745,368,377
4,Almería,68,Olula de Castro,200,103,97
4,Almería,69,Olula del Río,6580,3412,3168
4,Almería,70,Oria,2892,1505,1387
4,Almería,71,Padules,510,263,247
4,Almería,72,Partaloa,919,458,461
4,Almería,73,Paterna del Río,440,246,194
4,Almería,74,Pechina,3748,1909,1839
4,Almería,75,Pulpí,8726,4571,4155
4,Almería,76,Purchena,1771,913,858
4,Almería,77,Rágol,379,200,179
4,Almería,78,Rioja,1352,682,670
4,Almería,79,Roquetas de Mar,89851,47636,42215
4,Almería,80,Santa Cruz de Marchena,240,121,119
4,Almería,81,Santa Fe de Mondújar,476,242,234
4,Almería,82,Senés,331,170,161
4,Almería,83,Serón,2381,1186,1195
4,Almería,84,Sierro,453,231,222
4,Almería,85,Somontín,542,273,269
4,Almería,86,Sorbas,2787,1486,1301
4,Almería,87,Suflí,267,141,126
4,Almería,88,Tabernas,3648,1888,1760
4,Almería,89,Taberno,1205,597,608
4,Almería,90,Tahal,553,283,270
4,Almería,91,Terque,455,225,230
4,Almería,92,Tíjola,3875,1942,1933
4,Almería,93,Turre,3901,2015,1886
4,Almería,94,Turrillas,233,130,103
4,Almería,95,Uleila del Campo,989,514,475
4,Almería,96,Urrácal,361,177,184
4,Almería,97,Velefique,303,164,139
4,Almería,98,Vélez-Blanco,2276,1205,1071
4,Almería,99,Vélez-Rubio,7134,3475,3659
4,Almería,100,Vera,14689,7540,7149
4,Almería,101,Viator,5313,2685,2628
4,Almería,102,Vícar,23656,12578,11078
4,Almería,103,Zurgena,3133,1557,1576
4,Almería,901,"Tres Villas, Las",706,367,339
4,Almería,902,"Ejido, El",83774,45411,38363
4,Almería,903,"Mojonera, La",8686,4793,3893
5,Ávila,1,Adanero,292,149,143
5,Ávila,2,"Adrada, La",2680,1402,1278
5,Ávila,5,Albornos,228,122,106
5,Ávila,7,Aldeanueva de Santa Cruz,145,82,63
5,Ávila,8,Aldeaseca,270,124,146
5,Ávila,10,"Aldehuela, La",200,104,96
5,Ávila,12,Amavida,174,86,88
5,Ávila,13,"Arenal, El",1060,538,522
5,Ávila,14,Arenas de San Pedro,6933,3407,3526
5,Ávila,15,Arevalillo,114,56,58
5,Ávila,16,Arévalo,8099,3942,4157
5,Ávila,17,Aveinte,97,52,45
5,Ávila,18,Avellaneda,30,15,15
5,Ávila,19,Ávila,59008,28411,30597
5,Ávila,21,"Barco de Ávila, El",2729,1335,1394
5,Ávila,22,"Barraco, El",2077,1063,1014
5,Ávila,23,Barromán,207,109,98
5,Ávila,24,Becedas,270,141,129
5,Ávila,25,Becedillas,115,63,52
5,Ávila,26,Bercial de Zapardiel,251,122,129
5,Ávila,27,"Berlanas, Las",369,186,183
5,Ávila,29,Bernuy-Zapardiel,143,83,60
5,Ávila,30,Berrocalejo de Aragona,49,27,22
5,Ávila,33,Blascomillán,212,105,107
5,Ávila,34,Blasconuño de Matacabras,19,11,8
5,Ávila,35,Blascosancho,105,51,54
5,Ávila,36,"Bohodón, El",149,79,70
5,Ávila,37,Bohoyo,337,177,160
5,Ávila,38,Bonilla de la Sierra,134,78,56
5,Ávila,39,Brabos,58,32,26
5,Ávila,40,Bularros,84,52,32
5,Ávila,41,Burgohondo,1278,666,612
5,Ávila,42,Cabezas de Alambre,180,92,88
5,Ávila,43,Cabezas del Pozo,94,50,44
5,Ávila,44,Cabezas del Villar,329,181,148
5,Ávila,45,Cabizuela,116,57,59
5,Ávila,46,Canales,50,27,23
5,Ávila,47,Candeleda,5213,2683,2530
5,Ávila,48,Cantiveros,139,72,67
5,Ávila,49,Cardeñosa,513,265,248
5,Ávila,51,"Carrera, La",216,113,103
5,Ávila,52,Casas del Puerto,112,58,54
5,Ávila,53,Casasola,98,50,48
5,Ávila,54,Casavieja,1574,797,777
5,Ávila,55,Casillas,841,453,388
5,Ávila,56,Castellanos de Zapardiel,102,55,47
5,Ávila,57,Cebreros,3529,1810,1719
5,Ávila,58,Cepeda la Mora,93,46,47
5,Ávila,59,Cillán,119,70,49
5,Ávila,60,Cisla,143,71,72
5,Ávila,61,"Colilla, La",345,173,172
5,Ávila,62,Collado de Contreras,234,127,107
5,Ávila,63,Collado del Mirón,45,25,20
5,Ávila,64,Constanzana,124,72,52
5,Ávila,65,Crespos,547,295,252
5,Ávila,66,Cuevas del Valle,538,294,244
5,Ávila,67,Chamartín,92,53,39
5,Ávila,69,Donjimeno,107,66,41
5,Ávila,70,Donvidas,45,24,21
5,Ávila,72,Espinosa de los Caballeros,111,66,45
5,Ávila,73,Flores de Ávila,347,184,163
5,Ávila,74,Fontiveros,842,443,399
5,Ávila,75,Fresnedilla,108,49,59
5,Ávila,76,"Fresno, El",568,295,273
5,Ávila,77,Fuente el Saúz,240,125,115
5,Ávila,78,Fuentes de Año,143,80,63
5,Ávila,79,Gallegos de Altamiros,52,33,19
5,Ávila,80,Gallegos de Sobrinos,70,33,37
5,Ávila,81,Garganta del Villar,49,31,18
5,Ávila,82,Gavilanes,649,341,308
5,Ávila,83,Gemuño,162,78,84
5,Ávila,84,Gilbuena,85,51,34
5,Ávila,85,Gil García,39,20,19
5,Ávila,86,Gimialcón,94,55,39
5,Ávila,87,Gotarrendura,173,63,110
5,Ávila,88,Grandes y San Martín,32,19,13
5,Ávila,89,Guisando,571,284,287
5,Ávila,90,Gutierre-Muñoz,83,41,42
5,Ávila,92,Hernansancho,200,108,92
5,Ávila,93,Herradón de Pinares,525,288,237
5,Ávila,94,Herreros de Suso,165,85,80
5,Ávila,95,Higuera de las Dueñas,343,191,152
5,Ávila,96,"Hija de Dios, La",77,41,36
5,Ávila,97,"Horcajada, La",564,289,275
5,Ávila,99,Horcajo de las Torres,613,349,264
5,Ávila,100,"Hornillo, El",351,184,167
5,Ávila,101,Hoyocasero,344,190,154
5,Ávila,102,"Hoyo de Pinares, El",2422,1278,1144
5,Ávila,103,Hoyorredondo,87,50,37
5,Ávila,104,Hoyos del Collado,37,22,15
5,Ávila,105,Hoyos del Espino,444,248,196
5,Ávila,106,Hoyos de Miguel Muñoz,43,20,23
5,Ávila,107,Hurtumpascual,76,47,29
5,Ávila,108,Junciana,65,34,31
5,Ávila,109,Langa,527,266,261
5,Ávila,110,Lanzahíta,959,512,447
5,Ávila,112,"Losar del Barco, El",128,62,66
5,Ávila,113,"Llanos de Tormes, Los",83,40,43
5,Ávila,114,Madrigal de las Altas Torres,1659,842,817
5,Ávila,115,Maello,714,373,341
5,Ávila,116,Malpartida de Corneja,138,70,68
5,Ávila,117,Mamblas,228,122,106
5,Ávila,118,Mancera de Arriba,102,56,46
5,Ávila,119,Manjabálago,43,24,19
5,Ávila,120,Marlín,38,22,16
5,Ávila,121,Martiherrero,296,153,143
5,Ávila,122,Martínez,156,84,72
5,Ávila,123,Mediana de Voltoya,103,49,54
5,Ávila,124,Medinilla,138,66,72
5,Ávila,125,Mengamuñoz,67,31,36
5,Ávila,126,Mesegar de Corneja,80,43,37
5,Ávila,127,Mijares,861,457,404
5,Ávila,128,Mingorría,420,215,205
5,Ávila,129,"Mirón, El",162,96,66
5,Ávila,130,Mironcillo,109,60,49
5,Ávila,131,Mirueña de los Infanzones,126,65,61
5,Ávila,132,Mombeltrán,1228,638,590
5,Ávila,133,Monsalupe,53,26,27
5,Ávila,134,Moraleja de Matacabras,51,27,24
5,Ávila,135,Muñana,497,257,240
5,Ávila,136,Muñico,121,60,61
5,Ávila,138,Muñogalindo,387,211,176
5,Ávila,139,Muñogrande,78,42,36
5,Ávila,140,Muñomer del Peco,143,74,69
5,Ávila,141,Muñopepe,102,61,41
5,Ávila,142,Muñosancho,124,64,60
5,Ávila,143,Muñotello,79,42,37
5,Ávila,144,Narrillos del Álamo,96,51,45
5,Ávila,145,Narrillos del Rebollar,62,32,30
5,Ávila,147,Narros del Castillo,182,98,84
5,Ávila,148,Narros del Puerto,44,22,22
5,Ávila,149,Narros de Saldueña,137,76,61
5,Ávila,151,Navacepedilla de Corneja,115,62,53
5,Ávila,152,Nava de Arévalo,868,461,407
5,Ávila,153,Nava del Barco,117,61,56
5,Ávila,154,Navadijos,56,36,20
5,Ávila,155,Navaescurial,64,38,26
5,Ávila,156,Navahondilla,351,201,150
5,Ávila,157,Navalacruz,288,145,143
5,Ávila,158,Navalmoral,428,226,202
5,Ávila,159,Navalonguilla,300,158,142
5,Ávila,160,Navalosa,369,198,171
5,Ávila,161,Navalperal de Pinares,1066,557,509
5,Ávila,162,Navalperal de Tormes,114,64,50
5,Ávila,163,Navaluenga,2190,1096,1094
5,Ávila,164,Navaquesera,35,15,20
5,Ávila,165,Navarredonda de Gredos,472,241,231
5,Ávila,166,Navarredondilla,270,138,132
5,Ávila,167,Navarrevisca,329,179,150
5,Ávila,168,"Navas del Marqués, Las",5844,2984,2860
5,Ávila,169,Navatalgordo,256,131,125
5,Ávila,170,Navatejares,70,33,37
5,Ávila,171,Neila de San Miguel,87,45,42
5,Ávila,172,Niharra,161,85,76
5,Ávila,173,Ojos-Albos,63,37,26
5,Ávila,174,Orbita,97,51,46
5,Ávila,175,"Oso, El",212,125,87
5,Ávila,176,Padiernos,261,138,123
5,Ávila,177,Pajares de Adaja,207,106,101
5,Ávila,178,Palacios de Goda,456,237,219
5,Ávila,179,Papatrigo,272,141,131
5,Ávila,180,"Parral, El",112,63,49
5,Ávila,181,Pascualcobo,39,22,17
5,Ávila,182,Pedro Bernardo,1006,534,472
5,Ávila,183,Pedro-Rodríguez,198,96,102
5,Ávila,184,Peguerinos,306,172,134
5,Ávila,185,Peñalba de Ávila,123,71,52
5,Ávila,186,Piedrahíta,2014,966,1048
5,Ávila,187,Piedralaves,2298,1180,1118
5,Ávila,188,Poveda,61,38,23
5,Ávila,189,Poyales del Hoyo,598,321,277
5,Ávila,190,Pozanco,62,37,25
5,Ávila,191,Pradosegar,153,82,71
5,Ávila,192,Puerto Castilla,107,63,44
5,Ávila,193,Rasueros,238,137,101
5,Ávila,194,Riocabado,176,95,81
5,Ávila,195,Riofrío,255,151,104
5,Ávila,196,Rivilla de Barajas,76,32,44
5,Ávila,197,Salobral,127,62,65
5,Ávila,198,Salvadiós,86,45,41
5,Ávila,199,San Bartolomé de Béjar,49,25,24
5,Ávila,200,San Bartolomé de Corneja,64,31,33
5,Ávila,201,San Bartolomé de Pinares,627,328,299
5,Ávila,204,Sanchidrián,845,435,410
5,Ávila,205,Sanchorreja,95,44,51
5,Ávila,206,San Esteban de los Patos,35,18,17
5,Ávila,207,San Esteban del Valle,850,446,404
5,Ávila,208,San Esteban de Zapardiel,58,33,25
5,Ávila,209,San García de Ingelmos,106,62,44
5,Ávila,210,San Juan de la Encinilla,103,53,50
5,Ávila,211,San Juan de la Nava,516,269,247
5,Ávila,212,San Juan del Molinillo,291,162,129
5,Ávila,213,San Juan del Olmo,120,74,46
5,Ávila,214,San Lorenzo de Tormes,58,29,29
5,Ávila,215,San Martín de la Vega del Alberche,198,118,80
5,Ávila,216,San Martín del Pimpollar,228,131,97
5,Ávila,217,San Miguel de Corneja,79,40,39
5,Ávila,218,San Miguel de Serrezuela,164,94,70
5,Ávila,219,San Pascual,48,31,17
5,Ávila,220,San Pedro del Arroyo,487,255,232
5,Ávila,221,Santa Cruz del Valle,444,231,213
5,Ávila,222,Santa Cruz de Pinares,167,91,76
5,Ávila,224,Santa María del Arroyo,103,56,47
5,Ávila,225,Santa María del Berrocal,466,237,229
5,Ávila,226,Santa María de los Caballeros,95,52,43
5,Ávila,227,Santa María del Tiétar,593,313,280
5,Ávila,228,Santiago del Collado,203,125,78
5,Ávila,229,Santo Domingo de las Posadas,105,53,52
5,Ávila,230,Santo Tomé de Zabarcos,96,53,43
5,Ávila,231,San Vicente de Arévalo,199,108,91
5,Ávila,232,"Serrada, La",115,60,55
5,Ávila,233,Serranillos,282,159,123
5,Ávila,234,Sigeres,59,29,30
5,Ávila,235,Sinlabajos,149,75,74
5,Ávila,236,Solana de Ávila,149,78,71
5,Ávila,237,Solana de Rioalmar,217,114,103
5,Ávila,238,Solosancho,967,509,458
5,Ávila,239,Sotalbo,255,139,116
5,Ávila,240,Sotillo de la Adrada,4821,2425,2396
5,Ávila,241,"Tiemblo, El",4442,2278,2164
5,Ávila,242,Tiñosillos,840,428,412
5,Ávila,243,Tolbaños,111,54,57
5,Ávila,244,Tormellas,69,36,33
5,Ávila,245,Tornadizos de Ávila,424,206,218
5,Ávila,246,Tórtoles,75,38,37
5,Ávila,247,"Torre, La",264,143,121
5,Ávila,249,Umbrías,127,64,63
5,Ávila,251,Vadillo de la Sierra,89,50,39
5,Ávila,252,Valdecasa,75,44,31
5,Ávila,253,Vega de Santa María,102,52,50
5,Ávila,254,Velayos,266,134,132
5,Ávila,256,Villaflor,136,68,68
5,Ávila,257,Villafranca de la Sierra,158,87,71
5,Ávila,258,Villanueva de Gómez,144,75,69
5,Ávila,259,Villanueva del Aceral,158,75,83
5,Ávila,260,Villanueva del Campillo,120,66,54
5,Ávila,261,Villar de Corneja,48,26,22
5,Ávila,262,Villarejo del Valle,433,222,211
5,Ávila,263,Villatoro,195,107,88
5,Ávila,264,Viñegra de Moraña,59,34,25
5,Ávila,265,Vita,95,61,34
5,Ávila,266,Zapardiel de la Cañada,119,57,62
5,Ávila,267,Zapardiel de la Ribera,124,62,62
5,Ávila,901,San Juan de Gredos,338,195,143
5,Ávila,902,Santa María del Cubillo,359,205,154
5,Ávila,903,Diego del Carpio,178,98,80
5,Ávila,904,Santiago del Tormes,161,86,75
5,Ávila,905,Villanueva de Ávila,287,140,147
6,Badajoz,1,Acedera,823,423,400
6,Badajoz,2,Aceuchal,5717,2862,2855
6,Badajoz,3,Ahillones,1007,508,499
6,Badajoz,4,Alange,1994,1019,975
6,Badajoz,5,"Albuera, La",2051,1048,1003
6,Badajoz,6,Alburquerque,5619,2836,2783
6,Badajoz,7,Alconchel,1894,942,952
6,Badajoz,8,Alconera,736,368,368
6,Badajoz,9,Aljucén,255,139,116
6,Badajoz,10,Almendral,1308,631,677
6,Badajoz,11,Almendralejo,34319,17308,17011
6,Badajoz,12,Arroyo de San Serván,4253,2172,2081
6,Badajoz,13,Atalaya,321,166,155
6,Badajoz,14,Azuaga,8273,4113,4160
6,Badajoz,15,Badajoz,151565,73632,77933
6,Badajoz,16,Barcarrota,3708,1903,1805
6,Badajoz,17,Baterno,346,183,163
6,Badajoz,18,Benquerencia de la Serena,933,455,478
6,Badajoz,19,Berlanga,2474,1234,1240
6,Badajoz,20,Bienvenida,2319,1199,1120
6,Badajoz,21,Bodonal de la Sierra,1137,580,557
6,Badajoz,22,Burguillos del Cerro,3296,1637,1659
6,Badajoz,23,Cabeza del Buey,5365,2648,2717
6,Badajoz,24,Cabeza la Vaca,1440,736,704
6,Badajoz,25,Calamonte,6308,3149,3159
6,Badajoz,26,Calera de León,1053,515,538
6,Badajoz,27,Calzadilla de los Barros,936,476,460
6,Badajoz,28,Campanario,5293,2593,2700
6,Badajoz,29,Campillo de Llerena,1461,740,721
6,Badajoz,30,Capilla,192,99,93
6,Badajoz,31,Carmonita,578,292,286
6,Badajoz,32,"Carrascalejo, El",90,45,45
6,Badajoz,33,Casas de Don Pedro,1697,863,834
6,Badajoz,34,Casas de Reina,212,101,111
6,Badajoz,35,Castilblanco,1157,582,575
6,Badajoz,36,Castuera,6469,3198,3271
6,Badajoz,37,"Codosera, La",2320,1210,1110
6,Badajoz,38,Cordobilla de Lácara,987,496,491
6,Badajoz,39,"Coronada, La",2234,1102,1132
6,Badajoz,40,Corte de Peleas,1345,689,656
6,Badajoz,41,Cristina,565,300,265
6,Badajoz,42,Cheles,1241,597,644
6,Badajoz,43,Don Álvaro,761,395,366
6,Badajoz,44,Don Benito,36660,18138,18522
6,Badajoz,45,Entrín Bajo,610,307,303
6,Badajoz,46,Esparragalejo,1553,752,801
6,Badajoz,47,Esparragosa de la Serena,1065,546,519
6,Badajoz,48,Esparragosa de Lares,1017,494,523
6,Badajoz,49,Feria,1305,635,670
6,Badajoz,50,Fregenal de la Sierra,5178,2537,2641
6,Badajoz,51,Fuenlabrada de los Montes,1972,964,1008
6,Badajoz,52,Fuente de Cantos,4990,2458,2532
6,Badajoz,53,Fuente del Arco,758,381,377
6,Badajoz,54,Fuente del Maestre,6929,3459,3470
6,Badajoz,55,Fuentes de León,2513,1244,1269
6,Badajoz,56,Garbayuela,551,298,253
6,Badajoz,57,Garlitos,642,331,311
6,Badajoz,58,"Garrovilla, La",2497,1248,1249
6,Badajoz,59,Granja de Torrehermosa,2287,1141,1146
6,Badajoz,60,Guareña,7316,3705,3611
6,Badajoz,61,"Haba, La",1350,681,669
6,Badajoz,62,Helechosa de los Montes,738,413,325
6,Badajoz,63,Herrera del Duque,3702,1887,1815
6,Badajoz,64,Higuera de la Serena,1041,544,497
6,Badajoz,65,Higuera de Llerena,366,182,184
6,Badajoz,66,Higuera de Vargas,2108,1075,1033
6,Badajoz,67,Higuera la Real,2464,1256,1208
6,Badajoz,68,Hinojosa del Valle,544,271,273
6,Badajoz,69,Hornachos,3837,1932,1905
6,Badajoz,70,Jerez de los Caballeros,9918,4976,4942
6,Badajoz,71,"Lapa, La",298,151,147
6,Badajoz,72,Lobón,2837,1470,1367
6,Badajoz,73,Llera,925,476,449
6,Badajoz,74,Llerena,5984,2976,3008
6,Badajoz,75,Magacela,580,302,278
6,Badajoz,76,Maguilla,1043,514,529
6,Badajoz,77,Malcocinado,445,236,209
6,Badajoz,78,Malpartida de la Serena,643,323,320
6,Badajoz,79,Manchita,757,388,369
6,Badajoz,80,Medellín,2354,1181,1173
6,Badajoz,81,Medina de las Torres,1316,660,656
6,Badajoz,82,Mengabril,465,236,229
6,Badajoz,83,Mérida,57797,28186,29611
6,Badajoz,84,Mirandilla,1365,694,671
6,Badajoz,85,Monesterio,4347,2230,2117
6,Badajoz,86,Montemolín,1504,735,769
6,Badajoz,87,Monterrubio de la Serena,2702,1311,1391
6,Badajoz,88,Montijo,16267,8078,8189
6,Badajoz,89,"Morera, La",737,366,371
6,Badajoz,90,"Nava de Santiago, La",1066,533,533
6,Badajoz,91,Navalvillar de Pela,4833,2449,2384
6,Badajoz,92,Nogales,719,354,365
6,Badajoz,93,Oliva de la Frontera,5539,2788,2751
6,Badajoz,94,Oliva de Mérida,1848,948,900
6,Badajoz,95,Olivenza,12008,6003,6005
6,Badajoz,96,Orellana de la Sierra,285,155,130
6,Badajoz,97,Orellana la Vieja,2955,1529,1426
6,Badajoz,98,Palomas,697,352,345
6,Badajoz,99,"Parra, La",1403,718,685
6,Badajoz,100,Peñalsordo,1130,551,579
6,Badajoz,101,Peraleda del Zaucejo,614,319,295
6,Badajoz,102,Puebla de Alcocer,1257,628,629
6,Badajoz,103,Puebla de la Calzada,6019,2985,3034
6,Badajoz,104,Puebla de la Reina,843,424,419
6,Badajoz,105,Puebla del Maestre,780,395,385
6,Badajoz,106,Puebla del Prior,531,271,260
6,Badajoz,107,Puebla de Obando,1945,976,969
6,Badajoz,108,Puebla de Sancho Pérez,2878,1454,1424
6,Badajoz,109,Quintana de la Serena,5011,2528,2483
6,Badajoz,110,Reina,194,92,102
6,Badajoz,111,Rena,662,338,324
6,Badajoz,112,Retamal de Llerena,497,266,231
6,Badajoz,113,Ribera del Fresno,3482,1727,1755
6,Badajoz,114,Risco,162,81,81
6,Badajoz,115,"Roca de la Sierra, La",1519,742,777
6,Badajoz,116,Salvaleón,2022,1009,1013
6,Badajoz,117,Salvatierra de los Barros,1779,873,906
6,Badajoz,118,Sancti-Spíritus,243,131,112
6,Badajoz,119,San Pedro de Mérida,881,443,438
6,Badajoz,120,Santa Amalia,4346,2183,2163
6,Badajoz,121,Santa Marta,4351,2209,2142
6,Badajoz,122,"Santos de Maimona, Los",8244,4181,4063
6,Badajoz,123,San Vicente de Alcántara,5754,2904,2850
6,Badajoz,124,Segura de León,2089,1036,1053
6,Badajoz,125,Siruela,2170,1081,1089
6,Badajoz,126,Solana de los Barros,2797,1406,1391
6,Badajoz,127,Talarrubias,3624,1799,1825
6,Badajoz,128,Talavera la Real,5557,2805,2752
6,Badajoz,129,Táliga,777,391,386
6,Badajoz,130,Tamurejo,255,128,127
6,Badajoz,131,Torre de Miguel Sesmero,1261,642,619
6,Badajoz,132,Torremayor,1043,494,549
6,Badajoz,133,Torremejía,2233,1149,1084
6,Badajoz,134,Trasierra,694,374,320
6,Badajoz,135,Trujillanos,1455,768,687
6,Badajoz,136,Usagre,1940,976,964
6,Badajoz,137,Valdecaballeros,1212,607,605
6,Badajoz,138,Valdetorres,1279,636,643
6,Badajoz,139,Valencia de las Torres,690,368,322
6,Badajoz,140,Valencia del Mombuey,809,410,399
6,Badajoz,141,Valencia del Ventoso,2188,1104,1084
6,Badajoz,142,Valverde de Burguillos,319,165,154
6,Badajoz,143,Valverde de Leganés,4199,2116,2083
6,Badajoz,144,Valverde de Llerena,689,342,347
6,Badajoz,145,Valverde de Mérida,1152,592,560
6,Badajoz,146,Valle de la Serena,1406,703,703
6,Badajoz,147,Valle de Matamoros,435,215,220
6,Badajoz,148,Valle de Santa Ana,1171,585,586
6,Badajoz,149,Villafranca de los Barros,13269,6552,6717
6,Badajoz,150,Villagarcía de la Torre,1012,533,479
6,Badajoz,151,Villagonzalo,1336,652,684
6,Badajoz,152,Villalba de los Barros,1643,830,813
6,Badajoz,153,Villanueva de la Serena,26076,12784,13292
6,Badajoz,154,Villanueva del Fresno,3655,1795,1860
6,Badajoz,155,Villar del Rey,2374,1243,1131
6,Badajoz,156,Villar de Rena,1418,724,694
6,Badajoz,157,Villarta de los Montes,575,280,295
6,Badajoz,158,Zafra,16577,8004,8573
6,Badajoz,159,Zahínos,2879,1431,1448
6,Badajoz,160,Zalamea de la Serena,3908,1938,1970
6,Badajoz,161,Zarza-Capilla,382,187,195
6,Badajoz,162,"Zarza, La",3637,1846,1791
6,Badajoz,901,Valdelacalzada,2852,1469,1383
6,Badajoz,902,Pueblonuevo del Guadiana,2058,1040,1018
7,"Balears, Illes",1,Alaró,5438,2672,2766
7,"Balears, Illes",2,Alaior,9600,4805,4795
7,"Balears, Illes",3,Alcúdia,19243,9770,9473
7,"Balears, Illes",4,Algaida,5273,2742,2531
7,"Balears, Illes",5,Andratx,11919,6029,5890
7,"Balears, Illes",6,Artà,7553,3785,3768
7,"Balears, Illes",7,Banyalbufar,592,335,257
7,"Balears, Illes",8,Binissalem,7601,3786,3815
7,"Balears, Illes",9,Búger,1047,534,513
7,"Balears, Illes",10,Bunyola,6232,3098,3134
7,"Balears, Illes",11,Calvià,52451,26375,26076
7,"Balears, Illes",12,Campanet,2612,1269,1343
7,"Balears, Illes",13,Campos,9862,4991,4871
7,"Balears, Illes",14,Capdepera,11858,6039,5819
7,"Balears, Illes",15,Ciutadella de Menorca,29315,14646,14669
7,"Balears, Illes",16,Consell,3789,1941,1848
7,"Balears, Illes",17,Costitx,1133,572,561
7,"Balears, Illes",18,Deyá,752,385,367
7,"Balears, Illes",19,Escorca,284,161,123
7,"Balears, Illes",20,Esporles,4956,2447,2509
7,"Balears, Illes",21,Estellencs,402,210,192
7,"Balears, Illes",22,Felanitx,18482,9452,9030
7,"Balears, Illes",23,Ferreries,4717,2405,2312
7,"Balears, Illes",24,Formentera,10365,5444,4921
7,"Balears, Illes",25,Fornalutx,698,354,344
7,"Balears, Illes",26,Eivissa,49388,25340,24048
7,"Balears, Illes",27,Inca,29966,15129,14837
7,"Balears, Illes",28,Lloret de Vistalegre,1290,660,630
7,"Balears, Illes",29,Lloseta,5703,2898,2805
7,"Balears, Illes",30,Llubí,2299,1146,1153
7,"Balears, Illes",31,Llucmajor,36959,18717,18242
7,"Balears, Illes",32,Maó,28942,14255,14687
7,"Balears, Illes",33,Manacor,40873,20598,20275
7,"Balears, Illes",34,Mancor de la Vall,1324,662,662
7,"Balears, Illes",35,Maria de la Salut,2204,1137,1067
7,"Balears, Illes",36,Marratxí,34385,17331,17054
7,"Balears, Illes",37,"Mercadal, Es",5408,2778,2630
7,"Balears, Illes",38,Montuïri,2872,1458,1414
7,"Balears, Illes",39,Muro,6970,3541,3429
7,"Balears, Illes",40,Palma,405318,198634,206684
7,"Balears, Illes",41,Petra,2919,1444,1475
7,"Balears, Illes",42,Pollença,16114,8079,8035
7,"Balears, Illes",43,Porreres,5544,2894,2650
7,"Balears, Illes",44,"Pobla, Sa",12881,6619,6262
7,"Balears, Illes",45,Puigpunyent,1970,979,991
7,"Balears, Illes",46,Sant Antoni de Portmany,22299,11643,10656
7,"Balears, Illes",47,Sencelles,3128,1595,1533
7,"Balears, Illes",48,Sant Josep de sa Talaia,23688,12414,11274
7,"Balears, Illes",49,Sant Joan,1985,982,1003
7,"Balears, Illes",50,Sant Joan de Labritja,5351,2783,2568
7,"Balears, Illes",51,Sant Llorenç des Cardassar,8963,4513,4450
7,"Balears, Illes",52,Sant Lluís,7377,3726,3651
7,"Balears, Illes",53,Santa Eugènia,1640,838,802
7,"Balears, Illes",54,Santa Eulalia del Río,33734,17222,16512
7,"Balears, Illes",55,Santa Margalida,11718,6019,5699
7,"Balears, Illes",56,Santa María del Camí,6270,3125,3145
7,"Balears, Illes",57,Santanyí,13095,6686,6409
7,"Balears, Illes",58,Selva,3697,1867,1830
7,"Balears, Illes",59,"Salines, Ses",5272,2683,2589
7,"Balears, Illes",60,Sineu,3687,1833,1854
7,"Balears, Illes",61,Sóller,14148,7147,7001
7,"Balears, Illes",62,Son Servera,12195,6151,6044
7,"Balears, Illes",63,Valldemossa,2007,1023,984
7,"Balears, Illes",64,"Castell, Es",7990,4072,3918
7,"Balears, Illes",65,Vilafranca de Bonany,2958,1480,1478
7,"Balears, Illes",901,Ariany,883,479,404
7,"Balears, Illes",902,"Migjorn Gran, Es",1526,750,776
8,Barcelona,1,Abrera,11611,5926,5685
8,Barcelona,2,Aguilar de Segarra,245,131,114
8,Barcelona,3,Alella,9570,4705,4865
8,Barcelona,4,Alpens,302,165,137
8,Barcelona,5,"Ametlla del Vallès, L'",8111,4081,4030
8,Barcelona,6,Arenys de Mar,14863,7307,7556
8,Barcelona,7,Arenys de Munt,8500,4260,4240
8,Barcelona,8,Argençola,238,138,100
8,Barcelona,9,Argentona,11776,5821,5955
8,Barcelona,10,Artés,5575,2809,2766
8,Barcelona,11,Avià,2245,1124,1121
8,Barcelona,12,Avinyó,2321,1167,1154
8,Barcelona,13,Avinyonet del Penedès,1710,912,798
8,Barcelona,14,Aiguafreda,2481,1200,1281
8,Barcelona,15,Badalona,219786,109725,110061
8,Barcelona,16,Bagà,2372,1200,1172
8,Barcelona,17,Balenyà,3695,1846,1849
8,Barcelona,18,Balsareny,3494,1756,1738
8,Barcelona,19,Barcelona,1615448,767915,847533
8,Barcelona,20,Begues,6426,3207,3219
8,Barcelona,21,Bellprat,91,52,39
8,Barcelona,22,Berga,17018,8418,8600
8,Barcelona,23,Bigues i Riells,8755,4485,4270
8,Barcelona,24,Borredà,595,315,280
8,Barcelona,25,"Bruc, El",1992,1064,928
8,Barcelona,26,"Brull, El",249,136,113
8,Barcelona,27,"Cabanyes, Les",927,468,459
8,Barcelona,28,Cabrera d'Anoia,1355,726,629
8,Barcelona,29,Cabrera de Mar,4528,2279,2249
8,Barcelona,30,Cabrils,7196,3525,3671
8,Barcelona,31,Calaf,3522,1857,1665
8,Barcelona,32,Caldes d'Estrac,2776,1338,1438
8,Barcelona,33,Caldes de Montbui,17186,8616,8570
8,Barcelona,34,Calders,955,493,462
8,Barcelona,35,Calella,18694,9305,9389
8,Barcelona,36,Calonge de Segarra,198,103,95
8,Barcelona,37,Calldetenes,2426,1247,1179
8,Barcelona,38,Callús,1940,945,995
8,Barcelona,39,Campins,480,249,231
8,Barcelona,40,Canet de Mar,14072,6927,7145
8,Barcelona,41,Canovelles,15851,8233,7618
8,Barcelona,42,Cànoves i Samalús,2818,1449,1369
8,Barcelona,43,Canyelles,4282,2177,2105
8,Barcelona,44,Capellades,5494,2717,2777
8,Barcelona,45,Capolat,85,35,50
8,Barcelona,46,Cardedeu,17241,8483,8758
8,Barcelona,47,Cardona,5116,2518,2598
8,Barcelona,48,Carme,836,433,403
8,Barcelona,49,Casserres,1595,802,793
8,Barcelona,50,Castellar del Riu,174,95,79
8,Barcelona,51,Castellar del Vallès,23238,11530,11708
8,Barcelona,52,Castellar de n'Hug,169,93,76
8,Barcelona,53,Castellbell i el Vilar,3711,1895,1816
8,Barcelona,54,Castellbisbal,12267,6277,5990
8,Barcelona,55,Castellcir,665,342,323
8,Barcelona,56,Castelldefels,63139,31431,31708
8,Barcelona,57,Castell de l'Areny,70,39,31
8,Barcelona,58,Castellet i la Gornal,2223,1127,1096
8,Barcelona,59,Castellfollit del Boix,409,205,204
8,Barcelona,60,Castellfollit de Riubregós,190,101,89
8,Barcelona,61,Castellgalí,1966,1032,934
8,Barcelona,62,Castellnou de Bages,1091,557,534
8,Barcelona,63,Castellolí,550,265,285
8,Barcelona,64,Castellterçol,2376,1188,1188
8,Barcelona,65,Castellví de la Marca,1649,831,818
8,Barcelona,66,Castellví de Rosanes,1792,894,898
8,Barcelona,67,Centelles,7360,3602,3758
8,Barcelona,68,Cervelló,8651,4352,4299
8,Barcelona,69,Collbató,4242,2203,2039
8,Barcelona,70,Collsuspina,347,185,162
8,Barcelona,71,Copons,332,162,170
8,Barcelona,72,Corbera de Llobregat,14064,7078,6986
8,Barcelona,73,Cornellà de Llobregat,87243,43121,44122
8,Barcelona,74,Cubelles,14293,7274,7019
8,Barcelona,75,Dosrius,5123,2603,2520
8,Barcelona,76,Esparreguera,21986,11237,10749
8,Barcelona,77,Esplugues de Llobregat,46687,22678,24009
8,Barcelona,78,"Espunyola, L'",268,137,131
8,Barcelona,79,"Estany, L'",393,197,196
8,Barcelona,80,Fígols,52,30,22
8,Barcelona,81,Fogars de Montclús,453,242,211
8,Barcelona,82,Fogars de la Selva,1498,801,697
8,Barcelona,83,Folgueroles,2229,1130,1099
8,Barcelona,84,Fonollosa,1417,736,681
8,Barcelona,85,Font-rubí,1466,771,695
8,Barcelona,86,"Franqueses del Vallès, Les",18693,9619,9074
8,Barcelona,87,Gallifa,204,107,97
8,Barcelona,88,"Garriga, La",15236,7389,7847
8,Barcelona,89,Gavà,46250,22921,23329
8,Barcelona,90,Gaià,172,92,80
8,Barcelona,91,Gelida,7085,3556,3529
8,Barcelona,92,Gironella,5083,2523,2560
8,Barcelona,93,Gisclareny,31,16,15
8,Barcelona,94,"Granada, La",1995,1004,991
8,Barcelona,95,Granera,80,51,29
8,Barcelona,96,Granollers,60000,29893,30107
8,Barcelona,97,Gualba,1312,671,641
8,Barcelona,98,Sant Salvador de Guardiola,3146,1608,1538
8,Barcelona,99,Guardiola de Berguedà,1027,544,483
8,Barcelona,100,Gurb,2538,1318,1220
8,Barcelona,101,"Hospitalet de Llobregat, L'",256065,125118,130947
8,Barcelona,102,Igualada,39191,19322,19869
8,Barcelona,103,Jorba,820,411,409
8,Barcelona,104,"Llacuna, La",935,506,429
8,Barcelona,105,"Llagosta, La",13721,6859,6862
8,Barcelona,106,Llinars del Vallès,9293,4611,4682
8,Barcelona,107,Lliçà d'Amunt,14456,7332,7124
8,Barcelona,108,Lliçà de Vall,6404,3252,3152
8,Barcelona,109,Lluçà,254,135,119
8,Barcelona,110,Malgrat de Mar,18444,9233,9211
8,Barcelona,111,Malla,259,128,131
8,Barcelona,112,Manlleu,20445,10249,10196
8,Barcelona,113,Manresa,76589,37610,38979
8,Barcelona,114,Martorell,27457,14249,13208
8,Barcelona,115,Martorelles,4903,2463,2440
8,Barcelona,116,"Masies de Roda, Les",763,377,386
8,Barcelona,117,"Masies de Voltregà, Les",3174,1565,1609
8,Barcelona,118,"Masnou, El",22523,10794,11729
8,Barcelona,119,Masquefa,8310,4200,4110
8,Barcelona,120,Matadepera,8584,4318,4266
8,Barcelona,121,Mataró,123868,61960,61908
8,Barcelona,122,Mediona,2347,1192,1155
8,Barcelona,123,Molins de Rei,24572,11997,12575
8,Barcelona,124,Mollet del Vallès,52409,26236,26173
8,Barcelona,125,Montcada i Reixac,34232,17026,17206
8,Barcelona,126,Montgat,10739,5291,5448
8,Barcelona,127,Monistrol de Montserrat,3009,1550,1459
8,Barcelona,128,Monistrol de Calders,689,352,337
8,Barcelona,129,Muntanyola,568,291,277
8,Barcelona,130,Montclar,112,54,58
8,Barcelona,131,Montesquiu,901,465,436
8,Barcelona,132,Montmajor,475,245,230
8,Barcelona,133,Montmaneu,196,110,86
8,Barcelona,134,Figaró-Montmany,1112,565,547
8,Barcelona,135,Montmeló,8913,4403,4510
8,Barcelona,136,Montornès del Vallès,16042,8186,7856
8,Barcelona,137,Montseny,314,164,150
8,Barcelona,138,Moià,5730,2900,2830
8,Barcelona,139,Mura,230,119,111
8,Barcelona,140,Navarcles,5965,2926,3039
8,Barcelona,141,Navàs,6171,3068,3103
8,Barcelona,142,"Nou de Berguedà, La",147,78,69
8,Barcelona,143,Òdena,3469,1773,1696
8,Barcelona,144,Olvan,908,458,450
8,Barcelona,145,Olèrdola,3584,1856,1728
8,Barcelona,146,Olesa de Bonesvalls,1762,919,843
8,Barcelona,147,Olesa de Montserrat,23924,12060,11864
8,Barcelona,148,Olivella,3589,1909,1680
8,Barcelona,149,Olost,1191,595,596
8,Barcelona,150,Orís,291,149,142
8,Barcelona,151,Oristà,569,282,287
8,Barcelona,152,Orpí,172,95,77
8,Barcelona,153,Òrrius,644,327,317
8,Barcelona,154,Pacs del Penedès,872,437,435
8,Barcelona,155,Palafolls,8966,4494,4472
8,Barcelona,156,Palau-solità i Plegamans,14352,7173,7179
8,Barcelona,157,Pallejà,11272,5695,5577
8,Barcelona,158,"Papiol, El",3941,1947,1994
8,Barcelona,159,Parets del Vallès,18113,9190,8923
8,Barcelona,160,Perafita,400,204,196
8,Barcelona,161,Piera,14867,7581,7286
8,Barcelona,162,"Hostalets de Pierola, Els",2827,1473,1354
8,Barcelona,163,Pineda de Mar,26040,13156,12884
8,Barcelona,164,"Pla del Penedès, El",1145,578,567
8,Barcelona,165,"Pobla de Claramunt, La",2269,1146,1123
8,Barcelona,166,"Pobla de Lillet, La",1295,642,653
8,Barcelona,167,Polinyà,7984,4068,3916
8,Barcelona,168,Pontons,572,309,263
8,Barcelona,169,"Prat de Llobregat, El",63499,31528,31971
8,Barcelona,170,"Prats de Rei, Els",532,284,248
8,Barcelona,171,Prats de Lluçanès,2676,1322,1354
8,Barcelona,172,Premià de Mar,28310,13963,14347
8,Barcelona,174,Puigdàlber,525,259,266
8,Barcelona,175,Puig-reig,4347,2150,2197
8,Barcelona,176,Pujalt,208,107,101
8,Barcelona,177,"Quar, La",66,40,26
8,Barcelona,178,Rajadell,524,273,251
8,Barcelona,179,Rellinars,738,381,357
8,Barcelona,180,Ripollet,37348,18696,18652
8,Barcelona,181,"Roca del Vallès, La",10303,5193,5110
8,Barcelona,182,"Pont de Vilomara i Rocafort, El",3741,1940,1801
8,Barcelona,183,Roda de Ter,6151,3021,3130
8,Barcelona,184,Rubí,73979,37046,36933
8,Barcelona,185,Rubió,222,121,101
8,Barcelona,187,Sabadell,207721,101490,106231
8,Barcelona,188,Sagàs,140,74,66
8,Barcelona,189,Sant Pere Sallavinera,164,89,75
8,Barcelona,190,Saldes,324,180,144
8,Barcelona,191,Sallent,6892,3317,3575
8,Barcelona,192,Santpedor,7185,3608,3577
8,Barcelona,193,Sant Iscle de Vallalta,1281,672,609
8,Barcelona,194,Sant Adrià de Besòs,34157,16809,17348
8,Barcelona,195,Sant Agustí de Lluçanès,96,50,46
8,Barcelona,196,Sant Andreu de la Barca,27094,13692,13402
8,Barcelona,197,Sant Andreu de Llavaneres,10406,5188,5218
8,Barcelona,198,Sant Antoni de Vilamajor,5555,2784,2771
8,Barcelona,199,Sant Bartomeu del Grau,963,498,465
8,Barcelona,200,Sant Boi de Llobregat,82860,41117,41743
8,Barcelona,201,Sant Boi de Lluçanès,523,267,256
8,Barcelona,202,Sant Celoni,16949,8462,8487
8,Barcelona,203,Sant Cebrià de Vallalta,3426,1781,1645
8,Barcelona,204,Sant Climent de Llobregat,3907,1969,1938
8,Barcelona,205,Sant Cugat del Vallès,83337,40744,42593
8,Barcelona,206,Sant Cugat Sesgarrigues,992,504,488
8,Barcelona,207,Sant Esteve de Palautordera,2516,1234,1282
8,Barcelona,208,Sant Esteve Sesrovires,7439,3747,3692
8,Barcelona,209,Sant Fost de Campsentelles,8421,4227,4194
8,Barcelona,210,Sant Feliu de Codines,5990,3030,2960
8,Barcelona,211,Sant Feliu de Llobregat,43096,21026,22070
8,Barcelona,212,Sant Feliu Sasserra,669,343,326
8,Barcelona,213,Sant Fruitós de Bages,8198,4117,4081
8,Barcelona,214,Vilassar de Dalt,8794,4330,4464
8,Barcelona,215,Sant Hipòlit de Voltregà,3547,1795,1752
8,Barcelona,216,Sant Jaume de Frontanyà,19,11,8
8,Barcelona,217,Sant Joan Despí,32406,15889,16517
8,Barcelona,218,Sant Joan de Vilatorrada,10767,5411,5356
8,Barcelona,219,Vilassar de Mar,19840,9583,10257
8,Barcelona,220,Sant Julià de Vilatorta,2984,1466,1518
8,Barcelona,221,Sant Just Desvern,16253,7738,8515
8,Barcelona,222,Sant Llorenç d'Hortons,2492,1257,1235
8,Barcelona,223,Sant Llorenç Savall,2412,1216,1196
8,Barcelona,224,Sant Martí de Centelles,1080,550,530
8,Barcelona,225,Sant Martí d'Albars,109,56,53
8,Barcelona,226,Sant Martí de Tous,1167,590,577
8,Barcelona,227,Sant Martí Sarroca,3197,1596,1601
8,Barcelona,228,Sant Martí Sesgueioles,376,188,188
8,Barcelona,229,Sant Mateu de Bages,642,332,310
8,Barcelona,230,Premià de Dalt,10168,5095,5073
8,Barcelona,231,Sant Pere de Ribes,28783,14551,14232
8,Barcelona,232,Sant Pere de Riudebitlles,2382,1195,1187
8,Barcelona,233,Sant Pere de Torelló,2423,1237,1186
8,Barcelona,234,Sant Pere de Vilamajor,4256,2142,2114
8,Barcelona,235,Sant Pol de Mar,5070,2558,2512
8,Barcelona,236,Sant Quintí de Mediona,2147,1104,1043
8,Barcelona,237,Sant Quirze de Besora,2201,1079,1122
8,Barcelona,238,Sant Quirze del Vallès,19051,9368,9683
8,Barcelona,239,Sant Quirze Safaja,661,341,320
8,Barcelona,240,Sant Sadurní d'Anoia,12345,6074,6271
8,Barcelona,241,Sant Sadurní d'Osormort,95,52,43
8,Barcelona,242,Marganell,311,147,164
8,Barcelona,243,Santa Cecília de Voltregà,182,97,85
8,Barcelona,244,Santa Coloma de Cervelló,7931,3901,4030
8,Barcelona,245,Santa Coloma de Gramenet,120824,61082,59742
8,Barcelona,246,Santa Eugènia de Berga,2294,1188,1106
8,Barcelona,247,Santa Eulàlia de Riuprimer,1123,576,547
8,Barcelona,248,Santa Eulàlia de Ronçana,6921,3447,3474
8,Barcelona,249,Santa Fe del Penedès,408,208,200
8,Barcelona,250,Santa Margarida de Montbui,9812,4923,4889
8,Barcelona,251,Santa Margarida i els Monjos,7030,3588,3442
8,Barcelona,252,Barberà del Vallès,32033,15907,16126
8,Barcelona,253,Santa Maria de Besora,160,80,80
8,Barcelona,254,Santa Maria de Corcó,2216,1124,1092
8,Barcelona,255,Santa Maria de Merlès,171,82,89
8,Barcelona,256,Santa Maria de Martorelles,841,430,411
8,Barcelona,257,Santa Maria de Miralles,140,69,71
8,Barcelona,258,Santa Maria d'Oló,1066,541,525
8,Barcelona,259,Santa Maria de Palautordera,9097,4677,4420
8,Barcelona,260,Santa Perpètua de Mogoda,25331,13047,12284
8,Barcelona,261,Santa Susanna,3317,1693,1624
8,Barcelona,262,Sant Vicenç de Castellet,9126,4547,4579
8,Barcelona,263,Sant Vicenç dels Horts,28137,14135,14002
8,Barcelona,264,Sant Vicenç de Montalt,5854,2962,2892
8,Barcelona,265,Sant Vicenç de Torelló,2049,1004,1045
8,Barcelona,266,Cerdanyola del Vallès,58247,28737,29510
8,Barcelona,267,Sentmenat,8407,4266,4141
8,Barcelona,268,Cercs,1303,657,646
8,Barcelona,269,Seva,3412,1754,1658
8,Barcelona,270,Sitges,28617,14270,14347
8,Barcelona,271,Sobremunt,88,42,46
8,Barcelona,272,Sora,179,102,77
8,Barcelona,273,Subirats,3075,1540,1535
8,Barcelona,274,Súria,6255,3052,3203
8,Barcelona,275,Tavèrnoles,307,155,152
8,Barcelona,276,Tagamanent,314,170,144
8,Barcelona,277,Talamanca,155,89,66
8,Barcelona,278,Taradell,6181,3111,3070
8,Barcelona,279,Terrassa,213697,105920,107777
8,Barcelona,280,Tavertet,142,79,63
8,Barcelona,281,Teià,6162,3060,3102
8,Barcelona,282,Tiana,7973,3871,4102
8,Barcelona,283,Tona,8119,4051,4068
8,Barcelona,284,Tordera,15974,8167,7807
8,Barcelona,285,Torelló,13931,6887,7044
8,Barcelona,286,"Torre de Claramunt, La",3796,1973,1823
8,Barcelona,287,Torrelavit,1398,755,643
8,Barcelona,288,Torrelles de Foix,2454,1292,1162
8,Barcelona,289,Torrelles de Llobregat,5661,2810,2851
8,Barcelona,290,Ullastrell,1904,960,944
8,Barcelona,291,Vacarisses,6175,3215,2960
8,Barcelona,292,Vallbona d'Anoia,1433,737,696
8,Barcelona,293,Vallcebre,269,161,108
8,Barcelona,294,Vallgorguina,2617,1347,1270
8,Barcelona,295,Vallirana,14409,7209,7200
8,Barcelona,296,Vallromanes,2396,1223,1173
8,Barcelona,297,Veciana,173,97,76
8,Barcelona,298,Vic,40900,20298,20602
8,Barcelona,299,Vilada,509,257,252
8,Barcelona,300,Viladecavalls,7376,3692,3684
8,Barcelona,301,Viladecans,64737,32286,32451
8,Barcelona,302,Vilanova del Camí,12632,6381,6251
8,Barcelona,303,Vilanova de Sau,335,166,169
8,Barcelona,304,Vilobí del Penedès,1103,569,534
8,Barcelona,305,Vilafranca del Penedès,38785,19296,19489
8,Barcelona,306,Vilalba Sasserra,670,339,331
8,Barcelona,307,Vilanova i la Geltrú,66905,32887,34018
8,Barcelona,308,Viver i Serrateix,178,92,86
8,Barcelona,901,Rupit i Pruit,309,159,150
8,Barcelona,902,Vilanova del Vallès,4975,2534,2441
8,Barcelona,903,Sant Julià de Cerdanyola,263,145,118
8,Barcelona,904,Badia del Vallès,13643,6690,6953
8,Barcelona,905,"Palma de Cervelló, La",3019,1507,1512
9,Burgos,1,Abajas,29,18,11
9,Burgos,3,Adrada de Haza,252,135,117
9,Burgos,6,Aguas Cándidas,68,44,24
9,Burgos,7,Aguilar de Bureba,63,37,26
9,Burgos,9,Albillos,210,111,99
9,Burgos,10,Alcocero de Mola,37,23,14
9,Burgos,11,Alfoz de Bricia,97,52,45
9,Burgos,12,Alfoz de Santa Gadea,112,65,47
9,Burgos,13,Altable,57,30,27
9,Burgos,14,"Altos, Los",201,115,86
9,Burgos,16,Ameyugo,100,55,45
9,Burgos,17,Anguix,145,89,56
9,Burgos,18,Aranda de Duero,33229,16460,16769
9,Burgos,19,Arandilla,180,110,70
9,Burgos,20,Arauzo de Miel,350,192,158
9,Burgos,21,Arauzo de Salce,69,37,32
9,Burgos,22,Arauzo de Torre,91,50,41
9,Burgos,23,Arcos,1331,727,604
9,Burgos,24,Arenillas de Riopisuerga,188,107,81
9,Burgos,25,Arija,178,92,86
9,Burgos,26,Arlanzón,425,246,179
9,Burgos,27,Arraya de Oca,56,32,24
9,Burgos,29,Atapuerca,206,120,86
9,Burgos,30,"Ausines, Los",151,84,67
9,Burgos,32,Avellanosa de Muñó,127,67,60
9,Burgos,33,Bahabón de Esgueva,118,69,49
9,Burgos,34,"Balbases, Los",343,194,149
9,Burgos,35,Baños de Valdearados,382,226,156
9,Burgos,36,Bañuelos de Bureba,34,23,11
9,Burgos,37,Barbadillo de Herreros,124,73,51
9,Burgos,38,Barbadillo del Mercado,162,92,70
9,Burgos,39,Barbadillo del Pez,80,52,28
9,Burgos,41,Barrio de Muñó,35,19,16
9,Burgos,43,"Barrios de Bureba, Los",221,135,86
9,Burgos,44,Barrios de Colina,61,29,32
9,Burgos,45,Basconcillos del Tozo,315,179,136
9,Burgos,46,Bascuñana,41,26,15
9,Burgos,47,Belbimbre,75,39,36
9,Burgos,48,Belorado,2140,1112,1028
9,Burgos,50,Berberana,73,39,34
9,Burgos,51,Berlangas de Roa,199,106,93
9,Burgos,52,Berzosa de Bureba,42,28,14
9,Burgos,54,Bozoó,112,61,51
9,Burgos,55,Brazacorta,65,34,31
9,Burgos,56,Briviesca,7677,3933,3744
9,Burgos,57,Bugedo,189,120,69
9,Burgos,58,Buniel,467,259,208
9,Burgos,59,Burgos,179251,86158,93093
9,Burgos,60,Busto de Bureba,193,112,81
9,Burgos,61,Cabañes de Esgueva,210,108,102
9,Burgos,62,Cabezón de la Sierra,58,24,34
9,Burgos,63,Cavia,278,162,116
9,Burgos,64,Caleruega,504,250,254
9,Burgos,65,Campillo de Aranda,194,111,83
9,Burgos,66,Campolara,67,44,23
9,Burgos,67,Canicosa de la Sierra,557,299,258
9,Burgos,68,Cantabrana,29,17,12
9,Burgos,70,Carazo,46,30,16
9,Burgos,71,Carcedo de Bureba,51,29,22
9,Burgos,72,Carcedo de Burgos,357,207,150
9,Burgos,73,Cardeñadijo,1159,644,515
9,Burgos,74,Cardeñajimeno,950,513,437
9,Burgos,75,Cardeñuela Riopico,147,87,60
9,Burgos,76,Carrias,26,22,4
9,Burgos,77,Cascajares de Bureba,40,24,16
9,Burgos,78,Cascajares de la Sierra,42,21,21
9,Burgos,79,Castellanos de Castro,52,31,21
9,Burgos,82,Castildelgado,54,29,25
9,Burgos,83,Castil de Peones,32,17,15
9,Burgos,84,Castrillo de la Reina,228,145,83
9,Burgos,85,Castrillo de la Vega,644,341,303
9,Burgos,86,Castrillo del Val,728,418,310
9,Burgos,88,Castrillo de Riopisuerga,70,43,27
9,Burgos,90,Castrillo Matajudíos,65,35,30
9,Burgos,91,Castrojeriz,873,441,432
9,Burgos,93,Cayuela,196,105,91
9,Burgos,94,Cebrecos,52,33,19
9,Burgos,95,Celada del Camino,101,53,48
9,Burgos,98,Cerezo de Río Tirón,625,339,286
9,Burgos,100,Cerratón de Juarros,54,36,18
9,Burgos,101,Ciadoncha,73,46,27
9,Burgos,102,Cillaperlata,43,27,16
9,Burgos,103,Cilleruelo de Abajo,277,145,132
9,Burgos,104,Cilleruelo de Arriba,60,32,28
9,Burgos,105,Ciruelos de Cervera,123,67,56
9,Burgos,108,Cogollos,498,281,217
9,Burgos,109,Condado de Treviño,1461,833,628
9,Burgos,110,Contreras,100,63,37
9,Burgos,112,Coruña del Conde,132,78,54
9,Burgos,113,Covarrubias,627,337,290
9,Burgos,114,Cubillo del Campo,105,57,48
9,Burgos,115,Cubo de Bureba,117,66,51
9,Burgos,117,"Cueva de Roa, La",107,57,50
9,Burgos,119,Cuevas de San Clemente,54,22,32
9,Burgos,120,Encío,45,28,17
9,Burgos,122,Espinosa de Cervera,99,61,38
9,Burgos,123,Espinosa del Camino,36,19,17
9,Burgos,124,Espinosa de los Monteros,2075,1144,931
9,Burgos,125,Estépar,725,425,300
9,Burgos,127,Fontioso,56,28,28
9,Burgos,128,Frandovínez,105,59,46
9,Burgos,129,Fresneda de la Sierra Tirón,140,93,47
9,Burgos,130,Fresneña,101,54,47
9,Burgos,131,Fresnillo de las Dueñas,517,275,242
9,Burgos,132,Fresno de Río Tirón,194,112,82
9,Burgos,133,Fresno de Rodilla,48,30,18
9,Burgos,134,Frías,284,152,132
9,Burgos,135,Fuentebureba,46,22,24
9,Burgos,136,Fuentecén,249,142,107
9,Burgos,137,Fuentelcésped,219,108,111
9,Burgos,138,Fuentelisendo,103,61,42
9,Burgos,139,Fuentemolinos,110,69,41
9,Burgos,140,Fuentenebro,162,96,66
9,Burgos,141,Fuentespina,749,401,348
9,Burgos,143,Galbarros,30,22,8
9,Burgos,144,"Gallega, La",73,43,30
9,Burgos,148,Grijalba,119,58,61
9,Burgos,149,Grisaleña,41,28,13
9,Burgos,151,Gumiel de Izán,637,358,279
9,Burgos,152,Gumiel de Mercado,380,210,170
9,Burgos,154,Hacinas,183,99,84
9,Burgos,155,Haza,28,16,12
9,Burgos,159,Hontanas,70,40,30
9,Burgos,160,Hontangas,118,72,46
9,Burgos,162,Hontoria de la Cantera,134,73,61
9,Burgos,163,Hontoria del Pinar,774,429,345
9,Burgos,164,Hontoria de Valdearados,232,143,89
9,Burgos,166,"Hormazas, Las",111,64,47
9,Burgos,167,Hornillos del Camino,61,36,25
9,Burgos,168,"Horra, La",387,198,189
9,Burgos,169,Hortigüela,99,62,37
9,Burgos,170,Hoyales de Roa,244,127,117
9,Burgos,172,Huérmeces,136,68,68
9,Burgos,173,Huerta de Arriba,135,78,57
9,Burgos,174,Huerta de Rey,1070,575,495
9,Burgos,175,Humada,142,89,53
9,Burgos,176,Hurones,79,46,33
9,Burgos,177,Ibeas de Juarros,1432,781,651
9,Burgos,178,Ibrillos,65,37,28
9,Burgos,179,Iglesiarrubia,49,29,20
9,Burgos,180,Iglesias,149,83,66
9,Burgos,181,Isar,384,187,197
9,Burgos,182,Itero del Castillo,105,55,50
9,Burgos,183,Jaramillo de la Fuente,57,34,23
9,Burgos,184,Jaramillo Quemado,5,3,2
9,Burgos,189,Junta de Traslaloma,155,78,77
9,Burgos,190,Junta de Villalba de Losa,112,60,52
9,Burgos,191,Jurisdicción de Lara,48,26,22
9,Burgos,192,Jurisdicción de San Zadornil,78,44,34
9,Burgos,194,Lerma,2826,1404,1422
9,Burgos,195,Llano de Bureba,69,35,34
9,Burgos,196,Madrigal del Monte,176,105,71
9,Burgos,197,Madrigalejo del Monte,198,123,75
9,Burgos,198,Mahamud,143,81,62
9,Burgos,199,Mambrilla de Castrejón,110,59,51
9,Burgos,200,Mambrillas de Lara,53,28,25
9,Burgos,201,Mamolar,34,20,14
9,Burgos,202,Manciles,28,18,10
9,Burgos,206,Mazuela,70,38,32
9,Burgos,208,Mecerreyes,300,158,142
9,Burgos,209,Medina de Pomar,6225,3254,2971
9,Burgos,211,Melgar de Fernamental,1842,979,863
9,Burgos,213,Merindad de Cuesta-Urria,421,220,201
9,Burgos,214,Merindad de Montija,840,483,357
9,Burgos,215,Merindad de Sotoscueva,512,284,228
9,Burgos,216,Merindad de Valdeporres,462,241,221
9,Burgos,217,Merindad de Valdivielso,428,247,181
9,Burgos,218,Milagros,512,280,232
9,Burgos,219,Miranda de Ebro,38930,19565,19365
9,Burgos,220,Miraveche,89,53,36
9,Burgos,221,Modúbar de la Emparedada,582,330,252
9,Burgos,223,Monasterio de la Sierra,46,28,18
9,Burgos,224,Monasterio de Rodilla,209,117,92
9,Burgos,225,Moncalvillo,100,59,41
9,Burgos,226,Monterrubio de la Demanda,70,40,30
9,Burgos,227,Montorio,188,106,82
9,Burgos,228,Moradillo de Roa,200,106,94
9,Burgos,229,Nava de Roa,249,127,122
9,Burgos,230,Navas de Bureba,43,19,24
9,Burgos,231,Nebreda,80,55,25
9,Burgos,232,Neila,214,119,95
9,Burgos,235,Olmedillo de Roa,197,106,91
9,Burgos,236,Olmillos de Muñó,43,25,18
9,Burgos,238,Oña,1219,628,591
9,Burgos,239,Oquillas,61,33,28
9,Burgos,241,Orbaneja Riopico,237,130,107
9,Burgos,242,Padilla de Abajo,96,56,40
9,Burgos,243,Padilla de Arriba,89,58,31
9,Burgos,244,Padrones de Bureba,58,33,25
9,Burgos,246,Palacios de la Sierra,814,408,406
9,Burgos,247,Palacios de Riopisuerga,34,16,18
9,Burgos,248,Palazuelos de la Sierra,70,44,26
9,Burgos,249,Palazuelos de Muñó,61,32,29
9,Burgos,250,Pampliega,364,194,170
9,Burgos,251,Pancorbo,501,268,233
9,Burgos,253,Pardilla,124,73,51
9,Burgos,255,Partido de la Sierra en Tobalina,93,58,35
9,Burgos,256,Pedrosa de Duero,485,280,205
9,Burgos,257,Pedrosa del Páramo,103,59,44
9,Burgos,258,Pedrosa del Príncipe,175,93,82
9,Burgos,259,Pedrosa de Río Úrbel,287,175,112
9,Burgos,261,Peñaranda de Duero,576,290,286
9,Burgos,262,Peral de Arlanza,153,81,72
9,Burgos,265,Piérnigas,44,27,17
9,Burgos,266,Pineda de la Sierra,104,59,45
9,Burgos,267,Pineda Trasmonte,142,85,57
9,Burgos,268,Pinilla de los Barruecos,129,75,54
9,Burgos,269,Pinilla de los Moros,48,29,19
9,Burgos,270,Pinilla Trasmonte,196,111,85
9,Burgos,272,Poza de la Sal,368,183,185
9,Burgos,273,Prádanos de Bureba,57,36,21
9,Burgos,274,Pradoluengo,1414,703,711
9,Burgos,275,Presencio,191,107,84
9,Burgos,276,"Puebla de Arganzón, La",517,295,222
9,Burgos,277,Puentedura,138,85,53
9,Burgos,279,Quemada,258,150,108
9,Burgos,280,Quintanabureba,37,22,15
9,Burgos,281,Quintana del Pidio,179,94,85
9,Burgos,283,Quintanaélez,65,35,30
9,Burgos,287,Quintanaortuño,264,144,120
9,Burgos,288,Quintanapalla,109,61,48
9,Burgos,289,Quintanar de la Sierra,2011,1055,956
9,Burgos,292,Quintanavides,108,58,50
9,Burgos,294,Quintanilla de la Mata,144,80,64
9,Burgos,295,Quintanilla del Coco,77,41,36
9,Burgos,297,"Quintanillas, Las",404,225,179
9,Burgos,298,Quintanilla San García,115,63,52
9,Burgos,301,Quintanilla Vivar,759,398,361
9,Burgos,302,Rabanera del Pinar,124,69,55
9,Burgos,303,Rábanos,97,55,42
9,Burgos,304,Rabé de las Calzadas,221,110,111
9,Burgos,306,Rebolledo de la Torre,139,72,67
9,Burgos,307,Redecilla del Camino,137,76,61
9,Burgos,308,Redecilla del Campo,72,40,32
9,Burgos,309,Regumiel de la Sierra,410,209,201
9,Burgos,310,Reinoso,14,11,3
9,Burgos,311,Retuerta,72,43,29
9,Burgos,312,"Revilla y Ahedo, La",137,76,61
9,Burgos,314,Revilla del Campo,113,69,44
9,Burgos,315,Revillarruz,459,235,224
9,Burgos,316,Revilla Vallejera,103,64,39
9,Burgos,317,Rezmondo,16,7,9
9,Burgos,318,Riocavado de la Sierra,60,35,25
9,Burgos,321,Roa,2456,1270,1186
9,Burgos,323,Rojas,79,53,26
9,Burgos,325,Royuela de Río Franco,236,138,98
9,Burgos,326,Rubena,182,105,77
9,Burgos,327,Rublacedo de Abajo,37,20,17
9,Burgos,328,Rucandio,81,43,38
9,Burgos,329,Salas de Bureba,146,84,62
9,Burgos,330,Salas de los Infantes,2150,1115,1035
9,Burgos,332,Saldaña de Burgos,185,105,80
9,Burgos,334,Salinillas de Bureba,56,39,17
9,Burgos,335,San Adrián de Juarros,66,40,26
9,Burgos,337,San Juan del Monte,162,88,74
9,Burgos,338,San Mamés de Burgos,315,172,143
9,Burgos,339,San Martín de Rubiales,169,105,64
9,Burgos,340,San Millán de Lara,74,53,21
9,Burgos,343,Santa Cecilia,105,64,41
9,Burgos,345,Santa Cruz de la Salceda,172,100,72
9,Burgos,346,Santa Cruz del Valle Urbión,102,62,40
9,Burgos,347,Santa Gadea del Cid,161,89,72
9,Burgos,348,Santa Inés,143,80,63
9,Burgos,350,Santa María del Campo,629,343,286
9,Burgos,351,Santa María del Invierno,63,44,19
9,Burgos,352,Santa María del Mercadillo,141,81,60
9,Burgos,353,Santa María Rivarredonda,97,59,38
9,Burgos,354,Santa Olalla de Bureba,35,24,11
9,Burgos,355,Santibáñez de Esgueva,120,64,56
9,Burgos,356,Santibáñez del Val,65,41,24
9,Burgos,358,Santo Domingo de Silos,318,195,123
9,Burgos,360,San Vicente del Valle,40,23,17
9,Burgos,361,Sargentes de la Lora,144,83,61
9,Burgos,362,Sarracín,287,156,131
9,Burgos,363,Sasamón,1170,649,521
9,Burgos,365,"Sequera de Haza, La",46,26,20
9,Burgos,366,Solarana,102,53,49
9,Burgos,368,Sordillos,27,17,10
9,Burgos,369,Sotillo de la Ribera,569,314,255
9,Burgos,372,Sotragero,273,151,122
9,Burgos,373,Sotresgudo,521,300,221
9,Burgos,374,Susinos del Páramo,117,72,45
9,Burgos,375,Tamarón,46,26,20
9,Burgos,377,Tardajos,856,448,408
9,Burgos,378,Tejada,38,26,12
9,Burgos,380,Terradillos de Esgueva,105,53,52
9,Burgos,381,Tinieblas de la Sierra,40,24,16
9,Burgos,382,Tobar,30,18,12
9,Burgos,384,Tordómar,373,208,165
9,Burgos,386,Torrecilla del Monte,80,44,36
9,Burgos,387,Torregalindo,143,86,57
9,Burgos,388,Torrelara,32,21,11
9,Burgos,389,Torrepadre,86,55,31
9,Burgos,390,Torresandino,720,392,328
9,Burgos,391,Tórtoles de Esgueva,501,266,235
9,Burgos,392,Tosantos,53,32,21
9,Burgos,394,Trespaderne,1070,581,489
9,Burgos,395,Tubilla del Agua,179,111,68
9,Burgos,396,Tubilla del Lago,171,101,70
9,Burgos,398,Úrbel del Castillo,98,63,35
9,Burgos,400,Vadocondes,414,228,186
9,Burgos,403,Valdeande,105,66,39
9,Burgos,405,Valdezate,155,80,75
9,Burgos,406,Valdorros,306,176,130
9,Burgos,407,Valmala,33,15,18
9,Burgos,408,Vallarta de Bureba,49,29,20
9,Burgos,409,Valle de Manzanedo,168,91,77
9,Burgos,410,Valle de Mena,3961,2033,1928
9,Burgos,411,Valle de Oca,184,107,77
9,Burgos,412,Valle de Tobalina,1030,550,480
9,Burgos,413,Valle de Valdebezana,569,305,264
9,Burgos,414,Valle de Valdelaguna,197,118,79
9,Burgos,415,Valle de Valdelucio,361,192,169
9,Burgos,416,Valle de Zamanzas,69,40,29
9,Burgos,417,Vallejera,44,26,18
9,Burgos,418,Valles de Palenzuela,81,43,38
9,Burgos,419,Valluércanes,84,51,33
9,Burgos,421,"Vid y Barrios, La",296,171,125
9,Burgos,422,"Vid de Bureba, La",28,15,13
9,Burgos,423,Vileña,33,19,14
9,Burgos,424,Viloria de Rioja,50,28,22
9,Burgos,425,Vilviestre del Pinar,665,357,308
9,Burgos,427,Villadiego,1731,936,795
9,Burgos,428,Villaescusa de Roa,136,76,60
9,Burgos,429,Villaescusa la Sombría,74,52,22
9,Burgos,430,Villaespasa,18,10,8
9,Burgos,431,Villafranca Montes de Oca,147,85,62
9,Burgos,432,Villafruela,230,133,97
9,Burgos,433,Villagalijo,74,50,24
9,Burgos,434,Villagonzalo Pedernales,1637,868,769
9,Burgos,437,Villahoz,352,189,163
9,Burgos,438,Villalba de Duero,679,356,323
9,Burgos,439,Villalbilla de Burgos,1146,617,529
9,Burgos,440,Villalbilla de Gumiel,108,67,41
9,Burgos,441,Villaldemiro,75,40,35
9,Burgos,442,Villalmanzo,465,246,219
9,Burgos,443,Villamayor de los Montes,227,117,110
9,Burgos,444,Villamayor de Treviño,88,48,40
9,Burgos,445,Villambistia,47,31,16
9,Burgos,446,Villamedianilla,13,9,4
9,Burgos,447,Villamiel de la Sierra,37,22,15
9,Burgos,448,Villangómez,249,150,99
9,Burgos,449,Villanueva de Argaño,110,67,43
9,Burgos,450,Villanueva de Carazo,30,19,11
9,Burgos,451,Villanueva de Gumiel,293,154,139
9,Burgos,454,Villanueva de Teba,48,32,16
9,Burgos,455,Villaquirán de la Puebla,51,32,19
9,Burgos,456,Villaquirán de los Infantes,162,81,81
9,Burgos,458,Villariezo,553,322,231
9,Burgos,460,Villasandino,212,121,91
9,Burgos,463,Villasur de Herreros,283,160,123
9,Burgos,464,Villatuelda,53,31,22
9,Burgos,466,Villaverde del Monte,156,88,68
9,Burgos,467,Villaverde-Mogina,82,54,28
9,Burgos,471,Villayerno Morquillas,219,130,89
9,Burgos,472,Villazopeque,63,38,25
9,Burgos,473,Villegas,97,57,40
9,Burgos,476,Villoruebo,99,61,38
9,Burgos,478,Vizcaínos,55,33,22
9,Burgos,480,Zael,117,65,52
9,Burgos,482,Zarzosa de Río Pisuerga,36,23,13
9,Burgos,483,Zazuar,255,137,118
9,Burgos,485,Zuñeda,59,35,24
9,Burgos,901,Quintanilla del Agua y Tordueles,513,265,248
9,Burgos,902,Valle de Santibáñez,560,311,249
9,Burgos,903,Villarcayo de Merindad de Castilla la Vieja,4859,2582,2277
9,Burgos,904,Valle de las Navas,618,348,270
9,Burgos,905,Valle de Sedano,503,288,215
9,Burgos,906,Merindad de Río Ubierna,1433,793,640
9,Burgos,907,Alfoz de Quintanadueñas,1936,1045,891
9,Burgos,908,Valle de Losa,582,335,247
10,Cáceres,1,Abadía,328,181,147
10,Cáceres,2,Abertura,447,225,222
10,Cáceres,3,Acebo,679,351,328
10,Cáceres,4,Acehúche,829,404,425
10,Cáceres,5,Aceituna,620,318,302
10,Cáceres,6,Ahigal,1435,735,700
10,Cáceres,7,Albalá,805,407,398
10,Cáceres,8,Alcántara,1631,811,820
10,Cáceres,9,Alcollarín,260,121,139
10,Cáceres,10,Alcuéscar,2969,1539,1430
10,Cáceres,11,Aldeacentenera,733,386,347
10,Cáceres,12,Aldea del Cano,699,335,364
10,Cáceres,13,"Aldea del Obispo, La",340,181,159
10,Cáceres,14,Aldeanueva de la Vera,2216,1087,1129
10,Cáceres,15,Aldeanueva del Camino,784,389,395
10,Cáceres,16,Aldehuela de Jerte,386,205,181
10,Cáceres,17,Alía,1028,523,505
10,Cáceres,18,Aliseda,2013,1027,986
10,Cáceres,19,Almaraz,1521,788,733
10,Cáceres,20,Almoharín,2005,978,1027
10,Cáceres,21,Arroyo de la Luz,6392,3165,3227
10,Cáceres,22,Arroyomolinos de la Vera,486,240,246
10,Cáceres,23,Arroyomolinos,962,499,463
10,Cáceres,24,Baños de Montemayor,769,373,396
10,Cáceres,25,Barrado,458,236,222
10,Cáceres,26,Belvís de Monroy,656,336,320
10,Cáceres,27,Benquerencia,89,50,39
10,Cáceres,28,Berrocalejo,141,69,72
10,Cáceres,29,Berzocana,496,246,250
10,Cáceres,30,Bohonal de Ibor,565,296,269
10,Cáceres,31,Botija,214,109,105
10,Cáceres,32,Brozas,2070,1042,1028
10,Cáceres,33,Cabañas del Castillo,478,251,227
10,Cáceres,34,Cabezabellosa,408,205,203
10,Cáceres,35,Cabezuela del Valle,2428,1256,1172
10,Cáceres,36,Cabrero,374,198,176
10,Cáceres,37,Cáceres,95026,45665,49361
10,Cáceres,38,Cachorrilla,105,55,50
10,Cáceres,39,Cadalso,493,241,252
10,Cáceres,40,Calzadilla,507,255,252
10,Cáceres,41,Caminomorisco,1227,639,588
10,Cáceres,42,Campillo de Deleitosa,74,30,44
10,Cáceres,43,Campo Lugar,1006,501,505
10,Cáceres,44,Cañamero,1751,908,843
10,Cáceres,45,Cañaveral,1248,611,637
10,Cáceres,46,Carbajo,226,114,112
10,Cáceres,47,Carcaboso,1160,597,563
10,Cáceres,48,Carrascalejo,323,161,162
10,Cáceres,49,Casar de Cáceres,4846,2392,2454
10,Cáceres,50,Casar de Palomero,1491,752,739
10,Cáceres,51,Casares de las Hurdes,530,262,268
10,Cáceres,52,Casas de Don Antonio,213,100,113
10,Cáceres,53,Casas de Don Gómez,341,180,161
10,Cáceres,54,Casas del Castañar,620,299,321
10,Cáceres,55,Casas del Monte,814,413,401
10,Cáceres,56,Casas de Millán,673,338,335
10,Cáceres,57,Casas de Miravete,172,100,72
10,Cáceres,58,Casatejada,1461,752,709
10,Cáceres,59,Casillas de Coria,455,221,234
10,Cáceres,60,Castañar de Ibor,1193,629,564
10,Cáceres,61,Ceclavín,2020,1011,1009
10,Cáceres,62,Cedillo,490,253,237
10,Cáceres,63,Cerezo,188,90,98
10,Cáceres,64,Cilleros,1831,926,905
10,Cáceres,65,Collado,188,94,94
10,Cáceres,66,Conquista de la Sierra,212,120,92
10,Cáceres,67,Coria,13050,6412,6638
10,Cáceres,68,Cuacos de Yuste,902,459,443
10,Cáceres,69,"Cumbre, La",974,477,497
10,Cáceres,70,Deleitosa,826,426,400
10,Cáceres,71,Descargamaría,190,98,92
10,Cáceres,72,Eljas,1008,514,494
10,Cáceres,73,Escurial,804,421,383
10,Cáceres,75,Fresnedoso de Ibor,324,173,151
10,Cáceres,76,Galisteo,1055,525,530
10,Cáceres,77,Garciaz,823,422,401
10,Cáceres,78,"Garganta, La",482,261,221
10,Cáceres,79,Garganta la Olla,1023,541,482
10,Cáceres,80,Gargantilla,432,222,210
10,Cáceres,81,Gargüera,123,66,57
10,Cáceres,82,Garrovillas de Alconétar,2229,1088,1141
10,Cáceres,83,Garvín,108,58,50
10,Cáceres,84,Gata,1648,841,807
10,Cáceres,85,"Gordo, El",385,203,182
10,Cáceres,86,"Granja, La",364,195,169
10,Cáceres,87,Guadalupe,2063,1016,1047
10,Cáceres,88,Guijo de Coria,263,138,125
10,Cáceres,89,Guijo de Galisteo,1644,835,809
10,Cáceres,90,Guijo de Granadilla,611,307,304
10,Cáceres,91,Guijo de Santa Bárbara,405,212,193
10,Cáceres,92,Herguijuela,367,186,181
10,Cáceres,93,Hernán-Pérez,510,265,245
10,Cáceres,94,Herrera de Alcántara,275,138,137
10,Cáceres,95,Herreruela,369,184,185
10,Cáceres,96,Hervás,4197,2064,2133
10,Cáceres,97,Higuera,115,65,50
10,Cáceres,98,Hinojal,447,223,224
10,Cáceres,99,Holguera,762,389,373
10,Cáceres,100,Hoyos,955,483,472
10,Cáceres,101,Huélaga,204,105,99
10,Cáceres,102,Ibahernando,445,216,229
10,Cáceres,103,Jaraicejo,569,268,301
10,Cáceres,104,Jaraíz de la Vera,6791,3405,3386
10,Cáceres,105,Jarandilla de la Vera,3098,1542,1556
10,Cáceres,106,Jarilla,154,76,78
10,Cáceres,107,Jerte,1316,665,651
10,Cáceres,108,Ladrillar,210,112,98
10,Cáceres,109,Logrosán,2080,1055,1025
10,Cáceres,110,Losar de la Vera,2910,1480,1430
10,Cáceres,111,Madrigal de la Vera,1815,950,865
10,Cáceres,112,Madrigalejo,1890,932,958
10,Cáceres,113,Madroñera,2847,1415,1432
10,Cáceres,114,Majadas,1352,681,671
10,Cáceres,115,Malpartida de Cáceres,4398,2208,2190
10,Cáceres,116,Malpartida de Plasencia,4716,2379,2337
10,Cáceres,117,Marchagaz,241,121,120
10,Cáceres,118,Mata de Alcántara,336,172,164
10,Cáceres,119,Membrío,779,377,402
10,Cáceres,120,Mesas de Ibor,185,96,89
10,Cáceres,121,Miajadas,10234,5077,5157
10,Cáceres,122,Millanes,269,135,134
10,Cáceres,123,Mirabel,718,366,352
10,Cáceres,124,Mohedas de Granadilla,992,500,492
10,Cáceres,125,Monroy,1089,547,542
10,Cáceres,126,Montánchez,1969,980,989
10,Cáceres,127,Montehermoso,5819,2988,2831
10,Cáceres,128,Moraleja,7182,3569,3613
10,Cáceres,129,Morcillo,419,201,218
10,Cáceres,130,Navaconcejo,2031,1017,1014
10,Cáceres,131,Navalmoral de la Mata,17386,8548,8838
10,Cáceres,132,Navalvillar de Ibor,484,244,240
10,Cáceres,133,Navas del Madroño,1427,720,707
10,Cáceres,134,Navezuelas,693,361,332
10,Cáceres,135,Nuñomoral,1420,755,665
10,Cáceres,136,Oliva de Plasencia,303,167,136
10,Cáceres,137,Palomero,439,228,211
10,Cáceres,138,Pasarón de la Vera,677,327,350
10,Cáceres,139,Pedroso de Acim,111,59,52
10,Cáceres,140,Peraleda de la Mata,1448,739,709
10,Cáceres,141,Peraleda de San Román,286,144,142
10,Cáceres,142,Perales del Puerto,975,489,486
10,Cáceres,143,Pescueza,167,78,89
10,Cáceres,144,"Pesga, La",1130,586,544
10,Cáceres,145,Piedras Albas,188,99,89
10,Cáceres,146,Pinofranqueado,1631,876,755
10,Cáceres,147,Piornal,1552,777,775
10,Cáceres,148,Plasencia,41392,20157,21235
10,Cáceres,149,Plasenzuela,507,262,245
10,Cáceres,150,Portaje,409,208,201
10,Cáceres,151,Portezuelo,266,135,131
10,Cáceres,152,Pozuelo de Zarzón,561,279,282
10,Cáceres,153,Puerto de Santa Cruz,391,200,191
10,Cáceres,154,Rebollar,230,113,117
10,Cáceres,155,Riolobos,1368,724,644
10,Cáceres,156,Robledillo de Gata,119,64,55
10,Cáceres,157,Robledillo de la Vera,305,161,144
10,Cáceres,158,Robledillo de Trujillo,410,220,190
10,Cáceres,159,Robledollano,372,210,162
10,Cáceres,160,Romangordo,252,110,142
10,Cáceres,161,Ruanes,62,37,25
10,Cáceres,162,Salorino,686,354,332
10,Cáceres,163,Salvatierra de Santiago,313,153,160
10,Cáceres,164,San Martín de Trevejo,895,440,455
10,Cáceres,165,Santa Ana,294,155,139
10,Cáceres,166,Santa Cruz de la Sierra,278,138,140
10,Cáceres,167,Santa Cruz de Paniagua,300,165,135
10,Cáceres,168,Santa Marta de Magasca,299,144,155
10,Cáceres,169,Santiago de Alcántara,634,309,325
10,Cáceres,170,Santiago del Campo,290,147,143
10,Cáceres,171,Santibáñez el Alto,415,215,200
10,Cáceres,172,Santibáñez el Bajo,811,423,388
10,Cáceres,173,Saucedilla,854,461,393
10,Cáceres,174,Segura de Toro,196,93,103
10,Cáceres,175,Serradilla,1678,858,820
10,Cáceres,176,Serrejón,466,234,232
10,Cáceres,177,Sierra de Fuentes,2075,1060,1015
10,Cáceres,178,Talaván,915,461,454
10,Cáceres,179,Talaveruela de la Vera,392,205,187
10,Cáceres,180,Talayuela,9283,5006,4277
10,Cáceres,181,Tejeda de Tiétar,877,474,403
10,Cáceres,182,Toril,176,108,68
10,Cáceres,183,Tornavacas,1170,621,549
10,Cáceres,184,"Torno, El",972,523,449
10,Cáceres,185,Torrecilla de los Ángeles,656,339,317
10,Cáceres,186,Torrecillas de la Tiesa,1217,616,601
10,Cáceres,187,Torre de Don Miguel,565,298,267
10,Cáceres,188,Torre de Santa María,642,325,317
10,Cáceres,189,Torrejoncillo,3307,1617,1690
10,Cáceres,190,Torrejón el Rubio,612,313,299
10,Cáceres,191,Torremenga,664,356,308
10,Cáceres,192,Torremocha,992,481,511
10,Cáceres,193,Torreorgaz,1773,872,901
10,Cáceres,194,Torrequemada,611,288,323
10,Cáceres,195,Trujillo,9623,4707,4916
10,Cáceres,196,Valdastillas,365,192,173
10,Cáceres,197,Valdecañas de Tajo,121,67,54
10,Cáceres,198,Valdefuentes,1373,677,696
10,Cáceres,199,Valdehúncar,210,112,98
10,Cáceres,200,Valdelacasa de Tajo,560,280,280
10,Cáceres,201,Valdemorales,235,120,115
10,Cáceres,202,Valdeobispo,735,366,369
10,Cáceres,203,Valencia de Alcántara,6127,3060,3067
10,Cáceres,204,Valverde de la Vera,574,299,275
10,Cáceres,205,Valverde del Fresno,2459,1254,1205
10,Cáceres,206,Viandar de la Vera,267,134,133
10,Cáceres,207,Villa del Campo,548,270,278
10,Cáceres,208,Villa del Rey,144,74,70
10,Cáceres,209,Villamesías,284,141,143
10,Cáceres,210,Villamiel,666,333,333
10,Cáceres,211,Villanueva de la Sierra,497,248,249
10,Cáceres,212,Villanueva de la Vera,2109,1064,1045
10,Cáceres,213,Villar del Pedroso,679,347,332
10,Cáceres,214,Villar de Plasencia,243,117,126
10,Cáceres,215,Villasbuenas de Gata,450,234,216
10,Cáceres,216,Zarza de Granadilla,1860,971,889
10,Cáceres,217,Zarza de Montánchez,609,298,311
10,Cáceres,218,Zarza la Mayor,1393,706,687
10,Cáceres,219,Zorita,1642,809,833
10,Cáceres,901,Rosalejo,1281,668,613
10,Cáceres,902,Vegaviana,863,448,415
10,Cáceres,903,Alagón del Río,871,435,436
11,Cádiz,1,Alcalá de los Gazules,5549,2827,2722
11,Cádiz,2,Alcalá del Valle,5294,2683,2611
11,Cádiz,3,Algar,1505,776,729
11,Cádiz,4,Algeciras,117810,58271,59539
11,Cádiz,5,Algodonales,5800,2935,2865
11,Cádiz,6,Arcos de la Frontera,31496,15793,15703
11,Cádiz,7,Barbate,22928,11465,11463
11,Cádiz,8,"Barrios, Los",22853,11518,11335
11,Cádiz,9,Benaocaz,751,391,360
11,Cádiz,10,Bornos,8107,4042,4065
11,Cádiz,11,"Bosque, El",2117,1089,1028
11,Cádiz,12,Cádiz,124892,59203,65689
11,Cádiz,13,Castellar de la Frontera,3187,1606,1581
11,Cádiz,14,Conil de la Frontera,21664,10950,10714
11,Cádiz,15,Chiclana de la Frontera,79839,40259,39580
11,Cádiz,16,Chipiona,18860,9450,9410
11,Cádiz,17,Espera,3960,1971,1989
11,Cádiz,18,"Gastor, El",1839,961,878
11,Cádiz,19,Grazalema,2206,1120,1086
11,Cádiz,20,Jerez de la Frontera,210861,103305,107556
11,Cádiz,21,Jimena de la Frontera,10447,5405,5042
11,Cádiz,22,"Línea de la Concepción, La",64944,32068,32876
11,Cádiz,23,Medina-Sidonia,11823,6053,5770
11,Cádiz,24,Olvera,8549,4218,4331
11,Cádiz,25,Paterna de Rivera,5653,2903,2750
11,Cádiz,26,Prado del Rey,5941,2960,2981
11,Cádiz,27,"Puerto de Santa María, El",88917,43769,45148
11,Cádiz,28,Puerto Real,41101,20729,20372
11,Cádiz,29,Puerto Serrano,7156,3621,3535
11,Cádiz,30,Rota,29125,14621,14504
11,Cádiz,31,San Fernando,96894,47750,49144
11,Cádiz,32,Sanlúcar de Barrameda,66944,33425,33519
11,Cádiz,33,San Roque,29965,15078,14887
11,Cádiz,34,Setenil de las Bodegas,2951,1521,1430
11,Cádiz,35,Tarifa,17856,9105,8751
11,Cádiz,36,Torre Alháquime,836,432,404
11,Cádiz,37,Trebujena,7041,3557,3484
11,Cádiz,38,Ubrique,16873,8319,8554
11,Cádiz,39,Vejer de la Frontera,12854,6475,6379
11,Cádiz,40,Villaluenga del Rosario,485,255,230
11,Cádiz,41,Villamartín,12495,6268,6227
11,Cádiz,42,Zahara,1522,775,747
11,Cádiz,901,Benalup-Casas Viejas,7221,3687,3534
11,Cádiz,902,San José del Valle,4408,2256,2152
12,Castellón/Castelló,1,Atzeneta del Maestrat,1367,713,654
12,Castellón/Castelló,2,Aín,141,72,69
12,Castellón/Castelló,3,Albocàsser,1443,715,728
12,Castellón/Castelló,4,Alcalà de Xivert,8175,4191,3984
12,Castellón/Castelló,5,"Alcora, l'",10856,5487,5369
12,Castellón/Castelló,6,Alcudia de Veo,229,116,113
12,Castellón/Castelló,7,Alfondeguilla,881,443,438
12,Castellón/Castelló,8,Algimia de Almonacid,315,177,138
12,Castellón/Castelló,9,Almazora/Almassora,25945,13101,12844
12,Castellón/Castelló,10,Almedíjar,306,151,155
12,Castellón/Castelló,11,Almenara,6102,3049,3053
12,Castellón/Castelló,12,Altura,3924,2031,1893
12,Castellón/Castelló,13,Arañuel,196,99,97
12,Castellón/Castelló,14,Ares del Maestrat,206,110,96
12,Castellón/Castelló,15,Argelita,96,50,46
12,Castellón/Castelló,16,Artana,1990,1023,967
12,Castellón/Castelló,17,Ayódar,212,110,102
12,Castellón/Castelló,18,Azuébar,376,191,185
12,Castellón/Castelló,20,Barracas,198,102,96
12,Castellón/Castelló,21,Betxí,5890,2960,2930
12,Castellón/Castelló,22,Bejís,423,242,181
12,Castellón/Castelló,24,Benafer,177,97,80
12,Castellón/Castelló,25,Benafigos,161,91,70
12,Castellón/Castelló,26,Benasal,1264,649,615
12,Castellón/Castelló,27,Benicarló,26553,13376,13177
12,Castellón/Castelló,28,Benicasim/Benicàssim,18524,9353,9171
12,Castellón/Castelló,29,Benlloch,1211,634,577
12,Castellón/Castelló,31,Borriol,5180,2622,2558
12,Castellón/Castelló,32,Borriana/Burriana,35433,17729,17704
12,Castellón/Castelló,33,Cabanes,3019,1532,1487
12,Castellón/Castelló,34,Càlig,2236,1128,1108
12,Castellón/Castelló,36,Canet lo Roig,855,430,425
12,Castellón/Castelló,37,Castell de Cabres,17,9,8
12,Castellón/Castelló,38,Castellfort,237,126,111
12,Castellón/Castelló,39,Castellnovo,1065,542,523
12,Castellón/Castelló,40,Castellón de la Plana/Castelló de la Plana,180114,88478,91636
12,Castellón/Castelló,41,Castillo de Villamalefa,114,69,45
12,Castellón/Castelló,42,Catí,850,429,421
12,Castellón/Castelló,43,Caudiel,754,385,369
12,Castellón/Castelló,44,Cervera del Maestre,727,354,373
12,Castellón/Castelló,45,Cinctorres,494,245,249
12,Castellón/Castelló,46,Cirat,270,152,118
12,Castellón/Castelló,48,Cortes de Arenoso,347,187,160
12,Castellón/Castelló,49,Costur,581,298,283
12,Castellón/Castelló,50,"Coves de Vinromà, les",2049,1024,1025
12,Castellón/Castelló,51,Culla,608,312,296
12,Castellón/Castelló,52,Chert/Xert,889,446,443
12,Castellón/Castelló,53,Chilches/Xilxes,2844,1469,1375
12,Castellón/Castelló,55,Chodos/Xodos,125,66,59
12,Castellón/Castelló,56,Chóvar,363,187,176
12,Castellón/Castelló,57,Eslida,936,463,473
12,Castellón/Castelló,58,Espadilla,91,43,48
12,Castellón/Castelló,59,Fanzara,347,175,172
12,Castellón/Castelló,60,Figueroles,583,293,290
12,Castellón/Castelló,61,Forcall,529,259,270
12,Castellón/Castelló,63,Fuente la Reina,64,34,30
12,Castellón/Castelló,64,Fuentes de Ayódar,155,84,71
12,Castellón/Castelló,65,Gaibiel,196,110,86
12,Castellón/Castelló,67,Geldo,699,358,341
12,Castellón/Castelló,68,Herbés,59,32,27
12,Castellón/Castelló,69,Higueras,49,26,23
12,Castellón/Castelló,70,"Jana, la",787,402,385
12,Castellón/Castelló,71,Jérica,1634,817,817
12,Castellón/Castelló,72,Lucena del Cid,1516,766,750
12,Castellón/Castelló,73,Ludiente,200,107,93
12,Castellón/Castelló,74,"Llosa, la",951,483,468
12,Castellón/Castelló,75,"Mata de Morella, la",207,105,102
12,Castellón/Castelló,76,Matet,111,56,55
12,Castellón/Castelló,77,Moncofa,6348,3248,3100
12,Castellón/Castelló,78,Montán,425,212,213
12,Castellón/Castelló,79,Montanejos,630,319,311
12,Castellón/Castelló,80,Morella,2794,1395,1399
12,Castellón/Castelló,81,Navajas,819,429,390
12,Castellón/Castelló,82,Nules,13693,6845,6848
12,Castellón/Castelló,83,Olocau del Rey,139,75,64
12,Castellón/Castelló,84,Onda,25704,13052,12652
12,Castellón/Castelló,85,Oropesa del Mar/Orpesa,10088,5384,4704
12,Castellón/Castelló,87,Palanques,32,18,14
12,Castellón/Castelló,88,Pavías,59,33,26
12,Castellón/Castelló,89,Peníscola/Peñíscola,8094,4146,3948
12,Castellón/Castelló,90,Pina de Montalgrao,149,75,74
12,Castellón/Castelló,91,Portell de Morella,235,117,118
12,Castellón/Castelló,92,Puebla de Arenoso,175,94,81
12,Castellón/Castelló,93,"Pobla de Benifassà, la",316,168,148
12,Castellón/Castelló,94,"Pobla Tornesa, la",1165,604,561
12,Castellón/Castelló,95,Ribesalbes,1342,673,669
12,Castellón/Castelló,96,Rossell,1164,615,549
12,Castellón/Castelló,97,Sacañet,87,52,35
12,Castellón/Castelló,98,"Salzadella, la",870,432,438
12,Castellón/Castelló,99,Sant Jordi/San Jorge,1111,584,527
12,Castellón/Castelló,100,Sant Mateu,2118,1106,1012
12,Castellón/Castelló,101,San Rafael del Río,552,281,271
12,Castellón/Castelló,102,Santa Magdalena de Pulpis,848,449,399
12,Castellón/Castelló,103,Sarratella,103,54,49
12,Castellón/Castelló,104,Segorbe,9326,4603,4723
12,Castellón/Castelló,105,Sierra Engarcerán,1054,563,491
12,Castellón/Castelló,106,Soneja,1533,764,769
12,Castellón/Castelló,107,Sot de Ferrer,442,232,210
12,Castellón/Castelló,108,Sueras/Suera,672,347,325
12,Castellón/Castelló,109,Tales,890,444,446
12,Castellón/Castelló,110,Teresa,284,144,140
12,Castellón/Castelló,111,Tírig,560,294,266
12,Castellón/Castelló,112,Todolella,146,84,62
12,Castellón/Castelló,113,Toga,126,61,65
12,Castellón/Castelló,114,Torás,268,142,126
12,Castellón/Castelló,115,"Toro, El",279,158,121
12,Castellón/Castelló,116,Torralba del Pinar,54,26,28
12,Castellón/Castelló,117,Torreblanca,5718,2956,2762
12,Castellón/Castelló,118,Torrechiva,102,64,38
12,Castellón/Castelló,119,"Torre d'En Besora, la",177,101,76
12,Castellón/Castelló,120,"Torre d'en Doménec, la",265,135,130
12,Castellón/Castelló,121,Traiguera,1686,869,817
12,Castellón/Castelló,122,"Useras/Useres, les",1013,531,482
12,Castellón/Castelló,123,Vallat,78,41,37
12,Castellón/Castelló,124,Vall d'Alba,3036,1563,1473
12,Castellón/Castelló,125,Vall de Almonacid,277,146,131
12,Castellón/Castelló,126,"Vall d'Uixó, la",32864,16315,16549
12,Castellón/Castelló,127,Vallibona,101,53,48
12,Castellón/Castelló,128,Vilafamés,1951,1034,917
12,Castellón/Castelló,129,Villafranca del Cid/Vilafranca,2527,1240,1287
12,Castellón/Castelló,130,Villahermosa del Río,500,262,238
12,Castellón/Castelló,131,Villamalur,102,54,48
12,Castellón/Castelló,132,Vilanova d'Alcolea,703,373,330
12,Castellón/Castelló,133,Villanueva de Viver,66,38,28
12,Castellón/Castelló,134,Vilar de Canes,186,99,87
12,Castellón/Castelló,135,Vila-real,51168,25612,25556
12,Castellón/Castelló,136,"Vilavella, la",3321,1664,1657
12,Castellón/Castelló,137,Villores,50,27,23
12,Castellón/Castelló,138,Vinaròs,28508,14194,14314
12,Castellón/Castelló,139,Vistabella del Maestrazgo,413,219,194
12,Castellón/Castelló,140,Viver,1681,875,806
12,Castellón/Castelló,141,Zorita del Maestrazgo,150,74,76
12,Castellón/Castelló,142,Zucaina,190,101,89
12,Castellón/Castelló,901,Alquerías del Niño Perdido,4433,2189,2244
12,Castellón/Castelló,902,Sant Joan de Moró,2938,1539,1399
13,Ciudad Real,1,Abenójar,1605,820,785
13,Ciudad Real,2,Agudo,1866,943,923
13,Ciudad Real,3,Alamillo,531,268,263
13,Ciudad Real,4,Albaladejo,1480,774,706
13,Ciudad Real,5,Alcázar de San Juan,31652,15611,16041
13,Ciudad Real,6,Alcoba,706,356,350
13,Ciudad Real,7,Alcolea de Calatrava,1616,821,795
13,Ciudad Real,8,Alcubillas,579,298,281
13,Ciudad Real,9,Aldea del Rey,1969,1015,954
13,Ciudad Real,10,Alhambra,1105,559,546
13,Ciudad Real,11,Almadén,6101,2929,3172
13,Ciudad Real,12,Almadenejos,502,260,242
13,Ciudad Real,13,Almagro,9083,4487,4596
13,Ciudad Real,14,Almedina,687,352,335
13,Ciudad Real,15,Almodóvar del Campo,6711,3363,3348
13,Ciudad Real,16,Almuradiel,900,444,456
13,Ciudad Real,17,Anchuras,358,205,153
13,Ciudad Real,18,Arenas de San Juan,1077,555,522
13,Ciudad Real,19,Argamasilla de Alba,7416,3765,3651
13,Ciudad Real,20,Argamasilla de Calatrava,5941,3018,2923
13,Ciudad Real,21,Arroba de los Montes,506,268,238
13,Ciudad Real,22,Ballesteros de Calatrava,464,232,232
13,Ciudad Real,23,Bolaños de Calatrava,12159,6223,5936
13,Ciudad Real,24,Brazatortas,1117,583,534
13,Ciudad Real,25,Cabezarados,351,183,168
13,Ciudad Real,26,Cabezarrubias del Puerto,548,282,266
13,Ciudad Real,27,Calzada de Calatrava,4430,2218,2212
13,Ciudad Real,28,Campo de Criptana,14972,7631,7341
13,Ciudad Real,29,Cañada de Calatrava,115,65,50
13,Ciudad Real,30,Caracuel de Calatrava,168,93,75
13,Ciudad Real,31,Carrión de Calatrava,3003,1520,1483
13,Ciudad Real,32,Carrizosa,1445,720,725
13,Ciudad Real,33,Castellar de Santiago,2208,1103,1105
13,Ciudad Real,34,Ciudad Real,74798,35446,39352
13,Ciudad Real,35,Corral de Calatrava,1172,592,580
13,Ciudad Real,36,"Cortijos, Los",992,514,478
13,Ciudad Real,37,Cózar,1204,607,597
13,Ciudad Real,38,Chillón,2052,1006,1046
13,Ciudad Real,39,Daimiel,18673,9308,9365
13,Ciudad Real,40,Fernán Caballero,1143,566,577
13,Ciudad Real,41,Fontanarejo,318,169,149
13,Ciudad Real,42,Fuencaliente,1112,586,526
13,Ciudad Real,43,Fuenllana,298,147,151
13,Ciudad Real,44,Fuente el Fresno,3650,1878,1772
13,Ciudad Real,45,Granátula de Calatrava,896,432,464
13,Ciudad Real,46,Guadalmez,874,435,439
13,Ciudad Real,47,Herencia,8953,4587,4366
13,Ciudad Real,48,Hinojosas de Calatrava,539,278,261
13,Ciudad Real,49,Horcajo de los Montes,1019,512,507
13,Ciudad Real,50,"Labores, Las",650,322,328
13,Ciudad Real,51,Luciana,409,212,197
13,Ciudad Real,52,Malagón,8734,4369,4365
13,Ciudad Real,53,Manzanares,19239,9558,9681
13,Ciudad Real,54,Membrilla,6349,3206,3143
13,Ciudad Real,55,Mestanza,815,390,425
13,Ciudad Real,56,Miguelturra,14517,7346,7171
13,Ciudad Real,57,Montiel,1562,813,749
13,Ciudad Real,58,Moral de Calatrava,5657,2823,2834
13,Ciudad Real,59,Navalpino,267,135,132
13,Ciudad Real,60,Navas de Estena,343,195,148
13,Ciudad Real,61,Pedro Muñoz,8639,4521,4118
13,Ciudad Real,62,Picón,702,360,342
13,Ciudad Real,63,Piedrabuena,4815,2463,2352
13,Ciudad Real,64,Poblete,1978,1043,935
13,Ciudad Real,65,Porzuna,4056,2088,1968
13,Ciudad Real,66,Pozuelo de Calatrava,3204,1637,1567
13,Ciudad Real,67,"Pozuelos de Calatrava, Los",444,224,220
13,Ciudad Real,68,Puebla de Don Rodrigo,1255,677,578
13,Ciudad Real,69,Puebla del Príncipe,806,400,406
13,Ciudad Real,70,Puerto Lápice,1016,510,506
13,Ciudad Real,71,Puertollano,52200,25494,26706
13,Ciudad Real,72,Retuerta del Bullaque,1135,629,506
13,Ciudad Real,73,Saceruela,642,333,309
13,Ciudad Real,74,San Carlos del Valle,1208,616,592
13,Ciudad Real,75,San Lorenzo de Calatrava,247,127,120
13,Ciudad Real,76,Santa Cruz de los Cáñamos,582,294,288
13,Ciudad Real,77,Santa Cruz de Mudela,4625,2297,2328
13,Ciudad Real,78,Socuéllamos,13725,7081,6644
13,Ciudad Real,79,"Solana, La",16238,8243,7995
13,Ciudad Real,80,Solana del Pino,427,222,205
13,Ciudad Real,81,Terrinches,909,502,407
13,Ciudad Real,82,Tomelloso,38966,19701,19265
13,Ciudad Real,83,Torralba de Calatrava,3163,1551,1612
13,Ciudad Real,84,Torre de Juan Abad,1224,588,636
13,Ciudad Real,85,Torrenueva,2991,1503,1488
13,Ciudad Real,86,Valdemanco del Esteras,237,126,111
13,Ciudad Real,87,Valdepeñas,31141,15345,15796
13,Ciudad Real,88,Valenzuela de Calatrava,770,361,409
13,Ciudad Real,89,Villahermosa,2181,1043,1138
13,Ciudad Real,90,Villamanrique,1357,679,678
13,Ciudad Real,91,Villamayor de Calatrava,665,330,335
13,Ciudad Real,92,Villanueva de la Fuente,2500,1272,1228
13,Ciudad Real,93,Villanueva de los Infantes,5777,2878,2899
13,Ciudad Real,94,Villanueva de San Carlos,378,201,177
13,Ciudad Real,95,Villar del Pozo,98,50,48
13,Ciudad Real,96,Villarrubia de los Ojos,11096,5614,5482
13,Ciudad Real,97,Villarta de San Juan,3090,1568,1522
13,Ciudad Real,98,Viso del Marqués,2755,1383,1372
13,Ciudad Real,901,"Robledo, El",1307,689,618
13,Ciudad Real,902,Ruidera,594,305,289
13,Ciudad Real,903,Arenales de San Gregorio,718,374,344
13,Ciudad Real,904,Llanos del Caudillo,708,360,348
14,Córdoba,1,Adamuz,4467,2289,2178
14,Córdoba,2,Aguilar de la Frontera,13654,6869,6785
14,Córdoba,3,Alcaracejos,1545,764,781
14,Córdoba,4,Almedinilla,2510,1278,1232
14,Córdoba,5,Almodóvar del Río,7969,3992,3977
14,Córdoba,6,Añora,1552,766,786
14,Córdoba,7,Baena,21028,10654,10374
14,Córdoba,8,Belalcázar,3449,1658,1791
14,Córdoba,9,Belmez,3216,1579,1637
14,Córdoba,10,Benamejí,5155,2577,2578
14,Córdoba,11,"Blázquez, Los",745,387,358
14,Córdoba,12,Bujalance,7932,3950,3982
14,Córdoba,13,Cabra,21188,10426,10762
14,Córdoba,14,Cañete de las Torres,3157,1621,1536
14,Córdoba,15,Carcabuey,2662,1347,1315
14,Córdoba,16,Cardeña,1703,861,842
14,Córdoba,17,"Carlota, La",13595,6839,6756
14,Córdoba,18,"Carpio, El",4590,2268,2322
14,Córdoba,19,Castro del Río,8079,4017,4062
14,Córdoba,20,Conquista,466,225,241
14,Córdoba,21,Córdoba,328659,157984,170675
14,Córdoba,22,Doña Mencía,5010,2465,2545
14,Córdoba,23,Dos Torres,2555,1262,1293
14,Córdoba,24,Encinas Reales,2408,1189,1219
14,Córdoba,25,Espejo,3578,1817,1761
14,Córdoba,26,Espiel,2460,1226,1234
14,Córdoba,27,Fernán-Núñez,9794,4902,4892
14,Córdoba,28,Fuente la Lancha,376,191,185
14,Córdoba,29,Fuente Obejuna,5147,2631,2516
14,Córdoba,30,Fuente Palmera,11013,5558,5455
14,Córdoba,31,Fuente-Tójar,770,371,399
14,Córdoba,32,"Granjuela, La",518,259,259
14,Córdoba,33,Guadalcázar,1630,810,820
14,Córdoba,34,"Guijo, El",419,218,201
14,Córdoba,35,Hinojosa del Duque,7329,3544,3785
14,Córdoba,36,Hornachuelos,4739,2407,2332
14,Córdoba,37,Iznájar,4736,2383,2353
14,Córdoba,38,Lucena,42560,21166,21394
14,Córdoba,39,Luque,3371,1698,1673
14,Córdoba,40,Montalbán de Córdoba,4586,2311,2275
14,Córdoba,41,Montemayor,4143,2078,2065
14,Córdoba,42,Montilla,23870,11816,12054
14,Córdoba,43,Montoro,9920,4893,5027
14,Córdoba,44,Monturque,2001,989,1012
14,Córdoba,45,Moriles,3917,1937,1980
14,Córdoba,46,Nueva Carteya,5639,2843,2796
14,Córdoba,47,Obejo,1985,1016,969
14,Córdoba,48,Palenciana,1614,803,811
14,Córdoba,49,Palma del Río,21537,10731,10806
14,Córdoba,50,Pedro Abad,2976,1506,1470
14,Córdoba,51,Pedroche,1651,821,830
14,Córdoba,52,Peñarroya-Pueblonuevo,11778,5711,6067
14,Córdoba,53,Posadas,7628,3805,3823
14,Córdoba,54,Pozoblanco,17735,8683,9052
14,Córdoba,55,Priego de Córdoba,23528,11589,11939
14,Córdoba,56,Puente Genil,30424,15159,15265
14,Córdoba,57,"Rambla, La",7640,3837,3803
14,Córdoba,58,Rute,10594,5292,5302
14,Córdoba,59,San Sebastián de los Ballesteros,836,422,414
14,Córdoba,60,Santaella,6130,3098,3032
14,Córdoba,61,Santa Eufemia,945,485,460
14,Córdoba,62,Torrecampo,1264,613,651
14,Córdoba,63,Valenzuela,1337,665,672
14,Córdoba,64,Valsequillo,411,201,210
14,Córdoba,65,"Victoria, La",2336,1169,1167
14,Córdoba,66,Villa del Río,7469,3765,3704
14,Córdoba,67,Villafranca de Córdoba,4752,2444,2308
14,Córdoba,68,Villaharta,766,383,383
14,Córdoba,69,Villanueva de Córdoba,9521,4747,4774
14,Córdoba,70,Villanueva del Duque,1646,819,827
14,Córdoba,71,Villanueva del Rey,1183,603,580
14,Córdoba,72,Villaralto,1303,636,667
14,Córdoba,73,Villaviciosa de Córdoba,3525,1790,1735
14,Córdoba,74,"Viso, El",2787,1377,1410
14,Córdoba,75,Zuheros,746,373,373
15,"Coruña, A",1,Abegondo,5709,2833,2876
15,"Coruña, A",2,Ames,28852,13957,14895
15,"Coruña, A",3,Aranga,2113,1064,1049
15,"Coruña, A",4,Ares,5801,2864,2937
15,"Coruña, A",5,Arteixo,30482,15260,15222
15,"Coruña, A",6,Arzúa,6328,3134,3194
15,"Coruña, A",7,"Baña, A",4102,1959,2143
15,"Coruña, A",8,Bergondo,6722,3227,3495
15,"Coruña, A",9,Betanzos,13537,6459,7078
15,"Coruña, A",10,Boimorto,2211,1127,1084
15,"Coruña, A",11,Boiro,19106,9314,9792
15,"Coruña, A",12,Boqueixón,4430,2187,2243
15,"Coruña, A",13,Brión,7462,3627,3835
15,"Coruña, A",14,Cabana de Bergantiños,4865,2389,2476
15,"Coruña, A",15,Cabanas,3346,1656,1690
15,"Coruña, A",16,Camariñas,6168,3063,3105
15,"Coruña, A",17,Cambre,23649,11633,12016
15,"Coruña, A",18,"Capela, A",1386,683,703
15,"Coruña, A",19,Carballo,31303,15276,16027
15,"Coruña, A",20,Carnota,4834,2313,2521
15,"Coruña, A",21,Carral,6064,2982,3082
15,"Coruña, A",22,Cedeira,7338,3659,3679
15,"Coruña, A",23,Cee,7898,3804,4094
15,"Coruña, A",24,Cerceda,5392,2614,2778
15,"Coruña, A",25,Cerdido,1328,643,685
15,"Coruña, A",26,Cesuras,2225,1090,1135
15,"Coruña, A",27,Coirós,1771,874,897
15,"Coruña, A",28,Corcubión,1767,867,900
15,"Coruña, A",29,Coristanco,7102,3438,3664
15,"Coruña, A",30,"Coruña, A",246028,114312,131716
15,"Coruña, A",31,Culleredo,29207,14222,14985
15,"Coruña, A",32,Curtis,4214,2104,2110
15,"Coruña, A",33,Dodro,2980,1443,1537
15,"Coruña, A",34,Dumbría,3652,1745,1907
15,"Coruña, A",35,Fene,13902,6673,7229
15,"Coruña, A",36,Ferrol,72963,34320,38643
15,"Coruña, A",37,Fisterra,4983,2512,2471
15,"Coruña, A",38,Frades,2607,1300,1307
15,"Coruña, A",39,Irixoa,1502,750,752
15,"Coruña, A",40,Laxe,3366,1678,1688
15,"Coruña, A",41,"Laracha, A",11337,5566,5771
15,"Coruña, A",42,Lousame,3657,1763,1894
15,"Coruña, A",43,Malpica de Bergantiños,6102,2949,3153
15,"Coruña, A",44,Mañón,1589,775,814
15,"Coruña, A",45,Mazaricos,4720,2271,2449
15,"Coruña, A",46,Melide,7824,3852,3972
15,"Coruña, A",47,Mesía,2922,1461,1461
15,"Coruña, A",48,Miño,5760,2849,2911
15,"Coruña, A",49,Moeche,1363,638,725
15,"Coruña, A",50,Monfero,2178,1106,1072
15,"Coruña, A",51,Mugardos,5481,2661,2820
15,"Coruña, A",52,Muxía,5377,2617,2760
15,"Coruña, A",53,Muros,9565,4630,4935
15,"Coruña, A",54,Narón,38910,18929,19981
15,"Coruña, A",55,Neda,5442,2641,2801
15,"Coruña, A",56,Negreira,7077,3408,3669
15,"Coruña, A",57,Noia,14876,7126,7750
15,"Coruña, A",58,Oleiros,34133,16637,17496
15,"Coruña, A",59,Ordes,12948,6326,6622
15,"Coruña, A",60,Oroso,7174,3576,3598
15,"Coruña, A",61,Ortigueira,6956,3336,3620
15,"Coruña, A",62,Outes,7243,3475,3768
15,"Coruña, A",63,Oza dos Ríos,3229,1622,1607
15,"Coruña, A",64,Paderne,2628,1284,1344
15,"Coruña, A",65,Padrón,8924,4256,4668
15,"Coruña, A",66,"Pino, O",4743,2357,2386
15,"Coruña, A",67,"Pobra do Caramiñal, A",9726,4724,5002
15,"Coruña, A",68,Ponteceso,6134,3071,3063
15,"Coruña, A",69,Pontedeume,8342,4017,4325
15,"Coruña, A",70,"Pontes de García Rodríguez, As",11139,5544,5595
15,"Coruña, A",71,Porto do Son,9847,4912,4935
15,"Coruña, A",72,Rianxo,11780,5784,5996
15,"Coruña, A",73,Ribeira,27699,13748,13951
15,"Coruña, A",74,Rois,4910,2336,2574
15,"Coruña, A",75,Sada,14870,7324,7546
15,"Coruña, A",76,San Sadurniño,3099,1534,1565
15,"Coruña, A",77,Santa Comba,10241,4929,5312
15,"Coruña, A",78,Santiago de Compostela,95207,44320,50887
15,"Coruña, A",79,Santiso,1883,983,900
15,"Coruña, A",80,Sobrado,2087,1055,1032
15,"Coruña, A",81,"Somozas, As",1306,666,640
15,"Coruña, A",82,Teo,18266,8995,9271
15,"Coruña, A",83,Toques,1343,696,647
15,"Coruña, A",84,Tordoia,4168,1966,2202
15,"Coruña, A",85,Touro,4082,2022,2060
15,"Coruña, A",86,Trazo,3472,1700,1772
15,"Coruña, A",87,Valdoviño,6926,3396,3530
15,"Coruña, A",88,Val do Dubra,4313,2090,2223
15,"Coruña, A",89,Vedra,5046,2439,2607
15,"Coruña, A",90,Vilasantar,1380,715,665
15,"Coruña, A",91,Vilarmaior,1273,658,615
15,"Coruña, A",92,Vimianzo,8039,3925,4114
15,"Coruña, A",93,Zas,5219,2555,2664
15,"Coruña, A",901,Cariño,4474,2206,2268
16,Cuenca,1,Abia de la Obispalía,76,49,27
16,Cuenca,2,"Acebrón, El",267,135,132
16,Cuenca,3,Alarcón,189,86,103
16,Cuenca,4,Albaladejo del Cuende,345,178,167
16,Cuenca,5,Albalate de las Nogueras,299,166,133
16,Cuenca,6,Albendea,157,74,83
16,Cuenca,7,"Alberca de Záncara, La",1963,1021,942
16,Cuenca,8,Alcalá de la Vega,152,80,72
16,Cuenca,9,Alcantud,85,47,38
16,Cuenca,10,Alcázar del Rey,200,99,101
16,Cuenca,11,Alcohujate,46,26,20
16,Cuenca,12,Alconchel de la Estrella,142,80,62
16,Cuenca,13,Algarra,25,17,8
16,Cuenca,14,Aliaguilla,760,394,366
16,Cuenca,15,"Almarcha, La",531,291,240
16,Cuenca,16,Almendros,298,157,141
16,Cuenca,17,Almodóvar del Pinar,464,252,212
16,Cuenca,18,Almonacid del Marquesado,478,248,230
16,Cuenca,19,Altarejos,239,121,118
16,Cuenca,20,Arandilla del Arroyo,23,16,7
16,Cuenca,22,Arcos de la Sierra,105,57,48
16,Cuenca,23,Chillarón de Cuenca,586,309,277
16,Cuenca,24,Arguisuelas,151,82,69
16,Cuenca,25,Arrancacepas,33,18,15
16,Cuenca,26,Atalaya del Cañavate,122,60,62
16,Cuenca,27,Barajas de Melo,1086,567,519
16,Cuenca,29,Barchín del Hoyo,92,51,41
16,Cuenca,30,Bascuñana de San Pedro,25,15,10
16,Cuenca,31,Beamud,67,33,34
16,Cuenca,32,Belinchón,369,191,178
16,Cuenca,33,Belmonte,2215,1097,1118
16,Cuenca,34,Belmontejo,219,117,102
16,Cuenca,35,Beteta,334,161,173
16,Cuenca,36,Boniches,156,73,83
16,Cuenca,38,Buciegas,54,27,27
16,Cuenca,39,Buenache de Alarcón,613,333,280
16,Cuenca,40,Buenache de la Sierra,112,70,42
16,Cuenca,41,Buendía,485,252,233
16,Cuenca,42,Campillo de Altobuey,1649,805,844
16,Cuenca,43,Campillos-Paravientos,123,63,60
16,Cuenca,44,Campillos-Sierra,56,28,28
16,Cuenca,45,Canalejas del Arroyo,327,175,152
16,Cuenca,46,Cañada del Hoyo,298,150,148
16,Cuenca,47,Cañada Juncosa,309,170,139
16,Cuenca,48,Cañamares,543,300,243
16,Cuenca,49,"Cañavate, El",164,83,81
16,Cuenca,50,Cañaveras,387,206,181
16,Cuenca,51,Cañaveruelas,179,96,83
16,Cuenca,52,Cañete,967,502,465
16,Cuenca,53,Cañizares,537,287,250
16,Cuenca,55,Carboneras de Guadazaón,827,430,397
16,Cuenca,56,Cardenete,583,299,284
16,Cuenca,57,Carrascosa,117,72,45
16,Cuenca,58,Carrascosa de Haro,133,67,66
16,Cuenca,60,Casas de Benítez,1034,511,523
16,Cuenca,61,Casas de Fernando Alonso,1472,784,688
16,Cuenca,62,Casas de Garcimolina,33,20,13
16,Cuenca,63,Casas de Guijarro,142,78,64
16,Cuenca,64,Casas de Haro,892,474,418
16,Cuenca,65,Casas de los Pinos,582,273,309
16,Cuenca,66,Casasimarro,3344,1734,1610
16,Cuenca,67,Castejón,187,91,96
16,Cuenca,68,Castillejo de Iniesta,197,116,81
16,Cuenca,70,Castillejo-Sierra,35,20,15
16,Cuenca,71,Castillo-Albaráñez,28,12,16
16,Cuenca,72,Castillo de Garcimuñoz,184,101,83
16,Cuenca,73,Cervera del Llano,269,140,129
16,Cuenca,74,"Cierva, La",52,29,23
16,Cuenca,78,Cuenca,56703,27355,29348
16,Cuenca,79,Cueva del Hierro,41,28,13
16,Cuenca,81,Chumillas,68,37,31
16,Cuenca,82,Enguídanos,386,205,181
16,Cuenca,83,Fresneda de Altarejos,63,34,29
16,Cuenca,84,Fresneda de la Sierra,57,28,29
16,Cuenca,85,"Frontera, La",185,100,85
16,Cuenca,86,Fuente de Pedro Naharro,1331,693,638
16,Cuenca,87,Fuentelespino de Haro,277,144,133
16,Cuenca,88,Fuentelespino de Moya,143,75,68
16,Cuenca,89,Fuentes,499,266,233
16,Cuenca,91,Fuertescusa,84,47,37
16,Cuenca,92,Gabaldón,215,124,91
16,Cuenca,93,Garaballa,96,51,45
16,Cuenca,94,Gascueña,213,110,103
16,Cuenca,95,Graja de Campalbo,117,59,58
16,Cuenca,96,Graja de Iniesta,430,226,204
16,Cuenca,97,Henarejos,202,95,107
16,Cuenca,98,"Herrumblar, El",778,401,377
16,Cuenca,99,"Hinojosa, La",255,129,126
16,Cuenca,100,"Hinojosos, Los",1015,505,510
16,Cuenca,101,"Hito, El",181,98,83
16,Cuenca,102,Honrubia,1780,903,877
16,Cuenca,103,Hontanaya,393,209,184
16,Cuenca,104,Hontecillas,81,40,41
16,Cuenca,106,Horcajo de Santiago,4167,2196,1971
16,Cuenca,107,Huélamo,159,87,72
16,Cuenca,108,Huelves,77,38,39
16,Cuenca,109,Huérguina,54,26,28
16,Cuenca,110,Huerta de la Obispalía,118,70,48
16,Cuenca,111,Huerta del Marquesado,223,131,92
16,Cuenca,112,Huete,2004,1021,983
16,Cuenca,113,Iniesta,4679,2325,2354
16,Cuenca,115,Laguna del Marquesado,68,35,33
16,Cuenca,116,Lagunaseca,109,60,49
16,Cuenca,117,Landete,1381,711,670
16,Cuenca,118,Ledaña,1928,969,959
16,Cuenca,119,Leganiel,218,114,104
16,Cuenca,121,"Majadas, Las",324,164,160
16,Cuenca,122,Mariana,286,143,143
16,Cuenca,123,Masegosa,123,68,55
16,Cuenca,124,"Mesas, Las",2560,1334,1226
16,Cuenca,125,Minglanilla,2709,1436,1273
16,Cuenca,126,Mira,806,415,391
16,Cuenca,128,Monreal del Llano,79,41,38
16,Cuenca,129,Montalbanejo,132,65,67
16,Cuenca,130,Montalbo,760,402,358
16,Cuenca,131,Monteagudo de las Salinas,175,102,73
16,Cuenca,132,Mota de Altarejos,42,26,16
16,Cuenca,133,Mota del Cuervo,6376,3232,3144
16,Cuenca,134,Motilla del Palancar,6216,3148,3068
16,Cuenca,135,Moya,201,104,97
16,Cuenca,137,Narboneta,68,39,29
16,Cuenca,139,Olivares de Júcar,397,211,186
16,Cuenca,140,Olmeda de la Cuesta,39,16,23
16,Cuenca,141,Olmeda del Rey,158,77,81
16,Cuenca,142,Olmedilla de Alarcón,154,91,63
16,Cuenca,143,Olmedilla de Eliz,20,11,9
16,Cuenca,145,Osa de la Vega,611,314,297
16,Cuenca,146,Pajarón,96,48,48
16,Cuenca,147,Pajaroncillo,86,48,38
16,Cuenca,148,Palomares del Campo,763,392,371
16,Cuenca,149,Palomera,194,103,91
16,Cuenca,150,Paracuellos,139,65,74
16,Cuenca,151,Paredes,85,49,36
16,Cuenca,152,"Parra de las Vegas, La",46,25,21
16,Cuenca,153,"Pedernoso, El",1301,667,634
16,Cuenca,154,"Pedroñeras, Las",7175,3801,3374
16,Cuenca,155,"Peral, El",859,490,369
16,Cuenca,156,"Peraleja, La",142,75,67
16,Cuenca,157,"Pesquera, La",260,138,122
16,Cuenca,158,"Picazo, El",748,378,370
16,Cuenca,159,Pinarejo,375,187,188
16,Cuenca,160,Pineda de Gigüela,81,38,43
16,Cuenca,161,Piqueras del Castillo,81,41,40
16,Cuenca,162,Portalrubio de Guadamejud,53,29,24
16,Cuenca,163,Portilla,76,37,39
16,Cuenca,165,Poyatos,90,52,38
16,Cuenca,166,Pozoamargo,390,202,188
16,Cuenca,167,Pozorrubio,387,184,203
16,Cuenca,169,"Pozuelo, El",91,53,38
16,Cuenca,170,Priego,1133,572,561
16,Cuenca,171,"Provencio, El",2759,1354,1405
16,Cuenca,172,Puebla de Almenara,492,248,244
16,Cuenca,173,"Valle de Altomira, El",310,171,139
16,Cuenca,174,Puebla del Salvador,244,138,106
16,Cuenca,175,Quintanar del Rey,7945,4161,3784
16,Cuenca,176,Rada de Haro,82,43,39
16,Cuenca,177,Reíllo,119,63,56
16,Cuenca,181,Rozalén del Monte,81,37,44
16,Cuenca,185,Saceda-Trasierra,74,43,31
16,Cuenca,186,Saelices,659,349,310
16,Cuenca,187,Salinas del Manzano,91,52,39
16,Cuenca,188,Salmeroncillos,158,88,70
16,Cuenca,189,Salvacañete,325,170,155
16,Cuenca,190,San Clemente,7367,3750,3617
16,Cuenca,191,San Lorenzo de la Parrilla,1270,644,626
16,Cuenca,192,San Martín de Boniches,56,30,26
16,Cuenca,193,San Pedro Palmiches,83,45,38
16,Cuenca,194,Santa Cruz de Moya,307,164,143
16,Cuenca,195,Santa María del Campo Rus,703,356,347
16,Cuenca,196,Santa María de los Llanos,755,390,365
16,Cuenca,197,Santa María del Val,76,41,35
16,Cuenca,198,Sisante,1929,988,941
16,Cuenca,199,Solera de Gabaldón,31,12,19
16,Cuenca,202,Talayuelas,1053,539,514
16,Cuenca,203,Tarancón,15841,7954,7887
16,Cuenca,204,Tébar,372,194,178
16,Cuenca,205,Tejadillos,142,69,73
16,Cuenca,206,Tinajas,315,173,142
16,Cuenca,209,Torralba,167,93,74
16,Cuenca,211,Torrejoncillo del Rey,541,275,266
16,Cuenca,212,Torrubia del Campo,319,159,160
16,Cuenca,213,Torrubia del Castillo,44,27,17
16,Cuenca,215,Tragacete,343,191,152
16,Cuenca,216,Tresjuncos,391,200,191
16,Cuenca,217,Tribaldos,124,54,70
16,Cuenca,218,Uclés,242,119,123
16,Cuenca,219,Uña,119,60,59
16,Cuenca,224,Valdemeca,110,60,50
16,Cuenca,225,Valdemorillo de la Sierra,87,51,36
16,Cuenca,227,Valdemoro-Sierra,140,81,59
16,Cuenca,228,Valdeolivas,239,144,95
16,Cuenca,231,Valhermoso de la Fuente,43,22,21
16,Cuenca,234,Valsalobre,58,35,23
16,Cuenca,236,Valverde de Júcar,1267,633,634
16,Cuenca,237,Valverdejo,117,60,57
16,Cuenca,238,Vara de Rey,626,327,299
16,Cuenca,239,Vega del Codorno,179,97,82
16,Cuenca,240,Vellisca,139,75,64
16,Cuenca,242,Villaconejos de Trabaque,456,224,232
16,Cuenca,243,Villaescusa de Haro,566,282,284
16,Cuenca,244,Villagarcía del Llano,825,424,401
16,Cuenca,245,Villalba de la Sierra,558,277,281
16,Cuenca,246,Villalba del Rey,613,326,287
16,Cuenca,247,Villalgordo del Marquesado,98,49,49
16,Cuenca,248,Villalpardo,1169,570,599
16,Cuenca,249,Villamayor de Santiago,3050,1582,1468
16,Cuenca,250,Villanueva de Guadamejud,108,63,45
16,Cuenca,251,Villanueva de la Jara,2383,1193,1190
16,Cuenca,253,Villar de Cañas,446,241,205
16,Cuenca,254,Villar de Domingo García,227,117,110
16,Cuenca,255,Villar de la Encina,187,96,91
16,Cuenca,258,Villar del Humo,307,168,139
16,Cuenca,259,Villar del Infantado,44,29,15
16,Cuenca,263,Villar de Olalla,1228,644,584
16,Cuenca,264,Villarejo de Fuentes,692,368,324
16,Cuenca,265,Villarejo de la Peñuela,26,11,15
16,Cuenca,266,Villarejo-Periesteban,433,212,221
16,Cuenca,269,Villares del Saz,626,317,309
16,Cuenca,270,Villarrubio,253,138,115
16,Cuenca,271,Villarta,972,506,466
16,Cuenca,272,Villas de la Ventosa,304,158,146
16,Cuenca,273,Villaverde y Pasaconsol,377,194,183
16,Cuenca,274,Víllora,165,75,90
16,Cuenca,275,Vindel,18,11,7
16,Cuenca,276,Yémeda,40,21,19
16,Cuenca,277,Zafra de Záncara,150,80,70
16,Cuenca,278,Zafrilla,89,43,46
16,Cuenca,279,Zarza de Tajo,337,172,165
16,Cuenca,280,Zarzuela,233,126,107
16,Cuenca,901,Campos del Paraíso,952,472,480
16,Cuenca,902,Valdetórtola,170,98,72
16,Cuenca,903,"Valeras, Las",1767,953,814
16,Cuenca,904,Fuentenava de Jábaga,597,308,289
16,Cuenca,905,Arcas del Villar,1497,751,746
16,Cuenca,906,"Valdecolmenas, Los",109,62,47
16,Cuenca,908,Pozorrubielos de la Mancha,297,150,147
16,Cuenca,909,Sotorribas,850,427,423
16,Cuenca,910,Villar y Velasco,107,61,46
17,Girona,1,Agullana,839,430,409
17,Girona,2,Aiguaviva,754,380,374
17,Girona,3,Albanyà,150,84,66
17,Girona,4,Albons,709,368,341
17,Girona,5,"Far d'Empordà, El",555,274,281
17,Girona,6,Alp,1743,927,816
17,Girona,7,Amer,2277,1127,1150
17,Girona,8,Anglès,5637,2828,2809
17,Girona,9,Arbúcies,6713,3541,3172
17,Girona,10,Argelaguer,424,226,198
17,Girona,11,"Armentera, L'",863,417,446
17,Girona,12,Avinyonet de Puigventós,1509,768,741
17,Girona,13,Begur,4219,2143,2076
17,Girona,14,"Vajol, La",101,59,42
17,Girona,15,Banyoles,19159,9618,9541
17,Girona,16,Bàscara,985,514,471
17,Girona,18,Bellcaire d'Empordà,664,333,331
17,Girona,19,Besalú,2372,1130,1242
17,Girona,20,Bescanó,4601,2284,2317
17,Girona,21,Beuda,170,86,84
17,Girona,22,"Bisbal d'Empordà, La",10435,5267,5168
17,Girona,23,Blanes,39834,20064,19770
17,Girona,24,Bolvir,393,213,180
17,Girona,25,Bordils,1736,869,867
17,Girona,26,Borrassà,709,365,344
17,Girona,27,Breda,3781,1905,1876
17,Girona,28,Brunyola,388,187,201
17,Girona,29,Boadella i les Escaules,253,121,132
17,Girona,30,Cabanes,912,482,430
17,Girona,31,Cabanelles,247,141,106
17,Girona,32,Cadaqués,2902,1431,1471
17,Girona,33,Caldes de Malavella,6998,3481,3517
17,Girona,34,Calonge,10761,5395,5366
17,Girona,35,Camós,684,348,336
17,Girona,36,Campdevànol,3477,1716,1761
17,Girona,37,Campelles,136,67,69
17,Girona,38,Campllong,497,254,243
17,Girona,39,Camprodon,2450,1201,1249
17,Girona,40,Canet d'Adri,609,307,302
17,Girona,41,Cantallops,326,168,158
17,Girona,42,Capmany,623,336,287
17,Girona,43,Queralbs,186,104,82
17,Girona,44,Cassà de la Selva,9789,5075,4714
17,Girona,46,Castellfollit de la Roca,1002,512,490
17,Girona,47,Castelló d'Empúries,11885,6081,5804
17,Girona,48,Castell-Platja d'Aro,10420,5198,5222
17,Girona,49,Celrà,4772,2378,2394
17,Girona,50,Cervià de Ter,895,449,446
17,Girona,51,Cistella,272,136,136
17,Girona,52,Siurana,181,95,86
17,Girona,54,Colera,593,308,285
17,Girona,55,Colomers,196,97,99
17,Girona,56,Cornellà del Terri,2233,1129,1104
17,Girona,57,Corçà,1317,635,682
17,Girona,58,Crespià,260,133,127
17,Girona,60,Darnius,528,273,255
17,Girona,61,Das,219,126,93
17,Girona,62,"Escala, L'",10554,5404,5150
17,Girona,63,Espinelves,199,95,104
17,Girona,64,Espolla,417,207,210
17,Girona,65,Esponellà,451,219,232
17,Girona,66,Figueres,44765,22286,22479
17,Girona,67,Flaçà,1059,513,546
17,Girona,68,Foixà,318,167,151
17,Girona,69,Fontanals de Cerdanya,465,228,237
17,Girona,70,Fontanilles,167,97,70
17,Girona,71,Fontcoberta,1349,651,698
17,Girona,73,Fornells de la Selva,2380,1163,1217
17,Girona,74,Fortià,658,333,325
17,Girona,75,Garrigàs,386,201,185
17,Girona,76,Garrigoles,164,89,75
17,Girona,77,Garriguella,863,431,432
17,Girona,78,Ger,467,253,214
17,Girona,79,Girona,96722,46675,50047
17,Girona,80,Gombrèn,209,100,109
17,Girona,81,Gualta,358,196,162
17,Girona,82,Guils de Cerdanya,565,294,271
17,Girona,83,Hostalric,4030,2045,1985
17,Girona,84,Isòvol,322,180,142
17,Girona,85,Jafre,413,217,196
17,Girona,86,"Jonquera, La",3094,1564,1530
17,Girona,87,Juià,338,191,147
17,Girona,88,Lladó,713,352,361
17,Girona,89,Llagostera,8105,4183,3922
17,Girona,90,Llambilles,717,373,344
17,Girona,91,Llanars,561,291,270
17,Girona,92,Llançà,5140,2576,2564
17,Girona,93,Llers,1193,608,585
17,Girona,94,Llívia,1665,901,764
17,Girona,95,Lloret de Mar,40282,21164,19118
17,Girona,96,"Llosses, Les",221,128,93
17,Girona,97,Madremanya,260,123,137
17,Girona,98,Maià de Montcal,432,225,207
17,Girona,99,Meranges,96,54,42
17,Girona,100,Masarac,296,161,135
17,Girona,101,Massanes,700,364,336
17,Girona,102,Maçanet de Cabrenys,735,372,363
17,Girona,103,Maçanet de la Selva,7099,3653,3446
17,Girona,105,Mieres,335,172,163
17,Girona,106,Mollet de Peralada,178,87,91
17,Girona,107,Molló,358,175,183
17,Girona,109,Montagut i Oix,983,517,466
17,Girona,110,Mont-ras,1833,927,906
17,Girona,111,Navata,1227,613,614
17,Girona,112,Ogassa,251,148,103
17,Girona,114,Olot,33725,16814,16911
17,Girona,115,Ordis,379,204,175
17,Girona,116,Osor,456,227,229
17,Girona,117,Palafrugell,22816,11444,11372
17,Girona,118,Palamós,17918,8822,9096
17,Girona,119,Palau de Santa Eulàlia,104,63,41
17,Girona,120,Palau-saverdera,1488,740,748
17,Girona,121,Palau-sator,294,155,139
17,Girona,123,Palol de Revardit,471,245,226
17,Girona,124,Pals,2725,1379,1346
17,Girona,125,Pardines,159,91,68
17,Girona,126,Parlavà,383,198,185
17,Girona,128,Pau,589,294,295
17,Girona,129,Pedret i Marzà,175,92,83
17,Girona,130,"Pera, La",435,217,218
17,Girona,132,Peralada,1846,931,915
17,Girona,133,"Planes d'Hostoles, Les",1708,865,843
17,Girona,134,Planoles,309,167,142
17,Girona,135,Pont de Molins,509,267,242
17,Girona,136,Pontós,233,127,106
17,Girona,137,Porqueres,4431,2185,2246
17,Girona,138,Portbou,1290,644,646
17,Girona,139,"Preses, Les",1745,843,902
17,Girona,140,"Port de la Selva, El",1009,539,470
17,Girona,141,Puigcerdà,8802,4440,4362
17,Girona,142,Quart,3150,1597,1553
17,Girona,143,Rabós,196,102,94
17,Girona,144,Regencós,301,162,139
17,Girona,145,Ribes de Freser,1941,956,985
17,Girona,146,Riells i Viabrea,3993,2063,1930
17,Girona,147,Ripoll,10913,5393,5520
17,Girona,148,Riudarenes,2183,1113,1070
17,Girona,149,Riudaura,439,218,221
17,Girona,150,Riudellots de la Selva,2022,1047,975
17,Girona,151,Riumors,247,127,120
17,Girona,152,Roses,19731,9947,9784
17,Girona,153,Rupià,241,120,121
17,Girona,154,Sales de Llierca,144,77,67
17,Girona,155,Salt,30389,16216,14173
17,Girona,157,Sant Andreu Salou,152,76,76
17,Girona,158,Sant Climent Sescebes,545,290,255
17,Girona,159,Sant Feliu de Buixalleu,768,403,365
17,Girona,160,Sant Feliu de Guíxols,21814,10830,10984
17,Girona,161,Sant Feliu de Pallerols,1330,647,683
17,Girona,162,Sant Ferriol,228,134,94
17,Girona,163,Sant Gregori,3280,1662,1618
17,Girona,164,Sant Hilari Sacalm,5724,2939,2785
17,Girona,165,Sant Jaume de Llierca,774,389,385
17,Girona,166,Sant Jordi Desvalls,667,323,344
17,Girona,167,Sant Joan de les Abadesses,3492,1736,1756
17,Girona,168,Sant Joan de Mollet,522,264,258
17,Girona,169,Sant Julià de Ramis,3348,1686,1662
17,Girona,170,Vallfogona de Ripollès,223,121,102
17,Girona,171,Sant Llorenç de la Muga,227,117,110
17,Girona,172,Sant Martí de Llémena,591,306,285
17,Girona,173,Sant Martí Vell,258,137,121
17,Girona,174,Sant Miquel de Campmajor,234,121,113
17,Girona,175,Sant Miquel de Fluvià,764,390,374
17,Girona,176,Sant Mori,193,100,93
17,Girona,177,Sant Pau de Segúries,694,347,347
17,Girona,178,Sant Pere Pescador,2108,1133,975
17,Girona,180,Santa Coloma de Farners,12305,6293,6012
17,Girona,181,Santa Cristina d'Aro,5066,2582,2484
17,Girona,182,Santa Llogaia d'Àlguema,342,177,165
17,Girona,183,Sant Aniol de Finestres,345,184,161
17,Girona,184,Santa Pau,1601,807,794
17,Girona,185,Sant Joan les Fonts,2877,1456,1421
17,Girona,186,Sarrià de Ter,4714,2343,2371
17,Girona,187,"Saus,  Camallera i Llampaies",780,372,408
17,Girona,188,"Selva de Mar, La",209,111,98
17,Girona,189,"Cellera de Ter, La",2105,1055,1050
17,Girona,190,Serinyà,1117,569,548
17,Girona,191,Serra de Daró,209,113,96
17,Girona,192,Setcases,176,95,81
17,Girona,193,Sils,5492,2799,2693
17,Girona,194,Susqueda,115,68,47
17,Girona,195,"Tallada d'Empordà, La",449,224,225
17,Girona,196,Terrades,311,157,154
17,Girona,197,Torrent,189,100,89
17,Girona,198,Torroella de Fluvià,699,354,345
17,Girona,199,Torroella de Montgrí,11385,5770,5615
17,Girona,200,Tortellà,760,380,380
17,Girona,201,Toses,161,99,62
17,Girona,202,Tossa de Mar,5917,3023,2894
17,Girona,203,Ultramort,211,113,98
17,Girona,204,Ullà,1075,590,485
17,Girona,205,Ullastret,268,138,130
17,Girona,206,Urús,204,99,105
17,Girona,207,"Vall d'en Bas, La",2888,1443,1445
17,Girona,208,"Vall de Bianya, La",1315,667,648
17,Girona,209,Vall-llobrega,877,439,438
17,Girona,210,Ventalló,800,406,394
17,Girona,211,Verges,1207,600,607
17,Girona,212,Vidrà,167,88,79
17,Girona,213,Vidreres,7661,3967,3694
17,Girona,214,Vilabertran,902,463,439
17,Girona,215,Vilablareix,2401,1186,1215
17,Girona,216,Viladasens,210,110,100
17,Girona,217,Viladamat,458,242,216
17,Girona,218,Vilademuls,780,397,383
17,Girona,220,Viladrau,1102,558,544
17,Girona,221,Vilafant,5465,2726,2739
17,Girona,222,Vilaür,149,72,77
17,Girona,223,Vilajuïga,1166,575,591
17,Girona,224,Vilallonga de Ter,476,258,218
17,Girona,225,Vilamacolum,299,159,140
17,Girona,226,Vilamalla,1115,593,522
17,Girona,227,Vilamaniscle,171,100,71
17,Girona,228,Vilanant,373,181,192
17,Girona,230,Vila-sacra,656,321,335
17,Girona,232,Vilopriu,212,117,95
17,Girona,233,Vilobí d'Onyar,3031,1578,1453
17,Girona,234,Biure,248,127,121
17,Girona,901,"Cruïlles,  Monells i Sant Sadurní de l'Heura",1282,651,631
17,Girona,902,Forallac,1785,875,910
17,Girona,903,Sant Julià del Llor i Bonmatí,1271,646,625
18,Granada,1,Agrón,330,182,148
18,Granada,2,Alamedilla,704,364,340
18,Granada,3,Albolote,17892,8956,8936
18,Granada,4,Albondón,905,509,396
18,Granada,5,Albuñán,431,229,202
18,Granada,6,Albuñol,6686,3521,3165
18,Granada,7,Albuñuelas,956,483,473
18,Granada,10,Aldeire,677,349,328
18,Granada,11,Alfacar,5508,2810,2698
18,Granada,12,Algarinejo,3413,1734,1679
18,Granada,13,Alhama de Granada,6188,3279,2909
18,Granada,14,Alhendín,7362,3810,3552
18,Granada,15,Alicún de Ortega,528,287,241
18,Granada,16,Almegíjar,427,229,198
18,Granada,17,Almuñécar,27754,13729,14025
18,Granada,18,Alquife,738,365,373
18,Granada,20,Arenas del Rey,1981,1056,925
18,Granada,21,Armilla,22283,11175,11108
18,Granada,22,Atarfe,16432,8250,8182
18,Granada,23,Baza,22092,11093,10999
18,Granada,24,Beas de Granada,1023,548,475
18,Granada,25,Beas de Guadix,385,199,186
18,Granada,27,Benalúa,3370,1685,1685
18,Granada,28,Benalúa de las Villas,1381,776,605
18,Granada,29,Benamaurel,2471,1243,1228
18,Granada,30,Bérchules,828,441,387
18,Granada,32,Bubión,343,181,162
18,Granada,33,Busquístar,306,171,135
18,Granada,34,Cacín,609,302,307
18,Granada,35,Cádiar,1652,879,773
18,Granada,36,Cájar,4714,2264,2450
18,Granada,37,Calicasas,581,293,288
18,Granada,38,Campotéjar,1380,715,665
18,Granada,39,Caniles,4846,2447,2399
18,Granada,40,Cáñar,418,213,205
18,Granada,42,Capileira,537,271,266
18,Granada,43,Carataunas,200,102,98
18,Granada,44,Cástaras,277,155,122
18,Granada,45,Castilléjar,1553,776,777
18,Granada,46,Castril,2402,1231,1171
18,Granada,47,Cenes de la Vega,7771,3983,3788
18,Granada,48,Cijuela,3086,1575,1511
18,Granada,49,Cogollos de Guadix,747,402,345
18,Granada,50,Cogollos de la Vega,2029,1020,1009
18,Granada,51,Colomera,1507,806,701
18,Granada,53,Cortes de Baza,2265,1126,1139
18,Granada,54,Cortes y Graena,1071,541,530
18,Granada,56,Cúllar,4653,2340,2313
18,Granada,57,Cúllar Vega,7019,3558,3461
18,Granada,59,Chauchina,4768,2374,2394
18,Granada,61,Chimeneas,1485,777,708
18,Granada,62,Churriana de la Vega,12902,6431,6471
18,Granada,63,Darro,1467,726,741
18,Granada,64,Dehesas de Guadix,499,245,254
18,Granada,66,Deifontes,2567,1299,1268
18,Granada,67,Diezma,784,409,375
18,Granada,68,Dílar,1757,878,879
18,Granada,69,Dólar,620,323,297
18,Granada,70,Dúdar,322,174,148
18,Granada,71,Dúrcal,7333,3655,3678
18,Granada,72,Escúzar,783,399,384
18,Granada,74,Ferreira,343,180,163
18,Granada,76,Fonelas,1093,559,534
18,Granada,78,Freila,1092,549,543
18,Granada,79,Fuente Vaqueros,4325,2145,2180
18,Granada,82,Galera,1236,616,620
18,Granada,83,Gobernador,308,151,157
18,Granada,84,Gójar,5315,2733,2582
18,Granada,85,Gor,924,475,449
18,Granada,86,Gorafe,471,237,234
18,Granada,87,Granada,240099,111629,128470
18,Granada,88,Guadahortuna,2013,1039,974
18,Granada,89,Guadix,20375,10087,10288
18,Granada,93,Gualchos,4672,2445,2227
18,Granada,94,Güejar Sierra,3023,1594,1429
18,Granada,95,Güevéjar,2501,1301,1200
18,Granada,96,Huélago,351,185,166
18,Granada,97,Huéneja,1261,642,619
18,Granada,98,Huéscar,8131,4030,4101
18,Granada,99,Huétor de Santillán,1880,970,910
18,Granada,100,Huétor Tájar,10134,5126,5008
18,Granada,101,Huétor Vega,11770,5907,5863
18,Granada,102,Illora,10346,5163,5183
18,Granada,103,Itrabo,1169,597,572
18,Granada,105,Iznalloz,7003,3610,3393
18,Granada,107,Jayena,1162,594,568
18,Granada,108,Jerez del Marquesado,1079,551,528
18,Granada,109,Jete,888,480,408
18,Granada,111,Jun,3438,1773,1665
18,Granada,112,Juviles,167,84,83
18,Granada,114,"Calahorra, La",797,412,385
18,Granada,115,Láchar,3179,1606,1573
18,Granada,116,Lanjarón,3859,1924,1935
18,Granada,117,Lanteira,572,295,277
18,Granada,119,Lecrín,2271,1155,1116
18,Granada,120,Lentegí,336,180,156
18,Granada,121,Lobras,160,81,79
18,Granada,122,Loja,21618,10845,10773
18,Granada,123,Lugros,342,185,157
18,Granada,124,Lújar,453,241,212
18,Granada,126,"Malahá, La",1828,943,885
18,Granada,127,Maracena,21264,10531,10733
18,Granada,128,Marchal,418,193,225
18,Granada,132,Moclín,4213,2112,2101
18,Granada,133,Molvízar,3203,1641,1562
18,Granada,134,Monachil,7399,3800,3599
18,Granada,135,Montefrío,6152,3090,3062
18,Granada,136,Montejícar,2442,1233,1209
18,Granada,137,Montillana,1404,739,665
18,Granada,138,Moraleda de Zafayona,3281,1680,1601
18,Granada,140,Motril,60887,30162,30725
18,Granada,141,Murtas,648,384,264
18,Granada,143,Nigüelas,1181,581,600
18,Granada,144,Nívar,923,485,438
18,Granada,145,Ogíjares,13345,6648,6697
18,Granada,146,Orce,1321,683,638
18,Granada,147,Órgiva,5756,2886,2870
18,Granada,148,Otívar,1193,609,584
18,Granada,149,Otura,6747,3433,3314
18,Granada,150,Padul,8416,4238,4178
18,Granada,151,Pampaneira,363,188,175
18,Granada,152,Pedro Martínez,1273,620,653
18,Granada,153,Peligros,11021,5525,5496
18,Granada,154,"Peza, La",1303,692,611
18,Granada,157,Pinos Genil,1363,720,643
18,Granada,158,Pinos Puente,13314,6699,6615
18,Granada,159,Píñar,1299,712,587
18,Granada,161,Polícar,229,117,112
18,Granada,162,Polopos,1904,1037,867
18,Granada,163,Pórtugos,384,202,182
18,Granada,164,Puebla de Don Fadrique,2415,1249,1166
18,Granada,165,Pulianas,5143,2585,2558
18,Granada,167,Purullena,2260,1140,1120
18,Granada,168,Quéntar,1025,529,496
18,Granada,170,Rubite,456,255,201
18,Granada,171,Salar,2790,1420,1370
18,Granada,173,Salobreña,12790,6390,6400
18,Granada,174,Santa Cruz del Comercio,594,309,285
18,Granada,175,Santa Fe,15367,7584,7783
18,Granada,176,Soportújar,280,151,129
18,Granada,177,Sorvilán,592,307,285
18,Granada,178,Torre-Cardela,937,466,471
18,Granada,179,Torvizcón,755,400,355
18,Granada,180,Trevélez,823,427,396
18,Granada,181,Turón,291,169,122
18,Granada,182,Ugíjar,2711,1358,1353
18,Granada,183,Válor,710,364,346
18,Granada,184,Vélez de Benaudalla,2947,1489,1458
18,Granada,185,Ventas de Huelma,704,365,339
18,Granada,187,Villanueva de las Torres,699,388,311
18,Granada,188,Villanueva Mesía,2137,1082,1055
18,Granada,189,Víznar,907,469,438
18,Granada,192,Zafarraya,2167,1199,968
18,Granada,193,"Zubia, La",18412,9082,9330
18,Granada,194,Zújar,3018,1596,1422
18,Granada,901,"Taha, La",810,412,398
18,Granada,902,"Valle, El",1161,575,586
18,Granada,903,Nevada,1165,592,573
18,Granada,904,Alpujarra de la Sierra,1141,607,534
18,Granada,905,"Gabias, Las",17970,9229,8741
18,Granada,906,"Guajares, Los",1194,659,535
18,Granada,907,Valle del Zalabí,2315,1184,1131
18,Granada,908,Villamena,1052,525,527
18,Granada,909,Morelábor,765,401,364
18,Granada,910,"Pinar, El",1009,505,504
18,Granada,911,Vegas del Genil,9472,4854,4618
18,Granada,912,Cuevas del Campo,1979,987,992
18,Granada,913,Zagra,959,479,480
19,Guadalajara,1,Abánades,75,40,35
19,Guadalajara,2,Ablanque,98,57,41
19,Guadalajara,3,Adobes,52,25,27
19,Guadalajara,4,Alaminos,67,35,32
19,Guadalajara,5,Alarilla,138,84,54
19,Guadalajara,6,Albalate de Zorita,1125,627,498
19,Guadalajara,7,Albares,567,297,270
19,Guadalajara,8,Albendiego,43,30,13
19,Guadalajara,9,Alcocer,347,176,171
19,Guadalajara,10,Alcolea de las Peñas,19,12,7
19,Guadalajara,11,Alcolea del Pinar,407,228,179
19,Guadalajara,13,Alcoroches,166,100,66
19,Guadalajara,15,Aldeanueva de Guadalajara,107,55,52
19,Guadalajara,16,Algar de Mesa,77,41,36
19,Guadalajara,17,Algora,113,66,47
19,Guadalajara,18,Alhóndiga,206,113,93
19,Guadalajara,19,Alique,24,9,15
19,Guadalajara,20,Almadrones,90,56,34
19,Guadalajara,21,Almoguera,1477,778,699
19,Guadalajara,22,Almonacid de Zorita,806,383,423
19,Guadalajara,23,Alocén,170,92,78
19,Guadalajara,24,Alovera,11717,5983,5734
19,Guadalajara,27,Alustante,226,137,89
19,Guadalajara,31,Angón,20,13,7
19,Guadalajara,32,Anguita,228,124,104
19,Guadalajara,33,Anquela del Ducado,85,49,36
19,Guadalajara,34,Anquela del Pedregal,24,18,6
19,Guadalajara,36,Aranzueque,465,244,221
19,Guadalajara,37,Arbancón,187,107,80
19,Guadalajara,38,Arbeteta,51,30,21
19,Guadalajara,39,Argecilla,81,50,31
19,Guadalajara,40,Armallones,75,43,32
19,Guadalajara,41,Armuña de Tajuña,273,144,129
19,Guadalajara,42,Arroyo de las Fraguas,41,23,18
19,Guadalajara,43,Atanzón,104,64,40
19,Guadalajara,44,Atienza,473,262,211
19,Guadalajara,45,Auñón,194,110,84
19,Guadalajara,46,Azuqueca de Henares,34195,17672,16523
19,Guadalajara,47,Baides,97,51,46
19,Guadalajara,48,Baños de Tajo,20,15,5
19,Guadalajara,49,Bañuelos,25,17,8
19,Guadalajara,50,Barriopedro,23,11,12
19,Guadalajara,51,Berninches,86,48,38
19,Guadalajara,52,"Bodera, La",35,22,13
19,Guadalajara,53,Brihuega,2818,1461,1357
19,Guadalajara,54,Budia,228,127,101
19,Guadalajara,55,Bujalaro,73,40,33
19,Guadalajara,57,Bustares,81,48,33
19,Guadalajara,58,Cabanillas del Campo,9477,4765,4712
19,Guadalajara,59,Campillo de Dueñas,96,55,41
19,Guadalajara,60,Campillo de Ranas,195,119,76
19,Guadalajara,61,Campisábalos,93,59,34
19,Guadalajara,64,Canredondo,109,59,50
19,Guadalajara,65,Cantalojas,172,99,73
19,Guadalajara,66,Cañizar,84,44,40
19,Guadalajara,67,"Cardoso de la Sierra, El",77,50,27
19,Guadalajara,70,Casa de Uceda,135,74,61
19,Guadalajara,71,"Casar, El",11269,5797,5472
19,Guadalajara,73,Casas de San Galindo,28,16,12
19,Guadalajara,74,Caspueñas,111,67,44
19,Guadalajara,75,Castejón de Henares,92,51,41
19,Guadalajara,76,Castellar de la Muela,38,19,19
19,Guadalajara,78,Castilforte,73,47,26
19,Guadalajara,79,Castilnuevo,11,6,5
19,Guadalajara,80,Cendejas de Enmedio,104,56,48
19,Guadalajara,81,Cendejas de la Torre,41,25,16
19,Guadalajara,82,Centenera,112,56,56
19,Guadalajara,86,Cifuentes,2109,1078,1031
19,Guadalajara,87,Cincovillas,25,14,11
19,Guadalajara,88,Ciruelas,144,83,61
19,Guadalajara,89,Ciruelos del Pinar,37,20,17
19,Guadalajara,90,Cobeta,129,59,70
19,Guadalajara,91,Cogollor,33,19,14
19,Guadalajara,92,Cogolludo,671,381,290
19,Guadalajara,95,Condemios de Abajo,23,16,7
19,Guadalajara,96,Condemios de Arriba,153,81,72
19,Guadalajara,97,Congostrina,36,22,14
19,Guadalajara,98,Copernal,41,28,13
19,Guadalajara,99,Corduente,415,223,192
19,Guadalajara,102,"Cubillo de Uceda, El",182,93,89
19,Guadalajara,103,Checa,340,199,141
19,Guadalajara,104,Chequilla,18,9,9
19,Guadalajara,105,Chiloeches,3077,1607,1470
19,Guadalajara,106,Chillarón del Rey,124,67,57
19,Guadalajara,107,Driebes,443,235,208
19,Guadalajara,108,Durón,120,60,60
19,Guadalajara,109,Embid,53,30,23
19,Guadalajara,110,Escamilla,89,45,44
19,Guadalajara,111,Escariche,212,118,94
19,Guadalajara,112,Escopete,79,40,39
19,Guadalajara,113,Espinosa de Henares,816,434,382
19,Guadalajara,114,Esplegares,44,28,16
19,Guadalajara,115,Establés,47,27,20
19,Guadalajara,116,Estriégana,18,11,7
19,Guadalajara,117,Fontanar,2276,1197,1079
19,Guadalajara,118,Fuembellida,16,10,6
19,Guadalajara,119,Fuencemillán,139,84,55
19,Guadalajara,120,Fuentelahiguera de Albatages,132,74,58
19,Guadalajara,121,Fuentelencina,351,186,165
19,Guadalajara,122,Fuentelsaz,112,55,57
19,Guadalajara,123,Fuentelviejo,50,27,23
19,Guadalajara,124,Fuentenovilla,613,343,270
19,Guadalajara,125,Gajanejos,59,36,23
19,Guadalajara,126,Galápagos,2174,1155,1019
19,Guadalajara,127,Galve de Sorbe,125,69,56
19,Guadalajara,129,Gascueña de Bornova,67,42,25
19,Guadalajara,130,Guadalajara,84453,41412,43041
19,Guadalajara,132,Henche,111,58,53
19,Guadalajara,133,Heras de Ayuso,261,151,110
19,Guadalajara,134,Herrería,24,16,8
19,Guadalajara,135,Hiendelaencina,155,81,74
19,Guadalajara,136,Hijes,28,17,11
19,Guadalajara,138,Hita,416,230,186
19,Guadalajara,139,Hombrados,37,23,14
19,Guadalajara,142,Hontoba,335,182,153
19,Guadalajara,143,Horche,2484,1288,1196
19,Guadalajara,145,Hortezuela de Océn,70,40,30
19,Guadalajara,146,"Huerce, La",61,35,26
19,Guadalajara,147,Huérmeces del Cerro,62,36,26
19,Guadalajara,148,Huertahernando,65,42,23
19,Guadalajara,150,Hueva,146,80,66
19,Guadalajara,151,Humanes,1521,763,758
19,Guadalajara,152,Illana,929,531,398
19,Guadalajara,153,Iniéstola,23,17,6
19,Guadalajara,154,"Inviernas, Las",88,50,38
19,Guadalajara,155,Irueste,62,40,22
19,Guadalajara,156,Jadraque,1652,856,796
19,Guadalajara,157,Jirueque,69,45,24
19,Guadalajara,159,Ledanca,119,62,57
19,Guadalajara,160,Loranca de Tajuña,1434,780,654
19,Guadalajara,161,Lupiana,266,139,127
19,Guadalajara,162,Luzaga,90,49,41
19,Guadalajara,163,Luzón,77,37,40
19,Guadalajara,165,Majaelrayo,64,40,24
19,Guadalajara,166,Málaga del Fresno,205,115,90
19,Guadalajara,167,Malaguilla,154,87,67
19,Guadalajara,168,Mandayona,377,192,185
19,Guadalajara,169,Mantiel,70,38,32
19,Guadalajara,170,Maranchón,288,156,132
19,Guadalajara,171,Marchamalo,6042,3125,2917
19,Guadalajara,172,Masegoso de Tajuña,85,51,34
19,Guadalajara,173,Matarrubia,65,44,21
19,Guadalajara,174,Matillas,168,80,88
19,Guadalajara,175,Mazarete,51,25,26
19,Guadalajara,176,Mazuecos,325,170,155
19,Guadalajara,177,Medranda,100,53,47
19,Guadalajara,178,Megina,55,35,20
19,Guadalajara,179,Membrillera,124,63,61
19,Guadalajara,181,Miedes de Atienza,83,47,36
19,Guadalajara,182,"Mierla, La",42,27,15
19,Guadalajara,183,Milmarcos,114,63,51
19,Guadalajara,184,Millana,151,84,67
19,Guadalajara,185,"Miñosa, La",42,26,16
19,Guadalajara,186,Mirabueno,105,60,45
19,Guadalajara,187,Miralrío,88,49,39
19,Guadalajara,188,Mochales,76,42,34
19,Guadalajara,189,Mohernando,212,109,103
19,Guadalajara,190,Molina de Aragón,3670,1864,1806
19,Guadalajara,191,Monasterio,18,8,10
19,Guadalajara,192,Mondéjar,2705,1408,1297
19,Guadalajara,193,Montarrón,36,20,16
19,Guadalajara,194,Moratilla de los Meleros,144,81,63
19,Guadalajara,195,Morenilla,47,28,19
19,Guadalajara,196,Muduex,116,59,57
19,Guadalajara,197,"Navas de Jadraque, Las",30,19,11
19,Guadalajara,198,Negredo,23,12,11
19,Guadalajara,199,Ocentejo,25,15,10
19,Guadalajara,200,"Olivar, El",195,110,85
19,Guadalajara,201,Olmeda de Cobeta,81,38,43
19,Guadalajara,202,"Olmeda de Jadraque, La",18,9,9
19,Guadalajara,203,"Ordial, El",37,18,19
19,Guadalajara,204,Orea,242,150,92
19,Guadalajara,208,Pálmaces de Jadraque,70,41,29
19,Guadalajara,209,Pardos,57,29,28
19,Guadalajara,210,Paredes de Sigüenza,38,21,17
19,Guadalajara,211,Pareja,543,309,234
19,Guadalajara,212,Pastrana,1089,565,524
19,Guadalajara,213,"Pedregal, El",84,50,34
19,Guadalajara,214,Peñalén,100,54,46
19,Guadalajara,215,Peñalver,232,138,94
19,Guadalajara,216,Peralejos de las Truchas,160,87,73
19,Guadalajara,217,Peralveche,103,63,40
19,Guadalajara,218,Pinilla de Jadraque,62,34,28
19,Guadalajara,219,Pinilla de Molina,25,13,12
19,Guadalajara,220,Pioz,3341,1792,1549
19,Guadalajara,221,Piqueras,63,43,20
19,Guadalajara,222,"Pobo de Dueñas, El",150,79,71
19,Guadalajara,223,Poveda de la Sierra,152,87,65
19,Guadalajara,224,Pozo de Almoguera,122,65,57
19,Guadalajara,225,Pozo de Guadalajara,1330,694,636
19,Guadalajara,226,Prádena de Atienza,43,29,14
19,Guadalajara,227,Prados Redondos,110,58,52
19,Guadalajara,228,Puebla de Beleña,56,33,23
19,Guadalajara,229,Puebla de Valles,85,46,39
19,Guadalajara,230,Quer,661,353,308
19,Guadalajara,231,Rebollosa de Jadraque,20,12,8
19,Guadalajara,232,"Recuenco, El",89,51,38
19,Guadalajara,233,Renera,122,72,50
19,Guadalajara,234,Retiendas,76,41,35
19,Guadalajara,235,Riba de Saelices,130,78,52
19,Guadalajara,237,Rillo de Gallo,61,36,25
19,Guadalajara,238,Riofrío del Llano,49,29,20
19,Guadalajara,239,Robledillo de Mohernando,120,63,57
19,Guadalajara,240,Robledo de Corpes,67,34,33
19,Guadalajara,241,Romanillos de Atienza,46,28,18
19,Guadalajara,242,Romanones,131,75,56
19,Guadalajara,243,Rueda de la Sierra,56,34,22
19,Guadalajara,244,Sacecorbo,114,68,46
19,Guadalajara,245,Sacedón,1863,999,864
19,Guadalajara,246,Saelices de la Sal,58,33,25
19,Guadalajara,247,Salmerón,196,106,90
19,Guadalajara,248,San Andrés del Congosto,95,60,35
19,Guadalajara,249,San Andrés del Rey,38,16,22
19,Guadalajara,250,Santiuste,22,15,7
19,Guadalajara,251,Saúca,48,25,23
19,Guadalajara,252,Sayatón,116,67,49
19,Guadalajara,254,Selas,66,34,32
19,Guadalajara,255,Setiles,103,63,40
19,Guadalajara,256,Sienes,70,41,29
19,Guadalajara,257,Sigüenza,4947,2501,2446
19,Guadalajara,258,Solanillos del Extremo,117,66,51
19,Guadalajara,259,Somolinos,36,16,20
19,Guadalajara,260,"Sotillo, El",49,26,23
19,Guadalajara,261,Sotodosos,50,21,29
19,Guadalajara,262,Tamajón,184,98,86
19,Guadalajara,263,Taragudo,47,25,22
19,Guadalajara,264,Taravilla,49,29,20
19,Guadalajara,265,Tartanedo,167,95,72
19,Guadalajara,266,Tendilla,410,213,197
19,Guadalajara,267,Terzaga,22,13,9
19,Guadalajara,268,Tierzo,40,26,14
19,Guadalajara,269,"Toba, La",119,64,55
19,Guadalajara,270,Tordelrábano,20,12,8
19,Guadalajara,271,Tordellego,62,32,30
19,Guadalajara,272,Tordesilos,121,70,51
19,Guadalajara,274,Torija,1528,823,705
19,Guadalajara,277,Torrecuadrada de Molina,21,12,9
19,Guadalajara,278,Torrecuadradilla,35,20,15
19,Guadalajara,279,Torre del Burgo,214,111,103
19,Guadalajara,280,Torrejón del Rey,5041,2663,2378
19,Guadalajara,281,Torremocha de Jadraque,36,23,13
19,Guadalajara,282,Torremocha del Campo,244,136,108
19,Guadalajara,283,Torremocha del Pinar,51,22,29
19,Guadalajara,284,Torremochuela,12,7,5
19,Guadalajara,285,Torrubia,25,14,11
19,Guadalajara,286,Tórtola de Henares,939,513,426
19,Guadalajara,287,Tortuera,223,120,103
19,Guadalajara,288,Tortuero,20,13,7
19,Guadalajara,289,Traíd,35,20,15
19,Guadalajara,290,Trijueque,1392,752,640
19,Guadalajara,291,Trillo,1483,758,725
19,Guadalajara,293,Uceda,2604,1356,1248
19,Guadalajara,294,Ujados,30,17,13
19,Guadalajara,296,Utande,48,32,16
19,Guadalajara,297,Valdarachas,42,22,20
19,Guadalajara,298,Valdearenas,103,63,40
19,Guadalajara,299,Valdeavellano,115,68,47
19,Guadalajara,300,Valdeaveruelo,1052,554,498
19,Guadalajara,301,Valdeconcha,51,31,20
19,Guadalajara,302,Valdegrudas,75,48,27
19,Guadalajara,303,Valdelcubo,73,45,28
19,Guadalajara,304,Valdenuño Fernández,286,157,129
19,Guadalajara,305,Valdepeñas de la Sierra,198,111,87
19,Guadalajara,306,Valderrebollo,54,25,29
19,Guadalajara,307,Valdesotos,30,16,14
19,Guadalajara,308,Valfermoso de Tajuña,69,38,31
19,Guadalajara,309,Valhermoso,39,25,14
19,Guadalajara,310,Valtablado del Río,13,9,4
19,Guadalajara,311,Valverde de los Arroyos,94,52,42
19,Guadalajara,314,Viana de Jadraque,50,33,17
19,Guadalajara,317,Villanueva de Alcorón,189,99,90
19,Guadalajara,318,Villanueva de Argecilla,40,23,17
19,Guadalajara,319,Villanueva de la Torre,6284,3181,3103
19,Guadalajara,321,Villares de Jadraque,68,43,25
19,Guadalajara,322,Villaseca de Henares,40,22,18
19,Guadalajara,323,Villaseca de Uceda,59,32,27
19,Guadalajara,324,Villel de Mesa,219,118,101
19,Guadalajara,325,Viñuelas,142,81,61
19,Guadalajara,326,Yebes,1719,898,821
19,Guadalajara,327,Yebra,670,346,324
19,Guadalajara,329,Yélamos de Abajo,70,35,35
19,Guadalajara,330,Yélamos de Arriba,120,68,52
19,Guadalajara,331,Yunquera de Henares,3645,1860,1785
19,Guadalajara,332,"Yunta, La",117,64,53
19,Guadalajara,333,Zaorejas,162,104,58
19,Guadalajara,334,Zarzuela de Jadraque,49,31,18
19,Guadalajara,335,Zorita de los Canes,110,57,53
19,Guadalajara,901,Semillas,42,25,17
20,Gipuzkoa,1,Abaltzisketa,321,178,143
20,Gipuzkoa,2,Aduna,452,246,206
20,Gipuzkoa,3,Aizarnazabal,733,386,347
20,Gipuzkoa,4,Albiztur,312,162,150
20,Gipuzkoa,5,Alegia,1778,910,868
20,Gipuzkoa,6,Alkiza,357,192,165
20,Gipuzkoa,7,Altzo,405,217,188
20,Gipuzkoa,8,Amezketa,970,510,460
20,Gipuzkoa,9,Andoain,14689,7324,7365
20,Gipuzkoa,10,Anoeta,1832,952,880
20,Gipuzkoa,11,Antzuola,2187,1098,1089
20,Gipuzkoa,12,Arama,201,102,99
20,Gipuzkoa,13,Aretxabaleta,6725,3438,3287
20,Gipuzkoa,14,Asteasu,1491,796,695
20,Gipuzkoa,15,Ataun,1669,883,786
20,Gipuzkoa,16,Aia,2002,1087,915
20,Gipuzkoa,17,Azkoitia,11417,5728,5689
20,Gipuzkoa,18,Azpeitia,14351,7213,7138
20,Gipuzkoa,19,Beasain,13717,6901,6816
20,Gipuzkoa,20,Beizama,182,113,69
20,Gipuzkoa,21,Belauntza,287,162,125
20,Gipuzkoa,22,Berastegi,1061,565,496
20,Gipuzkoa,23,Berrobi,578,305,273
20,Gipuzkoa,24,Bidegoian,533,288,245
20,Gipuzkoa,25,Zegama,1553,813,740
20,Gipuzkoa,26,Zerain,257,123,134
20,Gipuzkoa,27,Zestoa,3655,1915,1740
20,Gipuzkoa,28,Zizurkil,2797,1417,1380
20,Gipuzkoa,29,Deba,5420,2715,2705
20,Gipuzkoa,30,Eibar,27396,13292,14104
20,Gipuzkoa,31,Elduain,232,121,111
20,Gipuzkoa,32,Elgoibar,11360,5659,5701
20,Gipuzkoa,33,Elgeta,1106,567,539
20,Gipuzkoa,34,Eskoriatza,4043,2080,1963
20,Gipuzkoa,35,Ezkio-Itsaso,609,319,290
20,Gipuzkoa,36,Hondarribia,16499,8252,8247
20,Gipuzkoa,37,Gaintza,130,73,57
20,Gipuzkoa,38,Gabiria,493,271,222
20,Gipuzkoa,39,Getaria,2666,1338,1328
20,Gipuzkoa,40,Hernani,19296,9446,9850
20,Gipuzkoa,41,Hernialde,359,192,167
20,Gipuzkoa,42,Ibarra,4290,2199,2091
20,Gipuzkoa,43,Idiazabal,2280,1156,1124
20,Gipuzkoa,44,Ikaztegieta,470,246,224
20,Gipuzkoa,45,Irun,61006,29841,31165
20,Gipuzkoa,46,Irura,1619,837,782
20,Gipuzkoa,47,Itsasondo,663,332,331
20,Gipuzkoa,48,Larraul,244,132,112
20,Gipuzkoa,49,Lazkao,5407,2747,2660
20,Gipuzkoa,50,Leaburu,383,194,189
20,Gipuzkoa,51,Legazpi,8684,4448,4236
20,Gipuzkoa,52,Legorreta,1526,775,751
20,Gipuzkoa,53,Lezo,6028,2993,3035
20,Gipuzkoa,54,Lizartza,644,346,298
20,Gipuzkoa,55,Arrasate/Mondragón,21972,10893,11079
20,Gipuzkoa,56,Mutriku,5029,2530,2499
20,Gipuzkoa,57,Mutiloa,246,132,114
20,Gipuzkoa,58,Olaberria,937,476,461
20,Gipuzkoa,59,Oñati,11033,5482,5551
20,Gipuzkoa,60,Orexa,122,67,55
20,Gipuzkoa,61,Orio,5270,2664,2606
20,Gipuzkoa,62,Ormaiztegi,1320,673,647
20,Gipuzkoa,63,Oiartzun,10006,5028,4978
20,Gipuzkoa,64,Pasaia,15945,7598,8347
20,Gipuzkoa,65,Soraluze/Placencia de las Armas,3995,2011,1984
20,Gipuzkoa,66,Errezil,607,324,283
20,Gipuzkoa,67,Errenteria,39217,19189,20028
20,Gipuzkoa,68,Leintz-Gatzaga,272,150,122
20,Gipuzkoa,69,Donostia-San Sebastián,186185,87287,98898
20,Gipuzkoa,70,Segura,1488,750,738
20,Gipuzkoa,71,Tolosa,18232,8786,9446
20,Gipuzkoa,72,Urnieta,6167,3105,3062
20,Gipuzkoa,73,Usurbil,6062,3104,2958
20,Gipuzkoa,74,Bergara,14577,7238,7339
20,Gipuzkoa,75,Villabona,5863,2959,2904
20,Gipuzkoa,76,Ordizia,9811,4901,4910
20,Gipuzkoa,77,Urretxu,6930,3494,3436
20,Gipuzkoa,78,Zaldibia,1517,794,723
20,Gipuzkoa,79,Zarautz,22697,11135,11562
20,Gipuzkoa,80,Zumarraga,10007,4979,5028
20,Gipuzkoa,81,Zumaia,9461,4700,4761
20,Gipuzkoa,901,Mendaro,1929,996,933
20,Gipuzkoa,902,Lasarte-Oria,17889,8813,9076
20,Gipuzkoa,903,Astigarraga,4818,2464,2354
20,Gipuzkoa,904,Baliarrain,122,64,58
20,Gipuzkoa,905,Orendain,186,92,94
20,Gipuzkoa,906,Altzaga,160,82,78
20,Gipuzkoa,907,Gaztelu,170,98,72
21,Huelva,1,Alájar,798,407,391
21,Huelva,2,Aljaraque,18937,9480,9457
21,Huelva,3,"Almendro, El",870,459,411
21,Huelva,4,Almonaster la Real,1849,922,927
21,Huelva,5,Almonte,22525,11292,11233
21,Huelva,6,Alosno,4285,2075,2210
21,Huelva,7,Aracena,7812,3866,3946
21,Huelva,8,Aroche,3282,1641,1641
21,Huelva,9,Arroyomolinos de León,1031,528,503
21,Huelva,10,Ayamonte,20763,10480,10283
21,Huelva,11,Beas,4353,2177,2176
21,Huelva,12,Berrocal,349,165,184
21,Huelva,13,Bollullos Par del Condado,14055,7011,7044
21,Huelva,14,Bonares,6189,3108,3081
21,Huelva,15,Cabezas Rubias,847,453,394
21,Huelva,16,Cala,1302,647,655
21,Huelva,17,Calañas,4187,2062,2125
21,Huelva,18,"Campillo, El",2208,1057,1151
21,Huelva,19,Campofrío,811,408,403
21,Huelva,20,Cañaveral de León,441,214,227
21,Huelva,21,Cartaya,19044,9840,9204
21,Huelva,22,Castaño del Robledo,214,122,92
21,Huelva,23,"Cerro de Andévalo, El",2439,1189,1250
21,Huelva,24,Corteconcepción,608,307,301
21,Huelva,25,Cortegana,4896,2460,2436
21,Huelva,26,Cortelazor,301,149,152
21,Huelva,27,Cumbres de Enmedio,65,38,27
21,Huelva,28,Cumbres de San Bartolomé,453,221,232
21,Huelva,29,Cumbres Mayores,1930,970,960
21,Huelva,30,Chucena,2148,1087,1061
21,Huelva,31,Encinasola,1540,794,746
21,Huelva,32,Escacena del Campo,2077,1037,1040
21,Huelva,33,Fuenteheridos,582,299,283
21,Huelva,34,Galaroza,1599,789,810
21,Huelva,35,Gibraleón,12587,6294,6293
21,Huelva,36,"Granada de Río-Tinto, La",240,119,121
21,Huelva,37,"Granado, El",567,316,251
21,Huelva,38,Higuera de la Sierra,1407,704,703
21,Huelva,39,Hinojales,358,182,176
21,Huelva,40,Hinojos,3924,1971,1953
21,Huelva,41,Huelva,148918,72032,76886
21,Huelva,42,Isla Cristina,21903,10885,11018
21,Huelva,43,Jabugo,2358,1171,1187
21,Huelva,44,Lepe,27241,14018,13223
21,Huelva,45,Linares de la Sierra,297,150,147
21,Huelva,46,Lucena del Puerto,3202,1632,1570
21,Huelva,47,Manzanilla,2300,1175,1125
21,Huelva,48,"Marines, Los",347,174,173
21,Huelva,49,Minas de Riotinto,4157,2008,2149
21,Huelva,50,Moguer,20418,10196,10222
21,Huelva,51,"Nava, La",324,163,161
21,Huelva,52,Nerva,5831,2812,3019
21,Huelva,53,Niebla,4169,2128,2041
21,Huelva,54,"Palma del Condado, La",10547,5280,5267
21,Huelva,55,Palos de la Frontera,9377,4689,4688
21,Huelva,56,Paterna del Campo,3688,1901,1787
21,Huelva,57,Paymogo,1308,648,660
21,Huelva,58,Puebla de Guzmán,3124,1602,1522
21,Huelva,59,Puerto Moral,272,135,137
21,Huelva,60,Punta Umbría,14899,7597,7302
21,Huelva,61,Rociana del Condado,7573,3799,3774
21,Huelva,62,Rosal de la Frontera,1913,966,947
21,Huelva,63,San Bartolomé de la Torre,3566,1788,1778
21,Huelva,64,San Juan del Puerto,8374,4205,4169
21,Huelva,65,Sanlúcar de Guadiana,440,224,216
21,Huelva,66,San Silvestre de Guzmán,731,397,334
21,Huelva,67,Santa Ana la Real,520,234,286
21,Huelva,68,Santa Bárbara de Casa,1177,577,600
21,Huelva,69,Santa Olalla del Cala,2190,1121,1069
21,Huelva,70,Trigueros,7820,3897,3923
21,Huelva,71,Valdelarco,254,119,135
21,Huelva,72,Valverde del Camino,12827,6273,6554
21,Huelva,73,Villablanca,2916,1502,1414
21,Huelva,74,Villalba del Alcor,3433,1687,1746
21,Huelva,75,Villanueva de las Cruces,418,198,220
21,Huelva,76,Villanueva de los Castillejos,2762,1381,1381
21,Huelva,77,Villarrasa,2191,1092,1099
21,Huelva,78,Zalamea la Real,3380,1694,1686
21,Huelva,79,Zufre,930,472,458
22,Huesca,1,Abiego,280,148,132
22,Huesca,2,Abizanda,139,71,68
22,Huesca,3,Adahuesca,176,85,91
22,Huesca,4,Agüero,160,91,69
22,Huesca,6,Aisa,379,210,169
22,Huesca,7,Albalate de Cinca,1259,665,594
22,Huesca,8,Albalatillo,237,122,115
22,Huesca,9,Albelda,839,447,392
22,Huesca,11,Albero Alto,134,78,56
22,Huesca,12,Albero Bajo,109,58,51
22,Huesca,13,Alberuela de Tubo,355,181,174
22,Huesca,14,Alcalá de Gurrea,275,137,138
22,Huesca,15,Alcalá del Obispo,411,243,168
22,Huesca,16,Alcampell,762,388,374
22,Huesca,17,Alcolea de Cinca,1137,592,545
22,Huesca,18,Alcubierre,439,231,208
22,Huesca,19,Alerre,222,114,108
22,Huesca,20,Alfántega,130,61,69
22,Huesca,21,Almudévar,2560,1318,1242
22,Huesca,22,Almunia de San Juan,661,344,317
22,Huesca,23,Almuniente,550,286,264
22,Huesca,24,Alquézar,302,168,134
22,Huesca,25,Altorricón,1492,817,675
22,Huesca,27,Angüés,439,229,210
22,Huesca,28,Ansó,475,244,231
22,Huesca,29,Antillón,146,79,67
22,Huesca,32,Aragüés del Puerto,133,71,62
22,Huesca,35,Arén,359,194,165
22,Huesca,36,Argavieso,118,72,46
22,Huesca,37,Arguis,117,70,47
22,Huesca,39,Ayerbe,1125,567,558
22,Huesca,40,Azanuy-Alins,181,93,88
22,Huesca,41,Azara,200,102,98
22,Huesca,42,Azlor,133,67,66
22,Huesca,43,Baélls,114,66,48
22,Huesca,44,Bailo,300,181,119
22,Huesca,45,Baldellou,119,66,53
22,Huesca,46,Ballobar,974,497,477
22,Huesca,47,Banastás,283,147,136
22,Huesca,48,Barbastro,17085,8375,8710
22,Huesca,49,Barbués,96,51,45
22,Huesca,50,Barbuñales,101,53,48
22,Huesca,51,Bárcabo,126,74,52
22,Huesca,52,Belver de Cinca,1374,750,624
22,Huesca,53,Benabarre,1180,616,564
22,Huesca,54,Benasque,2236,1167,1069
22,Huesca,55,Berbegal,417,219,198
22,Huesca,57,Bielsa,495,251,244
22,Huesca,58,Bierge,254,143,111
22,Huesca,59,Biescas,1597,865,732
22,Huesca,60,Binaced,1485,764,721
22,Huesca,61,Binéfar,9482,4979,4503
22,Huesca,62,Bisaurri,206,103,103
22,Huesca,63,Biscarrués,223,118,105
22,Huesca,64,Blecua y Torres,215,118,97
22,Huesca,66,Boltaña,1055,579,476
22,Huesca,67,Bonansa,102,55,47
22,Huesca,68,Borau,85,49,36
22,Huesca,69,Broto,543,288,255
22,Huesca,72,Caldearenas,231,130,101
22,Huesca,74,Campo,350,171,179
22,Huesca,75,Camporrélls,182,100,82
22,Huesca,76,Canal de Berdún,382,208,174
22,Huesca,77,Candasnos,395,206,189
22,Huesca,78,Canfranc,620,341,279
22,Huesca,79,Capdesaso,176,74,102
22,Huesca,80,Capella,372,196,176
22,Huesca,81,Casbas de Huesca,303,161,142
22,Huesca,82,Castejón del Puente,372,190,182
22,Huesca,83,Castejón de Monegros,649,340,309
22,Huesca,84,Castejón de Sos,776,406,370
22,Huesca,85,Castelflorite,128,68,60
22,Huesca,86,Castiello de Jaca,257,138,119
22,Huesca,87,Castigaleu,115,61,54
22,Huesca,88,Castillazuelo,197,91,106
22,Huesca,89,Castillonroy,380,190,190
22,Huesca,90,Colungo,142,80,62
22,Huesca,94,Chalamera,122,62,60
22,Huesca,95,Chía,102,61,41
22,Huesca,96,Chimillas,358,181,177
22,Huesca,99,Esplús,654,334,320
22,Huesca,102,Estada,234,133,101
22,Huesca,103,Estadilla,853,412,441
22,Huesca,105,Estopiñán del Castillo,174,97,77
22,Huesca,106,Fago,30,15,15
22,Huesca,107,Fanlo,132,81,51
22,Huesca,109,Fiscal,318,177,141
22,Huesca,110,Fonz,1021,519,502
22,Huesca,111,Foradada del Toscar,211,113,98
22,Huesca,112,Fraga,14426,7423,7003
22,Huesca,113,"Fueva, La",634,332,302
22,Huesca,114,Gistaín,150,81,69
22,Huesca,115,"Grado, El",484,256,228
22,Huesca,116,Grañén,1988,1008,980
22,Huesca,117,Graus,3697,1907,1790
22,Huesca,119,Gurrea de Gállego,1651,858,793
22,Huesca,122,Hoz de Jaca,70,35,35
22,Huesca,124,Huerto,267,142,125
22,Huesca,125,Huesca,52443,25379,27064
22,Huesca,126,Ibieca,109,61,48
22,Huesca,127,Igriés,666,344,322
22,Huesca,128,Ilche,237,122,115
22,Huesca,129,Isábena,305,166,139
22,Huesca,130,Jaca,13299,6635,6664
22,Huesca,131,Jasa,113,68,45
22,Huesca,133,Labuerda,169,89,80
22,Huesca,135,Laluenga,216,119,97
22,Huesca,136,Lalueza,1089,563,526
22,Huesca,137,Lanaja,1381,725,656
22,Huesca,139,Laperdiguera,102,53,49
22,Huesca,141,Lascellas-Ponzano,148,83,65
22,Huesca,142,Lascuarre,155,84,71
22,Huesca,143,Laspaúles,302,171,131
22,Huesca,144,Laspuña,301,162,139
22,Huesca,149,Loarre,369,203,166
22,Huesca,150,Loporzano,563,314,249
22,Huesca,151,Loscorrales,108,52,56
22,Huesca,155,Monesma y Cajigar,100,55,45
22,Huesca,156,Monflorite-Lascasas,315,168,147
22,Huesca,157,Montanuy,284,167,117
22,Huesca,158,Monzón,17215,8838,8377
22,Huesca,160,Naval,258,132,126
22,Huesca,162,Novales,175,84,91
22,Huesca,163,Nueno,559,314,245
22,Huesca,164,Olvena,55,25,30
22,Huesca,165,Ontiñena,597,305,292
22,Huesca,167,Osso de Cinca,768,398,370
22,Huesca,168,Palo,29,16,13
22,Huesca,170,Panticosa,820,422,398
22,Huesca,172,Peñalba,765,400,365
22,Huesca,173,"Peñas de Riglos, Las",269,165,104
22,Huesca,174,Peralta de Alcofea,619,318,301
22,Huesca,175,Peralta de Calasanz,243,136,107
22,Huesca,176,Peraltilla,212,110,102
22,Huesca,177,Perarrúa,112,60,52
22,Huesca,178,Pertusa,117,70,47
22,Huesca,181,Piracés,103,59,44
22,Huesca,182,Plan,327,171,156
22,Huesca,184,Poleñino,224,119,105
22,Huesca,186,Pozán de Vero,241,118,123
22,Huesca,187,"Puebla de Castro, La",416,211,205
22,Huesca,188,Puente de Montañana,143,64,79
22,Huesca,189,Puértolas,233,127,106
22,Huesca,190,"Pueyo de Araguás, El",151,90,61
22,Huesca,193,Pueyo de Santa Cruz,371,192,179
22,Huesca,195,Quicena,290,151,139
22,Huesca,197,Robres,606,314,292
22,Huesca,199,Sabiñánigo,10345,5258,5087
22,Huesca,200,Sahún,342,183,159
22,Huesca,201,Salas Altas,310,158,152
22,Huesca,202,Salas Bajas,140,61,79
22,Huesca,203,Salillas,106,58,48
22,Huesca,204,Sallent de Gállego,1536,779,757
22,Huesca,205,San Esteban de Litera,509,267,242
22,Huesca,206,Sangarrén,231,116,115
22,Huesca,207,San Juan de Plan,157,87,70
22,Huesca,208,Santa Cilia,208,113,95
22,Huesca,209,Santa Cruz de la Serós,189,108,81
22,Huesca,212,Santaliestra y San Quílez,97,50,47
22,Huesca,213,Sariñena,4402,2281,2121
22,Huesca,214,Secastilla,155,69,86
22,Huesca,215,Seira,151,82,69
22,Huesca,217,Sena,549,298,251
22,Huesca,218,Senés de Alcubierre,64,31,33
22,Huesca,220,Sesa,209,113,96
22,Huesca,221,Sesué,131,76,55
22,Huesca,222,Siétamo,658,357,301
22,Huesca,223,Sopeira,118,67,51
22,Huesca,225,Tamarite de Litera,3711,1891,1820
22,Huesca,226,Tardienta,998,508,490
22,Huesca,227,Tella-Sin,272,153,119
22,Huesca,228,Tierz,715,367,348
22,Huesca,229,Tolva,160,96,64
22,Huesca,230,Torla,327,172,155
22,Huesca,232,Torralba de Aragón,107,55,52
22,Huesca,233,Torre la Ribera,119,61,58
22,Huesca,234,Torrente de Cinca,1337,712,625
22,Huesca,235,Torres de Alcanadre,109,60,49
22,Huesca,236,Torres de Barbués,301,148,153
22,Huesca,239,Tramaced,98,60,38
22,Huesca,242,Valfarta,90,51,39
22,Huesca,243,Valle de Bardají,50,27,23
22,Huesca,244,Valle de Lierp,66,37,29
22,Huesca,245,Velilla de Cinca,449,233,216
22,Huesca,246,Veracruz,104,61,43
22,Huesca,247,Viacamp y Litera,48,31,17
22,Huesca,248,Vicién,119,67,52
22,Huesca,249,Villanova,157,75,82
22,Huesca,250,Villanúa,512,274,238
22,Huesca,251,Villanueva de Sigena,478,240,238
22,Huesca,252,Yebra de Basa,152,86,66
22,Huesca,253,Yésero,69,43,26
22,Huesca,254,Zaidín,1689,854,835
22,Huesca,901,Valle de Hecho,947,488,459
22,Huesca,902,Puente la Reina de Jaca,290,159,131
22,Huesca,903,San Miguel del Cinca,849,431,418
22,Huesca,904,"Sotonera, La",1040,551,489
22,Huesca,905,Lupiñén-Ortilla,389,200,189
22,Huesca,906,Santa María de Dulcis,219,120,99
22,Huesca,907,Aínsa-Sobrarbe,2232,1150,1082
22,Huesca,908,Hoz y Costean,208,117,91
22,Huesca,909,Vencillón,467,247,220
23,Jaén,1,Albanchez de Mágina,1229,623,606
23,Jaén,2,Alcalá la Real,22758,11307,11451
23,Jaén,3,Alcaudete,11265,5638,5627
23,Jaén,4,Aldeaquemada,560,293,267
23,Jaén,5,Andújar,39095,19298,19797
23,Jaén,6,Arjona,5771,2876,2895
23,Jaén,7,Arjonilla,3837,1910,1927
23,Jaén,8,Arquillos,1967,981,986
23,Jaén,9,Baeza,16411,8164,8247
23,Jaén,10,Bailén,18741,9446,9295
23,Jaén,11,Baños de la Encina,2714,1403,1311
23,Jaén,12,Beas de Segura,5763,3037,2726
23,Jaén,14,Begíjar,3168,1585,1583
23,Jaén,15,Bélmez de la Moraleda,1763,867,896
23,Jaén,16,Benatae,546,289,257
23,Jaén,17,Cabra del Santo Cristo,2055,1076,979
23,Jaén,18,Cambil,2921,1510,1411
23,Jaén,19,Campillo de Arenas,2055,1092,963
23,Jaén,20,Canena,2114,1096,1018
23,Jaén,21,Carboneros,661,347,314
23,Jaén,24,"Carolina, La",15978,7893,8085
23,Jaén,25,Castellar,3573,1827,1746
23,Jaén,26,Castillo de Locubín,4697,2335,2362
23,Jaén,27,Cazalilla,918,450,468
23,Jaén,28,Cazorla,8030,3876,4154
23,Jaén,29,Chiclana de Segura,1176,612,564
23,Jaén,30,Chilluévar,1589,785,804
23,Jaén,31,Escañuela,995,499,496
23,Jaén,32,Espelúy,746,375,371
23,Jaén,33,Frailes,1734,867,867
23,Jaén,34,Fuensanta de Martos,3236,1588,1648
23,Jaén,35,Fuerte del Rey,1381,706,675
23,Jaén,37,Génave,640,343,297
23,Jaén,38,"Guardia de Jaén, La",4465,2323,2142
23,Jaén,39,Guarromán,2869,1446,1423
23,Jaén,40,Lahiguera,1878,932,946
23,Jaén,41,Higuera de Calatrava,670,353,317
23,Jaén,42,Hinojares,435,232,203
23,Jaén,43,Hornos,675,332,343
23,Jaén,44,Huelma,6174,3057,3117
23,Jaén,45,Huesa,2662,1341,1321
23,Jaén,46,Ibros,3097,1542,1555
23,Jaén,47,"Iruela, La",2055,1042,1013
23,Jaén,48,Iznatoraf,1083,579,504
23,Jaén,49,Jabalquinto,2422,1230,1192
23,Jaén,50,Jaén,116781,56476,60305
23,Jaén,51,Jamilena,3494,1780,1714
23,Jaén,52,Jimena,1415,682,733
23,Jaén,53,Jódar,12120,6007,6113
23,Jaén,54,Larva,494,254,240
23,Jaén,55,Linares,61110,29922,31188
23,Jaén,56,Lopera,3918,1947,1971
23,Jaén,57,Lupión,1001,490,511
23,Jaén,58,Mancha Real,11162,5606,5556
23,Jaén,59,Marmolejo,7380,3703,3677
23,Jaén,60,Martos,24739,12167,12572
23,Jaén,61,Mengíbar,9732,4885,4847
23,Jaén,62,Montizón,1897,991,906
23,Jaén,63,Navas de San Juan,5000,2509,2491
23,Jaén,64,Noalejo,2095,1070,1025
23,Jaén,65,Orcera,1999,1000,999
23,Jaén,66,Peal de Becerro,5581,2857,2724
23,Jaén,67,Pegalajar,3095,1549,1546
23,Jaén,69,Porcuna,6828,3454,3374
23,Jaén,70,Pozo Alcón,5378,2784,2594
23,Jaén,71,Puente de Génave,2332,1175,1157
23,Jaén,72,"Puerta de Segura, La",2615,1303,1312
23,Jaén,73,Quesada,5841,2945,2896
23,Jaén,74,Rus,3821,1981,1840
23,Jaén,75,Sabiote,4275,2134,2141
23,Jaén,76,Santa Elena,996,534,462
23,Jaén,77,Santiago de Calatrava,838,435,403
23,Jaén,79,Santisteban del Puerto,4806,2478,2328
23,Jaén,80,Santo Tomé,2483,1292,1191
23,Jaén,81,Segura de la Sierra,1977,985,992
23,Jaén,82,Siles,2451,1242,1209
23,Jaén,84,Sorihuela del Guadalimar,1334,683,651
23,Jaén,85,Torreblascopedro,2856,1449,1407
23,Jaén,86,Torre del Campo,14625,7342,7283
23,Jaén,87,Torredonjimeno,14141,6961,7180
23,Jaén,88,Torreperogil,7710,3807,3903
23,Jaén,90,Torres,1643,820,823
23,Jaén,91,Torres de Albánchez,970,497,473
23,Jaén,92,Úbeda,35866,17624,18242
23,Jaén,93,Valdepeñas de Jaén,4108,2042,2066
23,Jaén,94,Vilches,4867,2471,2396
23,Jaén,95,Villacarrillo,11357,5793,5564
23,Jaén,96,Villanueva de la Reina,3334,1684,1650
23,Jaén,97,Villanueva del Arzobispo,8924,4709,4215
23,Jaén,98,Villardompardo,1111,556,555
23,Jaén,99,"Villares, Los",5871,2904,2967
23,Jaén,101,Villarrodrigo,449,231,218
23,Jaén,901,Cárcheles,1488,778,710
23,Jaén,902,Bedmar y Garcíez,3112,1553,1559
23,Jaén,903,Villatorres,4431,2256,2175
23,Jaén,904,Santiago-Pontones,3655,1871,1784
23,Jaén,905,Arroyo del Ojanco,2522,1313,1209
24,León,1,Acebedo,264,162,102
24,León,2,Algadefe,315,163,152
24,León,3,Alija del Infantado,827,419,408
24,León,4,Almanza,615,345,270
24,León,5,"Antigua, La",467,261,206
24,León,6,Ardón,609,321,288
24,León,7,Arganza,901,466,435
24,León,8,Astorga,11897,5643,6254
24,León,9,Balboa,371,201,170
24,León,10,"Bañeza, La",10899,5276,5623
24,León,11,Barjas,251,132,119
24,León,12,"Barrios de Luna, Los",317,173,144
24,León,14,Bembibre,10060,4981,5079
24,León,15,Benavides,2808,1399,1409
24,León,16,Benuza,591,321,270
24,León,17,Bercianos del Páramo,682,342,340
24,León,18,Bercianos del Real Camino,195,98,97
24,León,19,Berlanga del Bierzo,400,188,212
24,León,20,Boca de Huérgano,523,303,220
24,León,21,Boñar,2074,1048,1026
24,León,22,Borrenes,410,208,202
24,León,23,Brazuelo,329,174,155
24,León,24,"Burgo Ranero, El",826,454,372
24,León,25,Burón,360,217,143
24,León,26,Bustillo del Páramo,1448,754,694
24,León,27,Cabañas Raras,1310,669,641
24,León,28,Cabreros del Río,461,242,219
24,León,29,Cabrillanes,936,479,457
24,León,30,Cacabelos,5495,2756,2739
24,León,31,Calzada del Coto,259,147,112
24,León,32,Campazas,146,71,75
24,León,33,Campo de Villavidel,216,115,101
24,León,34,Camponaraya,4241,2139,2102
24,León,36,Candín,339,174,165
24,León,37,Cármenes,448,239,209
24,León,38,Carracedelo,3686,1811,1875
24,León,39,Carrizo,2521,1283,1238
24,León,40,Carrocera,548,279,269
24,León,41,Carucedo,642,328,314
24,León,42,Castilfalé,84,46,38
24,León,43,Castrillo de Cabrera,152,81,71
24,León,44,Castrillo de la Valduerna,185,85,100
24,León,46,Castrocalbón,1058,552,506
24,León,47,Castrocontrigo,907,464,443
24,León,49,Castropodame,1801,925,876
24,León,50,Castrotierra de Valmadrigal,126,67,59
24,León,51,Cea,515,267,248
24,León,52,Cebanico,187,105,82
24,León,53,Cebrones del Río,559,300,259
24,León,54,Cimanes de la Vega,559,285,274
24,León,55,Cimanes del Tejar,822,428,394
24,León,56,Cistierna,3709,1798,1911
24,León,57,Congosto,1692,826,866
24,León,58,Corbillos de los Oteros,240,128,112
24,León,59,Corullón,1098,559,539
24,León,60,Crémenes,679,353,326
24,León,61,Cuadros,2019,1014,1005
24,León,62,Cubillas de los Oteros,158,84,74
24,León,63,Cubillas de Rueda,486,255,231
24,León,64,Cubillos del Sil,1830,960,870
24,León,65,Chozas de Abajo,2438,1271,1167
24,León,66,Destriana,602,283,319
24,León,67,Encinedo,846,438,408
24,León,68,"Ercina, La",542,275,267
24,León,69,Escobar de Campos,54,34,20
24,León,70,Fabero,5218,2549,2669
24,León,71,Folgoso de la Ribera,1232,600,632
24,León,73,Fresno de la Vega,637,315,322
24,León,74,Fuentes de Carbajal,118,63,55
24,León,76,Garrafe de Torío,1336,709,627
24,León,77,Gordaliza del Pino,290,146,144
24,León,78,Gordoncillo,495,251,244
24,León,79,Gradefes,1118,580,538
24,León,80,Grajal de Campos,254,119,135
24,León,81,Gusendos de los Oteros,150,84,66
24,León,82,Hospital de Órbigo,1018,491,527
24,León,83,Igüeña,1385,722,663
24,León,84,Izagre,209,112,97
24,León,86,Joarilla de las Matas,361,191,170
24,León,87,Laguna Dalga,743,389,354
24,León,88,Laguna de Negrillos,1158,583,575
24,León,89,León,132744,60944,71800
24,León,90,Lucillo,416,218,198
24,León,91,Luyego,778,387,391
24,León,92,Llamas de la Ribera,942,479,463
24,León,93,Magaz de Cepeda,405,201,204
24,León,94,Mansilla de las Mulas,1950,1010,940
24,León,95,Mansilla Mayor,342,174,168
24,León,96,Maraña,160,91,69
24,León,97,Matadeón de los Oteros,278,143,135
24,León,98,Matallana de Torío,1429,735,694
24,León,99,Matanza,231,126,105
24,León,100,Molinaseca,854,450,404
24,León,101,Murias de Paredes,501,241,260
24,León,102,Noceda del Bierzo,780,385,395
24,León,103,Oencia,378,222,156
24,León,104,"Omañas, Las",314,164,150
24,León,105,Onzonilla,1761,926,835
24,León,106,Oseja de Sajambre,317,186,131
24,León,107,Pajares de los Oteros,383,239,144
24,León,108,Palacios de la Valduerna,453,220,233
24,León,109,Palacios del Sil,1202,655,547
24,León,110,Páramo del Sil,1464,747,717
24,León,112,Peranzanes,345,195,150
24,León,113,Pobladura de Pelayo García,436,220,216
24,León,114,"Pola de Gordón, La",3989,1986,2003
24,León,115,Ponferrada,68508,33027,35481
24,León,116,Posada de Valdeón,491,285,206
24,León,117,Pozuelo del Páramo,516,263,253
24,León,118,Prado de la Guzpeña,141,75,66
24,León,119,Priaranza del Bierzo,841,422,419
24,León,120,Prioro,405,219,186
24,León,121,Puebla de Lillo,710,395,315
24,León,122,Puente de Domingo Flórez,1655,855,800
24,León,123,Quintana del Castillo,881,478,403
24,León,124,Quintana del Marco,444,236,208
24,León,125,Quintana y Congosto,509,254,255
24,León,127,Regueras de Arriba,345,185,160
24,León,129,Reyero,130,66,64
24,León,130,Riaño,538,311,227
24,León,131,Riego de la Vega,896,455,441
24,León,132,Riello,717,393,324
24,León,133,Rioseco de Tapia,415,218,197
24,León,134,"Robla, La",4581,2343,2238
24,León,136,Roperuelos del Páramo,642,332,310
24,León,137,Sabero,1407,691,716
24,León,139,Sahagún,2820,1381,1439
24,León,141,San Adrián del Valle,132,68,64
24,León,142,San Andrés del Rabanedo,31562,15321,16241
24,León,143,Sancedo,560,278,282
24,León,144,San Cristóbal de la Polantera,856,431,425
24,León,145,San Emiliano,706,375,331
24,León,146,San Esteban de Nogales,298,151,147
24,León,148,San Justo de la Vega,2026,1034,992
24,León,149,San Millán de los Caballeros,187,97,90
24,León,150,San Pedro Bercianos,282,148,134
24,León,151,Santa Colomba de Curueño,568,289,279
24,León,152,Santa Colomba de Somoza,505,273,232
24,León,153,Santa Cristina de Valmadrigal,308,160,148
24,León,154,Santa Elena de Jamuz,1227,634,593
24,León,155,Santa María de la Isla,568,297,271
24,León,156,Santa María del Monte de Cea,276,144,132
24,León,157,Santa María del Páramo,3174,1576,1598
24,León,158,Santa María de Ordás,351,172,179
24,León,159,Santa Marina del Rey,2127,1056,1071
24,León,160,Santas Martas,878,469,409
24,León,161,Santiago Millas,373,196,177
24,León,162,Santovenia de la Valdoncina,1977,1008,969
24,León,163,Sariegos,4568,2311,2257
24,León,164,Sena de Luna,418,201,217
24,León,165,Sobrado,376,189,187
24,León,166,Soto de la Vega,1769,917,852
24,León,167,Soto y Amío,917,454,463
24,León,168,Toral de los Guzmanes,603,325,278
24,León,169,Toreno,3691,1813,1878
24,León,170,Torre del Bierzo,2562,1295,1267
24,León,171,Trabadelo,456,253,203
24,León,172,Truchas,529,263,266
24,León,173,Turcia,1130,563,567
24,León,174,Urdiales del Páramo,575,298,277
24,León,175,Valdefresno,2056,1058,998
24,León,176,Valdefuentes del Páramo,365,199,166
24,León,177,Valdelugueros,552,304,248
24,León,178,Valdemora,88,40,48
24,León,179,Valdepiélago,384,205,179
24,León,180,Valdepolo,1312,682,630
24,León,181,Valderas,2008,1020,988
24,León,182,Valderrey,510,241,269
24,León,183,Valderrueda,1001,513,488
24,León,184,Valdesamario,222,117,105
24,León,185,Val de San Lorenzo,578,294,284
24,León,187,Valdevimbre,1054,548,506
24,León,188,Valencia de Don Juan,5094,2499,2595
24,León,189,Valverde de la Virgen,6906,3516,3390
24,León,190,Valverde-Enrique,196,100,96
24,León,191,Vallecillo,131,73,58
24,León,193,"Vecilla, La",426,218,208
24,León,194,Vegacervera,368,193,175
24,León,196,Vega de Espinareda,2477,1261,1216
24,León,197,Vega de Infanzones,938,474,464
24,León,198,Vega de Valcarce,703,360,343
24,León,199,Vegaquemada,455,236,219
24,León,201,Vegas del Condado,1215,663,552
24,León,202,Villablino,10353,5104,5249
24,León,203,Villabraz,121,69,52
24,León,205,Villadangos del Páramo,1140,586,554
24,León,206,Toral de los Vados,2193,1082,1111
24,León,207,Villademor de la Vega,383,202,181
24,León,209,Villafranca del Bierzo,3505,1717,1788
24,León,210,Villagatón,642,321,321
24,León,211,Villamandos,322,167,155
24,León,212,Villamañán,1267,623,644
24,León,213,Villamartín de Don Sancho,162,88,74
24,León,214,Villamejil,796,408,388
24,León,215,Villamol,188,92,96
24,León,216,Villamontán de la Valduerna,872,449,423
24,León,217,Villamoratiel de las Matas,159,92,67
24,León,218,Villanueva de las Manzanas,543,271,272
24,León,219,Villaobispo de Otero,661,354,307
24,León,221,Villaquejida,991,500,491
24,León,222,Villaquilambre,18023,8988,9035
24,León,223,Villarejo de Órbigo,3240,1593,1647
24,León,224,Villares de Órbigo,718,371,347
24,León,225,Villasabariego,1245,647,598
24,León,226,Villaselán,231,127,104
24,León,227,Villaturiel,1920,1013,907
24,León,228,Villazala,815,431,384
24,León,229,Villazanzo de Valderaduey,531,299,232
24,León,230,Zotes del Páramo,488,273,215
24,León,901,Villamanín,1108,565,543
24,León,902,Villaornate y Castro,407,215,192
25,Lleida,1,Abella de la Conca,181,103,78
25,Lleida,2,Àger,590,316,274
25,Lleida,3,Agramunt,5653,2884,2769
25,Lleida,4,"Alamús, Els",748,403,345
25,Lleida,5,Alàs i Cerc,366,194,172
25,Lleida,6,"Albagés, L'",449,238,211
25,Lleida,7,Albatàrrec,2040,1063,977
25,Lleida,8,Albesa,1656,892,764
25,Lleida,9,"Albi, L'",860,454,406
25,Lleida,10,Alcanó,233,113,120
25,Lleida,11,Alcarràs,8350,4307,4043
25,Lleida,12,Alcoletge,3015,1577,1438
25,Lleida,13,Alfarràs,3107,1599,1508
25,Lleida,14,Alfés,331,176,155
25,Lleida,15,Algerri,450,232,218
25,Lleida,16,Alguaire,3097,1616,1481
25,Lleida,17,Alins,305,162,143
25,Lleida,19,Almacelles,6662,3485,3177
25,Lleida,20,Almatret,378,199,179
25,Lleida,21,Almenar,3605,1887,1718
25,Lleida,22,Alòs de Balaguer,138,81,57
25,Lleida,23,Alpicat,6190,3092,3098
25,Lleida,24,Alt Àneu,450,256,194
25,Lleida,25,Naut Aran,1760,908,852
25,Lleida,27,Anglesola,1389,699,690
25,Lleida,29,Arbeca,2493,1295,1198
25,Lleida,30,"Pont de Bar, El",190,108,82
25,Lleida,31,Arres,64,42,22
25,Lleida,32,Arsèguel,100,54,46
25,Lleida,33,Artesa de Lleida,1524,797,727
25,Lleida,34,Artesa de Segre,3828,1962,1866
25,Lleida,35,"Sentiu de Sió, La",488,248,240
25,Lleida,36,Aspa,224,115,109
25,Lleida,37,"Avellanes i Santa Linya, Les",470,264,206
25,Lleida,38,Aitona,2405,1259,1146
25,Lleida,39,Baix Pallars,382,201,181
25,Lleida,40,Balaguer,16877,8627,8250
25,Lleida,41,Barbens,896,484,412
25,Lleida,42,"Baronia de Rialb, La",257,136,121
25,Lleida,43,"Vall de Boí, La",1076,587,489
25,Lleida,44,Bassella,255,134,121
25,Lleida,45,Bausen,59,35,24
25,Lleida,46,Belianes,578,295,283
25,Lleida,47,Bellcaire d'Urgell,1356,681,675
25,Lleida,48,Bell-lloc d'Urgell,2446,1214,1232
25,Lleida,49,Bellmunt d'Urgell,202,95,107
25,Lleida,50,Bellpuig,5000,2615,2385
25,Lleida,51,Bellver de Cerdanya,2260,1175,1085
25,Lleida,52,Bellvís,2404,1212,1192
25,Lleida,53,Benavent de Segrià,1553,809,744
25,Lleida,55,Biosca,222,123,99
25,Lleida,56,Bovera,332,175,157
25,Lleida,57,"Bòrdes, Es",242,129,113
25,Lleida,58,"Borges Blanques, Les",6034,3078,2956
25,Lleida,59,Bossòst,1168,601,567
25,Lleida,60,Cabanabona,112,47,65
25,Lleida,61,Cabó,94,49,45
25,Lleida,62,Camarasa,949,494,455
25,Lleida,63,Canejan,104,57,47
25,Lleida,64,Castellar de la Ribera,156,80,76
25,Lleida,67,Castelldans,1006,546,460
25,Lleida,68,Castellnou de Seana,745,385,360
25,Lleida,69,Castelló de Farfanya,559,305,254
25,Lleida,70,Castellserà,1116,575,541
25,Lleida,71,Cava,61,36,25
25,Lleida,72,Cervera,9390,4792,4598
25,Lleida,73,Cervià de les Garrigues,808,419,389
25,Lleida,74,Ciutadilla,210,117,93
25,Lleida,75,Clariana de Cardener,157,81,76
25,Lleida,76,"Cogul, El",188,104,84
25,Lleida,77,Coll de Nargó,607,311,296
25,Lleida,78,Corbins,1377,737,640
25,Lleida,79,Cubells,400,211,189
25,Lleida,81,"Espluga Calba, L'",430,230,200
25,Lleida,82,Espot,350,191,159
25,Lleida,85,Estaràs,170,91,79
25,Lleida,86,Esterri d'Àneu,924,487,437
25,Lleida,87,Esterri de Cardós,77,38,39
25,Lleida,88,Estamariu,123,70,53
25,Lleida,89,Farrera,140,81,59
25,Lleida,92,"Floresta, La",168,92,76
25,Lleida,93,Fondarella,834,419,415
25,Lleida,94,Foradada,183,106,77
25,Lleida,96,"Fuliola, La",1286,656,630
25,Lleida,97,Fulleda,105,53,52
25,Lleida,98,Gavet de la Conca,302,149,153
25,Lleida,99,Golmés,1691,831,860
25,Lleida,100,Gósol,230,128,102
25,Lleida,101,"Granadella, La",759,405,354
25,Lleida,102,"Granja d'Escarp, La",968,519,449
25,Lleida,103,Granyanella,149,79,70
25,Lleida,104,Granyena de Segarra,137,68,69
25,Lleida,105,Granyena de les Garrigues,172,101,71
25,Lleida,109,Guimerà,320,170,150
25,Lleida,110,Guissona,6552,3495,3057
25,Lleida,111,Guixers,134,79,55
25,Lleida,112,Ivars de Noguera,357,193,164
25,Lleida,113,Ivars d'Urgell,1702,902,800
25,Lleida,114,Ivorra,120,63,57
25,Lleida,115,Isona i Conca Dellà,1100,584,516
25,Lleida,118,Juncosa,470,255,215
25,Lleida,119,Juneda,3482,1818,1664
25,Lleida,120,Lleida,138416,68652,69764
25,Lleida,121,Les,1005,511,494
25,Lleida,122,Linyola,2712,1389,1323
25,Lleida,123,Lladorre,244,118,126
25,Lleida,124,Lladurs,197,110,87
25,Lleida,125,Llardecans,515,265,250
25,Lleida,126,Llavorsí,373,194,179
25,Lleida,127,Lles de Cerdanya,268,164,104
25,Lleida,128,Llimiana,183,106,77
25,Lleida,129,Llobera,210,114,96
25,Lleida,130,Maldà,250,127,123
25,Lleida,131,Massalcoreig,581,308,273
25,Lleida,132,Massoteres,205,106,99
25,Lleida,133,Maials,969,509,460
25,Lleida,134,Menàrguens,903,488,415
25,Lleida,135,Miralcamp,1429,727,702
25,Lleida,136,"Molsosa, La",116,59,57
25,Lleida,137,Mollerussa,14705,7598,7107
25,Lleida,138,Montgai,720,372,348
25,Lleida,139,Montellà i Martinet,683,356,327
25,Lleida,140,Montferrer i Castellbò,1083,589,494
25,Lleida,141,Montoliu de Segarra,196,114,82
25,Lleida,142,Montoliu de Lleida,505,256,249
25,Lleida,143,Montornès de Segarra,98,47,51
25,Lleida,145,Nalec,99,53,46
25,Lleida,146,Navès,277,135,142
25,Lleida,148,Odèn,273,162,111
25,Lleida,149,Oliana,1942,976,966
25,Lleida,150,Oliola,230,131,99
25,Lleida,151,Olius,870,449,421
25,Lleida,152,"Oluges, Les",174,98,76
25,Lleida,153,"Omellons, Els",241,129,112
25,Lleida,154,"Omells de na Gaia, Els",146,78,68
25,Lleida,155,Organyà,929,452,477
25,Lleida,156,Os de Balaguer,987,513,474
25,Lleida,157,Ossó de Sió,218,110,108
25,Lleida,158,"Palau d'Anglesola, El",2172,1075,1097
25,Lleida,161,Conca de Dalt,420,218,202
25,Lleida,163,"Coma i la Pedra, La",275,163,112
25,Lleida,164,Penelles,505,296,209
25,Lleida,165,Peramola,384,194,190
25,Lleida,166,Pinell de Solsonès,217,119,98
25,Lleida,167,Pinós,307,169,138
25,Lleida,168,"Poal, El",645,332,313
25,Lleida,169,"Pobla de Cérvoles, La",245,136,109
25,Lleida,170,Bellaguarda,325,174,151
25,Lleida,171,"Pobla de Segur, La",3246,1594,1652
25,Lleida,172,Ponts,2714,1376,1338
25,Lleida,173,"Pont de Suert, El",2517,1310,1207
25,Lleida,174,"Portella, La",754,415,339
25,Lleida,175,Prats i Sansor,284,151,133
25,Lleida,176,Preixana,426,218,208
25,Lleida,177,Preixens,477,236,241
25,Lleida,179,Prullans,234,111,123
25,Lleida,180,Puiggròs,314,166,148
25,Lleida,181,Puigverd d'Agramunt,281,160,121
25,Lleida,182,Puigverd de Lleida,1422,735,687
25,Lleida,183,Rialp,664,341,323
25,Lleida,185,Ribera d'Urgellet,975,505,470
25,Lleida,186,Riner,283,141,142
25,Lleida,189,Rosselló,3030,1558,1472
25,Lleida,190,Salàs de Pallars,353,180,173
25,Lleida,191,Sanaüja,460,236,224
25,Lleida,192,Sant Guim de Freixenet,1111,558,553
25,Lleida,193,Sant Llorenç de Morunys,1032,526,506
25,Lleida,194,Sant Ramon,552,293,259
25,Lleida,196,Sant Esteve de la Sarga,138,83,55
25,Lleida,197,Sant Guim de la Plana,195,103,92
25,Lleida,200,Sarroca de Lleida,433,236,197
25,Lleida,201,Sarroca de Bellera,127,74,53
25,Lleida,202,Senterada,135,73,62
25,Lleida,203,"Seu d'Urgell, La",13009,6379,6630
25,Lleida,204,Seròs,1910,1052,858
25,Lleida,205,Sidamon,739,372,367
25,Lleida,206,"Soleràs, El",369,197,172
25,Lleida,207,Solsona,9304,4665,4639
25,Lleida,208,Soriguera,368,200,168
25,Lleida,209,Sort,2360,1204,1156
25,Lleida,210,Soses,1764,910,854
25,Lleida,211,Sudanell,885,489,396
25,Lleida,212,Sunyer,305,161,144
25,Lleida,215,Talarn,523,277,246
25,Lleida,216,Talavera,290,162,128
25,Lleida,217,Tàrrega,17129,8617,8512
25,Lleida,218,Tarrés,108,57,51
25,Lleida,219,Tarroja de Segarra,175,91,84
25,Lleida,220,Térmens,1521,784,737
25,Lleida,221,Tírvia,160,81,79
25,Lleida,222,Tiurana,83,40,43
25,Lleida,223,Torà,1343,683,660
25,Lleida,224,"Torms, Els",171,94,77
25,Lleida,225,Tornabous,871,469,402
25,Lleida,226,Torrebesses,300,157,143
25,Lleida,227,"Torre de Cabdella, La",769,384,385
25,Lleida,228,Torrefarrera,4309,2182,2127
25,Lleida,230,Torregrossa,2241,1133,1108
25,Lleida,231,Torrelameu,714,409,305
25,Lleida,232,Torres de Segre,2146,1115,1031
25,Lleida,233,Torre-serona,348,182,166
25,Lleida,234,Tremp,6711,3462,3249
25,Lleida,238,Vallbona de les Monges,264,142,122
25,Lleida,239,"Valls de Valira, Les",953,502,451
25,Lleida,240,Vallfogona de Balaguer,1847,917,930
25,Lleida,242,Verdú,1006,485,521
25,Lleida,243,Vielha e Mijaran,5601,2908,2693
25,Lleida,244,Vilagrassa,471,242,229
25,Lleida,245,Vilaller,691,400,291
25,Lleida,247,Vilamòs,189,103,86
25,Lleida,248,Vilanova de Bellpuig,1206,626,580
25,Lleida,249,Vilanova de l'Aguda,236,120,116
25,Lleida,250,Vilanova de Meià,422,223,199
25,Lleida,251,Vilanova de Segrià,870,457,413
25,Lleida,252,Vila-sana,698,351,347
25,Lleida,253,"Vilosell, El",203,104,99
25,Lleida,254,Vilanova de la Barca,1185,606,579
25,Lleida,255,Vinaixa,574,297,277
25,Lleida,901,Vall de Cardós,404,215,189
25,Lleida,902,Sant Martí de Riucorb,683,357,326
25,Lleida,903,"Guingueta d'Àneu, La",347,182,165
25,Lleida,904,Castell de Mur,186,96,90
25,Lleida,905,Ribera d'Ondara,459,238,221
25,Lleida,906,"Valls d'Aguilar, Les",305,169,136
25,Lleida,907,Torrefeta i Florejacs,634,329,305
25,Lleida,908,Fígols i Alinyà,282,157,125
25,Lleida,909,"Vansa i Fórnols, La",214,115,99
25,Lleida,910,Josa i Tuixén,136,78,58
25,Lleida,911,"Plans de Sió, Els",559,300,259
25,Lleida,912,Gimenells i el Pla de la Font,1179,592,587
25,Lleida,913,Riu de Cerdanya,113,64,49
26,"Rioja, La",1,Ábalos,364,235,129
26,"Rioja, La",2,Agoncillo,1159,650,509
26,"Rioja, La",3,Aguilar del Río Alhama,549,266,283
26,"Rioja, La",4,Ajamil de Cameros,80,54,26
26,"Rioja, La",5,Albelda de Iregua,3339,1756,1583
26,"Rioja, La",6,Alberite,2692,1351,1341
26,"Rioja, La",7,Alcanadre,745,394,351
26,"Rioja, La",8,Aldeanueva de Ebro,2816,1479,1337
26,"Rioja, La",9,Alesanco,562,291,271
26,"Rioja, La",10,Alesón,117,65,52
26,"Rioja, La",11,Alfaro,9827,4986,4841
26,"Rioja, La",12,Almarza de Cameros,23,15,8
26,"Rioja, La",13,Anguciana,471,256,215
26,"Rioja, La",14,Anguiano,543,304,239
26,"Rioja, La",15,Arenzana de Abajo,274,141,133
26,"Rioja, La",16,Arenzana de Arriba,34,22,12
26,"Rioja, La",17,Arnedillo,477,233,244
26,"Rioja, La",18,Arnedo,14457,7201,7256
26,"Rioja, La",19,Arrúbal,491,260,231
26,"Rioja, La",20,Ausejo,1122,677,445
26,"Rioja, La",21,Autol,4458,2314,2144
26,"Rioja, La",22,Azofra,251,136,115
26,"Rioja, La",23,Badarán,595,308,287
26,"Rioja, La",24,Bañares,313,153,160
26,"Rioja, La",25,Baños de Rioja,92,55,37
26,"Rioja, La",26,Baños de Río Tobía,1695,849,846
26,"Rioja, La",27,Berceo,180,109,71
26,"Rioja, La",28,Bergasa,155,89,66
26,"Rioja, La",29,Bergasillas Bajera,35,18,17
26,"Rioja, La",30,Bezares,19,9,10
26,"Rioja, La",31,Bobadilla,146,77,69
26,"Rioja, La",32,Brieva de Cameros,60,38,22
26,"Rioja, La",33,Briñas,249,118,131
26,"Rioja, La",34,Briones,873,470,403
26,"Rioja, La",35,Cabezón de Cameros,22,17,5
26,"Rioja, La",36,Calahorra,24839,12305,12534
26,"Rioja, La",37,Camprovín,178,98,80
26,"Rioja, La",38,Canales de la Sierra,95,54,41
26,"Rioja, La",39,Canillas de Río Tuerto,42,20,22
26,"Rioja, La",40,Cañas,89,42,47
26,"Rioja, La",41,Cárdenas,182,94,88
26,"Rioja, La",42,Casalarreina,1388,750,638
26,"Rioja, La",43,Castañares de Rioja,486,228,258
26,"Rioja, La",44,Castroviejo,67,37,30
26,"Rioja, La",45,Cellorigo,13,6,7
26,"Rioja, La",46,Cenicero,2081,1064,1017
26,"Rioja, La",47,Cervera del Río Alhama,2704,1398,1306
26,"Rioja, La",48,Cidamón,36,19,17
26,"Rioja, La",49,Cihuri,223,117,106
26,"Rioja, La",50,Cirueña,131,75,56
26,"Rioja, La",51,Clavijo,314,178,136
26,"Rioja, La",52,Cordovín,189,103,86
26,"Rioja, La",53,Corera,278,147,131
26,"Rioja, La",54,Cornago,426,241,185
26,"Rioja, La",55,Corporales,45,23,22
26,"Rioja, La",56,Cuzcurrita de Río Tirón,544,291,253
26,"Rioja, La",57,Daroca de Rioja,57,33,24
26,"Rioja, La",58,Enciso,168,95,73
26,"Rioja, La",59,Entrena,1503,779,724
26,"Rioja, La",60,Estollo,104,65,39
26,"Rioja, La",61,Ezcaray,2085,1104,981
26,"Rioja, La",62,Foncea,102,54,48
26,"Rioja, La",63,Fonzaleche,150,102,48
26,"Rioja, La",64,Fuenmayor,3169,1613,1556
26,"Rioja, La",65,Galbárruli,63,38,25
26,"Rioja, La",66,Galilea,401,207,194
26,"Rioja, La",67,Gallinero de Cameros,26,18,8
26,"Rioja, La",68,Gimileo,171,108,63
26,"Rioja, La",69,Grañón,307,174,133
26,"Rioja, La",70,Grávalos,234,121,113
26,"Rioja, La",71,Haro,11776,5901,5875
26,"Rioja, La",72,Herce,368,193,175
26,"Rioja, La",73,Herramélluri,106,56,50
26,"Rioja, La",74,Hervías,147,76,71
26,"Rioja, La",75,Hormilla,453,243,210
26,"Rioja, La",76,Hormilleja,175,93,82
26,"Rioja, La",77,Hornillos de Cameros,15,5,10
26,"Rioja, La",78,Hornos de Moncalvillo,96,56,40
26,"Rioja, La",79,Huércanos,917,488,429
26,"Rioja, La",80,Igea,729,427,302
26,"Rioja, La",81,Jalón de Cameros,24,14,10
26,"Rioja, La",82,Laguna de Cameros,142,85,57
26,"Rioja, La",83,Lagunilla del Jubera,356,199,157
26,"Rioja, La",84,Lardero,8438,4299,4139
26,"Rioja, La",86,Ledesma de la Cogolla,22,15,7
26,"Rioja, La",87,Leiva,304,158,146
26,"Rioja, La",88,Leza de Río Leza,49,28,21
26,"Rioja, La",89,Logroño,152641,73618,79023
26,"Rioja, La",91,Lumbreras,175,115,60
26,"Rioja, La",92,Manjarrés,152,83,69
26,"Rioja, La",93,Mansilla de la Sierra,70,46,24
26,"Rioja, La",94,Manzanares de Rioja,101,59,42
26,"Rioja, La",95,Matute,142,68,74
26,"Rioja, La",96,Medrano,293,159,134
26,"Rioja, La",98,Munilla,124,60,64
26,"Rioja, La",99,Murillo de Río Leza,1835,962,873
26,"Rioja, La",100,Muro de Aguas,66,39,27
26,"Rioja, La",101,Muro en Cameros,48,29,19
26,"Rioja, La",102,Nájera,8452,4204,4248
26,"Rioja, La",103,Nalda,1016,562,454
26,"Rioja, La",104,Navajún,21,15,6
26,"Rioja, La",105,Navarrete,2865,1459,1406
26,"Rioja, La",106,Nestares,81,49,32
26,"Rioja, La",107,Nieva de Cameros,103,63,40
26,"Rioja, La",108,Ocón,353,217,136
26,"Rioja, La",109,Ochánduri,120,71,49
26,"Rioja, La",110,Ojacastro,198,115,83
26,"Rioja, La",111,Ollauri,311,171,140
26,"Rioja, La",112,Ortigosa de Cameros,282,161,121
26,"Rioja, La",113,Pazuengos,35,24,11
26,"Rioja, La",114,Pedroso,95,58,37
26,"Rioja, La",115,Pinillos,18,10,8
26,"Rioja, La",117,Pradejón,4094,2152,1942
26,"Rioja, La",118,Pradillo,66,35,31
26,"Rioja, La",119,Préjano,283,155,128
26,"Rioja, La",120,Quel,2096,1121,975
26,"Rioja, La",121,Rabanera,68,44,24
26,"Rioja, La",122,"Rasillo de Cameros, El",150,78,72
26,"Rioja, La",123,"Redal, El",162,88,74
26,"Rioja, La",124,Ribafrecha,1001,533,468
26,"Rioja, La",125,Rincón de Soto,3819,1945,1874
26,"Rioja, La",126,Robres del Castillo,30,19,11
26,"Rioja, La",127,Rodezno,316,184,132
26,"Rioja, La",128,Sajazarra,137,71,66
26,"Rioja, La",129,San Asensio,1238,658,580
26,"Rioja, La",130,San Millán de la Cogolla,278,179,99
26,"Rioja, La",131,San Millán de Yécora,48,29,19
26,"Rioja, La",132,San Román de Cameros,169,88,81
26,"Rioja, La",134,Santa Coloma,127,75,52
26,"Rioja, La",135,Santa Engracia del Jubera,186,115,71
26,"Rioja, La",136,Santa Eulalia Bajera,130,70,60
26,"Rioja, La",138,Santo Domingo de la Calzada,6694,3461,3233
26,"Rioja, La",139,San Torcuato,83,47,36
26,"Rioja, La",140,Santurde de Rioja,336,179,157
26,"Rioja, La",141,Santurdejo,156,92,64
26,"Rioja, La",142,San Vicente de la Sonsierra,1132,624,508
26,"Rioja, La",143,Sojuela,234,138,96
26,"Rioja, La",144,Sorzano,252,141,111
26,"Rioja, La",145,Sotés,312,174,138
26,"Rioja, La",146,Soto en Cameros,163,87,76
26,"Rioja, La",147,Terroba,39,20,19
26,"Rioja, La",148,Tirgo,231,119,112
26,"Rioja, La",149,Tobía,72,41,31
26,"Rioja, La",150,Tormantos,155,87,68
26,"Rioja, La",151,Torrecilla en Cameros,555,299,256
26,"Rioja, La",152,Torrecilla sobre Alesanco,38,19,19
26,"Rioja, La",153,Torre en Cameros,12,10,2
26,"Rioja, La",154,Torremontalbo,14,7,7
26,"Rioja, La",155,Treviana,193,105,88
26,"Rioja, La",157,Tricio,393,195,198
26,"Rioja, La",158,Tudelilla,386,215,171
26,"Rioja, La",160,Uruñuela,952,487,465
26,"Rioja, La",161,Valdemadera,9,6,3
26,"Rioja, La",162,Valgañón,128,77,51
26,"Rioja, La",163,Ventosa,169,95,74
26,"Rioja, La",164,Ventrosa,68,40,28
26,"Rioja, La",165,Viguera,416,230,186
26,"Rioja, La",166,Villalba de Rioja,150,89,61
26,"Rioja, La",167,Villalobar de Rioja,71,49,22
26,"Rioja, La",168,Villamediana de Iregua,6958,3584,3374
26,"Rioja, La",169,Villanueva de Cameros,102,56,46
26,"Rioja, La",170,"Villar de Arnedo, El",660,340,320
26,"Rioja, La",171,Villar de Torre,263,144,119
26,"Rioja, La",172,Villarejo,33,23,10
26,"Rioja, La",173,Villarroya,9,4,5
26,"Rioja, La",174,Villarta-Quintana,166,91,75
26,"Rioja, La",175,Villavelayo,56,34,22
26,"Rioja, La",176,Villaverde de Rioja,72,38,34
26,"Rioja, La",177,Villoslada de Cameros,367,217,150
26,"Rioja, La",178,Viniegra de Abajo,99,59,40
26,"Rioja, La",179,Viniegra de Arriba,50,31,19
26,"Rioja, La",180,Zarratón,318,183,135
26,"Rioja, La",181,Zarzosa,15,12,3
26,"Rioja, La",183,Zorraquín,87,44,43
27,Lugo,1,Abadín,2811,1375,1436
27,Lugo,2,Alfoz,2059,1002,1057
27,Lugo,3,Antas de Ulla,2275,1120,1155
27,Lugo,4,Baleira,1510,784,726
27,Lugo,5,Barreiros,3166,1527,1639
27,Lugo,6,Becerreá,3121,1587,1534
27,Lugo,7,Begonte,3379,1684,1695
27,Lugo,8,Bóveda,1624,804,820
27,Lugo,9,Carballedo,2593,1297,1296
27,Lugo,10,Castro de Rei,5474,2712,2762
27,Lugo,11,Castroverde,2933,1506,1427
27,Lugo,12,Cervantes,1643,926,717
27,Lugo,13,Cervo,4562,2241,2321
27,Lugo,14,"Corgo, O",3882,1961,1921
27,Lugo,15,Cospeito,5088,2476,2612
27,Lugo,16,Chantada,8897,4312,4585
27,Lugo,17,Folgoso do Courel,1211,638,573
27,Lugo,18,"Fonsagrada, A",4309,2254,2055
27,Lugo,19,Foz,9968,4849,5119
27,Lugo,20,Friol,4202,2082,2120
27,Lugo,21,Xermade,2179,1063,1116
27,Lugo,22,Guitiriz,5727,2859,2868
27,Lugo,23,Guntín,3050,1545,1505
27,Lugo,24,"Incio, O",1956,951,1005
27,Lugo,25,Xove,3496,1734,1762
27,Lugo,26,Láncara,2908,1470,1438
27,Lugo,27,Lourenzá,2449,1189,1260
27,Lugo,28,Lugo,98007,45765,52242
27,Lugo,29,Meira,1780,882,898
27,Lugo,30,Mondoñedo,4299,2003,2296
27,Lugo,31,Monforte de Lemos,19622,9324,10298
27,Lugo,32,Monterroso,4032,2029,2003
27,Lugo,33,Muras,784,393,391
27,Lugo,34,Navia de Suarna,1390,760,630
27,Lugo,35,Negueira de Muñiz,224,120,104
27,Lugo,37,"Nogais, As",1341,686,655
27,Lugo,38,Ourol,1152,567,585
27,Lugo,39,Outeiro de Rei,5004,2565,2439
27,Lugo,40,Palas de Rei,3743,1853,1890
27,Lugo,41,Pantón,2936,1408,1528
27,Lugo,42,Paradela,2068,1030,1038
27,Lugo,43,"Páramo, O",1603,799,804
27,Lugo,44,"Pastoriza, A",3437,1700,1737
27,Lugo,45,Pedrafita do Cebreiro,1228,658,570
27,Lugo,46,Pol,1798,887,911
27,Lugo,47,"Pobra do Brollón, A",2027,993,1034
27,Lugo,48,"Pontenova, A",2732,1328,1404
27,Lugo,49,Portomarín,1737,886,851
27,Lugo,50,Quiroga,3711,1791,1920
27,Lugo,51,Ribadeo,10023,4767,5256
27,Lugo,52,Ribas de Sil,1098,544,554
27,Lugo,53,Ribeira de Piquín,654,336,318
27,Lugo,54,Riotorto,1466,715,751
27,Lugo,55,Samos,1614,831,783
27,Lugo,56,Rábade,1733,881,852
27,Lugo,57,Sarria,13590,6666,6924
27,Lugo,58,"Saviñao, O",4408,2208,2200
27,Lugo,59,Sober,2516,1199,1317
27,Lugo,60,Taboada,3345,1613,1732
27,Lugo,61,Trabada,1310,645,665
27,Lugo,62,Triacastela,772,380,392
27,Lugo,63,"Valadouro, O",2180,1077,1103
27,Lugo,64,"Vicedo, O",1921,945,976
27,Lugo,65,Vilalba,15202,7439,7763
27,Lugo,66,Viveiro,16107,7910,8197
27,Lugo,901,Baralla,2889,1504,1385
27,Lugo,902,Burela,9575,4819,4756
28,Madrid,1,"Acebeda, La",62,32,30
28,Madrid,2,Ajalvir,4111,2132,1979
28,Madrid,3,Alameda del Valle,246,140,106
28,Madrid,4,"Álamo, El",8475,4202,4273
28,Madrid,5,Alcalá de Henares,203686,101614,102072
28,Madrid,6,Alcobendas,109705,53167,56538
28,Madrid,7,Alcorcón,168523,82658,85865
28,Madrid,8,Aldea del Fresno,2531,1354,1177
28,Madrid,9,Algete,20701,10363,10338
28,Madrid,10,Alpedrete,13391,6663,6728
28,Madrid,11,Ambite,572,292,280
28,Madrid,12,Anchuelo,1135,595,540
28,Madrid,13,Aranjuez,55755,27287,28468
28,Madrid,14,Arganda del Rey,54220,27720,26500
28,Madrid,15,Arroyomolinos,19523,9958,9565
28,Madrid,16,"Atazar, El",102,53,49
28,Madrid,17,Batres,1518,774,744
28,Madrid,18,Becerril de la Sierra,5231,2585,2646
28,Madrid,19,Belmonte de Tajo,1519,768,751
28,Madrid,20,Berzosa del Lozoya,234,128,106
28,Madrid,21,"Berrueco, El",615,314,301
28,Madrid,22,Boadilla del Monte,46151,22622,23529
28,Madrid,23,"Boalo, El",6858,3565,3293
28,Madrid,24,Braojos,209,119,90
28,Madrid,25,Brea de Tajo,555,317,238
28,Madrid,26,Brunete,9967,4986,4981
28,Madrid,27,Buitrago del Lozoya,2078,1034,1044
28,Madrid,28,Bustarviejo,2208,1118,1090
28,Madrid,29,Cabanillas de la Sierra,737,392,345
28,Madrid,30,"Cabrera, La",2542,1305,1237
28,Madrid,31,Cadalso de los Vidrios,2906,1529,1377
28,Madrid,32,Camarma de Esteruelas,6682,3442,3240
28,Madrid,33,Campo Real,5448,2799,2649
28,Madrid,34,Canencia,501,270,231
28,Madrid,35,Carabaña,2036,1025,1011
28,Madrid,36,Casarrubuelos,3224,1663,1561
28,Madrid,37,Cenicientos,2088,1037,1051
28,Madrid,38,Cercedilla,7068,3435,3633
28,Madrid,39,Cervera de Buitrago,187,110,77
28,Madrid,40,Ciempozuelos,23354,11786,11568
28,Madrid,41,Cobeña,6560,3235,3325
28,Madrid,42,Colmenar del Arroyo,1518,768,750
28,Madrid,43,Colmenar de Oreja,8378,4273,4105
28,Madrid,44,Colmenarejo,8589,4256,4333
28,Madrid,45,Colmenar Viejo,45468,22525,22943
28,Madrid,46,Collado Mediano,6610,3364,3246
28,Madrid,47,Collado Villalba,60998,30075,30923
28,Madrid,48,Corpa,634,335,299
28,Madrid,49,Coslada,91861,46084,45777
28,Madrid,50,Cubas de la Sagra,5004,2492,2512
28,Madrid,51,Chapinería,2152,1095,1057
28,Madrid,52,Chinchón,5389,2747,2642
28,Madrid,53,Daganzo de Arriba,9268,4646,4622
28,Madrid,54,"Escorial, El",15092,7456,7636
28,Madrid,55,Estremera,1490,753,737
28,Madrid,56,Fresnedillas de la Oliva,1581,818,763
28,Madrid,57,Fresno de Torote,2041,1070,971
28,Madrid,58,Fuenlabrada,198560,99613,98947
28,Madrid,59,Fuente el Saz de Jarama,6377,3234,3143
28,Madrid,60,Fuentidueña de Tajo,2027,1026,1001
28,Madrid,61,Galapagar,32575,16221,16354
28,Madrid,62,Garganta de los Montes,390,203,187
28,Madrid,63,Gargantilla del Lozoya y Pinilla de Buitrago,379,214,165
28,Madrid,64,Gascones,183,105,78
28,Madrid,65,Getafe,170115,84148,85967
28,Madrid,66,Griñón,9730,4835,4895
28,Madrid,67,Guadalix de la Sierra,5992,3027,2965
28,Madrid,68,Guadarrama,15350,7564,7786
28,Madrid,69,"Hiruela, La",55,35,20
28,Madrid,70,Horcajo de la Sierra-Aoslos,176,102,74
28,Madrid,71,Horcajuelo de la Sierra,102,47,55
28,Madrid,72,Hoyo de Manzanares,7720,3852,3868
28,Madrid,73,Humanes de Madrid,18774,9589,9185
28,Madrid,74,Leganés,186552,91871,94681
28,Madrid,75,Loeches,7635,3824,3811
28,Madrid,76,Lozoya,647,341,306
28,Madrid,78,Madarcos,56,32,24
28,Madrid,79,Madrid,3265038,1529842,1735196
28,Madrid,80,Majadahonda,70076,33355,36721
28,Madrid,82,Manzanares el Real,7731,3960,3771
28,Madrid,83,Meco,12554,6406,6148
28,Madrid,84,Mejorada del Campo,22677,11338,11339
28,Madrid,85,Miraflores de la Sierra,5963,3006,2957
28,Madrid,86,"Molar, El",7973,4095,3878
28,Madrid,87,"Molinos, Los",4562,2311,2251
28,Madrid,88,Montejo de la Sierra,357,189,168
28,Madrid,89,Moraleja de Enmedio,4885,2466,2419
28,Madrid,90,Moralzarzal,11985,6015,5970
28,Madrid,91,Morata de Tajuña,7463,3771,3692
28,Madrid,92,Móstoles,205015,101435,103580
28,Madrid,93,Navacerrada,2779,1375,1404
28,Madrid,94,Navalafuente,1245,663,582
28,Madrid,95,Navalagamella,2367,1236,1131
28,Madrid,96,Navalcarnero,24613,12312,12301
28,Madrid,97,Navarredonda y San Mamés,146,84,62
28,Madrid,99,Navas del Rey,2682,1414,1268
28,Madrid,100,Nuevo Baztán,6295,3219,3076
28,Madrid,101,Olmeda de las Fuentes,357,182,175
28,Madrid,102,Orusco de Tajuña,1297,652,645
28,Madrid,104,Paracuellos de Jarama,18482,9415,9067
28,Madrid,106,Parla,121995,61936,60059
28,Madrid,107,Patones,536,261,275
28,Madrid,108,Pedrezuela,4671,2419,2252
28,Madrid,109,Pelayos de la Presa,2512,1272,1240
28,Madrid,110,Perales de Tajuña,2870,1446,1424
28,Madrid,111,Pezuela de las Torres,842,442,400
28,Madrid,112,Pinilla del Valle,213,116,97
28,Madrid,113,Pinto,45643,22827,22816
28,Madrid,114,Piñuécar-Gandullas,173,87,86
28,Madrid,115,Pozuelo de Alarcón,82916,39741,43175
28,Madrid,116,Pozuelo del Rey,987,533,454
28,Madrid,117,Prádena del Rincón,129,74,55
28,Madrid,118,Puebla de la Sierra,102,59,43
28,Madrid,119,Quijorna,3010,1543,1467
28,Madrid,120,Rascafría,1985,1087,898
28,Madrid,121,Redueña,282,150,132
28,Madrid,122,Ribatejada,655,336,319
28,Madrid,123,Rivas-Vaciamadrid,72896,36517,36379
28,Madrid,124,Robledillo de la Jara,103,52,51
28,Madrid,125,Robledo de Chavela,3991,2054,1937
28,Madrid,126,Robregordo,66,39,27
28,Madrid,127,"Rozas de Madrid, Las",89151,43316,45835
28,Madrid,128,Rozas de Puerto Real,466,270,196
28,Madrid,129,San Agustín del Guadalix,12425,6191,6234
28,Madrid,130,San Fernando de Henares,41380,20627,20753
28,Madrid,131,San Lorenzo de El Escorial,18447,8831,9616
28,Madrid,132,San Martín de la Vega,19224,10013,9211
28,Madrid,133,San Martín de Valdeiglesias,8236,4119,4117
28,Madrid,134,San Sebastián de los Reyes,79825,39142,40683
28,Madrid,135,Santa María de la Alameda,1152,621,531
28,Madrid,136,Santorcaz,827,429,398
28,Madrid,137,"Santos de la Humosa, Los",2297,1190,1107
28,Madrid,138,"Serna del Monte, La",102,55,47
28,Madrid,140,Serranillos del Valle,3515,1758,1757
28,Madrid,141,Sevilla la Nueva,8808,4346,4462
28,Madrid,143,Somosierra,99,57,42
28,Madrid,144,Soto del Real,8505,4171,4334
28,Madrid,145,Talamanca de Jarama,3110,1583,1527
28,Madrid,146,Tielmes,2605,1353,1252
28,Madrid,147,Titulcia,1184,615,569
28,Madrid,148,Torrejón de Ardoz,122589,61588,61001
28,Madrid,149,Torrejón de la Calzada,7298,3630,3668
28,Madrid,150,Torrejón de Velasco,4148,2089,2059
28,Madrid,151,Torrelaguna,4918,2537,2381
28,Madrid,152,Torrelodones,22354,10799,11555
28,Madrid,153,Torremocha de Jarama,861,411,450
28,Madrid,154,Torres de la Alameda,7941,4070,3871
28,Madrid,155,Valdaracete,679,336,343
28,Madrid,156,Valdeavero,1360,721,639
28,Madrid,157,Valdelaguna,879,449,430
28,Madrid,158,Valdemanco,972,525,447
28,Madrid,159,Valdemaqueda,861,432,429
28,Madrid,160,Valdemorillo,11545,5939,5606
28,Madrid,161,Valdemoro,68418,34235,34183
28,Madrid,162,Valdeolmos-Alalpardo,3360,1728,1632
28,Madrid,163,Valdepiélagos,541,281,260
28,Madrid,164,Valdetorres de Jarama,4008,2065,1943
28,Madrid,165,Valdilecha,2794,1454,1340
28,Madrid,166,Valverde de Alcalá,437,237,200
28,Madrid,167,Velilla de San Antonio,11793,5998,5795
28,Madrid,168,"Vellón, El",1760,902,858
28,Madrid,169,Venturada,1860,960,900
28,Madrid,170,Villaconejos,3530,1808,1722
28,Madrid,171,Villa del Prado,6456,3346,3110
28,Madrid,172,Villalbilla,10465,5345,5120
28,Madrid,173,Villamanrique de Tajo,802,420,382
28,Madrid,174,Villamanta,2524,1266,1258
28,Madrid,175,Villamantilla,1089,534,555
28,Madrid,176,Villanueva de la Cañada,17865,8665,9200
28,Madrid,177,Villanueva del Pardillo,16091,7885,8206
28,Madrid,178,Villanueva de Perales,1478,764,714
28,Madrid,179,Villar del Olmo,2151,1129,1022
28,Madrid,180,Villarejo de Salvanés,7380,3748,3632
28,Madrid,181,Villaviciosa de Odón,26646,13011,13635
28,Madrid,182,Villavieja del Lozoya,288,151,137
28,Madrid,183,Zarzalejo,1513,797,716
28,Madrid,901,Lozoyuela-Navas-Sieteiglesias,1157,618,539
28,Madrid,902,Puentes Viejas,645,374,271
28,Madrid,903,Tres Cantos,41065,19950,21115
29,Málaga,1,Alameda,5471,2728,2743
29,Málaga,2,Alcaucín,2753,1388,1365
29,Málaga,3,Alfarnate,1323,683,640
29,Málaga,4,Alfarnatejo,546,278,268
29,Málaga,5,Algarrobo,6539,3282,3257
29,Málaga,6,Algatocín,904,460,444
29,Málaga,7,Alhaurín de la Torre,36730,18346,18384
29,Málaga,8,Alhaurín el Grande,23807,11976,11831
29,Málaga,9,Almáchar,1885,967,918
29,Málaga,10,Almargen,2136,1077,1059
29,Málaga,11,Almogía,4221,2162,2059
29,Málaga,12,Álora,13499,6796,6703
29,Málaga,13,Alozaina,2268,1160,1108
29,Málaga,14,Alpandeire,279,138,141
29,Málaga,15,Antequera,41854,20550,21304
29,Málaga,16,Árchez,476,247,229
29,Málaga,17,Archidona,8857,4432,4425
29,Málaga,18,Ardales,2632,1319,1313
29,Málaga,19,Arenas,1423,747,676
29,Málaga,20,Arriate,4162,2050,2112
29,Málaga,21,Atajate,171,90,81
29,Málaga,22,Benadalid,262,130,132
29,Málaga,23,Benahavís,5486,2812,2674
29,Málaga,24,Benalauría,514,280,234
29,Málaga,25,Benalmádena,63788,31546,32242
29,Málaga,26,Benamargosa,1617,820,797
29,Málaga,27,Benamocarra,3084,1581,1503
29,Málaga,28,Benaoján,1572,806,766
29,Málaga,29,Benarrabá,587,295,292
29,Málaga,30,"Borge, El",1033,539,494
29,Málaga,31,"Burgo, El",1957,981,976
29,Málaga,32,Campillos,8707,4347,4360
29,Málaga,33,Canillas de Aceituno,2242,1154,1088
29,Málaga,34,Canillas de Albaida,947,477,470
29,Málaga,35,Cañete la Real,1947,979,968
29,Málaga,36,Carratraca,875,445,430
29,Málaga,37,Cartajima,277,138,139
29,Málaga,38,Cártama,22867,11660,11207
29,Málaga,39,Casabermeja,3675,1951,1724
29,Málaga,40,Casarabonela,2707,1425,1282
29,Málaga,41,Casares,5331,2738,2593
29,Málaga,42,Coín,22159,11348,10811
29,Málaga,43,Colmenar,3673,1871,1802
29,Málaga,44,Comares,1636,868,768
29,Málaga,45,Cómpeta,3832,1948,1884
29,Málaga,46,Cortes de la Frontera,3586,1824,1762
29,Málaga,47,Cuevas Bajas,1482,756,726
29,Málaga,48,Cuevas del Becerro,1790,892,898
29,Málaga,49,Cuevas de San Marcos,4097,2066,2031
29,Málaga,50,Cútar,674,342,332
29,Málaga,51,Estepona,65667,32716,32951
29,Málaga,52,Faraján,292,134,158
29,Málaga,53,Frigiliana,3273,1623,1650
29,Málaga,54,Fuengirola,74054,36526,37528
29,Málaga,55,Fuente de Piedra,2837,1431,1406
29,Málaga,56,Gaucín,1776,917,859
29,Málaga,57,Genalguacil,544,282,262
29,Málaga,58,Guaro,2310,1151,1159
29,Málaga,59,Humilladero,3358,1677,1681
29,Málaga,60,Igualeja,934,456,478
29,Málaga,61,Istán,1520,793,727
29,Málaga,62,Iznate,949,492,457
29,Málaga,63,Jimera de Líbar,471,241,230
29,Málaga,64,Jubrique,781,382,399
29,Málaga,65,Júzcar,242,136,106
29,Málaga,66,Macharaviaya,519,276,243
29,Málaga,67,Málaga,568030,273355,294675
29,Málaga,68,Manilva,13810,7145,6665
29,Málaga,69,Marbella,138662,67562,71100
29,Málaga,70,Mijas,79262,39789,39473
29,Málaga,71,Moclinejo,1303,665,638
29,Málaga,72,Mollina,5283,2675,2608
29,Málaga,73,Monda,2486,1274,1212
29,Málaga,74,Montejaque,1048,514,534
29,Málaga,75,Nerja,22294,11071,11223
29,Málaga,76,Ojén,3244,1667,1577
29,Málaga,77,Parauta,265,130,135
29,Málaga,79,Periana,3570,1852,1718
29,Málaga,80,Pizarra,9137,4674,4463
29,Málaga,81,Pujerra,343,189,154
29,Málaga,82,Rincón de la Victoria,40339,20014,20325
29,Málaga,83,Riogordo,3127,1616,1511
29,Málaga,84,Ronda,36793,18007,18786
29,Málaga,85,Salares,232,122,110
29,Málaga,86,Sayalonga,1557,782,775
29,Málaga,87,Sedella,733,402,331
29,Málaga,88,Sierra de Yeguas,3552,1777,1775
29,Málaga,89,Teba,4148,2085,2063
29,Málaga,90,Tolox,2343,1186,1157
29,Málaga,91,Torrox,17859,9039,8820
29,Málaga,92,Totalán,768,398,370
29,Málaga,93,Valle de Abdalajís,2761,1380,1381
29,Málaga,94,Vélez-Málaga,77004,38349,38655
29,Málaga,95,Villanueva de Algaidas,4489,2294,2195
29,Málaga,96,Villanueva del Rosario,3646,1801,1845
29,Málaga,97,Villanueva del Trabuco,5424,2725,2699
29,Málaga,98,Villanueva de Tapia,1663,858,805
29,Málaga,99,Viñuela,1980,1019,961
29,Málaga,100,Yunquera,3181,1615,1566
29,Málaga,901,Torremolinos,68181,34275,33906
29,Málaga,902,Villanueva de la Concepción,3443,1692,1751
30,Murcia,1,Abanilla,6633,3341,3292
30,Murcia,2,Abarán,12986,6575,6411
30,Murcia,3,Águilas,34990,17603,17387
30,Murcia,4,Albudeite,1447,731,716
30,Murcia,5,Alcantarilla,41568,20589,20979
30,Murcia,6,Aledo,1044,527,517
30,Murcia,7,Alguazas,9288,4816,4472
30,Murcia,8,Alhama de Murcia,20725,10601,10124
30,Murcia,9,Archena,18083,9434,8649
30,Murcia,10,Beniel,11068,5724,5344
30,Murcia,11,Blanca,6489,3308,3181
30,Murcia,12,Bullas,12361,6278,6083
30,Murcia,13,Calasparra,10685,5410,5275
30,Murcia,14,Campos del Río,2226,1069,1157
30,Murcia,15,Caravaca de la Cruz,26438,13282,13156
30,Murcia,16,Cartagena,214918,108024,106894
30,Murcia,17,Cehegín,16286,8240,8046
30,Murcia,18,Ceutí,10729,5410,5319
30,Murcia,19,Cieza,35425,17755,17670
30,Murcia,20,Fortuna,10002,5347,4655
30,Murcia,21,Fuente Álamo de Murcia,15873,8368,7505
30,Murcia,22,Jumilla,25926,13532,12394
30,Murcia,23,Librilla,4730,2396,2334
30,Murcia,24,Lorca,92869,48202,44667
30,Murcia,25,Lorquí,7048,3618,3430
30,Murcia,26,Mazarrón,35473,18545,16928
30,Murcia,27,Molina de Segura,66775,33540,33235
30,Murcia,28,Moratalla,8382,4256,4126
30,Murcia,29,Mula,17067,8744,8323
30,Murcia,30,Murcia,442203,218324,223879
30,Murcia,31,Ojós,610,330,280
30,Murcia,32,Pliego,4027,2083,1944
30,Murcia,33,Puerto Lumbreras,14339,7175,7164
30,Murcia,34,Ricote,1456,748,708
30,Murcia,35,San Javier,32366,16564,15802
30,Murcia,36,San Pedro del Pinatar,24093,12167,11926
30,Murcia,37,Torre-Pacheco,33218,17415,15803
30,Murcia,38,"Torres de Cotillas, Las",21443,11041,10402
30,Murcia,39,Totana,29961,15451,14510
30,Murcia,40,Ulea,919,474,445
30,Murcia,41,"Unión, La",18825,9486,9339
30,Murcia,42,Villanueva del Río Segura,2396,1193,1203
30,Murcia,43,Yecla,34813,17510,17303
30,Murcia,901,Santomera,15649,7975,7674
30,Murcia,902,"Alcázares, Los",16217,8380,7837
31,Navarra,1,Abáigar,103,53,50
31,Navarra,2,Abárzuza,548,278,270
31,Navarra,3,Abaurregaina/Abaurrea Alta,137,83,54
31,Navarra,4,Abaurrepea/Abaurrea Baja,40,27,13
31,Navarra,5,Aberin,383,206,177
31,Navarra,6,Ablitas,2654,1351,1303
31,Navarra,7,Adiós,186,101,85
31,Navarra,8,Aguilar de Codés,104,54,50
31,Navarra,9,Aibar/Oibar,887,489,398
31,Navarra,10,Altsasu/Alsasua,7655,3870,3785
31,Navarra,11,Allín,844,445,399
31,Navarra,12,Allo,1075,535,540
31,Navarra,13,Améscoa Baja,793,423,370
31,Navarra,14,Ancín/Antzin,381,212,169
31,Navarra,15,Andosilla,3031,1582,1449
31,Navarra,16,Ansoáin/Antsoain,10776,5420,5356
31,Navarra,17,Anue,410,231,179
31,Navarra,18,Añorbe,562,308,254
31,Navarra,19,Aoiz/Agoitz,2571,1281,1290
31,Navarra,20,Araitz,567,329,238
31,Navarra,21,Aranarache/Aranaratxe,84,45,39
31,Navarra,22,Arantza,644,354,290
31,Navarra,23,Aranguren,7586,3888,3698
31,Navarra,24,Arano,124,67,57
31,Navarra,25,Arakil,956,511,445
31,Navarra,26,Aras,187,108,79
31,Navarra,27,Arbizu,1082,561,521
31,Navarra,28,Arce/Artzi,272,157,115
31,Navarra,29,"Arcos, Los",1244,611,633
31,Navarra,30,Arellano,199,114,85
31,Navarra,31,Areso,280,151,129
31,Navarra,32,Arguedas,2401,1227,1174
31,Navarra,33,Aria,58,34,24
31,Navarra,34,Aribe,48,27,21
31,Navarra,35,Armañanzas,62,32,30
31,Navarra,36,Arróniz,1124,613,511
31,Navarra,37,Arruazu,112,63,49
31,Navarra,38,Artajona,1736,902,834
31,Navarra,39,Artazu,121,62,59
31,Navarra,40,Atez,237,136,101
31,Navarra,41,Ayegui/Aiegi,1932,1003,929
31,Navarra,42,Azagra,3860,1981,1879
31,Navarra,43,Azuelo,41,18,23
31,Navarra,44,Bakaiku,340,186,154
31,Navarra,45,Barásoain,645,337,308
31,Navarra,46,Barbarin,67,33,34
31,Navarra,47,Bargota,314,152,162
31,Navarra,48,Barillas,189,101,88
31,Navarra,49,Basaburua,888,497,391
31,Navarra,50,Baztan,8075,4093,3982
31,Navarra,51,Beire,334,172,162
31,Navarra,52,Belascoáin,127,65,62
31,Navarra,53,Berbinzana,714,367,347
31,Navarra,54,Bertizarana,646,320,326
31,Navarra,55,Betelu,345,191,154
31,Navarra,56,Biurrun-Olcoz,222,127,95
31,Navarra,57,Buñuel,2380,1190,1190
31,Navarra,58,Auritz/Burguete,290,144,146
31,Navarra,59,Burgui/Burgi,236,136,100
31,Navarra,60,Burlada/Burlata,18195,8900,9295
31,Navarra,61,"Busto, El",79,41,38
31,Navarra,62,Cabanillas,1493,764,729
31,Navarra,63,Cabredo,104,54,50
31,Navarra,64,Cadreita,2133,1112,1021
31,Navarra,65,Caparroso,2791,1439,1352
31,Navarra,66,Cárcar,1161,589,572
31,Navarra,67,Carcastillo,2591,1351,1240
31,Navarra,68,Cascante,3992,2007,1985
31,Navarra,69,Cáseda,1031,503,528
31,Navarra,70,Castejón,4316,2175,2141
31,Navarra,71,Castillonuevo,17,12,5
31,Navarra,72,Cintruénigo,7777,3997,3780
31,Navarra,73,Ziordia,399,184,215
31,Navarra,74,Cirauqui/Zirauki,505,278,227
31,Navarra,75,Ciriza,111,59,52
31,Navarra,76,Cizur,3499,1737,1762
31,Navarra,77,Corella,8123,4248,3875
31,Navarra,78,Cortes,3349,1724,1625
31,Navarra,79,Desojo,102,54,48
31,Navarra,80,Dicastillo,687,368,319
31,Navarra,81,Donamaria,436,218,218
31,Navarra,82,Etxalar,826,446,380
31,Navarra,83,Echarri,67,37,30
31,Navarra,84,Etxarri-Aranatz,2485,1295,1190
31,Navarra,85,Etxauri,591,312,279
31,Navarra,86,Egüés,16222,8206,8016
31,Navarra,87,Elgorriaga,232,118,114
31,Navarra,88,Noáin (Valle de Elorz)/Noain (Elortzibar),7415,3743,3672
31,Navarra,89,Enériz/Eneritz,351,184,167
31,Navarra,90,Eratsun,161,102,59
31,Navarra,91,Ergoiena,422,224,198
31,Navarra,92,Erro,795,452,343
31,Navarra,93,Ezcároz/Ezkaroze,340,178,162
31,Navarra,94,Eslava,128,70,58
31,Navarra,95,Esparza de Salazar/Espartza Zaraitzu,91,48,43
31,Navarra,96,Espronceda,130,77,53
31,Navarra,97,Estella/Lizarra,14251,6946,7305
31,Navarra,98,Esteribar,2341,1238,1103
31,Navarra,99,Etayo,91,46,45
31,Navarra,100,Eulate,338,179,159
31,Navarra,101,Ezcabarte,1675,894,781
31,Navarra,102,Ezkurra,169,108,61
31,Navarra,103,Ezprogui,51,27,24
31,Navarra,104,Falces,2637,1347,1290
31,Navarra,105,Fitero,2268,1162,1106
31,Navarra,106,Fontellas,933,482,451
31,Navarra,107,Funes,2499,1357,1142
31,Navarra,108,Fustiñana,2592,1305,1287
31,Navarra,109,Galar,1783,934,849
31,Navarra,110,Gallipienzo/Galipentzu,118,65,53
31,Navarra,111,Gallués/Galoze,106,68,38
31,Navarra,112,Garaioa,105,59,46
31,Navarra,113,Garde,170,101,69
31,Navarra,114,Garínoain,518,290,228
31,Navarra,115,Garralda,189,94,95
31,Navarra,116,Genevilla,83,51,32
31,Navarra,117,Goizueta,771,427,344
31,Navarra,118,Goñi,192,122,70
31,Navarra,119,Güesa/Gorza,51,28,23
31,Navarra,120,Guesálaz/Gesalatz,457,271,186
31,Navarra,121,Guirguillano,102,55,47
31,Navarra,122,Huarte/Uharte,6309,3208,3101
31,Navarra,123,Uharte-Arakil,836,450,386
31,Navarra,124,Ibargoiti,243,146,97
31,Navarra,125,Igúzquiza,348,172,176
31,Navarra,126,Imotz,430,234,196
31,Navarra,127,Irañeta,160,93,67
31,Navarra,128,Isaba/Izaba,500,248,252
31,Navarra,129,Ituren,523,271,252
31,Navarra,130,Iturmendi,403,206,197
31,Navarra,131,Iza/Itza,1093,578,515
31,Navarra,132,Izagaondoa,178,111,67
31,Navarra,133,Izalzu/Itzaltzu,49,28,21
31,Navarra,134,Jaurrieta,215,117,98
31,Navarra,135,Javier,116,43,73
31,Navarra,136,Juslapeña,566,310,256
31,Navarra,137,Beintza-Labaien,248,146,102
31,Navarra,138,Lakuntza,1237,644,593
31,Navarra,139,Lana,197,112,85
31,Navarra,140,Lantz,130,80,50
31,Navarra,141,Lapoblación,155,88,67
31,Navarra,142,Larraga,2161,1170,991
31,Navarra,143,Larraona,113,52,61
31,Navarra,144,Larraun,1008,553,455
31,Navarra,145,Lazagurría,208,108,100
31,Navarra,146,Leache,59,33,26
31,Navarra,147,Legarda,119,65,54
31,Navarra,148,Legaria,114,54,60
31,Navarra,149,Leitza,2953,1581,1372
31,Navarra,150,Leoz/Leotz,272,173,99
31,Navarra,151,Lerga,75,45,30
31,Navarra,152,Lerín,1863,959,904
31,Navarra,153,Lesaka,2803,1445,1358
31,Navarra,154,Lezáun,269,158,111
31,Navarra,155,Liédena,326,161,165
31,Navarra,156,Lizoáin-Arriasgoiti,323,198,125
31,Navarra,157,Lodosa,4993,2523,2470
31,Navarra,158,Lónguida/Longida,316,165,151
31,Navarra,159,Lumbier,1412,758,654
31,Navarra,160,Luquin,138,72,66
31,Navarra,161,Mañeru,427,229,198
31,Navarra,162,Marañón,57,29,28
31,Navarra,163,Marcilla,2806,1415,1391
31,Navarra,164,Mélida,755,388,367
31,Navarra,165,Mendavia,3717,1888,1829
31,Navarra,166,Mendaza,357,187,170
31,Navarra,167,Mendigorría,1066,557,509
31,Navarra,168,Metauten,284,162,122
31,Navarra,169,Milagro,3440,1780,1660
31,Navarra,170,Mirafuentes,54,26,28
31,Navarra,171,Miranda de Arga,929,471,458
31,Navarra,172,Monreal,490,260,230
31,Navarra,173,Monteagudo,1149,591,558
31,Navarra,174,Morentin,134,69,65
31,Navarra,175,Mues,92,46,46
31,Navarra,176,Murchante,3732,1870,1862
31,Navarra,177,Murieta,349,193,156
31,Navarra,178,Murillo el Cuende,655,339,316
31,Navarra,179,Murillo el Fruto,706,367,339
31,Navarra,180,Muruzábal,288,134,154
31,Navarra,181,Navascués,174,106,68
31,Navarra,182,Nazar,52,31,21
31,Navarra,183,Obanos,926,457,469
31,Navarra,184,Oco,73,40,33
31,Navarra,185,Ochagavía/Otsagabia,625,320,305
31,Navarra,186,Odieta,357,193,164
31,Navarra,187,Oitz,148,89,59
31,Navarra,188,Olaibar,243,128,115
31,Navarra,189,Olazti/Olazagutía,1696,885,811
31,Navarra,190,Olejua,55,27,28
31,Navarra,191,Olite/Erriberri,3750,1896,1854
31,Navarra,192,Olóriz/Oloritz,183,108,75
31,Navarra,193,Cendea de Olza/Oltza Zendea,1655,843,812
31,Navarra,194,Ollo,374,198,176
31,Navarra,195,Orbaitzeta,215,110,105
31,Navarra,196,Orbara,48,24,24
31,Navarra,197,Orísoain,89,49,40
31,Navarra,198,Oronz/Orontze,51,26,25
31,Navarra,199,Oroz-Betelu/Orotz-Betelu,169,92,77
31,Navarra,200,Oteiza,956,505,451
31,Navarra,201,Pamplona/Iruña,197932,94642,103290
31,Navarra,202,Peralta/Azkoien,6080,3084,2996
31,Navarra,203,Petilla de Aragón,22,15,7
31,Navarra,204,Piedramillera,52,32,20
31,Navarra,205,Pitillas,555,262,293
31,Navarra,206,Puente la Reina/Gares,2877,1490,1387
31,Navarra,207,Pueyo,341,190,151
31,Navarra,208,Ribaforada,3669,1878,1791
31,Navarra,209,Romanzado,171,90,81
31,Navarra,210,Roncal/Erronkari,254,136,118
31,Navarra,211,Orreaga/Roncesvalles,24,12,12
31,Navarra,212,Sada,195,103,92
31,Navarra,213,Saldías,116,72,44
31,Navarra,214,Salinas de Oro/Jaitz,118,66,52
31,Navarra,215,San Adrián,6263,3113,3150
31,Navarra,216,Sangüesa/Zangoza,5254,2680,2574
31,Navarra,217,San Martín de Unx,458,228,230
31,Navarra,219,Sansol,112,60,52
31,Navarra,220,Santacara,928,477,451
31,Navarra,221,Doneztebe/Santesteban,1679,868,811
31,Navarra,222,Sarriés/Sartze,69,43,26
31,Navarra,223,Sartaguda,1428,747,681
31,Navarra,224,Sesma,1270,653,617
31,Navarra,225,Sorlada,66,38,28
31,Navarra,226,Sunbilla,663,346,317
31,Navarra,227,Tafalla,11390,5670,5720
31,Navarra,228,Tiebas-Muruarte de Reta,675,346,329
31,Navarra,229,Tirapu,53,33,20
31,Navarra,230,Torralba del Río,134,71,63
31,Navarra,231,Torres del Río,156,73,83
31,Navarra,232,Tudela,35429,17638,17791
31,Navarra,233,Tulebras,131,54,77
31,Navarra,234,Ucar,179,103,76
31,Navarra,235,Ujué,212,119,93
31,Navarra,236,Ultzama,1706,876,830
31,Navarra,237,Unciti,230,138,92
31,Navarra,238,Unzué,142,83,59
31,Navarra,239,Urdazubi/Urdax,388,195,193
31,Navarra,240,Urdiain,714,378,336
31,Navarra,241,Urraul Alto,187,112,75
31,Navarra,242,Urraul Bajo,284,124,160
31,Navarra,243,Urroz-Villa,394,206,188
31,Navarra,244,Urrotz,177,103,74
31,Navarra,245,Urzainqui/Urzainki,91,55,36
31,Navarra,246,Uterga,205,116,89
31,Navarra,247,Uztárroz/Uztarroze,174,86,88
31,Navarra,248,Luzaide/Valcarlos,410,213,197
31,Navarra,249,Valtierra,2547,1254,1293
31,Navarra,250,Bera,3762,1880,1882
31,Navarra,251,Viana,4018,2042,1976
31,Navarra,252,Vidángoz/Bidankoze,100,53,47
31,Navarra,253,Bidaurreta,157,88,69
31,Navarra,254,Villafranca,2973,1509,1464
31,Navarra,255,Villamayor de Monjardín,139,73,66
31,Navarra,256,Hiriberri/Villanueva de Aezkoa,120,70,50
31,Navarra,257,Villatuerta,1122,563,559
31,Navarra,258,Villava/Atarrabia,10487,5207,5280
31,Navarra,259,Igantzi,635,339,296
31,Navarra,260,Valle de Yerri/Deierri,1546,794,752
31,Navarra,261,Yesa,245,127,118
31,Navarra,262,Zabalza/Zabaltza,270,140,130
31,Navarra,263,Zubieta,311,174,137
31,Navarra,264,Zugarramurdi,211,107,104
31,Navarra,265,Zúñiga,109,72,37
31,Navarra,901,Barañain,21552,10573,10979
31,Navarra,902,Berrioplano,5366,2726,2640
31,Navarra,903,Berriozar,8931,4585,4346
31,Navarra,904,Irurtzun,2279,1182,1097
31,Navarra,905,Beriáin,3800,1867,1933
31,Navarra,906,Orkoien,3637,1852,1785
31,Navarra,907,Zizur Mayor/Zizur Nagusia,13871,6828,7043
31,Navarra,908,Lekunberri,1473,732,741
32,Ourense,1,Allariz,5985,2986,2999
32,Ourense,2,Amoeiro,2297,1121,1176
32,Ourense,3,"Arnoia, A",1084,539,545
32,Ourense,4,Avión,2528,1171,1357
32,Ourense,5,Baltar,1094,563,531
32,Ourense,6,Bande,2020,947,1073
32,Ourense,7,Baños de Molgas,1825,906,919
32,Ourense,8,Barbadás,9731,4731,5000
32,Ourense,9,"Barco de Valdeorras, O",14123,6917,7206
32,Ourense,10,Beade,515,267,248
32,Ourense,11,Beariz,1278,589,689
32,Ourense,12,"Blancos, Os",1007,527,480
32,Ourense,13,Boborás,2936,1370,1566
32,Ourense,14,"Bola, A",1436,680,756
32,Ourense,15,"Bolo, O",1117,555,562
32,Ourense,16,Calvos de Randín,1176,580,596
32,Ourense,17,Carballeda de Valdeorras,1819,909,910
32,Ourense,18,Carballeda de Avia,1504,725,779
32,Ourense,19,"Carballiño, O",14145,6662,7483
32,Ourense,20,Cartelle,3299,1611,1688
32,Ourense,21,Castrelo do Val,1177,601,576
32,Ourense,22,Castrelo de Miño,1814,898,916
32,Ourense,23,Castro Caldelas,1533,765,768
32,Ourense,24,Celanova,5906,2767,3139
32,Ourense,25,Cenlle,1357,639,718
32,Ourense,26,Coles,3199,1615,1584
32,Ourense,27,Cortegada,1326,655,671
32,Ourense,28,Cualedro,1993,1012,981
32,Ourense,29,Chandrexa de Queixa,619,342,277
32,Ourense,30,Entrimo,1398,660,738
32,Ourense,31,Esgos,1194,610,584
32,Ourense,32,Xinzo de Limia,10329,5120,5209
32,Ourense,33,Gomesende,946,445,501
32,Ourense,34,"Gudiña, A",1554,814,740
32,Ourense,35,"Irixo, O",1740,822,918
32,Ourense,36,Xunqueira de Ambía,1697,847,850
32,Ourense,37,Xunqueira de Espadanedo,914,455,459
32,Ourense,38,Larouco,557,266,291
32,Ourense,39,Laza,1561,784,777
32,Ourense,40,Leiro,1799,893,906
32,Ourense,41,Lobeira,983,481,502
32,Ourense,42,Lobios,2238,1117,1121
32,Ourense,43,Maceda,3129,1533,1596
32,Ourense,44,Manzaneda,1006,503,503
32,Ourense,45,Maside,3058,1482,1576
32,Ourense,46,Melón,1475,699,776
32,Ourense,47,"Merca, A",2212,1076,1136
32,Ourense,48,"Mezquita, A",1328,691,637
32,Ourense,49,Montederramo,935,487,448
32,Ourense,50,Monterrei,2973,1479,1494
32,Ourense,51,Muíños,1782,909,873
32,Ourense,52,Nogueira de Ramuín,2381,1160,1221
32,Ourense,53,Oímbra,2045,1072,973
32,Ourense,54,Ourense,108002,49802,58200
32,Ourense,55,Paderne de Allariz,1601,775,826
32,Ourense,56,Padrenda,2355,1162,1193
32,Ourense,57,Parada de Sil,648,326,322
32,Ourense,58,"Pereiro de Aguiar, O",6184,3154,3030
32,Ourense,59,"Peroxa, A",2179,1070,1109
32,Ourense,60,Petín,1008,487,521
32,Ourense,61,Piñor,1362,679,683
32,Ourense,62,Porqueira,1043,493,550
32,Ourense,63,"Pobra de Trives, A",2456,1222,1234
32,Ourense,64,Pontedeva,667,319,348
32,Ourense,65,Punxín,825,389,436
32,Ourense,66,Quintela de Leirado,724,326,398
32,Ourense,67,Rairiz de Veiga,1622,806,816
32,Ourense,68,Ramirás,1856,861,995
32,Ourense,69,Ribadavia,5459,2629,2830
32,Ourense,70,San Xoán de Río,708,345,363
32,Ourense,71,Riós,1846,925,921
32,Ourense,72,"Rúa, A",4719,2335,2384
32,Ourense,73,Rubiá,1561,779,782
32,Ourense,74,San Amaro,1262,624,638
32,Ourense,75,San Cibrao das Viñas,4579,2337,2242
32,Ourense,76,San Cristovo de Cea,2634,1316,1318
32,Ourense,77,Sandiás,1391,636,755
32,Ourense,78,Sarreaus,1486,745,741
32,Ourense,79,Taboadela,1652,838,814
32,Ourense,80,"Teixeira, A",428,211,217
32,Ourense,81,Toén,2605,1340,1265
32,Ourense,82,Trasmiras,1560,758,802
32,Ourense,83,"Veiga, A",1048,536,512
32,Ourense,84,Verea,1222,584,638
32,Ourense,85,Verín,14633,7240,7393
32,Ourense,86,Viana do Bolo,3247,1625,1622
32,Ourense,87,Vilamarín,2162,1070,1092
32,Ourense,88,Vilamartín de Valdeorras,2047,1027,1020
32,Ourense,89,Vilar de Barrio,1602,800,802
32,Ourense,90,Vilar de Santos,942,459,483
32,Ourense,91,Vilardevós,2182,1110,1072
32,Ourense,92,Vilariño de Conso,673,375,298
33,Asturias,1,Allande,2004,1020,984
33,Asturias,2,Aller,12324,6056,6268
33,Asturias,3,Amieva,804,433,371
33,Asturias,4,Avilés,83617,39981,43636
33,Asturias,5,Belmonte de Miranda,1715,879,836
33,Asturias,6,Bimenes,1901,902,999
33,Asturias,7,Boal,1863,930,933
33,Asturias,8,Cabrales,2227,1141,1086
33,Asturias,9,Cabranes,1079,554,525
33,Asturias,10,Candamo,2170,1062,1108
33,Asturias,11,Cangas del Narcea,14249,7116,7133
33,Asturias,12,Cangas de Onís,6786,3331,3455
33,Asturias,13,Caravia,522,268,254
33,Asturias,14,Carreño,10963,5337,5626
33,Asturias,15,Caso,1839,1012,827
33,Asturias,16,Castrillón,22893,11149,11744
33,Asturias,17,Castropol,3762,1813,1949
33,Asturias,18,Coaña,3447,1665,1782
33,Asturias,19,Colunga,3735,1829,1906
33,Asturias,20,Corvera de Asturias,16236,8000,8236
33,Asturias,21,Cudillero,5721,2834,2887
33,Asturias,22,Degaña,1225,646,579
33,Asturias,23,"Franco, El",3981,1971,2010
33,Asturias,24,Gijón,277559,131283,146276
33,Asturias,25,Gozón,10833,5288,5545
33,Asturias,26,Grado,10901,5287,5614
33,Asturias,27,Grandas de Salime,1016,521,495
33,Asturias,28,Ibias,1661,897,764
33,Asturias,29,Illano,444,238,206
33,Asturias,30,Illas,1020,527,493
33,Asturias,31,Langreo,44737,21313,23424
33,Asturias,32,Laviana,14085,6814,7271
33,Asturias,33,Lena,12545,6084,6461
33,Asturias,34,Valdés,13241,6459,6782
33,Asturias,35,Llanera,14036,6959,7077
33,Asturias,36,Llanes,14048,6828,7220
33,Asturias,37,Mieres,42951,20347,22604
33,Asturias,38,Morcín,2870,1430,1440
33,Asturias,39,Muros de Nalón,1938,917,1021
33,Asturias,40,Nava,5597,2757,2840
33,Asturias,41,Navia,9015,4398,4617
33,Asturias,42,Noreña,5432,2637,2795
33,Asturias,43,Onís,805,424,381
33,Asturias,44,Oviedo,225391,105293,120098
33,Asturias,45,Parres,5796,2835,2961
33,Asturias,46,Peñamellera Alta,617,310,307
33,Asturias,47,Peñamellera Baja,1319,654,665
33,Asturias,48,Pesoz,189,93,96
33,Asturias,49,Piloña,7915,3894,4021
33,Asturias,50,Ponga,688,409,279
33,Asturias,51,Pravia,8995,4368,4627
33,Asturias,52,Proaza,823,463,360
33,Asturias,53,Quirós,1309,735,574
33,Asturias,54,"Regueras, Las",1981,988,993
33,Asturias,55,Ribadedeva,1882,923,959
33,Asturias,56,Ribadesella,6242,2975,3267
33,Asturias,57,Ribera de Arriba,1984,1021,963
33,Asturias,58,Riosa,2170,1104,1066
33,Asturias,59,Salas,5782,2878,2904
33,Asturias,60,San Martín del Rey Aurelio,18286,8831,9455
33,Asturias,61,San Martín de Oscos,503,252,251
33,Asturias,62,Santa Eulalia de Oscos,510,267,243
33,Asturias,63,San Tirso de Abres,531,256,275
33,Asturias,64,Santo Adriano,265,133,132
33,Asturias,65,Sariego,1320,634,686
33,Asturias,66,Siero,52094,25473,26621
33,Asturias,67,Sobrescobio,895,463,432
33,Asturias,68,Somiedo,1409,806,603
33,Asturias,69,Soto del Barco,4075,1985,2090
33,Asturias,70,Tapia de Casariego,4045,1942,2103
33,Asturias,71,Taramundi,732,358,374
33,Asturias,72,Teverga,1929,1005,924
33,Asturias,73,Tineo,10829,5457,5372
33,Asturias,74,Vegadeo,4160,2024,2136
33,Asturias,75,Villanueva de Oscos,364,184,180
33,Asturias,76,Villaviciosa,14962,7358,7604
33,Asturias,77,Villayón,1520,768,752
33,Asturias,78,Yernes y Tameza,178,95,83
34,Palencia,1,Abarca de Campos,39,22,17
34,Palencia,3,Abia de las Torres,179,102,77
34,Palencia,4,Aguilar de Campoo,7226,3505,3721
34,Palencia,5,Alar del Rey,1055,515,540
34,Palencia,6,Alba de Cerrato,89,50,39
34,Palencia,9,Amayuelas de Arriba,38,25,13
34,Palencia,10,Ampudia,621,335,286
34,Palencia,11,Amusco,442,238,204
34,Palencia,12,Antigüedad,410,219,191
34,Palencia,15,Arconada,42,25,17
34,Palencia,17,Astudillo,1106,565,541
34,Palencia,18,Autilla del Pino,250,138,112
34,Palencia,19,Autillo de Campos,153,79,74
34,Palencia,20,Ayuela,63,37,26
34,Palencia,22,Baltanás,1337,708,629
34,Palencia,23,Venta de Baños,6465,3226,3239
34,Palencia,24,Baquerín de Campos,39,24,15
34,Palencia,25,Bárcena de Campos,53,27,26
34,Palencia,27,Barruelo de Santullán,1459,711,748
34,Palencia,28,Báscones de Ojeda,166,88,78
34,Palencia,29,Becerril de Campos,936,476,460
34,Palencia,31,Belmonte de Campos,35,19,16
34,Palencia,32,Berzosilla,54,27,27
34,Palencia,33,Boada de Campos,20,12,8
34,Palencia,34,Boadilla del Camino,124,70,54
34,Palencia,35,Boadilla de Rioseco,133,78,55
34,Palencia,36,Brañosera,253,143,110
34,Palencia,37,Buenavista de Valdavia,388,200,188
34,Palencia,38,Bustillo de la Vega,326,176,150
34,Palencia,39,Bustillo del Páramo de Carrión,69,41,28
34,Palencia,41,Calahorra de Boedo,108,60,48
34,Palencia,42,Calzada de los Molinos,353,192,161
34,Palencia,45,Capillas,91,45,46
34,Palencia,46,Cardeñosa de Volpejera,50,26,24
34,Palencia,47,Carrión de los Condes,2221,1093,1128
34,Palencia,48,Castil de Vela,72,33,39
34,Palencia,49,Castrejón de la Peña,466,253,213
34,Palencia,50,Castrillo de Don Juan,255,133,122
34,Palencia,51,Castrillo de Onielo,119,58,61
34,Palencia,52,Castrillo de Villavega,208,108,100
34,Palencia,53,Castromocho,252,132,120
34,Palencia,55,Cervatos de la Cueza,321,184,137
34,Palencia,56,Cervera de Pisuerga,2589,1292,1297
34,Palencia,57,Cevico de la Torre,504,253,251
34,Palencia,58,Cevico Navero,224,117,107
34,Palencia,59,Cisneros,513,249,264
34,Palencia,60,Cobos de Cerrato,158,83,75
34,Palencia,61,Collazos de Boedo,128,69,59
34,Palencia,62,Congosto de Valdavia,186,106,80
34,Palencia,63,Cordovilla la Real,136,75,61
34,Palencia,66,Cubillas de Cerrato,68,36,32
34,Palencia,67,Dehesa de Montejo,150,87,63
34,Palencia,68,Dehesa de Romanos,39,24,15
34,Palencia,69,Dueñas,2844,1479,1365
34,Palencia,70,Espinosa de Cerrato,194,101,93
34,Palencia,71,Espinosa de Villagonzalo,228,122,106
34,Palencia,72,Frechilla,198,101,97
34,Palencia,73,Fresno del Río,200,104,96
34,Palencia,74,Frómista,833,427,406
34,Palencia,76,Fuentes de Nava,740,381,359
34,Palencia,77,Fuentes de Valdepero,313,166,147
34,Palencia,79,Grijota,1802,930,872
34,Palencia,80,Guardo,7145,3569,3576
34,Palencia,81,Guaza de Campos,61,31,30
34,Palencia,82,Hérmedes de Cerrato,102,57,45
34,Palencia,83,Herrera de Pisuerga,2283,1126,1157
34,Palencia,84,Herrera de Valdecañas,152,81,71
34,Palencia,86,Hontoria de Cerrato,111,57,54
34,Palencia,87,Hornillos de Cerrato,109,54,55
34,Palencia,88,Husillos,251,135,116
34,Palencia,89,Itero de la Vega,177,95,82
34,Palencia,91,Lagartos,145,78,67
34,Palencia,92,Lantadilla,363,183,180
34,Palencia,93,"Vid de Ojeda, La",116,68,48
34,Palencia,94,Ledigos,74,40,34
34,Palencia,96,Lomas,57,33,24
34,Palencia,98,Magaz de Pisuerga,1052,596,456
34,Palencia,99,Manquillos,68,36,32
34,Palencia,100,Mantinos,149,82,67
34,Palencia,101,Marcilla de Campos,46,20,26
34,Palencia,102,Mazariegos,256,150,106
34,Palencia,103,Mazuecos de Valdeginate,110,60,50
34,Palencia,104,Melgar de Yuso,301,172,129
34,Palencia,106,Meneses de Campos,127,68,59
34,Palencia,107,Micieces de Ojeda,92,51,41
34,Palencia,108,Monzón de Campos,669,349,320
34,Palencia,109,Moratinos,68,39,29
34,Palencia,110,Mudá,101,50,51
34,Palencia,112,Nogal de las Huertas,47,28,19
34,Palencia,113,Olea de Boedo,37,15,22
34,Palencia,114,Olmos de Ojeda,251,152,99
34,Palencia,116,Osornillo,77,39,38
34,Palencia,120,Palencia,81552,38608,42944
34,Palencia,121,Palenzuela,227,121,106
34,Palencia,122,Páramo de Boedo,92,50,42
34,Palencia,123,Paredes de Nava,2072,1055,1017
34,Palencia,124,Payo de Ojeda,74,42,32
34,Palencia,125,Pedraza de Campos,102,53,49
34,Palencia,126,Pedrosa de la Vega,360,199,161
34,Palencia,127,Perales,155,77,78
34,Palencia,129,Pino del Río,211,124,87
34,Palencia,130,Piña de Campos,254,131,123
34,Palencia,131,Población de Arroyo,69,37,32
34,Palencia,132,Población de Campos,140,77,63
34,Palencia,133,Población de Cerrato,125,69,56
34,Palencia,134,Polentinos,73,40,33
34,Palencia,135,Pomar de Valdivia,516,275,241
34,Palencia,136,Poza de la Vega,229,126,103
34,Palencia,137,Pozo de Urama,30,17,13
34,Palencia,139,Prádanos de Ojeda,218,119,99
34,Palencia,140,"Puebla de Valdavia, La",113,59,54
34,Palencia,141,Quintana del Puente,242,128,114
34,Palencia,143,Quintanilla de Onsoña,208,117,91
34,Palencia,146,Reinoso de Cerrato,60,36,24
34,Palencia,147,Renedo de la Vega,222,120,102
34,Palencia,149,Requena de Campos,27,11,16
34,Palencia,151,Respenda de la Peña,197,112,85
34,Palencia,152,Revenga de Campos,161,83,78
34,Palencia,154,Revilla de Collazos,84,45,39
34,Palencia,155,Ribas de Campos,175,89,86
34,Palencia,156,Riberos de la Cueza,63,41,22
34,Palencia,157,Saldaña,3052,1553,1499
34,Palencia,158,Salinas de Pisuerga,421,210,211
34,Palencia,159,San Cebrián de Campos,481,265,216
34,Palencia,160,San Cebrián de Mudá,174,87,87
34,Palencia,161,San Cristóbal de Boedo,26,15,11
34,Palencia,163,San Mamés de Campos,69,31,38
34,Palencia,165,San Román de la Cuba,90,49,41
34,Palencia,167,Santa Cecilia del Alcor,139,81,58
34,Palencia,168,Santa Cruz de Boedo,62,33,29
34,Palencia,169,Santervás de la Vega,500,281,219
34,Palencia,170,Santibáñez de Ecla,79,36,43
34,Palencia,171,Santibáñez de la Peña,1231,611,620
34,Palencia,174,Santoyo,236,124,112
34,Palencia,175,"Serna, La",118,71,47
34,Palencia,176,Sotobañado y Priorato,162,92,70
34,Palencia,177,Soto de Cerrato,190,107,83
34,Palencia,178,Tabanera de Cerrato,117,68,49
34,Palencia,179,Tabanera de Valdavia,35,15,20
34,Palencia,180,Támara de Campos,90,46,44
34,Palencia,181,Tariego de Cerrato,536,284,252
34,Palencia,182,Torquemada,1075,575,500
34,Palencia,184,Torremormojón,51,30,21
34,Palencia,185,Triollo,73,41,32
34,Palencia,186,Valbuena de Pisuerga,60,34,26
34,Palencia,189,Valdeolmillos,69,36,33
34,Palencia,190,Valderrábano,55,30,25
34,Palencia,192,Valde-Ucieza,116,66,50
34,Palencia,196,Valle de Cerrato,101,58,43
34,Palencia,199,Velilla del Río Carrión,1512,774,738
34,Palencia,201,Vertavillo,222,118,104
34,Palencia,202,Villabasta de Valdavia,35,18,17
34,Palencia,204,Villacidaler,55,30,25
34,Palencia,205,Villaconancio,70,44,26
34,Palencia,206,Villada,1086,549,537
34,Palencia,208,Villaeles de Valdavia,67,35,32
34,Palencia,210,Villahán,111,58,53
34,Palencia,211,Villaherreros,235,115,120
34,Palencia,213,Villalaco,73,35,38
34,Palencia,214,Villalba de Guardo,194,102,92
34,Palencia,215,Villalcázar de Sirga,174,86,88
34,Palencia,216,Villalcón,68,35,33
34,Palencia,217,Villalobón,1405,724,681
34,Palencia,218,Villaluenga de la Vega,597,339,258
34,Palencia,220,Villamartín de Campos,180,100,80
34,Palencia,221,Villamediana,196,102,94
34,Palencia,222,Villameriel,128,75,53
34,Palencia,223,Villamoronta,282,161,121
34,Palencia,224,Villamuera de la Cueza,56,32,24
34,Palencia,225,Villamuriel de Cerrato,6295,3245,3050
34,Palencia,227,Villanueva del Rebollar,92,48,44
34,Palencia,228,Villanuño de Valdavia,104,58,46
34,Palencia,229,Villaprovedo,71,45,26
34,Palencia,230,Villarmentero de Campos,11,8,3
34,Palencia,231,Villarrabé,269,131,138
34,Palencia,232,Villarramiel,917,486,431
34,Palencia,233,Villasarracino,161,87,74
34,Palencia,234,Villasila de Valdavia,74,53,21
34,Palencia,236,Villaturde,187,92,95
34,Palencia,237,Villaumbrales,752,386,366
34,Palencia,238,Villaviudas,396,192,204
34,Palencia,240,Villerías de Campos,110,61,49
34,Palencia,241,Villodre,20,12,8
34,Palencia,242,Villodrigo,144,76,68
34,Palencia,243,Villoldo,387,214,173
34,Palencia,245,Villota del Páramo,360,206,154
34,Palencia,246,Villovieco,87,47,40
34,Palencia,901,Osorno la Mayor,1455,755,700
34,Palencia,902,Valle del Retortillo,185,102,83
34,Palencia,903,Loma de Ucieza,275,159,116
34,Palencia,904,"Pernía, La",381,219,162
35,"Palmas, Las",1,Agaete,5776,2917,2859
35,"Palmas, Las",2,Agüimes,29767,15129,14638
35,"Palmas, Las",3,Antigua,10600,5754,4846
35,"Palmas, Las",4,Arrecife,57357,29236,28121
35,"Palmas, Las",5,Artenara,1261,679,582
35,"Palmas, Las",6,Arucas,36872,18379,18493
35,"Palmas, Las",7,Betancuria,839,439,400
35,"Palmas, Las",8,Firgas,7640,3904,3736
35,"Palmas, Las",9,Gáldar,24361,12253,12108
35,"Palmas, Las",10,Haría,5203,2694,2509
35,"Palmas, Las",11,Ingenio,29871,15148,14723
35,"Palmas, Las",12,Mogán,23476,12250,11226
35,"Palmas, Las",13,Moya,8089,4108,3981
35,"Palmas, Las",14,"Oliva, La",22953,12309,10644
35,"Palmas, Las",15,Pájara,20565,11063,9502
35,"Palmas, Las",16,"Palmas de Gran Canaria, Las",383343,186866,196477
35,"Palmas, Las",17,Puerto del Rosario,35664,18346,17318
35,"Palmas, Las",18,San Bartolomé,18468,9423,9045
35,"Palmas, Las",19,San Bartolomé de Tirajana,54613,28579,26034
35,"Palmas, Las",20,"Aldea de San Nicolás, La",8626,4376,4250
35,"Palmas, Las",21,Santa Brígida,18973,9412,9561
35,"Palmas, Las",22,Santa Lucía de Tirajana,66130,33268,32862
35,"Palmas, Las",23,Santa María de Guía de Gran Canaria,14306,7111,7195
35,"Palmas, Las",24,Teguise,20788,10526,10262
35,"Palmas, Las",25,Tejeda,2201,1173,1028
35,"Palmas, Las",26,Telde,101375,50402,50973
35,"Palmas, Las",27,Teror,12932,6624,6308
35,"Palmas, Las",28,Tías,20102,10348,9754
35,"Palmas, Las",29,Tinajo,5728,2965,2763
35,"Palmas, Las",30,Tuineje,13451,6966,6485
35,"Palmas, Las",31,Valsequillo de Gran Canaria,9090,4621,4469
35,"Palmas, Las",32,Valleseco,3963,2097,1866
35,"Palmas, Las",33,Vega de San Mateo,7726,3946,3780
35,"Palmas, Las",34,Yaiza,14871,7930,6941
36,Pontevedra,1,Arbo,3741,1863,1878
36,Pontevedra,2,Barro,3668,1801,1867
36,Pontevedra,3,Baiona,12258,6102,6156
36,Pontevedra,4,Bueu,12348,6087,6261
36,Pontevedra,5,Caldas de Reis,10060,4902,5158
36,Pontevedra,6,Cambados,13946,6777,7169
36,Pontevedra,7,Campo Lameiro,2036,977,1059
36,Pontevedra,8,Cangas,26121,12954,13167
36,Pontevedra,9,"Cañiza, A",6461,3145,3316
36,Pontevedra,10,Catoira,3489,1711,1778
36,Pontevedra,11,Cerdedo,2297,1063,1234
36,Pontevedra,12,Cotobade,4432,2101,2331
36,Pontevedra,13,Covelo,3235,1588,1647
36,Pontevedra,14,Crecente,2533,1219,1314
36,Pontevedra,15,Cuntis,5066,2383,2683
36,Pontevedra,16,Dozón,1744,857,887
36,Pontevedra,17,"Estrada, A",21759,10392,11367
36,Pontevedra,18,Forcarei,4044,1924,2120
36,Pontevedra,19,Fornelos de Montes,2002,950,1052
36,Pontevedra,20,Agolada,2926,1440,1486
36,Pontevedra,21,Gondomar,13973,6895,7078
36,Pontevedra,22,"Grove, O",11241,5532,5709
36,Pontevedra,23,"Guarda, A",10484,5110,5374
36,Pontevedra,24,Lalín,21127,10291,10836
36,Pontevedra,25,"Lama, A",2976,1426,1550
36,Pontevedra,26,Marín,25864,12997,12867
36,Pontevedra,27,Meaño,5444,2644,2800
36,Pontevedra,28,Meis,4988,2373,2615
36,Pontevedra,29,Moaña,19336,9498,9838
36,Pontevedra,30,Mondariz,5081,2461,2620
36,Pontevedra,31,Mondariz-Balneario,730,366,364
36,Pontevedra,32,Moraña,4398,2124,2274
36,Pontevedra,33,Mos,14942,7378,7564
36,Pontevedra,34,"Neves, As",4400,2162,2238
36,Pontevedra,35,Nigrán,17879,8765,9114
36,Pontevedra,36,Oia,3179,1600,1579
36,Pontevedra,37,Pazos de Borbén,3192,1530,1662
36,Pontevedra,38,Pontevedra,82400,39074,43326
36,Pontevedra,39,"Porriño, O",18075,8877,9198
36,Pontevedra,40,Portas,3070,1460,1610
36,Pontevedra,41,Poio,16501,8131,8370
36,Pontevedra,42,Ponteareas,23561,11493,12068
36,Pontevedra,43,Ponte Caldelas,6319,3077,3242
36,Pontevedra,44,Pontecesures,3136,1585,1551
36,Pontevedra,45,Redondela,30006,14709,15297
36,Pontevedra,46,Ribadumia,5107,2466,2641
36,Pontevedra,47,Rodeiro,3034,1534,1500
36,Pontevedra,48,"Rosal, O",6613,3277,3336
36,Pontevedra,49,Salceda de Caselas,8665,4388,4277
36,Pontevedra,50,Salvaterra de Miño,9546,4813,4733
36,Pontevedra,51,Sanxenxo,17586,8677,8909
36,Pontevedra,52,Silleda,9199,4512,4687
36,Pontevedra,53,Soutomaior,7223,3561,3662
36,Pontevedra,54,Tomiño,13604,6844,6760
36,Pontevedra,55,Tui,17236,8299,8937
36,Pontevedra,56,Valga,6103,2997,3106
36,Pontevedra,57,Vigo,297241,141638,155603
36,Pontevedra,58,Vilaboa,6024,2917,3107
36,Pontevedra,59,Vila de Cruces,6325,3126,3199
36,Pontevedra,60,Vilagarcía de Arousa,37903,18176,19727
36,Pontevedra,61,Vilanova de Arousa,10614,5184,5430
36,Pontevedra,901,"Illa de Arousa, A",5020,2488,2532
37,Salamanca,1,Abusejo,236,123,113
37,Salamanca,2,Agallas,162,86,76
37,Salamanca,3,Ahigal de los Aceiteros,147,75,72
37,Salamanca,4,Ahigal de Villarino,39,20,19
37,Salamanca,5,"Alameda de Gardón, La",105,54,51
37,Salamanca,6,"Alamedilla, La",191,96,95
37,Salamanca,7,Alaraz,544,283,261
37,Salamanca,8,Alba de Tormes,5401,2666,2735
37,Salamanca,9,Alba de Yeltes,257,131,126
37,Salamanca,10,"Alberca, La",1208,612,596
37,Salamanca,11,"Alberguería de Argañán, La",144,74,70
37,Salamanca,12,Alconada,167,87,80
37,Salamanca,13,Aldeacipreste,146,76,70
37,Salamanca,14,Aldeadávila de la Ribera,1370,710,660
37,Salamanca,15,Aldea del Obispo,339,188,151
37,Salamanca,16,Aldealengua,651,331,320
37,Salamanca,17,Aldeanueva de Figueroa,292,150,142
37,Salamanca,18,Aldeanueva de la Sierra,143,79,64
37,Salamanca,19,Aldearrodrigo,167,88,79
37,Salamanca,20,Aldearrubia,527,286,241
37,Salamanca,21,Aldeaseca de Alba,87,39,48
37,Salamanca,22,Aldeaseca de la Frontera,324,165,159
37,Salamanca,23,Aldeatejada,1326,678,648
37,Salamanca,24,Aldeavieja de Tormes,109,55,54
37,Salamanca,25,Aldehuela de la Bóveda,308,154,154
37,Salamanca,26,Aldehuela de Yeltes,223,125,98
37,Salamanca,27,Almenara de Tormes,282,153,129
37,Salamanca,28,Almendra,190,105,85
37,Salamanca,29,Anaya de Alba,241,137,104
37,Salamanca,30,Añover de Tormes,101,57,44
37,Salamanca,31,Arabayona de Mógica,446,240,206
37,Salamanca,32,Arapiles,598,310,288
37,Salamanca,33,Arcediano,106,58,48
37,Salamanca,34,"Arco, El",103,57,46
37,Salamanca,35,Armenteros,395,202,193
37,Salamanca,36,San Miguel del Robledo,72,33,39
37,Salamanca,37,"Atalaya, La",136,74,62
37,Salamanca,38,Babilafuente,936,490,446
37,Salamanca,39,Bañobárez,359,184,175
37,Salamanca,40,Barbadillo,462,239,223
37,Salamanca,41,Barbalos,85,47,38
37,Salamanca,42,Barceo,51,28,23
37,Salamanca,44,Barruecopardo,521,276,245
37,Salamanca,45,"Bastida, La",28,17,11
37,Salamanca,46,Béjar,14511,6932,7579
37,Salamanca,47,Beleña,227,102,125
37,Salamanca,49,Bermellar,169,86,83
37,Salamanca,50,Berrocal de Huebra,75,39,36
37,Salamanca,51,Berrocal de Salvatierra,98,49,49
37,Salamanca,52,Boada,318,161,157
37,Salamanca,54,"Bodón, El",315,160,155
37,Salamanca,55,Bogajo,154,83,71
37,Salamanca,56,"Bouza, La",76,41,35
37,Salamanca,57,Bóveda del Río Almar,260,136,124
37,Salamanca,58,Brincones,72,35,37
37,Salamanca,59,Buenamadre,141,79,62
37,Salamanca,60,Buenavista,246,136,110
37,Salamanca,61,"Cabaco, El",317,158,159
37,Salamanca,62,Cabezabellosa de la Calzada,96,52,44
37,Salamanca,63,"Cabeza de Béjar, La",97,56,41
37,Salamanca,65,Cabeza del Caballo,377,200,177
37,Salamanca,67,Cabrerizos,3993,1998,1995
37,Salamanca,68,Cabrillas,428,210,218
37,Salamanca,69,Calvarrasa de Abajo,1135,592,543
37,Salamanca,70,Calvarrasa de Arriba,666,349,317
37,Salamanca,71,"Calzada de Béjar, La",101,54,47
37,Salamanca,72,Calzada de Don Diego,199,106,93
37,Salamanca,73,Calzada de Valdunciel,656,336,320
37,Salamanca,74,Campillo de Azaba,193,102,91
37,Salamanca,77,"Campo de Peñaranda, El",311,167,144
37,Salamanca,78,Candelario,1033,519,514
37,Salamanca,79,Canillas de Abajo,86,57,29
37,Salamanca,80,Cantagallo,279,146,133
37,Salamanca,81,Cantalapiedra,1110,565,545
37,Salamanca,82,Cantalpino,1007,552,455
37,Salamanca,83,Cantaracillo,213,113,100
37,Salamanca,85,Carbajosa de la Sagrada,6213,3189,3024
37,Salamanca,86,Carpio de Azaba,114,64,50
37,Salamanca,87,Carrascal de Barregas,970,511,459
37,Salamanca,88,Carrascal del Obispo,233,123,110
37,Salamanca,89,Casafranca,73,39,34
37,Salamanca,90,"Casas del Conde, Las",65,35,30
37,Salamanca,91,Casillas de Flores,214,106,108
37,Salamanca,92,Castellanos de Moriscos,1812,942,870
37,Salamanca,96,Castillejo de Martín Viejo,257,143,114
37,Salamanca,97,Castraz,49,28,21
37,Salamanca,98,Cepeda,400,198,202
37,Salamanca,99,Cereceda de la Sierra,119,60,59
37,Salamanca,100,Cerezal de Peñahorcada,90,51,39
37,Salamanca,101,Cerralbo,215,118,97
37,Salamanca,102,"Cerro, El",463,233,230
37,Salamanca,103,Cespedosa de Tormes,593,324,269
37,Salamanca,104,Cilleros de la Bastida,39,23,16
37,Salamanca,106,Cipérez,311,156,155
37,Salamanca,107,Ciudad Rodrigo,13708,6663,7045
37,Salamanca,108,Coca de Alba,110,54,56
37,Salamanca,109,Colmenar de Montemayor,201,110,91
37,Salamanca,110,Cordovilla,128,72,56
37,Salamanca,112,Cristóbal,196,106,90
37,Salamanca,113,"Cubo de Don Sancho, El",494,260,234
37,Salamanca,114,Chagarcía Medianero,97,52,45
37,Salamanca,115,Dios le Guarde,158,85,73
37,Salamanca,116,Doñinos de Ledesma,84,42,42
37,Salamanca,117,Doñinos de Salamanca,1735,922,813
37,Salamanca,118,Ejeme,154,89,65
37,Salamanca,119,"Encina, La",126,77,49
37,Salamanca,120,Encina de San Silvestre,119,60,59
37,Salamanca,121,Encinas de Abajo,620,322,298
37,Salamanca,122,Encinas de Arriba,252,126,126
37,Salamanca,123,Encinasola de los Comendadores,217,113,104
37,Salamanca,124,Endrinal,256,137,119
37,Salamanca,125,Escurial de la Sierra,277,148,129
37,Salamanca,126,Espadaña,41,22,19
37,Salamanca,127,Espeja,276,137,139
37,Salamanca,128,Espino de la Orbada,289,153,136
37,Salamanca,129,Florida de Liébana,288,151,137
37,Salamanca,130,Forfoleda,194,105,89
37,Salamanca,131,Frades de la Sierra,224,123,101
37,Salamanca,132,"Fregeneda, La",440,223,217
37,Salamanca,133,Fresnedoso,114,63,51
37,Salamanca,134,Fresno Alhándiga,273,148,125
37,Salamanca,135,"Fuente de San Esteban, La",1453,741,712
37,Salamanca,136,Fuenteguinaldo,774,393,381
37,Salamanca,137,Fuenteliante,120,62,58
37,Salamanca,138,Fuenterroble de Salvatierra,260,133,127
37,Salamanca,139,Fuentes de Béjar,260,130,130
37,Salamanca,140,Fuentes de Oñoro,1420,700,720
37,Salamanca,141,Gajates,175,82,93
37,Salamanca,142,Galindo y Perahuy,742,431,311
37,Salamanca,143,Galinduste,474,232,242
37,Salamanca,144,Galisancho,431,237,194
37,Salamanca,145,Gallegos de Argañán,322,166,156
37,Salamanca,146,Gallegos de Solmirón,145,74,71
37,Salamanca,147,Garcibuey,198,110,88
37,Salamanca,148,Garcihernández,528,275,253
37,Salamanca,149,Garcirrey,82,44,38
37,Salamanca,150,Gejuelo del Barro,44,25,19
37,Salamanca,151,Golpejas,164,86,78
37,Salamanca,152,Gomecello,554,290,264
37,Salamanca,154,Guadramiro,168,96,72
37,Salamanca,155,Guijo de Ávila,105,59,46
37,Salamanca,156,Guijuelo,6050,3086,2964
37,Salamanca,157,Herguijuela de Ciudad Rodrigo,98,54,44
37,Salamanca,158,Herguijuela de la Sierra,296,159,137
37,Salamanca,159,Herguijuela del Campo,109,52,57
37,Salamanca,160,Hinojosa de Duero,722,360,362
37,Salamanca,161,Horcajo de Montemayor,170,89,81
37,Salamanca,162,Horcajo Medianero,251,135,116
37,Salamanca,163,"Hoya, La",48,27,21
37,Salamanca,164,Huerta,329,183,146
37,Salamanca,165,Iruelos,37,17,20
37,Salamanca,166,Ituero de Azaba,239,125,114
37,Salamanca,167,Juzbado,173,90,83
37,Salamanca,168,Lagunilla,549,296,253
37,Salamanca,169,Larrodrigo,219,123,96
37,Salamanca,170,Ledesma,1958,980,978
37,Salamanca,171,Ledrada,571,284,287
37,Salamanca,172,Linares de Riofrío,991,534,457
37,Salamanca,173,Lumbrales,1894,950,944
37,Salamanca,174,Macotera,1304,682,622
37,Salamanca,175,Machacón,480,250,230
37,Salamanca,176,Madroñal,162,94,68
37,Salamanca,177,"Maíllo, El",325,182,143
37,Salamanca,178,Malpartida,112,64,48
37,Salamanca,179,Mancera de Abajo,252,128,124
37,Salamanca,180,"Manzano, El",73,39,34
37,Salamanca,181,Martiago,333,174,159
37,Salamanca,182,Martinamor,116,68,48
37,Salamanca,183,Martín de Yeltes,455,237,218
37,Salamanca,184,Masueco,411,205,206
37,Salamanca,185,Castellanos de Villiquera,687,368,319
37,Salamanca,186,"Mata de Ledesma, La",120,63,57
37,Salamanca,187,Matilla de los Caños del Río,663,336,327
37,Salamanca,188,"Maya, La",215,123,92
37,Salamanca,189,Membribe de la Sierra,149,89,60
37,Salamanca,190,Mieza,248,123,125
37,Salamanca,191,"Milano, El",136,78,58
37,Salamanca,192,Miranda de Azán,443,226,217
37,Salamanca,193,Miranda del Castañar,505,266,239
37,Salamanca,194,Mogarraz,321,161,160
37,Salamanca,195,Molinillo,53,29,24
37,Salamanca,196,Monforte de la Sierra,108,61,47
37,Salamanca,197,Monleón,103,58,45
37,Salamanca,198,Monleras,263,123,140
37,Salamanca,199,Monsagro,167,93,74
37,Salamanca,200,Montejo,232,125,107
37,Salamanca,201,Montemayor del Río,304,157,147
37,Salamanca,202,Monterrubio de Armuña,1255,666,589
37,Salamanca,203,Monterrubio de la Sierra,197,108,89
37,Salamanca,204,Morasverdes,315,169,146
37,Salamanca,205,Morille,263,137,126
37,Salamanca,206,Moríñigo,108,55,53
37,Salamanca,207,Moriscos,326,181,145
37,Salamanca,208,Moronta,99,57,42
37,Salamanca,209,Mozárbez,471,254,217
37,Salamanca,211,Narros de Matalayegua,235,123,112
37,Salamanca,212,Navacarros,132,74,58
37,Salamanca,213,Nava de Béjar,111,58,53
37,Salamanca,214,Nava de Francia,139,74,65
37,Salamanca,215,Nava de Sotrobal,190,103,87
37,Salamanca,216,Navales,331,179,152
37,Salamanca,217,Navalmoral de Béjar,60,26,34
37,Salamanca,218,Navamorales,85,50,35
37,Salamanca,219,Navarredonda de la Rinconada,210,109,101
37,Salamanca,221,Navasfrías,515,264,251
37,Salamanca,222,Negrilla de Palencia,132,67,65
37,Salamanca,223,Olmedo de Camaces,134,73,61
37,Salamanca,224,"Orbada, La",233,118,115
37,Salamanca,225,Pajares de la Laguna,136,72,64
37,Salamanca,226,Palacios del Arzobispo,181,92,89
37,Salamanca,228,Palaciosrubios,435,232,203
37,Salamanca,229,Palencia de Negrilla,163,91,72
37,Salamanca,230,Parada de Arriba,264,138,126
37,Salamanca,231,Parada de Rubiales,310,164,146
37,Salamanca,232,Paradinas de San Juan,474,265,209
37,Salamanca,233,Pastores,64,36,28
37,Salamanca,234,"Payo, El",412,205,207
37,Salamanca,235,Pedraza de Alba,259,135,124
37,Salamanca,236,Pedrosillo de Alba,161,88,73
37,Salamanca,237,Pedrosillo de los Aires,388,214,174
37,Salamanca,238,Pedrosillo el Ralo,142,71,71
37,Salamanca,239,"Pedroso de la Armuña, El",257,126,131
37,Salamanca,240,Pelabravo,965,504,461
37,Salamanca,241,Pelarrodríguez,185,106,79
37,Salamanca,242,Pelayos,119,65,54
37,Salamanca,243,"Peña, La",129,60,69
37,Salamanca,244,Peñacaballera,163,75,88
37,Salamanca,245,Peñaparda,399,208,191
37,Salamanca,246,Peñaranda de Bracamonte,6766,3345,3421
37,Salamanca,247,Peñarandilla,229,122,107
37,Salamanca,248,Peralejos de Abajo,173,94,79
37,Salamanca,249,Peralejos de Arriba,49,29,20
37,Salamanca,250,Pereña de la Ribera,408,211,197
37,Salamanca,251,Peromingo,154,72,82
37,Salamanca,252,Pinedas,136,76,60
37,Salamanca,253,"Pino de Tormes, El",164,84,80
37,Salamanca,254,Pitiegua,208,114,94
37,Salamanca,255,Pizarral,77,39,38
37,Salamanca,256,Poveda de las Cintas,265,148,117
37,Salamanca,257,Pozos de Hinojo,54,30,24
37,Salamanca,258,Puebla de Azaba,229,119,110
37,Salamanca,259,Puebla de San Medel,42,23,19
37,Salamanca,260,Puebla de Yeltes,174,94,80
37,Salamanca,261,Puente del Congosto,266,142,124
37,Salamanca,262,Puertas,85,47,38
37,Salamanca,263,Puerto de Béjar,397,199,198
37,Salamanca,264,Puerto Seguro,78,40,38
37,Salamanca,265,Rágama,250,124,126
37,Salamanca,266,"Redonda, La",92,52,40
37,Salamanca,267,Retortillo,234,115,119
37,Salamanca,268,"Rinconada de la Sierra, La",127,71,56
37,Salamanca,269,Robleda,530,274,256
37,Salamanca,270,Robliza de Cojos,241,127,114
37,Salamanca,271,Rollán,448,237,211
37,Salamanca,272,Saelices el Chico,168,85,83
37,Salamanca,273,"Sagrada, La",128,65,63
37,Salamanca,274,Salamanca,153472,70740,82732
37,Salamanca,275,Saldeana,141,80,61
37,Salamanca,276,Salmoral,216,117,99
37,Salamanca,277,Salvatierra de Tormes,60,28,32
37,Salamanca,278,San Cristóbal de la Cuesta,980,523,457
37,Salamanca,279,Sancti-Spíritus,891,471,420
37,Salamanca,280,Sanchón de la Ribera,93,49,44
37,Salamanca,281,Sanchón de la Sagrada,38,21,17
37,Salamanca,282,Sanchotello,225,118,107
37,Salamanca,283,Sando,149,84,65
37,Salamanca,284,San Esteban de la Sierra,365,187,178
37,Salamanca,285,San Felices de los Gallegos,504,258,246
37,Salamanca,286,San Martín del Castañar,267,141,126
37,Salamanca,287,San Miguel de Valero,378,182,196
37,Salamanca,288,San Morales,286,165,121
37,Salamanca,289,San Muñoz,281,146,135
37,Salamanca,290,San Pedro del Valle,146,79,67
37,Salamanca,291,San Pedro de Rozados,318,165,153
37,Salamanca,292,San Pelayo de Guareña,101,55,46
37,Salamanca,293,Santa María de Sando,133,68,65
37,Salamanca,294,Santa Marta de Tormes,14853,7429,7424
37,Salamanca,296,Santiago de la Puebla,417,219,198
37,Salamanca,297,Santibáñez de Béjar,533,270,263
37,Salamanca,298,Santibáñez de la Sierra,219,113,106
37,Salamanca,299,Santiz,262,133,129
37,Salamanca,300,"Santos, Los",652,339,313
37,Salamanca,301,Sardón de los Frailes,88,47,41
37,Salamanca,302,Saucelle,387,198,189
37,Salamanca,303,"Sahugo, El",229,115,114
37,Salamanca,304,Sepulcro-Hilario,198,111,87
37,Salamanca,305,Sequeros,232,111,121
37,Salamanca,306,Serradilla del Arroyo,338,179,159
37,Salamanca,307,Serradilla del Llano,184,90,94
37,Salamanca,309,"Sierpe, La",43,27,16
37,Salamanca,310,Sieteiglesias de Tormes,181,84,97
37,Salamanca,311,Sobradillo,276,140,136
37,Salamanca,312,Sorihuela,328,164,164
37,Salamanca,313,Sotoserrano,655,345,310
37,Salamanca,314,Tabera de Abajo,100,54,46
37,Salamanca,315,"Tala, La",106,59,47
37,Salamanca,316,Tamames,945,486,459
37,Salamanca,317,Tarazona de Guareña,361,195,166
37,Salamanca,318,Tardáguila,245,133,112
37,Salamanca,319,"Tejado, El",145,78,67
37,Salamanca,320,Tejeda y Segoyuela,101,57,44
37,Salamanca,321,Tenebrón,171,83,88
37,Salamanca,322,Terradillos,3419,1766,1653
37,Salamanca,323,Topas,612,324,288
37,Salamanca,324,Tordillos,446,238,208
37,Salamanca,325,"Tornadizo, El",117,62,55
37,Salamanca,327,Torresmenudas,213,104,109
37,Salamanca,328,Trabanca,257,126,131
37,Salamanca,329,Tremedal de Tormes,42,21,21
37,Salamanca,330,Valdecarros,385,202,183
37,Salamanca,331,Valdefuentes de Sangusín,257,131,126
37,Salamanca,332,Valdehijaderos,90,50,40
37,Salamanca,333,Valdelacasa,273,153,120
37,Salamanca,334,Valdelageve,97,47,50
37,Salamanca,335,Valdelosa,501,240,261
37,Salamanca,336,Valdemierque,61,35,26
37,Salamanca,337,Valderrodrigo,161,80,81
37,Salamanca,338,Valdunciel,104,55,49
37,Salamanca,339,Valero,361,190,171
37,Salamanca,340,Valsalabroso,168,97,71
37,Salamanca,341,Valverde de Valdelacasa,85,48,37
37,Salamanca,342,Valverdón,283,142,141
37,Salamanca,343,Vallejera de Riofrío,68,32,36
37,Salamanca,344,Vecinos,304,155,149
37,Salamanca,345,Vega de Tirados,200,97,103
37,Salamanca,346,"Veguillas, Las",287,137,150
37,Salamanca,347,"Vellés, La",585,318,267
37,Salamanca,348,Ventosa del Río Almar,128,68,60
37,Salamanca,349,"Vídola, La",146,70,76
37,Salamanca,350,Vilvestre,490,239,251
37,Salamanca,351,Villaflores,321,164,157
37,Salamanca,352,Villagonzalo de Tormes,224,126,98
37,Salamanca,353,Villalba de los Llanos,157,91,66
37,Salamanca,354,Villamayor,6589,3338,3251
37,Salamanca,355,Villanueva del Conde,182,96,86
37,Salamanca,356,Villar de Argañán,100,49,51
37,Salamanca,357,Villar de Ciervo,310,163,147
37,Salamanca,358,Villar de Gallimazo,169,93,76
37,Salamanca,359,Villar de la Yegua,209,107,102
37,Salamanca,360,Villar de Peralonso,278,132,146
37,Salamanca,361,Villar de Samaniego,101,56,45
37,Salamanca,362,Villares de la Reina,5914,2957,2957
37,Salamanca,363,Villares de Yeltes,137,66,71
37,Salamanca,364,Villarino de los Aires,975,497,478
37,Salamanca,365,Villarmayor,209,111,98
37,Salamanca,366,Villarmuerto,45,28,17
37,Salamanca,367,Villasbuenas,231,124,107
37,Salamanca,368,Villasdardo,21,9,12
37,Salamanca,369,Villaseco de los Gamitos,170,93,77
37,Salamanca,370,Villaseco de los Reyes,400,227,173
37,Salamanca,371,Villasrubias,245,138,107
37,Salamanca,372,Villaverde de Guareña,156,81,75
37,Salamanca,373,Villavieja de Yeltes,924,463,461
37,Salamanca,374,Villoria,1491,762,729
37,Salamanca,375,Villoruela,912,466,446
37,Salamanca,376,Vitigudino,2894,1438,1456
37,Salamanca,377,Yecla de Yeltes,294,149,145
37,Salamanca,378,Zamarra,116,64,52
37,Salamanca,379,Zamayón,181,103,78
37,Salamanca,380,Zarapicos,58,31,27
37,Salamanca,381,"Zarza de Pumareda, La",157,89,68
37,Salamanca,382,Zorita de la Frontera,216,113,103
38,Santa Cruz de Tenerife,1,Adeje,45134,23234,21900
38,Santa Cruz de Tenerife,2,Agulo,1202,608,594
38,Santa Cruz de Tenerife,3,Alajeró,2016,1083,933
38,Santa Cruz de Tenerife,4,Arafo,5536,2753,2783
38,Santa Cruz de Tenerife,5,Arico,7924,4070,3854
38,Santa Cruz de Tenerife,6,Arona,75339,38836,36503
38,Santa Cruz de Tenerife,7,Barlovento,2231,1123,1108
38,Santa Cruz de Tenerife,8,Breña Alta,7344,3630,3714
38,Santa Cruz de Tenerife,9,Breña Baja,5348,2706,2642
38,Santa Cruz de Tenerife,10,Buenavista del Norte,5103,2625,2478
38,Santa Cruz de Tenerife,11,Candelaria,25957,12744,13213
38,Santa Cruz de Tenerife,12,Fasnia,3015,1544,1471
38,Santa Cruz de Tenerife,13,Frontera,4143,2101,2042
38,Santa Cruz de Tenerife,14,Fuencaliente de la Palma,1905,968,937
38,Santa Cruz de Tenerife,15,Garachico,5327,2658,2669
38,Santa Cruz de Tenerife,16,Garafía,1707,879,828
38,Santa Cruz de Tenerife,17,Granadilla de Abona,41555,21207,20348
38,Santa Cruz de Tenerife,18,"Guancha, La",5455,2683,2772
38,Santa Cruz de Tenerife,19,Guía de Isora,20396,10249,10147
38,Santa Cruz de Tenerife,20,Güímar,18131,8987,9144
38,Santa Cruz de Tenerife,21,Hermigua,2232,1123,1109
38,Santa Cruz de Tenerife,22,Icod de los Vinos,24147,12012,12135
38,Santa Cruz de Tenerife,23,San Cristóbal de La Laguna,153187,74907,78280
38,Santa Cruz de Tenerife,24,"Llanos de Aridane, Los",21145,10331,10814
38,Santa Cruz de Tenerife,25,"Matanza de Acentejo, La",8655,4418,4237
38,Santa Cruz de Tenerife,26,"Orotava, La",41706,20552,21154
38,Santa Cruz de Tenerife,27,"Paso, El",7947,3989,3958
38,Santa Cruz de Tenerife,28,Puerto de la Cruz,32817,16010,16807
38,Santa Cruz de Tenerife,29,Puntagorda,2028,1066,962
38,Santa Cruz de Tenerife,30,Puntallana,2416,1216,1200
38,Santa Cruz de Tenerife,31,"Realejos, Los",38015,18791,19224
38,Santa Cruz de Tenerife,32,"Rosario, El",17383,8948,8435
38,Santa Cruz de Tenerife,33,San Andrés y Sauces,4860,2463,2397
38,Santa Cruz de Tenerife,34,San Juan de la Rambla,5093,2536,2557
38,Santa Cruz de Tenerife,35,San Miguel de Abona,17130,8678,8452
38,Santa Cruz de Tenerife,36,San Sebastián de la Gomera,9120,4628,4492
38,Santa Cruz de Tenerife,37,Santa Cruz de la Palma,16924,8225,8699
38,Santa Cruz de Tenerife,38,Santa Cruz de Tenerife,222271,106496,115775
38,Santa Cruz de Tenerife,39,Santa Úrsula,14333,7193,7140
38,Santa Cruz de Tenerife,40,Santiago del Teide,12274,6166,6108
38,Santa Cruz de Tenerife,41,"Sauzal, El",9065,4495,4570
38,Santa Cruz de Tenerife,42,"Silos, Los",5257,2626,2631
38,Santa Cruz de Tenerife,43,Tacoronte,23699,11887,11812
38,Santa Cruz de Tenerife,44,"Tanque, El",2903,1438,1465
38,Santa Cruz de Tenerife,45,Tazacorte,5559,2829,2730
38,Santa Cruz de Tenerife,46,Tegueste,10874,5401,5473
38,Santa Cruz de Tenerife,47,Tijarafe,2763,1398,1365
38,Santa Cruz de Tenerife,48,Valverde,5048,2568,2480
38,Santa Cruz de Tenerife,49,Valle Gran Rey,5364,2714,2650
38,Santa Cruz de Tenerife,50,Vallehermoso,3142,1612,1530
38,Santa Cruz de Tenerife,51,"Victoria de Acentejo, La",9043,4536,4507
38,Santa Cruz de Tenerife,52,Vilaflor,1831,945,886
38,Santa Cruz de Tenerife,53,Villa de Mazo,4986,2526,2460
38,Santa Cruz de Tenerife,901,"Pinar de El Hierro, El",1804,939,865
39,Cantabria,1,Alfoz de Lloredo,2484,1263,1221
39,Cantabria,2,Ampuero,4230,2166,2064
39,Cantabria,3,Anievas,363,177,186
39,Cantabria,4,Arenas de Iguña,1806,925,881
39,Cantabria,5,Argoños,1712,893,819
39,Cantabria,6,Arnuero,2101,1071,1030
39,Cantabria,7,Arredondo,515,291,224
39,Cantabria,8,"Astillero, El",17675,8668,9007
39,Cantabria,9,Bárcena de Cicero,4074,2124,1950
39,Cantabria,10,Bárcena de Pie de Concha,770,382,388
39,Cantabria,11,Bareyo,2075,1046,1029
39,Cantabria,12,Cabezón de la Sal,8303,4065,4238
39,Cantabria,13,Cabezón de Liébana,699,418,281
39,Cantabria,14,Cabuérniga,1077,564,513
39,Cantabria,15,Camaleño,1048,565,483
39,Cantabria,16,Camargo,31556,15559,15997
39,Cantabria,17,Campoo de Yuso,697,375,322
39,Cantabria,18,Cartes,5423,2764,2659
39,Cantabria,19,Castañeda,2470,1263,1207
39,Cantabria,20,Castro-Urdiales,32374,16355,16019
39,Cantabria,21,Cieza,607,307,300
39,Cantabria,22,Cillorigo de Liébana,1336,728,608
39,Cantabria,23,Colindres,7948,3943,4005
39,Cantabria,24,Comillas,2425,1152,1273
39,Cantabria,25,"Corrales de Buelna, Los",11623,5733,5890
39,Cantabria,26,Corvera de Toranzo,2191,1121,1070
39,Cantabria,27,Campoo de Enmedio,3792,1971,1821
39,Cantabria,28,Entrambasaguas,4443,2299,2144
39,Cantabria,29,Escalante,763,404,359
39,Cantabria,30,Guriezo,2435,1268,1167
39,Cantabria,31,Hazas de Cesto,1516,778,738
39,Cantabria,32,Hermandad de Campoo de Suso,1784,962,822
39,Cantabria,33,Herrerías,641,359,282
39,Cantabria,34,Lamasón,310,198,112
39,Cantabria,35,Laredo,12206,5889,6317
39,Cantabria,36,Liendo,1256,646,610
39,Cantabria,37,Liérganes,2457,1234,1223
39,Cantabria,38,Limpias,1841,928,913
39,Cantabria,39,Luena,710,389,321
39,Cantabria,40,Marina de Cudeyo,5280,2663,2617
39,Cantabria,41,Mazcuerras,2121,1091,1030
39,Cantabria,42,Medio Cudeyo,7561,3698,3863
39,Cantabria,43,Meruelo,1742,888,854
39,Cantabria,44,Miengo,4648,2347,2301
39,Cantabria,45,Miera,439,228,211
39,Cantabria,46,Molledo,1634,806,828
39,Cantabria,47,Noja,2645,1327,1318
39,Cantabria,48,Penagos,1878,958,920
39,Cantabria,49,Peñarrubia,373,198,175
39,Cantabria,50,Pesaguero,348,199,149
39,Cantabria,51,Pesquera,89,45,44
39,Cantabria,52,Piélagos,22223,11201,11022
39,Cantabria,53,Polaciones,265,164,101
39,Cantabria,54,Polanco,5283,2606,2677
39,Cantabria,55,Potes,1481,724,757
39,Cantabria,56,Puente Viesgo,2846,1450,1396
39,Cantabria,57,Ramales de la Victoria,2784,1423,1361
39,Cantabria,58,Rasines,1024,558,466
39,Cantabria,59,Reinosa,10177,4802,5375
39,Cantabria,60,Reocín,8287,4106,4181
39,Cantabria,61,Ribamontán al Mar,4476,2271,2205
39,Cantabria,62,Ribamontán al Monte,2141,1112,1029
39,Cantabria,63,Rionansa,1112,637,475
39,Cantabria,64,Riotuerto,1627,796,831
39,Cantabria,65,"Rozas de Valdearroyo, Las",295,162,133
39,Cantabria,66,Ruente,1052,564,488
39,Cantabria,67,Ruesga,1005,532,473
39,Cantabria,68,Ruiloba,799,408,391
39,Cantabria,69,San Felices de Buelna,2318,1147,1171
39,Cantabria,70,San Miguel de Aguayo,166,85,81
39,Cantabria,71,San Pedro del Romeral,528,287,241
39,Cantabria,72,San Roque de Riomiera,437,251,186
39,Cantabria,73,Santa Cruz de Bezana,11776,5781,5995
39,Cantabria,74,Santa María de Cayón,9005,4634,4371
39,Cantabria,75,Santander,179921,83415,96506
39,Cantabria,76,Santillana del Mar,4029,1960,2069
39,Cantabria,77,Santiurde de Reinosa,298,170,128
39,Cantabria,78,Santiurde de Toranzo,1581,802,779
39,Cantabria,79,Santoña,11465,5670,5795
39,Cantabria,80,San Vicente de la Barquera,4475,2242,2233
39,Cantabria,81,Saro,504,262,242
39,Cantabria,82,Selaya,2035,1011,1024
39,Cantabria,83,Soba,1335,713,622
39,Cantabria,84,Solórzano,1056,569,487
39,Cantabria,85,Suances,8489,4241,4248
39,Cantabria,86,"Tojos, Los",434,246,188
39,Cantabria,87,Torrelavega,55553,26573,28980
39,Cantabria,88,Tresviso,74,47,27
39,Cantabria,89,Tudanca,174,121,53
39,Cantabria,90,Udías,871,447,424
39,Cantabria,91,Valdáliga,2326,1213,1113
39,Cantabria,92,Valdeolea,1145,593,552
39,Cantabria,93,Valdeprado del Río,380,212,168
39,Cantabria,94,Valderredible,1107,619,488
39,Cantabria,95,Val de San Vicente,2846,1444,1402
39,Cantabria,96,Vega de Liébana,851,451,400
39,Cantabria,97,Vega de Pas,849,430,419
39,Cantabria,98,Villacarriedo,1749,910,839
39,Cantabria,99,Villaescusa,3687,1863,1824
39,Cantabria,100,Villafufre,1124,587,537
39,Cantabria,101,Valle de Villaverde,369,188,181
39,Cantabria,102,Voto,2793,1481,1312
40,Segovia,1,Abades,882,448,434
40,Segovia,2,Adrada de Pirón,46,23,23
40,Segovia,3,Adrados,158,87,71
40,Segovia,4,Aguilafuente,700,338,362
40,Segovia,5,Alconada de Maderuelo,36,22,14
40,Segovia,6,Aldealcorvo,25,18,7
40,Segovia,7,Aldealengua de Pedraza,98,58,40
40,Segovia,8,Aldealengua de Santa María,83,40,43
40,Segovia,9,Aldeanueva de la Serrezuela,58,37,21
40,Segovia,10,Aldeanueva del Codonal,150,80,70
40,Segovia,12,Aldea Real,348,185,163
40,Segovia,13,Aldeasoña,73,44,29
40,Segovia,14,Aldehorno,60,32,28
40,Segovia,15,Aldehuela del Codonal,32,17,15
40,Segovia,16,Aldeonte,67,29,38
40,Segovia,17,Anaya,149,70,79
40,Segovia,18,Añe,106,60,46
40,Segovia,19,Arahuetes,44,27,17
40,Segovia,20,Arcones,241,127,114
40,Segovia,21,Arevalillo de Cega,36,19,17
40,Segovia,22,Armuña,241,132,109
40,Segovia,24,Ayllón,1383,737,646
40,Segovia,25,Barbolla,209,118,91
40,Segovia,26,Basardilla,166,79,87
40,Segovia,28,Bercial,112,59,53
40,Segovia,29,Bercimuel,50,27,23
40,Segovia,30,Bernardos,608,323,285
40,Segovia,31,Bernuy de Porreros,704,381,323
40,Segovia,32,Boceguillas,767,391,376
40,Segovia,33,Brieva,78,51,27
40,Segovia,34,Caballar,105,51,54
40,Segovia,35,Cabañas de Polendos,156,83,73
40,Segovia,36,Cabezuela,698,358,340
40,Segovia,37,Calabazas de Fuentidueña,41,22,19
40,Segovia,39,Campo de San Pedro,350,204,146
40,Segovia,40,Cantalejo,3918,1980,1938
40,Segovia,41,Cantimpalos,1427,740,687
40,Segovia,43,Carbonero el Mayor,2589,1323,1266
40,Segovia,44,Carrascal del Río,165,90,75
40,Segovia,45,Casla,169,88,81
40,Segovia,46,Castillejo de Mesleón,158,94,64
40,Segovia,47,Castro de Fuentidueña,57,33,24
40,Segovia,48,Castrojimeno,37,20,17
40,Segovia,49,Castroserna de Abajo,60,26,34
40,Segovia,51,Castroserracín,62,37,25
40,Segovia,52,Cedillo de la Torre,129,61,68
40,Segovia,53,Cerezo de Abajo,165,95,70
40,Segovia,54,Cerezo de Arriba,203,107,96
40,Segovia,55,Cilleruelo de San Mamés,42,24,18
40,Segovia,56,Cobos de Fuentidueña,39,17,22
40,Segovia,57,Coca,2088,1023,1065
40,Segovia,58,Codorniz,395,203,192
40,Segovia,59,Collado Hermoso,164,80,84
40,Segovia,60,Condado de Castilnovo,98,53,45
40,Segovia,61,Corral de Ayllón,82,52,30
40,Segovia,62,Cubillo,68,39,29
40,Segovia,63,Cuéllar,9725,4918,4807
40,Segovia,65,Chañe,887,430,457
40,Segovia,68,Domingo García,36,20,16
40,Segovia,69,Donhierro,119,67,52
40,Segovia,70,Duruelo,176,103,73
40,Segovia,71,Encinas,55,32,23
40,Segovia,72,Encinillas,195,114,81
40,Segovia,73,Escalona del Prado,598,309,289
40,Segovia,74,Escarabajosa de Cabezas,335,190,145
40,Segovia,75,Escobar de Polendos,200,105,95
40,Segovia,76,"Espinar, El",9749,5018,4731
40,Segovia,77,Espirdo,985,529,456
40,Segovia,78,Fresneda de Cuéllar,196,107,89
40,Segovia,79,Fresno de Cantespino,275,154,121
40,Segovia,80,Fresno de la Fuente,111,59,52
40,Segovia,81,Frumales,169,85,84
40,Segovia,82,Fuente de Santa Cruz,137,67,70
40,Segovia,83,Fuente el Olmo de Fuentidueña,172,61,111
40,Segovia,84,Fuente el Olmo de Íscar,78,41,37
40,Segovia,86,Fuentepelayo,988,503,485
40,Segovia,87,Fuentepiñel,126,64,62
40,Segovia,88,Fuenterrebollo,376,197,179
40,Segovia,89,Fuentesaúco de Fuentidueña,294,158,136
40,Segovia,91,Fuentesoto,157,85,72
40,Segovia,92,Fuentidueña,119,61,58
40,Segovia,93,Gallegos,99,52,47
40,Segovia,94,Garcillán,472,253,219
40,Segovia,95,Gomezserracín,714,368,346
40,Segovia,97,Grajera,244,131,113
40,Segovia,99,Honrubia de la Cuesta,75,42,33
40,Segovia,100,Hontalbilla,343,186,157
40,Segovia,101,Hontanares de Eresma,1054,535,519
40,Segovia,103,"Huertos, Los",174,100,74
40,Segovia,104,Ituero y Lama,369,192,177
40,Segovia,105,Juarros de Riomoros,69,40,29
40,Segovia,106,Juarros de Voltoya,285,139,146
40,Segovia,107,Labajos,154,82,72
40,Segovia,108,Laguna de Contreras,121,71,50
40,Segovia,109,Languilla,92,49,43
40,Segovia,110,Lastras de Cuéllar,457,227,230
40,Segovia,111,Lastras del Pozo,84,41,43
40,Segovia,112,"Lastrilla, La",3405,1756,1649
40,Segovia,113,"Losa, La",544,288,256
40,Segovia,115,Maderuelo,159,91,68
40,Segovia,118,Marazuela,60,33,27
40,Segovia,119,Martín Miguel,267,155,112
40,Segovia,120,Martín Muñoz de la Dehesa,205,110,95
40,Segovia,121,Martín Muñoz de las Posadas,373,185,188
40,Segovia,122,Marugán,679,369,310
40,Segovia,123,Matabuena,242,130,112
40,Segovia,124,Mata de Cuéllar,296,157,139
40,Segovia,125,"Matilla, La",106,60,46
40,Segovia,126,Melque de Cercos,99,51,48
40,Segovia,127,Membibre de la Hoz,45,23,22
40,Segovia,128,Migueláñez,167,80,87
40,Segovia,129,Montejo de Arévalo,225,122,103
40,Segovia,130,Montejo de la Vega de la Serrezuela,160,89,71
40,Segovia,131,Monterrubio,64,34,30
40,Segovia,132,Moral de Hornuez,92,51,41
40,Segovia,134,Mozoncillo,1097,587,510
40,Segovia,135,Muñopedro,324,172,152
40,Segovia,136,Muñoveros,194,98,96
40,Segovia,138,Nava de la Asunción,3011,1519,1492
40,Segovia,139,Navafría,365,195,170
40,Segovia,140,Navalilla,121,60,61
40,Segovia,141,Navalmanzano,1183,613,570
40,Segovia,142,Navares de Ayuso,57,29,28
40,Segovia,143,Navares de Enmedio,116,68,48
40,Segovia,144,Navares de las Cuevas,23,16,7
40,Segovia,145,Navas de Oro,1459,742,717
40,Segovia,146,Navas de San Antonio,449,247,202
40,Segovia,148,Nieva,343,181,162
40,Segovia,149,Olombrada,694,378,316
40,Segovia,150,Orejana,75,46,29
40,Segovia,151,Ortigosa de Pestaño,94,49,45
40,Segovia,152,Otero de Herreros,1009,518,491
40,Segovia,154,Pajarejos,26,15,11
40,Segovia,155,Palazuelos de Eresma,4442,2316,2126
40,Segovia,156,Pedraza,467,261,206
40,Segovia,157,Pelayos del Arroyo,83,45,38
40,Segovia,158,Perosillo,24,17,7
40,Segovia,159,Pinarejos,132,80,52
40,Segovia,160,Pinarnegrillo,131,73,58
40,Segovia,161,Pradales,59,30,29
40,Segovia,162,Prádena,616,328,288
40,Segovia,163,Puebla de Pedraza,73,37,36
40,Segovia,164,Rapariegos,230,116,114
40,Segovia,165,Rebollo,107,60,47
40,Segovia,166,Remondo,339,168,171
40,Segovia,168,Riaguas de San Bartolomé,38,19,19
40,Segovia,170,Riaza,2516,1371,1145
40,Segovia,171,Ribota,36,26,10
40,Segovia,172,Riofrío de Riaza,38,23,15
40,Segovia,173,Roda de Eresma,225,124,101
40,Segovia,174,Sacramenia,501,264,237
40,Segovia,176,Samboal,519,276,243
40,Segovia,177,San Cristóbal de Cuéllar,177,97,80
40,Segovia,178,San Cristóbal de la Vega,131,66,65
40,Segovia,179,Sanchonuño,935,455,480
40,Segovia,180,Sangarcía,417,221,196
40,Segovia,181,Real Sitio de San Ildefonso,5698,2818,2880
40,Segovia,182,San Martín y Mudrián,269,130,139
40,Segovia,183,San Miguel de Bernuy,169,85,84
40,Segovia,184,San Pedro de Gaíllos,312,166,146
40,Segovia,185,Santa María la Real de Nieva,1174,624,550
40,Segovia,186,Santa Marta del Cerro,48,22,26
40,Segovia,188,Santiuste de Pedraza,134,76,58
40,Segovia,189,Santiuste de San Juan Bautista,631,336,295
40,Segovia,190,Santo Domingo de Pirón,58,30,28
40,Segovia,191,Santo Tomé del Puerto,336,183,153
40,Segovia,192,Sauquillo de Cabezas,213,117,96
40,Segovia,193,Sebúlcor,284,146,138
40,Segovia,194,Segovia,55220,26523,28697
40,Segovia,195,Sepúlveda,1229,633,596
40,Segovia,196,Sequera de Fresno,56,31,25
40,Segovia,198,Sotillo,28,16,12
40,Segovia,199,Sotosalbos,137,71,66
40,Segovia,200,Tabanera la Luenga,76,34,42
40,Segovia,201,Tolocirio,59,26,33
40,Segovia,202,Torreadrada,98,46,52
40,Segovia,203,Torrecaballeros,1244,629,615
40,Segovia,204,Torrecilla del Pinar,222,114,108
40,Segovia,205,Torreiglesias,368,186,182
40,Segovia,206,Torre Val de San Pedro,193,100,93
40,Segovia,207,Trescasas,925,465,460
40,Segovia,208,Turégano,1101,552,549
40,Segovia,210,Urueñas,114,68,46
40,Segovia,211,Valdeprados,89,47,42
40,Segovia,212,Valdevacas de Montejo,35,18,17
40,Segovia,213,Valdevacas y Guijar,118,60,58
40,Segovia,214,Valseca,299,163,136
40,Segovia,215,Valtiendas,138,81,57
40,Segovia,216,Valverde del Majano,1056,531,525
40,Segovia,218,Valle de Tabladillo,116,66,50
40,Segovia,219,Vallelado,786,417,369
40,Segovia,220,Valleruela de Pedraza,83,42,41
40,Segovia,221,Valleruela de Sepúlveda,62,31,31
40,Segovia,222,Veganzones,264,145,119
40,Segovia,223,Vegas de Matute,296,173,123
40,Segovia,224,Ventosilla y Tejadilla,36,22,14
40,Segovia,225,Villacastín,1649,850,799
40,Segovia,228,Villaverde de Íscar,709,371,338
40,Segovia,229,Villaverde de Montejo,42,24,18
40,Segovia,230,Villeguillo,159,97,62
40,Segovia,231,Yanguas de Eresma,149,77,72
40,Segovia,233,Zarzuela del Monte,591,303,288
40,Segovia,234,Zarzuela del Pinar,501,262,239
40,Segovia,901,Ortigosa del Monte,555,287,268
40,Segovia,902,Cozuelos de Fuentidueña,150,82,68
40,Segovia,903,Marazoleja,124,74,50
40,Segovia,904,Navas de Riofrío,412,200,212
40,Segovia,905,Cuevas de Provanco,152,81,71
40,Segovia,906,San Cristóbal de Segovia,2899,1499,1400
41,Sevilla,1,Aguadulce,2165,1080,1085
41,Sevilla,2,Alanís,1859,928,931
41,Sevilla,3,Albaida del Aljarafe,2971,1503,1468
41,Sevilla,4,Alcalá de Guadaíra,72800,36241,36559
41,Sevilla,5,Alcalá del Río,11298,5702,5596
41,Sevilla,6,Alcolea del Río,3408,1685,1723
41,Sevilla,7,"Algaba, La",15519,7737,7782
41,Sevilla,8,Algámitas,1320,687,633
41,Sevilla,9,Almadén de la Plata,1542,774,768
41,Sevilla,10,Almensilla,5786,2915,2871
41,Sevilla,11,Arahal,19382,9586,9796
41,Sevilla,12,Aznalcázar,4206,2138,2068
41,Sevilla,13,Aznalcóllar,6161,3155,3006
41,Sevilla,14,Badolatosa,3215,1664,1551
41,Sevilla,15,Benacazón,6872,3480,3392
41,Sevilla,16,Bollullos de la Mitación,9470,4752,4718
41,Sevilla,17,Bormujos,19694,9774,9920
41,Sevilla,18,Brenes,12717,6353,6364
41,Sevilla,19,Burguillos,6286,3149,3137
41,Sevilla,20,"Cabezas de San Juan, Las",16580,8431,8149
41,Sevilla,21,Camas,26292,12858,13434
41,Sevilla,22,"Campana, La",5511,2770,2741
41,Sevilla,23,Cantillana,10700,5460,5240
41,Sevilla,24,Carmona,28679,14495,14184
41,Sevilla,25,Carrión de los Céspedes,2521,1212,1309
41,Sevilla,26,Casariche,5611,2872,2739
41,Sevilla,27,Castilblanco de los Arroyos,5183,2625,2558
41,Sevilla,28,Castilleja de Guzmán,2880,1475,1405
41,Sevilla,29,Castilleja de la Cuesta,17442,8504,8938
41,Sevilla,30,Castilleja del Campo,648,315,333
41,Sevilla,31,"Castillo de las Guardas, El",1611,820,791
41,Sevilla,32,Cazalla de la Sierra,5072,2507,2565
41,Sevilla,33,Constantina,6483,3216,3267
41,Sevilla,34,Coria del Río,29284,14718,14566
41,Sevilla,35,Coripe,1411,710,701
41,Sevilla,36,"Coronil, El",5024,2523,2501
41,Sevilla,37,"Corrales, Los",4044,2065,1979
41,Sevilla,38,Dos Hermanas,127375,62997,64378
41,Sevilla,39,Écija,40718,20066,20652
41,Sevilla,40,Espartinas,13624,6869,6755
41,Sevilla,41,Estepa,12637,6287,6350
41,Sevilla,42,Fuentes de Andalucía,7274,3625,3649
41,Sevilla,43,"Garrobo, El",783,400,383
41,Sevilla,44,Gelves,9401,4674,4727
41,Sevilla,45,Gerena,6994,3529,3465
41,Sevilla,46,Gilena,3941,1968,1973
41,Sevilla,47,Gines,13189,6503,6686
41,Sevilla,48,Guadalcanal,2927,1457,1470
41,Sevilla,49,Guillena,11823,5949,5874
41,Sevilla,50,Herrera,6543,3241,3302
41,Sevilla,51,Huévar del Aljarafe,2710,1388,1322
41,Sevilla,52,"Lantejuela, La",3904,1989,1915
41,Sevilla,53,Lebrija,27029,13573,13456
41,Sevilla,54,Lora de Estepa,873,440,433
41,Sevilla,55,Lora del Río,19407,9627,9780
41,Sevilla,56,"Luisiana, La",4622,2350,2272
41,Sevilla,57,"Madroño, El",334,165,169
41,Sevilla,58,Mairena del Alcor,21560,10769,10791
41,Sevilla,59,Mairena del Aljarafe,42186,20765,21421
41,Sevilla,60,Marchena,19891,9933,9958
41,Sevilla,61,Marinaleda,2778,1400,1378
41,Sevilla,62,Martín de la Jara,2791,1437,1354
41,Sevilla,63,"Molares, Los",3400,1755,1645
41,Sevilla,64,Montellano,7179,3595,3584
41,Sevilla,65,Morón de la Frontera,28489,14125,14364
41,Sevilla,66,"Navas de la Concepción, Las",1709,842,867
41,Sevilla,67,Olivares,9560,4795,4765
41,Sevilla,68,Osuna,17973,8882,9091
41,Sevilla,69,"Palacios y Villafranca, Los",37500,18889,18611
41,Sevilla,70,Palomares del Río,7519,3779,3740
41,Sevilla,71,Paradas,7065,3536,3529
41,Sevilla,72,Pedrera,5351,2657,2694
41,Sevilla,73,"Pedroso, El",2206,1095,1111
41,Sevilla,74,Peñaflor,3798,1916,1882
41,Sevilla,75,Pilas,13690,6916,6774
41,Sevilla,76,Pruna,2853,1475,1378
41,Sevilla,77,"Puebla de Cazalla, La",11530,5750,5780
41,Sevilla,78,"Puebla de los Infantes, La",3199,1594,1605
41,Sevilla,79,"Puebla del Río, La",12236,6098,6138
41,Sevilla,80,"Real de la Jara, El",1606,780,826
41,Sevilla,81,"Rinconada, La",37239,18582,18657
41,Sevilla,82,"Roda de Andalucía, La",4400,2183,2217
41,Sevilla,83,"Ronquillo, El",1420,728,692
41,Sevilla,84,"Rubio, El",3565,1764,1801
41,Sevilla,85,Salteras,5298,2585,2713
41,Sevilla,86,San Juan de Aznalfarache,21439,10356,11083
41,Sevilla,87,Sanlúcar la Mayor,13137,6549,6588
41,Sevilla,88,San Nicolás del Puerto,626,319,307
41,Sevilla,89,Santiponce,8366,4184,4182
41,Sevilla,90,"Saucejo, El",4448,2235,2213
41,Sevilla,91,Sevilla,703021,334429,368592
41,Sevilla,92,Tocina,9592,4745,4847
41,Sevilla,93,Tomares,23661,11724,11937
41,Sevilla,94,Umbrete,8181,4127,4054
41,Sevilla,95,Utrera,51630,25826,25804
41,Sevilla,96,Valencina de la Concepción,8026,3997,4029
41,Sevilla,97,Villamanrique de la Condesa,4167,2054,2113
41,Sevilla,98,Villanueva del Ariscal,6124,2986,3138
41,Sevilla,99,Villanueva del Río y Minas,5249,2621,2628
41,Sevilla,100,Villanueva de San Juan,1340,654,686
41,Sevilla,101,Villaverde del Río,7544,3845,3699
41,Sevilla,102,"Viso del Alcor, El",18828,9502,9326
41,Sevilla,901,Cañada Rosal,3262,1639,1623
41,Sevilla,902,Isla Mayor,5915,2965,2950
41,Sevilla,903,"Cuervo de Sevilla, El",8660,4408,4252
42,Soria,1,Abejar,378,207,171
42,Soria,3,Adradas,72,39,33
42,Soria,4,Ágreda,3174,1597,1577
42,Soria,6,Alconaba,201,118,83
42,Soria,7,Alcubilla de Avellaneda,163,86,77
42,Soria,8,Alcubilla de las Peñas,84,48,36
42,Soria,9,Aldealafuente,106,58,48
42,Soria,10,Aldealices,25,14,11
42,Soria,11,Aldealpozo,30,15,15
42,Soria,12,Aldealseñor,47,25,22
42,Soria,13,Aldehuela de Periáñez,51,25,26
42,Soria,14,"Aldehuelas, Las",92,48,44
42,Soria,15,Alentisque,35,19,16
42,Soria,16,Aliud,26,14,12
42,Soria,17,Almajano,213,113,100
42,Soria,18,Almaluez,190,107,83
42,Soria,19,Almarza,663,378,285
42,Soria,20,Almazán,6005,3073,2932
42,Soria,21,Almazul,103,58,45
42,Soria,22,Almenar de Soria,282,161,121
42,Soria,23,Alpanseque,82,45,37
42,Soria,24,Arancón,99,62,37
42,Soria,25,Arcos de Jalón,1869,1007,862
42,Soria,26,Arenillas,34,21,13
42,Soria,27,Arévalo de la Sierra,84,54,30
42,Soria,28,Ausejo de la Sierra,68,38,30
42,Soria,29,Baraona,182,99,83
42,Soria,30,Barca,120,70,50
42,Soria,31,Barcones,32,18,14
42,Soria,32,Bayubas de Abajo,199,106,93
42,Soria,33,Bayubas de Arriba,53,30,23
42,Soria,34,Beratón,44,27,17
42,Soria,35,Berlanga de Duero,1023,513,510
42,Soria,36,Blacos,54,31,23
42,Soria,37,Bliecos,43,25,18
42,Soria,38,Borjabad,41,23,18
42,Soria,39,Borobia,294,157,137
42,Soria,41,Buberos,37,20,17
42,Soria,42,Buitrago,60,32,28
42,Soria,43,Burgo de Osma-Ciudad de Osma,5268,2641,2627
42,Soria,44,Cabrejas del Campo,69,38,31
42,Soria,45,Cabrejas del Pinar,423,238,185
42,Soria,46,Calatañazor,68,37,31
42,Soria,48,Caltojar,79,47,32
42,Soria,49,Candilichera,153,84,69
42,Soria,50,Cañamaque,32,21,11
42,Soria,51,Carabantes,24,11,13
42,Soria,52,Caracena,20,15,5
42,Soria,53,Carrascosa de Abajo,28,17,11
42,Soria,54,Carrascosa de la Sierra,20,12,8
42,Soria,55,Casarejos,209,109,100
42,Soria,56,Castilfrío de la Sierra,32,19,13
42,Soria,57,Castilruiz,220,113,107
42,Soria,58,Castillejo de Robledo,136,75,61
42,Soria,59,Centenera de Andaluz,26,9,17
42,Soria,60,Cerbón,40,25,15
42,Soria,61,Cidones,346,194,152
42,Soria,62,Cigudosa,41,27,14
42,Soria,63,Cihuela,70,40,30
42,Soria,64,Ciria,100,53,47
42,Soria,65,Cirujales del Río,28,16,12
42,Soria,68,Coscurita,103,60,43
42,Soria,69,Covaleda,1859,964,895
42,Soria,70,Cubilla,47,27,20
42,Soria,71,Cubo de la Solana,206,109,97
42,Soria,73,Cueva de Ágreda,87,51,36
42,Soria,75,Dévanos,97,53,44
42,Soria,76,Deza,268,137,131
42,Soria,78,Duruelo de la Sierra,1305,669,636
42,Soria,79,Escobosa de Almazán,32,20,12
42,Soria,80,Espeja de San Marcelino,200,121,79
42,Soria,81,Espejón,199,104,95
42,Soria,82,Estepa de San Juan,11,6,5
42,Soria,83,Frechilla de Almazán,27,14,13
42,Soria,84,Fresno de Caracena,27,16,11
42,Soria,85,Fuentearmegil,231,130,101
42,Soria,86,Fuentecambrón,44,26,18
42,Soria,87,Fuentecantos,61,31,30
42,Soria,88,Fuentelmonge,80,48,32
42,Soria,89,Fuentelsaz de Soria,66,36,30
42,Soria,90,Fuentepinilla,103,62,41
42,Soria,92,Fuentes de Magaña,106,53,53
42,Soria,93,Fuentestrún,53,34,19
42,Soria,94,Garray,597,329,268
42,Soria,95,Golmayo,2133,1117,1016
42,Soria,96,Gómara,385,210,175
42,Soria,97,Gormaz,21,10,11
42,Soria,98,Herrera de Soria,14,10,4
42,Soria,100,Hinojosa del Campo,31,21,10
42,Soria,103,Langa de Duero,821,446,375
42,Soria,105,Liceras,58,28,30
42,Soria,106,"Losilla, La",14,8,6
42,Soria,107,Magaña,97,56,41
42,Soria,108,Maján,14,9,5
42,Soria,110,Matalebreras,88,46,42
42,Soria,111,Matamala de Almazán,352,192,160
42,Soria,113,Medinaceli,818,404,414
42,Soria,115,Miño de Medinaceli,92,52,40
42,Soria,116,Miño de San Esteban,66,42,24
42,Soria,117,Molinos de Duero,176,92,84
42,Soria,118,Momblona,26,18,8
42,Soria,119,Monteagudo de las Vicarías,243,120,123
42,Soria,120,Montejo de Tiermes,193,121,72
42,Soria,121,Montenegro de Cameros,87,55,32
42,Soria,123,Morón de Almazán,222,109,113
42,Soria,124,Muriel de la Fuente,75,43,32
42,Soria,125,Muriel Viejo,80,45,35
42,Soria,127,Nafría de Ucero,50,29,21
42,Soria,128,Narros,45,24,21
42,Soria,129,Navaleno,896,465,431
42,Soria,130,Nepas,70,43,27
42,Soria,131,Nolay,63,31,32
42,Soria,132,Noviercas,183,96,87
42,Soria,134,Ólvega,3834,1979,1855
42,Soria,135,Oncala,100,62,38
42,Soria,139,Pinilla del Campo,20,11,9
42,Soria,140,Portillo de Soria,18,12,6
42,Soria,141,"Póveda de Soria, La",118,61,57
42,Soria,142,Pozalmuro,84,44,40
42,Soria,144,Quintana Redonda,546,293,253
42,Soria,145,Quintanas de Gormaz,155,86,69
42,Soria,148,Quiñonería,15,8,7
42,Soria,149,"Rábanos, Los",519,307,212
42,Soria,151,Rebollar,44,22,22
42,Soria,152,Recuerda,104,60,44
42,Soria,153,Rello,22,13,9
42,Soria,154,Renieblas,106,65,41
42,Soria,155,Retortillo de Soria,218,119,99
42,Soria,156,Reznos,34,22,12
42,Soria,157,"Riba de Escalote, La",18,12,6
42,Soria,158,Rioseco de Soria,141,79,62
42,Soria,159,Rollamienta,42,26,16
42,Soria,160,"Royo, El",331,173,158
42,Soria,161,Salduero,182,95,87
42,Soria,162,San Esteban de Gormaz,3241,1699,1542
42,Soria,163,San Felices,68,42,26
42,Soria,164,San Leonardo de Yagüe,2285,1172,1113
42,Soria,165,San Pedro Manrique,659,367,292
42,Soria,166,Santa Cruz de Yanguas,73,46,27
42,Soria,167,Santa María de Huerta,370,198,172
42,Soria,168,Santa María de las Hoyas,140,77,63
42,Soria,171,Serón de Nágima,176,99,77
42,Soria,172,Soliedra,36,19,17
42,Soria,173,Soria,39987,19112,20875
42,Soria,174,Sotillo del Rincón,220,111,109
42,Soria,175,Suellacabras,30,19,11
42,Soria,176,Tajahuerce,32,17,15
42,Soria,177,Tajueco,88,49,39
42,Soria,178,Talveila,145,82,63
42,Soria,181,Tardelcuende,501,254,247
42,Soria,182,Taroda,56,29,27
42,Soria,183,Tejado,152,85,67
42,Soria,184,Torlengua,86,45,41
42,Soria,185,Torreblacos,29,15,14
42,Soria,187,Torrubia de Soria,69,46,23
42,Soria,188,Trévago,66,31,35
42,Soria,189,Ucero,79,42,37
42,Soria,190,Vadillo,137,79,58
42,Soria,191,Valdeavellano de Tera,220,118,102
42,Soria,192,Valdegeña,44,28,16
42,Soria,193,Valdelagua del Cerro,18,11,7
42,Soria,194,Valdemaluque,214,104,110
42,Soria,195,Valdenebro,117,70,47
42,Soria,196,Valdeprado,18,10,8
42,Soria,197,Valderrodilla,95,52,43
42,Soria,198,Valtajeros,26,15,11
42,Soria,200,Velamazán,104,66,38
42,Soria,201,Velilla de la Sierra,29,18,11
42,Soria,202,Velilla de los Ajos,34,21,13
42,Soria,204,Viana de Duero,67,46,21
42,Soria,205,Villaciervos,103,62,41
42,Soria,206,Villanueva de Gormaz,9,6,3
42,Soria,207,Villar del Ala,58,26,32
42,Soria,208,Villar del Campo,24,16,8
42,Soria,209,Villar del Río,172,106,66
42,Soria,211,"Villares de Soria, Los",100,56,44
42,Soria,212,Villasayas,92,57,35
42,Soria,213,Villaseca de Arciel,38,21,17
42,Soria,215,Vinuesa,1003,546,457
42,Soria,216,Vizmanos,29,17,12
42,Soria,217,Vozmediano,43,27,16
42,Soria,218,Yanguas,127,73,54
42,Soria,219,Yelo,51,27,24
43,Tarragona,1,Aiguamúrcia,917,479,438
43,Tarragona,2,Albinyana,2347,1180,1167
43,Tarragona,3,"Albiol, L'",451,225,226
43,Tarragona,4,Alcanar,10601,5497,5104
43,Tarragona,5,Alcover,5140,2602,2538
43,Tarragona,6,Aldover,978,483,495
43,Tarragona,7,"Aleixar, L'",914,458,456
43,Tarragona,8,Alfara de Carles,400,212,188
43,Tarragona,9,Alforja,1866,960,906
43,Tarragona,10,Alió,380,188,192
43,Tarragona,11,Almoster,1362,681,681
43,Tarragona,12,Altafulla,4776,2364,2412
43,Tarragona,13,"Ametlla de Mar, L'",7649,3888,3761
43,Tarragona,14,Amposta,21445,10860,10585
43,Tarragona,15,Arbolí,114,63,51
43,Tarragona,16,"Arboç, L'",5548,2880,2668
43,Tarragona,17,"Argentera, L'",159,91,68
43,Tarragona,18,Arnes,496,259,237
43,Tarragona,19,Ascó,1665,866,799
43,Tarragona,20,Banyeres del Penedès,2995,1546,1449
43,Tarragona,21,Barberà de la Conca,540,294,246
43,Tarragona,22,Batea,2150,1104,1046
43,Tarragona,23,Bellmunt del Priorat,337,169,168
43,Tarragona,24,Bellvei,2082,1073,1009
43,Tarragona,25,Benifallet,803,400,403
43,Tarragona,26,Benissanet,1249,672,577
43,Tarragona,27,"Bisbal de Falset, La",225,124,101
43,Tarragona,28,"Bisbal del Penedès, La",3373,1740,1633
43,Tarragona,29,Blancafort,415,211,204
43,Tarragona,30,Bonastre,642,336,306
43,Tarragona,31,"Borges del Camp, Les",2146,1072,1074
43,Tarragona,32,Bot,693,358,335
43,Tarragona,33,Botarell,1109,596,513
43,Tarragona,34,Bràfim,670,338,332
43,Tarragona,35,Cabacés,340,174,166
43,Tarragona,36,Cabra del Camp,1152,615,537
43,Tarragona,37,Calafell,24984,12661,12323
43,Tarragona,38,Cambrils,33008,16414,16594
43,Tarragona,39,Capafonts,123,67,56
43,Tarragona,40,Capçanes,420,210,210
43,Tarragona,41,Caseres,292,143,149
43,Tarragona,42,Castellvell del Camp,2792,1404,1388
43,Tarragona,43,"Catllar, El",4148,2133,2015
43,Tarragona,44,"Sénia, La",6045,3084,2961
43,Tarragona,45,Colldejou,181,101,80
43,Tarragona,46,Conesa,129,65,64
43,Tarragona,47,Constantí,6592,3499,3093
43,Tarragona,48,Corbera d'Ebre,1180,632,548
43,Tarragona,49,Cornudella de Montsant,1026,544,482
43,Tarragona,50,Creixell,3386,1747,1639
43,Tarragona,51,Cunit,12551,6339,6212
43,Tarragona,52,Xerta,1297,639,658
43,Tarragona,53,Duesaigües,236,135,101
43,Tarragona,54,"Espluga de Francolí, L'",3923,1921,2002
43,Tarragona,55,Falset,2952,1482,1470
43,Tarragona,56,"Fatarella, La",1111,555,556
43,Tarragona,57,"Febró, La",51,33,18
43,Tarragona,58,"Figuera, La",133,74,59
43,Tarragona,59,Figuerola del Camp,349,172,177
43,Tarragona,60,Flix,3969,1996,1973
43,Tarragona,61,Forès,59,34,25
43,Tarragona,62,Freginals,464,246,218
43,Tarragona,63,"Galera, La",846,435,411
43,Tarragona,64,Gandesa,3219,1662,1557
43,Tarragona,65,Garcia,580,291,289
43,Tarragona,66,"Garidells, Els",191,99,92
43,Tarragona,67,Ginestar,986,520,466
43,Tarragona,68,Godall,822,429,393
43,Tarragona,69,Gratallops,264,140,124
43,Tarragona,70,"Guiamets, Els",322,148,174
43,Tarragona,71,Horta de Sant Joan,1295,690,605
43,Tarragona,72,"Lloar, El",119,67,52
43,Tarragona,73,Llorac,112,59,53
43,Tarragona,74,Llorenç del Penedès,2245,1112,1133
43,Tarragona,75,Margalef,115,64,51
43,Tarragona,76,Marçà,638,335,303
43,Tarragona,77,Mas de Barberans,635,317,318
43,Tarragona,78,Masdenverge,1131,588,543
43,Tarragona,79,Masllorenç,538,288,250
43,Tarragona,80,"Masó, La",293,150,143
43,Tarragona,81,Maspujols,730,381,349
43,Tarragona,82,"Masroig, El",562,296,266
43,Tarragona,83,"Milà, El",183,89,94
43,Tarragona,84,Miravet,770,408,362
43,Tarragona,85,"Molar, El",305,166,139
43,Tarragona,86,Montblanc,7354,3725,3629
43,Tarragona,88,Montbrió del Camp,2461,1245,1216
43,Tarragona,89,Montferri,405,213,192
43,Tarragona,90,"Montmell, El",1509,821,688
43,Tarragona,91,Mont-ral,175,102,73
43,Tarragona,92,Mont-roig del Camp,12476,6485,5991
43,Tarragona,93,Móra d'Ebre,5699,2814,2885
43,Tarragona,94,Móra la Nova,3289,1681,1608
43,Tarragona,95,"Morell, El",3445,1784,1661
43,Tarragona,96,"Morera de Montsant, La",164,99,65
43,Tarragona,97,"Nou de Gaià, La",535,263,272
43,Tarragona,98,Nulles,461,237,224
43,Tarragona,99,"Palma d'Ebre, La",417,199,218
43,Tarragona,100,"Pallaresos, Els",4265,2180,2085
43,Tarragona,101,Passanant i Belltall,168,91,77
43,Tarragona,102,Paüls,605,301,304
43,Tarragona,103,Perafort,1230,646,584
43,Tarragona,104,"Perelló, El",3336,1784,1552
43,Tarragona,105,"Piles, Les",219,117,102
43,Tarragona,106,"Pinell de Brai, El",1133,575,558
43,Tarragona,107,Pira,500,260,240
43,Tarragona,108,"Pla de Santa Maria, El",2385,1257,1128
43,Tarragona,109,"Pobla de Mafumet, La",2810,1460,1350
43,Tarragona,110,"Pobla de Massaluca, La",377,198,179
43,Tarragona,111,"Pobla de Montornès, La",2902,1539,1363
43,Tarragona,112,Poboleda,383,209,174
43,Tarragona,113,"Pont d'Armentera, El",583,306,277
43,Tarragona,114,Porrera,468,251,217
43,Tarragona,115,Pradell de la Teixeta,204,91,113
43,Tarragona,116,Prades,662,348,314
43,Tarragona,117,Prat de Comte,190,105,85
43,Tarragona,118,Pratdip,848,457,391
43,Tarragona,119,Puigpelat,1022,533,489
43,Tarragona,120,Querol,544,295,249
43,Tarragona,121,Rasquera,962,482,480
43,Tarragona,122,Renau,138,71,67
43,Tarragona,123,Reus,106709,52399,54310
43,Tarragona,124,"Riba, La",681,363,318
43,Tarragona,125,Riba-roja d'Ebre,1321,706,615
43,Tarragona,126,"Riera de Gaià, La",1677,858,819
43,Tarragona,127,Riudecanyes,1154,592,562
43,Tarragona,128,Riudecols,1294,666,628
43,Tarragona,129,Riudoms,6466,3320,3146
43,Tarragona,130,Rocafort de Queralt,244,129,115
43,Tarragona,131,Roda de Barà,6284,3277,3007
43,Tarragona,132,Rodonyà,500,266,234
43,Tarragona,133,Roquetes,8280,4344,3936
43,Tarragona,134,"Rourell, El",386,201,185
43,Tarragona,135,Salomó,525,285,240
43,Tarragona,136,Sant Carles de la Ràpita,15338,7595,7743
43,Tarragona,137,Sant Jaume dels Domenys,2505,1285,1220
43,Tarragona,138,Santa Bàrbara,3989,2042,1947
43,Tarragona,139,Santa Coloma de Queralt,3092,1558,1534
43,Tarragona,140,Santa Oliva,3343,1730,1613
43,Tarragona,141,Pontils,134,76,58
43,Tarragona,142,Sarral,1703,874,829
43,Tarragona,143,Savallà del Comtat,69,34,35
43,Tarragona,144,"Secuita, La",1582,810,772
43,Tarragona,145,"Selva del Camp, La",5576,2822,2754
43,Tarragona,146,Senan,55,34,21
43,Tarragona,147,Solivella,687,349,338
43,Tarragona,148,Tarragona,134085,65961,68124
43,Tarragona,149,Tivenys,910,464,446
43,Tarragona,150,Tivissa,1824,927,897
43,Tarragona,151,"Torre de Fontaubella, La",140,73,67
43,Tarragona,152,"Torre de l'Espanyol, La",698,354,344
43,Tarragona,153,Torredembarra,15461,7692,7769
43,Tarragona,154,Torroja del Priorat,171,93,78
43,Tarragona,155,Tortosa,34432,17305,17127
43,Tarragona,156,Ulldecona,7404,3823,3581
43,Tarragona,157,Ulldemolins,449,258,191
43,Tarragona,158,Vallclara,125,70,55
43,Tarragona,159,Vallfogona de Riucorb,115,67,48
43,Tarragona,160,Vallmoll,1651,862,789
43,Tarragona,161,Valls,25016,12618,12398
43,Tarragona,162,Vandellòs i l'Hospitalet de l'Infant,5941,2956,2985
43,Tarragona,163,"Vendrell, El",36453,18296,18157
43,Tarragona,164,Vespella de Gaià,415,235,180
43,Tarragona,165,Vilabella,826,426,400
43,Tarragona,166,Vilallonga del Camp,2181,1115,1066
43,Tarragona,167,Vilanova d'Escornalbou,568,318,250
43,Tarragona,168,Vilanova de Prades,133,69,64
43,Tarragona,169,Vilaplana,639,323,316
43,Tarragona,170,Vila-rodona,1279,662,617
43,Tarragona,171,Vila-seca,21839,11178,10661
43,Tarragona,172,Vilaverd,504,249,255
43,Tarragona,173,"Vilella Alta, La",140,76,64
43,Tarragona,174,"Vilella Baixa, La",210,116,94
43,Tarragona,175,Vilalba dels Arcs,711,371,340
43,Tarragona,176,Vimbodí i Poblet,1010,571,439
43,Tarragona,177,Vinebre,460,227,233
43,Tarragona,178,Vinyols i els Arcs,1911,984,927
43,Tarragona,901,Deltebre,12302,6264,6038
43,Tarragona,902,Sant Jaume d'Enveja,3541,1800,1741
43,Tarragona,903,Camarles,3600,1846,1754
43,Tarragona,904,"Aldea, L'",4513,2411,2102
43,Tarragona,905,Salou,26193,14073,12120
43,Tarragona,906,"Ampolla, L'",3529,1801,1728
43,Tarragona,907,"Canonja, La",5673,2837,2836
44,Teruel,1,Ababuj,78,48,30
44,Teruel,2,Abejuela,66,39,27
44,Teruel,3,Aguatón,20,9,11
44,Teruel,4,Aguaviva,693,349,344
44,Teruel,5,Aguilar del Alfambra,70,42,28
44,Teruel,6,Alacón,349,180,169
44,Teruel,7,Alba,230,114,116
44,Teruel,8,Albalate del Arzobispo,2115,1083,1032
44,Teruel,9,Albarracín,1096,558,538
44,Teruel,10,Albentosa,301,156,145
44,Teruel,11,Alcaine,67,38,29
44,Teruel,12,Alcalá de la Selva,516,274,242
44,Teruel,13,Alcañiz,16420,8258,8162
44,Teruel,14,Alcorisa,3622,1865,1757
44,Teruel,16,Alfambra,677,368,309
44,Teruel,17,Aliaga,382,214,168
44,Teruel,18,Almohaja,29,23,6
44,Teruel,19,Alobras,75,42,33
44,Teruel,20,Alpeñés,26,17,9
44,Teruel,21,Allepuz,129,62,67
44,Teruel,22,Alloza,701,359,342
44,Teruel,23,Allueva,23,14,9
44,Teruel,24,Anadón,24,15,9
44,Teruel,25,Andorra,8324,4285,4039
44,Teruel,26,Arcos de las Salinas,100,52,48
44,Teruel,27,Arens de Lledó,196,88,108
44,Teruel,28,Argente,223,105,118
44,Teruel,29,Ariño,914,472,442
44,Teruel,31,Azaila,148,82,66
44,Teruel,32,Bádenas,21,12,9
44,Teruel,33,Báguena,386,210,176
44,Teruel,34,Bañón,165,90,75
44,Teruel,35,Barrachina,145,78,67
44,Teruel,36,Bea,32,21,11
44,Teruel,37,Beceite,608,313,295
44,Teruel,38,Belmonte de San José,129,62,67
44,Teruel,39,Bello,274,128,146
44,Teruel,40,Berge,264,132,132
44,Teruel,41,Bezas,82,44,38
44,Teruel,42,Blancas,154,89,65
44,Teruel,43,Blesa,132,81,51
44,Teruel,44,Bordón,146,81,65
44,Teruel,45,Bronchales,469,272,197
44,Teruel,46,Bueña,65,33,32
44,Teruel,47,Burbáguena,300,144,156
44,Teruel,48,Cabra de Mora,87,52,35
44,Teruel,49,Calaceite,1143,596,547
44,Teruel,50,Calamocha,4628,2330,2298
44,Teruel,51,Calanda,4004,1979,2025
44,Teruel,52,Calomarde,103,57,46
44,Teruel,53,Camañas,125,68,57
44,Teruel,54,Camarena de la Sierra,159,90,69
44,Teruel,55,Camarillas,130,81,49
44,Teruel,56,Caminreal,718,376,342
44,Teruel,59,Cantavieja,757,405,352
44,Teruel,60,Cañada de Benatanduz,41,27,14
44,Teruel,61,"Cañada de Verich, La",112,62,50
44,Teruel,62,Cañada Vellida,40,28,12
44,Teruel,63,Cañizar del Olivar,106,61,45
44,Teruel,64,Cascante del Río,102,63,39
44,Teruel,65,Castejón de Tornos,68,39,29
44,Teruel,66,Castel de Cabra,140,73,67
44,Teruel,67,Castelnou,120,60,60
44,Teruel,68,Castelserás,832,436,396
44,Teruel,70,"Castellar, El",69,44,25
44,Teruel,71,Castellote,805,417,388
44,Teruel,74,Cedrillas,620,325,295
44,Teruel,75,Celadas,434,236,198
44,Teruel,76,Cella,2905,1523,1382
44,Teruel,77,"Cerollera, La",103,62,41
44,Teruel,80,"Codoñera, La",387,206,181
44,Teruel,82,Corbalán,102,54,48
44,Teruel,84,Cortes de Aragón,76,37,39
44,Teruel,85,Cosa,60,35,25
44,Teruel,86,Cretas,607,313,294
44,Teruel,87,Crivillén,92,48,44
44,Teruel,88,"Cuba, La",52,28,24
44,Teruel,89,Cubla,68,42,26
44,Teruel,90,Cucalón,101,60,41
44,Teruel,92,"Cuervo, El",101,56,45
44,Teruel,93,Cuevas de Almudén,141,82,59
44,Teruel,94,Cuevas Labradas,135,69,66
44,Teruel,96,Ejulve,203,100,103
44,Teruel,97,Escorihuela,183,92,91
44,Teruel,99,Escucha,1019,574,445
44,Teruel,100,Estercuel,272,150,122
44,Teruel,101,Ferreruela de Huerva,68,37,31
44,Teruel,102,Fonfría,30,17,13
44,Teruel,103,Formiche Alto,181,101,80
44,Teruel,105,Fórnoles,102,52,50
44,Teruel,106,Fortanete,223,131,92
44,Teruel,107,Foz-Calanda,293,162,131
44,Teruel,108,"Fresneda, La",499,275,224
44,Teruel,109,Frías de Albarracín,152,86,66
44,Teruel,110,Fuenferrada,62,35,27
44,Teruel,111,Fuentes Calientes,119,66,53
44,Teruel,112,Fuentes Claras,582,308,274
44,Teruel,113,Fuentes de Rubielos,134,71,63
44,Teruel,114,Fuentespalda,326,163,163
44,Teruel,115,Galve,151,82,69
44,Teruel,116,Gargallo,125,68,57
44,Teruel,117,Gea de Albarracín,415,214,201
44,Teruel,118,"Ginebrosa, La",230,130,100
44,Teruel,119,Griegos,141,85,56
44,Teruel,120,Guadalaviar,247,138,109
44,Teruel,121,Gúdar,82,47,35
44,Teruel,122,Híjar,1872,948,924
44,Teruel,123,Hinojosa de Jarque,150,81,69
44,Teruel,124,"Hoz de la Vieja, La",89,48,41
44,Teruel,125,Huesa del Común,92,57,35
44,Teruel,126,"Iglesuela del Cid, La",501,268,233
44,Teruel,127,Jabaloyas,90,55,35
44,Teruel,128,Jarque de la Val,89,47,42
44,Teruel,129,Jatiel,52,28,24
44,Teruel,130,Jorcas,44,25,19
44,Teruel,131,Josa,38,21,17
44,Teruel,132,Lagueruela,68,35,33
44,Teruel,133,Lanzuela,27,18,9
44,Teruel,135,Libros,156,87,69
44,Teruel,136,Lidón,56,27,29
44,Teruel,137,Linares de Mora,300,172,128
44,Teruel,138,Loscos,179,105,74
44,Teruel,141,Lledó,168,94,74
44,Teruel,142,Maicas,39,20,19
44,Teruel,143,Manzanera,562,301,261
44,Teruel,144,Martín del Río,432,221,211
44,Teruel,145,Mas de las Matas,1387,721,666
44,Teruel,146,"Mata de los Olmos, La",283,143,140
44,Teruel,147,Mazaleón,564,301,263
44,Teruel,148,Mezquita de Jarque,117,68,49
44,Teruel,149,Mirambel,133,70,63
44,Teruel,150,Miravete de la Sierra,33,19,14
44,Teruel,151,Molinos,283,159,124
44,Teruel,152,Monforte de Moyuela,64,43,21
44,Teruel,153,Monreal del Campo,2768,1384,1384
44,Teruel,154,Monroyo,394,245,149
44,Teruel,155,Montalbán,1392,713,679
44,Teruel,156,Monteagudo del Castillo,66,39,27
44,Teruel,157,Monterde de Albarracín,64,37,27
44,Teruel,158,Mora de Rubielos,1666,850,816
44,Teruel,159,Moscardón,67,34,33
44,Teruel,160,Mosqueruela,625,334,291
44,Teruel,161,Muniesa,665,340,325
44,Teruel,163,Noguera de Albarracín,148,76,72
44,Teruel,164,Nogueras,36,26,10
44,Teruel,165,Nogueruelas,215,113,102
44,Teruel,167,Obón,38,22,16
44,Teruel,168,Odón,221,108,113
44,Teruel,169,Ojos Negros,473,258,215
44,Teruel,171,Olba,238,133,105
44,Teruel,172,Oliete,470,249,221
44,Teruel,173,"Olmos, Los",131,71,60
44,Teruel,174,Orihuela del Tremedal,580,307,273
44,Teruel,175,Orrios,153,78,75
44,Teruel,176,Palomar de Arroyos,191,110,81
44,Teruel,177,Pancrudo,139,80,59
44,Teruel,178,"Parras de Castellote, Las",77,41,36
44,Teruel,179,Peñarroya de Tastavins,509,275,234
44,Teruel,180,Peracense,88,49,39
44,Teruel,181,Peralejos,84,42,42
44,Teruel,182,Perales del Alfambra,268,146,122
44,Teruel,183,Pitarque,94,43,51
44,Teruel,184,Plou,45,28,17
44,Teruel,185,"Pobo, El",143,93,50
44,Teruel,187,"Portellada, La",259,129,130
44,Teruel,189,Pozondón,80,39,41
44,Teruel,190,Pozuel del Campo,98,52,46
44,Teruel,191,"Puebla de Híjar, La",1013,510,503
44,Teruel,192,"Puebla de Valverde, La",552,319,233
44,Teruel,193,Puertomingalvo,157,86,71
44,Teruel,194,Ráfales,165,84,81
44,Teruel,195,Rillo,112,63,49
44,Teruel,196,Riodeva,176,85,91
44,Teruel,197,Ródenas,71,42,29
44,Teruel,198,Royuela,251,136,115
44,Teruel,199,Rubiales,58,34,24
44,Teruel,200,Rubielos de la Cérida,43,22,21
44,Teruel,201,Rubielos de Mora,751,382,369
44,Teruel,203,Salcedillo,8,7,1
44,Teruel,204,Saldón,29,20,9
44,Teruel,205,Samper de Calanda,909,454,455
44,Teruel,206,San Agustín,201,127,74
44,Teruel,207,San Martín del Río,193,100,93
44,Teruel,208,Santa Cruz de Nogueras,40,23,17
44,Teruel,209,Santa Eulalia,1147,572,575
44,Teruel,210,Sarrión,1135,628,507
44,Teruel,211,Segura de los Baños,39,25,14
44,Teruel,212,Seno,46,24,22
44,Teruel,213,Singra,92,51,41
44,Teruel,215,Terriente,197,115,82
44,Teruel,216,Teruel,35288,17063,18225
44,Teruel,217,Toril y Masegoso,37,25,12
44,Teruel,218,Tormón,36,19,17
44,Teruel,219,Tornos,230,125,105
44,Teruel,220,Torralba de los Sisones,209,114,95
44,Teruel,221,Torrecilla de Alcañiz,437,231,206
44,Teruel,222,Torrecilla del Rebollar,146,81,65
44,Teruel,223,Torre de Arcas,95,47,48
44,Teruel,224,Torre de las Arcas,35,18,17
44,Teruel,225,Torre del Compte,156,83,73
44,Teruel,226,Torrelacárcel,213,114,99
44,Teruel,227,Torre los Negros,103,54,49
44,Teruel,228,Torremocha de Jiloca,135,73,62
44,Teruel,229,Torres de Albarracín,167,92,75
44,Teruel,230,Torrevelilla,216,111,105
44,Teruel,231,Torrijas,63,28,35
44,Teruel,232,Torrijo del Campo,518,268,250
44,Teruel,234,Tramacastiel,89,52,37
44,Teruel,235,Tramacastilla,118,58,60
44,Teruel,236,Tronchón,107,60,47
44,Teruel,237,Urrea de Gaén,527,262,265
44,Teruel,238,Utrillas,3270,1688,1582
44,Teruel,239,Valacloche,31,18,13
44,Teruel,240,Valbona,202,112,90
44,Teruel,241,Valdealgorfa,675,326,349
44,Teruel,243,Valdecuenca,53,38,15
44,Teruel,244,Valdelinares,113,67,46
44,Teruel,245,Valdeltormo,324,168,156
44,Teruel,246,Valderrobres,2303,1203,1100
44,Teruel,247,Valjunquera,387,200,187
44,Teruel,249,"Vallecillo, El",61,35,26
44,Teruel,250,Veguillas de la Sierra,25,15,10
44,Teruel,251,Villafranca del Campo,339,179,160
44,Teruel,252,Villahermosa del Campo,102,61,41
44,Teruel,256,Villanueva del Rebollar de la Sierra,52,28,24
44,Teruel,257,Villar del Cobo,205,112,93
44,Teruel,258,Villar del Salz,80,47,33
44,Teruel,260,Villarluengo,194,110,84
44,Teruel,261,Villarquemado,906,474,432
44,Teruel,262,Villarroya de los Pinares,172,92,80
44,Teruel,263,Villastar,448,233,215
44,Teruel,264,Villel,342,197,145
44,Teruel,265,Vinaceite,301,164,137
44,Teruel,266,Visiedo,148,66,82
44,Teruel,267,Vivel del Río Martín,91,48,43
44,Teruel,268,"Zoma, La",22,9,13
45,Toledo,1,Ajofrín,2309,1171,1138
45,Toledo,2,Alameda de la Sagra,3487,1835,1652
45,Toledo,3,Albarreal de Tajo,742,386,356
45,Toledo,4,Alcabón,762,400,362
45,Toledo,5,Alcañizo,327,172,155
45,Toledo,6,Alcaudete de la Jara,2089,1054,1035
45,Toledo,7,Alcolea de Tajo,904,458,446
45,Toledo,8,Aldea en Cabo,228,125,103
45,Toledo,9,Aldeanueva de Barbarroya,654,324,330
45,Toledo,10,Aldeanueva de San Bartolomé,509,248,261
45,Toledo,11,Almendral de la Cañada,373,204,169
45,Toledo,12,Almonacid de Toledo,873,455,418
45,Toledo,13,Almorox,2469,1315,1154
45,Toledo,14,Añover de Tajo,5412,2809,2603
45,Toledo,15,Arcicóllar,811,401,410
45,Toledo,16,Argés,5643,2836,2807
45,Toledo,17,Azután,298,148,150
45,Toledo,18,Barcience,671,354,317
45,Toledo,19,Bargas,9666,4868,4798
45,Toledo,20,Belvís de la Jara,1814,918,896
45,Toledo,21,Borox,3435,1789,1646
45,Toledo,22,Buenaventura,482,251,231
45,Toledo,23,Burguillos de Toledo,2734,1398,1336
45,Toledo,24,Burujón,1463,774,689
45,Toledo,25,Cabañas de la Sagra,1968,1046,922
45,Toledo,26,Cabañas de Yepes,331,173,158
45,Toledo,27,Cabezamesada,546,298,248
45,Toledo,28,Calera y Chozas,4690,2400,2290
45,Toledo,29,Caleruela,283,150,133
45,Toledo,30,Calzada de Oropesa,570,303,267
45,Toledo,31,Camarena,3793,1997,1796
45,Toledo,32,Camarenilla,632,336,296
45,Toledo,33,"Campillo de la Jara, El",465,247,218
45,Toledo,34,Camuñas,1915,971,944
45,Toledo,35,Cardiel de los Montes,385,205,180
45,Toledo,36,Carmena,845,451,394
45,Toledo,37,"Carpio de Tajo, El",2169,1089,1080
45,Toledo,38,Carranque,4285,2202,2083
45,Toledo,39,Carriches,315,161,154
45,Toledo,40,"Casar de Escalona, El",2288,1232,1056
45,Toledo,41,Casarrubios del Monte,5380,2849,2531
45,Toledo,42,Casasbuenas,206,101,105
45,Toledo,43,Castillo de Bayuela,1051,531,520
45,Toledo,45,Cazalegas,1842,956,886
45,Toledo,46,Cebolla,3823,1967,1856
45,Toledo,47,Cedillo del Condado,3204,1690,1514
45,Toledo,48,"Cerralbos, Los",506,270,236
45,Toledo,49,Cervera de los Montes,448,228,220
45,Toledo,50,Ciruelos,649,341,308
45,Toledo,51,Cobeja,2399,1257,1142
45,Toledo,52,Cobisa,4045,2052,1993
45,Toledo,53,Consuegra,11022,5628,5394
45,Toledo,54,Corral de Almaguer,6258,3200,3058
45,Toledo,55,Cuerva,1605,847,758
45,Toledo,56,Chozas de Canales,3988,2126,1862
45,Toledo,57,Chueca,264,148,116
45,Toledo,58,Domingo Pérez,503,256,247
45,Toledo,59,Dosbarrios,2381,1198,1183
45,Toledo,60,Erustes,259,131,128
45,Toledo,61,Escalona,3540,1839,1701
45,Toledo,62,Escalonilla,1544,765,779
45,Toledo,63,Espinoso del Rey,589,318,271
45,Toledo,64,Esquivias,5474,2770,2704
45,Toledo,65,"Estrella, La",327,163,164
45,Toledo,66,Fuensalida,11189,5731,5458
45,Toledo,67,Gálvez,3440,1758,1682
45,Toledo,68,Garciotum,171,85,86
45,Toledo,69,Gerindote,2499,1287,1212
45,Toledo,70,Guadamur,1855,948,907
45,Toledo,71,"Guardia, La",2422,1220,1202
45,Toledo,72,"Herencias, Las",816,417,399
45,Toledo,73,Herreruela de Oropesa,467,228,239
45,Toledo,74,Hinojosa de San Vicente,461,253,208
45,Toledo,75,Hontanar,209,113,96
45,Toledo,76,Hormigos,830,461,369
45,Toledo,77,Huecas,720,367,353
45,Toledo,78,Huerta de Valdecarábanos,1952,964,988
45,Toledo,79,"Iglesuela, La",412,219,193
45,Toledo,80,Illán de Vacas,5,3,2
45,Toledo,81,Illescas,23627,12030,11597
45,Toledo,82,Lagartera,1564,787,777
45,Toledo,83,Layos,558,280,278
45,Toledo,84,Lillo,3171,1642,1529
45,Toledo,85,Lominchar,2321,1217,1104
45,Toledo,86,Lucillos,673,341,332
45,Toledo,87,Madridejos,11304,5693,5611
45,Toledo,88,Magán,3091,1628,1463
45,Toledo,89,Malpica de Tajo,2106,1073,1033
45,Toledo,90,Manzaneque,463,230,233
45,Toledo,91,Maqueda,563,288,275
45,Toledo,92,Marjaliza,311,162,149
45,Toledo,93,Marrupe,187,97,90
45,Toledo,94,Mascaraque,522,262,260
45,Toledo,95,"Mata, La",1022,531,491
45,Toledo,96,Mazarambroz,1343,692,651
45,Toledo,97,Mejorada,1337,687,650
45,Toledo,98,Menasalbas,3185,1697,1488
45,Toledo,99,Méntrida,4967,2555,2412
45,Toledo,100,Mesegar de Tajo,240,125,115
45,Toledo,101,Miguel Esteban,5460,2757,2703
45,Toledo,102,Mocejón,4908,2535,2373
45,Toledo,103,Mohedas de la Jara,496,271,225
45,Toledo,104,Montearagón,569,290,279
45,Toledo,105,Montesclaros,448,235,213
45,Toledo,106,Mora,10547,5358,5189
45,Toledo,107,Nambroca,4121,2126,1995
45,Toledo,108,"Nava de Ricomalillo, La",671,347,324
45,Toledo,109,Navahermosa,4211,2203,2008
45,Toledo,110,Navalcán,2405,1271,1134
45,Toledo,111,Navalmoralejo,67,34,33
45,Toledo,112,"Navalmorales, Los",2730,1434,1296
45,Toledo,113,"Navalucillos, Los",2599,1347,1252
45,Toledo,114,Navamorcuende,680,352,328
45,Toledo,115,Noblejas,3617,1863,1754
45,Toledo,116,Noez,1001,533,468
45,Toledo,117,Nombela,1026,527,499
45,Toledo,118,Novés,2860,1503,1357
45,Toledo,119,Numancia de la Sagra,4828,2522,2306
45,Toledo,120,Nuño Gómez,181,95,86
45,Toledo,121,Ocaña,10721,5447,5274
45,Toledo,122,Olías del Rey,7002,3630,3372
45,Toledo,123,Ontígola,3979,2164,1815
45,Toledo,124,Orgaz,2807,1407,1400
45,Toledo,125,Oropesa,2917,1435,1482
45,Toledo,126,Otero,381,186,195
45,Toledo,127,Palomeque,944,517,427
45,Toledo,128,Pantoja,3392,1705,1687
45,Toledo,129,Paredes de Escalona,162,76,86
45,Toledo,130,Parrillas,418,210,208
45,Toledo,131,Pelahustán,395,212,183
45,Toledo,132,Pepino,2563,1330,1233
45,Toledo,133,Polán,4032,2042,1990
45,Toledo,134,Portillo de Toledo,2250,1154,1096
45,Toledo,135,"Puebla de Almoradiel, La",5976,3051,2925
45,Toledo,136,"Puebla de Montalbán, La",8426,4284,4142
45,Toledo,137,"Pueblanueva, La",2383,1215,1168
45,Toledo,138,"Puente del Arzobispo, El",1466,722,744
45,Toledo,139,Puerto de San Vicente,256,126,130
45,Toledo,140,Pulgar,1700,888,812
45,Toledo,141,Quero,1344,682,662
45,Toledo,142,Quintanar de la Orden,13026,6724,6302
45,Toledo,143,Quismondo,1726,882,844
45,Toledo,144,"Real de San Vicente, El",1119,608,511
45,Toledo,145,Recas,4074,2319,1755
45,Toledo,146,Retamoso de la Jara,117,58,59
45,Toledo,147,Rielves,787,390,397
45,Toledo,148,Robledo del Mazo,379,215,164
45,Toledo,149,"Romeral, El",767,382,385
45,Toledo,150,San Bartolomé de las Abiertas,590,319,271
45,Toledo,151,San Martín de Montalbán,841,414,427
45,Toledo,152,San Martín de Pusa,847,450,397
45,Toledo,153,San Pablo de los Montes,2175,1101,1074
45,Toledo,154,San Román de los Montes,1824,980,844
45,Toledo,155,Santa Ana de Pusa,532,297,235
45,Toledo,156,Santa Cruz de la Zarza,4906,2520,2386
45,Toledo,157,Santa Cruz del Retamar,3065,1598,1467
45,Toledo,158,Santa Olalla,3511,1799,1712
45,Toledo,159,Sartajada,108,61,47
45,Toledo,160,Segurilla,1314,661,653
45,Toledo,161,Seseña,18504,9598,8906
45,Toledo,162,Sevilleja de la Jara,853,455,398
45,Toledo,163,Sonseca,11530,5872,5658
45,Toledo,164,Sotillo de las Palomas,217,111,106
45,Toledo,165,Talavera de la Reina,88674,43243,45431
45,Toledo,166,Tembleque,2371,1229,1142
45,Toledo,167,"Toboso, El",2187,1107,1080
45,Toledo,168,Toledo,83108,39896,43212
45,Toledo,169,Torralba de Oropesa,275,141,134
45,Toledo,170,Torrecilla de la Jara,288,144,144
45,Toledo,171,"Torre de Esteban Hambrán, La",1809,959,850
45,Toledo,172,Torrico,892,465,427
45,Toledo,173,Torrijos,13454,6704,6750
45,Toledo,174,Totanés,425,217,208
45,Toledo,175,Turleque,902,446,456
45,Toledo,176,Ugena,5193,2733,2460
45,Toledo,177,Urda,3074,1536,1538
45,Toledo,179,Valdeverdeja,723,338,385
45,Toledo,180,Valmojado,4175,2153,2022
45,Toledo,181,Velada,2869,1512,1357
45,Toledo,182,"Ventas con Peña Aguilera, Las",1344,695,649
45,Toledo,183,"Ventas de Retamosa, Las",3246,1687,1559
45,Toledo,184,"Ventas de San Julián, Las",228,109,119
45,Toledo,185,Villacañas,10641,5326,5315
45,Toledo,186,"Villa de Don Fadrique, La",4121,2054,2067
45,Toledo,187,Villafranca de los Caballeros,5404,2698,2706
45,Toledo,188,Villaluenga de la Sagra,4030,2032,1998
45,Toledo,189,Villamiel de Toledo,931,491,440
45,Toledo,190,Villaminaya,607,306,301
45,Toledo,191,Villamuelas,727,371,356
45,Toledo,192,Villanueva de Alcardete,3799,1973,1826
45,Toledo,193,Villanueva de Bogas,807,424,383
45,Toledo,194,Villarejo de Montalbán,64,33,31
45,Toledo,195,Villarrubia de Santiago,2827,1432,1395
45,Toledo,196,Villaseca de la Sagra,1866,967,899
45,Toledo,197,Villasequilla,2664,1377,1287
45,Toledo,198,Villatobas,2745,1414,1331
45,Toledo,199,"Viso de San Juan, El",3755,2028,1727
45,Toledo,200,"Yébenes, Los",6405,3278,3127
45,Toledo,201,Yeles,5170,2771,2399
45,Toledo,202,Yepes,5212,2674,2538
45,Toledo,203,Yuncler,3573,1823,1750
45,Toledo,204,Yunclillos,845,443,402
45,Toledo,205,Yuncos,10043,5203,4840
45,Toledo,901,Santo Domingo-Caudilla,1073,548,525
46,Valencia/València,1,Ademuz,1292,686,606
46,Valencia/València,2,Ador,1542,792,750
46,Valencia/València,3,Atzeneta d'Albaida,1236,645,591
46,Valencia/València,4,Agullent,2479,1222,1257
46,Valencia/València,5,Alaquàs,30235,14952,15283
46,Valencia/València,6,Albaida,6178,3072,3106
46,Valencia/València,7,Albal,15594,7864,7730
46,Valencia/València,8,Albalat de la Ribera,3609,1826,1783
46,Valencia/València,9,Albalat dels Sorells,3859,1886,1973
46,Valencia/València,10,Albalat dels Tarongers,1147,601,546
46,Valencia/València,11,Alberic,11331,5723,5608
46,Valencia/València,12,Alborache,1263,655,608
46,Valencia/València,13,Alboraya,22563,11262,11301
46,Valencia/València,14,Albuixech,3998,1983,2015
46,Valencia/València,15,Alcàsser,9439,4806,4633
46,Valencia/València,16,Alcàntera de Xúquer,1400,686,714
46,Valencia/València,17,Alzira,44752,21836,22916
46,Valencia/València,18,Alcublas,807,411,396
46,Valencia/València,19,"Alcúdia, l'",11432,5596,5836
46,Valencia/València,20,"Alcúdia de Crespins, l'",5289,2664,2625
46,Valencia/València,21,Aldaia,30645,15357,15288
46,Valencia/València,22,Alfafar,20728,10267,10461
46,Valencia/València,23,Alfauir,439,229,210
46,Valencia/València,24,Alfara de la Baronia,562,287,275
46,Valencia/València,25,Alfara del Patriarca,3201,1599,1602
46,Valencia/València,26,Alfarp,1604,833,771
46,Valencia/València,27,Alfarrasí,1299,633,666
46,Valencia/València,28,Algar de Palancia,576,283,293
46,Valencia/València,29,Algemesí,28293,14001,14292
46,Valencia/València,30,Algimia de Alfara,1049,523,526
46,Valencia/València,31,Alginet,13363,6777,6586
46,Valencia/València,32,Almàssera,7250,3512,3738
46,Valencia/València,33,Almiserà,303,154,149
46,Valencia/València,34,Almoines,2435,1247,1188
46,Valencia/València,35,Almussafes,8408,4202,4206
46,Valencia/València,36,Alpuente,784,421,363
46,Valencia/València,37,"Alqueria de la Comtessa, l'",1527,756,771
46,Valencia/València,38,Andilla,441,247,194
46,Valencia/València,39,Anna,2749,1377,1372
46,Valencia/València,40,Antella,1490,733,757
46,Valencia/València,41,Aras de los Olmos,442,249,193
46,Valencia/València,42,Aielo de Malferit,4809,2403,2406
46,Valencia/València,43,Aielo de Rugat,194,103,91
46,Valencia/València,44,Ayora,5415,2753,2662
46,Valencia/València,45,Barxeta,1649,851,798
46,Valencia/València,46,Barx,1360,696,664
46,Valencia/València,47,Bèlgida,723,355,368
46,Valencia/València,48,Bellreguard,4756,2364,2392
46,Valencia/València,49,Bellús,357,171,186
46,Valencia/València,50,Benagéber,167,91,76
46,Valencia/València,51,Benaguasil,11295,5831,5464
46,Valencia/València,52,Benavites,653,312,341
46,Valencia/València,53,Beneixida,721,343,378
46,Valencia/València,54,Benetússer,15290,7676,7614
46,Valencia/València,55,Beniarjó,1785,866,919
46,Valencia/València,56,Beniatjar,271,141,130
46,Valencia/València,57,Benicolet,639,338,301
46,Valencia/València,58,Benifairó de les Valls,2200,1095,1105
46,Valencia/València,59,Benifairó de la Valldigna,1658,822,836
46,Valencia/València,60,Benifaió,12117,5975,6142
46,Valencia/València,61,Beniflá,445,233,212
46,Valencia/València,62,Benigánim,6512,3355,3157
46,Valencia/València,63,Benimodo,2291,1178,1113
46,Valencia/València,64,Benimuslem,683,348,335
46,Valencia/València,65,Beniparrell,1996,1028,968
46,Valencia/València,66,Benirredrà,1655,819,836
46,Valencia/València,67,Benisanó,2274,1139,1135
46,Valencia/València,68,Benissoda,392,219,173
46,Valencia/València,69,Benisuera,205,107,98
46,Valencia/València,70,Bétera,21512,10730,10782
46,Valencia/València,71,Bicorp,575,291,284
46,Valencia/València,72,Bocairent,4454,2247,2207
46,Valencia/València,73,Bolbaite,1491,769,722
46,Valencia/València,74,Bonrepòs i Mirambell,3425,1683,1742
46,Valencia/València,75,Bufali,199,106,93
46,Valencia/València,76,Bugarra,835,426,409
46,Valencia/València,77,Buñol,9955,5014,4941
46,Valencia/València,78,Burjassot,38205,18602,19603
46,Valencia/València,79,Calles,491,270,221
46,Valencia/València,80,Camporrobles,1498,771,727
46,Valencia/València,81,Canals,14084,7150,6934
46,Valencia/València,82,Canet d'En Berenguer,5853,3013,2840
46,Valencia/València,83,Carcaixent,20687,10235,10452
46,Valencia/València,84,Càrcer,2081,1010,1071
46,Valencia/València,85,Carlet,15485,7801,7684
46,Valencia/València,86,Carrícola,93,46,47
46,Valencia/València,87,Casas Altas,168,93,75
46,Valencia/València,88,Casas Bajas,243,130,113
46,Valencia/València,89,Casinos,2842,1455,1387
46,Valencia/València,90,Castelló de Rugat,2388,1218,1170
46,Valencia/València,91,Castellonet de la Conquesta,176,95,81
46,Valencia/València,92,Castielfabib,342,168,174
46,Valencia/València,93,Catadau,2760,1388,1372
46,Valencia/València,94,Catarroja,27330,13577,13753
46,Valencia/València,95,Caudete de las Fuentes,774,419,355
46,Valencia/València,96,Cerdà,394,207,187
46,Valencia/València,97,Cofrentes,1005,503,502
46,Valencia/València,98,Corbera,3356,1664,1692
46,Valencia/València,99,Cortes de Pallás,1054,547,507
46,Valencia/València,100,Cotes,405,214,191
46,Valencia/València,101,Quart de les Valls,1065,515,550
46,Valencia/València,102,Quart de Poblet,25449,12511,12938
46,Valencia/València,103,Quartell,1473,724,749
46,Valencia/València,104,Quatretonda,2472,1265,1207
46,Valencia/València,105,Cullera,23304,11803,11501
46,Valencia/València,106,Chelva,1683,870,813
46,Valencia/València,107,Chella,2798,1395,1403
46,Valencia/València,108,Chera,599,328,271
46,Valencia/València,109,Cheste,8432,4357,4075
46,Valencia/València,110,Xirivella,30405,15230,15175
46,Valencia/València,111,Chiva,15072,7794,7278
46,Valencia/València,112,Chulilla,752,400,352
46,Valencia/València,113,Daimús,3200,1626,1574
46,Valencia/València,114,Domeño,714,371,343
46,Valencia/València,115,Dos Aguas,565,323,242
46,Valencia/València,116,"Eliana, l'",17061,8446,8615
46,Valencia/València,117,Emperador,637,333,304
46,Valencia/València,118,Enguera,5968,3080,2888
46,Valencia/València,119,"Ènova, l'",982,497,485
46,Valencia/València,120,Estivella,1382,669,713
46,Valencia/València,121,Estubeny,129,66,63
46,Valencia/València,122,Faura,3648,1853,1795
46,Valencia/València,123,Favara,2411,1208,1203
46,Valencia/València,124,Fontanars dels Alforins,1036,528,508
46,Valencia/València,125,Fortaleny,1039,509,530
46,Valencia/València,126,Foios,6962,3411,3551
46,Valencia/València,127,"Font d'En Carròs, la",4191,2140,2051
46,Valencia/València,128,"Font de la Figuera, la",2234,1142,1092
46,Valencia/València,129,Fuenterrobles,755,406,349
46,Valencia/València,130,Gavarda,1143,561,582
46,Valencia/València,131,Gandia,78704,39479,39225
46,Valencia/València,132,Genovés,2826,1428,1398
46,Valencia/València,133,Gestalgar,817,422,395
46,Valencia/València,134,Gilet,3248,1676,1572
46,Valencia/València,135,Godella,13242,6409,6833
46,Valencia/València,136,Godelleta,3353,1729,1624
46,Valencia/València,137,"Granja de la Costera, la",343,172,171
46,Valencia/València,138,Guadasequies,437,226,211
46,Valencia/València,139,Guadassuar,6101,3054,3047
46,Valencia/València,140,Guardamar de la Safor,502,263,239
46,Valencia/València,141,Higueruelas,505,264,241
46,Valencia/València,142,Jalance,993,502,491
46,Valencia/València,143,Xeraco,6156,3208,2948
46,Valencia/València,144,Jarafuel,833,433,400
46,Valencia/València,145,Xàtiva,29469,14513,14956
46,Valencia/València,146,Xeresa,2320,1183,1137
46,Valencia/València,147,Llíria,23397,11892,11505
46,Valencia/València,148,Loriguilla,1686,854,832
46,Valencia/València,149,Losa del Obispo,564,288,276
46,Valencia/València,150,Llutxent,2538,1291,1247
46,Valencia/València,151,Llocnou d'En Fenollet,898,468,430
46,Valencia/València,152,Llocnou de la Corona,156,83,73
46,Valencia/València,153,Llocnou de Sant Jeroni,570,283,287
46,Valencia/València,154,Llanera de Ranes,1159,605,554
46,Valencia/València,155,Llaurí,1306,658,648
46,Valencia/València,156,Llombai,2786,1402,1384
46,Valencia/València,157,"Llosa de Ranes, la",4078,2110,1968
46,Valencia/València,158,Macastre,1341,695,646
46,Valencia/València,159,Manises,30747,15214,15533
46,Valencia/València,160,Manuel,2625,1274,1351
46,Valencia/València,161,Marines,1832,922,910
46,Valencia/València,162,Massalavés,1636,845,791
46,Valencia/València,163,Massalfassar,2349,1161,1188
46,Valencia/València,164,Massamagrell,15491,7678,7813
46,Valencia/València,165,Massanassa,9022,4483,4539
46,Valencia/València,166,Meliana,10601,5280,5321
46,Valencia/València,167,Millares,466,226,240
46,Valencia/València,168,Miramar,2538,1327,1211
46,Valencia/València,169,Mislata,43657,21414,22243
46,Valencia/València,170,Mogente/Moixent,4758,2435,2323
46,Valencia/València,171,Moncada,21860,10848,11012
46,Valencia/València,172,Montserrat,7207,3801,3406
46,Valencia/València,173,Montaverner,1843,915,928
46,Valencia/València,174,Montesa,1339,692,647
46,Valencia/València,175,Montitxelvo/Montichelvo,668,343,325
46,Valencia/València,176,Montroy,2928,1542,1386
46,Valencia/València,177,Museros,5984,3009,2975
46,Valencia/València,178,Náquera,5900,3069,2831
46,Valencia/València,179,Navarrés,3269,1676,1593
46,Valencia/València,180,Novelé/Novetlè,849,428,421
46,Valencia/València,181,Oliva,28400,14389,14011
46,Valencia/València,182,Olocau,1517,788,729
46,Valencia/València,183,"Olleria, l'",8709,4417,4292
46,Valencia/València,184,Ontinyent,37606,18807,18799
46,Valencia/València,185,Otos,490,251,239
46,Valencia/València,186,Paiporta,24298,12210,12088
46,Valencia/València,187,Palma de Gandía,1854,949,905
46,Valencia/València,188,Palmera,989,523,466
46,Valencia/València,189,"Palomar, el",601,288,313
46,Valencia/València,190,Paterna,66948,33435,33513
46,Valencia/València,191,Pedralba,3011,1629,1382
46,Valencia/València,192,Petrés,1024,505,519
46,Valencia/València,193,Picanya,11261,5564,5697
46,Valencia/València,194,Picassent,20087,10161,9926
46,Valencia/València,195,Piles,2853,1446,1407
46,Valencia/València,196,Pinet,182,89,93
46,Valencia/València,197,Polinyà de Xúquer,2504,1263,1241
46,Valencia/València,198,Potríes,1026,509,517
46,Valencia/València,199,"Pobla de Farnals, la",7614,3899,3715
46,Valencia/València,200,"Pobla del Duc, la",2539,1238,1301
46,Valencia/València,201,Puebla de San Miguel,86,47,39
46,Valencia/València,202,"Pobla de Vallbona, la",21708,11000,10708
46,Valencia/València,203,"Pobla Llarga, la",4604,2303,2301
46,Valencia/València,204,Puig,9097,4503,4594
46,Valencia/València,205,Puçol,19310,9577,9733
46,Valencia/València,206,Quesa,734,373,361
46,Valencia/València,207,Rafelbuñol/Rafelbunyol,8569,4253,4316
46,Valencia/València,208,Rafelcofer,1471,703,768
46,Valencia/València,209,Rafelguaraf,2532,1263,1269
46,Valencia/València,210,Ráfol de Salem,442,215,227
46,Valencia/València,211,Real de Gandía,2259,1104,1155
46,Valencia/València,212,Real,2367,1249,1118
46,Valencia/València,213,Requena,21394,10836,10558
46,Valencia/València,214,Riba-roja de Túria,21094,10771,10323
46,Valencia/València,215,Riola,1875,965,910
46,Valencia/València,216,Rocafort,6806,3313,3493
46,Valencia/València,217,Rotglà i Corberà,1208,601,607
46,Valencia/València,218,Rótova,1324,675,649
46,Valencia/València,219,Rugat,197,99,98
46,Valencia/València,220,Sagunto/Sagunt,65595,32489,33106
46,Valencia/València,221,Salem,469,236,233
46,Valencia/València,222,Sant Joanet,498,242,256
46,Valencia/València,223,Sedaví,10092,4926,5166
46,Valencia/València,224,Segart,173,90,83
46,Valencia/València,225,Sellent,427,221,206
46,Valencia/València,226,Sempere,48,24,24
46,Valencia/València,227,Senyera,1188,595,593
46,Valencia/València,228,Serra,3349,1750,1599
46,Valencia/València,229,Siete Aguas,1486,781,705
46,Valencia/València,230,Silla,19213,9618,9595
46,Valencia/València,231,Simat de la Valldigna,3666,1889,1777
46,Valencia/València,232,Sinarcas,1203,625,578
46,Valencia/València,233,Sollana,5041,2482,2559
46,Valencia/València,234,Sot de Chera,458,235,223
46,Valencia/València,235,Sueca,28986,14498,14488
46,Valencia/València,236,Sumacàrcer,1255,624,631
46,Valencia/València,237,Tavernes Blanques,9305,4539,4766
46,Valencia/València,238,Tavernes de la Valldigna,18185,9164,9021
46,Valencia/València,239,Teresa de Cofrentes,663,331,332
46,Valencia/València,240,Terrateig,330,168,162
46,Valencia/València,241,Titaguas,518,267,251
46,Valencia/València,242,Torrebaja,457,247,210
46,Valencia/València,243,Torrella,155,81,74
46,Valencia/València,244,Torrent,80610,40411,40199
46,Valencia/València,245,Torres Torres,602,317,285
46,Valencia/València,246,Tous,1268,648,620
46,Valencia/València,247,Tuéjar,1234,668,566
46,Valencia/València,248,Turís,6529,3438,3091
46,Valencia/València,249,Utiel,12449,6259,6190
46,Valencia/València,250,Valencia,798033,382412,415621
46,Valencia/València,251,Vallada,3365,1722,1643
46,Valencia/València,252,Vallanca,156,86,70
46,Valencia/València,253,Vallés,167,91,76
46,Valencia/València,254,Venta del Moro,1443,775,668
46,Valencia/València,255,Villalonga,4327,2144,2183
46,Valencia/València,256,Vilamarxant,9393,4866,4527
46,Valencia/València,257,Villanueva de Castellón,7595,3792,3803
46,Valencia/València,258,Villar del Arzobispo,3804,1934,1870
46,Valencia/València,259,Villargordo del Cabriel,770,413,357
46,Valencia/València,260,Vinalesa,3166,1543,1623
46,Valencia/València,261,Yátova,2168,1127,1041
46,Valencia/València,262,"Yesa, La",265,146,119
46,Valencia/València,263,Zarra,566,314,252
46,Valencia/València,902,Gátova,460,224,236
46,Valencia/València,903,San Antonio de Benagéber,6856,3372,3484
46,Valencia/València,904,Benicull de Xúquer,980,489,491
47,Valladolid,1,Adalia,58,32,26
47,Valladolid,2,Aguasal,30,19,11
47,Valladolid,3,Aguilar de Campos,299,169,130
47,Valladolid,4,Alaejos,1560,820,740
47,Valladolid,5,Alcazarén,726,392,334
47,Valladolid,6,Aldea de San Miguel,225,118,107
47,Valladolid,7,Aldeamayor de San Martín,4322,2248,2074
47,Valladolid,8,Almenara de Adaja,29,15,14
47,Valladolid,9,Amusquillo,120,76,44
47,Valladolid,10,Arroyo de la Encomienda,14461,7469,6992
47,Valladolid,11,Ataquines,683,375,308
47,Valladolid,12,Bahabón,173,83,90
47,Valladolid,13,Barcial de la Loma,129,65,64
47,Valladolid,14,Barruelo del Valle,57,35,22
47,Valladolid,15,Becilla de Valderaduey,314,176,138
47,Valladolid,16,Benafarces,105,53,52
47,Valladolid,17,Bercero,227,126,101
47,Valladolid,18,Berceruelo,40,23,17
47,Valladolid,19,Berrueces,118,67,51
47,Valladolid,20,Bobadilla del Campo,314,170,144
47,Valladolid,21,Bocigas,99,53,46
47,Valladolid,22,Bocos de Duero,63,28,35
47,Valladolid,23,Boecillo,3862,2002,1860
47,Valladolid,24,Bolaños de Campos,356,186,170
47,Valladolid,25,Brahojos de Medina,146,73,73
47,Valladolid,26,Bustillo de Chaves,87,47,40
47,Valladolid,27,Cabezón de Pisuerga,3520,1814,1706
47,Valladolid,28,Cabezón de Valderaduey,38,21,17
47,Valladolid,29,Cabreros del Monte,72,38,34
47,Valladolid,30,Campaspero,1330,713,617
47,Valladolid,31,"Campillo, El",231,129,102
47,Valladolid,32,Camporredondo,174,97,77
47,Valladolid,33,Canalejas de Peñafiel,300,160,140
47,Valladolid,34,Canillas de Esgueva,95,54,41
47,Valladolid,35,Carpio,1103,583,520
47,Valladolid,36,Casasola de Arión,314,175,139
47,Valladolid,37,Castrejón de Trabancos,217,111,106
47,Valladolid,38,Castrillo de Duero,155,78,77
47,Valladolid,39,Castrillo-Tejeriego,203,117,86
47,Valladolid,40,Castrobol,75,34,41
47,Valladolid,41,Castrodeza,180,107,73
47,Valladolid,42,Castromembibre,70,36,34
47,Valladolid,43,Castromonte,374,207,167
47,Valladolid,44,Castronuevo de Esgueva,379,204,175
47,Valladolid,45,Castronuño,984,487,497
47,Valladolid,46,Castroponce,161,90,71
47,Valladolid,47,Castroverde de Cerrato,257,156,101
47,Valladolid,48,Ceinos de Campos,270,143,127
47,Valladolid,49,Cervillego de la Cruz,96,55,41
47,Valladolid,50,Cigales,4743,2420,2323
47,Valladolid,51,Ciguñuela,410,222,188
47,Valladolid,52,Cistérniga,8253,4249,4004
47,Valladolid,53,Cogeces de Íscar,170,96,74
47,Valladolid,54,Cogeces del Monte,816,443,373
47,Valladolid,55,Corcos,236,128,108
47,Valladolid,56,Corrales de Duero,103,58,45
47,Valladolid,57,Cubillas de Santa Marta,288,169,119
47,Valladolid,58,Cuenca de Campos,233,119,114
47,Valladolid,59,Curiel de Duero,131,84,47
47,Valladolid,60,Encinas de Esgueva,302,163,139
47,Valladolid,61,Esguevillas de Esgueva,292,159,133
47,Valladolid,62,Fombellida,207,116,91
47,Valladolid,63,Fompedraza,133,74,59
47,Valladolid,64,Fontihoyuelo,37,20,17
47,Valladolid,65,Fresno el Viejo,1011,529,482
47,Valladolid,66,Fuensaldaña,1455,736,719
47,Valladolid,67,Fuente el Sol,217,119,98
47,Valladolid,68,Fuente-Olmedo,45,22,23
47,Valladolid,69,Gallegos de Hornija,147,74,73
47,Valladolid,70,Gatón de Campos,40,25,15
47,Valladolid,71,Geria,493,262,231
47,Valladolid,73,Herrín de Campos,153,75,78
47,Valladolid,74,Hornillos de Eresma,188,103,85
47,Valladolid,75,Íscar,6871,3506,3365
47,Valladolid,76,Laguna de Duero,22334,11272,11062
47,Valladolid,77,Langayo,320,191,129
47,Valladolid,78,Lomoviejo,206,107,99
47,Valladolid,79,Llano de Olmedo,75,43,32
47,Valladolid,80,Manzanillo,67,37,30
47,Valladolid,81,Marzales,57,26,31
47,Valladolid,82,Matapozuelos,1053,523,530
47,Valladolid,83,Matilla de los Caños,99,55,44
47,Valladolid,84,Mayorga,1937,952,985
47,Valladolid,85,Medina del Campo,21607,10504,11103
47,Valladolid,86,Medina de Rioseco,5001,2451,2550
47,Valladolid,87,Megeces,455,239,216
47,Valladolid,88,Melgar de Abajo,142,82,60
47,Valladolid,89,Melgar de Arriba,209,113,96
47,Valladolid,90,Mojados,3354,1758,1596
47,Valladolid,91,Monasterio de Vega,101,54,47
47,Valladolid,92,Montealegre de Campos,141,81,60
47,Valladolid,93,Montemayor de Pililla,997,517,480
47,Valladolid,94,Moral de la Reina,198,109,89
47,Valladolid,95,Moraleja de las Panaderas,43,28,15
47,Valladolid,96,Morales de Campos,161,84,77
47,Valladolid,97,Mota del Marqués,380,201,179
47,Valladolid,98,Mucientes,733,375,358
47,Valladolid,99,"Mudarra, La",185,98,87
47,Valladolid,100,Muriel,182,98,84
47,Valladolid,101,Nava del Rey,2112,1071,1041
47,Valladolid,102,Nueva Villa de las Torres,322,188,134
47,Valladolid,103,Olivares de Duero,345,187,158
47,Valladolid,104,Olmedo,3897,1919,1978
47,Valladolid,105,Olmos de Esgueva,233,127,106
47,Valladolid,106,Olmos de Peñafiel,72,38,34
47,Valladolid,109,Palazuelo de Vedija,221,117,104
47,Valladolid,110,"Parrilla, La",529,264,265
47,Valladolid,111,"Pedraja de Portillo, La",1163,596,567
47,Valladolid,112,Pedrajas de San Esteban,3652,1874,1778
47,Valladolid,113,Pedrosa del Rey,203,111,92
47,Valladolid,114,Peñafiel,5616,2841,2775
47,Valladolid,115,Peñaflor de Hornija,348,187,161
47,Valladolid,116,Pesquera de Duero,535,295,240
47,Valladolid,117,Piña de Esgueva,348,172,176
47,Valladolid,118,Piñel de Abajo,191,102,89
47,Valladolid,119,Piñel de Arriba,127,69,58
47,Valladolid,121,Pollos,677,349,328
47,Valladolid,122,Portillo,2556,1321,1235
47,Valladolid,123,Pozal de Gallinas,538,284,254
47,Valladolid,124,Pozaldez,576,308,268
47,Valladolid,125,Pozuelo de la Orden,61,37,24
47,Valladolid,126,Puras,55,29,26
47,Valladolid,127,Quintanilla de Arriba,186,102,84
47,Valladolid,128,Quintanilla del Molar,70,34,36
47,Valladolid,129,Quintanilla de Onésimo,1137,591,546
47,Valladolid,130,Quintanilla de Trigueros,128,64,64
47,Valladolid,131,Rábano,213,115,98
47,Valladolid,132,Ramiro,43,27,16
47,Valladolid,133,Renedo de Esgueva,3113,1628,1485
47,Valladolid,134,Roales de Campos,203,106,97
47,Valladolid,135,Robladillo,104,59,45
47,Valladolid,137,Roturas,34,18,16
47,Valladolid,138,Rubí de Bracamonte,287,157,130
47,Valladolid,139,Rueda,1421,737,684
47,Valladolid,140,Saelices de Mayorga,139,78,61
47,Valladolid,141,Salvador de Zapardiel,159,90,69
47,Valladolid,142,San Cebrián de Mazote,180,104,76
47,Valladolid,143,San Llorente,160,87,73
47,Valladolid,144,San Martín de Valvení,107,61,46
47,Valladolid,145,San Miguel del Arroyo,747,393,354
47,Valladolid,146,San Miguel del Pino,294,163,131
47,Valladolid,147,San Pablo de la Moraleja,137,70,67
47,Valladolid,148,San Pedro de Latarce,548,295,253
47,Valladolid,149,San Pelayo,53,25,28
47,Valladolid,150,San Román de Hornija,394,185,209
47,Valladolid,151,San Salvador,37,21,16
47,Valladolid,152,Santa Eufemia del Arroyo,106,56,50
47,Valladolid,153,Santervás de Campos,139,75,64
47,Valladolid,154,Santibáñez de Valcorba,173,92,81
47,Valladolid,155,Santovenia de Pisuerga,3965,2026,1939
47,Valladolid,156,San Vicente del Palacio,202,107,95
47,Valladolid,157,Sardón de Duero,683,349,334
47,Valladolid,158,"Seca, La",1124,584,540
47,Valladolid,159,Serrada,1190,620,570
47,Valladolid,160,Siete Iglesias de Trabancos,555,296,259
47,Valladolid,161,Simancas,5357,2731,2626
47,Valladolid,162,Tamariz de Campos,80,40,40
47,Valladolid,163,Tiedra,345,173,172
47,Valladolid,164,Tordehumos,468,236,232
47,Valladolid,165,Tordesillas,9172,4699,4473
47,Valladolid,166,Torrecilla de la Abadesa,318,159,159
47,Valladolid,167,Torrecilla de la Orden,301,151,150
47,Valladolid,168,Torrecilla de la Torre,39,27,12
47,Valladolid,169,Torre de Esgueva,72,36,36
47,Valladolid,170,Torre de Peñafiel,47,28,19
47,Valladolid,171,Torrelobatón,498,249,249
47,Valladolid,172,Torrescárcela,192,103,89
47,Valladolid,173,Traspinedo,1036,564,472
47,Valladolid,174,Trigueros del Valle,344,192,152
47,Valladolid,175,Tudela de Duero,8746,4519,4227
47,Valladolid,176,"Unión de Campos, La",262,138,124
47,Valladolid,177,Urones de Castroponce,119,65,54
47,Valladolid,178,Urueña,222,120,102
47,Valladolid,179,Valbuena de Duero,499,269,230
47,Valladolid,180,Valdearcos de la Vega,118,59,59
47,Valladolid,181,Valdenebro de los Valles,228,116,112
47,Valladolid,182,Valdestillas,1780,928,852
47,Valladolid,183,Valdunquillo,175,83,92
47,Valladolid,184,Valoria la Buena,696,362,334
47,Valladolid,185,Valverde de Campos,120,67,53
47,Valladolid,186,Valladolid,313437,148776,164661
47,Valladolid,187,Vega de Ruiponce,118,66,52
47,Valladolid,188,Vega de Valdetronco,133,73,60
47,Valladolid,189,Velascálvaro,186,106,80
47,Valladolid,190,Velilla,124,63,61
47,Valladolid,191,Velliza,117,69,48
47,Valladolid,192,Ventosa de la Cuesta,136,78,58
47,Valladolid,193,Viana de Cega,1968,1022,946
47,Valladolid,194,Viloria,380,205,175
47,Valladolid,195,Villabáñez,530,295,235
47,Valladolid,196,Villabaruz de Campos,45,22,23
47,Valladolid,197,Villabrágima,1107,581,526
47,Valladolid,198,Villacarralón,83,51,32
47,Valladolid,199,Villacid de Campos,99,54,45
47,Valladolid,200,Villaco,106,64,42
47,Valladolid,203,Villafrades de Campos,94,46,48
47,Valladolid,204,Villafranca de Duero,336,173,163
47,Valladolid,205,Villafrechós,545,294,251
47,Valladolid,206,Villafuerte,119,66,53
47,Valladolid,207,Villagarcía de Campos,376,215,161
47,Valladolid,208,Villagómez la Nueva,69,38,31
47,Valladolid,209,Villalán de Campos,49,27,22
47,Valladolid,210,Villalar de los Comuneros,470,229,241
47,Valladolid,211,Villalba de la Loma,52,28,24
47,Valladolid,212,Villalba de los Alcores,481,263,218
47,Valladolid,213,Villalbarba,137,69,68
47,Valladolid,214,Villalón de Campos,1890,942,948
47,Valladolid,215,Villamuriel de Campos,69,35,34
47,Valladolid,216,Villán de Tordesillas,140,76,64
47,Valladolid,217,Villanubla,2281,1194,1087
47,Valladolid,218,Villanueva de Duero,1209,626,583
47,Valladolid,219,Villanueva de la Condesa,77,42,35
47,Valladolid,220,Villanueva de los Caballeros,223,110,113
47,Valladolid,221,Villanueva de los Infantes,123,70,53
47,Valladolid,222,Villanueva de San Mancio,110,60,50
47,Valladolid,223,Villardefrades,203,110,93
47,Valladolid,224,Villarmentero de Esgueva,110,56,54
47,Valladolid,225,Villasexmir,93,52,41
47,Valladolid,226,Villavaquerín,199,111,88
47,Valladolid,227,Villavellid,72,41,31
47,Valladolid,228,Villaverde de Medina,546,297,249
47,Valladolid,229,Villavicencio de los Caballeros,265,128,137
47,Valladolid,230,Wamba,366,193,173
47,Valladolid,231,Zaratán,5621,2909,2712
47,Valladolid,232,"Zarza, La",126,71,55
48,Bizkaia,1,Abadiño,7312,3631,3681
48,Bizkaia,2,Abanto y Ciérvana-Abanto Zierbena,9713,4830,4883
48,Bizkaia,3,Amorebieta-Etxano,18140,8980,9160
48,Bizkaia,4,Amoroto,413,217,196
48,Bizkaia,5,Arakaldo,128,70,58
48,Bizkaia,6,Arantzazu,354,172,182
48,Bizkaia,7,Munitibar-Arbatzegi Gerrikaitz,427,229,198
48,Bizkaia,8,Artzentales,742,404,338
48,Bizkaia,9,Arrankudiaga,933,461,472
48,Bizkaia,10,Arrieta,542,276,266
48,Bizkaia,11,Arrigorriaga,12511,6162,6349
48,Bizkaia,12,Bakio,2542,1285,1257
48,Bizkaia,13,Barakaldo,100061,48597,51464
48,Bizkaia,14,Barrika,1516,749,767
48,Bizkaia,15,Basauri,42166,20597,21569
48,Bizkaia,16,Berango,6812,3331,3481
48,Bizkaia,17,Bermeo,17078,8402,8676
48,Bizkaia,18,Berriatua,1257,699,558
48,Bizkaia,19,Berriz,4871,2459,2412
48,Bizkaia,20,Bilbao,352700,166887,185813
48,Bizkaia,21,Busturia,1776,885,891
48,Bizkaia,22,Karrantza Harana/Valle de Carranza,2794,1451,1343
48,Bizkaia,23,Artea,783,388,395
48,Bizkaia,24,Zeanuri,1297,663,634
48,Bizkaia,25,Zeberio,1063,531,532
48,Bizkaia,26,Dima,1356,697,659
48,Bizkaia,27,Durango,28226,13879,14347
48,Bizkaia,28,Ea,896,453,443
48,Bizkaia,29,Etxebarri,10133,5105,5028
48,Bizkaia,30,Etxebarria,808,419,389
48,Bizkaia,31,Elantxobe,423,196,227
48,Bizkaia,32,Elorrio,7249,3568,3681
48,Bizkaia,33,Ereño,263,135,128
48,Bizkaia,34,Ermua,16274,8185,8089
48,Bizkaia,35,Fruiz,469,236,233
48,Bizkaia,36,Galdakao,29049,14327,14722
48,Bizkaia,37,Galdames,849,441,408
48,Bizkaia,38,Gamiz-Fika,1331,674,657
48,Bizkaia,39,Garai,339,168,171
48,Bizkaia,40,Gatika,1584,813,771
48,Bizkaia,41,Gautegiz Arteaga,879,443,436
48,Bizkaia,42,Gordexola,1756,882,874
48,Bizkaia,43,Gorliz,5515,2724,2791
48,Bizkaia,44,Getxo,80089,37721,42368
48,Bizkaia,45,Güeñes,6400,3155,3245
48,Bizkaia,46,Gernika-Lumo,16442,7952,8490
48,Bizkaia,47,Gizaburuaga,205,103,102
48,Bizkaia,48,Ibarrangelu,636,316,320
48,Bizkaia,49,Ispaster,679,350,329
48,Bizkaia,50,Izurtza,276,165,111
48,Bizkaia,51,Lanestosa,265,135,130
48,Bizkaia,52,Larrabetzu,1931,957,974
48,Bizkaia,53,Laukiz,1138,585,553
48,Bizkaia,54,Leioa,30454,14854,15600
48,Bizkaia,55,Lemoa,3346,1667,1679
48,Bizkaia,56,Lemoiz,1042,548,494
48,Bizkaia,57,Lekeitio,7409,3643,3766
48,Bizkaia,58,Mallabia,1188,597,591
48,Bizkaia,59,Mañaria,513,273,240
48,Bizkaia,60,Markina-Xemein,4967,2605,2362
48,Bizkaia,61,Maruri-Jatabe,916,465,451
48,Bizkaia,62,Mendata,381,204,177
48,Bizkaia,63,Mendexa,438,223,215
48,Bizkaia,64,Meñaka,726,367,359
48,Bizkaia,65,Ugao-Miraballes,4059,2042,2017
48,Bizkaia,66,Morga,411,214,197
48,Bizkaia,67,Muxika,1477,760,717
48,Bizkaia,68,Mundaka,1939,938,1001
48,Bizkaia,69,Mungia,16737,8183,8554
48,Bizkaia,70,Aulesti,681,343,338
48,Bizkaia,71,Muskiz,7408,3697,3711
48,Bizkaia,72,Otxandio,1277,678,599
48,Bizkaia,73,Ondarroa,8852,4470,4382
48,Bizkaia,74,Urduña/Orduña,4259,2177,2082
48,Bizkaia,75,Orozko,2451,1213,1238
48,Bizkaia,76,Sukarrieta,354,187,167
48,Bizkaia,77,Plentzia,4311,2087,2224
48,Bizkaia,78,Portugalete,47742,22968,24774
48,Bizkaia,79,Errigoiti,557,299,258
48,Bizkaia,80,Valle de Trápaga-Trapagaran,12224,5983,6241
48,Bizkaia,81,Lezama,2517,1249,1268
48,Bizkaia,82,Santurtzi,47076,22869,24207
48,Bizkaia,83,Ortuella,8412,4091,4321
48,Bizkaia,84,Sestao,28959,14064,14895
48,Bizkaia,85,Sopelana,12693,6265,6428
48,Bizkaia,86,Sopuerta,2588,1315,1273
48,Bizkaia,87,Trucios-Turtzioz,537,277,260
48,Bizkaia,88,Ubide,184,91,93
48,Bizkaia,89,Urduliz,3571,1774,1797
48,Bizkaia,90,Balmaseda,7583,3692,3891
48,Bizkaia,91,Atxondo,1429,733,696
48,Bizkaia,92,Bedia,970,463,507
48,Bizkaia,93,Areatza,1179,557,622
48,Bizkaia,94,Igorre,4273,2099,2174
48,Bizkaia,95,Zaldibar,3038,1509,1529
48,Bizkaia,96,Zalla,8258,4061,4197
48,Bizkaia,97,Zaratamo,1666,830,836
48,Bizkaia,901,Derio,5458,2671,2787
48,Bizkaia,902,Erandio,24262,11919,12343
48,Bizkaia,903,Loiu,2491,1259,1232
48,Bizkaia,904,Sondika,4533,2189,2344
48,Bizkaia,905,Zamudio,3248,1631,1617
48,Bizkaia,906,Forua,979,492,487
48,Bizkaia,907,Kortezubi,430,219,211
48,Bizkaia,908,Murueta,308,159,149
48,Bizkaia,909,Nabarniz,236,123,113
48,Bizkaia,910,Iurreta,3867,1946,1921
48,Bizkaia,911,Ajangiz,458,235,223
48,Bizkaia,912,Alonsotegi,2820,1392,1428
48,Bizkaia,913,Zierbena,1440,769,671
48,Bizkaia,914,Arratzu,389,193,196
48,Bizkaia,915,Ziortza-Bolibar,410,217,193
49,Zamora,2,Abezames,83,43,40
49,Zamora,3,Alcañices,1163,582,581
49,Zamora,4,Alcubilla de Nogales,138,72,66
49,Zamora,5,Alfaraz de Sayago,169,92,77
49,Zamora,6,Algodre,175,93,82
49,Zamora,7,Almaraz de Duero,408,205,203
49,Zamora,8,Almeida de Sayago,564,290,274
49,Zamora,9,Andavías,490,254,236
49,Zamora,10,Arcenillas,397,202,195
49,Zamora,11,Arcos de la Polvorosa,260,136,124
49,Zamora,12,Argañín,82,42,40
49,Zamora,13,Argujillo,331,170,161
49,Zamora,14,Arquillinos,138,70,68
49,Zamora,15,Arrabalde,283,130,153
49,Zamora,16,Aspariegos,302,146,156
49,Zamora,17,Asturianos,278,151,127
49,Zamora,18,Ayoó de Vidriales,372,201,171
49,Zamora,19,Barcial del Barco,281,149,132
49,Zamora,20,Belver de los Montes,363,195,168
49,Zamora,21,Benavente,19187,9371,9816
49,Zamora,22,Benegiles,378,201,177
49,Zamora,23,Bermillo de Sayago,1209,628,581
49,Zamora,24,"Bóveda de Toro, La",881,445,436
49,Zamora,25,Bretó,198,113,85
49,Zamora,26,Bretocino,253,136,117
49,Zamora,27,Brime de Sog,181,86,95
49,Zamora,28,Brime de Urz,131,73,58
49,Zamora,29,Burganes de Valverde,774,404,370
49,Zamora,30,Bustillo del Oro,103,56,47
49,Zamora,31,Cabañas de Sayago,171,91,80
49,Zamora,32,Calzadilla de Tera,396,179,217
49,Zamora,33,Camarzana de Tera,950,472,478
49,Zamora,34,Cañizal,520,272,248
49,Zamora,35,Cañizo,295,146,149
49,Zamora,36,Carbajales de Alba,673,345,328
49,Zamora,37,Carbellino,228,118,110
49,Zamora,38,Casaseca de Campeán,130,73,57
49,Zamora,39,Casaseca de las Chanas,421,237,184
49,Zamora,40,Castrillo de la Guareña,129,68,61
49,Zamora,41,Castrogonzalo,509,270,239
49,Zamora,42,Castronuevo,286,142,144
49,Zamora,43,Castroverde de Campos,362,189,173
49,Zamora,44,Cazurra,82,44,38
49,Zamora,46,Cerecinos de Campos,353,189,164
49,Zamora,47,Cerecinos del Carrizal,139,79,60
49,Zamora,48,Cernadilla,169,81,88
49,Zamora,50,Cobreros,666,352,314
49,Zamora,52,Coomonte,227,114,113
49,Zamora,53,Coreses,1142,591,551
49,Zamora,54,Corrales del Vino,1075,539,536
49,Zamora,55,Cotanes del Monte,122,66,56
49,Zamora,56,Cubillos,354,178,176
49,Zamora,57,Cubo de Benavente,134,76,58
49,Zamora,58,"Cubo de Tierra del Vino, El",417,227,190
49,Zamora,59,Cuelgamures,115,69,46
49,Zamora,61,Entrala,160,86,74
49,Zamora,62,Espadañedo,160,84,76
49,Zamora,63,Faramontanos de Tábara,409,210,199
49,Zamora,64,Fariza,612,314,298
49,Zamora,65,Fermoselle,1466,751,715
49,Zamora,66,Ferreras de Abajo,597,302,295
49,Zamora,67,Ferreras de Arriba,468,242,226
49,Zamora,68,Ferreruela,563,303,260
49,Zamora,69,Figueruela de Arriba,413,192,221
49,Zamora,71,Fonfría,950,482,468
49,Zamora,75,Fresno de la Polvorosa,165,83,82
49,Zamora,76,Fresno de la Ribera,397,214,183
49,Zamora,77,Fresno de Sayago,238,125,113
49,Zamora,78,Friera de Valverde,226,113,113
49,Zamora,79,Fuente Encalada,119,69,50
49,Zamora,80,Fuentelapeña,834,437,397
49,Zamora,81,Fuentesaúco,1909,952,957
49,Zamora,82,Fuentes de Ropel,480,240,240
49,Zamora,83,Fuentesecas,65,32,33
49,Zamora,84,Fuentespreadas,332,180,152
49,Zamora,85,Galende,1384,713,671
49,Zamora,86,Gallegos del Pan,141,81,60
49,Zamora,87,Gallegos del Río,623,333,290
49,Zamora,88,Gamones,100,56,44
49,Zamora,90,Gema,241,123,118
49,Zamora,91,Granja de Moreruela,302,159,143
49,Zamora,92,Granucillo,176,91,85
49,Zamora,93,Guarrate,375,199,176
49,Zamora,94,Hermisende,321,177,144
49,Zamora,95,"Hiniesta, La",347,172,175
49,Zamora,96,Jambrina,202,104,98
49,Zamora,97,Justel,108,61,47
49,Zamora,98,Losacino,255,140,115
49,Zamora,99,Losacio,135,76,59
49,Zamora,100,Lubián,354,183,171
49,Zamora,101,Luelmo,205,107,98
49,Zamora,102,"Maderal, El",238,123,115
49,Zamora,103,Madridanos,521,270,251
49,Zamora,104,Mahide,400,221,179
49,Zamora,105,Maire de Castroponce,164,89,75
49,Zamora,107,Malva,169,84,85
49,Zamora,108,Manganeses de la Lampreana,556,273,283
49,Zamora,109,Manganeses de la Polvorosa,754,370,384
49,Zamora,110,Manzanal de Arriba,400,206,194
49,Zamora,111,Manzanal del Barco,156,81,75
49,Zamora,112,Manzanal de los Infantes,143,78,65
49,Zamora,113,Matilla de Arzón,202,112,90
49,Zamora,114,Matilla la Seca,58,28,30
49,Zamora,115,Mayalde,220,112,108
49,Zamora,116,Melgar de Tera,433,212,221
49,Zamora,117,Micereces de Tera,550,277,273
49,Zamora,118,Milles de la Polvorosa,239,131,108
49,Zamora,119,Molacillos,284,150,134
49,Zamora,120,Molezuelas de la Carballeda,82,44,38
49,Zamora,121,Mombuey,446,243,203
49,Zamora,122,Monfarracinos,907,470,437
49,Zamora,123,Montamarta,615,310,305
49,Zamora,124,Moral de Sayago,310,175,135
49,Zamora,125,Moraleja del Vino,1631,849,782
49,Zamora,126,Moraleja de Sayago,264,137,127
49,Zamora,127,Morales del Vino,2785,1460,1325
49,Zamora,128,Morales de Rey,666,331,335
49,Zamora,129,Morales de Toro,1112,564,548
49,Zamora,130,Morales de Valverde,232,118,114
49,Zamora,131,Moralina,329,164,165
49,Zamora,132,Moreruela de los Infanzones,391,202,189
49,Zamora,133,Moreruela de Tábara,385,201,184
49,Zamora,134,Muelas de los Caballeros,214,111,103
49,Zamora,135,Muelas del Pan,776,393,383
49,Zamora,136,Muga de Sayago,402,197,205
49,Zamora,137,Navianos de Valverde,210,118,92
49,Zamora,138,Olmillos de Castro,295,156,139
49,Zamora,139,Otero de Bodas,222,119,103
49,Zamora,141,Pajares de la Lampreana,437,221,216
49,Zamora,142,Palacios del Pan,266,132,134
49,Zamora,143,Palacios de Sanabria,287,140,147
49,Zamora,145,Pedralba de la Pradería,303,163,140
49,Zamora,146,"Pego, El",356,180,176
49,Zamora,147,Peleagonzalo,332,169,163
49,Zamora,148,Peleas de Abajo,241,127,114
49,Zamora,149,Peñausende,470,236,234
49,Zamora,150,Peque,188,87,101
49,Zamora,151,"Perdigón, El",800,414,386
49,Zamora,152,Pereruela,656,347,309
49,Zamora,153,Perilla de Castro,201,97,104
49,Zamora,154,Pías,158,85,73
49,Zamora,155,Piedrahita de Castro,111,60,51
49,Zamora,156,Pinilla de Toro,274,147,127
49,Zamora,157,Pino del Oro,193,102,91
49,Zamora,158,"Piñero, El",256,131,125
49,Zamora,159,Pobladura del Valle,315,163,152
49,Zamora,160,Pobladura de Valderaduey,50,27,23
49,Zamora,162,Porto,230,124,106
49,Zamora,163,Pozoantiguo,286,145,141
49,Zamora,164,Pozuelo de Tábara,186,87,99
49,Zamora,165,Prado,77,43,34
49,Zamora,166,Puebla de Sanabria,1573,754,819
49,Zamora,167,Pueblica de Valverde,253,132,121
49,Zamora,168,Quintanilla del Monte,102,48,54
49,Zamora,169,Quintanilla del Olmo,39,20,19
49,Zamora,170,Quintanilla de Urz,130,66,64
49,Zamora,171,Quiruelas de Vidriales,770,381,389
49,Zamora,172,Rabanales,674,354,320
49,Zamora,173,Rábano de Aliste,480,240,240
49,Zamora,174,Requejo,173,92,81
49,Zamora,175,Revellinos,294,156,138
49,Zamora,176,Riofrío de Aliste,849,458,391
49,Zamora,177,Rionegro del Puente,317,160,157
49,Zamora,178,Roales,815,425,390
49,Zamora,179,Robleda-Cervantes,510,274,236
49,Zamora,180,Roelos de Sayago,189,89,100
49,Zamora,181,Rosinos de la Requejada,434,228,206
49,Zamora,183,Salce,111,56,55
49,Zamora,184,Samir de los Caños,209,110,99
49,Zamora,185,San Agustín del Pozo,208,105,103
49,Zamora,186,San Cebrián de Castro,288,140,148
49,Zamora,187,San Cristóbal de Entreviñas,1556,814,742
49,Zamora,188,San Esteban del Molar,159,91,68
49,Zamora,189,San Justo,283,153,130
49,Zamora,190,San Martín de Valderaduey,81,41,40
49,Zamora,191,San Miguel de la Ribera,353,184,169
49,Zamora,192,San Miguel del Valle,188,90,98
49,Zamora,193,San Pedro de Ceque,577,290,287
49,Zamora,194,San Pedro de la Nave-Almendra,382,193,189
49,Zamora,197,Santa Clara de Avedillo,201,100,101
49,Zamora,199,Santa Colomba de las Monjas,297,148,149
49,Zamora,200,Santa Cristina de la Polvorosa,1168,587,581
49,Zamora,201,Santa Croya de Tera,358,184,174
49,Zamora,202,Santa Eufemia del Barco,232,134,98
49,Zamora,203,Santa María de la Vega,383,197,186
49,Zamora,204,Santa María de Valverde,80,37,43
49,Zamora,205,Santibáñez de Tera,474,241,233
49,Zamora,206,Santibáñez de Vidriales,1162,577,585
49,Zamora,207,Santovenia,317,154,163
49,Zamora,208,San Vicente de la Cabeza,470,249,221
49,Zamora,209,San Vitero,633,350,283
49,Zamora,210,Sanzoles,577,296,281
49,Zamora,214,Tábara,879,458,421
49,Zamora,216,Tapioles,185,102,83
49,Zamora,219,Toro,9649,4726,4923
49,Zamora,220,"Torre del Valle, La",168,87,81
49,Zamora,221,Torregamones,299,159,140
49,Zamora,222,Torres del Carrizal,441,225,216
49,Zamora,223,Trabazos,1021,535,486
49,Zamora,224,Trefacio,186,94,92
49,Zamora,225,Uña de Quintana,175,93,82
49,Zamora,226,Vadillo de la Guareña,328,166,162
49,Zamora,227,Valcabado,318,157,161
49,Zamora,228,Valdefinjas,69,41,28
49,Zamora,229,Valdescorriel,154,77,77
49,Zamora,230,Vallesa de la Guareña,128,66,62
49,Zamora,231,Vega de Tera,406,199,207
49,Zamora,232,Vega de Villalobos,118,53,65
49,Zamora,233,Vegalatrave,124,70,54
49,Zamora,234,Venialbo,486,262,224
49,Zamora,235,Vezdemarbán,550,279,271
49,Zamora,236,Vidayanes,96,49,47
49,Zamora,237,Videmala,165,85,80
49,Zamora,238,Villabrázaro,292,154,138
49,Zamora,239,Villabuena del Puente,840,432,408
49,Zamora,240,Villadepera,255,137,118
49,Zamora,241,Villaescusa,299,154,145
49,Zamora,242,Villafáfila,573,295,278
49,Zamora,243,Villaferrueña,119,59,60
49,Zamora,244,Villageriz,52,31,21
49,Zamora,245,Villalazán,324,162,162
49,Zamora,246,Villalba de la Lampreana,271,146,125
49,Zamora,247,Villalcampo,555,274,281
49,Zamora,248,Villalobos,308,143,165
49,Zamora,249,Villalonso,82,46,36
49,Zamora,250,Villalpando,1630,808,822
49,Zamora,251,Villalube,203,105,98
49,Zamora,252,Villamayor de Campos,430,216,214
49,Zamora,255,Villamor de los Escuderos,469,245,224
49,Zamora,256,Villanázar,339,167,172
49,Zamora,257,Villanueva de Azoague,325,162,163
49,Zamora,258,Villanueva de Campeán,148,78,70
49,Zamora,259,Villanueva de las Peras,119,61,58
49,Zamora,260,Villanueva del Campo,966,475,491
49,Zamora,261,Villaralbo,1884,954,930
49,Zamora,262,Villardeciervos,474,230,244
49,Zamora,263,Villar de Fallaves,65,35,30
49,Zamora,264,Villar del Buey,709,376,333
49,Zamora,265,Villardiegua de la Ribera,151,76,75
49,Zamora,266,Villárdiga,103,59,44
49,Zamora,267,Villardondiego,120,73,47
49,Zamora,268,Villarrín de Campos,520,282,238
49,Zamora,269,Villaseco del Pan,258,117,141
49,Zamora,270,Villavendimio,192,114,78
49,Zamora,271,Villaveza del Agua,248,128,120
49,Zamora,272,Villaveza de Valverde,103,49,54
49,Zamora,273,Viñas,235,121,114
49,Zamora,275,Zamora,65525,30913,34612
50,Zaragoza,1,Abanto,130,67,63
50,Zaragoza,2,Acered,198,111,87
50,Zaragoza,3,Agón,164,87,77
50,Zaragoza,4,Aguarón,873,455,418
50,Zaragoza,5,Aguilón,258,135,123
50,Zaragoza,6,Ainzón,1245,630,615
50,Zaragoza,7,Aladrén,67,44,23
50,Zaragoza,8,Alagón,7112,3587,3525
50,Zaragoza,9,Alarba,160,89,71
50,Zaragoza,10,Alberite de San Juan,99,59,40
50,Zaragoza,11,Albeta,149,74,75
50,Zaragoza,12,Alborge,121,62,59
50,Zaragoza,13,Alcalá de Ebro,283,130,153
50,Zaragoza,14,Alcalá de Moncayo,205,118,87
50,Zaragoza,15,Alconchel de Ariza,96,55,41
50,Zaragoza,16,Aldehuela de Liestos,52,34,18
50,Zaragoza,17,Alfajarín,2215,1124,1091
50,Zaragoza,18,Alfamén,1577,865,712
50,Zaragoza,19,Alforque,87,48,39
50,Zaragoza,20,Alhama de Aragón,1146,604,542
50,Zaragoza,21,Almochuel,37,20,17
50,Zaragoza,22,"Almolda, La",615,313,302
50,Zaragoza,23,Almonacid de la Cuba,270,141,129
50,Zaragoza,24,Almonacid de la Sierra,824,461,363
50,Zaragoza,25,"Almunia de Doña Godina, La",7851,4046,3805
50,Zaragoza,26,Alpartir,570,296,274
50,Zaragoza,27,Ambel,290,142,148
50,Zaragoza,28,Anento,133,79,54
50,Zaragoza,29,Aniñón,803,440,363
50,Zaragoza,30,Añón de Moncayo,208,122,86
50,Zaragoza,31,Aranda de Moncayo,208,123,85
50,Zaragoza,32,Arándiga,412,211,201
50,Zaragoza,33,Ardisa,85,53,32
50,Zaragoza,34,Ariza,1286,657,629
50,Zaragoza,35,Artieda,92,52,40
50,Zaragoza,36,Asín,110,53,57
50,Zaragoza,37,Atea,128,74,54
50,Zaragoza,38,Ateca,2160,1120,1040
50,Zaragoza,39,Azuara,702,388,314
50,Zaragoza,40,Badules,100,50,50
50,Zaragoza,41,Bagüés,21,12,9
50,Zaragoza,42,Balconchán,15,7,8
50,Zaragoza,43,Bárboles,326,187,139
50,Zaragoza,44,Bardallur,328,161,167
50,Zaragoza,45,Belchite,1683,872,811
50,Zaragoza,46,Belmonte de Gracián,236,134,102
50,Zaragoza,47,Berdejo,71,42,29
50,Zaragoza,48,Berrueco,45,22,23
50,Zaragoza,50,Bijuesca,115,73,42
50,Zaragoza,51,Biota,1095,568,527
50,Zaragoza,52,Bisimbre,108,57,51
50,Zaragoza,53,Boquiñeni,985,500,485
50,Zaragoza,54,Bordalba,73,43,30
50,Zaragoza,55,Borja,5020,2560,2460
50,Zaragoza,56,Botorrita,526,287,239
50,Zaragoza,57,Brea de Aragón,1816,910,906
50,Zaragoza,58,Bubierca,82,45,37
50,Zaragoza,59,Bujaraloz,1048,545,503
50,Zaragoza,60,Bulbuente,241,122,119
50,Zaragoza,61,Bureta,272,142,130
50,Zaragoza,62,"Burgo de Ebro, El",2341,1223,1118
50,Zaragoza,63,"Buste, El",83,43,40
50,Zaragoza,64,Cabañas de Ebro,550,298,252
50,Zaragoza,65,Cabolafuente,46,24,22
50,Zaragoza,66,Cadrete,3177,1662,1515
50,Zaragoza,67,Calatayud,20837,10278,10559
50,Zaragoza,68,Calatorao,3054,1613,1441
50,Zaragoza,69,Calcena,70,40,30
50,Zaragoza,70,Calmarza,105,53,52
50,Zaragoza,71,Campillo de Aragón,151,84,67
50,Zaragoza,72,Carenas,195,105,90
50,Zaragoza,73,Cariñena,3728,1949,1779
50,Zaragoza,74,Caspe,9871,5150,4721
50,Zaragoza,75,Castejón de Alarba,97,55,42
50,Zaragoza,76,Castejón de las Armas,121,67,54
50,Zaragoza,77,Castejón de Valdejasa,274,140,134
50,Zaragoza,78,Castiliscar,328,164,164
50,Zaragoza,79,Cervera de la Cañada,313,167,146
50,Zaragoza,80,Cerveruela,46,29,17
50,Zaragoza,81,Cetina,687,343,344
50,Zaragoza,82,Cimballa,127,63,64
50,Zaragoza,83,Cinco Olivas,125,60,65
50,Zaragoza,84,Clarés de Ribota,97,55,42
50,Zaragoza,85,Codo,213,109,104
50,Zaragoza,86,Codos,251,157,94
50,Zaragoza,87,Contamina,39,23,16
50,Zaragoza,88,Cosuenda,413,208,205
50,Zaragoza,89,Cuarte de Huerva,9564,4998,4566
50,Zaragoza,90,Cubel,194,98,96
50,Zaragoza,91,"Cuerlas, Las",62,31,31
50,Zaragoza,92,Chiprana,465,236,229
50,Zaragoza,93,Chodes,147,81,66
50,Zaragoza,94,Daroca,2313,1138,1175
50,Zaragoza,95,Ejea de los Caballeros,17306,8930,8376
50,Zaragoza,96,Embid de Ariza,53,26,27
50,Zaragoza,98,Encinacorba,253,129,124
50,Zaragoza,99,Épila,4720,2531,2189
50,Zaragoza,100,Erla,406,206,200
50,Zaragoza,101,Escatrón,1121,555,566
50,Zaragoza,102,Fabara,1263,687,576
50,Zaragoza,104,Farlete,435,207,228
50,Zaragoza,105,Fayón,406,207,199
50,Zaragoza,106,"Fayos, Los",153,79,74
50,Zaragoza,107,Figueruelas,1303,669,634
50,Zaragoza,108,Fombuena,50,28,22
50,Zaragoza,109,"Frago, El",107,64,43
50,Zaragoza,110,"Frasno, El",477,250,227
50,Zaragoza,111,Fréscano,217,116,101
50,Zaragoza,113,Fuendejalón,979,529,450
50,Zaragoza,114,Fuendetodos,180,99,81
50,Zaragoza,115,Fuentes de Ebro,4603,2411,2192
50,Zaragoza,116,Fuentes de Jiloca,279,153,126
50,Zaragoza,117,Gallocanta,156,86,70
50,Zaragoza,118,Gallur,2931,1485,1446
50,Zaragoza,119,Gelsa,1174,612,562
50,Zaragoza,120,Godojos,44,23,21
50,Zaragoza,121,Gotor,384,202,182
50,Zaragoza,122,Grisel,71,45,26
50,Zaragoza,123,Grisén,563,295,268
50,Zaragoza,124,Herrera de los Navarros,604,314,290
50,Zaragoza,125,Ibdes,482,249,233
50,Zaragoza,126,Illueca,3282,1640,1642
50,Zaragoza,128,Isuerre,36,24,12
50,Zaragoza,129,Jaraba,363,190,173
50,Zaragoza,130,Jarque,543,295,248
50,Zaragoza,131,Jaulín,302,164,138
50,Zaragoza,132,"Joyosa, La",941,477,464
50,Zaragoza,133,Lagata,145,81,64
50,Zaragoza,134,Langa del Castillo,145,72,73
50,Zaragoza,135,Layana,123,68,55
50,Zaragoza,136,Lécera,759,404,355
50,Zaragoza,137,Leciñena,1339,665,674
50,Zaragoza,138,Lechón,48,27,21
50,Zaragoza,139,Letux,428,233,195
50,Zaragoza,140,Litago,185,102,83
50,Zaragoza,141,Lituénigo,126,66,60
50,Zaragoza,142,Lobera de Onsella,54,33,21
50,Zaragoza,143,Longares,907,506,401
50,Zaragoza,144,Longás,32,22,10
50,Zaragoza,146,Lucena de Jalón,307,172,135
50,Zaragoza,147,Luceni,1088,535,553
50,Zaragoza,148,Luesia,401,217,184
50,Zaragoza,149,Luesma,51,30,21
50,Zaragoza,150,Lumpiaque,939,496,443
50,Zaragoza,151,Luna,839,440,399
50,Zaragoza,152,Maella,2018,1039,979
50,Zaragoza,153,Magallón,1221,638,583
50,Zaragoza,154,Mainar,164,84,80
50,Zaragoza,155,Malanquilla,130,75,55
50,Zaragoza,156,Maleján,338,171,167
50,Zaragoza,157,Malón,375,194,181
50,Zaragoza,159,Maluenda,1106,544,562
50,Zaragoza,160,Mallén,3709,1973,1736
50,Zaragoza,161,Manchones,141,82,59
50,Zaragoza,162,Mara,202,100,102
50,Zaragoza,163,María de Huerva,5048,2627,2421
50,Zaragoza,164,Mediana de Aragón,470,238,232
50,Zaragoza,165,Mequinenza,2478,1267,1211
50,Zaragoza,166,Mesones de Isuela,316,157,159
50,Zaragoza,167,Mezalocha,222,127,95
50,Zaragoza,168,Mianos,41,21,20
50,Zaragoza,169,Miedes de Aragón,462,246,216
50,Zaragoza,170,Monegrillo,472,264,208
50,Zaragoza,171,Moneva,129,72,57
50,Zaragoza,172,Monreal de Ariza,186,105,81
50,Zaragoza,173,Monterde,190,112,78
50,Zaragoza,174,Montón,136,81,55
50,Zaragoza,175,Morata de Jalón,1314,645,669
50,Zaragoza,176,Morata de Jiloca,286,163,123
50,Zaragoza,177,Morés,422,222,200
50,Zaragoza,178,Moros,449,232,217
50,Zaragoza,179,Moyuela,258,138,120
50,Zaragoza,180,Mozota,113,55,58
50,Zaragoza,181,Muel,1434,729,705
50,Zaragoza,182,"Muela, La",5213,2698,2515
50,Zaragoza,183,Munébrega,467,241,226
50,Zaragoza,184,Murero,148,87,61
50,Zaragoza,185,Murillo de Gállego,194,109,85
50,Zaragoza,186,Navardún,48,30,18
50,Zaragoza,187,Nigüella,79,45,34
50,Zaragoza,188,Nombrevilla,38,21,17
50,Zaragoza,189,Nonaspe,1054,560,494
50,Zaragoza,190,Novallas,949,507,442
50,Zaragoza,191,Novillas,603,305,298
50,Zaragoza,192,Nuévalos,355,200,155
50,Zaragoza,193,Nuez de Ebro,837,433,404
50,Zaragoza,194,Olvés,119,68,51
50,Zaragoza,195,Orcajo,43,22,21
50,Zaragoza,196,Orera,136,71,65
50,Zaragoza,197,Orés,107,62,45
50,Zaragoza,198,Oseja,54,30,24
50,Zaragoza,199,Osera de Ebro,462,231,231
50,Zaragoza,200,Paniza,766,403,363
50,Zaragoza,201,Paracuellos de Jiloca,590,306,284
50,Zaragoza,202,Paracuellos de la Ribera,187,89,98
50,Zaragoza,203,Pastriz,1351,650,701
50,Zaragoza,204,Pedrola,3769,1989,1780
50,Zaragoza,205,"Pedrosas, Las",117,61,56
50,Zaragoza,206,Perdiguera,651,338,313
50,Zaragoza,207,Piedratajada,147,75,72
50,Zaragoza,208,Pina de Ebro,2626,1353,1273
50,Zaragoza,209,Pinseque,3579,1857,1722
50,Zaragoza,210,"Pintanos, Los",45,27,18
50,Zaragoza,211,Plasencia de Jalón,389,219,170
50,Zaragoza,212,Pleitas,53,27,26
50,Zaragoza,213,Plenas,135,66,69
50,Zaragoza,214,Pomer,36,24,12
50,Zaragoza,215,Pozuel de Ariza,21,12,9
50,Zaragoza,216,Pozuelo de Aragón,340,185,155
50,Zaragoza,217,Pradilla de Ebro,619,324,295
50,Zaragoza,218,Puebla de Albortón,120,73,47
50,Zaragoza,219,"Puebla de Alfindén, La",5433,2846,2587
50,Zaragoza,220,Puendeluna,62,34,28
50,Zaragoza,221,Purujosa,43,29,14
50,Zaragoza,222,Quinto,2105,1084,1021
50,Zaragoza,223,Remolinos,1183,601,582
50,Zaragoza,224,Retascón,76,44,32
50,Zaragoza,225,Ricla,3065,1647,1418
50,Zaragoza,227,Romanos,123,72,51
50,Zaragoza,228,Rueda de Jalón,350,189,161
50,Zaragoza,229,Ruesca,80,41,39
50,Zaragoza,230,Sádaba,1643,841,802
50,Zaragoza,231,Salillas de Jalón,383,189,194
50,Zaragoza,232,Salvatierra de Esca,226,109,117
50,Zaragoza,233,Samper del Salz,119,63,56
50,Zaragoza,234,San Martín de la Virgen de Moncayo,285,161,124
50,Zaragoza,235,San Mateo de Gállego,3137,1626,1511
50,Zaragoza,236,Santa Cruz de Grío,161,87,74
50,Zaragoza,237,Santa Cruz de Moncayo,130,64,66
50,Zaragoza,238,Santa Eulalia de Gállego,130,70,60
50,Zaragoza,239,Santed,67,38,29
50,Zaragoza,240,Sástago,1294,659,635
50,Zaragoza,241,Sabiñán,747,379,368
50,Zaragoza,242,Sediles,115,64,51
50,Zaragoza,243,Sestrica,401,228,173
50,Zaragoza,244,Sierra de Luna,310,169,141
50,Zaragoza,245,Sigüés,131,70,61
50,Zaragoza,246,Sisamón,43,28,15
50,Zaragoza,247,Sobradiel,979,474,505
50,Zaragoza,248,Sos del Rey Católico,666,341,325
50,Zaragoza,249,Tabuenca,394,218,176
50,Zaragoza,250,Talamantes,57,26,31
50,Zaragoza,251,Tarazona,11121,5490,5631
50,Zaragoza,252,Tauste,7484,3747,3737
50,Zaragoza,253,Terrer,500,254,246
50,Zaragoza,254,Tierga,202,112,90
50,Zaragoza,255,Tobed,250,118,132
50,Zaragoza,256,Torralba de los Frailes,94,52,42
50,Zaragoza,257,Torralba de Ribota,202,112,90
50,Zaragoza,258,Torralbilla,58,32,26
50,Zaragoza,259,Torrehermosa,81,43,38
50,Zaragoza,260,Torrelapaja,43,24,19
50,Zaragoza,261,Torrellas,296,157,139
50,Zaragoza,262,Torres de Berrellén,1511,790,721
50,Zaragoza,263,Torrijo de la Cañada,279,154,125
50,Zaragoza,264,Tosos,242,129,113
50,Zaragoza,265,Trasmoz,76,40,36
50,Zaragoza,266,Trasobares,146,89,57
50,Zaragoza,267,Uncastillo,754,358,396
50,Zaragoza,268,Undués de Lerda,74,40,34
50,Zaragoza,269,Urrea de Jalón,403,200,203
50,Zaragoza,270,Urriés,36,23,13
50,Zaragoza,271,Used,321,180,141
50,Zaragoza,272,Utebo,18204,9176,9028
50,Zaragoza,273,Valdehorna,36,19,17
50,Zaragoza,274,Val de San Martín,80,45,35
50,Zaragoza,275,Valmadrid,106,69,37
50,Zaragoza,276,Valpalmas,164,78,86
50,Zaragoza,277,Valtorres,95,45,50
50,Zaragoza,278,Velilla de Ebro,245,130,115
50,Zaragoza,279,Velilla de Jiloca,99,53,46
50,Zaragoza,280,Vera de Moncayo,405,211,194
50,Zaragoza,281,Vierlas,97,48,49
50,Zaragoza,282,"Vilueña, La",119,61,58
50,Zaragoza,283,Villadoz,84,49,35
50,Zaragoza,284,Villafeliche,225,117,108
50,Zaragoza,285,Villafranca de Ebro,837,416,421
50,Zaragoza,286,Villalba de Perejil,113,60,53
50,Zaragoza,287,Villalengua,390,203,187
50,Zaragoza,288,Villanueva de Gállego,4526,2299,2227
50,Zaragoza,289,Villanueva de Jiloca,78,37,41
50,Zaragoza,290,Villanueva de Huerva,560,294,266
50,Zaragoza,291,Villar de los Navarros,120,64,56
50,Zaragoza,292,Villarreal de Huerva,230,125,105
50,Zaragoza,293,Villarroya de la Sierra,575,298,277
50,Zaragoza,294,Villarroya del Campo,81,45,36
50,Zaragoza,295,Vistabella,50,34,16
50,Zaragoza,296,"Zaida, La",514,252,262
50,Zaragoza,297,Zaragoza,674725,327075,347650
50,Zaragoza,298,Zuera,7604,3920,3684
50,Zaragoza,901,Biel,166,97,69
50,Zaragoza,902,Marracos,110,59,51
50,Zaragoza,903,Villamayor de Gállego,2885,1443,1442
51,Ceuta,1,Ceuta,82376,42165,40211
52,Melilla,1,Melilla,78476,40256,38220
