CPRO,PROVINCIA,CMUN,NOMBRE,POB22,HOMBRES,MUJERES
2,Albacete,1,Abengibre,739,363,376
2,Albacete,2,Alatoz,496,276,220
2,Albacete,3,Albacete,172357,84230,88127
2,Albacete,4,Albatana,670,342,328
2,Albacete,5,Alborea,663,338,325
2,Albacete,6,Alcadozo,634,343,291
2,Albacete,7,Alcalá del Júcar,1148,622,526
2,Albacete,8,Alcaraz,1307,681,626
2,Albacete,9,Almansa,24224,12024,12200
2,Albacete,10,Alpera,2245,1171,1074
2,Albacete,11,Ayna,582,319,263
2,Albacete,12,Balazote,2388,1227,1161
2,Albacete,14,"Ballestero, El",427,222,205
2,Albacete,13,Balsa de Ves,126,74,52
2,Albacete,15,Barrax,1831,943,888
2,Albacete,16,Bienservida,574,312,262
2,Albacete,17,Bogarra,756,393,363
2,Albacete,18,Bonete,1006,532,474
2,Albacete,19,"Bonillo, El",2698,1368,1330
2,Albacete,20,Carcelén,483,253,230
2,Albacete,21,Casas de Juan Núñez,1356,731,625
2,Albacete,22,Casas de Lázaro,321,177,144
2,Albacete,23,Casas de Ves,561,296,265
2,Albacete,24,Casas-Ibáñez,4547,2291,2256
2,Albacete,25,Caudete,10135,5167,4968
2,Albacete,26,Cenizate,1183,592,591
2,Albacete,29,Chinchilla de Monte-Aragón,4497,2341,2156
2,Albacete,27,Corral-Rubio,300,160,140
2,Albacete,28,Cotillas,129,72,57
2,Albacete,30,Elche de la Sierra,3553,1743,1810
2,Albacete,31,Férez,614,310,304
2,Albacete,32,Fuensanta,281,154,127
2,Albacete,33,Fuente-Álamo,2461,1286,1175
2,Albacete,34,Fuentealbilla,1821,938,883
2,Albacete,35,"Gineta, La",2568,1338,1230
2,Albacete,36,Golosalvo,98,52,46
2,Albacete,37,Hellín,30492,15323,15169
2,Albacete,38,"Herrera, La",304,162,142
2,Albacete,39,Higueruela,1125,585,540
2,Albacete,40,Hoya-Gonzalo,561,304,257
2,Albacete,41,Jorquera,350,194,156
2,Albacete,42,Letur,901,445,456
2,Albacete,43,Lezuza,1300,675,625
2,Albacete,44,Liétor,1096,568,528
2,Albacete,45,Madrigueras,4644,2379,2265
2,Albacete,46,Mahora,1430,737,693
2,Albacete,47,Masegoso,114,66,48
2,Albacete,48,Minaya,1442,738,704
2,Albacete,49,Molinicos,837,430,407
2,Albacete,50,Montalvos,88,51,37
2,Albacete,51,Montealegre del Castillo,2056,1066,990
2,Albacete,52,Motilleja,660,360,300
2,Albacete,53,Munera,3422,1751,1671
2,Albacete,54,Navas de Jorquera,528,279,249
2,Albacete,55,Nerpio,1180,658,522
2,Albacete,56,Ontur,1934,975,959
2,Albacete,57,Ossa de Montiel,2215,1123,1092
2,Albacete,58,Paterna del Madera,329,186,143
2,Albacete,60,Peñas de San Pedro,1433,842,591
2,Albacete,59,Peñascosa,323,184,139
2,Albacete,61,Pétrola,663,349,314
2,Albacete,62,Povedilla,388,217,171
2,Albacete,901,Pozo Cañada,2763,1400,1363
2,Albacete,63,Pozohondo,1569,821,748
2,Albacete,64,Pozo-Lorente,391,206,185
2,Albacete,65,Pozuelo,461,249,212
2,Albacete,66,"Recueja, La",221,124,97
2,Albacete,67,Riópar,1318,677,641
2,Albacete,68,Robledo,385,209,176
2,Albacete,69,"Roda, La",15497,7820,7677
2,Albacete,70,Salobre,438,226,212
2,Albacete,71,San Pedro,1142,590,552
2,Albacete,72,Socovos,1743,904,839
2,Albacete,73,Tarazona de la Mancha,6183,3188,2995
2,Albacete,74,Tobarra,7758,4010,3748
2,Albacete,75,Valdeganga,1919,977,942
2,Albacete,76,Vianos,313,162,151
2,Albacete,77,Villa de Ves,60,34,26
2,Albacete,78,Villalgordo del Júcar,1072,567,505
2,Albacete,79,Villamalea,4000,2047,1953
2,Albacete,80,Villapalacios,555,288,267
2,Albacete,81,Villarrobledo,24886,12299,12587
2,Albacete,82,Villatoya,106,60,46
2,Albacete,83,Villavaliente,202,124,78
2,Albacete,84,Villaverde de Guadalimar,321,180,141
2,Albacete,85,Viveros,335,174,161
2,Albacete,86,Yeste,2495,1299,1196
3,Alicante/Alacant,2,Agost,4948,2502,2446
3,Alicante/Alacant,3,Agres,589,325,264
3,Alicante/Alacant,4,Aigües,1085,549,536
3,Alicante/Alacant,5,Albatera,12864,6519,6345
3,Alicante/Alacant,6,Alcalalí,1349,672,677
3,Alicante/Alacant,8,Alcoleja,196,105,91
3,Alicante/Alacant,7,Alcosser,254,125,129
3,Alicante/Alacant,9,Alcoy/Alcoi,58960,28912,30048
3,Alicante/Alacant,10,Alfafara,417,199,218
3,Alicante/Alacant,11,"Alfàs del Pi, l'",20668,10226,10442
3,Alicante/Alacant,12,Algorfa,3513,1777,1736
3,Alicante/Alacant,13,Algueña,1351,681,670
3,Alicante/Alacant,14,Alicante/Alacant,338577,163548,175029
3,Alicante/Alacant,15,Almoradí,21401,10737,10664
3,Alicante/Alacant,16,Almudaina,112,55,57
3,Alicante/Alacant,17,"Alqueria d'Asnar, l'",489,246,243
3,Alicante/Alacant,18,Altea,23010,11305,11705
3,Alicante/Alacant,19,Aspe,21191,10671,10520
3,Alicante/Alacant,1,"Atzúbia, l'",616,319,297
3,Alicante/Alacant,20,Balones,126,66,60
3,Alicante/Alacant,21,Banyeres de Mariola,7201,3633,3568
3,Alicante/Alacant,22,Benasau,171,82,89
3,Alicante/Alacant,23,Beneixama,1705,852,853
3,Alicante/Alacant,24,Benejúzar,5480,2754,2726
3,Alicante/Alacant,25,Benferri,1955,1016,939
3,Alicante/Alacant,26,Beniarbeig,2267,1156,1111
3,Alicante/Alacant,27,Beniardá,218,106,112
3,Alicante/Alacant,28,Beniarrés,1078,555,523
3,Alicante/Alacant,30,Benidoleig,1232,606,626
3,Alicante/Alacant,31,Benidorm,69738,34629,35109
3,Alicante/Alacant,32,Benifallim,106,56,50
3,Alicante/Alacant,33,Benifato,139,74,65
3,Alicante/Alacant,29,Benigembla,512,255,257
3,Alicante/Alacant,34,Benijófar,3427,1667,1760
3,Alicante/Alacant,35,Benilloba,740,387,353
3,Alicante/Alacant,36,Benillup,108,58,50
3,Alicante/Alacant,37,Benimantell,499,251,248
3,Alicante/Alacant,38,Benimarfull,410,213,197
3,Alicante/Alacant,39,Benimassot,93,51,42
3,Alicante/Alacant,40,Benimeli,419,194,225
3,Alicante/Alacant,41,Benissa,11871,5846,6025
3,Alicante/Alacant,42,"Benitachell/Poble Nou de Benitatxell, el",4687,2283,2404
3,Alicante/Alacant,43,Biar,3612,1770,1842
3,Alicante/Alacant,44,Bigastro,7130,3591,3539
3,Alicante/Alacant,45,Bolulla,413,214,199
3,Alicante/Alacant,46,Busot,3343,1686,1657
3,Alicante/Alacant,49,Callosa de Segura,19315,9832,9483
3,Alicante/Alacant,48,Callosa d'en Sarrià,7653,3953,3700
3,Alicante/Alacant,47,Calp,24096,12058,12038
3,Alicante/Alacant,50,"Campello, el",29409,14314,15095
3,Alicante/Alacant,51,"Campo de Mirra/Camp de Mirra, el",433,223,210
3,Alicante/Alacant,52,Cañada,1191,594,597
3,Alicante/Alacant,53,Castalla,11097,5646,5451
3,Alicante/Alacant,54,Castell de Castells,426,225,201
3,Alicante/Alacant,75,"Castell de Guadalest, el",258,129,129
3,Alicante/Alacant,55,Catral,8976,4509,4467
3,Alicante/Alacant,56,Cocentaina,11298,5683,5615
3,Alicante/Alacant,57,Confrides,282,154,128
3,Alicante/Alacant,58,Cox,7431,3766,3665
3,Alicante/Alacant,59,Crevillent,29881,15120,14761
3,Alicante/Alacant,61,Daya Nueva,1758,860,898
3,Alicante/Alacant,62,Daya Vieja,683,338,345
3,Alicante/Alacant,63,Dénia,43899,21350,22549
3,Alicante/Alacant,64,Dolores,7799,3893,3906
3,Alicante/Alacant,65,Elche/Elx,235580,116931,118649
3,Alicante/Alacant,66,Elda,52297,25483,26814
3,Alicante/Alacant,67,Fageca,104,53,51
3,Alicante/Alacant,68,Famorca,48,26,22
3,Alicante/Alacant,69,Finestrat,7909,4059,3850
3,Alicante/Alacant,77,"Fondó de les Neus, el/Hondón de las Nieves",2684,1388,1296
3,Alicante/Alacant,70,Formentera del Segura,4446,2268,2178
3,Alicante/Alacant,72,Gaianes,548,277,271
3,Alicante/Alacant,71,Gata de Gorgos,6364,3235,3129
3,Alicante/Alacant,73,Gorga,270,144,126
3,Alicante/Alacant,74,Granja de Rocamora,2626,1355,1271
3,Alicante/Alacant,76,Guardamar del Segura,16138,7852,8286
3,Alicante/Alacant,78,Hondón de los Frailes,1261,639,622
3,Alicante/Alacant,79,Ibi,23677,11872,11805
3,Alicante/Alacant,80,Jacarilla,2039,1035,1004
3,Alicante/Alacant,82,Jávea/Xàbia,28731,14346,14385
3,Alicante/Alacant,83,Jijona/Xixona,6860,3317,3543
3,Alicante/Alacant,85,Llíber,967,481,486
3,Alicante/Alacant,84,"Lorcha/Orxa, l'",565,283,282
3,Alicante/Alacant,86,Millena,243,131,112
3,Alicante/Alacant,88,Monforte del Cid,8619,4502,4117
3,Alicante/Alacant,89,Monóvar/Monòver,12387,6167,6220
3,Alicante/Alacant,903,"Montesinos, Los",5217,2657,2560
3,Alicante/Alacant,91,Murla,540,254,286
3,Alicante/Alacant,92,Muro de Alcoy,9303,4646,4657
3,Alicante/Alacant,90,Mutxamel,26192,13088,13104
3,Alicante/Alacant,93,Novelda,25592,12691,12901
3,Alicante/Alacant,94,"Nucia, la",18624,9442,9182
3,Alicante/Alacant,95,Ondara,7085,3563,3522
3,Alicante/Alacant,96,Onil,7580,3796,3784
3,Alicante/Alacant,97,Orba,2348,1156,1192
3,Alicante/Alacant,99,Orihuela,80784,40021,40763
3,Alicante/Alacant,98,Orxeta,812,414,398
3,Alicante/Alacant,100,Parcent,997,496,501
3,Alicante/Alacant,101,Pedreguer,8280,4129,4151
3,Alicante/Alacant,102,Pego,10295,5113,5182
3,Alicante/Alacant,103,Penàguila,287,148,139
3,Alicante/Alacant,104,Petrer,33978,16816,17162
3,Alicante/Alacant,902,Pilar de la Horadada,22949,11753,11196
3,Alicante/Alacant,105,"Pinós, el/Pinoso",8084,4097,3987
3,Alicante/Alacant,106,Planes,695,375,320
3,Alicante/Alacant,901,"Poblets, els",2735,1288,1447
3,Alicante/Alacant,107,Polop,5186,2636,2550
3,Alicante/Alacant,60,Quatretondeta,133,73,60
3,Alicante/Alacant,109,Rafal,4634,2299,2335
3,Alicante/Alacant,110,"Ràfol d'Almúnia, el",731,371,360
3,Alicante/Alacant,111,Redován,8123,4219,3904
3,Alicante/Alacant,112,Relleu,1171,613,558
3,Alicante/Alacant,113,Rojales,16943,8564,8379
3,Alicante/Alacant,114,"Romana, la",2605,1370,1235
3,Alicante/Alacant,115,Sagra,435,208,227
3,Alicante/Alacant,116,Salinas,1678,861,817
3,Alicante/Alacant,118,San Fulgencio,9091,4573,4518
3,Alicante/Alacant,904,San Isidro,2154,1111,1043
3,Alicante/Alacant,120,San Miguel de Salinas,6659,3343,3316
3,Alicante/Alacant,122,San Vicente del Raspeig/Sant Vicent del Raspeig,59138,29262,29876
3,Alicante/Alacant,117,Sanet y Negrals,734,364,370
3,Alicante/Alacant,119,Sant Joan d'Alacant,24450,11789,12661
3,Alicante/Alacant,121,Santa Pola,36174,18186,17988
3,Alicante/Alacant,123,Sax,9988,5011,4977
3,Alicante/Alacant,124,Sella,592,307,285
3,Alicante/Alacant,125,Senija,623,321,302
3,Alicante/Alacant,127,Tàrbena,624,328,296
3,Alicante/Alacant,128,Teulada,11944,5929,6015
3,Alicante/Alacant,129,Tibi,1731,906,825
3,Alicante/Alacant,130,Tollos,30,20,10
3,Alicante/Alacant,131,Tormos,332,161,171
3,Alicante/Alacant,132,"Torremanzanas/Torre de les Maçanes, la",683,365,318
3,Alicante/Alacant,133,Torrevieja,83547,41023,42524
3,Alicante/Alacant,134,"Vall d'Alcalà, la",164,90,74
3,Alicante/Alacant,136,"Vall de Gallinera, la",579,304,275
3,Alicante/Alacant,137,"Vall de Laguar, la",890,444,446
3,Alicante/Alacant,135,"Vall d'Ebo, la",219,113,106
3,Alicante/Alacant,138,"Verger, el",4986,2470,2516
3,Alicante/Alacant,139,"Villajoyosa/Vila Joiosa, la",34828,17259,17569
3,Alicante/Alacant,140,Villena,33969,17041,16928
3,Alicante/Alacant,81,Xaló,2931,1469,1462
4,Almería,1,Abla,1247,642,605
4,Almería,2,Abrucena,1221,643,578
4,Almería,3,Adra,25300,12962,12338
4,Almería,4,Albanchez,735,387,348
4,Almería,5,Alboloduy,615,299,316
4,Almería,6,Albox,12087,6172,5915
4,Almería,7,Alcolea,831,431,400
4,Almería,8,Alcóntar,538,297,241
4,Almería,9,Alcudia de Monteagud,133,69,64
4,Almería,10,Alhabia,685,361,324
4,Almería,11,Alhama de Almería,3757,1887,1870
4,Almería,12,Alicún,214,105,109
4,Almería,13,Almería,199237,97026,102211
4,Almería,14,Almócita,201,109,92
4,Almería,15,Alsodux,129,73,56
4,Almería,16,Antas,3339,1730,1609
4,Almería,17,Arboleas,4532,2267,2265
4,Almería,18,Armuña de Almanzora,313,155,158
4,Almería,19,Bacares,240,127,113
4,Almería,904,Balanegra,2886,1508,1378
4,Almería,20,Bayárcal,312,166,146
4,Almería,21,Bayarque,226,108,118
4,Almería,22,Bédar,1009,516,493
4,Almería,23,Beires,138,72,66
4,Almería,24,Benahadux,4605,2288,2317
4,Almería,26,Benitagla,53,30,23
4,Almería,27,Benizalón,253,143,110
4,Almería,28,Bentarique,239,133,106
4,Almería,29,Berja,12807,6588,6219
4,Almería,30,Canjáyar,1163,611,552
4,Almería,31,Cantoria,3533,1785,1748
4,Almería,32,Carboneras,8210,4228,3982
4,Almería,33,Castro de Filabres,115,63,52
4,Almería,36,Chercos,301,154,147
4,Almería,37,Chirivel,1511,785,726
4,Almería,34,Cóbdar,160,86,74
4,Almería,35,Cuevas del Almanzora,14790,7666,7124
4,Almería,38,Dalías,4141,2047,2094
4,Almería,902,"Ejido, El",87500,45452,42048
4,Almería,41,Enix,554,306,248
4,Almería,43,Felix,697,402,295
4,Almería,44,Fines,2161,1135,1026
4,Almería,45,Fiñana,1978,1004,974
4,Almería,46,Fondón,1045,540,505
4,Almería,47,Gádor,3018,1574,1444
4,Almería,48,"Gallardos, Los",2991,1495,1496
4,Almería,49,Garrucha,10027,5331,4696
4,Almería,50,Gérgal,1115,609,506
4,Almería,51,Huécija,503,249,254
4,Almería,52,Huércal de Almería,18384,9341,9043
4,Almería,53,Huércal-Overa,20093,9997,10096
4,Almería,54,Íllar,456,243,213
4,Almería,55,Instinción,467,245,222
4,Almería,56,Laroya,200,113,87
4,Almería,57,Láujar de Andarax,1587,795,792
4,Almería,58,Líjar,383,202,181
4,Almería,59,Lubrín,1457,742,715
4,Almería,60,Lucainena de las Torres,595,307,288
4,Almería,61,Lúcar,803,398,405
4,Almería,62,Macael,5393,2758,2635
4,Almería,63,María,1228,625,603
4,Almería,64,Mojácar,7527,3680,3847
4,Almería,903,"Mojonera, La",8824,4897,3927
4,Almería,65,Nacimiento,512,270,242
4,Almería,66,Níjar,31816,17820,13996
4,Almería,67,Ohanes,551,287,264
4,Almería,68,Olula de Castro,192,106,86
4,Almería,69,Olula del Río,6259,3183,3076
4,Almería,70,Oria,2212,1154,1058
4,Almería,71,Padules,424,224,200
4,Almería,72,Partaloa,1003,498,505
4,Almería,73,Paterna del Río,395,223,172
4,Almería,74,Pechina,4224,2175,2049
4,Almería,75,Pulpí,10493,5420,5073
4,Almería,76,Purchena,1550,802,748
4,Almería,77,Rágol,288,145,143
4,Almería,78,Rioja,1510,775,735
4,Almería,79,Roquetas de Mar,102881,53233,49648
4,Almería,80,Santa Cruz de Marchena,219,115,104
4,Almería,81,Santa Fe de Mondújar,476,253,223
4,Almería,82,Senés,285,159,126
4,Almería,83,Serón,2062,1060,1002
4,Almería,84,Sierro,384,203,181
4,Almería,85,Somontín,445,218,227
4,Almería,86,Sorbas,2505,1302,1203
4,Almería,87,Suflí,203,111,92
4,Almería,88,Tabernas,4025,2120,1905
4,Almería,89,Taberno,949,468,481
4,Almería,90,Tahal,346,184,162
4,Almería,91,Terque,386,202,184
4,Almería,92,Tíjola,3520,1762,1758
4,Almería,901,"Tres Villas, Las",573,319,254
4,Almería,93,Turre,4067,2110,1957
4,Almería,94,Turrillas,270,150,120
4,Almería,95,Uleila del Campo,812,406,406
4,Almería,96,Urrácal,371,195,176
4,Almería,97,Velefique,248,137,111
4,Almería,98,Vélez-Blanco,1925,987,938
4,Almería,99,Vélez-Rubio,6528,3172,3356
4,Almería,100,Vera,18224,9299,8925
4,Almería,101,Viator,6066,3106,2960
4,Almería,102,Vícar,27631,15065,12566
4,Almería,103,Zurgena,2912,1478,1434
1,Araba/Álava,51,Agurain/Salvatierra,5069,2545,2524
1,Araba/Álava,1,Alegría-Dulantzi,2960,1530,1430
1,Araba/Álava,2,Amurrio,10281,5103,5178
1,Araba/Álava,49,Añana,156,97,59
1,Araba/Álava,3,Aramaio,1431,741,690
1,Araba/Álava,6,Armiñón,235,120,115
1,Araba/Álava,37,Arraia-Maeztu,804,445,359
1,Araba/Álava,8,Arratzua-Ubarrundia,1031,550,481
1,Araba/Álava,4,Artziniega,1810,889,921
1,Araba/Álava,9,Asparrena,1637,827,810
1,Araba/Álava,10,Ayala/Aiara,2921,1481,1440
1,Araba/Álava,11,Baños de Ebro/Mañueta,296,170,126
1,Araba/Álava,13,Barrundia,914,499,415
1,Araba/Álava,14,Berantevilla,452,240,212
1,Araba/Álava,16,Bernedo,560,320,240
1,Araba/Álava,17,Campezo/Kanpezu,1094,577,517
1,Araba/Álava,21,Elburgo/Burgelu,629,331,298
1,Araba/Álava,22,Elciego,971,486,485
1,Araba/Álava,23,Elvillar/Bilar,316,149,167
1,Araba/Álava,47,Erriberabeitia,1416,766,650
1,Araba/Álava,46,Erriberagoitia/Ribera Alta,820,481,339
1,Araba/Álava,56,Harana/Valle de Arana,226,126,100
1,Araba/Álava,901,Iruña Oka/Iruña de Oca,3551,1886,1665
1,Araba/Álava,27,Iruraiz-Gauna,537,296,241
1,Araba/Álava,19,Kripan,176,92,84
1,Araba/Álava,20,Kuartango,421,241,180
1,Araba/Álava,28,Labastida/Bastida,1538,787,751
1,Araba/Álava,30,Lagrán,175,100,75
1,Araba/Álava,31,Laguardia,1483,771,712
1,Araba/Álava,32,Lanciego/Lantziego,724,378,346
1,Araba/Álava,902,Lantarón,931,522,409
1,Araba/Álava,33,Lapuebla de Labarca,870,448,422
1,Araba/Álava,36,Laudio/Llodio,17906,8683,9223
1,Araba/Álava,58,Legutio,2017,1064,953
1,Araba/Álava,34,Leza,217,112,105
1,Araba/Álava,39,Moreda de Álava/Moreda Araba,216,112,104
1,Araba/Álava,41,Navaridas,200,113,87
1,Araba/Álava,42,Okondo,1187,626,561
1,Araba/Álava,43,Oyón-Oion,3408,1728,1680
1,Araba/Álava,44,Peñacerrada-Urizaharra,310,179,131
1,Araba/Álava,52,Samaniego,311,152,159
1,Araba/Álava,53,San Millán/Donemiliaga,718,392,326
1,Araba/Álava,54,Urkabustaiz,1408,733,675
1,Araba/Álava,55,Valdegovía/Gaubea,1097,588,509
1,Araba/Álava,57,Villabuena de Álava/Eskuernaga,291,153,138
1,Araba/Álava,59,Vitoria-Gasteiz,253672,123291,130381
1,Araba/Álava,60,Yécora/Iekora,247,126,121
1,Araba/Álava,61,Zalduondo,195,106,89
1,Araba/Álava,62,Zambrana,425,228,197
1,Araba/Álava,18,Zigoitia,1822,984,838
1,Araba/Álava,63,Zuia,2330,1221,1109
33,Asturias,1,Allande,1574,785,789
33,Asturias,2,Aller,10201,5040,5161
33,Asturias,3,Amieva,603,343,260
33,Asturias,4,Avilés,75877,35814,40063
33,Asturias,5,Belmonte de Miranda,1425,761,664
33,Asturias,6,Bimenes,1672,812,860
33,Asturias,7,Boal,1442,733,709
33,Asturias,8,Cabrales,1907,963,944
33,Asturias,9,Cabranes,1112,570,542
33,Asturias,10,Candamo,1943,951,992
33,Asturias,12,Cangas de Onís,6260,3029,3231
33,Asturias,11,Cangas del Narcea,11817,5768,6049
33,Asturias,13,Caravia,508,270,238
33,Asturias,14,Carreño,10226,4927,5299
33,Asturias,15,Caso,1443,822,621
33,Asturias,16,Castrillón,22235,10769,11466
33,Asturias,17,Castropol,3288,1615,1673
33,Asturias,18,Coaña,3285,1620,1665
33,Asturias,19,Colunga,3220,1593,1627
33,Asturias,20,Corvera de Asturias,15563,7605,7958
33,Asturias,21,Cudillero,4928,2428,2500
33,Asturias,22,Degaña,821,418,403
33,Asturias,23,"Franco, El",3736,1832,1904
33,Asturias,24,Gijón,267706,125827,141879
33,Asturias,25,Gozón,10433,5111,5322
33,Asturias,26,Grado,9598,4663,4935
33,Asturias,27,Grandas de Salime,774,396,378
33,Asturias,28,Ibias,1152,657,495
33,Asturias,29,Illano,305,153,152
33,Asturias,30,Illas,1062,535,527
33,Asturias,31,Langreo,38262,18208,20054
33,Asturias,32,Laviana,12584,6046,6538
33,Asturias,33,Lena,10499,5053,5446
33,Asturias,35,Llanera,13792,6809,6983
33,Asturias,36,Llanes,13545,6595,6950
33,Asturias,37,Mieres,36574,17390,19184
33,Asturias,38,Morcín,2560,1284,1276
33,Asturias,39,Muros de Nalón,1963,948,1015
33,Asturias,40,Nava,5236,2568,2668
33,Asturias,41,Navia,8263,3989,4274
33,Asturias,42,Noreña,5088,2433,2655
33,Asturias,43,Onís,735,401,334
33,Asturias,44,Oviedo,215167,99535,115632
33,Asturias,45,Parres,5233,2570,2663
33,Asturias,46,Peñamellera Alta,529,282,247
33,Asturias,47,Peñamellera Baja,1225,612,613
33,Asturias,48,Pesoz,138,76,62
33,Asturias,49,Piloña,6862,3349,3513
33,Asturias,50,Ponga,561,337,224
33,Asturias,51,Pravia,7905,3855,4050
33,Asturias,52,Proaza,715,420,295
33,Asturias,53,Quirós,1202,702,500
33,Asturias,54,"Regueras, Las",1888,955,933
33,Asturias,55,Ribadedeva,1724,842,882
33,Asturias,56,Ribadesella,5642,2672,2970
33,Asturias,57,Ribera de Arriba,1865,938,927
33,Asturias,58,Riosa,1805,914,891
33,Asturias,59,Salas,4828,2390,2438
33,Asturias,61,San Martín de Oscos,349,177,172
33,Asturias,60,San Martín del Rey Aurelio,15505,7432,8073
33,Asturias,63,San Tirso de Abres,408,197,211
33,Asturias,62,Santa Eulalia de Oscos,434,220,214
33,Asturias,64,Santo Adriano,272,129,143
33,Asturias,65,Sariego,1285,623,662
33,Asturias,66,Siero,51792,25331,26461
33,Asturias,67,Sobrescobio,829,444,385
33,Asturias,68,Somiedo,1100,647,453
33,Asturias,69,Soto del Barco,3851,1900,1951
33,Asturias,70,Tapia de Casariego,3671,1783,1888
33,Asturias,71,Taramundi,592,279,313
33,Asturias,72,Teverga,1579,869,710
33,Asturias,73,Tineo,9009,4562,4447
33,Asturias,34,Valdés,11099,5454,5645
33,Asturias,74,Vegadeo,3895,1880,2015
33,Asturias,75,Villanueva de Oscos,263,134,129
33,Asturias,76,Villaviciosa,14984,7437,7547
33,Asturias,77,Villayón,1130,583,547
33,Asturias,78,Yernes y Tameza,133,70,63
5,Ávila,1,Adanero,214,114,100
5,Ávila,2,"Adrada, La",2750,1412,1338
5,Ávila,5,Albornos,172,88,84
5,Ávila,7,Aldeanueva de Santa Cruz,104,54,50
5,Ávila,8,Aldeaseca,217,105,112
5,Ávila,10,"Aldehuela, La",148,76,72
5,Ávila,12,Amavida,133,75,58
5,Ávila,13,"Arenal, El",938,465,473
5,Ávila,14,Arenas de San Pedro,6465,3142,3323
5,Ávila,15,Arevalillo,68,33,35
5,Ávila,16,Arévalo,7884,3828,4056
5,Ávila,17,Aveinte,80,46,34
5,Ávila,18,Avellaneda,27,16,11
5,Ávila,19,Ávila,57730,27490,30240
5,Ávila,21,"Barco de Ávila, El",2249,1076,1173
5,Ávila,22,"Barraco, El",1956,1004,952
5,Ávila,23,Barromán,176,96,80
5,Ávila,24,Becedas,172,93,79
5,Ávila,25,Becedillas,78,41,37
5,Ávila,26,Bercial de Zapardiel,190,100,90
5,Ávila,27,"Berlanas, Las",338,178,160
5,Ávila,29,Bernuy-Zapardiel,90,50,40
5,Ávila,30,Berrocalejo de Aragona,53,30,23
5,Ávila,33,Blascomillán,173,90,83
5,Ávila,34,Blasconuño de Matacabras,14,9,5
5,Ávila,35,Blascosancho,99,50,49
5,Ávila,36,"Bohodón, El",111,60,51
5,Ávila,37,Bohoyo,230,129,101
5,Ávila,38,Bonilla de la Sierra,124,75,49
5,Ávila,39,Brabos,41,26,15
5,Ávila,40,Bularros,59,39,20
5,Ávila,41,Burgohondo,1196,627,569
5,Ávila,42,Cabezas de Alambre,157,74,83
5,Ávila,43,Cabezas del Pozo,79,39,40
5,Ávila,44,Cabezas del Villar,244,135,109
5,Ávila,45,Cabizuela,85,43,42
5,Ávila,46,Canales,37,22,15
5,Ávila,47,Candeleda,5044,2544,2500
5,Ávila,48,Cantiveros,97,58,39
5,Ávila,49,Cardeñosa,425,230,195
5,Ávila,51,"Carrera, La",157,89,68
5,Ávila,52,Casas del Puerto,80,44,36
5,Ávila,53,Casasola,67,38,29
5,Ávila,54,Casavieja,1418,735,683
5,Ávila,55,Casillas,649,348,301
5,Ávila,56,Castellanos de Zapardiel,90,51,39
5,Ávila,57,Cebreros,3213,1670,1543
5,Ávila,58,Cepeda la Mora,74,41,33
5,Ávila,67,Chamartín,63,36,27
5,Ávila,59,Cillán,75,46,29
5,Ávila,60,Cisla,102,55,47
5,Ávila,61,"Colilla, La",358,188,170
5,Ávila,62,Collado de Contreras,148,76,72
5,Ávila,63,Collado del Mirón,27,16,11
5,Ávila,64,Constanzana,101,59,42
5,Ávila,65,Crespos,481,254,227
5,Ávila,66,Cuevas del Valle,523,284,239
5,Ávila,903,Diego del Carpio,116,68,48
5,Ávila,69,Donjimeno,69,38,31
5,Ávila,70,Donvidas,30,19,11
5,Ávila,72,Espinosa de los Caballeros,104,53,51
5,Ávila,73,Flores de Ávila,279,150,129
5,Ávila,74,Fontiveros,719,374,345
5,Ávila,75,Fresnedilla,106,54,52
5,Ávila,76,"Fresno, El",593,310,283
5,Ávila,77,Fuente el Saúz,160,88,72
5,Ávila,78,Fuentes de Año,92,53,39
5,Ávila,79,Gallegos de Altamiros,58,35,23
5,Ávila,80,Gallegos de Sobrinos,47,23,24
5,Ávila,81,Garganta del Villar,41,27,14
5,Ávila,82,Gavilanes,573,315,258
5,Ávila,83,Gemuño,154,80,74
5,Ávila,85,Gil García,41,20,21
5,Ávila,84,Gilbuena,58,36,22
5,Ávila,86,Gimialcón,72,45,27
5,Ávila,87,Gotarrendura,174,66,108
5,Ávila,88,Grandes y San Martín,33,16,17
5,Ávila,89,Guisando,497,250,247
5,Ávila,90,Gutierre-Muñoz,63,34,29
5,Ávila,92,Hernansancho,153,86,67
5,Ávila,93,Herradón de Pinares,501,280,221
5,Ávila,94,Herreros de Suso,140,77,63
5,Ávila,95,Higuera de las Dueñas,270,153,117
5,Ávila,96,"Hija de Dios, La",86,52,34
5,Ávila,97,"Horcajada, La",482,247,235
5,Ávila,99,Horcajo de las Torres,469,264,205
5,Ávila,100,"Hornillo, El",270,146,124
5,Ávila,102,"Hoyo de Pinares, El",2169,1118,1051
5,Ávila,101,Hoyocasero,276,162,114
5,Ávila,103,Hoyorredondo,58,31,27
5,Ávila,106,Hoyos de Miguel Muñoz,25,13,12
5,Ávila,104,Hoyos del Collado,29,17,12
5,Ávila,105,Hoyos del Espino,364,189,175
5,Ávila,107,Hurtumpascual,45,27,18
5,Ávila,108,Junciana,39,23,16
5,Ávila,109,Langa,456,234,222
5,Ávila,110,Lanzahíta,819,428,391
5,Ávila,113,"Llanos de Tormes, Los",62,32,30
5,Ávila,112,"Losar del Barco, El",101,57,44
5,Ávila,114,Madrigal de las Altas Torres,1350,683,667
5,Ávila,115,Maello,669,358,311
5,Ávila,116,Malpartida de Corneja,101,50,51
5,Ávila,117,Mamblas,198,113,85
5,Ávila,118,Mancera de Arriba,70,38,32
5,Ávila,119,Manjabálago y Ortigosa de Rioalmar,20,11,9
5,Ávila,120,Marlín,29,20,9
5,Ávila,121,Martiherrero,338,176,162
5,Ávila,122,Martínez,117,63,54
5,Ávila,123,Mediana de Voltoya,116,61,55
5,Ávila,124,Medinilla,89,44,45
5,Ávila,125,Mengamuñoz,61,30,31
5,Ávila,126,Mesegar de Corneja,57,35,22
5,Ávila,127,Mijares,726,398,328
5,Ávila,128,Mingorría,385,195,190
5,Ávila,129,"Mirón, El",109,67,42
5,Ávila,130,Mironcillo,112,58,54
5,Ávila,131,Mirueña de los Infanzones,90,51,39
5,Ávila,132,Mombeltrán,933,487,446
5,Ávila,133,Monsalupe,60,31,29
5,Ávila,134,Moraleja de Matacabras,57,30,27
5,Ávila,135,Muñana,463,247,216
5,Ávila,136,Muñico,79,44,35
5,Ávila,138,Muñogalindo,309,152,157
5,Ávila,139,Muñogrande,73,40,33
5,Ávila,140,Muñomer del Peco,109,56,53
5,Ávila,141,Muñopepe,102,57,45
5,Ávila,142,Muñosancho,89,47,42
5,Ávila,143,Muñotello,56,29,27
5,Ávila,144,Narrillos del Álamo,63,35,28
5,Ávila,145,Narrillos del Rebollar,40,26,14
5,Ávila,149,Narros de Saldueña,106,57,49
5,Ávila,147,Narros del Castillo,153,83,70
5,Ávila,148,Narros del Puerto,31,17,14
5,Ávila,152,Nava de Arévalo,695,360,335
5,Ávila,153,Nava del Barco,87,43,44
5,Ávila,151,Navacepedilla de Corneja,91,49,42
5,Ávila,154,Navadijos,37,26,11
5,Ávila,155,Navaescurial,44,26,18
5,Ávila,156,Navahondilla,366,220,146
5,Ávila,157,Navalacruz,215,124,91
5,Ávila,158,Navalmoral,356,185,171
5,Ávila,159,Navalonguilla,205,103,102
5,Ávila,160,Navalosa,317,182,135
5,Ávila,161,Navalperal de Pinares,761,402,359
5,Ávila,162,Navalperal de Tormes,81,46,35
5,Ávila,163,Navaluenga,2136,1066,1070
5,Ávila,164,Navaquesera,24,11,13
5,Ávila,165,Navarredonda de Gredos,429,217,212
5,Ávila,166,Navarredondilla,156,80,76
5,Ávila,167,Navarrevisca,289,168,121
5,Ávila,168,"Navas del Marqués, Las",5268,2701,2567
5,Ávila,169,Navatalgordo,238,132,106
5,Ávila,170,Navatejares,58,27,31
5,Ávila,171,Neila de San Miguel,64,35,29
5,Ávila,172,Niharra,164,99,65
5,Ávila,173,Ojos-Albos,83,47,36
5,Ávila,174,Orbita,79,46,33
5,Ávila,175,"Oso, El",144,83,61
5,Ávila,176,Padiernos,287,157,130
5,Ávila,177,Pajares de Adaja,127,69,58
5,Ávila,178,Palacios de Goda,384,205,179
5,Ávila,179,Papatrigo,230,111,119
5,Ávila,180,"Parral, El",59,36,23
5,Ávila,181,Pascualcobo,42,27,15
5,Ávila,182,Pedro Bernardo,797,420,377
5,Ávila,183,Pedro-Rodríguez,138,72,66
5,Ávila,184,Peguerinos,282,158,124
5,Ávila,185,Peñalba de Ávila,109,60,49
5,Ávila,186,Piedrahíta,1720,834,886
5,Ávila,187,Piedralaves,2123,1055,1068
5,Ávila,188,Poveda,43,24,19
5,Ávila,189,Poyales del Hoyo,463,255,208
5,Ávila,190,Pozanco,49,29,20
5,Ávila,191,Pradosegar,122,69,53
5,Ávila,192,Puerto Castilla,111,70,41
5,Ávila,193,Rasueros,161,90,71
5,Ávila,194,Riocabado,133,78,55
5,Ávila,195,Riofrío,194,121,73
5,Ávila,196,Rivilla de Barajas,58,26,32
5,Ávila,197,Salobral,110,60,50
5,Ávila,198,Salvadiós,74,38,36
5,Ávila,199,San Bartolomé de Béjar,47,24,23
5,Ávila,200,San Bartolomé de Corneja,38,22,16
5,Ávila,201,San Bartolomé de Pinares,510,282,228
5,Ávila,206,San Esteban de los Patos,20,13,7
5,Ávila,208,San Esteban de Zapardiel,41,22,19
5,Ávila,207,San Esteban del Valle,759,394,365
5,Ávila,209,San García de Ingelmos,67,44,23
5,Ávila,901,San Juan de Gredos,251,143,108
5,Ávila,210,San Juan de la Encinilla,73,36,37
5,Ávila,211,San Juan de la Nava,443,238,205
5,Ávila,212,San Juan del Molinillo,200,113,87
5,Ávila,213,San Juan del Olmo,86,55,31
5,Ávila,214,San Lorenzo de Tormes,35,17,18
5,Ávila,215,San Martín de la Vega del Alberche,162,96,66
5,Ávila,216,San Martín del Pimpollar,213,126,87
5,Ávila,217,San Miguel de Corneja,55,31,24
5,Ávila,218,San Miguel de Serrezuela,106,56,50
5,Ávila,219,San Pascual,43,26,17
5,Ávila,220,San Pedro del Arroyo,452,239,213
5,Ávila,231,San Vicente de Arévalo,169,94,75
5,Ávila,204,Sanchidrián,715,368,347
5,Ávila,205,Sanchorreja,84,40,44
5,Ávila,222,Santa Cruz de Pinares,158,92,66
5,Ávila,221,Santa Cruz del Valle,329,169,160
5,Ávila,226,Santa María de los Caballeros,61,38,23
5,Ávila,224,Santa María del Arroyo,111,60,51
5,Ávila,225,Santa María del Berrocal,388,202,186
5,Ávila,902,Santa María del Cubillo,305,174,131
5,Ávila,227,Santa María del Tiétar,499,262,237
5,Ávila,228,Santiago del Collado,171,107,64
5,Ávila,904,Santiago del Tormes,112,62,50
5,Ávila,229,Santo Domingo de las Posadas,72,40,32
5,Ávila,230,Santo Tomé de Zabarcos,72,42,30
5,Ávila,232,"Serrada, La",125,67,58
5,Ávila,233,Serranillos,244,130,114
5,Ávila,234,Sigeres,42,20,22
5,Ávila,235,Sinlabajos,148,69,79
5,Ávila,236,Solana de Ávila,110,64,46
5,Ávila,237,Solana de Rioalmar,152,89,63
5,Ávila,238,Solosancho,792,422,370
5,Ávila,239,Sotalbo,239,138,101
5,Ávila,240,Sotillo de la Adrada,4762,2365,2397
5,Ávila,241,"Tiemblo, El",4373,2214,2159
5,Ávila,242,Tiñosillos,760,391,369
5,Ávila,243,Tolbaños,82,48,34
5,Ávila,244,Tormellas,37,23,14
5,Ávila,245,Tornadizos de Ávila,451,221,230
5,Ávila,247,"Torre, La",238,128,110
5,Ávila,246,Tórtoles,43,23,20
5,Ávila,249,Umbrías,100,52,48
5,Ávila,251,Vadillo de la Sierra,63,42,21
5,Ávila,252,Valdecasa,61,37,24
5,Ávila,253,Vega de Santa María,76,39,37
5,Ávila,254,Velayos,214,106,108
5,Ávila,256,Villaflor,104,56,48
5,Ávila,257,Villafranca de la Sierra,143,83,60
5,Ávila,905,Villanueva de Ávila,247,132,115
5,Ávila,258,Villanueva de Gómez,116,66,50
5,Ávila,259,Villanueva del Aceral,106,53,53
5,Ávila,260,Villanueva del Campillo,110,61,49
5,Ávila,261,Villar de Corneja,38,23,15
5,Ávila,262,Villarejo del Valle,322,177,145
5,Ávila,263,Villatoro,156,93,63
5,Ávila,264,Viñegra de Moraña,46,24,22
5,Ávila,265,Vita,84,49,35
5,Ávila,266,Zapardiel de la Cañada,88,48,40
5,Ávila,267,Zapardiel de la Ribera,92,49,43
6,Badajoz,1,Acedera,816,418,398
6,Badajoz,2,Aceuchal,5456,2714,2742
6,Badajoz,3,Ahillones,826,414,412
6,Badajoz,4,Alange,1844,951,893
6,Badajoz,5,"Albuera, La",2014,1042,972
6,Badajoz,6,Alburquerque,5144,2563,2581
6,Badajoz,7,Alconchel,1644,835,809
6,Badajoz,8,Alconera,750,372,378
6,Badajoz,9,Aljucén,243,134,109
6,Badajoz,10,Almendral,1207,605,602
6,Badajoz,11,Almendralejo,33669,16636,17033
6,Badajoz,12,Arroyo de San Serván,4054,2042,2012
6,Badajoz,13,Atalaya,285,149,136
6,Badajoz,14,Azuaga,7636,3781,3855
6,Badajoz,15,Badajoz,150146,72634,77512
6,Badajoz,16,Barcarrota,3445,1754,1691
6,Badajoz,17,Baterno,248,135,113
6,Badajoz,18,Benquerencia de la Serena,808,403,405
6,Badajoz,19,Berlanga,2241,1108,1133
6,Badajoz,20,Bienvenida,2070,1065,1005
6,Badajoz,21,Bodonal de la Sierra,1008,510,498
6,Badajoz,22,Burguillos del Cerro,3047,1495,1552
6,Badajoz,23,Cabeza del Buey,4682,2331,2351
6,Badajoz,24,Cabeza la Vaca,1296,664,632
6,Badajoz,25,Calamonte,6115,3030,3085
6,Badajoz,26,Calera de León,933,476,457
6,Badajoz,27,Calzadilla de los Barros,716,358,358
6,Badajoz,28,Campanario,4787,2374,2413
6,Badajoz,29,Campillo de Llerena,1325,663,662
6,Badajoz,30,Capilla,161,84,77
6,Badajoz,31,Carmonita,525,262,263
6,Badajoz,32,"Carrascalejo, El",84,42,42
6,Badajoz,33,Casas de Don Pedro,1436,745,691
6,Badajoz,34,Casas de Reina,194,99,95
6,Badajoz,35,Castilblanco,864,439,425
6,Badajoz,36,Castuera,5637,2793,2844
6,Badajoz,42,Cheles,1159,573,586
6,Badajoz,37,"Codosera, La",2025,1063,962
6,Badajoz,38,Cordobilla de Lácara,855,447,408
6,Badajoz,39,"Coronada, La",2172,1053,1119
6,Badajoz,40,Corte de Peleas,1187,584,603
6,Badajoz,41,Cristina,558,286,272
6,Badajoz,43,Don Álvaro,807,433,374
6,Badajoz,44,Don Benito,37310,18390,18920
6,Badajoz,45,Entrín Bajo,557,286,271
6,Badajoz,46,Esparragalejo,1480,729,751
6,Badajoz,47,Esparragosa de la Serena,975,488,487
6,Badajoz,48,Esparragosa de Lares,883,440,443
6,Badajoz,49,Feria,1073,511,562
6,Badajoz,50,Fregenal de la Sierra,4773,2327,2446
6,Badajoz,51,Fuenlabrada de los Montes,1755,863,892
6,Badajoz,52,Fuente de Cantos,4667,2320,2347
6,Badajoz,53,Fuente del Arco,680,348,332
6,Badajoz,54,Fuente del Maestre,6659,3294,3365
6,Badajoz,55,Fuentes de León,2232,1100,1132
6,Badajoz,56,Garbayuela,502,266,236
6,Badajoz,57,Garlitos,543,275,268
6,Badajoz,58,"Garrovilla, La",2317,1141,1176
6,Badajoz,59,Granja de Torrehermosa,1940,965,975
6,Badajoz,903,Guadiana,2414,1189,1225
6,Badajoz,60,Guareña,6771,3401,3370
6,Badajoz,61,"Haba, La",1214,609,605
6,Badajoz,62,Helechosa de los Montes,597,341,256
6,Badajoz,63,Herrera del Duque,3467,1736,1731
6,Badajoz,64,Higuera de la Serena,924,470,454
6,Badajoz,65,Higuera de Llerena,340,179,161
6,Badajoz,66,Higuera de Vargas,1934,980,954
6,Badajoz,67,Higuera la Real,2216,1129,1087
6,Badajoz,68,Hinojosa del Valle,479,233,246
6,Badajoz,69,Hornachos,3487,1741,1746
6,Badajoz,70,Jerez de los Caballeros,9167,4509,4658
6,Badajoz,71,"Lapa, La",288,145,143
6,Badajoz,73,Llera,822,418,404
6,Badajoz,74,Llerena,5670,2817,2853
6,Badajoz,72,Lobón,2761,1417,1344
6,Badajoz,75,Magacela,507,262,245
6,Badajoz,76,Maguilla,961,483,478
6,Badajoz,77,Malcocinado,344,191,153
6,Badajoz,78,Malpartida de la Serena,528,273,255
6,Badajoz,79,Manchita,750,379,371
6,Badajoz,80,Medellín,2232,1136,1096
6,Badajoz,81,Medina de las Torres,1161,600,561
6,Badajoz,82,Mengabril,485,264,221
6,Badajoz,83,Mérida,59324,28829,30495
6,Badajoz,84,Mirandilla,1231,618,613
6,Badajoz,85,Monesterio,4302,2211,2091
6,Badajoz,86,Montemolín,1322,636,686
6,Badajoz,87,Monterrubio de la Serena,2269,1125,1144
6,Badajoz,88,Montijo,15427,7642,7785
6,Badajoz,89,"Morera, La",700,360,340
6,Badajoz,90,"Nava de Santiago, La",911,452,459
6,Badajoz,91,Navalvillar de Pela,4371,2195,2176
6,Badajoz,92,Nogales,633,313,320
6,Badajoz,93,Oliva de la Frontera,5010,2519,2491
6,Badajoz,94,Oliva de Mérida,1674,846,828
6,Badajoz,95,Olivenza,11832,5891,5941
6,Badajoz,96,Orellana de la Sierra,252,133,119
6,Badajoz,97,Orellana la Vieja,2603,1327,1276
6,Badajoz,98,Palomas,662,332,330
6,Badajoz,99,"Parra, La",1302,671,631
6,Badajoz,100,Peñalsordo,851,425,426
6,Badajoz,101,Peraleda del Zaucejo,500,253,247
6,Badajoz,102,Puebla de Alcocer,1139,557,582
6,Badajoz,103,Puebla de la Calzada,5856,2940,2916
6,Badajoz,104,Puebla de la Reina,709,347,362
6,Badajoz,107,Puebla de Obando,1842,942,900
6,Badajoz,108,Puebla de Sancho Pérez,2642,1347,1295
6,Badajoz,105,Puebla del Maestre,660,342,318
6,Badajoz,106,Puebla del Prior,460,234,226
6,Badajoz,902,Pueblonuevo del Guadiana,1971,982,989
6,Badajoz,109,Quintana de la Serena,4536,2291,2245
6,Badajoz,110,Reina,150,79,71
6,Badajoz,111,Rena,610,320,290
6,Badajoz,112,Retamal de Llerena,435,227,208
6,Badajoz,113,Ribera del Fresno,3234,1623,1611
6,Badajoz,114,Risco,121,58,63
6,Badajoz,115,"Roca de la Sierra, La",1435,702,733
6,Badajoz,116,Salvaleón,1701,860,841
6,Badajoz,117,Salvatierra de los Barros,1590,778,812
6,Badajoz,119,San Pedro de Mérida,851,440,411
6,Badajoz,123,San Vicente de Alcántara,5291,2658,2633
6,Badajoz,118,Sancti-Spíritus,161,90,71
6,Badajoz,120,Santa Amalia,3942,1980,1962
6,Badajoz,121,Santa Marta,4125,2075,2050
6,Badajoz,122,"Santos de Maimona, Los",8072,4051,4021
6,Badajoz,124,Segura de León,1818,913,905
6,Badajoz,125,Siruela,1841,934,907
6,Badajoz,126,Solana de los Barros,2553,1274,1279
6,Badajoz,127,Talarrubias,3285,1633,1652
6,Badajoz,128,Talavera la Real,5276,2645,2631
6,Badajoz,129,Táliga,663,331,332
6,Badajoz,130,Tamurejo,201,103,98
6,Badajoz,131,Torre de Miguel Sesmero,1228,628,600
6,Badajoz,132,Torremayor,985,482,503
6,Badajoz,133,Torremejía,2236,1164,1072
6,Badajoz,134,Trasierra,612,326,286
6,Badajoz,135,Trujillanos,1401,719,682
6,Badajoz,136,Usagre,1765,871,894
6,Badajoz,137,Valdecaballeros,1075,561,514
6,Badajoz,901,Valdelacalzada,2755,1386,1369
6,Badajoz,138,Valdetorres,1161,571,590
6,Badajoz,139,Valencia de las Torres,512,275,237
6,Badajoz,140,Valencia del Mombuey,718,374,344
6,Badajoz,141,Valencia del Ventoso,1921,963,958
6,Badajoz,146,Valle de la Serena,1127,573,554
6,Badajoz,147,Valle de Matamoros,344,174,170
6,Badajoz,148,Valle de Santa Ana,1132,557,575
6,Badajoz,142,Valverde de Burguillos,273,142,131
6,Badajoz,143,Valverde de Leganés,4172,2081,2091
6,Badajoz,144,Valverde de Llerena,562,282,280
6,Badajoz,145,Valverde de Mérida,1023,518,505
6,Badajoz,149,Villafranca de los Barros,12429,6129,6300
6,Badajoz,150,Villagarcía de la Torre,905,460,445
6,Badajoz,151,Villagonzalo,1217,591,626
6,Badajoz,152,Villalba de los Barros,1446,720,726
6,Badajoz,153,Villanueva de la Serena,25873,12551,13322
6,Badajoz,154,Villanueva del Fresno,3316,1671,1645
6,Badajoz,156,Villar de Rena,1332,688,644
6,Badajoz,155,Villar del Rey,2089,1119,970
6,Badajoz,157,Villarta de los Montes,403,203,200
6,Badajoz,158,Zafra,16702,8026,8676
6,Badajoz,159,Zahínos,2776,1379,1397
6,Badajoz,160,Zalamea de la Serena,3460,1740,1720
6,Badajoz,162,"Zarza, La",3386,1693,1693
6,Badajoz,161,Zarza-Capilla,305,152,153
7,"Balears, Illes",2,Alaior,9606,4814,4792
7,"Balears, Illes",1,Alaró,5811,2825,2986
7,"Balears, Illes",3,Alcúdia,20717,10491,10226
7,"Balears, Illes",4,Algaida,6075,3073,3002
7,"Balears, Illes",5,Andratx,11735,5916,5819
7,"Balears, Illes",901,Ariany,912,477,435
7,"Balears, Illes",6,Artà,8062,4023,4039
7,"Balears, Illes",7,Banyalbufar,566,304,262
7,"Balears, Illes",8,Binissalem,9027,4498,4529
7,"Balears, Illes",9,Búger,1111,588,523
7,"Balears, Illes",10,Bunyola,7121,3499,3622
7,"Balears, Illes",11,Calvià,52458,26175,26283
7,"Balears, Illes",12,Campanet,2719,1358,1361
7,"Balears, Illes",13,Campos,11618,5815,5803
7,"Balears, Illes",14,Capdepera,12081,6093,5988
7,"Balears, Illes",64,"Castell, Es",7525,3817,3708
7,"Balears, Illes",15,Ciutadella de Menorca,30811,15336,15475
7,"Balears, Illes",16,Consell,4230,2096,2134
7,"Balears, Illes",17,Costitx,1446,714,732
7,"Balears, Illes",18,Deià,674,328,346
7,"Balears, Illes",26,Eivissa,50715,25550,25165
7,"Balears, Illes",19,Escorca,187,112,75
7,"Balears, Illes",20,Esporles,5182,2546,2636
7,"Balears, Illes",21,Estellencs,336,175,161
7,"Balears, Illes",22,Felanitx,18357,9219,9138
7,"Balears, Illes",23,Ferreries,4944,2479,2465
7,"Balears, Illes",24,Formentera,11418,5938,5480
7,"Balears, Illes",25,Fornalutx,710,354,356
7,"Balears, Illes",27,Inca,34093,17155,16938
7,"Balears, Illes",28,Lloret de Vistalegre,1514,762,752
7,"Balears, Illes",29,Lloseta,6312,3155,3157
7,"Balears, Illes",30,Llubí,2392,1191,1201
7,"Balears, Illes",31,Llucmajor,38722,19595,19127
7,"Balears, Illes",33,Manacor,45352,22720,22632
7,"Balears, Illes",34,Mancor de la Vall,1596,817,779
7,"Balears, Illes",32,Maó,29445,14287,15158
7,"Balears, Illes",35,Maria de la Salut,2273,1174,1099
7,"Balears, Illes",36,Marratxí,38902,19542,19360
7,"Balears, Illes",37,"Mercadal, Es",5676,2878,2798
7,"Balears, Illes",902,"Migjorn Gran, Es",1507,750,757
7,"Balears, Illes",38,Montuïri,3119,1576,1543
7,"Balears, Illes",39,Muro,7667,3882,3785
7,"Balears, Illes",40,Palma,415940,203175,212765
7,"Balears, Illes",41,Petra,3067,1509,1558
7,"Balears, Illes",44,"Pobla, Sa",14005,7079,6926
7,"Balears, Illes",42,Pollença,17126,8534,8592
7,"Balears, Illes",43,Porreres,5645,2856,2789
7,"Balears, Illes",45,Puigpunyent,2075,1026,1049
7,"Balears, Illes",59,"Salines, Ses",5039,2519,2520
7,"Balears, Illes",46,Sant Antoni de Portmany,27431,14334,13097
7,"Balears, Illes",49,Sant Joan,2179,1079,1100
7,"Balears, Illes",50,Sant Joan de Labritja,6703,3401,3302
7,"Balears, Illes",48,Sant Josep de sa Talaia,28813,14785,14028
7,"Balears, Illes",51,Sant Llorenç des Cardassar,9035,4537,4498
7,"Balears, Illes",52,Sant Lluís,6953,3509,3444
7,"Balears, Illes",53,Santa Eugènia,1771,888,883
7,"Balears, Illes",54,Santa Eulària des Riu,40548,20454,20094
7,"Balears, Illes",55,Santa Margalida,12776,6555,6221
7,"Balears, Illes",56,Santa María del Camí,7483,3734,3749
7,"Balears, Illes",57,Santanyí,12321,6199,6122
7,"Balears, Illes",58,Selva,4243,2090,2153
7,"Balears, Illes",47,Sencelles,3659,1851,1808
7,"Balears, Illes",60,Sineu,4232,2109,2123
7,"Balears, Illes",61,Sóller,13454,6659,6795
7,"Balears, Illes",62,Son Servera,11752,5837,5915
7,"Balears, Illes",63,Valldemossa,2085,1049,1036
7,"Balears, Illes",65,Vilafranca de Bonany,3600,1831,1769
8,Barcelona,1,Abrera,12697,6414,6283
8,Barcelona,2,Aguilar de Segarra,287,154,133
8,Barcelona,14,Aiguafreda,2552,1249,1303
8,Barcelona,3,Alella,10079,4931,5148
8,Barcelona,4,Alpens,281,150,131
8,Barcelona,5,"Ametlla del Vallès, L'",9020,4529,4491
8,Barcelona,6,Arenys de Mar,16155,7854,8301
8,Barcelona,7,Arenys de Munt,9278,4685,4593
8,Barcelona,8,Argençola,216,116,100
8,Barcelona,9,Argentona,12745,6329,6416
8,Barcelona,10,Artés,5902,2972,2930
8,Barcelona,11,Avià,2237,1117,1120
8,Barcelona,12,Avinyó,2270,1148,1122
8,Barcelona,13,Avinyonet del Penedès,1706,912,794
8,Barcelona,15,Badalona,223506,110151,113355
8,Barcelona,904,Badia del Vallès,13163,6464,6699
8,Barcelona,16,Bagà,2167,1082,1085
8,Barcelona,17,Balenyà,3948,1984,1964
8,Barcelona,18,Balsareny,3249,1623,1626
8,Barcelona,252,Barberà del Vallès,33082,16250,16832
8,Barcelona,19,Barcelona,1636193,778674,857519
8,Barcelona,20,Begues,7450,3725,3725
8,Barcelona,21,Bellprat,74,46,28
8,Barcelona,22,Berga,16762,8273,8489
8,Barcelona,23,Bigues i Riells del Fai,9757,4961,4796
8,Barcelona,24,Borredà,448,251,197
8,Barcelona,25,"Bruc, El",2218,1181,1037
8,Barcelona,26,"Brull, El",278,150,128
8,Barcelona,27,"Cabanyes, Les",999,512,487
8,Barcelona,28,Cabrera d'Anoia,1606,850,756
8,Barcelona,29,Cabrera de Mar,4848,2429,2419
8,Barcelona,30,Cabrils,7729,3821,3908
8,Barcelona,31,Calaf,3590,1812,1778
8,Barcelona,34,Calders,1101,569,532
8,Barcelona,33,Caldes de Montbui,17932,8949,8983
8,Barcelona,32,Caldes d'Estrac,3148,1519,1629
8,Barcelona,35,Calella,19363,9393,9970
8,Barcelona,37,Calldetenes,2532,1296,1236
8,Barcelona,38,Callús,2122,1043,1079
8,Barcelona,36,Calonge de Segarra,195,98,97
8,Barcelona,39,Campins,557,284,273
8,Barcelona,40,Canet de Mar,14845,7216,7629
8,Barcelona,41,Canovelles,16761,8632,8129
8,Barcelona,42,Cànoves i Samalús,3289,1672,1617
8,Barcelona,43,Canyelles,5007,2613,2394
8,Barcelona,44,Capellades,5344,2655,2689
8,Barcelona,45,Capolat,89,42,47
8,Barcelona,46,Cardedeu,18785,9154,9631
8,Barcelona,47,Cardona,4575,2248,2327
8,Barcelona,48,Carme,754,391,363
8,Barcelona,49,Casserres,1646,820,826
8,Barcelona,57,Castell de l'Areny,69,38,31
8,Barcelona,52,Castellar de n'Hug,176,95,81
8,Barcelona,50,Castellar del Riu,175,99,76
8,Barcelona,51,Castellar del Vallès,24933,12344,12589
8,Barcelona,53,Castellbell i el Vilar,3889,2003,1886
8,Barcelona,54,Castellbisbal,12735,6403,6332
8,Barcelona,55,Castellcir,778,404,374
8,Barcelona,56,Castelldefels,67307,32948,34359
8,Barcelona,58,Castellet i la Gornal,2474,1281,1193
8,Barcelona,60,Castellfollit de Riubregós,159,87,72
8,Barcelona,59,Castellfollit del Boix,460,232,228
8,Barcelona,61,Castellgalí,2236,1142,1094
8,Barcelona,62,Castellnou de Bages,1431,761,670
8,Barcelona,63,Castellolí,636,307,329
8,Barcelona,64,Castellterçol,2655,1360,1295
8,Barcelona,65,Castellví de la Marca,1614,833,781
8,Barcelona,66,Castellví de Rosanes,2096,1034,1062
8,Barcelona,67,Centelles,7641,3754,3887
8,Barcelona,268,Cercs,1169,582,587
8,Barcelona,266,Cerdanyola del Vallès,57291,27889,29402
8,Barcelona,68,Cervelló,9307,4697,4610
8,Barcelona,69,Collbató,4726,2426,2300
8,Barcelona,70,Collsuspina,398,199,199
8,Barcelona,71,Copons,333,167,166
8,Barcelona,72,Corbera de Llobregat,15210,7650,7560
8,Barcelona,73,Cornellà de Llobregat,89039,43139,45900
8,Barcelona,74,Cubelles,16386,8257,8129
8,Barcelona,75,Dosrius,5710,2872,2838
8,Barcelona,76,Esparreguera,22365,11287,11078
8,Barcelona,77,Esplugues de Llobregat,46414,22106,24308
8,Barcelona,78,"Espunyola, L'",265,132,133
8,Barcelona,254,"Esquirol, L'",2245,1117,1128
8,Barcelona,79,"Estany, L'",391,213,178
8,Barcelona,134,Figaró-Montmany,1108,537,571
8,Barcelona,80,Fígols,45,28,17
8,Barcelona,82,Fogars de la Selva,1564,809,755
8,Barcelona,81,Fogars de Montclús,493,265,228
8,Barcelona,83,Folgueroles,2254,1135,1119
8,Barcelona,84,Fonollosa,1546,781,765
8,Barcelona,85,Font-rubí,1446,768,678
8,Barcelona,86,"Franqueses del Vallès, Les",20322,10248,10074
8,Barcelona,90,Gaià,179,94,85
8,Barcelona,87,Gallifa,186,96,90
8,Barcelona,88,"Garriga, La",16788,8095,8693
8,Barcelona,89,Gavà,46974,22982,23992
8,Barcelona,91,Gelida,7814,3921,3893
8,Barcelona,92,Gironella,4940,2453,2487
8,Barcelona,93,Gisclareny,28,18,10
8,Barcelona,94,"Granada, La",2207,1104,1103
8,Barcelona,95,Granera,80,51,29
8,Barcelona,96,Granollers,61983,30569,31414
8,Barcelona,97,Gualba,1610,816,794
8,Barcelona,99,Guardiola de Berguedà,918,481,437
8,Barcelona,100,Gurb,2702,1392,1310
8,Barcelona,101,"Hospitalet de Llobregat, L'",265444,128539,136905
8,Barcelona,162,"Hostalets de Pierola, Els",3127,1593,1534
8,Barcelona,102,Igualada,40767,20027,20740
8,Barcelona,103,Jorba,806,415,391
8,Barcelona,104,"Llacuna, La",942,497,445
8,Barcelona,105,"Llagosta, La",13155,6451,6704
8,Barcelona,107,Lliçà d'Amunt,15801,8046,7755
8,Barcelona,108,Lliçà de Vall,6760,3443,3317
8,Barcelona,106,Llinars del Vallès,10205,5056,5149
8,Barcelona,109,Lluçà,279,137,142
8,Barcelona,110,Malgrat de Mar,19093,9455,9638
8,Barcelona,111,Malla,272,137,135
8,Barcelona,112,Manlleu,20883,10478,10405
8,Barcelona,113,Manresa,77452,37964,39488
8,Barcelona,242,Marganell,282,143,139
8,Barcelona,114,Martorell,28684,14637,14047
8,Barcelona,115,Martorelles,4859,2454,2405
8,Barcelona,116,"Masies de Roda, Les",733,371,362
8,Barcelona,117,"Masies de Voltregà, Les",3133,1551,1582
8,Barcelona,118,"Masnou, El",23829,11464,12365
8,Barcelona,119,Masquefa,9744,4966,4778
8,Barcelona,120,Matadepera,9752,4871,4881
8,Barcelona,121,Mataró,128956,63951,65005
8,Barcelona,122,Mediona,2517,1292,1225
8,Barcelona,138,Moià,6548,3374,3174
8,Barcelona,123,Molins de Rei,26242,12806,13436
8,Barcelona,124,Mollet del Vallès,51294,25268,26026
8,Barcelona,128,Monistrol de Calders,742,397,345
8,Barcelona,127,Monistrol de Montserrat,3166,1625,1541
8,Barcelona,125,Montcada i Reixac,36666,18069,18597
8,Barcelona,130,Montclar,136,69,67
8,Barcelona,131,Montesquiu,1059,526,533
8,Barcelona,126,Montgat,12277,6058,6219
8,Barcelona,132,Montmajor,484,243,241
8,Barcelona,133,Montmaneu,166,91,75
8,Barcelona,135,Montmeló,8793,4304,4489
8,Barcelona,136,Montornès del Vallès,16707,8423,8284
8,Barcelona,137,Montseny,370,188,182
8,Barcelona,129,Muntanyola,700,368,332
8,Barcelona,139,Mura,232,119,113
8,Barcelona,140,Navarcles,6067,2955,3112
8,Barcelona,141,Navàs,6018,2965,3053
8,Barcelona,142,"Nou de Berguedà, La",179,93,86
8,Barcelona,143,Òdena,3728,1920,1808
8,Barcelona,145,Olèrdola,3884,2030,1854
8,Barcelona,146,Olesa de Bonesvalls,2016,1052,964
8,Barcelona,147,Olesa de Montserrat,24272,12129,12143
8,Barcelona,148,Olivella,4339,2238,2101
8,Barcelona,149,Olost,1206,597,609
8,Barcelona,144,Olvan,876,436,440
8,Barcelona,150,Orís,347,179,168
8,Barcelona,151,Oristà,573,295,278
8,Barcelona,152,Orpí,159,82,77
8,Barcelona,153,Òrrius,793,399,394
8,Barcelona,154,Pacs del Penedès,935,467,468
8,Barcelona,155,Palafolls,9661,4845,4816
8,Barcelona,156,Palau-solità i Plegamans,14911,7291,7620
8,Barcelona,157,Pallejà,11593,5760,5833
8,Barcelona,905,"Palma de Cervelló, La",3026,1494,1532
8,Barcelona,158,"Papiol, El",4274,2133,2141
8,Barcelona,159,Parets del Vallès,18889,9422,9467
8,Barcelona,160,Perafita,418,213,205
8,Barcelona,161,Piera,16787,8616,8171
8,Barcelona,163,Pineda de Mar,28083,13947,14136
8,Barcelona,164,"Pla del Penedès, El",1335,677,658
8,Barcelona,165,"Pobla de Claramunt, La",2275,1159,1116
8,Barcelona,166,"Pobla de Lillet, La",1079,524,555
8,Barcelona,167,Polinyà,8451,4252,4199
8,Barcelona,182,"Pont de Vilomara i Rocafort, El",4024,2082,1942
8,Barcelona,168,Pontons,507,278,229
8,Barcelona,169,"Prat de Llobregat, El",65030,31752,33278
8,Barcelona,171,Prats de Lluçanès,2627,1325,1302
8,Barcelona,170,"Prats de Rei, Els",554,298,256
8,Barcelona,230,Premià de Dalt,10400,5179,5221
8,Barcelona,172,Premià de Mar,28518,13898,14620
8,Barcelona,174,Puigdàlber,555,268,287
8,Barcelona,175,Puig-reig,4327,2153,2174
8,Barcelona,176,Pujalt,204,113,91
8,Barcelona,177,"Quar, La",47,29,18
8,Barcelona,178,Rajadell,545,283,262
8,Barcelona,179,Rellinars,915,480,435
8,Barcelona,180,Ripollet,39031,19232,19799
8,Barcelona,181,"Roca del Vallès, La",10776,5411,5365
8,Barcelona,183,Roda de Ter,6555,3276,3279
8,Barcelona,184,Rubí,79007,39072,39935
8,Barcelona,185,Rubió,244,141,103
8,Barcelona,901,Rupit i Pruit,279,139,140
8,Barcelona,187,Sabadell,215760,104747,111013
8,Barcelona,188,Sagàs,157,81,76
8,Barcelona,190,Saldes,298,169,129
8,Barcelona,191,Sallent,6805,3312,3493
8,Barcelona,194,Sant Adrià de Besòs,36918,18068,18850
8,Barcelona,195,Sant Agustí de Lluçanès,100,51,49
8,Barcelona,196,Sant Andreu de la Barca,26965,13304,13661
8,Barcelona,197,Sant Andreu de Llavaneres,11593,5694,5899
8,Barcelona,198,Sant Antoni de Vilamajor,6483,3204,3279
8,Barcelona,199,Sant Bartomeu del Grau,924,485,439
8,Barcelona,200,Sant Boi de Llobregat,83371,40584,42787
8,Barcelona,201,Sant Boi de Lluçanès,575,295,280
8,Barcelona,203,Sant Cebrià de Vallalta,3619,1882,1737
8,Barcelona,202,Sant Celoni,18285,9112,9173
8,Barcelona,204,Sant Climent de Llobregat,4170,2086,2084
8,Barcelona,205,Sant Cugat del Vallès,95725,46536,49189
8,Barcelona,206,Sant Cugat Sesgarrigues,1009,490,519
8,Barcelona,207,Sant Esteve de Palautordera,3043,1504,1539
8,Barcelona,208,Sant Esteve Sesrovires,7889,3962,3927
8,Barcelona,210,Sant Feliu de Codines,6460,3262,3198
8,Barcelona,211,Sant Feliu de Llobregat,45642,22155,23487
8,Barcelona,212,Sant Feliu Sasserra,611,327,284
8,Barcelona,209,Sant Fost de Campsentelles,9064,4521,4543
8,Barcelona,213,Sant Fruitós de Bages,9025,4452,4573
8,Barcelona,215,Sant Hipòlit de Voltregà,3644,1841,1803
8,Barcelona,193,Sant Iscle de Vallalta,1433,765,668
8,Barcelona,216,Sant Jaume de Frontanyà,31,16,15
8,Barcelona,218,Sant Joan de Vilatorrada,10820,5396,5424
8,Barcelona,217,Sant Joan Despí,34039,16538,17501
8,Barcelona,903,Sant Julià de Cerdanyola,241,134,107
8,Barcelona,220,Sant Julià de Vilatorta,3193,1581,1612
8,Barcelona,221,Sant Just Desvern,19806,9570,10236
8,Barcelona,222,Sant Llorenç d'Hortons,2503,1263,1240
8,Barcelona,223,Sant Llorenç Savall,2524,1260,1264
8,Barcelona,225,Sant Martí d'Albars,119,57,62
8,Barcelona,224,Sant Martí de Centelles,1232,621,611
8,Barcelona,226,Sant Martí de Tous,1243,626,617
8,Barcelona,227,Sant Martí Sarroca,3313,1654,1659
8,Barcelona,228,Sant Martí Sesgueioles,361,187,174
8,Barcelona,229,Sant Mateu de Bages,628,321,307
8,Barcelona,231,Sant Pere de Ribes,31688,15769,15919
8,Barcelona,232,Sant Pere de Riudebitlles,2404,1213,1191
8,Barcelona,233,Sant Pere de Torelló,2514,1293,1221
8,Barcelona,234,Sant Pere de Vilamajor,4815,2439,2376
8,Barcelona,189,Sant Pere Sallavinera,167,89,78
8,Barcelona,235,Sant Pol de Mar,5680,2779,2901
8,Barcelona,236,Sant Quintí de Mediona,2393,1212,1181
8,Barcelona,237,Sant Quirze de Besora,2142,1035,1107
8,Barcelona,238,Sant Quirze del Vallès,20180,9870,10310
8,Barcelona,239,Sant Quirze Safaja,672,360,312
8,Barcelona,240,Sant Sadurní d'Anoia,12863,6344,6519
8,Barcelona,241,Sant Sadurní d'Osormort,90,53,37
8,Barcelona,98,Sant Salvador de Guardiola,3351,1714,1637
8,Barcelona,262,Sant Vicenç de Castellet,9949,5001,4948
8,Barcelona,264,Sant Vicenç de Montalt,6661,3309,3352
8,Barcelona,265,Sant Vicenç de Torelló,2077,1041,1036
8,Barcelona,263,Sant Vicenç dels Horts,28079,13904,14175
8,Barcelona,243,Santa Cecília de Voltregà,185,103,82
8,Barcelona,244,Santa Coloma de Cervelló,8309,4059,4250
8,Barcelona,245,Santa Coloma de Gramenet,117981,58173,59808
8,Barcelona,246,Santa Eugènia de Berga,2256,1156,1100
8,Barcelona,247,Santa Eulàlia de Riuprimer,1401,700,701
8,Barcelona,248,Santa Eulàlia de Ronçana,7740,3883,3857
8,Barcelona,249,Santa Fe del Penedès,370,182,188
8,Barcelona,250,Santa Margarida de Montbui,10294,5189,5105
8,Barcelona,251,Santa Margarida i els Monjos,7624,3875,3749
8,Barcelona,253,Santa Maria de Besora,159,83,76
8,Barcelona,256,Santa Maria de Martorelles,889,445,444
8,Barcelona,255,Santa Maria de Merlès,184,92,92
8,Barcelona,257,Santa Maria de Miralles,138,74,64
8,Barcelona,259,Santa Maria de Palautordera,9777,4895,4882
8,Barcelona,258,Santa Maria d'Oló,1063,530,533
8,Barcelona,260,Santa Perpètua de Mogoda,25930,13018,12912
8,Barcelona,261,Santa Susanna,3755,1874,1881
8,Barcelona,192,Santpedor,7612,3777,3835
8,Barcelona,267,Sentmenat,9417,4761,4656
8,Barcelona,269,Seva,3736,1924,1812
8,Barcelona,270,Sitges,31222,15696,15526
8,Barcelona,271,Sobremunt,83,34,49
8,Barcelona,272,Sora,219,120,99
8,Barcelona,273,Subirats,3241,1678,1563
8,Barcelona,274,Súria,5921,2873,3048
8,Barcelona,276,Tagamanent,340,178,162
8,Barcelona,277,Talamanca,219,122,97
8,Barcelona,278,Taradell,6699,3349,3350
8,Barcelona,275,Tavèrnoles,329,166,163
8,Barcelona,280,Tavertet,116,62,54
8,Barcelona,281,Teià,6635,3260,3375
8,Barcelona,279,Terrassa,224114,110205,113909
8,Barcelona,282,Tiana,9110,4402,4708
8,Barcelona,283,Tona,8368,4140,4228
8,Barcelona,284,Tordera,18022,9134,8888
8,Barcelona,285,Torelló,14726,7365,7361
8,Barcelona,286,"Torre de Claramunt, La",3966,2058,1908
8,Barcelona,287,Torrelavit,1457,748,709
8,Barcelona,288,Torrelles de Foix,2557,1359,1198
8,Barcelona,289,Torrelles de Llobregat,6186,3072,3114
8,Barcelona,290,Ullastrell,2139,1060,1079
8,Barcelona,291,Vacarisses,7325,3779,3546
8,Barcelona,292,Vallbona d'Anoia,1387,713,674
8,Barcelona,293,Vallcebre,268,144,124
8,Barcelona,294,Vallgorguina,3144,1603,1541
8,Barcelona,295,Vallirana,15658,7803,7855
8,Barcelona,296,Vallromanes,2632,1357,1275
8,Barcelona,297,Veciana,182,100,82
8,Barcelona,298,Vic,47545,24069,23476
8,Barcelona,299,Vilada,439,237,202
8,Barcelona,301,Viladecans,66720,32992,33728
8,Barcelona,300,Viladecavalls,7644,3794,3850
8,Barcelona,305,Vilafranca del Penedès,40056,19469,20587
8,Barcelona,306,Vilalba Sasserra,748,379,369
8,Barcelona,303,Vilanova de Sau,320,153,167
8,Barcelona,302,Vilanova del Camí,12699,6370,6329
8,Barcelona,902,Vilanova del Vallès,5557,2809,2748
8,Barcelona,307,Vilanova i la Geltrú,68152,32987,35165
8,Barcelona,214,Vilassar de Dalt,9128,4521,4607
8,Barcelona,219,Vilassar de Mar,21067,10148,10919
8,Barcelona,304,Vilobí del Penedès,1130,589,541
8,Barcelona,308,Viver i Serrateix,166,85,81
48,Bizkaia,1,Abadiño,7708,3860,3848
48,Bizkaia,2,Abanto y Ciérvana-Abanto Zierbena,9369,4648,4721
48,Bizkaia,911,Ajangiz,480,252,228
48,Bizkaia,912,Alonsotegi,2960,1463,1497
48,Bizkaia,3,Amorebieta-Etxano,19587,9636,9951
48,Bizkaia,4,Amoroto,398,204,194
48,Bizkaia,5,Arakaldo,158,75,83
48,Bizkaia,6,Arantzazu,401,199,202
48,Bizkaia,93,Areatza,1249,611,638
48,Bizkaia,9,Arrankudiaga,1008,498,510
48,Bizkaia,914,Arratzu,432,204,228
48,Bizkaia,10,Arrieta,576,299,277
48,Bizkaia,11,Arrigorriaga,11954,5836,6118
48,Bizkaia,23,Artea,746,374,372
48,Bizkaia,8,Artzentales,720,378,342
48,Bizkaia,91,Atxondo,1372,697,675
48,Bizkaia,70,Aulesti,655,323,332
48,Bizkaia,12,Bakio,2812,1405,1407
48,Bizkaia,90,Balmaseda,7636,3674,3962
48,Bizkaia,13,Barakaldo,100535,48586,51949
48,Bizkaia,14,Barrika,1547,778,769
48,Bizkaia,15,Basauri,40324,19505,20819
48,Bizkaia,92,Bedia,1102,531,571
48,Bizkaia,16,Berango,7347,3598,3749
48,Bizkaia,17,Bermeo,16755,8237,8518
48,Bizkaia,18,Berriatua,1220,671,549
48,Bizkaia,19,Berriz,4535,2254,2281
48,Bizkaia,20,Bilbao,344127,162828,181299
48,Bizkaia,21,Busturia,1667,831,836
48,Bizkaia,901,Derio,6819,3332,3487
48,Bizkaia,26,Dima,1454,751,703
48,Bizkaia,27,Durango,29609,14421,15188
48,Bizkaia,28,Ea,824,439,385
48,Bizkaia,31,Elantxobe,349,169,180
48,Bizkaia,32,Elorrio,7309,3593,3716
48,Bizkaia,902,Erandio,24446,11844,12602
48,Bizkaia,33,Ereño,267,151,116
48,Bizkaia,34,Ermua,15589,7724,7865
48,Bizkaia,79,Errigoiti,504,268,236
48,Bizkaia,29,Etxebarri,11780,5882,5898
48,Bizkaia,30,Etxebarria,787,402,385
48,Bizkaia,906,Forua,910,444,466
48,Bizkaia,35,Fruiz,550,270,280
48,Bizkaia,36,Galdakao,29285,14384,14901
48,Bizkaia,37,Galdames,837,446,391
48,Bizkaia,38,Gamiz-Fika,1391,699,692
48,Bizkaia,39,Garai,334,164,170
48,Bizkaia,40,Gatika,1642,826,816
48,Bizkaia,41,Gautegiz Arteaga,866,431,435
48,Bizkaia,46,Gernika-Lumo,16855,8085,8770
48,Bizkaia,44,Getxo,76365,35776,40589
48,Bizkaia,47,Gizaburuaga,192,97,95
48,Bizkaia,42,Gordexola,1711,874,837
48,Bizkaia,43,Gorliz,6031,2987,3044
48,Bizkaia,45,Güeñes,6737,3261,3476
48,Bizkaia,48,Ibarrangelu,680,347,333
48,Bizkaia,94,Igorre,4330,2140,2190
48,Bizkaia,49,Ispaster,731,384,347
48,Bizkaia,910,Iurreta,3695,1822,1873
48,Bizkaia,50,Izurtza,210,129,81
48,Bizkaia,22,Karrantza Harana/Valle de Carranza,2712,1400,1312
48,Bizkaia,907,Kortezubi,441,213,228
48,Bizkaia,51,Lanestosa,261,142,119
48,Bizkaia,52,Larrabetzu,2049,1005,1044
48,Bizkaia,53,Laukiz,1227,602,625
48,Bizkaia,54,Leioa,32172,15739,16433
48,Bizkaia,57,Lekeitio,7178,3548,3630
48,Bizkaia,55,Lemoa,3530,1770,1760
48,Bizkaia,56,Lemoiz,1314,685,629
48,Bizkaia,81,Lezama,2477,1238,1239
48,Bizkaia,903,Loiu,2318,1123,1195
48,Bizkaia,58,Mallabia,1185,601,584
48,Bizkaia,59,Mañaria,530,271,259
48,Bizkaia,60,Markina-Xemein,5042,2550,2492
48,Bizkaia,61,Maruri-Jatabe,1036,528,508
48,Bizkaia,62,Mendata,393,205,188
48,Bizkaia,63,Mendexa,425,221,204
48,Bizkaia,64,Meñaka,751,395,356
48,Bizkaia,66,Morga,422,220,202
48,Bizkaia,68,Mundaka,1866,922,944
48,Bizkaia,69,Mungia,17662,8585,9077
48,Bizkaia,7,Munitibar-Arbatzegi Gerrikaitz,473,257,216
48,Bizkaia,908,Murueta,327,175,152
48,Bizkaia,71,Muskiz,7367,3563,3804
48,Bizkaia,67,Muxika,1483,771,712
48,Bizkaia,909,Nabarniz,261,129,132
48,Bizkaia,73,Ondarroa,8246,4115,4131
48,Bizkaia,75,Orozko,2664,1314,1350
48,Bizkaia,83,Ortuella,8466,4113,4353
48,Bizkaia,72,Otxandio,1336,685,651
48,Bizkaia,77,Plentzia,4376,2140,2236
48,Bizkaia,78,Portugalete,44800,21413,23387
48,Bizkaia,82,Santurtzi,45749,21943,23806
48,Bizkaia,84,Sestao,27533,13319,14214
48,Bizkaia,904,Sondika,4521,2184,2337
48,Bizkaia,85,Sopela,14635,7238,7397
48,Bizkaia,86,Sopuerta,2698,1339,1359
48,Bizkaia,76,Sukarrieta,361,195,166
48,Bizkaia,87,Trucios-Turtzioz,516,270,246
48,Bizkaia,88,Ubide,164,87,77
48,Bizkaia,65,Ugao-Miraballes,4128,2080,2048
48,Bizkaia,89,Urduliz,5247,2604,2643
48,Bizkaia,74,Urduña/Orduña,4166,2143,2023
48,Bizkaia,80,Valle de Trápaga-Trapagaran,11918,5785,6133
48,Bizkaia,95,Zaldibar,3020,1534,1486
48,Bizkaia,96,Zalla,8300,4069,4231
48,Bizkaia,905,Zamudio,3256,1617,1639
48,Bizkaia,97,Zaratamo,1628,813,815
48,Bizkaia,24,Zeanuri,1271,636,635
48,Bizkaia,25,Zeberio,1084,552,532
48,Bizkaia,913,Zierbena,1485,785,700
48,Bizkaia,915,Ziortza-Bolibar,405,213,192
9,Burgos,1,Abajas,29,19,10
9,Burgos,3,Adrada de Haza,199,97,102
9,Burgos,6,Aguas Cándidas,62,40,22
9,Burgos,7,Aguilar de Bureba,51,32,19
9,Burgos,9,Albillos,220,114,106
9,Burgos,10,Alcocero de Mola,40,26,14
9,Burgos,11,Alfoz de Bricia,76,49,27
9,Burgos,907,Alfoz de Quintanadueñas,2201,1159,1042
9,Burgos,12,Alfoz de Santa Gadea,103,56,47
9,Burgos,13,Altable,47,28,19
9,Burgos,14,"Altos, Los",178,107,71
9,Burgos,16,Ameyugo,121,61,60
9,Burgos,17,Anguix,162,105,57
9,Burgos,18,Aranda de Duero,33172,16123,17049
9,Burgos,19,Arandilla,153,98,55
9,Burgos,20,Arauzo de Miel,278,156,122
9,Burgos,21,Arauzo de Salce,46,26,20
9,Burgos,22,Arauzo de Torre,74,46,28
9,Burgos,23,Arcos,1840,964,876
9,Burgos,24,Arenillas de Riopisuerga,176,107,69
9,Burgos,25,Arija,108,57,51
9,Burgos,26,Arlanzón,416,252,164
9,Burgos,27,Arraya de Oca,45,25,20
9,Burgos,29,Atapuerca,182,106,76
9,Burgos,30,"Ausines, Los",138,85,53
9,Burgos,32,Avellanosa de Muñó,100,54,46
9,Burgos,33,Bahabón de Esgueva,81,44,37
9,Burgos,34,"Balbases, Los",316,173,143
9,Burgos,35,Baños de Valdearados,332,192,140
9,Burgos,36,Bañuelos de Bureba,34,20,14
9,Burgos,37,Barbadillo de Herreros,110,68,42
9,Burgos,38,Barbadillo del Mercado,141,76,65
9,Burgos,39,Barbadillo del Pez,68,40,28
9,Burgos,41,Barrio de Muñó,32,18,14
9,Burgos,43,"Barrios de Bureba, Los",179,102,77
9,Burgos,44,Barrios de Colina,56,30,26
9,Burgos,45,Basconcillos del Tozo,293,171,122
9,Burgos,46,Bascuñana,20,13,7
9,Burgos,47,Belbimbre,56,30,26
9,Burgos,48,Belorado,1787,908,879
9,Burgos,50,Berberana,52,30,22
9,Burgos,51,Berlangas de Roa,182,98,84
9,Burgos,52,Berzosa de Bureba,27,20,7
9,Burgos,54,Bozoó,100,60,40
9,Burgos,55,Brazacorta,48,31,17
9,Burgos,56,Briviesca,6374,3193,3181
9,Burgos,57,Bugedo,195,120,75
9,Burgos,58,Buniel,602,331,271
9,Burgos,59,Burgos,173483,82601,90882
9,Burgos,60,Busto de Bureba,138,78,60
9,Burgos,61,Cabañes de Esgueva,163,90,73
9,Burgos,62,Cabezón de la Sierra,40,16,24
9,Burgos,64,Caleruega,415,208,207
9,Burgos,65,Campillo de Aranda,177,99,78
9,Burgos,66,Campolara,54,37,17
9,Burgos,67,Canicosa de la Sierra,426,228,198
9,Burgos,68,Cantabrana,23,14,9
9,Burgos,70,Carazo,30,20,10
9,Burgos,71,Carcedo de Bureba,43,21,22
9,Burgos,72,Carcedo de Burgos,465,244,221
9,Burgos,73,Cardeñadijo,1425,772,653
9,Burgos,74,Cardeñajimeno,1205,639,566
9,Burgos,75,Cardeñuela Riopico,107,62,45
9,Burgos,76,Carrias,25,19,6
9,Burgos,77,Cascajares de Bureba,27,13,14
9,Burgos,78,Cascajares de la Sierra,31,17,14
9,Burgos,79,Castellanos de Castro,48,29,19
9,Burgos,83,Castil de Peones,26,15,11
9,Burgos,82,Castildelgado,37,21,16
9,Burgos,84,Castrillo de la Reina,168,111,57
9,Burgos,85,Castrillo de la Vega,627,335,292
9,Burgos,88,Castrillo de Riopisuerga,56,34,22
9,Burgos,86,Castrillo del Val,829,470,359
9,Burgos,90,Castrillo Mota de Judíos,48,25,23
9,Burgos,91,Castrojeriz,767,414,353
9,Burgos,63,Cavia,243,142,101
9,Burgos,93,Cayuela,189,104,85
9,Burgos,94,Cebrecos,52,33,19
9,Burgos,95,Celada del Camino,96,45,51
9,Burgos,98,Cerezo de Río Tirón,512,277,235
9,Burgos,100,Cerratón de Juarros,55,36,19
9,Burgos,101,Ciadoncha,78,48,30
9,Burgos,102,Cillaperlata,36,24,12
9,Burgos,103,Cilleruelo de Abajo,208,125,83
9,Burgos,104,Cilleruelo de Arriba,43,23,20
9,Burgos,105,Ciruelos de Cervera,101,60,41
9,Burgos,108,Cogollos,601,336,265
9,Burgos,109,Condado de Treviño,1428,781,647
9,Burgos,110,Contreras,83,54,29
9,Burgos,112,Coruña del Conde,104,66,38
9,Burgos,113,Covarrubias,533,284,249
9,Burgos,114,Cubillo del Campo,101,58,43
9,Burgos,115,Cubo de Bureba,107,62,45
9,Burgos,117,"Cueva de Roa, La",101,54,47
9,Burgos,119,Cuevas de San Clemente,41,17,24
9,Burgos,120,Encío,43,20,23
9,Burgos,122,Espinosa de Cervera,82,53,29
9,Burgos,124,Espinosa de los Monteros,1642,852,790
9,Burgos,123,Espinosa del Camino,42,24,18
9,Burgos,125,Estépar,630,371,259
9,Burgos,127,Fontioso,45,28,17
9,Burgos,128,Frandovínez,97,55,42
9,Burgos,129,Fresneda de la Sierra Tirón,94,60,34
9,Burgos,130,Fresneña,67,44,23
9,Burgos,131,Fresnillo de las Dueñas,687,352,335
9,Burgos,132,Fresno de Río Tirón,172,101,71
9,Burgos,133,Fresno de Rodilla,47,27,20
9,Burgos,134,Frías,267,141,126
9,Burgos,135,Fuentebureba,42,23,19
9,Burgos,136,Fuentecén,219,119,100
9,Burgos,137,Fuentelcésped,254,128,126
9,Burgos,138,Fuentelisendo,115,63,52
9,Burgos,139,Fuentemolinos,94,65,29
9,Burgos,140,Fuentenebro,146,86,60
9,Burgos,141,Fuentespina,779,411,368
9,Burgos,143,Galbarros,29,18,11
9,Burgos,144,"Gallega, La",44,29,15
9,Burgos,148,Grijalba,110,55,55
9,Burgos,149,Grisaleña,61,40,21
9,Burgos,151,Gumiel de Izán,579,318,261
9,Burgos,152,Gumiel de Mercado,381,204,177
9,Burgos,154,Hacinas,151,92,59
9,Burgos,155,Haza,29,20,9
9,Burgos,159,Hontanas,73,43,30
9,Burgos,160,Hontangas,95,60,35
9,Burgos,162,Hontoria de la Cantera,155,85,70
9,Burgos,164,Hontoria de Valdearados,165,100,65
9,Burgos,163,Hontoria del Pinar,622,338,284
9,Burgos,166,"Hormazas, Las",98,52,46
9,Burgos,167,Hornillos del Camino,54,29,25
9,Burgos,168,"Horra, La",314,175,139
9,Burgos,169,Hortigüela,107,71,36
9,Burgos,170,Hoyales de Roa,214,114,100
9,Burgos,172,Huérmeces,173,101,72
9,Burgos,173,Huerta de Arriba,127,70,57
9,Burgos,174,Huerta de Rey,894,481,413
9,Burgos,175,Humada,118,80,38
9,Burgos,176,Hurones,53,37,16
9,Burgos,177,Ibeas de Juarros,1418,756,662
9,Burgos,178,Ibrillos,36,25,11
9,Burgos,179,Iglesiarrubia,45,23,22
9,Burgos,180,Iglesias,146,78,68
9,Burgos,181,Isar,283,148,135
9,Burgos,182,Itero del Castillo,86,50,36
9,Burgos,183,Jaramillo de la Fuente,44,30,14
9,Burgos,184,Jaramillo Quemado,9,8,1
9,Burgos,189,Junta de Traslaloma,118,65,53
9,Burgos,190,Junta de Villalba de Losa,84,45,39
9,Burgos,191,Jurisdicción de Lara,40,24,16
9,Burgos,192,Jurisdicción de San Zadornil,66,41,25
9,Burgos,194,Lerma,2584,1294,1290
9,Burgos,195,Llano de Bureba,51,36,15
9,Burgos,196,Madrigal del Monte,142,85,57
9,Burgos,197,Madrigalejo del Monte,183,113,70
9,Burgos,198,Mahamud,107,57,50
9,Burgos,199,Mambrilla de Castrejón,107,64,43
9,Burgos,200,Mambrillas de Lara,47,29,18
9,Burgos,201,Mamolar,26,16,10
9,Burgos,202,Manciles,22,14,8
9,Burgos,206,Mazuela,58,34,24
9,Burgos,208,Mecerreyes,194,108,86
9,Burgos,209,Medina de Pomar,5856,2948,2908
9,Burgos,211,Melgar de Fernamental,1535,848,687
9,Burgos,213,Merindad de Cuesta-Urria,268,153,115
9,Burgos,214,Merindad de Montija,733,438,295
9,Burgos,906,Merindad de Río Ubierna,1392,787,605
9,Burgos,215,Merindad de Sotoscueva,404,231,173
9,Burgos,216,Merindad de Valdeporres,413,216,197
9,Burgos,217,Merindad de Valdivielso,386,215,171
9,Burgos,218,Milagros,433,231,202
9,Burgos,219,Miranda de Ebro,35239,17332,17907
9,Burgos,220,Miraveche,94,60,34
9,Burgos,221,Modúbar de la Emparedada,789,428,361
9,Burgos,223,Monasterio de la Sierra,42,26,16
9,Burgos,224,Monasterio de Rodilla,163,88,75
9,Burgos,225,Moncalvillo,81,47,34
9,Burgos,226,Monterrubio de la Demanda,56,34,22
9,Burgos,227,Montorio,154,87,67
9,Burgos,228,Moradillo de Roa,161,88,73
9,Burgos,229,Nava de Roa,200,107,93
9,Burgos,230,Navas de Bureba,27,13,14
9,Burgos,231,Nebreda,53,35,18
9,Burgos,232,Neila,139,79,60
9,Burgos,235,Olmedillo de Roa,196,113,83
9,Burgos,236,Olmillos de Muñó,36,21,15
9,Burgos,238,Oña,976,514,462
9,Burgos,239,Oquillas,51,27,24
9,Burgos,241,Orbaneja Riopico,355,202,153
9,Burgos,242,Padilla de Abajo,70,42,28
9,Burgos,243,Padilla de Arriba,84,54,30
9,Burgos,244,Padrones de Bureba,47,22,25
9,Burgos,246,Palacios de la Sierra,710,367,343
9,Burgos,247,Palacios de Riopisuerga,21,11,10
9,Burgos,248,Palazuelos de la Sierra,92,56,36
9,Burgos,249,Palazuelos de Muñó,55,30,25
9,Burgos,250,Pampliega,286,158,128
9,Burgos,251,Pancorbo,421,220,201
9,Burgos,253,Pardilla,119,72,47
9,Burgos,255,Partido de la Sierra en Tobalina,81,50,31
9,Burgos,256,Pedrosa de Duero,492,301,191
9,Burgos,259,Pedrosa de Río Úrbel,258,152,106
9,Burgos,257,Pedrosa del Páramo,87,53,34
9,Burgos,258,Pedrosa del Príncipe,168,95,73
9,Burgos,261,Peñaranda de Duero,510,259,251
9,Burgos,262,Peral de Arlanza,175,97,78
9,Burgos,265,Piérnigas,42,25,17
9,Burgos,266,Pineda de la Sierra,99,65,34
9,Burgos,267,Pineda Trasmonte,110,65,45
9,Burgos,268,Pinilla de los Barruecos,98,59,39
9,Burgos,269,Pinilla de los Moros,37,20,17
9,Burgos,270,Pinilla Trasmonte,171,98,73
9,Burgos,272,Poza de la Sal,284,157,127
9,Burgos,273,Prádanos de Bureba,55,33,22
9,Burgos,274,Pradoluengo,1096,560,536
9,Burgos,275,Presencio,199,119,80
9,Burgos,276,"Puebla de Arganzón, La",526,280,246
9,Burgos,277,Puentedura,120,77,43
9,Burgos,279,Quemada,259,159,100
9,Burgos,281,Quintana del Pidio,150,80,70
9,Burgos,280,Quintanabureba,33,19,14
9,Burgos,283,Quintanaélez,45,24,21
9,Burgos,287,Quintanaortuño,268,144,124
9,Burgos,288,Quintanapalla,113,55,58
9,Burgos,289,Quintanar de la Sierra,1557,816,741
9,Burgos,292,Quintanavides,70,40,30
9,Burgos,294,Quintanilla de la Mata,117,72,45
9,Burgos,901,Quintanilla del Agua y Tordueles,343,190,153
9,Burgos,295,Quintanilla del Coco,52,26,26
9,Burgos,298,Quintanilla San García,73,43,30
9,Burgos,301,Quintanilla Vivar,878,474,404
9,Burgos,297,"Quintanillas, Las",380,224,156
9,Burgos,302,Rabanera del Pinar,96,58,38
9,Burgos,303,Rábanos,80,48,32
9,Burgos,304,Rabé de las Calzadas,226,116,110
9,Burgos,306,Rebolledo de la Torre,94,54,40
9,Burgos,307,Redecilla del Camino,107,64,43
9,Burgos,308,Redecilla del Campo,65,37,28
9,Burgos,309,Regumiel de la Sierra,323,177,146
9,Burgos,310,Reinoso,15,11,4
9,Burgos,311,Retuerta,65,40,25
9,Burgos,314,Revilla del Campo,102,62,40
9,Burgos,316,Revilla Vallejera,111,65,46
9,Burgos,312,"Revilla y Ahedo, La",94,54,40
9,Burgos,315,Revillarruz,601,316,285
9,Burgos,317,Rezmondo,20,8,12
9,Burgos,318,Riocavado de la Sierra,56,37,19
9,Burgos,321,Roa,2201,1122,1079
9,Burgos,323,Rojas,64,43,21
9,Burgos,325,Royuela de Río Franco,178,105,73
9,Burgos,326,Rubena,193,110,83
9,Burgos,327,Rublacedo de Abajo,28,13,15
9,Burgos,328,Rucandio,67,32,35
9,Burgos,329,Salas de Bureba,134,77,57
9,Burgos,330,Salas de los Infantes,1970,1024,946
9,Burgos,332,Saldaña de Burgos,184,111,73
9,Burgos,334,Salinillas de Bureba,50,37,13
9,Burgos,335,San Adrián de Juarros,95,61,34
9,Burgos,337,San Juan del Monte,151,84,67
9,Burgos,338,San Mamés de Burgos,317,180,137
9,Burgos,339,San Martín de Rubiales,140,86,54
9,Burgos,340,San Millán de Lara,65,48,17
9,Burgos,360,San Vicente del Valle,29,20,9
9,Burgos,343,Santa Cecilia,105,64,41
9,Burgos,345,Santa Cruz de la Salceda,139,81,58
9,Burgos,346,Santa Cruz del Valle Urbión,103,68,35
9,Burgos,347,Santa Gadea del Cid,155,84,71
9,Burgos,348,Santa Inés,146,82,64
9,Burgos,350,Santa María del Campo,516,281,235
9,Burgos,351,Santa María del Invierno,62,45,17
9,Burgos,352,Santa María del Mercadillo,97,66,31
9,Burgos,353,Santa María Rivarredonda,93,58,35
9,Burgos,354,Santa Olalla de Bureba,40,27,13
9,Burgos,355,Santibáñez de Esgueva,85,47,38
9,Burgos,356,Santibáñez del Val,57,34,23
9,Burgos,358,Santo Domingo de Silos,264,168,96
9,Burgos,361,Sargentes de la Lora,119,67,52
9,Burgos,362,Sarracín,264,139,125
9,Burgos,363,Sasamón,957,546,411
9,Burgos,365,"Sequera de Haza, La",26,19,7
9,Burgos,366,Solarana,80,48,32
9,Burgos,368,Sordillos,26,16,10
9,Burgos,369,Sotillo de la Ribera,485,252,233
9,Burgos,372,Sotragero,294,163,131
9,Burgos,373,Sotresgudo,433,257,176
9,Burgos,374,Susinos del Páramo,115,72,43
9,Burgos,375,Tamarón,44,25,19
9,Burgos,377,Tardajos,812,441,371
9,Burgos,378,Tejada,34,19,15
9,Burgos,380,Terradillos de Esgueva,69,34,35
9,Burgos,381,Tinieblas de la Sierra,27,14,13
9,Burgos,382,Tobar,26,19,7
9,Burgos,384,Tordómar,324,179,145
9,Burgos,386,Torrecilla del Monte,78,44,34
9,Burgos,387,Torregalindo,123,76,47
9,Burgos,388,Torrelara,34,20,14
9,Burgos,389,Torrepadre,72,42,30
9,Burgos,390,Torresandino,583,306,277
9,Burgos,391,Tórtoles de Esgueva,406,225,181
9,Burgos,392,Tosantos,51,27,24
9,Burgos,394,Trespaderne,735,366,369
9,Burgos,395,Tubilla del Agua,135,86,49
9,Burgos,396,Tubilla del Lago,165,87,78
9,Burgos,398,Úrbel del Castillo,67,43,24
9,Burgos,400,Vadocondes,369,200,169
9,Burgos,403,Valdeande,99,59,40
9,Burgos,405,Valdezate,122,69,53
9,Burgos,406,Valdorros,333,191,142
9,Burgos,408,Vallarta de Bureba,43,27,16
9,Burgos,904,Valle de las Navas,536,316,220
9,Burgos,908,Valle de Losa,497,284,213
9,Burgos,409,Valle de Manzanedo,132,68,64
9,Burgos,410,Valle de Mena,4030,2033,1997
9,Burgos,411,Valle de Oca,165,97,68
9,Burgos,902,Valle de Santibáñez,476,278,198
9,Burgos,905,Valle de Sedano,417,239,178
9,Burgos,412,Valle de Tobalina,896,494,402
9,Burgos,413,Valle de Valdebezana,459,249,210
9,Burgos,414,Valle de Valdelaguna,196,119,77
9,Burgos,415,Valle de Valdelucio,333,186,147
9,Burgos,416,Valle de Zamanzas,46,31,15
9,Burgos,417,Vallejera,39,22,17
9,Burgos,418,Valles de Palenzuela,81,40,41
9,Burgos,419,Valluércanes,67,45,22
9,Burgos,407,Valmala,27,13,14
9,Burgos,422,"Vid de Bureba, La",24,14,10
9,Burgos,421,"Vid y Barrios, La",260,150,110
9,Burgos,423,Vileña,25,15,10
9,Burgos,427,Villadiego,1478,817,661
9,Burgos,428,Villaescusa de Roa,100,54,46
9,Burgos,429,Villaescusa la Sombría,57,40,17
9,Burgos,430,Villaespasa,28,17,11
9,Burgos,431,Villafranca Montes de Oca,116,70,46
9,Burgos,432,Villafruela,154,92,62
9,Burgos,433,Villagalijo,52,30,22
9,Burgos,434,Villagonzalo Pedernales,1856,978,878
9,Burgos,437,Villahoz,299,165,134
9,Burgos,438,Villalba de Duero,714,378,336
9,Burgos,439,Villalbilla de Burgos,1462,787,675
9,Burgos,440,Villalbilla de Gumiel,86,54,32
9,Burgos,441,Villaldemiro,95,55,40
9,Burgos,442,Villalmanzo,423,228,195
9,Burgos,443,Villamayor de los Montes,160,80,80
9,Burgos,444,Villamayor de Treviño,61,32,29
9,Burgos,445,Villambistia,45,33,12
9,Burgos,446,Villamedianilla,9,6,3
9,Burgos,447,Villamiel de la Sierra,44,27,17
9,Burgos,448,Villangómez,223,135,88
9,Burgos,449,Villanueva de Argaño,118,67,51
9,Burgos,450,Villanueva de Carazo,24,15,9
9,Burgos,451,Villanueva de Gumiel,284,147,137
9,Burgos,454,Villanueva de Teba,43,28,15
9,Burgos,455,Villaquirán de la Puebla,46,26,20
9,Burgos,456,Villaquirán de los Infantes,151,80,71
9,Burgos,903,Villarcayo de Merindad de Castilla la Vieja,3942,2029,1913
9,Burgos,458,Villariezo,717,391,326
9,Burgos,460,Villasandino,172,97,75
9,Burgos,463,Villasur de Herreros,278,169,109
9,Burgos,464,Villatuelda,46,24,22
9,Burgos,466,Villaverde del Monte,115,69,46
9,Burgos,467,Villaverde-Mogina,74,51,23
9,Burgos,471,Villayerno Morquillas,210,108,102
9,Burgos,472,Villazopeque,54,30,24
9,Burgos,473,Villegas,94,51,43
9,Burgos,476,Villoruebo,69,45,24
9,Burgos,424,Viloria de Rioja,37,23,14
9,Burgos,425,Vilviestre del Pinar,528,295,233
9,Burgos,478,Vizcaínos,47,35,12
9,Burgos,480,Zael,121,61,60
9,Burgos,482,Zarzosa de Río Pisuerga,32,21,11
9,Burgos,483,Zazuar,199,103,96
9,Burgos,485,Zuñeda,57,30,27
10,Cáceres,1,Abadía,340,185,155
10,Cáceres,2,Abertura,388,195,193
10,Cáceres,3,Acebo,542,263,279
10,Cáceres,4,Acehúche,816,416,400
10,Cáceres,5,Aceituna,588,301,287
10,Cáceres,6,Ahigal,1371,685,686
10,Cáceres,903,Alagón del Río,924,456,468
10,Cáceres,7,Albalá,665,345,320
10,Cáceres,8,Alcántara,1361,670,691
10,Cáceres,9,Alcollarín,269,138,131
10,Cáceres,10,Alcuéscar,2470,1278,1192
10,Cáceres,12,Aldea del Cano,617,295,322
10,Cáceres,13,"Aldea del Obispo, La",305,165,140
10,Cáceres,11,Aldeacentenera,585,308,277
10,Cáceres,14,Aldeanueva de la Vera,2025,999,1026
10,Cáceres,15,Aldeanueva del Camino,742,368,374
10,Cáceres,16,Aldehuela de Jerte,365,191,174
10,Cáceres,17,Alía,761,400,361
10,Cáceres,18,Aliseda,1751,897,854
10,Cáceres,19,Almaraz,1687,864,823
10,Cáceres,20,Almoharín,1782,879,903
10,Cáceres,21,Arroyo de la Luz,5596,2769,2827
10,Cáceres,23,Arroyomolinos,827,425,402
10,Cáceres,22,Arroyomolinos de la Vera,412,206,206
10,Cáceres,24,Baños de Montemayor,739,346,393
10,Cáceres,25,Barrado,353,183,170
10,Cáceres,26,Belvís de Monroy,737,388,349
10,Cáceres,27,Benquerencia,79,47,32
10,Cáceres,28,Berrocalejo,106,57,49
10,Cáceres,29,Berzocana,404,211,193
10,Cáceres,30,Bohonal de Ibor,491,243,248
10,Cáceres,31,Botija,185,98,87
10,Cáceres,32,Brozas,1774,874,900
10,Cáceres,33,Cabañas del Castillo,402,207,195
10,Cáceres,34,Cabezabellosa,343,170,173
10,Cáceres,35,Cabezuela del Valle,2152,1091,1061
10,Cáceres,36,Cabrero,347,192,155
10,Cáceres,37,Cáceres,95456,45716,49740
10,Cáceres,38,Cachorrilla,91,45,46
10,Cáceres,39,Cadalso,414,208,206
10,Cáceres,40,Calzadilla,473,244,229
10,Cáceres,41,Caminomorisco,1155,606,549
10,Cáceres,42,Campillo de Deleitosa,81,37,44
10,Cáceres,43,Campo Lugar,822,410,412
10,Cáceres,44,Cañamero,1641,866,775
10,Cáceres,45,Cañaveral,1018,505,513
10,Cáceres,46,Carbajo,196,101,95
10,Cáceres,47,Carcaboso,1088,551,537
10,Cáceres,48,Carrascalejo,233,121,112
10,Cáceres,49,Casar de Cáceres,4481,2206,2275
10,Cáceres,50,Casar de Palomero,1036,528,508
10,Cáceres,51,Casares de las Hurdes,374,194,180
10,Cáceres,52,Casas de Don Antonio,184,93,91
10,Cáceres,53,Casas de Don Gómez,286,153,133
10,Cáceres,56,Casas de Millán,558,283,275
10,Cáceres,57,Casas de Miravete,119,75,44
10,Cáceres,54,Casas del Castañar,538,272,266
10,Cáceres,55,Casas del Monte,775,402,373
10,Cáceres,58,Casatejada,1342,691,651
10,Cáceres,59,Casillas de Coria,337,168,169
10,Cáceres,60,Castañar de Ibor,1025,526,499
10,Cáceres,61,Ceclavín,1779,901,878
10,Cáceres,62,Cedillo,432,222,210
10,Cáceres,63,Cerezo,151,75,76
10,Cáceres,64,Cilleros,1590,804,786
10,Cáceres,65,Collado de la Vera,237,132,105
10,Cáceres,66,Conquista de la Sierra,201,115,86
10,Cáceres,67,Coria,12308,6038,6270
10,Cáceres,68,Cuacos de Yuste,828,421,407
10,Cáceres,69,"Cumbre, La",831,420,411
10,Cáceres,70,Deleitosa,675,349,326
10,Cáceres,71,Descargamaría,106,60,46
10,Cáceres,72,Eljas,876,447,429
10,Cáceres,73,Escurial,869,454,415
10,Cáceres,75,Fresnedoso de Ibor,262,141,121
10,Cáceres,76,Galisteo,860,427,433
10,Cáceres,77,Garciaz,696,357,339
10,Cáceres,79,Garganta la Olla,919,487,432
10,Cáceres,78,"Garganta, La",363,194,169
10,Cáceres,80,Gargantilla,379,195,184
10,Cáceres,81,Gargüera,177,95,82
10,Cáceres,82,Garrovillas de Alconétar,1988,973,1015
10,Cáceres,83,Garvín,96,52,44
10,Cáceres,84,Gata,1395,713,682
10,Cáceres,85,"Gordo, El",371,197,174
10,Cáceres,86,"Granja, La",326,164,162
10,Cáceres,87,Guadalupe,1787,892,895
10,Cáceres,88,Guijo de Coria,186,99,87
10,Cáceres,89,Guijo de Galisteo,1525,761,764
10,Cáceres,90,Guijo de Granadilla,494,259,235
10,Cáceres,91,Guijo de Santa Bárbara,382,200,182
10,Cáceres,92,Herguijuela,267,141,126
10,Cáceres,93,Hernán-Pérez,424,206,218
10,Cáceres,94,Herrera de Alcántara,230,124,106
10,Cáceres,95,Herreruela,321,165,156
10,Cáceres,96,Hervás,3972,1946,2026
10,Cáceres,97,Higuera de Albalat,104,60,44
10,Cáceres,98,Hinojal,377,194,183
10,Cáceres,99,Holguera,618,309,309
10,Cáceres,100,Hoyos,878,431,447
10,Cáceres,101,Huélaga,212,102,110
10,Cáceres,102,Ibahernando,542,269,273
10,Cáceres,103,Jaraicejo,447,218,229
10,Cáceres,104,Jaraíz de la Vera,6585,3310,3275
10,Cáceres,105,Jarandilla de la Vera,2860,1409,1451
10,Cáceres,106,Jarilla,137,70,67
10,Cáceres,107,Jerte,1256,624,632
10,Cáceres,108,Ladrillar,184,105,79
10,Cáceres,109,Logrosán,1936,985,951
10,Cáceres,110,Losar de la Vera,2653,1345,1308
10,Cáceres,111,Madrigal de la Vera,1543,808,735
10,Cáceres,112,Madrigalejo,1712,873,839
10,Cáceres,113,Madroñera,2383,1191,1192
10,Cáceres,114,Majadas,1312,656,656
10,Cáceres,115,Malpartida de Cáceres,4074,2032,2042
10,Cáceres,116,Malpartida de Plasencia,4635,2292,2343
10,Cáceres,117,Marchagaz,243,134,109
10,Cáceres,118,Mata de Alcántara,292,152,140
10,Cáceres,119,Membrío,591,294,297
10,Cáceres,120,Mesas de Ibor,157,80,77
10,Cáceres,121,Miajadas,9458,4695,4763
10,Cáceres,122,Millanes,247,123,124
10,Cáceres,123,Mirabel,662,332,330
10,Cáceres,124,Mohedas de Granadilla,828,417,411
10,Cáceres,125,Monroy,903,463,440
10,Cáceres,126,Montánchez,1628,814,814
10,Cáceres,127,Montehermoso,5666,2895,2771
10,Cáceres,128,Moraleja,6691,3329,3362
10,Cáceres,129,Morcillo,362,171,191
10,Cáceres,130,Navaconcejo,2054,1040,1014
10,Cáceres,131,Navalmoral de la Mata,16784,8108,8676
10,Cáceres,132,Navalvillar de Ibor,387,192,195
10,Cáceres,133,Navas del Madroño,1256,619,637
10,Cáceres,134,Navezuelas,641,328,313
10,Cáceres,135,Nuñomoral,1218,651,567
10,Cáceres,136,Oliva de Plasencia,285,165,120
10,Cáceres,137,Palomero,391,204,187
10,Cáceres,138,Pasarón de la Vera,600,292,308
10,Cáceres,139,Pedroso de Acim,73,43,30
10,Cáceres,140,Peraleda de la Mata,1416,718,698
10,Cáceres,141,Peraleda de San Román,304,174,130
10,Cáceres,142,Perales del Puerto,931,469,462
10,Cáceres,143,Pescueza,125,54,71
10,Cáceres,144,"Pesga, La",1006,522,484
10,Cáceres,145,Piedras Albas,129,63,66
10,Cáceres,146,Pinofranqueado,1686,883,803
10,Cáceres,147,Piornal,1503,763,740
10,Cáceres,148,Plasencia,39247,18853,20394
10,Cáceres,149,Plasenzuela,483,239,244
10,Cáceres,150,Portaje,371,188,183
10,Cáceres,151,Portezuelo,219,117,102
10,Cáceres,152,Pozuelo de Zarzón,437,221,216
10,Cáceres,905,Pueblonuevo de Miramontes,767,383,384
10,Cáceres,153,Puerto de Santa Cruz,277,143,134
10,Cáceres,154,Rebollar,200,103,97
10,Cáceres,155,Riolobos,1197,599,598
10,Cáceres,156,Robledillo de Gata,86,52,34
10,Cáceres,157,Robledillo de la Vera,252,126,126
10,Cáceres,158,Robledillo de Trujillo,349,182,167
10,Cáceres,159,Robledollano,282,152,130
10,Cáceres,160,Romangordo,255,131,124
10,Cáceres,901,Rosalejo,1378,710,668
10,Cáceres,161,Ruanes,80,41,39
10,Cáceres,162,Salorino,554,288,266
10,Cáceres,163,Salvatierra de Santiago,264,137,127
10,Cáceres,164,San Martín de Trevejo,750,371,379
10,Cáceres,165,Santa Ana,279,143,136
10,Cáceres,166,Santa Cruz de la Sierra,320,162,158
10,Cáceres,167,Santa Cruz de Paniagua,288,163,125
10,Cáceres,168,Santa Marta de Magasca,302,153,149
10,Cáceres,169,Santiago de Alcántara,475,232,243
10,Cáceres,170,Santiago del Campo,239,125,114
10,Cáceres,171,Santibáñez el Alto,342,186,156
10,Cáceres,172,Santibáñez el Bajo,734,380,354
10,Cáceres,173,Saucedilla,888,465,423
10,Cáceres,174,Segura de Toro,177,90,87
10,Cáceres,175,Serradilla,1490,748,742
10,Cáceres,176,Serrejón,414,218,196
10,Cáceres,177,Sierra de Fuentes,2020,1044,976
10,Cáceres,178,Talaván,789,407,382
10,Cáceres,179,Talaveruela de la Vera,307,155,152
10,Cáceres,180,Talayuela,7266,3835,3431
10,Cáceres,181,Tejeda de Tiétar,778,413,365
10,Cáceres,904,Tiétar,869,470,399
10,Cáceres,182,Toril,154,97,57
10,Cáceres,183,Tornavacas,1017,541,476
10,Cáceres,184,"Torno, El",847,442,405
10,Cáceres,187,Torre de Don Miguel,487,258,229
10,Cáceres,188,Torre de Santa María,531,262,269
10,Cáceres,185,Torrecilla de los Ángeles,648,339,309
10,Cáceres,186,Torrecillas de la Tiesa,1067,539,528
10,Cáceres,190,Torrejón el Rubio,532,264,268
10,Cáceres,189,Torrejoncillo,2854,1388,1466
10,Cáceres,191,Torremenga,592,310,282
10,Cáceres,192,Torremocha,763,383,380
10,Cáceres,193,Torreorgaz,1673,825,848
10,Cáceres,194,Torrequemada,574,280,294
10,Cáceres,195,Trujillo,8695,4269,4426
10,Cáceres,196,Valdastillas,323,165,158
10,Cáceres,197,Valdecañas de Tajo,119,61,58
10,Cáceres,198,Valdefuentes,1122,538,584
10,Cáceres,199,Valdehúncar,185,101,84
10,Cáceres,200,Valdelacasa de Tajo,341,181,160
10,Cáceres,201,Valdemorales,210,104,106
10,Cáceres,202,Valdeobispo,651,318,333
10,Cáceres,203,Valencia de Alcántara,5272,2587,2685
10,Cáceres,204,Valverde de la Vera,445,230,215
10,Cáceres,205,Valverde del Fresno,2162,1088,1074
10,Cáceres,902,Vegaviana,849,435,414
10,Cáceres,206,Viandar de la Vera,215,108,107
10,Cáceres,207,Villa del Campo,451,217,234
10,Cáceres,208,Villa del Rey,115,57,58
10,Cáceres,209,Villamesías,256,131,125
10,Cáceres,210,Villamiel,392,196,196
10,Cáceres,211,Villanueva de la Sierra,476,242,234
10,Cáceres,212,Villanueva de la Vera,2108,1062,1046
10,Cáceres,214,Villar de Plasencia,237,124,113
10,Cáceres,213,Villar del Pedroso,554,285,269
10,Cáceres,215,Villasbuenas de Gata,379,189,190
10,Cáceres,216,Zarza de Granadilla,1803,916,887
10,Cáceres,217,Zarza de Montánchez,516,266,250
10,Cáceres,218,Zarza la Mayor,1176,585,591
10,Cáceres,219,Zorita,1297,646,651
11,Cádiz,1,Alcalá de los Gazules,5227,2672,2555
11,Cádiz,2,Alcalá del Valle,4982,2493,2489
11,Cádiz,3,Algar,1433,731,702
11,Cádiz,4,Algeciras,122368,60299,62069
11,Cádiz,5,Algodonales,5504,2788,2716
11,Cádiz,6,Arcos de la Frontera,30953,15424,15529
11,Cádiz,7,Barbate,22872,11438,11434
11,Cádiz,8,"Barrios, Los",24069,12092,11977
11,Cádiz,901,Benalup-Casas Viejas,7160,3627,3533
11,Cádiz,9,Benaocaz,695,374,321
11,Cádiz,10,Bornos,7607,3800,3807
11,Cádiz,11,"Bosque, El",2209,1114,1095
11,Cádiz,12,Cádiz,113066,53373,59693
11,Cádiz,13,Castellar de la Frontera,3043,1505,1538
11,Cádiz,15,Chiclana de la Frontera,87493,43699,43794
11,Cádiz,16,Chipiona,19592,9797,9795
11,Cádiz,14,Conil de la Frontera,23497,11801,11696
11,Cádiz,17,Espera,3820,1896,1924
11,Cádiz,18,"Gastor, El",1699,855,844
11,Cádiz,19,Grazalema,2005,998,1007
11,Cádiz,20,Jerez de la Frontera,212730,103879,108851
11,Cádiz,21,Jimena de la Frontera,6681,3409,3272
11,Cádiz,22,"Línea de la Concepción, La",63271,31012,32259
11,Cádiz,23,Medina Sidonia,11739,5927,5812
11,Cádiz,24,Olvera,7974,3920,4054
11,Cádiz,25,Paterna de Rivera,5451,2824,2627
11,Cádiz,26,Prado del Rey,5647,2797,2850
11,Cádiz,27,"Puerto de Santa María, El",89435,43737,45698
11,Cádiz,28,Puerto Real,41963,21091,20872
11,Cádiz,29,Puerto Serrano,6971,3530,3441
11,Cádiz,30,Rota,29491,14641,14850
11,Cádiz,31,San Fernando,94120,45869,48251
11,Cádiz,902,San José del Valle,4453,2281,2172
11,Cádiz,903,San Martín del Tesorillo,2797,1446,1351
11,Cádiz,33,San Roque,33018,16416,16602
11,Cádiz,32,Sanlúcar de Barrameda,69727,34730,34997
11,Cádiz,34,Setenil de las Bodegas,2675,1382,1293
11,Cádiz,35,Tarifa,18564,9318,9246
11,Cádiz,36,Torre Alháquime,803,405,398
11,Cádiz,37,Trebujena,7010,3490,3520
11,Cádiz,38,Ubrique,16383,8070,8313
11,Cádiz,39,Vejer de la Frontera,12656,6303,6353
11,Cádiz,40,Villaluenga del Rosario,462,237,225
11,Cádiz,41,Villamartín,12095,6069,6026
11,Cádiz,42,Zahara,1371,688,683
39,Cantabria,1,Alfoz de Lloredo,2466,1284,1182
39,Cantabria,2,Ampuero,4384,2196,2188
39,Cantabria,3,Anievas,267,147,120
39,Cantabria,4,Arenas de Iguña,1734,870,864
39,Cantabria,5,Argoños,1848,945,903
39,Cantabria,6,Arnuero,2170,1092,1078
39,Cantabria,7,Arredondo,471,271,200
39,Cantabria,8,"Astillero, El",18153,8861,9292
39,Cantabria,9,Bárcena de Cicero,4503,2316,2187
39,Cantabria,10,Bárcena de Pie de Concha,663,335,328
39,Cantabria,11,Bareyo,2149,1081,1068
39,Cantabria,12,Cabezón de la Sal,8208,3925,4283
39,Cantabria,13,Cabezón de Liébana,574,322,252
39,Cantabria,14,Cabuérniga,994,524,470
39,Cantabria,15,Camaleño,966,547,419
39,Cantabria,16,Camargo,30374,14824,15550
39,Cantabria,27,Campoo de Enmedio,3704,1887,1817
39,Cantabria,17,Campoo de Yuso,688,372,316
39,Cantabria,18,Cartes,5781,2896,2885
39,Cantabria,19,Castañeda,3067,1559,1508
39,Cantabria,20,Castro-Urdiales,33109,16397,16712
39,Cantabria,21,Cieza,548,280,268
39,Cantabria,22,Cillorigo de Liébana,1306,679,627
39,Cantabria,23,Colindres,8512,4192,4320
39,Cantabria,24,Comillas,2126,1006,1120
39,Cantabria,25,"Corrales de Buelna, Los",10742,5232,5510
39,Cantabria,26,Corvera de Toranzo,2115,1066,1049
39,Cantabria,28,Entrambasaguas,5418,2710,2708
39,Cantabria,29,Escalante,759,393,366
39,Cantabria,30,Guriezo,2432,1282,1150
39,Cantabria,31,Hazas de Cesto,1697,842,855
39,Cantabria,32,Hermandad de Campoo de Suso,1601,883,718
39,Cantabria,33,Herrerías,594,336,258
39,Cantabria,34,Lamasón,258,165,93
39,Cantabria,35,Laredo,10967,5219,5748
39,Cantabria,36,Liendo,1235,637,598
39,Cantabria,37,Liérganes,2423,1202,1221
39,Cantabria,38,Limpias,1993,996,997
39,Cantabria,39,Luena,622,333,289
39,Cantabria,40,Marina de Cudeyo,5170,2583,2587
39,Cantabria,41,Mazcuerras,2095,1081,1014
39,Cantabria,42,Medio Cudeyo,7663,3713,3950
39,Cantabria,43,Meruelo,2212,1097,1115
39,Cantabria,44,Miengo,5123,2642,2481
39,Cantabria,45,Miera,391,203,188
39,Cantabria,46,Molledo,1495,730,765
39,Cantabria,47,Noja,2664,1332,1332
39,Cantabria,48,Penagos,2207,1112,1095
39,Cantabria,49,Peñarrubia,317,168,149
39,Cantabria,50,Pesaguero,287,166,121
39,Cantabria,51,Pesquera,79,47,32
39,Cantabria,52,Piélagos,26279,13006,13273
39,Cantabria,53,Polaciones,216,134,82
39,Cantabria,54,Polanco,6126,3035,3091
39,Cantabria,55,Potes,1330,627,703
39,Cantabria,56,Puente Viesgo,2894,1465,1429
39,Cantabria,57,Ramales de la Victoria,2958,1488,1470
39,Cantabria,58,Rasines,996,508,488
39,Cantabria,59,Reinosa,8660,4079,4581
39,Cantabria,60,Reocín,8455,4169,4286
39,Cantabria,61,Ribamontán al Mar,4695,2408,2287
39,Cantabria,62,Ribamontán al Monte,2436,1249,1187
39,Cantabria,63,Rionansa,1026,570,456
39,Cantabria,64,Riotuerto,1659,799,860
39,Cantabria,65,"Rozas de Valdearroyo, Las",261,146,115
39,Cantabria,66,Ruente,1045,565,480
39,Cantabria,67,Ruesga,815,450,365
39,Cantabria,68,Ruiloba,759,392,367
39,Cantabria,69,San Felices de Buelna,2373,1198,1175
39,Cantabria,70,San Miguel de Aguayo,154,79,75
39,Cantabria,71,San Pedro del Romeral,460,253,207
39,Cantabria,72,San Roque de Riomiera,337,201,136
39,Cantabria,80,San Vicente de la Barquera,4030,1965,2065
39,Cantabria,73,Santa Cruz de Bezana,13482,6599,6883
39,Cantabria,74,Santa María de Cayón,9192,4569,4623
39,Cantabria,75,Santander,171693,79116,92577
39,Cantabria,76,Santillana del Mar,4250,2070,2180
39,Cantabria,77,Santiurde de Reinosa,242,141,101
39,Cantabria,78,Santiurde de Toranzo,1711,905,806
39,Cantabria,79,Santoña,10857,5273,5584
39,Cantabria,81,Saro,520,271,249
39,Cantabria,82,Selaya,1849,932,917
39,Cantabria,83,Soba,1131,629,502
39,Cantabria,84,Solórzano,1068,564,504
39,Cantabria,85,Suances,9115,4484,4631
39,Cantabria,86,"Tojos, Los",380,229,151
39,Cantabria,87,Torrelavega,51142,24053,27089
39,Cantabria,88,Tresviso,54,36,18
39,Cantabria,89,Tudanca,150,102,48
39,Cantabria,90,Udías,951,479,472
39,Cantabria,95,Val de San Vicente,2801,1420,1381
39,Cantabria,91,Valdáliga,2162,1116,1046
39,Cantabria,92,Valdeolea,905,487,418
39,Cantabria,93,Valdeprado del Río,322,184,138
39,Cantabria,94,Valderredible,945,537,408
39,Cantabria,101,Valle de Villaverde,266,148,118
39,Cantabria,96,Vega de Liébana,713,373,340
39,Cantabria,97,Vega de Pas,730,387,343
39,Cantabria,98,Villacarriedo,1640,848,792
39,Cantabria,99,Villaescusa,3937,1941,1996
39,Cantabria,100,Villafufre,1030,531,499
39,Cantabria,102,Voto,2876,1530,1346
12,Castellón/Castelló,2,Aín,136,72,64
12,Castellón/Castelló,3,Albocàsser,1264,639,625
12,Castellón/Castelló,4,Alcalà de Xivert,6831,3487,3344
12,Castellón/Castelló,5,"Alcora, l'",10468,5266,5202
12,Castellón/Castelló,6,Alcudia de Veo,195,105,90
12,Castellón/Castelló,7,Alfondeguilla,877,435,442
12,Castellón/Castelló,8,Algimia de Almonacid,247,135,112
12,Castellón/Castelló,9,Almassora,27383,13735,13648
12,Castellón/Castelló,10,Almedíjar,269,146,123
12,Castellón/Castelló,11,Almenara,6388,3201,3187
12,Castellón/Castelló,901,"Alqueries, les/Alquerías del Niño Perdido",4511,2263,2248
12,Castellón/Castelló,12,Altura,3667,1890,1777
12,Castellón/Castelló,13,Arañuel,162,85,77
12,Castellón/Castelló,14,Ares del Maestrat,173,103,70
12,Castellón/Castelló,15,Argelita,153,84,69
12,Castellón/Castelló,16,Artana,1979,1013,966
12,Castellón/Castelló,1,Atzeneta del Maestrat,1287,654,633
12,Castellón/Castelló,17,Ayódar,156,89,67
12,Castellón/Castelló,18,Azuébar,318,174,144
12,Castellón/Castelló,20,Barracas,185,98,87
12,Castellón/Castelló,22,Bejís,393,223,170
12,Castellón/Castelló,24,Benafer,171,89,82
12,Castellón/Castelló,25,Benafigos,136,81,55
12,Castellón/Castelló,26,Benassal,1040,529,511
12,Castellón/Castelló,27,Benicarló,27780,13863,13917
12,Castellón/Castelló,28,Benicasim/Benicàssim,19507,9633,9874
12,Castellón/Castelló,29,Benlloc,1092,555,537
12,Castellón/Castelló,21,Betxí,5587,2773,2814
12,Castellón/Castelló,32,Borriana/Burriana,35019,17343,17676
12,Castellón/Castelló,31,Borriol,5749,2953,2796
12,Castellón/Castelló,33,Cabanes,3079,1565,1514
12,Castellón/Castelló,34,Càlig,1990,998,992
12,Castellón/Castelló,36,Canet lo Roig,680,345,335
12,Castellón/Castelló,37,Castell de Cabres,20,12,8
12,Castellón/Castelló,38,Castellfort,188,99,89
12,Castellón/Castelló,39,Castellnovo,893,455,438
12,Castellón/Castelló,40,Castelló de la Plana,171857,82969,88888
12,Castellón/Castelló,41,Castillo de Villamalefa,112,73,39
12,Castellón/Castelló,42,Catí,711,356,355
12,Castellón/Castelló,43,Caudiel,674,350,324
12,Castellón/Castelló,44,Cervera del Maestre,593,284,309
12,Castellón/Castelló,53,Chilches/Xilxes,2846,1464,1382
12,Castellón/Castelló,55,Chodos/Xodos,120,72,48
12,Castellón/Castelló,56,Chóvar,304,158,146
12,Castellón/Castelló,45,Cinctorres,412,200,212
12,Castellón/Castelló,46,Cirat,226,130,96
12,Castellón/Castelló,48,Cortes de Arenoso,293,152,141
12,Castellón/Castelló,49,Costur,528,279,249
12,Castellón/Castelló,50,"Coves de Vinromà, les",1791,909,882
12,Castellón/Castelló,51,Culla,499,255,244
12,Castellón/Castelló,57,Eslida,742,368,374
12,Castellón/Castelló,58,Espadilla,92,52,40
12,Castellón/Castelló,59,Fanzara,283,145,138
12,Castellón/Castelló,60,Figueroles,518,258,260
12,Castellón/Castelló,61,Forcall,465,223,242
12,Castellón/Castelló,63,Fuente la Reina,58,34,24
12,Castellón/Castelló,64,Fuentes de Ayódar,95,53,42
12,Castellón/Castelló,65,Gaibiel,201,111,90
12,Castellón/Castelló,67,Geldo,643,322,321
12,Castellón/Castelló,68,Herbers,63,40,23
12,Castellón/Castelló,69,Higueras,46,24,22
12,Castellón/Castelló,70,"Jana, la",669,343,326
12,Castellón/Castelló,71,Jérica,1655,841,814
12,Castellón/Castelló,74,"Llosa, la",969,471,498
12,Castellón/Castelló,72,Llucena/Lucena del Cid,1325,662,663
12,Castellón/Castelló,73,Ludiente,140,80,60
12,Castellón/Castelló,75,"Mata de Morella, la",179,98,81
12,Castellón/Castelló,76,Matet,78,50,28
12,Castellón/Castelló,77,Moncofa,7338,3747,3591
12,Castellón/Castelló,78,Montán,375,191,184
12,Castellón/Castelló,79,Montanejos,553,294,259
12,Castellón/Castelló,80,Morella,2475,1210,1265
12,Castellón/Castelló,81,Navajas,781,409,372
12,Castellón/Castelló,82,Nules,13449,6728,6721
12,Castellón/Castelló,83,Olocau del Rey,119,62,57
12,Castellón/Castelló,84,Onda,25099,12566,12533
12,Castellón/Castelló,85,Oropesa del Mar/Orpesa,10184,5205,4979
12,Castellón/Castelló,87,Palanques,38,23,15
12,Castellón/Castelló,88,Pavías,74,45,29
12,Castellón/Castelló,89,Peníscola/Peñíscola,8210,4174,4036
12,Castellón/Castelló,90,Pina de Montalgrao,113,61,52
12,Castellón/Castelló,93,"Pobla de Benifassà, la",225,129,96
12,Castellón/Castelló,94,"Pobla Tornesa, la",1304,668,636
12,Castellón/Castelló,91,Portell de Morella,178,89,89
12,Castellón/Castelló,92,Puebla de Arenoso,162,89,73
12,Castellón/Castelló,95,Ribesalbes,1159,603,556
12,Castellón/Castelló,96,Rossell,886,469,417
12,Castellón/Castelló,97,Sacañet,52,38,14
12,Castellón/Castelló,98,"Salzadella, la",671,348,323
12,Castellón/Castelló,101,San Rafael del Río,484,236,248
12,Castellón/Castelló,902,Sant Joan de Moró,3387,1745,1642
12,Castellón/Castelló,99,Sant Jordi/San Jorge,1171,616,555
12,Castellón/Castelló,100,Sant Mateu,1954,963,991
12,Castellón/Castelló,102,Santa Magdalena de Pulpis,776,404,372
12,Castellón/Castelló,104,Segorbe,9146,4545,4601
12,Castellón/Castelló,103,"Serratella, la",103,51,52
12,Castellón/Castelló,105,Sierra Engarcerán,997,528,469
12,Castellón/Castelló,106,Soneja,1520,758,762
12,Castellón/Castelló,107,Sot de Ferrer,447,238,209
12,Castellón/Castelló,108,Sueras/Suera,565,299,266
12,Castellón/Castelló,109,Tales,853,434,419
12,Castellón/Castelló,110,Teresa,253,131,122
12,Castellón/Castelló,111,Tírig,417,214,203
12,Castellón/Castelló,112,Todolella,156,91,65
12,Castellón/Castelló,113,Toga,104,56,48
12,Castellón/Castelló,114,Torás,249,137,112
12,Castellón/Castelló,115,"Toro, El",238,131,107
12,Castellón/Castelló,116,Torralba del Pinar,60,28,32
12,Castellón/Castelló,119,"Torre d'En Besora, la",165,92,73
12,Castellón/Castelló,120,"Torre d'en Doménec, la",167,87,80
12,Castellón/Castelló,117,Torreblanca,5682,2912,2770
12,Castellón/Castelló,118,Torrechiva,89,46,43
12,Castellón/Castelló,121,Traiguera,1323,675,648
12,Castellón/Castelló,122,"Useras/Useres, les",949,504,445
12,Castellón/Castelló,124,Vall d'Alba,2959,1544,1415
12,Castellón/Castelló,125,Vall de Almonacid,287,147,140
12,Castellón/Castelló,126,"Vall d'Uixó, la",31388,15423,15965
12,Castellón/Castelló,123,Vallat,54,27,27
12,Castellón/Castelló,127,Vallibona,61,36,25
12,Castellón/Castelló,128,Vilafamés,1864,1003,861
12,Castellón/Castelló,129,Vilafranca/Villafranca del Cid,2154,1074,1080
12,Castellón/Castelló,132,Vilanova d'Alcolea,571,296,275
12,Castellón/Castelló,134,Vilar de Canes,170,87,83
12,Castellón/Castelló,135,Vila-real,51369,25532,25837
12,Castellón/Castelló,136,"Vilavella, la",3084,1533,1551
12,Castellón/Castelló,130,Villahermosa del Río,463,260,203
12,Castellón/Castelló,131,Villamalur,85,57,28
12,Castellón/Castelló,133,Villanueva de Viver,89,48,41
12,Castellón/Castelló,137,Villores,53,26,27
12,Castellón/Castelló,138,Vinaròs,29120,14380,14740
12,Castellón/Castelló,139,Vistabella del Maestrat,334,181,153
12,Castellón/Castelló,140,Viver,1691,866,825
12,Castellón/Castelló,52,Xert,679,336,343
12,Castellón/Castelló,141,Zorita del Maestrazgo,107,56,51
12,Castellón/Castelló,142,Zucaina,174,97,77
51,Ceuta,1,Ceuta,83117,41927,41190
13,Ciudad Real,1,Abenójar,1314,680,634
13,Ciudad Real,2,Agudo,1615,811,804
13,Ciudad Real,3,Alamillo,464,243,221
13,Ciudad Real,4,Albaladejo,1074,554,520
13,Ciudad Real,5,Alcázar de San Juan,30516,14842,15674
13,Ciudad Real,6,Alcoba,535,273,262
13,Ciudad Real,7,Alcolea de Calatrava,1370,693,677
13,Ciudad Real,8,Alcubillas,452,221,231
13,Ciudad Real,9,Aldea del Rey,1580,796,784
13,Ciudad Real,10,Alhambra,983,503,480
13,Ciudad Real,11,Almadén,5069,2444,2625
13,Ciudad Real,12,Almadenejos,391,200,191
13,Ciudad Real,13,Almagro,8907,4394,4513
13,Ciudad Real,14,Almedina,489,261,228
13,Ciudad Real,15,Almodóvar del Campo,5873,2953,2920
13,Ciudad Real,16,Almuradiel,740,372,368
13,Ciudad Real,17,Anchuras,265,140,125
13,Ciudad Real,903,Arenales de San Gregorio,571,294,277
13,Ciudad Real,18,Arenas de San Juan,1031,532,499
13,Ciudad Real,19,Argamasilla de Alba,6846,3443,3403
13,Ciudad Real,20,Argamasilla de Calatrava,5849,2916,2933
13,Ciudad Real,21,Arroba de los Montes,402,219,183
13,Ciudad Real,22,Ballesteros de Calatrava,367,182,185
13,Ciudad Real,23,Bolaños de Calatrava,11910,6137,5773
13,Ciudad Real,24,Brazatortas,1005,528,477
13,Ciudad Real,25,Cabezarados,300,164,136
13,Ciudad Real,26,Cabezarrubias del Puerto,484,256,228
13,Ciudad Real,27,Calzada de Calatrava,3704,1863,1841
13,Ciudad Real,28,Campo de Criptana,13142,6588,6554
13,Ciudad Real,29,Cañada de Calatrava,104,59,45
13,Ciudad Real,30,Caracuel de Calatrava,125,74,51
13,Ciudad Real,31,Carrión de Calatrava,3131,1581,1550
13,Ciudad Real,32,Carrizosa,1154,579,575
13,Ciudad Real,33,Castellar de Santiago,1819,922,897
13,Ciudad Real,38,Chillón,1758,844,914
13,Ciudad Real,34,Ciudad Real,74850,35458,39392
13,Ciudad Real,35,Corral de Calatrava,1089,535,554
13,Ciudad Real,36,"Cortijos, Los",865,462,403
13,Ciudad Real,37,Cózar,913,463,450
13,Ciudad Real,39,Daimiel,17680,8878,8802
13,Ciudad Real,40,Fernán Caballero,977,492,485
13,Ciudad Real,41,Fontanarejo,246,143,103
13,Ciudad Real,42,Fuencaliente,1012,524,488
13,Ciudad Real,43,Fuenllana,214,113,101
13,Ciudad Real,44,Fuente el Fresno,3085,1585,1500
13,Ciudad Real,45,Granátula de Calatrava,716,349,367
13,Ciudad Real,46,Guadalmez,718,349,369
13,Ciudad Real,47,Herencia,8432,4288,4144
13,Ciudad Real,48,Hinojosas de Calatrava,505,264,241
13,Ciudad Real,49,Horcajo de los Montes,821,422,399
13,Ciudad Real,50,"Labores, Las",557,286,271
13,Ciudad Real,904,Llanos del Caudillo,693,345,348
13,Ciudad Real,51,Luciana,368,200,168
13,Ciudad Real,52,Malagón,7801,3858,3943
13,Ciudad Real,53,Manzanares,17738,8787,8951
13,Ciudad Real,54,Membrilla,5904,2952,2952
13,Ciudad Real,55,Mestanza,644,339,305
13,Ciudad Real,56,Miguelturra,15744,7911,7833
13,Ciudad Real,57,Montiel,1233,645,588
13,Ciudad Real,58,Moral de Calatrava,5178,2627,2551
13,Ciudad Real,59,Navalpino,203,108,95
13,Ciudad Real,60,Navas de Estena,292,158,134
13,Ciudad Real,61,Pedro Muñoz,7480,3780,3700
13,Ciudad Real,62,Picón,667,348,319
13,Ciudad Real,63,Piedrabuena,4363,2213,2150
13,Ciudad Real,64,Poblete,2802,1444,1358
13,Ciudad Real,65,Porzuna,3505,1813,1692
13,Ciudad Real,66,Pozuelo de Calatrava,3629,1856,1773
13,Ciudad Real,67,"Pozuelos de Calatrava, Los",352,189,163
13,Ciudad Real,68,Puebla de Don Rodrigo,1119,618,501
13,Ciudad Real,69,Puebla del Príncipe,671,356,315
13,Ciudad Real,70,Puerto Lápice,896,443,453
13,Ciudad Real,71,Puertollano,45539,21948,23591
13,Ciudad Real,72,Retuerta del Bullaque,911,500,411
13,Ciudad Real,901,"Robledo, El",1061,559,502
13,Ciudad Real,902,Ruidera,555,269,286
13,Ciudad Real,73,Saceruela,526,276,250
13,Ciudad Real,74,San Carlos del Valle,1099,567,532
13,Ciudad Real,75,San Lorenzo de Calatrava,206,115,91
13,Ciudad Real,76,Santa Cruz de los Cáñamos,513,248,265
13,Ciudad Real,77,Santa Cruz de Mudela,3950,1966,1984
13,Ciudad Real,78,Socuéllamos,12098,6089,6009
13,Ciudad Real,80,Solana del Pino,328,171,157
13,Ciudad Real,79,"Solana, La",15313,7793,7520
13,Ciudad Real,81,Terrinches,622,328,294
13,Ciudad Real,82,Tomelloso,36024,17951,18073
13,Ciudad Real,83,Torralba de Calatrava,3052,1516,1536
13,Ciudad Real,84,Torre de Juan Abad,1003,496,507
13,Ciudad Real,85,Torrenueva,2659,1348,1311
13,Ciudad Real,86,Valdemanco del Esteras,164,87,77
13,Ciudad Real,87,Valdepeñas,30071,14680,15391
13,Ciudad Real,88,Valenzuela de Calatrava,661,309,352
13,Ciudad Real,89,Villahermosa,1772,875,897
13,Ciudad Real,90,Villamanrique,1083,527,556
13,Ciudad Real,91,Villamayor de Calatrava,607,297,310
13,Ciudad Real,92,Villanueva de la Fuente,1965,1010,955
13,Ciudad Real,93,Villanueva de los Infantes,4828,2397,2431
13,Ciudad Real,94,Villanueva de San Carlos,278,145,133
13,Ciudad Real,95,Villar del Pozo,54,32,22
13,Ciudad Real,96,Villarrubia de los Ojos,9667,4830,4837
13,Ciudad Real,97,Villarta de San Juan,2713,1365,1348
13,Ciudad Real,98,Viso del Marqués,2183,1062,1121
14,Córdoba,1,Adamuz,4125,2098,2027
14,Córdoba,2,Aguilar de la Frontera,13318,6629,6689
14,Córdoba,3,Alcaracejos,1493,729,764
14,Córdoba,4,Almedinilla,2350,1178,1172
14,Córdoba,5,Almodóvar del Río,8093,4042,4051
14,Córdoba,6,Añora,1509,748,761
14,Córdoba,7,Baena,18764,9403,9361
14,Córdoba,8,Belalcázar,3166,1536,1630
14,Córdoba,9,Belmez,2862,1394,1468
14,Córdoba,10,Benamejí,4974,2461,2513
14,Córdoba,11,"Blázquez, Los",661,337,324
14,Córdoba,12,Bujalance,7257,3626,3631
14,Córdoba,13,Cabra,20097,9788,10309
14,Córdoba,14,Cañete de las Torres,2859,1471,1388
14,Córdoba,15,Carcabuey,2367,1199,1168
14,Córdoba,16,Cardeña,1455,732,723
14,Córdoba,17,"Carlota, La",14324,7125,7199
14,Córdoba,18,"Carpio, El",4353,2146,2207
14,Córdoba,19,Castro del Río,7711,3797,3914
14,Córdoba,20,Conquista,380,192,188
14,Córdoba,21,Córdoba,319515,153368,166147
14,Córdoba,22,Doña Mencía,4583,2220,2363
14,Córdoba,23,Dos Torres,2402,1205,1197
14,Córdoba,24,Encinas Reales,2266,1115,1151
14,Córdoba,25,Espejo,3245,1629,1616
14,Córdoba,26,Espiel,2423,1220,1203
14,Córdoba,27,Fernán-Núñez,9646,4793,4853
14,Córdoba,901,Fuente Carreteros,1109,574,535
14,Córdoba,28,Fuente la Lancha,329,160,169
14,Córdoba,29,Fuente Obejuna,4462,2317,2145
14,Córdoba,30,Fuente Palmera,9879,4926,4953
14,Córdoba,31,Fuente-Tójar,663,318,345
14,Córdoba,32,"Granjuela, La",414,203,211
14,Córdoba,33,Guadalcázar,1552,778,774
14,Córdoba,902,"Guijarrosa, La",1341,689,652
14,Córdoba,34,"Guijo, El",344,181,163
14,Córdoba,35,Hinojosa del Duque,6640,3268,3372
14,Córdoba,36,Hornachuelos,4450,2217,2233
14,Córdoba,37,Iznájar,4002,2031,1971
14,Córdoba,38,Lucena,42645,21230,21415
14,Córdoba,39,Luque,2926,1472,1454
14,Córdoba,40,Montalbán de Córdoba,4494,2212,2282
14,Córdoba,41,Montemayor,3869,1951,1918
14,Córdoba,42,Montilla,22490,11149,11341
14,Córdoba,43,Montoro,9203,4546,4657
14,Córdoba,44,Monturque,1933,967,966
14,Córdoba,45,Moriles,3673,1839,1834
14,Córdoba,46,Nueva Carteya,5347,2719,2628
14,Córdoba,47,Obejo,2054,1075,979
14,Córdoba,48,Palenciana,1461,740,721
14,Córdoba,49,Palma del Río,20810,10331,10479
14,Córdoba,50,Pedro Abad,2809,1410,1399
14,Córdoba,51,Pedroche,1481,738,743
14,Córdoba,52,Peñarroya-Pueblonuevo,10419,5046,5373
14,Córdoba,53,Posadas,7267,3600,3667
14,Córdoba,54,Pozoblanco,17102,8287,8815
14,Córdoba,55,Priego de Córdoba,22092,10780,11312
14,Córdoba,56,Puente Genil,29748,14675,15073
14,Córdoba,57,"Rambla, La",7525,3771,3754
14,Córdoba,58,Rute,9801,4899,4902
14,Córdoba,59,San Sebastián de los Ballesteros,835,423,412
14,Córdoba,61,Santa Eufemia,734,365,369
14,Córdoba,60,Santaella,4637,2338,2299
14,Córdoba,62,Torrecampo,1032,509,523
14,Córdoba,63,Valenzuela,1079,542,537
14,Córdoba,64,Valsequillo,347,169,178
14,Córdoba,65,"Victoria, La",2316,1151,1165
14,Córdoba,66,Villa del Río,6993,3484,3509
14,Córdoba,67,Villafranca de Córdoba,4872,2494,2378
14,Córdoba,68,Villaharta,632,308,324
14,Córdoba,69,Villanueva de Córdoba,8587,4252,4335
14,Córdoba,70,Villanueva del Duque,1431,721,710
14,Córdoba,71,Villanueva del Rey,1007,492,515
14,Córdoba,72,Villaralto,1111,557,554
14,Córdoba,73,Villaviciosa de Córdoba,3160,1617,1543
14,Córdoba,74,"Viso, El",2528,1272,1256
14,Córdoba,75,Zuheros,631,319,312
15,"Coruña, A",1,Abegondo,5534,2729,2805
15,"Coruña, A",2,Ames,32095,15451,16644
15,"Coruña, A",3,Aranga,1837,937,900
15,"Coruña, A",4,Ares,6033,2962,3071
15,"Coruña, A",5,Arteixo,33076,16342,16734
15,"Coruña, A",6,Arzúa,5918,2949,2969
15,"Coruña, A",7,"Baña, A",3333,1576,1757
15,"Coruña, A",8,Bergondo,6892,3368,3524
15,"Coruña, A",9,Betanzos,13066,6212,6854
15,"Coruña, A",10,Boimorto,1890,940,950
15,"Coruña, A",11,Boiro,18976,9204,9772
15,"Coruña, A",12,Boqueixón,4188,2048,2140
15,"Coruña, A",13,Brión,8069,3884,4185
15,"Coruña, A",14,Cabana de Bergantiños,4195,2029,2166
15,"Coruña, A",15,Cabanas,3340,1625,1715
15,"Coruña, A",16,Camariñas,5188,2534,2654
15,"Coruña, A",17,Cambre,24505,11949,12556
15,"Coruña, A",18,"Capela, A",1225,599,626
15,"Coruña, A",19,Carballo,31432,15361,16071
15,"Coruña, A",901,Cariño,3699,1824,1875
15,"Coruña, A",20,Carnota,3845,1826,2019
15,"Coruña, A",21,Carral,6649,3259,3390
15,"Coruña, A",22,Cedeira,6626,3295,3331
15,"Coruña, A",23,Cee,7573,3610,3963
15,"Coruña, A",24,Cerceda,5019,2478,2541
15,"Coruña, A",25,Cerdido,1060,520,540
15,"Coruña, A",27,Coirós,1913,950,963
15,"Coruña, A",28,Corcubión,1670,836,834
15,"Coruña, A",29,Coristanco,5807,2778,3029
15,"Coruña, A",30,"Coruña, A",244700,113439,131261
15,"Coruña, A",31,Culleredo,30790,14792,15998
15,"Coruña, A",32,Curtis,4104,2076,2028
15,"Coruña, A",33,Dodro,2675,1276,1399
15,"Coruña, A",34,Dumbría,2909,1393,1516
15,"Coruña, A",35,Fene,12702,6034,6668
15,"Coruña, A",36,Ferrol,64158,30176,33982
15,"Coruña, A",37,Fisterra,4726,2398,2328
15,"Coruña, A",38,Frades,2273,1118,1155
15,"Coruña, A",39,Irixoa,1318,668,650
15,"Coruña, A",41,"Laracha, A",11505,5690,5815
15,"Coruña, A",40,Laxe,2977,1492,1485
15,"Coruña, A",42,Lousame,3210,1601,1609
15,"Coruña, A",43,Malpica de Bergantiños,5296,2589,2707
15,"Coruña, A",44,Mañón,1287,636,651
15,"Coruña, A",45,Mazaricos,3761,1793,1968
15,"Coruña, A",46,Melide,7438,3648,3790
15,"Coruña, A",47,Mesía,2457,1232,1225
15,"Coruña, A",48,Miño,6624,3302,3322
15,"Coruña, A",49,Moeche,1191,570,621
15,"Coruña, A",50,Monfero,1865,949,916
15,"Coruña, A",51,Mugardos,5246,2552,2694
15,"Coruña, A",53,Muros,8365,4034,4331
15,"Coruña, A",52,Muxía,4486,2161,2325
15,"Coruña, A",54,Narón,38938,18858,20080
15,"Coruña, A",55,Neda,4972,2421,2551
15,"Coruña, A",56,Negreira,6811,3291,3520
15,"Coruña, A",57,Noia,14140,6770,7370
15,"Coruña, A",58,Oleiros,37271,17991,19280
15,"Coruña, A",59,Ordes,12589,6136,6453
15,"Coruña, A",60,Oroso,7572,3724,3848
15,"Coruña, A",61,Ortigueira,5420,2561,2859
15,"Coruña, A",62,Outes,6108,2924,3184
15,"Coruña, A",902,Oza-Cesuras,5247,2661,2586
15,"Coruña, A",64,Paderne,2420,1198,1222
15,"Coruña, A",65,Padrón,8349,4034,4315
15,"Coruña, A",66,"Pino, O",4576,2301,2275
15,"Coruña, A",67,"Pobra do Caramiñal, A",9290,4559,4731
15,"Coruña, A",68,Ponteceso,5429,2729,2700
15,"Coruña, A",69,Pontedeume,7563,3617,3946
15,"Coruña, A",70,"Pontes de García Rodríguez, As",9974,4880,5094
15,"Coruña, A",71,Porto do Son,9153,4552,4601
15,"Coruña, A",72,Rianxo,10949,5373,5576
15,"Coruña, A",73,Ribeira,26897,13300,13597
15,"Coruña, A",74,Rois,4445,2126,2319
15,"Coruña, A",75,Sada,16627,8145,8482
15,"Coruña, A",76,San Sadurniño,2792,1385,1407
15,"Coruña, A",77,Santa Comba,9365,4553,4812
15,"Coruña, A",78,Santiago de Compostela,98179,45721,52458
15,"Coruña, A",79,Santiso,1509,784,725
15,"Coruña, A",80,Sobrado,1767,916,851
15,"Coruña, A",81,"Somozas, As",1073,544,529
15,"Coruña, A",82,Teo,18918,9237,9681
15,"Coruña, A",83,Toques,1089,558,531
15,"Coruña, A",84,Tordoia,3192,1515,1677
15,"Coruña, A",85,Touro,3451,1707,1744
15,"Coruña, A",86,Trazo,3034,1485,1549
15,"Coruña, A",88,Val do Dubra,3783,1820,1963
15,"Coruña, A",87,Valdoviño,6924,3385,3539
15,"Coruña, A",89,Vedra,5005,2460,2545
15,"Coruña, A",91,Vilarmaior,1245,631,614
15,"Coruña, A",90,Vilasantar,1239,655,584
15,"Coruña, A",92,Vimianzo,6851,3310,3541
15,"Coruña, A",93,Zas,4308,2076,2232
16,Cuenca,1,Abia de la Obispalía,60,37,23
16,Cuenca,2,"Acebrón, El",231,110,121
16,Cuenca,3,Alarcón,152,69,83
16,Cuenca,4,Albaladejo del Cuende,230,122,108
16,Cuenca,5,Albalate de las Nogueras,259,134,125
16,Cuenca,6,Albendea,122,57,65
16,Cuenca,7,"Alberca de Záncara, La",1585,800,785
16,Cuenca,8,Alcalá de la Vega,79,45,34
16,Cuenca,9,Alcantud,51,29,22
16,Cuenca,10,Alcázar del Rey,134,73,61
16,Cuenca,11,Alcohujate,26,12,14
16,Cuenca,12,Alconchel de la Estrella,77,45,32
16,Cuenca,13,Algarra,22,12,10
16,Cuenca,14,Aliaguilla,634,330,304
16,Cuenca,15,"Almarcha, La",425,233,192
16,Cuenca,16,Almendros,234,128,106
16,Cuenca,17,Almodóvar del Pinar,386,202,184
16,Cuenca,18,Almonacid del Marquesado,424,217,207
16,Cuenca,19,Altarejos,205,108,97
16,Cuenca,20,Arandilla del Arroyo,9,6,3
16,Cuenca,905,Arcas,1994,998,996
16,Cuenca,22,Arcos de la Sierra,73,44,29
16,Cuenca,24,Arguisuelas,133,65,68
16,Cuenca,25,Arrancacepas,18,10,8
16,Cuenca,26,Atalaya del Cañavate,110,58,52
16,Cuenca,27,Barajas de Melo,987,528,459
16,Cuenca,29,Barchín del Hoyo,97,65,32
16,Cuenca,30,Bascuñana de San Pedro,24,20,4
16,Cuenca,31,Beamud,41,22,19
16,Cuenca,32,Belinchón,383,195,188
16,Cuenca,33,Belmonte,1782,884,898
16,Cuenca,34,Belmontejo,141,82,59
16,Cuenca,35,Beteta,229,114,115
16,Cuenca,36,Boniches,141,69,72
16,Cuenca,38,Buciegas,36,25,11
16,Cuenca,39,Buenache de Alarcón,447,238,209
16,Cuenca,40,Buenache de la Sierra,106,60,46
16,Cuenca,41,Buendía,415,226,189
16,Cuenca,42,Campillo de Altobuey,1262,635,627
16,Cuenca,43,Campillos-Paravientos,103,60,43
16,Cuenca,44,Campillos-Sierra,29,15,14
16,Cuenca,901,Campos del Paraíso,691,357,334
16,Cuenca,45,Canalejas del Arroyo,168,95,73
16,Cuenca,46,Cañada del Hoyo,231,123,108
16,Cuenca,47,Cañada Juncosa,231,126,105
16,Cuenca,48,Cañamares,445,245,200
16,Cuenca,49,"Cañavate, El",136,61,75
16,Cuenca,50,Cañaveras,244,121,123
16,Cuenca,51,Cañaveruelas,129,66,63
16,Cuenca,52,Cañete,792,411,381
16,Cuenca,53,Cañizares,429,234,195
16,Cuenca,55,Carboneras de Guadazaón,794,412,382
16,Cuenca,56,Cardenete,474,250,224
16,Cuenca,57,Carrascosa,68,43,25
16,Cuenca,58,Carrascosa de Haro,98,48,50
16,Cuenca,60,Casas de Benítez,816,402,414
16,Cuenca,61,Casas de Fernando Alonso,1144,595,549
16,Cuenca,62,Casas de Garcimolina,31,19,12
16,Cuenca,63,Casas de Guijarro,108,57,51
16,Cuenca,64,Casas de Haro,844,447,397
16,Cuenca,65,Casas de los Pinos,415,202,213
16,Cuenca,66,Casasimarro,3140,1639,1501
16,Cuenca,67,Castejón,124,72,52
16,Cuenca,68,Castillejo de Iniesta,115,62,53
16,Cuenca,70,Castillejo-Sierra,28,14,14
16,Cuenca,72,Castillo de Garcimuñoz,128,78,50
16,Cuenca,71,Castillo-Albaráñez,22,10,12
16,Cuenca,73,Cervera del Llano,217,109,108
16,Cuenca,23,Chillarón de Cuenca,721,381,340
16,Cuenca,81,Chumillas,58,34,24
16,Cuenca,74,"Cierva, La",37,21,16
16,Cuenca,78,Cuenca,53389,25274,28115
16,Cuenca,79,Cueva del Hierro,35,22,13
16,Cuenca,82,Enguídanos,299,160,139
16,Cuenca,83,Fresneda de Altarejos,35,19,16
16,Cuenca,84,Fresneda de la Sierra,46,27,19
16,Cuenca,85,"Frontera, La",144,77,67
16,Cuenca,86,Fuente de Pedro Naharro,1211,630,581
16,Cuenca,87,Fuentelespino de Haro,235,122,113
16,Cuenca,88,Fuentelespino de Moya,103,54,49
16,Cuenca,904,Fuentenava de Jábaga,546,286,260
16,Cuenca,89,Fuentes,467,240,227
16,Cuenca,91,Fuertescusa,69,37,32
16,Cuenca,92,Gabaldón,151,92,59
16,Cuenca,93,Garaballa,58,30,28
16,Cuenca,94,Gascueña,142,84,58
16,Cuenca,95,Graja de Campalbo,96,54,42
16,Cuenca,96,Graja de Iniesta,362,191,171
16,Cuenca,97,Henarejos,129,67,62
16,Cuenca,98,"Herrumblar, El",733,370,363
16,Cuenca,99,"Hinojosa, La",191,95,96
16,Cuenca,100,"Hinojosos, Los",759,384,375
16,Cuenca,101,"Hito, El",151,79,72
16,Cuenca,102,Honrubia,1530,761,769
16,Cuenca,103,Hontanaya,256,141,115
16,Cuenca,104,Hontecillas,62,31,31
16,Cuenca,106,Horcajo de Santiago,3572,1832,1740
16,Cuenca,107,Huélamo,73,40,33
16,Cuenca,108,Huelves,72,38,34
16,Cuenca,109,Huérguina,50,27,23
16,Cuenca,110,Huerta de la Obispalía,116,70,46
16,Cuenca,111,Huerta del Marquesado,170,93,77
16,Cuenca,112,Huete,1716,884,832
16,Cuenca,113,Iniesta,4340,2150,2190
16,Cuenca,115,Laguna del Marquesado,56,32,24
16,Cuenca,116,Lagunaseca,55,32,23
16,Cuenca,117,Landete,1217,627,590
16,Cuenca,118,Ledaña,1563,774,789
16,Cuenca,119,Leganiel,221,118,103
16,Cuenca,121,"Majadas, Las",233,121,112
16,Cuenca,122,Mariana,312,164,148
16,Cuenca,123,Masegosa,62,36,26
16,Cuenca,124,"Mesas, Las",2296,1175,1121
16,Cuenca,125,Minglanilla,2268,1161,1107
16,Cuenca,126,Mira,924,468,456
16,Cuenca,128,Monreal del Llano,50,29,21
16,Cuenca,129,Montalbanejo,93,46,47
16,Cuenca,130,Montalbo,691,354,337
16,Cuenca,131,Monteagudo de las Salinas,120,73,47
16,Cuenca,132,Mota de Altarejos,34,21,13
16,Cuenca,133,Mota del Cuervo,6069,3022,3047
16,Cuenca,134,Motilla del Palancar,6026,2998,3028
16,Cuenca,135,Moya,128,76,52
16,Cuenca,137,Narboneta,41,24,17
16,Cuenca,139,Olivares de Júcar,294,154,140
16,Cuenca,140,Olmeda de la Cuesta,21,13,8
16,Cuenca,141,Olmeda del Rey,134,67,67
16,Cuenca,142,Olmedilla de Alarcón,136,78,58
16,Cuenca,143,Olmedilla de Eliz,17,14,3
16,Cuenca,145,Osa de la Vega,447,231,216
16,Cuenca,146,Pajarón,77,36,41
16,Cuenca,147,Pajaroncillo,63,41,22
16,Cuenca,148,Palomares del Campo,560,282,278
16,Cuenca,149,Palomera,169,81,88
16,Cuenca,150,Paracuellos,96,49,47
16,Cuenca,151,Paredes,55,32,23
16,Cuenca,152,"Parra de las Vegas, La",33,24,9
16,Cuenca,153,"Pedernoso, El",1125,565,560
16,Cuenca,154,"Pedroñeras, Las",6583,3385,3198
16,Cuenca,155,"Peral, El",650,374,276
16,Cuenca,156,"Peraleja, La",97,61,36
16,Cuenca,157,"Pesquera, La",212,114,98
16,Cuenca,158,"Picazo, El",674,345,329
16,Cuenca,159,Pinarejo,189,96,93
16,Cuenca,160,Pineda de Gigüela,62,41,21
16,Cuenca,161,Piqueras del Castillo,46,27,19
16,Cuenca,162,Portalrubio de Guadamejud,31,16,15
16,Cuenca,163,Portilla,58,31,27
16,Cuenca,165,Poyatos,58,32,26
16,Cuenca,166,Pozoamargo,279,152,127
16,Cuenca,908,Pozorrubielos de la Mancha,173,93,80
16,Cuenca,167,Pozorrubio de Santiago,322,154,168
16,Cuenca,169,"Pozuelo, El",43,28,15
16,Cuenca,170,Priego,885,444,441
16,Cuenca,171,"Provencio, El",2387,1193,1194
16,Cuenca,172,Puebla de Almenara,311,168,143
16,Cuenca,174,Puebla del Salvador,192,103,89
16,Cuenca,175,Quintanar del Rey,7632,3924,3708
16,Cuenca,176,Rada de Haro,49,30,19
16,Cuenca,177,Reíllo,105,56,49
16,Cuenca,181,Rozalén del Monte,58,29,29
16,Cuenca,185,Saceda-Trasierra,37,24,13
16,Cuenca,186,Saelices,450,233,217
16,Cuenca,187,Salinas del Manzano,67,39,28
16,Cuenca,188,Salmeroncillos,101,59,42
16,Cuenca,189,Salvacañete,291,144,147
16,Cuenca,190,San Clemente,6827,3429,3398
16,Cuenca,191,San Lorenzo de la Parrilla,1066,554,512
16,Cuenca,192,San Martín de Boniches,46,26,20
16,Cuenca,193,San Pedro Palmiches,49,28,21
16,Cuenca,194,Santa Cruz de Moya,230,117,113
16,Cuenca,196,Santa María de los Llanos,680,360,320
16,Cuenca,195,Santa María del Campo Rus,522,268,254
16,Cuenca,197,Santa María del Val,61,32,29
16,Cuenca,198,Sisante,1618,829,789
16,Cuenca,199,Solera de Gabaldón,36,22,14
16,Cuenca,909,Sotorribas,696,362,334
16,Cuenca,202,Talayuelas,856,457,399
16,Cuenca,203,Tarancón,15799,7805,7994
16,Cuenca,204,Tébar,287,154,133
16,Cuenca,205,Tejadillos,113,51,62
16,Cuenca,206,Tinajas,196,107,89
16,Cuenca,209,Torralba,109,65,44
16,Cuenca,211,Torrejoncillo del Rey,345,191,154
16,Cuenca,212,Torrubia del Campo,296,146,150
16,Cuenca,213,Torrubia del Castillo,41,27,14
16,Cuenca,215,Tragacete,277,156,121
16,Cuenca,216,Tresjuncos,268,147,121
16,Cuenca,217,Tribaldos,99,55,44
16,Cuenca,218,Uclés,222,115,107
16,Cuenca,219,Uña,84,46,38
16,Cuenca,906,"Valdecolmenas, Los",74,48,26
16,Cuenca,224,Valdemeca,74,43,31
16,Cuenca,225,Valdemorillo de la Sierra,54,32,22
16,Cuenca,227,Valdemoro-Sierra,104,59,45
16,Cuenca,228,Valdeolivas,218,136,82
16,Cuenca,902,Valdetórtola,127,72,55
16,Cuenca,903,"Valeras, Las",1499,796,703
16,Cuenca,231,Valhermoso de la Fuente,42,22,20
16,Cuenca,173,"Valle de Altomira, El",206,111,95
16,Cuenca,234,Valsalobre,21,11,10
16,Cuenca,236,Valverde de Júcar,1091,541,550
16,Cuenca,237,Valverdejo,94,48,46
16,Cuenca,238,Vara de Rey,460,240,220
16,Cuenca,239,Vega del Codorno,132,81,51
16,Cuenca,240,Vellisca,114,63,51
16,Cuenca,242,Villaconejos de Trabaque,323,168,155
16,Cuenca,243,Villaescusa de Haro,474,244,230
16,Cuenca,244,Villagarcía del Llano,697,348,349
16,Cuenca,245,Villalba de la Sierra,484,238,246
16,Cuenca,246,Villalba del Rey,481,258,223
16,Cuenca,247,Villalgordo del Marquesado,66,39,27
16,Cuenca,248,Villalpardo,1013,504,509
16,Cuenca,249,Villamayor de Santiago,2433,1248,1185
16,Cuenca,250,Villanueva de Guadamejud,64,41,23
16,Cuenca,251,Villanueva de la Jara,2287,1156,1131
16,Cuenca,253,Villar de Cañas,385,209,176
16,Cuenca,254,Villar de Domingo García,222,112,110
16,Cuenca,255,Villar de la Encina,161,83,78
16,Cuenca,263,Villar de Olalla,1356,724,632
16,Cuenca,258,Villar del Humo,169,92,77
16,Cuenca,259,Villar del Infantado,39,22,17
16,Cuenca,910,Villar y Velasco,79,44,35
16,Cuenca,264,Villarejo de Fuentes,392,196,196
16,Cuenca,265,Villarejo de la Peñuela,23,13,10
16,Cuenca,266,Villarejo-Periesteban,383,195,188
16,Cuenca,269,Villares del Saz,468,245,223
16,Cuenca,270,Villarrubio,189,102,87
16,Cuenca,271,Villarta,789,390,399
16,Cuenca,272,Villas de la Ventosa,210,119,91
16,Cuenca,273,Villaverde y Pasaconsol,338,180,158
16,Cuenca,274,Víllora,141,79,62
16,Cuenca,275,Vindel,12,8,4
16,Cuenca,276,Yémeda,17,12,5
16,Cuenca,277,Zafra de Záncara,100,56,44
16,Cuenca,278,Zafrilla,55,29,26
16,Cuenca,279,Zarza de Tajo,268,147,121
16,Cuenca,280,Zarzuela,154,86,68
20,Gipuzkoa,1,Abaltzisketa,309,169,140
20,Gipuzkoa,2,Aduna,486,259,227
20,Gipuzkoa,16,Aia,2094,1104,990
20,Gipuzkoa,3,Aizarnazabal,774,392,382
20,Gipuzkoa,4,Albiztur,316,163,153
20,Gipuzkoa,5,Alegia,1740,901,839
20,Gipuzkoa,6,Alkiza,357,175,182
20,Gipuzkoa,906,Altzaga,178,86,92
20,Gipuzkoa,7,Altzo,428,224,204
20,Gipuzkoa,8,Amezketa,948,507,441
20,Gipuzkoa,9,Andoain,14504,7193,7311
20,Gipuzkoa,10,Anoeta,2079,1070,1009
20,Gipuzkoa,11,Antzuola,2071,1034,1037
20,Gipuzkoa,12,Arama,192,94,98
20,Gipuzkoa,13,Aretxabaleta,7069,3546,3523
20,Gipuzkoa,55,Arrasate/Mondragón,21760,10694,11066
20,Gipuzkoa,14,Asteasu,1557,794,763
20,Gipuzkoa,903,Astigarraga,7417,3770,3647
20,Gipuzkoa,15,Ataun,1660,849,811
20,Gipuzkoa,17,Azkoitia,11617,5782,5835
20,Gipuzkoa,18,Azpeitia,15154,7600,7554
20,Gipuzkoa,904,Baliarrain,152,86,66
20,Gipuzkoa,19,Beasain,13877,6973,6904
20,Gipuzkoa,20,Beizama,136,87,49
20,Gipuzkoa,21,Belauntza,269,142,127
20,Gipuzkoa,22,Berastegi,1102,563,539
20,Gipuzkoa,74,Bergara,14513,7195,7318
20,Gipuzkoa,23,Berrobi,581,303,278
20,Gipuzkoa,24,Bidania-Goiatz,527,283,244
20,Gipuzkoa,29,Deba,5395,2669,2726
20,Gipuzkoa,69,Donostia/San Sebastián,187849,88786,99063
20,Gipuzkoa,30,Eibar,27282,13261,14021
20,Gipuzkoa,31,Elduain,247,124,123
20,Gipuzkoa,33,Elgeta,1122,565,557
20,Gipuzkoa,32,Elgoibar,11480,5645,5835
20,Gipuzkoa,67,Errenteria,39023,18851,20172
20,Gipuzkoa,66,Errezil,565,298,267
20,Gipuzkoa,34,Eskoriatza,4160,2081,2079
20,Gipuzkoa,35,Ezkio-Itsaso,609,314,295
20,Gipuzkoa,38,Gabiria,503,271,232
20,Gipuzkoa,37,Gaintza,128,74,54
20,Gipuzkoa,907,Gaztelu,173,89,84
20,Gipuzkoa,39,Getaria,2825,1408,1417
20,Gipuzkoa,40,Hernani,20375,9960,10415
20,Gipuzkoa,41,Hernialde,314,164,150
20,Gipuzkoa,36,Hondarribia,16904,8399,8505
20,Gipuzkoa,42,Ibarra,4143,2046,2097
20,Gipuzkoa,43,Idiazabal,2271,1148,1123
20,Gipuzkoa,44,Ikaztegieta,483,252,231
20,Gipuzkoa,45,Irun,62635,30701,31934
20,Gipuzkoa,46,Irura,1885,994,891
20,Gipuzkoa,47,Itsasondo,643,331,312
20,Gipuzkoa,48,Larraul,258,146,112
20,Gipuzkoa,902,Lasarte-Oria,18949,9173,9776
20,Gipuzkoa,49,Lazkao,5962,2987,2975
20,Gipuzkoa,50,Leaburu,385,204,181
20,Gipuzkoa,51,Legazpi,8337,4190,4147
20,Gipuzkoa,52,Legorreta,1432,714,718
20,Gipuzkoa,68,Leintz-Gatzaga,206,116,90
20,Gipuzkoa,53,Lezo,6011,2991,3020
20,Gipuzkoa,54,Lizartza,629,327,302
20,Gipuzkoa,901,Mendaro,1977,994,983
20,Gipuzkoa,57,Mutiloa,259,135,124
20,Gipuzkoa,56,Mutriku,5304,2665,2639
20,Gipuzkoa,63,Oiartzun,10362,5140,5222
20,Gipuzkoa,58,Olaberria,914,465,449
20,Gipuzkoa,59,Oñati,11515,5708,5807
20,Gipuzkoa,76,Ordizia,10424,5183,5241
20,Gipuzkoa,905,Orendain,246,116,130
20,Gipuzkoa,60,Orexa,114,64,50
20,Gipuzkoa,61,Orio,6062,3040,3022
20,Gipuzkoa,62,Ormaiztegi,1242,628,614
20,Gipuzkoa,64,Pasaia,15711,7547,8164
20,Gipuzkoa,70,Segura,1469,733,736
20,Gipuzkoa,65,Soraluze-Placencia de las Armas,3842,1926,1916
20,Gipuzkoa,71,Tolosa,19886,9626,10260
20,Gipuzkoa,72,Urnieta,6181,3110,3071
20,Gipuzkoa,77,Urretxu,6738,3332,3406
20,Gipuzkoa,73,Usurbil,6166,3081,3085
20,Gipuzkoa,75,Villabona,5833,2903,2930
20,Gipuzkoa,78,Zaldibia,1673,852,821
20,Gipuzkoa,79,Zarautz,23101,11227,11874
20,Gipuzkoa,25,Zegama,1538,777,761
20,Gipuzkoa,26,Zerain,276,132,144
20,Gipuzkoa,27,Zestoa,3750,1964,1786
20,Gipuzkoa,28,Zizurkil,2996,1511,1485
20,Gipuzkoa,81,Zumaia,10153,5037,5116
20,Gipuzkoa,80,Zumarraga,9636,4754,4882
17,Girona,1,Agullana,903,455,448
17,Girona,2,Aiguaviva,780,387,393
17,Girona,3,Albanyà,180,94,86
17,Girona,4,Albons,797,415,382
17,Girona,6,Alp,1717,894,823
17,Girona,7,Amer,2422,1185,1237
17,Girona,8,Anglès,5682,2851,2831
17,Girona,9,Arbúcies,6474,3335,3139
17,Girona,10,Argelaguer,439,224,215
17,Girona,11,"Armentera, L'",1043,532,511
17,Girona,12,Avinyonet de Puigventós,1676,831,845
17,Girona,15,Banyoles,20187,10012,10175
17,Girona,16,Bàscara,1034,535,499
17,Girona,13,Begur,4177,2086,2091
17,Girona,18,Bellcaire d'Empordà,713,344,369
17,Girona,19,Besalú,2480,1182,1298
17,Girona,20,Bescanó,5156,2605,2551
17,Girona,21,Beuda,202,106,96
17,Girona,22,"Bisbal d'Empordà, La",11163,5592,5571
17,Girona,234,Biure,249,135,114
17,Girona,23,Blanes,40579,20198,20381
17,Girona,29,Boadella i les Escaules,258,129,129
17,Girona,24,Bolvir,518,267,251
17,Girona,25,Bordils,1815,912,903
17,Girona,26,Borrassà,776,403,373
17,Girona,27,Breda,3842,1895,1947
17,Girona,28,Brunyola i Sant Martí Sapresa,388,201,187
17,Girona,31,Cabanelles,279,151,128
17,Girona,30,Cabanes,949,498,451
17,Girona,32,Cadaqués,2889,1415,1474
17,Girona,33,Caldes de Malavella,8196,4099,4097
17,Girona,34,Calonge i Sant Antoni,11712,5838,5874
17,Girona,35,Camós,715,355,360
17,Girona,36,Campdevànol,3217,1576,1641
17,Girona,37,Campelles,162,87,75
17,Girona,38,Campllong,535,267,268
17,Girona,39,Camprodon,2469,1200,1269
17,Girona,40,Canet d'Adri,750,388,362
17,Girona,41,Cantallops,330,168,162
17,Girona,42,Capmany,672,350,322
17,Girona,44,Cassà de la Selva,10680,5471,5209
17,Girona,46,Castellfollit de la Roca,926,476,450
17,Girona,47,Castelló d'Empúries,11611,5893,5718
17,Girona,48,Castell-Platja d'Aro,11757,5809,5948
17,Girona,189,"Cellera de Ter, La",1967,964,1003
17,Girona,49,Celrà,5503,2747,2756
17,Girona,50,Cervià de Ter,999,513,486
17,Girona,51,Cistella,307,149,158
17,Girona,54,Colera,468,234,234
17,Girona,55,Colomers,204,98,106
17,Girona,57,Corçà,1268,651,617
17,Girona,56,Cornellà del Terri,2407,1208,1199
17,Girona,58,Crespià,276,143,133
17,Girona,901,"Cruïlles, Monells i Sant Sadurní de l'Heura",1338,676,662
17,Girona,60,Darnius,535,277,258
17,Girona,61,Das,267,141,126
17,Girona,62,"Escala, L'",10520,5322,5198
17,Girona,63,Espinelves,248,125,123
17,Girona,64,Espolla,408,207,201
17,Girona,65,Esponellà,489,256,233
17,Girona,5,"Far d'Empordà, El",625,320,305
17,Girona,66,Figueres,47088,23198,23890
17,Girona,67,Flaçà,1130,550,580
17,Girona,68,Foixà,288,148,140
17,Girona,69,Fontanals de Cerdanya,533,275,258
17,Girona,70,Fontanilles,163,93,70
17,Girona,71,Fontcoberta,1466,732,734
17,Girona,902,Forallac,1765,853,912
17,Girona,73,Fornells de la Selva,2693,1339,1354
17,Girona,74,Fortià,778,389,389
17,Girona,75,Garrigàs,458,238,220
17,Girona,76,Garrigoles,177,96,81
17,Girona,77,Garriguella,922,465,457
17,Girona,78,Ger,512,273,239
17,Girona,79,Girona,102666,49352,53314
17,Girona,80,Gombrèn,200,98,102
17,Girona,81,Gualta,439,254,185
17,Girona,82,Guils de Cerdanya,573,303,270
17,Girona,83,Hostalric,4370,2201,2169
17,Girona,84,Isòvol,318,182,136
17,Girona,85,Jafre,386,201,185
17,Girona,86,"Jonquera, La",3317,1669,1648
17,Girona,87,Juià,334,179,155
17,Girona,88,Lladó,827,412,415
17,Girona,89,Llagostera,9024,4543,4481
17,Girona,90,Llambilles,731,375,356
17,Girona,91,Llanars,533,269,264
17,Girona,92,Llançà,4905,2408,2497
17,Girona,93,Llers,1245,626,619
17,Girona,94,Llívia,1495,799,696
17,Girona,95,Lloret de Mar,38941,19790,19151
17,Girona,96,"Llosses, Les",205,119,86
17,Girona,102,Maçanet de Cabrenys,724,362,362
17,Girona,103,Maçanet de la Selva,7572,3915,3657
17,Girona,97,Madremanya,302,148,154
17,Girona,98,Maià de Montcal,462,255,207
17,Girona,100,Masarac,294,155,139
17,Girona,101,Massanes,825,438,387
17,Girona,99,Meranges,111,61,50
17,Girona,105,Mieres,341,174,167
17,Girona,106,Mollet de Peralada,202,104,98
17,Girona,107,Molló,365,173,192
17,Girona,109,Montagut i Oix,958,509,449
17,Girona,110,Mont-ras,1676,848,828
17,Girona,111,Navata,1465,718,747
17,Girona,112,Ogassa,222,123,99
17,Girona,114,Olot,36716,18588,18128
17,Girona,115,Ordis,373,199,174
17,Girona,116,Osor,423,230,193
17,Girona,117,Palafrugell,23396,11670,11726
17,Girona,118,Palamós,18145,8853,9292
17,Girona,119,Palau de Santa Eulàlia,115,65,50
17,Girona,121,Palau-sator,327,179,148
17,Girona,120,Palau-saverdera,1472,743,729
17,Girona,123,Palol de Revardit,457,231,226
17,Girona,124,Pals,2548,1319,1229
17,Girona,125,Pardines,165,90,75
17,Girona,126,Parlavà,415,205,210
17,Girona,128,Pau,579,284,295
17,Girona,129,Pedret i Marzà,181,89,92
17,Girona,130,"Pera, La",438,220,218
17,Girona,132,Peralada,1974,972,1002
17,Girona,133,"Planes d'Hostoles, Les",1745,883,862
17,Girona,134,Planoles,307,171,136
17,Girona,135,Pont de Molins,542,275,267
17,Girona,136,Pontós,274,150,124
17,Girona,137,Porqueres,4712,2324,2388
17,Girona,140,"Port de la Selva, El",1015,521,494
17,Girona,138,Portbou,1090,539,551
17,Girona,139,"Preses, Les",1875,930,945
17,Girona,141,Puigcerdà,9484,4731,4753
17,Girona,142,Quart,3906,1980,1926
17,Girona,43,Queralbs,191,98,93
17,Girona,143,Rabós,210,101,109
17,Girona,144,Regencós,271,146,125
17,Girona,145,Ribes de Freser,1810,923,887
17,Girona,146,Riells i Viabrea,4279,2177,2102
17,Girona,147,Ripoll,10641,5284,5357
17,Girona,148,Riudarenes,2337,1213,1124
17,Girona,149,Riudaura,511,258,253
17,Girona,150,Riudellots de la Selva,2072,1051,1021
17,Girona,151,Riumors,244,128,116
17,Girona,152,Roses,19907,10102,9805
17,Girona,153,Rupià,300,152,148
17,Girona,154,Sales de Llierca,169,84,85
17,Girona,155,Salt,32517,17139,15378
17,Girona,157,Sant Andreu Salou,162,79,83
17,Girona,183,Sant Aniol de Finestres,363,184,179
17,Girona,158,Sant Climent Sescebes,696,421,275
17,Girona,159,Sant Feliu de Buixalleu,839,431,408
17,Girona,160,Sant Feliu de Guíxols,22149,10841,11308
17,Girona,161,Sant Feliu de Pallerols,1495,766,729
17,Girona,162,Sant Ferriol,256,140,116
17,Girona,163,Sant Gregori,4085,2086,1999
17,Girona,164,Sant Hilari Sacalm,5836,2950,2886
17,Girona,165,Sant Jaume de Llierca,842,414,428
17,Girona,167,Sant Joan de les Abadesses,3274,1625,1649
17,Girona,168,Sant Joan de Mollet,515,258,257
17,Girona,185,Sant Joan les Fonts,3054,1550,1504
17,Girona,166,Sant Jordi Desvalls,830,406,424
17,Girona,169,Sant Julià de Ramis,3623,1821,1802
17,Girona,903,Sant Julià del Llor i Bonmatí,1347,684,663
17,Girona,171,Sant Llorenç de la Muga,267,143,124
17,Girona,172,Sant Martí de Llémena,679,346,333
17,Girona,173,Sant Martí Vell,261,140,121
17,Girona,174,Sant Miquel de Campmajor,239,133,106
17,Girona,175,Sant Miquel de Fluvià,808,414,394
17,Girona,176,Sant Mori,159,80,79
17,Girona,177,Sant Pau de Segúries,732,372,360
17,Girona,178,Sant Pere Pescador,2079,1114,965
17,Girona,180,Santa Coloma de Farners,13557,6851,6706
17,Girona,181,Santa Cristina d'Aro,5585,2819,2766
17,Girona,182,Santa Llogaia d'Àlguema,379,190,189
17,Girona,184,Santa Pau,1605,808,797
17,Girona,186,Sarrià de Ter,5294,2607,2687
17,Girona,187,"Saus, Camallera i Llampaies",865,438,427
17,Girona,188,"Selva de Mar, La",220,111,109
17,Girona,190,Serinyà,1153,582,571
17,Girona,191,Serra de Daró,233,124,109
17,Girona,192,Setcases,200,112,88
17,Girona,193,Sils,6507,3358,3149
17,Girona,52,Siurana,178,84,94
17,Girona,194,Susqueda,96,55,41
17,Girona,195,"Tallada d'Empordà, La",480,254,226
17,Girona,196,Terrades,345,167,178
17,Girona,197,Torrent,166,92,74
17,Girona,198,Torroella de Fluvià,741,378,363
17,Girona,199,Torroella de Montgrí,12061,6143,5918
17,Girona,200,Tortellà,823,391,432
17,Girona,201,Toses,185,104,81
17,Girona,202,Tossa de Mar,5956,3052,2904
17,Girona,204,Ullà,1195,655,540
17,Girona,205,Ullastret,250,127,123
17,Girona,203,Ultramort,224,116,108
17,Girona,206,Urús,214,112,102
17,Girona,14,"Vajol, La",87,49,38
17,Girona,208,"Vall de Bianya, La",1345,673,672
17,Girona,207,"Vall d'en Bas, La",3143,1590,1553
17,Girona,170,Vallfogona de Ripollès,222,116,106
17,Girona,209,Vall-llobrega,926,463,463
17,Girona,210,Ventalló,911,456,455
17,Girona,211,Verges,1162,576,586
17,Girona,212,Vidrà,181,91,90
17,Girona,213,Vidreres,8167,4217,3950
17,Girona,214,Vilabertran,991,497,494
17,Girona,215,Vilablareix,3396,1691,1705
17,Girona,217,Viladamat,479,242,237
17,Girona,216,Viladasens,216,116,100
17,Girona,218,Vilademuls,840,437,403
17,Girona,220,Viladrau,1103,556,547
17,Girona,221,Vilafant,5562,2740,2822
17,Girona,223,Vilajuïga,1142,567,575
17,Girona,224,Vilallonga de Ter,410,224,186
17,Girona,225,Vilamacolum,386,222,164
17,Girona,226,Vilamalla,1166,593,573
17,Girona,227,Vilamaniscle,204,113,91
17,Girona,228,Vilanant,401,199,202
17,Girona,230,Vila-sacra,785,377,408
17,Girona,222,Vilaür,162,84,78
17,Girona,233,Vilobí d'Onyar,3304,1701,1603
17,Girona,232,Vilopriu,223,119,104
18,Granada,1,Agrón,247,130,117
18,Granada,2,Alamedilla,567,293,274
18,Granada,3,Albolote,19199,9426,9773
18,Granada,4,Albondón,724,398,326
18,Granada,5,Albuñán,407,210,197
18,Granada,6,Albuñol,7420,4118,3302
18,Granada,7,Albuñuelas,787,394,393
18,Granada,10,Aldeire,603,313,290
18,Granada,11,Alfacar,5585,2833,2752
18,Granada,12,Algarinejo,2436,1253,1183
18,Granada,13,Alhama de Granada,5703,2997,2706
18,Granada,14,Alhendín,9941,5018,4923
18,Granada,15,Alicún de Ortega,458,232,226
18,Granada,16,Almegíjar,328,156,172
18,Granada,17,Almuñécar,26748,13268,13480
18,Granada,904,Alpujarra de la Sierra,922,521,401
18,Granada,18,Alquife,586,296,290
18,Granada,20,Arenas del Rey,623,328,295
18,Granada,21,Armilla,24629,12116,12513
18,Granada,22,Atarfe,19452,9758,9694
18,Granada,23,Baza,20376,10100,10276
18,Granada,24,Beas de Granada,986,514,472
18,Granada,25,Beas de Guadix,319,159,160
18,Granada,27,Benalúa,3260,1608,1652
18,Granada,28,Benalúa de las Villas,1058,547,511
18,Granada,29,Benamaurel,2275,1134,1141
18,Granada,30,Bérchules,694,378,316
18,Granada,32,Bubión,323,169,154
18,Granada,33,Busquístar,302,163,139
18,Granada,34,Cacín,547,285,262
18,Granada,35,Cádiar,1542,814,728
18,Granada,36,Cájar,5389,2660,2729
18,Granada,114,"Calahorra, La",664,340,324
18,Granada,37,Calicasas,658,328,330
18,Granada,38,Campotéjar,1231,624,607
18,Granada,39,Caniles,4018,2057,1961
18,Granada,40,Cáñar,400,214,186
18,Granada,42,Capileira,578,283,295
18,Granada,43,Carataunas,201,111,90
18,Granada,44,Cástaras,233,141,92
18,Granada,45,Castilléjar,1312,689,623
18,Granada,46,Castril,2019,1049,970
18,Granada,47,Cenes de la Vega,8121,4030,4091
18,Granada,59,Chauchina,5667,2799,2868
18,Granada,61,Chimeneas,1254,666,588
18,Granada,62,Churriana de la Vega,16026,7892,8134
18,Granada,48,Cijuela,3537,1816,1721
18,Granada,49,Cogollos de Guadix,636,358,278
18,Granada,50,Cogollos de la Vega,2042,1043,999
18,Granada,51,Colomera,1291,681,610
18,Granada,53,Cortes de Baza,1824,906,918
18,Granada,54,Cortes y Graena,994,514,480
18,Granada,912,Cuevas del Campo,1767,889,878
18,Granada,56,Cúllar,4017,1992,2025
18,Granada,57,Cúllar Vega,7681,3890,3791
18,Granada,63,Darro,1652,846,806
18,Granada,64,Dehesas de Guadix,404,195,209
18,Granada,65,Dehesas Viejas,666,343,323
18,Granada,66,Deifontes,2615,1320,1295
18,Granada,67,Diezma,763,411,352
18,Granada,68,Dílar,2188,1096,1092
18,Granada,69,Dólar,614,325,289
18,Granada,915,Domingo Pérez de Granada,849,445,404
18,Granada,70,Dúdar,355,191,164
18,Granada,71,Dúrcal,7216,3627,3589
18,Granada,72,Escúzar,835,440,395
18,Granada,74,Ferreira,305,158,147
18,Granada,76,Fonelas,981,509,472
18,Granada,77,Fornes,519,274,245
18,Granada,78,Freila,906,478,428
18,Granada,79,Fuente Vaqueros,4451,2248,2203
18,Granada,905,"Gabias, Las",22312,11273,11039
18,Granada,82,Galera,1116,569,547
18,Granada,83,Gobernador,210,105,105
18,Granada,84,Gójar,6096,3084,3012
18,Granada,85,Gor,735,393,342
18,Granada,86,Gorafe,377,196,181
18,Granada,87,Granada,228682,105522,123160
18,Granada,88,Guadahortuna,1836,936,900
18,Granada,89,Guadix,18493,9189,9304
18,Granada,906,"Guájares, Los",1100,597,503
18,Granada,93,Gualchos,5292,2837,2455
18,Granada,94,Güéjar Sierra,2880,1537,1343
18,Granada,95,Güevéjar,2664,1381,1283
18,Granada,96,Huélago,373,193,180
18,Granada,97,Huéneja,1207,647,560
18,Granada,98,Huéscar,7246,3582,3664
18,Granada,99,Huétor de Santillán,1923,986,937
18,Granada,100,Huétor Tájar,10543,5319,5224
18,Granada,101,Huétor Vega,12089,6075,6014
18,Granada,102,Íllora,10020,5067,4953
18,Granada,103,Ítrabo,937,462,475
18,Granada,105,Iznalloz,5142,2627,2515
18,Granada,106,Játar,579,319,260
18,Granada,107,Jayena,1008,518,490
18,Granada,108,Jérez del Marquesado,956,483,473
18,Granada,109,Jete,1008,533,475
18,Granada,111,Jun,3991,2024,1967
18,Granada,112,Juviles,134,76,58
18,Granada,115,Láchar,3657,1868,1789
18,Granada,116,Lanjarón,3615,1817,1798
18,Granada,117,Lanteira,566,301,265
18,Granada,119,Lecrín,2225,1128,1097
18,Granada,120,Lentegí,335,168,167
18,Granada,121,Lobras,135,68,67
18,Granada,122,Loja,20555,10273,10282
18,Granada,123,Lugros,304,158,146
18,Granada,124,Lújar,483,260,223
18,Granada,126,"Malahá, La",1810,906,904
18,Granada,127,Maracena,22293,10889,11404
18,Granada,128,Marchal,414,199,215
18,Granada,132,Moclín,3607,1790,1817
18,Granada,133,Molvízar,2731,1405,1326
18,Granada,134,Monachil,8182,4194,3988
18,Granada,135,Montefrío,5406,2819,2587
18,Granada,136,Montejícar,2058,1067,991
18,Granada,137,Montillana,1083,576,507
18,Granada,138,Moraleda de Zafayona,3123,1585,1538
18,Granada,909,Morelábor,582,310,272
18,Granada,140,Motril,58798,28845,29953
18,Granada,141,Murtas,463,261,202
18,Granada,903,Nevada,1086,560,526
18,Granada,143,Nigüelas,1225,628,597
18,Granada,144,Nívar,1099,569,530
18,Granada,145,Ogíjares,14627,7263,7364
18,Granada,146,Orce,1148,577,571
18,Granada,147,Órgiva,5791,2890,2901
18,Granada,148,Otívar,1004,517,487
18,Granada,150,Padul,9158,4575,4583
18,Granada,151,Pampaneira,319,161,158
18,Granada,152,Pedro Martínez,1120,562,558
18,Granada,153,Peligros,11624,5749,5875
18,Granada,154,"Peza, La",1149,597,552
18,Granada,910,"Pinar, El",896,474,422
18,Granada,157,Pinos Genil,1530,795,735
18,Granada,158,Pinos Puente,9804,4876,4928
18,Granada,159,Píñar,1106,601,505
18,Granada,161,Polícar,262,139,123
18,Granada,162,Polopos,1630,900,730
18,Granada,163,Pórtugos,397,202,195
18,Granada,164,Puebla de Don Fadrique,2197,1126,1071
18,Granada,165,Pulianas,5495,2765,2730
18,Granada,167,Purullena,2329,1180,1149
18,Granada,168,Quéntar,972,508,464
18,Granada,170,Rubite,403,226,177
18,Granada,171,Salar,2612,1306,1306
18,Granada,173,Salobreña,12477,6224,6253
18,Granada,174,Santa Cruz del Comercio,539,275,264
18,Granada,175,Santa Fe,15042,7399,7643
18,Granada,176,Soportújar,265,142,123
18,Granada,177,Sorvilán,535,298,237
18,Granada,901,"Taha, La",727,357,370
18,Granada,178,Torre-Cardela,709,385,324
18,Granada,916,Torrenueva Costa,3038,1592,1446
18,Granada,179,Torvizcón,650,346,304
18,Granada,180,Trevélez,712,377,335
18,Granada,181,Turón,235,144,91
18,Granada,182,Ugíjar,2555,1264,1291
18,Granada,914,Valderrubio,2045,1007,1038
18,Granada,907,Valle del Zalabí,2087,1068,1019
18,Granada,902,"Valle, El",917,458,459
18,Granada,183,Válor,678,359,319
18,Granada,911,Vegas del Genil,11874,6045,5829
18,Granada,184,Vélez de Benaudalla,2960,1495,1465
18,Granada,185,Ventas de Huelma,641,356,285
18,Granada,149,Villa de Otura,7362,3717,3645
18,Granada,908,Villamena,954,488,466
18,Granada,187,Villanueva de las Torres,536,296,240
18,Granada,188,Villanueva Mesía,2031,990,1041
18,Granada,189,Víznar,987,514,473
18,Granada,192,Zafarraya,2123,1124,999
18,Granada,913,Zagra,931,501,430
18,Granada,193,"Zubia, La",19593,9691,9902
18,Granada,194,Zújar,2501,1280,1221
19,Guadalajara,1,Abánades,61,37,24
19,Guadalajara,2,Ablanque,63,35,28
19,Guadalajara,3,Adobes,28,16,12
19,Guadalajara,4,Alaminos,56,27,29
19,Guadalajara,5,Alarilla,136,84,52
19,Guadalajara,6,Albalate de Zorita,1056,586,470
19,Guadalajara,7,Albares,518,268,250
19,Guadalajara,8,Albendiego,46,31,15
19,Guadalajara,9,Alcocer,315,161,154
19,Guadalajara,10,Alcolea de las Peñas,12,8,4
19,Guadalajara,11,Alcolea del Pinar,326,189,137
19,Guadalajara,13,Alcoroches,122,73,49
19,Guadalajara,15,Aldeanueva de Guadalajara,106,63,43
19,Guadalajara,16,Algar de Mesa,48,34,14
19,Guadalajara,17,Algora,80,50,30
19,Guadalajara,18,Alhóndiga,158,91,67
19,Guadalajara,19,Alique,13,6,7
19,Guadalajara,20,Almadrones,54,36,18
19,Guadalajara,21,Almoguera,1284,649,635
19,Guadalajara,22,Almonacid de Zorita,659,337,322
19,Guadalajara,23,Alocén,159,80,79
19,Guadalajara,24,Alovera,13142,6701,6441
19,Guadalajara,27,Alustante,145,85,60
19,Guadalajara,31,Angón,10,8,2
19,Guadalajara,32,Anguita,155,84,71
19,Guadalajara,33,Anquela del Ducado,54,32,22
19,Guadalajara,34,Anquela del Pedregal,26,15,11
19,Guadalajara,36,Aranzueque,358,195,163
19,Guadalajara,37,Arbancón,145,86,59
19,Guadalajara,38,Arbeteta,19,15,4
19,Guadalajara,39,Argecilla,70,47,23
19,Guadalajara,40,Armallones,50,28,22
19,Guadalajara,41,Armuña de Tajuña,254,128,126
19,Guadalajara,42,Arroyo de las Fraguas,23,12,11
19,Guadalajara,43,Atanzón,97,64,33
19,Guadalajara,44,Atienza,398,231,167
19,Guadalajara,45,Auñón,151,84,67
19,Guadalajara,46,Azuqueca de Henares,35182,17735,17447
19,Guadalajara,47,Baides,60,30,30
19,Guadalajara,48,Baños de Tajo,17,12,5
19,Guadalajara,49,Bañuelos,14,12,2
19,Guadalajara,50,Barriopedro,19,12,7
19,Guadalajara,51,Berninches,52,35,17
19,Guadalajara,52,"Bodera, La",22,15,7
19,Guadalajara,53,Brihuega,2511,1308,1203
19,Guadalajara,54,Budia,197,117,80
19,Guadalajara,55,Bujalaro,44,22,22
19,Guadalajara,57,Bustares,71,43,28
19,Guadalajara,58,Cabanillas del Campo,10968,5518,5450
19,Guadalajara,59,Campillo de Dueñas,80,48,32
19,Guadalajara,60,Campillo de Ranas,109,71,38
19,Guadalajara,61,Campisábalos,67,46,21
19,Guadalajara,64,Canredondo,76,48,28
19,Guadalajara,65,Cantalojas,135,76,59
19,Guadalajara,66,Cañizar,57,34,23
19,Guadalajara,67,"Cardoso de la Sierra, El",49,31,18
19,Guadalajara,70,Casa de Uceda,92,51,41
19,Guadalajara,71,"Casar, El",12919,6524,6395
19,Guadalajara,73,Casas de San Galindo,21,15,6
19,Guadalajara,74,Caspueñas,119,74,45
19,Guadalajara,75,Castejón de Henares,61,39,22
19,Guadalajara,76,Castellar de la Muela,27,14,13
19,Guadalajara,78,Castilforte,56,36,20
19,Guadalajara,79,Castilnuevo,6,5,1
19,Guadalajara,80,Cendejas de Enmedio,67,35,32
19,Guadalajara,81,Cendejas de la Torre,24,17,7
19,Guadalajara,82,Centenera,144,83,61
19,Guadalajara,103,Checa,286,174,112
19,Guadalajara,104,Chequilla,16,9,7
19,Guadalajara,106,Chillarón del Rey,85,47,38
19,Guadalajara,105,Chiloeches,3858,1998,1860
19,Guadalajara,86,Cifuentes,1625,822,803
19,Guadalajara,87,Cincovillas,27,14,13
19,Guadalajara,88,Ciruelas,120,68,52
19,Guadalajara,89,Ciruelos del Pinar,24,14,10
19,Guadalajara,90,Cobeta,108,53,55
19,Guadalajara,91,Cogollor,20,13,7
19,Guadalajara,92,Cogolludo,563,329,234
19,Guadalajara,95,Condemios de Abajo,11,9,2
19,Guadalajara,96,Condemios de Arriba,106,62,44
19,Guadalajara,97,Congostrina,13,10,3
19,Guadalajara,98,Copernal,34,23,11
19,Guadalajara,99,Corduente,324,184,140
19,Guadalajara,102,"Cubillo de Uceda, El",121,69,52
19,Guadalajara,107,Driebes,355,197,158
19,Guadalajara,108,Durón,109,62,47
19,Guadalajara,109,Embid,28,17,11
19,Guadalajara,110,Escamilla,63,42,21
19,Guadalajara,111,Escariche,186,114,72
19,Guadalajara,112,Escopete,68,37,31
19,Guadalajara,113,Espinosa de Henares,625,318,307
19,Guadalajara,114,Esplegares,33,18,15
19,Guadalajara,115,Establés,29,17,12
19,Guadalajara,116,Estriégana,12,9,3
19,Guadalajara,117,Fontanar,2567,1344,1223
19,Guadalajara,118,Fuembellida,12,8,4
19,Guadalajara,119,Fuencemillán,79,49,30
19,Guadalajara,120,Fuentelahiguera de Albatages,130,76,54
19,Guadalajara,121,Fuentelencina,314,165,149
19,Guadalajara,122,Fuentelsaz,88,45,43
19,Guadalajara,123,Fuentelviejo,52,31,21
19,Guadalajara,124,Fuentenovilla,568,318,250
19,Guadalajara,125,Gajanejos,61,37,24
19,Guadalajara,126,Galápagos,2600,1353,1247
19,Guadalajara,127,Galve de Sorbe,96,52,44
19,Guadalajara,129,Gascueña de Bornova,30,18,12
19,Guadalajara,130,Guadalajara,87452,42094,45358
19,Guadalajara,132,Henche,82,43,39
19,Guadalajara,133,Heras de Ayuso,231,128,103
19,Guadalajara,134,Herrería,24,15,9
19,Guadalajara,135,Hiendelaencina,115,72,43
19,Guadalajara,136,Hijes,19,11,8
19,Guadalajara,138,Hita,325,182,143
19,Guadalajara,139,Hombrados,45,27,18
19,Guadalajara,142,Hontoba,390,220,170
19,Guadalajara,143,Horche,2751,1381,1370
19,Guadalajara,145,Hortezuela de Océn,38,23,15
19,Guadalajara,146,"Huerce, La",54,32,22
19,Guadalajara,147,Huérmeces del Cerro,42,31,11
19,Guadalajara,148,Huertahernando,57,37,20
19,Guadalajara,150,Hueva,97,60,37
19,Guadalajara,151,Humanes,1644,835,809
19,Guadalajara,152,Illana,799,443,356
19,Guadalajara,153,Iniéstola,22,15,7
19,Guadalajara,154,"Inviernas, Las",61,42,19
19,Guadalajara,155,Irueste,81,52,29
19,Guadalajara,156,Jadraque,1393,731,662
19,Guadalajara,157,Jirueque,49,34,15
19,Guadalajara,159,Ledanca,107,52,55
19,Guadalajara,160,Loranca de Tajuña,1318,715,603
19,Guadalajara,161,Lupiana,286,154,132
19,Guadalajara,162,Luzaga,65,36,29
19,Guadalajara,163,Luzón,65,32,33
19,Guadalajara,165,Majaelrayo,54,34,20
19,Guadalajara,166,Málaga del Fresno,174,97,77
19,Guadalajara,167,Malaguilla,172,96,76
19,Guadalajara,168,Mandayona,298,145,153
19,Guadalajara,169,Mantiel,31,21,10
19,Guadalajara,170,Maranchón,225,120,105
19,Guadalajara,171,Marchamalo,8030,4029,4001
19,Guadalajara,172,Masegoso de Tajuña,57,33,24
19,Guadalajara,173,Matarrubia,64,42,22
19,Guadalajara,174,Matillas,103,56,47
19,Guadalajara,175,Mazarete,24,11,13
19,Guadalajara,176,Mazuecos,260,144,116
19,Guadalajara,177,Medranda,68,34,34
19,Guadalajara,178,Megina,36,23,13
19,Guadalajara,179,Membrillera,117,68,49
19,Guadalajara,181,Miedes de Atienza,54,36,18
19,Guadalajara,182,"Mierla, La",38,24,14
19,Guadalajara,184,Millana,110,66,44
19,Guadalajara,183,Milmarcos,70,43,27
19,Guadalajara,185,"Miñosa, La",29,17,12
19,Guadalajara,186,Mirabueno,83,51,32
19,Guadalajara,187,Miralrío,64,35,29
19,Guadalajara,188,Mochales,38,19,19
19,Guadalajara,189,Mohernando,167,94,73
19,Guadalajara,190,Molina de Aragón,3234,1598,1636
19,Guadalajara,191,Monasterio,15,7,8
19,Guadalajara,192,Mondéjar,2757,1435,1322
19,Guadalajara,193,Montarrón,26,17,9
19,Guadalajara,194,Moratilla de los Meleros,107,61,46
19,Guadalajara,195,Morenilla,52,29,23
19,Guadalajara,196,Muduex,103,56,47
19,Guadalajara,197,"Navas de Jadraque, Las",33,22,11
19,Guadalajara,198,Negredo,16,8,8
19,Guadalajara,199,Ocentejo,16,11,5
19,Guadalajara,200,"Olivar, El",61,36,25
19,Guadalajara,201,Olmeda de Cobeta,59,30,29
19,Guadalajara,202,"Olmeda de Jadraque, La",14,11,3
19,Guadalajara,203,"Ordial, El",39,24,15
19,Guadalajara,204,Orea,189,115,74
19,Guadalajara,208,Pálmaces de Jadraque,42,28,14
19,Guadalajara,209,Pardos,39,22,17
19,Guadalajara,210,Paredes de Sigüenza,23,10,13
19,Guadalajara,211,Pareja,463,280,183
19,Guadalajara,212,Pastrana,850,422,428
19,Guadalajara,213,"Pedregal, El",63,43,20
19,Guadalajara,214,Peñalén,78,45,33
19,Guadalajara,215,Peñalver,154,97,57
19,Guadalajara,216,Peralejos de las Truchas,149,79,70
19,Guadalajara,217,Peralveche,47,32,15
19,Guadalajara,218,Pinilla de Jadraque,52,33,19
19,Guadalajara,219,Pinilla de Molina,12,10,2
19,Guadalajara,220,Pioz,5013,2609,2404
19,Guadalajara,221,Piqueras,42,30,12
19,Guadalajara,222,"Pobo de Dueñas, El",101,52,49
19,Guadalajara,223,Poveda de la Sierra,116,62,54
19,Guadalajara,224,Pozo de Almoguera,110,67,43
19,Guadalajara,225,Pozo de Guadalajara,1555,837,718
19,Guadalajara,226,Prádena de Atienza,41,28,13
19,Guadalajara,227,Prados Redondos,54,39,15
19,Guadalajara,228,Puebla de Beleña,49,30,19
19,Guadalajara,229,Puebla de Valles,58,34,24
19,Guadalajara,230,Quer,945,502,443
19,Guadalajara,231,Rebollosa de Jadraque,11,8,3
19,Guadalajara,232,"Recuenco, El",61,36,25
19,Guadalajara,233,Renera,104,68,36
19,Guadalajara,234,Retiendas,50,34,16
19,Guadalajara,235,Riba de Saelices,115,69,46
19,Guadalajara,237,Rillo de Gallo,47,27,20
19,Guadalajara,238,Riofrío del Llano,58,36,22
19,Guadalajara,239,Robledillo de Mohernando,148,87,61
19,Guadalajara,240,Robledo de Corpes,42,21,21
19,Guadalajara,241,Romanillos de Atienza,32,22,10
19,Guadalajara,242,Romanones,112,58,54
19,Guadalajara,243,Rueda de la Sierra,41,28,13
19,Guadalajara,244,Sacecorbo,99,58,41
19,Guadalajara,245,Sacedón,1547,792,755
19,Guadalajara,246,Saelices de la Sal,48,28,20
19,Guadalajara,247,Salmerón,128,74,54
19,Guadalajara,248,San Andrés del Congosto,73,47,26
19,Guadalajara,249,San Andrés del Rey,36,19,17
19,Guadalajara,250,Santiuste,14,10,4
19,Guadalajara,251,Saúca,52,31,21
19,Guadalajara,252,Sayatón,63,34,29
19,Guadalajara,254,Selas,40,20,20
19,Guadalajara,901,Semillas,35,22,13
19,Guadalajara,255,Setiles,86,49,37
19,Guadalajara,256,Sienes,48,28,20
19,Guadalajara,257,Sigüenza,4359,2221,2138
19,Guadalajara,258,Solanillos del Extremo,87,56,31
19,Guadalajara,259,Somolinos,31,17,14
19,Guadalajara,260,"Sotillo, El",35,17,18
19,Guadalajara,261,Sotodosos,31,18,13
19,Guadalajara,262,Tamajón,147,83,64
19,Guadalajara,263,Taragudo,43,27,16
19,Guadalajara,264,Taravilla,33,23,10
19,Guadalajara,265,Tartanedo,147,87,60
19,Guadalajara,266,Tendilla,315,173,142
19,Guadalajara,267,Terzaga,20,12,8
19,Guadalajara,268,Tierzo,36,21,15
19,Guadalajara,269,"Toba, La",76,50,26
19,Guadalajara,271,Tordellego,49,28,21
19,Guadalajara,270,Tordelrábano,12,8,4
19,Guadalajara,272,Tordesilos,93,55,38
19,Guadalajara,274,Torija,1663,863,800
19,Guadalajara,279,Torre del Burgo,474,273,201
19,Guadalajara,277,Torrecuadrada de Molina,21,14,7
19,Guadalajara,278,Torrecuadradilla,28,17,11
19,Guadalajara,280,Torrejón del Rey,6002,3114,2888
19,Guadalajara,281,Torremocha de Jadraque,18,10,8
19,Guadalajara,282,Torremocha del Campo,183,106,77
19,Guadalajara,283,Torremocha del Pinar,40,18,22
19,Guadalajara,284,Torremochuela,8,6,2
19,Guadalajara,285,Torrubia,23,15,8
19,Guadalajara,286,Tórtola de Henares,1331,713,618
19,Guadalajara,287,Tortuera,181,94,87
19,Guadalajara,288,Tortuero,18,13,5
19,Guadalajara,289,Traíd,24,15,9
19,Guadalajara,290,Trijueque,1478,794,684
19,Guadalajara,291,Trillo,1401,732,669
19,Guadalajara,293,Uceda,3048,1563,1485
19,Guadalajara,294,Ujados,28,13,15
19,Guadalajara,296,Utande,34,26,8
19,Guadalajara,297,Valdarachas,47,24,23
19,Guadalajara,298,Valdearenas,76,49,27
19,Guadalajara,299,Valdeavellano,108,58,50
19,Guadalajara,300,Valdeaveruelo,1177,612,565
19,Guadalajara,301,Valdeconcha,39,22,17
19,Guadalajara,302,Valdegrudas,53,34,19
19,Guadalajara,303,Valdelcubo,38,25,13
19,Guadalajara,304,Valdenuño Fernández,308,168,140
19,Guadalajara,305,Valdepeñas de la Sierra,147,89,58
19,Guadalajara,306,Valderrebollo,23,12,11
19,Guadalajara,307,Valdesotos,27,17,10
19,Guadalajara,308,Valfermoso de Tajuña,74,45,29
19,Guadalajara,309,Valhermoso,26,16,10
19,Guadalajara,310,Valtablado del Río,8,5,3
19,Guadalajara,311,Valverde de los Arroyos,88,49,39
19,Guadalajara,314,Viana de Jadraque,41,28,13
19,Guadalajara,317,Villanueva de Alcorón,135,79,56
19,Guadalajara,318,Villanueva de Argecilla,39,21,18
19,Guadalajara,319,Villanueva de la Torre,6559,3333,3226
19,Guadalajara,321,Villares de Jadraque,49,31,18
19,Guadalajara,322,Villaseca de Henares,26,14,12
19,Guadalajara,323,Villaseca de Uceda,45,24,21
19,Guadalajara,324,Villel de Mesa,173,102,71
19,Guadalajara,325,Viñuelas,182,91,91
19,Guadalajara,326,Yebes,4936,2532,2404
19,Guadalajara,327,Yebra,451,241,210
19,Guadalajara,329,Yélamos de Abajo,65,32,33
19,Guadalajara,330,Yélamos de Arriba,82,49,33
19,Guadalajara,331,Yunquera de Henares,4329,2203,2126
19,Guadalajara,332,"Yunta, La",90,53,37
19,Guadalajara,333,Zaorejas,101,67,34
19,Guadalajara,334,Zarzuela de Jadraque,54,37,17
19,Guadalajara,335,Zorita de los Canes,60,34,26
21,Huelva,1,Alájar,802,412,390
21,Huelva,2,Aljaraque,22078,10980,11098
21,Huelva,3,"Almendro, El",848,439,409
21,Huelva,4,Almonaster la Real,1785,948,837
21,Huelva,5,Almonte,25448,12370,13078
21,Huelva,6,Alosno,3940,1947,1993
21,Huelva,7,Aracena,8240,4055,4185
21,Huelva,8,Aroche,3024,1511,1513
21,Huelva,9,Arroyomolinos de León,951,481,470
21,Huelva,10,Ayamonte,21725,10902,10823
21,Huelva,11,Beas,4465,2217,2248
21,Huelva,12,Berrocal,302,154,148
21,Huelva,13,Bollullos Par del Condado,14293,7077,7216
21,Huelva,14,Bonares,6093,3034,3059
21,Huelva,15,Cabezas Rubias,705,369,336
21,Huelva,16,Cala,1155,586,569
21,Huelva,17,Calañas,2734,1382,1352
21,Huelva,18,"Campillo, El",2018,982,1036
21,Huelva,19,Campofrío,742,383,359
21,Huelva,20,Cañaveral de León,393,197,196
21,Huelva,21,Cartaya,20717,10533,10184
21,Huelva,22,Castaño del Robledo,227,127,100
21,Huelva,23,"Cerro de Andévalo, El",2286,1142,1144
21,Huelva,30,Chucena,2229,1115,1114
21,Huelva,24,Corteconcepción,561,295,266
21,Huelva,25,Cortegana,4636,2343,2293
21,Huelva,26,Cortelazor,302,142,160
21,Huelva,27,Cumbres de Enmedio,59,31,28
21,Huelva,28,Cumbres de San Bartolomé,377,196,181
21,Huelva,29,Cumbres Mayores,1737,860,877
21,Huelva,31,Encinasola,1275,645,630
21,Huelva,32,Escacena del Campo,2288,1100,1188
21,Huelva,33,Fuenteheridos,778,402,376
21,Huelva,34,Galaroza,1373,686,687
21,Huelva,35,Gibraleón,12930,6485,6445
21,Huelva,36,"Granada de Río-Tinto, La",254,126,128
21,Huelva,37,"Granado, El",507,263,244
21,Huelva,38,Higuera de la Sierra,1320,688,632
21,Huelva,39,Hinojales,335,168,167
21,Huelva,40,Hinojos,3951,1992,1959
21,Huelva,41,Huelva,141854,68050,73804
21,Huelva,42,Isla Cristina,21523,10801,10722
21,Huelva,43,Jabugo,2243,1123,1120
21,Huelva,44,Lepe,28617,14791,13826
21,Huelva,45,Linares de la Sierra,276,134,142
21,Huelva,46,Lucena del Puerto,3213,1691,1522
21,Huelva,47,Manzanilla,2119,1091,1028
21,Huelva,48,"Marines, Los",410,216,194
21,Huelva,49,Minas de Riotinto,3738,1801,1937
21,Huelva,50,Moguer,22643,11407,11236
21,Huelva,51,"Nava, La",247,130,117
21,Huelva,52,Nerva,5100,2462,2638
21,Huelva,53,Niebla,4196,2112,2084
21,Huelva,54,"Palma del Condado, La",10770,5360,5410
21,Huelva,55,Palos de la Frontera,12483,6418,6065
21,Huelva,56,Paterna del Campo,3478,1772,1706
21,Huelva,57,Paymogo,1124,557,567
21,Huelva,58,Puebla de Guzmán,3092,1586,1506
21,Huelva,59,Puerto Moral,281,137,144
21,Huelva,60,Punta Umbría,16167,8238,7929
21,Huelva,61,Rociana del Condado,7866,3933,3933
21,Huelva,62,Rosal de la Frontera,1698,844,854
21,Huelva,63,San Bartolomé de la Torre,3906,1964,1942
21,Huelva,64,San Juan del Puerto,9532,4774,4758
21,Huelva,66,San Silvestre de Guzmán,659,345,314
21,Huelva,65,Sanlúcar de Guadiana,402,199,203
21,Huelva,67,Santa Ana la Real,473,219,254
21,Huelva,68,Santa Bárbara de Casa,1075,536,539
21,Huelva,69,Santa Olalla del Cala,2028,1040,988
21,Huelva,70,Trigueros,7926,3933,3993
21,Huelva,71,Valdelarco,239,111,128
21,Huelva,72,Valverde del Camino,12721,6250,6471
21,Huelva,73,Villablanca,2945,1482,1463
21,Huelva,74,Villalba del Alcor,3316,1641,1675
21,Huelva,75,Villanueva de las Cruces,377,184,193
21,Huelva,76,Villanueva de los Castillejos,2923,1495,1428
21,Huelva,77,Villarrasa,2190,1098,1092
21,Huelva,78,Zalamea la Real,3026,1519,1507
21,Huelva,902,"Zarza-Perrunal, La",1230,622,608
21,Huelva,79,Zufre,774,405,369
22,Huesca,1,Abiego,278,139,139
22,Huesca,2,Abizanda,151,76,75
22,Huesca,3,Adahuesca,204,117,87
22,Huesca,4,Agüero,145,80,65
22,Huesca,907,Aínsa-Sobrarbe,2315,1166,1149
22,Huesca,6,Aisa,339,184,155
22,Huesca,7,Albalate de Cinca,1125,616,509
22,Huesca,8,Albalatillo,204,110,94
22,Huesca,9,Albelda,694,356,338
22,Huesca,11,Albero Alto,117,66,51
22,Huesca,12,Albero Bajo,134,71,63
22,Huesca,13,Alberuela de Tubo,305,155,150
22,Huesca,14,Alcalá de Gurrea,230,121,109
22,Huesca,15,Alcalá del Obispo,374,212,162
22,Huesca,16,Alcampell,623,295,328
22,Huesca,17,Alcolea de Cinca,1160,627,533
22,Huesca,18,Alcubierre,399,217,182
22,Huesca,19,Alerre,213,115,98
22,Huesca,20,Alfántega,124,67,57
22,Huesca,21,Almudévar,2394,1217,1177
22,Huesca,22,Almunia de San Juan,707,367,340
22,Huesca,23,Almuniente,453,236,217
22,Huesca,24,Alquézar,354,184,170
22,Huesca,25,Altorricón,1416,771,645
22,Huesca,27,Angüés,368,196,172
22,Huesca,28,Ansó,406,204,202
22,Huesca,29,Antillón,136,71,65
22,Huesca,32,Aragüés del Puerto,117,65,52
22,Huesca,35,Arén,318,172,146
22,Huesca,36,Argavieso,126,76,50
22,Huesca,37,Arguis,153,84,69
22,Huesca,39,Ayerbe,1059,526,533
22,Huesca,40,Azanuy-Alins,174,86,88
22,Huesca,41,Azara,160,84,76
22,Huesca,42,Azlor,148,68,80
22,Huesca,43,Baélls,90,51,39
22,Huesca,44,Bailo,273,164,109
22,Huesca,45,Baldellou,79,43,36
22,Huesca,46,Ballobar,864,446,418
22,Huesca,47,Banastás,333,171,162
22,Huesca,48,Barbastro,17214,8442,8772
22,Huesca,49,Barbués,90,55,35
22,Huesca,50,Barbuñales,98,49,49
22,Huesca,51,Bárcabo,108,59,49
22,Huesca,52,Belver de Cinca,1330,770,560
22,Huesca,53,Benabarre,1175,607,568
22,Huesca,54,Benasque,2282,1230,1052
22,Huesca,246,Beranuy,72,40,32
22,Huesca,55,Berbegal,335,180,155
22,Huesca,57,Bielsa,480,255,225
22,Huesca,58,Bierge,251,141,110
22,Huesca,59,Biescas,1584,835,749
22,Huesca,60,Binaced,1621,883,738
22,Huesca,61,Binéfar,9927,5278,4649
22,Huesca,62,Bisaurri,173,91,82
22,Huesca,63,Biscarrués,193,102,91
22,Huesca,64,Blecua y Torres,188,101,87
22,Huesca,66,Boltaña,1097,586,511
22,Huesca,67,Bonansa,91,51,40
22,Huesca,68,Borau,90,50,40
22,Huesca,69,Broto,577,322,255
22,Huesca,72,Caldearenas,241,141,100
22,Huesca,74,Campo,460,245,215
22,Huesca,75,Camporrélls,136,70,66
22,Huesca,76,Canal de Berdún,346,189,157
22,Huesca,77,Candasnos,396,217,179
22,Huesca,78,Canfranc,612,347,265
22,Huesca,79,Capdesaso,204,85,119
22,Huesca,80,Capella,352,187,165
22,Huesca,81,Casbas de Huesca,301,171,130
22,Huesca,83,Castejón de Monegros,512,271,241
22,Huesca,84,Castejón de Sos,805,405,400
22,Huesca,82,Castejón del Puente,333,175,158
22,Huesca,85,Castelflorite,100,49,51
22,Huesca,86,Castiello de Jaca,249,139,110
22,Huesca,87,Castigaleu,88,55,33
22,Huesca,88,Castillazuelo,164,86,78
22,Huesca,89,Castillonroy,328,170,158
22,Huesca,94,Chalamera,117,63,54
22,Huesca,95,Chía,87,54,33
22,Huesca,96,Chimillas,402,206,196
22,Huesca,90,Colungo,123,69,54
22,Huesca,99,Esplús,656,342,314
22,Huesca,102,Estada,206,117,89
22,Huesca,103,Estadilla,812,415,397
22,Huesca,105,Estopiñán del Castillo,117,62,55
22,Huesca,106,Fago,25,15,10
22,Huesca,107,Fanlo,106,67,39
22,Huesca,109,Fiscal,361,198,163
22,Huesca,110,Fonz,857,431,426
22,Huesca,111,Foradada del Toscar,168,92,76
22,Huesca,112,Fraga,15294,7819,7475
22,Huesca,113,"Fueva, La",609,328,281
22,Huesca,114,Gistaín,129,74,55
22,Huesca,115,"Grado, El",405,208,197
22,Huesca,116,Grañén,1727,899,828
22,Huesca,117,Graus,3420,1698,1722
22,Huesca,119,Gurrea de Gállego,1460,751,709
22,Huesca,122,Hoz de Jaca,77,40,37
22,Huesca,908,Hoz y Costean,240,134,106
22,Huesca,124,Huerto,230,125,105
22,Huesca,125,Huesca,53305,25507,27798
22,Huesca,126,Ibieca,110,61,49
22,Huesca,127,Igriés,703,370,333
22,Huesca,128,Ilche,188,97,91
22,Huesca,129,Isábena,239,123,116
22,Huesca,130,Jaca,13437,6594,6843
22,Huesca,131,Jasa,105,62,43
22,Huesca,133,Labuerda,146,81,65
22,Huesca,135,Laluenga,202,104,98
22,Huesca,136,Lalueza,888,463,425
22,Huesca,137,Lanaja,1189,631,558
22,Huesca,139,Laperdiguera,95,51,44
22,Huesca,141,Lascellas-Ponzano,135,84,51
22,Huesca,142,Lascuarre,141,72,69
22,Huesca,143,Laspaúles,228,127,101
22,Huesca,144,Laspuña,286,155,131
22,Huesca,149,Loarre,353,192,161
22,Huesca,150,Loporzano,574,321,253
22,Huesca,151,Loscorrales,98,47,51
22,Huesca,905,Lupiñén-Ortilla,354,180,174
22,Huesca,155,Monesma y Cajigar,66,36,30
22,Huesca,156,Monflorite-Lascasas,442,240,202
22,Huesca,157,Montanuy,224,130,94
22,Huesca,158,Monzón,17650,8915,8735
22,Huesca,160,Naval,263,142,121
22,Huesca,162,Novales,155,78,77
22,Huesca,163,Nueno,584,332,252
22,Huesca,164,Olvena,67,33,34
22,Huesca,165,Ontiñena,514,266,248
22,Huesca,167,Osso de Cinca,650,366,284
22,Huesca,168,Palo,30,16,14
22,Huesca,170,Panticosa,887,466,421
22,Huesca,172,Peñalba,757,446,311
22,Huesca,173,"Peñas de Riglos, Las",260,163,97
22,Huesca,174,Peralta de Alcofea,596,304,292
22,Huesca,175,Peralta de Calasanz,221,124,97
22,Huesca,176,Peraltilla,223,107,116
22,Huesca,177,Perarrúa,108,59,49
22,Huesca,178,Pertusa,125,74,51
22,Huesca,181,Piracés,95,48,47
22,Huesca,182,Plan,283,150,133
22,Huesca,184,Poleñino,193,101,92
22,Huesca,186,Pozán de Vero,241,120,121
22,Huesca,187,"Puebla de Castro, La",415,221,194
22,Huesca,188,Puente de Montañana,94,44,50
22,Huesca,902,Puente la Reina de Jaca,261,140,121
22,Huesca,189,Puértolas,216,115,101
22,Huesca,190,"Pueyo de Araguás, El",168,93,75
22,Huesca,193,Pueyo de Santa Cruz,318,154,164
22,Huesca,195,Quicena,295,142,153
22,Huesca,197,Robres,537,280,257
22,Huesca,199,Sabiñánigo,9371,4699,4672
22,Huesca,200,Sahún,308,150,158
22,Huesca,201,Salas Altas,316,164,152
22,Huesca,202,Salas Bajas,190,94,96
22,Huesca,203,Salillas,102,58,44
22,Huesca,204,Sallent de Gállego,1557,781,776
22,Huesca,205,San Esteban de Litera,586,305,281
22,Huesca,207,San Juan de Plan,158,86,72
22,Huesca,903,San Miguel del Cinca,801,411,390
22,Huesca,206,Sangarrén,219,117,102
22,Huesca,208,Santa Cilia,254,129,125
22,Huesca,209,Santa Cruz de la Serós,194,109,85
22,Huesca,906,Santa María de Dulcis,201,108,93
22,Huesca,212,Santaliestra y San Quílez,79,47,32
22,Huesca,213,Sariñena,4164,2169,1995
22,Huesca,214,Secastilla,151,70,81
22,Huesca,215,Seira,159,88,71
22,Huesca,217,Sena,496,262,234
22,Huesca,218,Senés de Alcubierre,46,22,24
22,Huesca,220,Sesa,160,91,69
22,Huesca,221,Sesué,128,66,62
22,Huesca,222,Siétamo,697,393,304
22,Huesca,223,Sopeira,93,51,42
22,Huesca,904,"Sotonera, La",919,488,431
22,Huesca,225,Tamarite de Litera,3445,1775,1670
22,Huesca,226,Tardienta,937,464,473
22,Huesca,227,Tella-Sin,228,129,99
22,Huesca,228,Tierz,822,406,416
22,Huesca,229,Tolva,132,71,61
22,Huesca,230,Torla-Ordesa,307,163,144
22,Huesca,232,Torralba de Aragón,105,61,44
22,Huesca,233,Torre la Ribera,101,53,48
22,Huesca,234,Torrente de Cinca,1151,617,534
22,Huesca,235,Torres de Alcanadre,85,49,36
22,Huesca,236,Torres de Barbués,256,122,134
22,Huesca,239,Tramaced,110,68,42
22,Huesca,242,Valfarta,58,37,21
22,Huesca,243,Valle de Bardají,58,37,21
22,Huesca,901,Valle de Hecho,810,436,374
22,Huesca,244,Valle de Lierp,53,33,20
22,Huesca,245,Velilla de Cinca,476,249,227
22,Huesca,909,Vencillón,415,222,193
22,Huesca,247,Viacamp y Litera,39,25,14
22,Huesca,248,Vicién,128,73,55
22,Huesca,249,Villanova,170,89,81
22,Huesca,250,Villanúa,560,300,260
22,Huesca,251,Villanueva de Sigena,370,200,170
22,Huesca,252,Yebra de Basa,154,93,61
22,Huesca,253,Yésero,58,32,26
22,Huesca,254,Zaidín,1872,974,898
23,Jaén,1,Albanchez de Mágina,993,516,477
23,Jaén,2,Alcalá la Real,21556,10645,10911
23,Jaén,3,Alcaudete,10347,5090,5257
23,Jaén,4,Aldeaquemada,463,248,215
23,Jaén,5,Andújar,36030,17618,18412
23,Jaén,6,Arjona,5397,2662,2735
23,Jaén,7,Arjonilla,3535,1792,1743
23,Jaén,8,Arquillos,1698,855,843
23,Jaén,905,Arroyo del Ojanco,2227,1129,1098
23,Jaén,9,Baeza,15773,7815,7958
23,Jaén,10,Bailén,17377,8609,8768
23,Jaén,11,Baños de la Encina,2594,1340,1254
23,Jaén,12,Beas de Segura,5112,2657,2455
23,Jaén,902,Bedmar y Garcíez,2637,1343,1294
23,Jaén,14,Begíjar,3008,1507,1501
23,Jaén,15,Bélmez de la Moraleda,1519,738,781
23,Jaén,16,Benatae,448,228,220
23,Jaén,17,Cabra del Santo Cristo,1745,915,830
23,Jaén,18,Cambil,2642,1389,1253
23,Jaén,19,Campillo de Arenas,1705,856,849
23,Jaén,20,Canena,1802,938,864
23,Jaén,21,Carboneros,593,308,285
23,Jaén,901,Cárcheles,1310,684,626
23,Jaén,24,"Carolina, La",14960,7402,7558
23,Jaén,25,Castellar,3209,1616,1593
23,Jaén,26,Castillo de Locubín,3960,1966,1994
23,Jaén,27,Cazalilla,745,376,369
23,Jaén,28,Cazorla,7183,3473,3710
23,Jaén,29,Chiclana de Segura,902,462,440
23,Jaén,30,Chilluévar,1397,688,709
23,Jaén,31,Escañuela,932,459,473
23,Jaén,32,Espeluy,606,300,306
23,Jaén,33,Frailes,1565,786,779
23,Jaén,34,Fuensanta de Martos,3023,1529,1494
23,Jaén,35,Fuerte del Rey,1309,682,627
23,Jaén,37,Génave,573,305,268
23,Jaén,38,"Guardia de Jaén, La",5151,2633,2518
23,Jaén,39,Guarromán,2748,1377,1371
23,Jaén,41,Higuera de Calatrava,609,322,287
23,Jaén,42,Hinojares,335,175,160
23,Jaén,43,Hornos,589,291,298
23,Jaén,44,Huelma,5615,2779,2836
23,Jaén,45,Huesa,2445,1238,1207
23,Jaén,46,Ibros,2787,1397,1390
23,Jaén,47,"Iruela, La",1910,967,943
23,Jaén,48,Iznatoraf,905,454,451
23,Jaén,49,Jabalquinto,1968,984,984
23,Jaén,50,Jaén,111669,53690,57979
23,Jaén,51,Jamilena,3314,1655,1659
23,Jaén,52,Jimena,1253,611,642
23,Jaén,53,Jódar,11533,5744,5789
23,Jaén,40,Lahiguera,1638,810,828
23,Jaén,54,Larva,459,237,222
23,Jaén,55,Linares,55729,27232,28497
23,Jaén,56,Lopera,3616,1847,1769
23,Jaén,57,Lupión,830,405,425
23,Jaén,58,Mancha Real,11350,5659,5691
23,Jaén,59,Marmolejo,6660,3315,3345
23,Jaén,60,Martos,24329,12064,12265
23,Jaén,61,Mengíbar,9965,4958,5007
23,Jaén,62,Montizón,1606,820,786
23,Jaén,63,Navas de San Juan,4465,2248,2217
23,Jaén,64,Noalejo,1856,936,920
23,Jaén,65,Orcera,1752,885,867
23,Jaén,66,Peal de Becerro,5345,2677,2668
23,Jaén,67,Pegalajar,2823,1426,1397
23,Jaén,69,Porcuna,6080,3064,3016
23,Jaén,70,Pozo Alcón,4633,2384,2249
23,Jaén,71,Puente de Génave,2175,1112,1063
23,Jaén,72,"Puerta de Segura, La",2245,1128,1117
23,Jaén,73,Quesada,5106,2595,2511
23,Jaén,74,Rus,3465,1758,1707
23,Jaén,75,Sabiote,3863,1905,1958
23,Jaén,76,Santa Elena,883,458,425
23,Jaén,77,Santiago de Calatrava,655,345,310
23,Jaén,904,Santiago-Pontones,2777,1436,1341
23,Jaén,79,Santisteban del Puerto,4434,2289,2145
23,Jaén,80,Santo Tomé,2105,1072,1033
23,Jaén,81,Segura de la Sierra,1729,861,868
23,Jaén,82,Siles,2168,1109,1059
23,Jaén,84,Sorihuela del Guadalimar,1053,547,506
23,Jaén,85,Torreblascopedro,2460,1249,1211
23,Jaén,86,Torredelcampo,13922,6977,6945
23,Jaén,87,Torredonjimeno,13467,6642,6825
23,Jaén,88,Torreperogil,7130,3508,3622
23,Jaén,90,Torres,1360,703,657
23,Jaén,91,Torres de Albánchez,758,399,359
23,Jaén,92,Úbeda,34062,16656,17406
23,Jaén,93,Valdepeñas de Jaén,3597,1787,1810
23,Jaén,94,Vilches,4317,2168,2149
23,Jaén,95,Villacarrillo,10484,5286,5198
23,Jaén,96,Villanueva de la Reina,3013,1518,1495
23,Jaén,97,Villanueva del Arzobispo,7968,4082,3886
23,Jaén,98,Villardompardo,935,466,469
23,Jaén,99,"Villares, Los",6120,3074,3046
23,Jaén,101,Villarrodrigo,375,201,174
23,Jaén,903,Villatorres,4293,2194,2099
24,León,1,Acebedo,185,103,82
24,León,2,Algadefe,285,147,138
24,León,3,Alija del Infantado,569,302,267
24,León,4,Almanza,603,344,259
24,León,5,"Antigua, La",333,191,142
24,León,6,Ardón,569,312,257
24,León,7,Arganza,778,386,392
24,León,8,Astorga,10392,4874,5518
24,León,9,Balboa,271,149,122
24,León,10,"Bañeza, La",10024,4801,5223
24,León,11,Barjas,157,88,69
24,León,12,"Barrios de Luna, Los",299,171,128
24,León,14,Bembibre,8279,3982,4297
24,León,15,Benavides,2390,1182,1208
24,León,16,Benuza,464,279,185
24,León,17,Bercianos del Páramo,528,273,255
24,León,18,Bercianos del Real Camino,187,101,86
24,León,19,Berlanga del Bierzo,350,157,193
24,León,20,Boca de Huérgano,438,255,183
24,León,21,Boñar,1823,927,896
24,León,22,Borrenes,306,166,140
24,León,23,Brazuelo,340,201,139
24,León,24,"Burgo Ranero, El",697,370,327
24,León,25,Burón,290,171,119
24,León,26,Bustillo del Páramo,1094,564,530
24,León,27,Cabañas Raras,1339,696,643
24,León,28,Cabreros del Río,403,218,185
24,León,29,Cabrillanes,713,378,335
24,León,30,Cacabelos,4874,2400,2474
24,León,31,Calzada del Coto,224,131,93
24,León,32,Campazas,106,51,55
24,León,33,Campo de Villavidel,201,112,89
24,León,34,Camponaraya,4109,2032,2077
24,León,36,Candín,248,138,110
24,León,37,Cármenes,329,188,141
24,León,38,Carracedelo,3434,1726,1708
24,León,39,Carrizo,2234,1123,1111
24,León,40,Carrocera,458,237,221
24,León,41,Carucedo,501,252,249
24,León,42,Castilfalé,63,37,26
24,León,43,Castrillo de Cabrera,106,64,42
24,León,44,Castrillo de la Valduerna,144,70,74
24,León,46,Castrocalbón,931,479,452
24,León,47,Castrocontrigo,701,385,316
24,León,49,Castropodame,1577,820,757
24,León,50,Castrotierra de Valmadrigal,109,55,54
24,León,51,Cea,389,207,182
24,León,52,Cebanico,142,84,58
24,León,53,Cebrones del Río,437,245,192
24,León,65,Chozas de Abajo,2625,1353,1272
24,León,54,Cimanes de la Vega,453,237,216
24,León,55,Cimanes del Tejar,744,406,338
24,León,56,Cistierna,2986,1463,1523
24,León,57,Congosto,1447,718,729
24,León,58,Corbillos de los Oteros,187,104,83
24,León,59,Corullón,858,430,428
24,León,60,Crémenes,522,285,237
24,León,61,Cuadros,2049,1034,1015
24,León,62,Cubillas de los Oteros,137,75,62
24,León,63,Cubillas de Rueda,388,211,177
24,León,64,Cubillos del Sil,1789,931,858
24,León,66,Destriana,438,209,229
24,León,67,Encinedo,603,323,280
24,León,68,"Ercina, La",440,242,198
24,León,69,Escobar de Campos,31,19,12
24,León,70,Fabero,4239,2075,2164
24,León,71,Folgoso de la Ribera,1026,498,528
24,León,73,Fresno de la Vega,472,239,233
24,León,74,Fuentes de Carbajal,79,50,29
24,León,76,Garrafe de Torío,1580,852,728
24,León,77,Gordaliza del Pino,244,115,129
24,León,78,Gordoncillo,330,159,171
24,León,79,Gradefes,941,520,421
24,León,80,Grajal de Campos,214,107,107
24,León,81,Gusendos de los Oteros,126,64,62
24,León,82,Hospital de Órbigo,981,489,492
24,León,83,Igüeña,1108,577,531
24,León,84,Izagre,146,73,73
24,León,86,Joarilla de las Matas,259,137,122
24,León,87,Laguna Dalga,633,344,289
24,León,88,Laguna de Negrillos,1043,525,518
24,León,89,León,120951,54652,66299
24,León,92,Llamas de la Ribera,810,427,383
24,León,90,Lucillo,376,198,178
24,León,91,Luyego,562,310,252
24,León,93,Magaz de Cepeda,357,192,165
24,León,94,Mansilla de las Mulas,1679,840,839
24,León,95,Mansilla Mayor,327,176,151
24,León,96,Maraña,112,69,43
24,León,97,Matadeón de los Oteros,230,121,109
24,León,98,Matallana de Torío,1269,653,616
24,León,99,Matanza,175,95,80
24,León,100,Molinaseca,851,462,389
24,León,101,Murias de Paredes,346,181,165
24,León,102,Noceda del Bierzo,612,314,298
24,León,103,Oencia,267,152,115
24,León,104,"Omañas, Las",248,132,116
24,León,105,Onzonilla,1845,947,898
24,León,106,Oseja de Sajambre,236,143,93
24,León,107,Pajares de los Oteros,235,142,93
24,León,108,Palacios de la Valduerna,366,182,184
24,León,109,Palacios del Sil,886,484,402
24,León,110,Páramo del Sil,1217,629,588
24,León,112,Peranzanes,264,153,111
24,León,113,Pobladura de Pelayo García,372,191,181
24,León,114,"Pola de Gordón, La",2929,1473,1456
24,León,115,Ponferrada,63052,29806,33246
24,León,116,Posada de Valdeón,420,240,180
24,León,117,Pozuelo del Páramo,408,201,207
24,León,118,Prado de la Guzpeña,103,60,43
24,León,119,Priaranza del Bierzo,742,368,374
24,León,120,Prioro,335,197,138
24,León,121,Puebla de Lillo,666,380,286
24,León,122,Puente de Domingo Flórez,1421,741,680
24,León,123,Quintana del Castillo,709,393,316
24,León,124,Quintana del Marco,353,194,159
24,León,125,Quintana y Congosto,398,212,186
24,León,127,Regueras de Arriba,264,139,125
24,León,129,Reyero,125,65,60
24,León,130,Riaño,475,258,217
24,León,131,Riego de la Vega,731,392,339
24,León,132,Riello,614,351,263
24,León,133,Rioseco de Tapia,386,216,170
24,León,134,"Robla, La",3654,1803,1851
24,León,136,Roperuelos del Páramo,511,261,250
24,León,137,Sabero,1088,556,532
24,León,139,Sahagún,2434,1194,1240
24,León,141,San Adrián del Valle,100,57,43
24,León,142,San Andrés del Rabanedo,29888,14221,15667
24,León,144,San Cristóbal de la Polantera,653,339,314
24,León,145,San Emiliano,626,353,273
24,León,146,San Esteban de Nogales,251,132,119
24,León,148,San Justo de la Vega,1765,914,851
24,León,149,San Millán de los Caballeros,176,95,81
24,León,150,San Pedro Bercianos,231,124,107
24,León,143,Sancedo,536,270,266
24,León,151,Santa Colomba de Curueño,495,253,242
24,León,152,Santa Colomba de Somoza,529,290,239
24,León,153,Santa Cristina de Valmadrigal,273,140,133
24,León,154,Santa Elena de Jamuz,1046,546,500
24,León,155,Santa María de la Isla,462,240,222
24,León,158,Santa María de Ordás,333,183,150
24,León,156,Santa María del Monte de Cea,215,120,95
24,León,157,Santa María del Páramo,3065,1502,1563
24,León,159,Santa Marina del Rey,1801,904,897
24,León,160,Santas Martas,753,399,354
24,León,161,Santiago Millas,352,196,156
24,León,162,Santovenia de la Valdoncina,2084,1057,1027
24,León,163,Sariegos,5306,2649,2657
24,León,164,Sena de Luna,375,180,195
24,León,165,Sobrado,294,150,144
24,León,166,Soto de la Vega,1490,777,713
24,León,167,Soto y Amío,753,381,372
24,León,168,Toral de los Guzmanes,513,287,226
24,León,206,Toral de los Vados,1792,883,909
24,León,169,Toreno,2980,1494,1486
24,León,170,Torre del Bierzo,2068,1051,1017
24,León,171,Trabadelo,338,191,147
24,León,172,Truchas,418,225,193
24,León,173,Turcia,993,507,486
24,León,174,Urdiales del Páramo,466,252,214
24,León,185,Val de San Lorenzo,493,238,255
24,León,175,Valdefresno,2280,1187,1093
24,León,176,Valdefuentes del Páramo,315,170,145
24,León,177,Valdelugueros,501,282,219
24,León,178,Valdemora,64,28,36
24,León,179,Valdepiélago,293,173,120
24,León,180,Valdepolo,1190,647,543
24,León,181,Valderas,1566,800,766
24,León,182,Valderrey,422,217,205
24,León,183,Valderrueda,820,443,377
24,León,184,Valdesamario,186,109,77
24,León,187,Valdevimbre,928,474,454
24,León,188,Valencia de Don Juan,5176,2547,2629
24,León,191,Vallecillo,114,68,46
24,León,189,Valverde de la Virgen,7559,3913,3646
24,León,190,Valverde-Enrique,152,76,76
24,León,193,"Vecilla, La",411,224,187
24,León,196,Vega de Espinareda,2018,1029,989
24,León,197,Vega de Infanzones,835,423,412
24,León,198,Vega de Valcarce,579,293,286
24,León,194,Vegacervera,266,137,129
24,León,199,Vegaquemada,428,244,184
24,León,201,Vegas del Condado,1154,660,494
24,León,202,Villablino,8086,3911,4175
24,León,203,Villabraz,99,56,43
24,León,205,Villadangos del Páramo,1221,653,568
24,León,207,Villademor de la Vega,290,150,140
24,León,209,Villafranca del Bierzo,2756,1328,1428
24,León,210,Villagatón,650,359,291
24,León,211,Villamandos,288,156,132
24,León,901,Villamanín,905,464,441
24,León,212,Villamañán,1076,552,524
24,León,213,Villamartín de Don Sancho,156,84,72
24,León,214,Villamejil,677,366,311
24,León,215,Villamol,144,74,70
24,León,216,Villamontán de la Valduerna,701,359,342
24,León,217,Villamoratiel de las Matas,131,73,58
24,León,218,Villanueva de las Manzanas,499,259,240
24,León,219,Villaobispo de Otero,537,299,238
24,León,902,Villaornate y Castro,333,169,164
24,León,221,Villaquejida,808,411,397
24,León,222,Villaquilambre,18589,9213,9376
24,León,223,Villarejo de Órbigo,2930,1429,1501
24,León,224,Villares de Órbigo,575,308,267
24,León,225,Villasabariego,1127,580,547
24,León,226,Villaselán,185,106,79
24,León,227,Villaturiel,1878,991,887
24,León,228,Villazala,619,331,288
24,León,229,Villazanzo de Valderaduey,385,224,161
24,León,230,Zotes del Páramo,412,233,179
25,Lleida,1,Abella de la Conca,167,85,82
25,Lleida,2,Àger,580,318,262
25,Lleida,3,Agramunt,5479,2766,2713
25,Lleida,38,Aitona,2521,1320,1201
25,Lleida,4,"Alamús, Els",781,389,392
25,Lleida,5,Alàs i Cerc,329,161,168
25,Lleida,6,"Albagés, L'",348,185,163
25,Lleida,7,Albatàrrec,2217,1141,1076
25,Lleida,8,Albesa,1579,859,720
25,Lleida,9,"Albi, L'",755,387,368
25,Lleida,10,Alcanó,240,123,117
25,Lleida,11,Alcarràs,9637,5030,4607
25,Lleida,12,Alcoletge,3470,1828,1642
25,Lleida,13,Alfarràs,2795,1456,1339
25,Lleida,14,Alfés,300,163,137
25,Lleida,15,Algerri,422,233,189
25,Lleida,16,Alguaire,3040,1613,1427
25,Lleida,17,Alins,285,148,137
25,Lleida,19,Almacelles,6922,3701,3221
25,Lleida,20,Almatret,302,172,130
25,Lleida,21,Almenar,3401,1810,1591
25,Lleida,22,Alòs de Balaguer,121,69,52
25,Lleida,23,Alpicat,6333,3173,3160
25,Lleida,24,Alt Àneu,441,250,191
25,Lleida,27,Anglesola,1350,676,674
25,Lleida,29,Arbeca,2100,1089,1011
25,Lleida,31,Arres,61,41,20
25,Lleida,32,Arsèguel,80,46,34
25,Lleida,33,Artesa de Lleida,1505,802,703
25,Lleida,34,Artesa de Segre,3470,1792,1678
25,Lleida,36,Aspa,221,113,108
25,Lleida,37,"Avellanes i Santa Linya, Les",459,254,205
25,Lleida,39,Baix Pallars,345,183,162
25,Lleida,40,Balaguer,17460,8936,8524
25,Lleida,41,Barbens,979,542,437
25,Lleida,42,"Baronia de Rialb, La",229,120,109
25,Lleida,44,Bassella,223,117,106
25,Lleida,45,Bausen,66,33,33
25,Lleida,46,Belianes,508,251,257
25,Lleida,170,Bellaguarda,288,152,136
25,Lleida,47,Bellcaire d'Urgell,1229,630,599
25,Lleida,48,Bell-lloc d'Urgell,2342,1173,1169
25,Lleida,49,Bellmunt d'Urgell,178,90,88
25,Lleida,50,Bellpuig,5168,2756,2412
25,Lleida,51,Bellver de Cerdanya,2176,1129,1047
25,Lleida,52,Bellvís,2243,1141,1102
25,Lleida,53,Benavent de Segrià,1563,822,741
25,Lleida,55,Biosca,182,99,83
25,Lleida,57,"Bòrdes, Es",282,154,128
25,Lleida,58,"Borges Blanques, Les",6248,3188,3060
25,Lleida,59,Bossòst,1121,544,577
25,Lleida,56,Bovera,263,146,117
25,Lleida,60,Cabanabona,62,27,35
25,Lleida,61,Cabó,98,49,49
25,Lleida,62,Camarasa,786,400,386
25,Lleida,63,Canejan,92,46,46
25,Lleida,904,Castell de Mur,171,96,75
25,Lleida,64,Castellar de la Ribera,135,68,67
25,Lleida,67,Castelldans,895,474,421
25,Lleida,68,Castellnou de Seana,715,375,340
25,Lleida,69,Castelló de Farfanya,508,268,240
25,Lleida,70,Castellserà,961,491,470
25,Lleida,71,Cava,51,34,17
25,Lleida,72,Cervera,9393,4794,4599
25,Lleida,73,Cervià de les Garrigues,642,345,297
25,Lleida,74,Ciutadilla,190,99,91
25,Lleida,75,Clariana de Cardener,162,86,76
25,Lleida,76,"Cogul, El",151,83,68
25,Lleida,77,Coll de Nargó,548,278,270
25,Lleida,163,"Coma i la Pedra, La",278,161,117
25,Lleida,161,Conca de Dalt,427,221,206
25,Lleida,78,Corbins,1462,803,659
25,Lleida,79,Cubells,356,188,168
25,Lleida,81,"Espluga Calba, L'",331,169,162
25,Lleida,82,Espot,377,204,173
25,Lleida,88,Estamariu,128,74,54
25,Lleida,85,Estaràs,169,86,83
25,Lleida,86,Esterri d'Àneu,841,417,424
25,Lleida,87,Esterri de Cardós,62,30,32
25,Lleida,89,Farrera,121,67,54
25,Lleida,908,Fígols i Alinyà,266,148,118
25,Lleida,92,"Floresta, La",154,88,66
25,Lleida,93,Fondarella,778,387,391
25,Lleida,94,Foradada,191,110,81
25,Lleida,96,"Fuliola, La",1238,630,608
25,Lleida,97,Fulleda,98,48,50
25,Lleida,98,Gavet de la Conca,261,132,129
25,Lleida,912,Gimenells i el Pla de la Font,1109,594,515
25,Lleida,99,Golmés,1893,958,935
25,Lleida,100,Gósol,233,129,104
25,Lleida,101,"Granadella, La",724,397,327
25,Lleida,102,"Granja d'Escarp, La",923,520,403
25,Lleida,103,Granyanella,136,79,57
25,Lleida,105,Granyena de les Garrigues,147,88,59
25,Lleida,104,Granyena de Segarra,157,82,75
25,Lleida,109,Guimerà,261,139,122
25,Lleida,903,"Guingueta d'Àneu, La",298,163,135
25,Lleida,110,Guissona,7390,3966,3424
25,Lleida,111,Guixers,132,81,51
25,Lleida,115,Isona i Conca Dellà,1057,578,479
25,Lleida,112,Ivars de Noguera,327,176,151
25,Lleida,113,Ivars d'Urgell,1560,834,726
25,Lleida,114,Ivorra,100,55,45
25,Lleida,910,Josa i Tuixén,105,63,42
25,Lleida,118,Juncosa,401,208,193
25,Lleida,119,Juneda,3558,1902,1656
25,Lleida,121,Les,970,488,482
25,Lleida,122,Linyola,2723,1377,1346
25,Lleida,123,Lladorre,254,133,121
25,Lleida,124,Lladurs,190,104,86
25,Lleida,125,Llardecans,421,225,196
25,Lleida,126,Llavorsí,343,171,172
25,Lleida,120,Lleida,140797,69874,70923
25,Lleida,127,Lles de Cerdanya,286,166,120
25,Lleida,128,Llimiana,146,83,63
25,Lleida,129,Llobera,202,115,87
25,Lleida,133,Maials,911,506,405
25,Lleida,130,Maldà,234,117,117
25,Lleida,131,Massalcoreig,589,332,257
25,Lleida,132,Massoteres,220,122,98
25,Lleida,134,Menàrguens,774,414,360
25,Lleida,135,Miralcamp,1364,703,661
25,Lleida,137,Mollerussa,14730,7592,7138
25,Lleida,136,"Molsosa, La",99,49,50
25,Lleida,139,Montellà i Martinet,615,329,286
25,Lleida,140,Montferrer i Castellbò,1083,587,496
25,Lleida,138,Montgai,647,339,308
25,Lleida,142,Montoliu de Lleida,494,257,237
25,Lleida,141,Montoliu de Segarra,180,99,81
25,Lleida,143,Montornès de Segarra,92,43,49
25,Lleida,145,Nalec,95,53,42
25,Lleida,25,Naut Aran,1923,1011,912
25,Lleida,146,Navès,305,155,150
25,Lleida,148,Odèn,252,148,104
25,Lleida,149,Oliana,1849,929,920
25,Lleida,150,Oliola,196,105,91
25,Lleida,151,Olius,985,518,467
25,Lleida,152,"Oluges, Les",166,90,76
25,Lleida,153,"Omellons, Els",198,104,94
25,Lleida,154,"Omells de na Gaia, Els",127,69,58
25,Lleida,155,Organyà,796,403,393
25,Lleida,156,Os de Balaguer,1046,531,515
25,Lleida,157,Ossó de Sió,193,94,99
25,Lleida,158,"Palau d'Anglesola, El",2191,1088,1103
25,Lleida,164,Penelles,430,249,181
25,Lleida,165,Peramola,348,174,174
25,Lleida,166,Pinell de Solsonès,190,107,83
25,Lleida,167,Pinós,291,159,132
25,Lleida,911,"Plans de Sió, Els",490,272,218
25,Lleida,168,"Poal, El",667,343,324
25,Lleida,169,"Pobla de Cérvoles, La",209,114,95
25,Lleida,171,"Pobla de Segur, La",3055,1529,1526
25,Lleida,30,"Pont de Bar, El",163,98,65
25,Lleida,173,"Pont de Suert, El",2336,1183,1153
25,Lleida,172,Ponts,2661,1358,1303
25,Lleida,174,"Portella, La",718,411,307
25,Lleida,175,Prats i Sansor,260,138,122
25,Lleida,176,Preixana,404,213,191
25,Lleida,177,Preixens,422,213,209
25,Lleida,179,Prullans,264,124,140
25,Lleida,180,Puiggròs,257,133,124
25,Lleida,181,Puigverd d'Agramunt,253,147,106
25,Lleida,182,Puigverd de Lleida,1398,718,680
25,Lleida,183,Rialp,675,334,341
25,Lleida,905,Ribera d'Ondara,441,228,213
25,Lleida,185,Ribera d'Urgellet,920,471,449
25,Lleida,186,Riner,280,138,142
25,Lleida,913,Riu de Cerdanya,100,59,41
25,Lleida,189,Rosselló,3278,1687,1591
25,Lleida,190,Salàs de Pallars,345,184,161
25,Lleida,191,Sanaüja,392,202,190
25,Lleida,196,Sant Esteve de la Sarga,123,75,48
25,Lleida,192,Sant Guim de Freixenet,1120,584,536
25,Lleida,197,Sant Guim de la Plana,182,98,84
25,Lleida,193,Sant Llorenç de Morunys,1000,491,509
25,Lleida,902,Sant Martí de Riucorb,646,340,306
25,Lleida,194,Sant Ramon,480,258,222
25,Lleida,201,Sarroca de Bellera,113,64,49
25,Lleida,200,Sarroca de Lleida,365,200,165
25,Lleida,202,Senterada,161,93,68
25,Lleida,35,"Sentiu de Sió, La",417,216,201
25,Lleida,204,Seròs,1890,1016,874
25,Lleida,203,"Seu d'Urgell, La",12261,5958,6303
25,Lleida,205,Sidamon,759,407,352
25,Lleida,206,"Soleràs, El",330,182,148
25,Lleida,207,Solsona,9131,4531,4600
25,Lleida,208,Soriguera,429,229,200
25,Lleida,209,Sort,2192,1094,1098
25,Lleida,210,Soses,1784,953,831
25,Lleida,211,Sudanell,873,484,389
25,Lleida,212,Sunyer,332,182,150
25,Lleida,215,Talarn,562,349,213
25,Lleida,216,Talavera,291,160,131
25,Lleida,217,Tàrrega,17810,8848,8962
25,Lleida,218,Tarrés,105,50,55
25,Lleida,219,Tarroja de Segarra,175,95,80
25,Lleida,220,Térmens,1363,702,661
25,Lleida,221,Tírvia,132,62,70
25,Lleida,222,Tiurana,71,31,40
25,Lleida,223,Torà,1224,613,611
25,Lleida,224,"Torms, Els",149,77,72
25,Lleida,225,Tornabous,847,456,391
25,Lleida,227,"Torre de Cabdella, La",764,389,375
25,Lleida,226,Torrebesses,300,168,132
25,Lleida,228,Torrefarrera,4730,2393,2337
25,Lleida,907,Torrefeta i Florejacs,621,340,281
25,Lleida,230,Torregrossa,2155,1121,1034
25,Lleida,231,Torrelameu,765,460,305
25,Lleida,232,Torres de Segre,2248,1171,1077
25,Lleida,233,Torre-serona,387,204,183
25,Lleida,234,Tremp,5847,2878,2969
25,Lleida,43,"Vall de Boí, La",1090,581,509
25,Lleida,901,Vall de Cardós,386,212,174
25,Lleida,238,Vallbona de les Monges,227,118,109
25,Lleida,240,Vallfogona de Balaguer,1935,968,967
25,Lleida,906,"Valls d'Aguilar, Les",274,153,121
25,Lleida,239,"Valls de Valira, Les",794,411,383
25,Lleida,909,"Vansa i Fórnols, La",166,85,81
25,Lleida,242,Verdú,851,395,456
25,Lleida,243,Vielha e Mijaran,5581,2852,2729
25,Lleida,244,Vilagrassa,605,324,281
25,Lleida,245,Vilaller,532,286,246
25,Lleida,247,Vilamòs,172,99,73
25,Lleida,248,Vilanova de Bellpuig,1179,596,583
25,Lleida,254,Vilanova de la Barca,1110,611,499
25,Lleida,249,Vilanova de l'Aguda,200,99,101
25,Lleida,250,Vilanova de Meià,413,249,164
25,Lleida,251,Vilanova de Segrià,1021,547,474
25,Lleida,252,Vila-sana,767,380,387
25,Lleida,253,"Vilosell, El",195,103,92
25,Lleida,255,Vinaixa,465,244,221
27,Lugo,1,Abadín,2259,1112,1147
27,Lugo,2,Alfoz,1585,765,820
27,Lugo,3,Antas de Ulla,1918,953,965
27,Lugo,4,Baleira,1158,625,533
27,Lugo,901,Baralla,2436,1274,1162
27,Lugo,5,Barreiros,3020,1461,1559
27,Lugo,6,Becerreá,2755,1373,1382
27,Lugo,7,Begonte,2951,1482,1469
27,Lugo,8,Bóveda,1414,708,706
27,Lugo,902,Burela,9430,4742,4688
27,Lugo,9,Carballedo,2065,1041,1024
27,Lugo,10,Castro de Rei,5033,2495,2538
27,Lugo,11,Castroverde,2592,1332,1260
27,Lugo,12,Cervantes,1250,725,525
27,Lugo,13,Cervo,4192,2060,2132
27,Lugo,16,Chantada,8083,3902,4181
27,Lugo,14,"Corgo, O",3429,1764,1665
27,Lugo,15,Cospeito,4342,2134,2208
27,Lugo,17,Folgoso do Courel,985,507,478
27,Lugo,18,"Fonsagrada, A",3265,1715,1550
27,Lugo,19,Foz,10118,4892,5226
27,Lugo,20,Friol,3627,1845,1782
27,Lugo,22,Guitiriz,5328,2689,2639
27,Lugo,23,Guntín,2627,1345,1282
27,Lugo,24,"Incio, O",1536,781,755
27,Lugo,26,Láncara,2501,1277,1224
27,Lugo,27,Lourenzá,2115,1025,1090
27,Lugo,28,Lugo,97211,44906,52305
27,Lugo,29,Meira,1742,878,864
27,Lugo,30,Mondoñedo,3503,1648,1855
27,Lugo,31,Monforte de Lemos,18081,8605,9476
27,Lugo,32,Monterroso,3585,1785,1800
27,Lugo,33,Muras,606,305,301
27,Lugo,34,Navia de Suarna,997,552,445
27,Lugo,35,Negueira de Muñiz,228,125,103
27,Lugo,37,"Nogais, As",991,529,462
27,Lugo,38,Ourol,999,517,482
27,Lugo,39,Outeiro de Rei,5296,2718,2578
27,Lugo,40,Palas de Rei,3319,1675,1644
27,Lugo,41,Pantón,2435,1208,1227
27,Lugo,42,Paradela,1683,842,841
27,Lugo,43,"Páramo, O",1322,653,669
27,Lugo,44,"Pastoriza, A",2879,1457,1422
27,Lugo,45,Pedrafita do Cebreiro,936,504,432
27,Lugo,47,"Pobra do Brollón, A",1551,769,782
27,Lugo,46,Pol,1612,802,810
27,Lugo,48,"Pontenova, A",2191,1057,1134
27,Lugo,49,Portomarín,1352,701,651
27,Lugo,50,Quiroga,3125,1468,1657
27,Lugo,56,Rábade,1503,748,755
27,Lugo,51,Ribadeo,9811,4638,5173
27,Lugo,52,Ribas de Sil,937,472,465
27,Lugo,53,Ribeira de Piquín,500,260,240
27,Lugo,54,Riotorto,1187,596,591
27,Lugo,55,Samos,1202,641,561
27,Lugo,57,Sarria,13214,6440,6774
27,Lugo,58,"Saviñao, O",3547,1779,1768
27,Lugo,59,Sober,2213,1073,1140
27,Lugo,60,Taboada,2646,1276,1370
27,Lugo,61,Trabada,1107,539,568
27,Lugo,62,Triacastela,629,309,320
27,Lugo,63,"Valadouro, O",1938,923,1015
27,Lugo,64,"Vicedo, O",1665,822,843
27,Lugo,65,Vilalba,13881,6667,7214
27,Lugo,66,Viveiro,15231,7461,7770
27,Lugo,21,Xermade,1768,862,906
27,Lugo,25,Xove,3352,1733,1619
28,Madrid,1,"Acebeda, La",62,32,30
28,Madrid,2,Ajalvir,4751,2473,2278
28,Madrid,3,Alameda del Valle,241,137,104
28,Madrid,4,"Álamo, El",10123,4972,5151
28,Madrid,5,Alcalá de Henares,196888,95472,101416
28,Madrid,6,Alcobendas,117041,55907,61134
28,Madrid,7,Alcorcón,170296,81673,88623
28,Madrid,8,Aldea del Fresno,3227,1653,1574
28,Madrid,9,Algete,20767,10181,10586
28,Madrid,10,Alpedrete,15006,7380,7626
28,Madrid,11,Ambite,648,324,324
28,Madrid,12,Anchuelo,1354,702,652
28,Madrid,13,Aranjuez,59762,29046,30716
28,Madrid,14,Arganda del Rey,57553,28729,28824
28,Madrid,15,Arroyomolinos,34833,17313,17520
28,Madrid,16,"Atazar, El",107,60,47
28,Madrid,17,Batres,1823,941,882
28,Madrid,18,Becerril de la Sierra,6197,3085,3112
28,Madrid,19,Belmonte de Tajo,1769,910,859
28,Madrid,21,"Berrueco, El",801,406,395
28,Madrid,20,Berzosa del Lozoya,227,129,98
28,Madrid,22,Boadilla del Monte,62627,30630,31997
28,Madrid,23,"Boalo, El",8216,4100,4116
28,Madrid,24,Braojos,218,132,86
28,Madrid,25,Brea de Tajo,541,307,234
28,Madrid,26,Brunete,10845,5335,5510
28,Madrid,27,Buitrago del Lozoya,1948,931,1017
28,Madrid,28,Bustarviejo,2706,1350,1356
28,Madrid,29,Cabanillas de la Sierra,874,453,421
28,Madrid,30,"Cabrera, La",2805,1383,1422
28,Madrid,31,Cadalso de los Vidrios,3193,1664,1529
28,Madrid,32,Camarma de Esteruelas,7595,3837,3758
28,Madrid,33,Campo Real,6651,3365,3286
28,Madrid,34,Canencia,455,242,213
28,Madrid,35,Carabaña,2210,1105,1105
28,Madrid,36,Casarrubuelos,3961,2032,1929
28,Madrid,37,Cenicientos,2089,1045,1044
28,Madrid,38,Cercedilla,7533,3740,3793
28,Madrid,39,Cervera de Buitrago,169,100,69
28,Madrid,51,Chapinería,2512,1266,1246
28,Madrid,52,Chinchón,5658,2838,2820
28,Madrid,40,Ciempozuelos,25383,12799,12584
28,Madrid,41,Cobeña,7551,3697,3854
28,Madrid,46,Collado Mediano,7456,3702,3754
28,Madrid,47,Collado Villalba,64263,31170,33093
28,Madrid,43,Colmenar de Oreja,8462,4295,4167
28,Madrid,42,Colmenar del Arroyo,1936,1020,916
28,Madrid,45,Colmenar Viejo,53389,26267,27122
28,Madrid,44,Colmenarejo,9473,4652,4821
28,Madrid,48,Corpa,764,384,380
28,Madrid,49,Coslada,80596,39281,41315
28,Madrid,50,Cubas de la Sagra,6698,3352,3346
28,Madrid,53,Daganzo de Arriba,10650,5310,5340
28,Madrid,54,"Escorial, El",16618,8200,8418
28,Madrid,55,Estremera,1410,720,690
28,Madrid,56,Fresnedillas de la Oliva,1784,898,886
28,Madrid,57,Fresno de Torote,2444,1294,1150
28,Madrid,58,Fuenlabrada,189891,93170,96721
28,Madrid,59,Fuente el Saz de Jarama,7034,3530,3504
28,Madrid,60,Fuentidueña de Tajo,2250,1139,1111
28,Madrid,61,Galapagar,34834,16914,17920
28,Madrid,62,Garganta de los Montes,395,214,181
28,Madrid,63,Gargantilla del Lozoya y Pinilla de Buitrago,361,206,155
28,Madrid,64,Gascones,212,114,98
28,Madrid,65,Getafe,183219,89393,93826
28,Madrid,66,Griñón,10491,5189,5302
28,Madrid,67,Guadalix de la Sierra,6672,3355,3317
28,Madrid,68,Guadarrama,16921,8343,8578
28,Madrid,69,"Hiruela, La",75,50,25
28,Madrid,70,Horcajo de la Sierra-Aoslos,201,107,94
28,Madrid,71,Horcajuelo de la Sierra,110,58,52
28,Madrid,72,Hoyo de Manzanares,8811,4443,4368
28,Madrid,73,Humanes de Madrid,19838,9869,9969
28,Madrid,74,Leganés,186660,90038,96622
28,Madrid,75,Loeches,8944,4496,4448
28,Madrid,76,Lozoya,602,322,280
28,Madrid,901,Lozoyuela-Navas-Sieteiglesias,1461,759,702
28,Madrid,78,Madarcos,63,32,31
28,Madrid,79,Madrid,3280782,1531214,1749568
28,Madrid,80,Majadahonda,72179,34148,38031
28,Madrid,82,Manzanares el Real,9247,4667,4580
28,Madrid,83,Meco,15143,7635,7508
28,Madrid,84,Mejorada del Campo,23897,11830,12067
28,Madrid,85,Miraflores de la Sierra,6711,3440,3271
28,Madrid,86,"Molar, El",9437,4774,4663
28,Madrid,87,"Molinos, Los",4699,2323,2376
28,Madrid,88,Montejo de la Sierra,372,183,189
28,Madrid,89,Moraleja de Enmedio,5368,2701,2667
28,Madrid,90,Moralzarzal,13905,6937,6968
28,Madrid,91,Morata de Tajuña,7960,4009,3951
28,Madrid,92,Móstoles,208761,101318,107443
28,Madrid,93,Navacerrada,3218,1594,1624
28,Madrid,94,Navalafuente,1574,810,764
28,Madrid,95,Navalagamella,2809,1442,1367
28,Madrid,96,Navalcarnero,31379,15585,15794
28,Madrid,97,Navarredonda y San Mamés,138,85,53
28,Madrid,99,Navas del Rey,3134,1625,1509
28,Madrid,100,Nuevo Baztán,6760,3468,3292
28,Madrid,101,Olmeda de las Fuentes,376,193,183
28,Madrid,102,Orusco de Tajuña,1326,695,631
28,Madrid,104,Paracuellos de Jarama,26450,13246,13204
28,Madrid,106,Parla,130577,64847,65730
28,Madrid,107,Patones,536,257,279
28,Madrid,108,Pedrezuela,6307,3175,3132
28,Madrid,109,Pelayos de la Presa,2867,1454,1413
28,Madrid,110,Perales de Tajuña,3117,1573,1544
28,Madrid,111,Pezuela de las Torres,931,492,439
28,Madrid,112,Pinilla del Valle,198,106,92
28,Madrid,113,Pinto,54088,26726,27362
28,Madrid,114,Piñuécar-Gandullas,184,96,88
28,Madrid,115,Pozuelo de Alarcón,87728,41989,45739
28,Madrid,116,Pozuelo del Rey,1178,611,567
28,Madrid,117,Prádena del Rincón,147,84,63
28,Madrid,118,Puebla de la Sierra,84,51,33
28,Madrid,902,Puentes Viejas,697,386,311
28,Madrid,119,Quijorna,3683,1852,1831
28,Madrid,120,Rascafría,1736,939,797
28,Madrid,121,Redueña,298,165,133
28,Madrid,122,Ribatejada,871,454,417
28,Madrid,123,Rivas-Vaciamadrid,96690,47889,48801
28,Madrid,124,Robledillo de la Jara,114,59,55
28,Madrid,125,Robledo de Chavela,4587,2400,2187
28,Madrid,126,Robregordo,70,39,31
28,Madrid,127,"Rozas de Madrid, Las",95725,46232,49493
28,Madrid,128,Rozas de Puerto Real,577,336,241
28,Madrid,129,San Agustín del Guadalix,13608,6636,6972
28,Madrid,130,San Fernando de Henares,38904,18960,19944
28,Madrid,131,San Lorenzo de El Escorial,18423,8811,9612
28,Madrid,132,San Martín de la Vega,19927,10128,9799
28,Madrid,133,San Martín de Valdeiglesias,8812,4383,4429
28,Madrid,134,San Sebastián de los Reyes,91083,44203,46880
28,Madrid,135,Santa María de la Alameda,1499,802,697
28,Madrid,136,Santorcaz,941,473,468
28,Madrid,137,"Santos de la Humosa, Los",2751,1414,1337
28,Madrid,138,"Serna del Monte, La",108,59,49
28,Madrid,140,Serranillos del Valle,4509,2218,2291
28,Madrid,141,Sevilla la Nueva,9361,4599,4762
28,Madrid,143,Somosierra,87,50,37
28,Madrid,144,Soto del Real,9188,4522,4666
28,Madrid,145,Talamanca de Jarama,4210,2053,2157
28,Madrid,146,Tielmes,2783,1410,1373
28,Madrid,147,Titulcia,1336,702,634
28,Madrid,148,Torrejón de Ardoz,134733,66136,68597
28,Madrid,149,Torrejón de la Calzada,9947,4936,5011
28,Madrid,150,Torrejón de Velasco,4685,2321,2364
28,Madrid,151,Torrelaguna,4940,2459,2481
28,Madrid,152,Torrelodones,24775,11945,12830
28,Madrid,153,Torremocha de Jarama,1097,565,532
28,Madrid,154,Torres de la Alameda,7714,3951,3763
28,Madrid,903,Tres Cantos,50187,24325,25862
28,Madrid,155,Valdaracete,627,322,305
28,Madrid,156,Valdeavero,1701,877,824
28,Madrid,157,Valdelaguna,1016,509,507
28,Madrid,158,Valdemanco,1033,534,499
28,Madrid,159,Valdemaqueda,798,401,397
28,Madrid,160,Valdemorillo,13453,6773,6680
28,Madrid,161,Valdemoro,79100,38886,40214
28,Madrid,162,Valdeolmos-Alalpardo,4396,2245,2151
28,Madrid,163,Valdepiélagos,621,319,302
28,Madrid,164,Valdetorres de Jarama,4830,2418,2412
28,Madrid,165,Valdilecha,3104,1604,1500
28,Madrid,166,Valverde de Alcalá,532,282,250
28,Madrid,167,Velilla de San Antonio,12770,6409,6361
28,Madrid,168,"Vellón, El",2124,1106,1018
28,Madrid,169,Venturada,2445,1271,1174
28,Madrid,171,Villa del Prado,7092,3607,3485
28,Madrid,170,Villaconejos,3456,1774,1682
28,Madrid,172,Villalbilla,15866,7986,7880
28,Madrid,173,Villamanrique de Tajo,757,394,363
28,Madrid,174,Villamanta,2714,1380,1334
28,Madrid,175,Villamantilla,1567,768,799
28,Madrid,176,Villanueva de la Cañada,22845,11120,11725
28,Madrid,178,Villanueva de Perales,1623,832,791
28,Madrid,177,Villanueva del Pardillo,17382,8416,8966
28,Madrid,179,Villar del Olmo,2219,1102,1117
28,Madrid,180,Villarejo de Salvanés,7629,3790,3839
28,Madrid,181,Villaviciosa de Odón,28152,13619,14533
28,Madrid,182,Villavieja del Lozoya,284,150,134
28,Madrid,183,Zarzalejo,1773,903,870
29,Málaga,1,Alameda,5451,2757,2694
29,Málaga,2,Alcaucín,2487,1269,1218
29,Málaga,3,Alfarnate,1039,534,505
29,Málaga,4,Alfarnatejo,364,189,175
29,Málaga,5,Algarrobo,6625,3305,3320
29,Málaga,6,Algatocín,826,439,387
29,Málaga,7,Alhaurín de la Torre,42531,21153,21378
29,Málaga,8,Alhaurín el Grande,26436,13183,13253
29,Málaga,9,Almáchar,1840,936,904
29,Málaga,10,Almargen,1927,976,951
29,Málaga,11,Almogía,3885,2021,1864
29,Málaga,12,Álora,13382,6765,6617
29,Málaga,13,Alozaina,2089,1050,1039
29,Málaga,14,Alpandeire,266,133,133
29,Málaga,15,Antequera,41184,20163,21021
29,Málaga,16,Árchez,396,198,198
29,Málaga,17,Archidona,8024,4079,3945
29,Málaga,18,Ardales,2520,1272,1248
29,Málaga,19,Arenas,1249,641,608
29,Málaga,20,Arriate,4110,2026,2084
29,Málaga,21,Atajate,183,103,80
29,Málaga,22,Benadalid,239,118,121
29,Málaga,23,Benahavís,8763,4368,4395
29,Málaga,24,Benalauría,434,229,205
29,Málaga,25,Benalmádena,73160,35839,37321
29,Málaga,26,Benamargosa,1519,785,734
29,Málaga,27,Benamocarra,3085,1541,1544
29,Málaga,28,Benaoján,1459,742,717
29,Málaga,29,Benarrabá,446,231,215
29,Málaga,30,"Borge, El",921,470,451
29,Málaga,31,"Burgo, El",1791,905,886
29,Málaga,32,Campillos,8372,4204,4168
29,Málaga,33,Canillas de Aceituno,1722,903,819
29,Málaga,34,Canillas de Albaida,796,387,409
29,Málaga,35,Cañete la Real,1584,776,808
29,Málaga,36,Carratraca,718,377,341
29,Málaga,37,Cartajima,256,133,123
29,Málaga,38,Cártama,27712,14028,13684
29,Málaga,39,Casabermeja,3813,1976,1837
29,Málaga,40,Casarabonela,2524,1357,1167
29,Málaga,41,Casares,7700,3946,3754
29,Málaga,42,Coín,24309,12169,12140
29,Málaga,43,Colmenar,3488,1799,1689
29,Málaga,44,Comares,1320,707,613
29,Málaga,45,Cómpeta,3814,1909,1905
29,Málaga,46,Cortes de la Frontera,2986,1545,1441
29,Málaga,47,Cuevas Bajas,1353,656,697
29,Málaga,49,Cuevas de San Marcos,3632,1824,1808
29,Málaga,48,Cuevas del Becerro,1609,788,821
29,Málaga,50,Cútar,590,309,281
29,Málaga,51,Estepona,74493,36530,37963
29,Málaga,52,Faraján,270,132,138
29,Málaga,53,Frigiliana,3282,1625,1657
29,Málaga,54,Fuengirola,83226,40454,42772
29,Málaga,55,Fuente de Piedra,2787,1392,1395
29,Málaga,56,Gaucín,1608,825,783
29,Málaga,57,Genalguacil,393,196,197
29,Málaga,58,Guaro,2302,1167,1135
29,Málaga,59,Humilladero,3282,1629,1653
29,Málaga,60,Igualeja,729,366,363
29,Málaga,61,Istán,1587,789,798
29,Málaga,62,Iznate,899,472,427
29,Málaga,63,Jimera de Líbar,403,211,192
29,Málaga,64,Jubrique,545,271,274
29,Málaga,65,Júzcar,247,142,105
29,Málaga,66,Macharaviaya,513,280,233
29,Málaga,67,Málaga,579076,278086,300990
29,Málaga,68,Manilva,17157,8631,8526
29,Málaga,69,Marbella,150725,72195,78530
29,Málaga,70,Mijas,89502,44451,45051
29,Málaga,71,Moclinejo,1243,645,598
29,Málaga,72,Mollina,5376,2678,2698
29,Málaga,73,Monda,2844,1498,1346
29,Málaga,903,Montecorto,582,310,272
29,Málaga,74,Montejaque,938,469,469
29,Málaga,75,Nerja,21450,10529,10921
29,Málaga,76,Ojén,4218,2151,2067
29,Málaga,77,Parauta,272,138,134
29,Málaga,79,Periana,3234,1679,1555
29,Málaga,80,Pizarra,9661,4841,4820
29,Málaga,81,Pujerra,274,138,136
29,Málaga,82,Rincón de la Victoria,50569,24731,25838
29,Málaga,83,Riogordo,2762,1447,1315
29,Málaga,84,Ronda,33401,16205,17196
29,Málaga,85,Salares,175,88,87
29,Málaga,86,Sayalonga,1641,845,796
29,Málaga,87,Sedella,598,341,257
29,Málaga,904,Serrato,458,226,232
29,Málaga,88,Sierra de Yeguas,3393,1707,1686
29,Málaga,89,Teba,3729,1875,1854
29,Málaga,90,Tolox,2309,1160,1149
29,Málaga,901,Torremolinos,68819,34437,34382
29,Málaga,91,Torrox,19997,10044,9953
29,Málaga,92,Totalán,750,382,368
29,Málaga,93,Valle de Abdalajís,2473,1245,1228
29,Málaga,94,Vélez-Málaga,83899,41352,42547
29,Málaga,95,Villanueva de Algaidas,4146,2116,2030
29,Málaga,902,Villanueva de la Concepción,3295,1588,1707
29,Málaga,98,Villanueva de Tapia,1417,716,701
29,Málaga,96,Villanueva del Rosario,3339,1636,1703
29,Málaga,97,Villanueva del Trabuco,5340,2666,2674
29,Málaga,99,Viñuela,2106,1098,1008
29,Málaga,100,Yunquera,2841,1450,1391
52,Melilla,1,Melilla,85170,42990,42180
30,Murcia,1,Abanilla,6146,3112,3034
30,Murcia,2,Abarán,12992,6492,6500
30,Murcia,3,Águilas,36403,18178,18225
30,Murcia,4,Albudeite,1390,708,682
30,Murcia,5,Alcantarilla,42630,21148,21482
30,Murcia,902,"Alcázares, Los",17603,9008,8595
30,Murcia,6,Aledo,1110,550,560
30,Murcia,7,Alguazas,9965,5148,4817
30,Murcia,8,Alhama de Murcia,22691,11485,11206
30,Murcia,9,Archena,19622,10290,9332
30,Murcia,10,Beniel,11578,6045,5533
30,Murcia,11,Blanca,6681,3437,3244
30,Murcia,12,Bullas,11627,5833,5794
30,Murcia,13,Calasparra,10163,5164,4999
30,Murcia,14,Campos del Río,2090,1000,1090
30,Murcia,15,Caravaca de la Cruz,25722,12839,12883
30,Murcia,16,Cartagena,216961,107794,109167
30,Murcia,17,Cehegín,14710,7352,7358
30,Murcia,18,Ceutí,12391,6260,6131
30,Murcia,19,Cieza,35298,17742,17556
30,Murcia,20,Fortuna,10843,5735,5108
30,Murcia,21,Fuente Álamo de Murcia,17589,9181,8408
30,Murcia,22,Jumilla,26596,13915,12681
30,Murcia,23,Librilla,5619,2863,2756
30,Murcia,24,Lorca,97151,49758,47393
30,Murcia,25,Lorquí,7510,3822,3688
30,Murcia,26,Mazarrón,33700,17416,16284
30,Murcia,27,Molina de Segura,74762,37281,37481
30,Murcia,28,Moratalla,7753,3934,3819
30,Murcia,29,Mula,17231,8810,8421
30,Murcia,30,Murcia,462979,227012,235967
30,Murcia,31,Ojós,522,268,254
30,Murcia,32,Pliego,3901,2019,1882
30,Murcia,33,Puerto Lumbreras,16564,8501,8063
30,Murcia,34,Ricote,1275,679,596
30,Murcia,35,San Javier,34468,17315,17153
30,Murcia,36,San Pedro del Pinatar,26827,13482,13345
30,Murcia,901,Santomera,16125,8060,8065
30,Murcia,37,Torre-Pacheco,38140,19652,18488
30,Murcia,38,"Torres de Cotillas, Las",21980,11135,10845
30,Murcia,39,Totana,32329,16577,15752
30,Murcia,40,Ulea,882,459,423
30,Murcia,41,"Unión, La",20656,10451,10205
30,Murcia,42,Villanueva del Río Segura,3469,1761,1708
30,Murcia,43,Yecla,35234,17737,17497
31,Navarra,1,Abáigar,80,48,32
31,Navarra,2,Abárzuza/Abartzuza,527,264,263
31,Navarra,3,Abaurregaina/Abaurrea Alta,120,75,45
31,Navarra,4,Abaurrepea/Abaurrea Baja,31,19,12
31,Navarra,5,Aberin,371,201,170
31,Navarra,6,Ablitas,2557,1290,1267
31,Navarra,7,Adiós,165,97,68
31,Navarra,8,Aguilar de Codés,76,44,32
31,Navarra,9,Aibar/Oibar,784,412,372
31,Navarra,11,Allín/Allin,879,472,407
31,Navarra,12,Allo,939,484,455
31,Navarra,10,Altsasu/Alsasua,7504,3789,3715
31,Navarra,13,Améscoa Baja,732,407,325
31,Navarra,14,Ancín/Antzin,332,187,145
31,Navarra,15,Andosilla,2818,1423,1395
31,Navarra,16,Ansoáin/Antsoain,10588,5175,5413
31,Navarra,17,Anue,490,258,232
31,Navarra,18,Añorbe,605,330,275
31,Navarra,19,Aoiz/Agoitz,2892,1463,1429
31,Navarra,20,Araitz,512,285,227
31,Navarra,25,Arakil,967,505,462
31,Navarra,21,Aranarache/Aranaratxe,71,42,29
31,Navarra,23,Aranguren,12156,6123,6033
31,Navarra,24,Arano,111,61,50
31,Navarra,22,Arantza,591,316,275
31,Navarra,26,Aras,154,83,71
31,Navarra,27,Arbizu,1124,590,534
31,Navarra,28,Arce/Artzi,278,155,123
31,Navarra,29,"Arcos, Los",1139,560,579
31,Navarra,30,Arellano,156,86,70
31,Navarra,31,Areso,270,140,130
31,Navarra,32,Arguedas,2312,1183,1129
31,Navarra,33,Aria,48,30,18
31,Navarra,34,Aribe,36,20,16
31,Navarra,35,Armañanzas,51,27,24
31,Navarra,36,Arróniz,1036,553,483
31,Navarra,37,Arruazu,106,56,50
31,Navarra,38,Artajona,1762,912,850
31,Navarra,39,Artazu,113,58,55
31,Navarra,40,Atez/Atetz,212,120,92
31,Navarra,58,Auritz/Burguete,230,123,107
31,Navarra,41,Ayegui/Aiegi,2488,1301,1187
31,Navarra,42,Azagra,3802,1921,1881
31,Navarra,43,Azuelo,26,10,16
31,Navarra,44,Bakaiku,355,186,169
31,Navarra,901,Barañáin/Barañain,19537,9470,10067
31,Navarra,45,Barásoain,621,323,298
31,Navarra,46,Barbarin,48,26,22
31,Navarra,47,Bargota,256,124,132
31,Navarra,48,Barillas,257,140,117
31,Navarra,49,Basaburua,842,482,360
31,Navarra,50,Baztan,7851,3978,3873
31,Navarra,137,Beintza-Labaien,213,127,86
31,Navarra,51,Beire,311,154,157
31,Navarra,52,Belascoáin,121,62,59
31,Navarra,250,Bera,3771,1860,1911
31,Navarra,53,Berbinzana,648,330,318
31,Navarra,905,Beriáin,4100,2010,2090
31,Navarra,902,Berrioplano/Berriobeiti,7453,3800,3653
31,Navarra,903,Berriozar,10765,5405,5360
31,Navarra,54,Bertizarana,599,300,299
31,Navarra,55,Betelu,369,189,180
31,Navarra,253,Bidaurreta,167,85,82
31,Navarra,56,Biurrun-Olcoz,235,126,109
31,Navarra,57,Buñuel,2223,1084,1139
31,Navarra,59,Burgui/Burgi,203,118,85
31,Navarra,60,Burlada/Burlata,20398,9862,10536
31,Navarra,61,"Busto, El",51,25,26
31,Navarra,62,Cabanillas,1370,709,661
31,Navarra,63,Cabredo,78,45,33
31,Navarra,64,Cadreita,2083,1092,991
31,Navarra,65,Caparroso,2783,1474,1309
31,Navarra,66,Cárcar,1124,575,549
31,Navarra,67,Carcastillo,2428,1237,1191
31,Navarra,68,Cascante,3950,1952,1998
31,Navarra,69,Cáseda,946,494,452
31,Navarra,70,Castejón,4311,2145,2166
31,Navarra,71,Castillonuevo,16,10,6
31,Navarra,193,Cendea de Olza/Oltza Zendea,1871,925,946
31,Navarra,72,Cintruénigo,8106,4191,3915
31,Navarra,74,Cirauqui/Zirauki,465,241,224
31,Navarra,75,Ciriza/Ziritza,161,76,85
31,Navarra,76,Cizur,3920,2014,1906
31,Navarra,77,Corella,8336,4210,4126
31,Navarra,78,Cortes,3184,1621,1563
31,Navarra,79,Desojo,68,39,29
31,Navarra,80,Dicastillo,595,310,285
31,Navarra,81,Donamaria,465,231,234
31,Navarra,221,Doneztebe/Santesteban,1823,905,918
31,Navarra,83,Echarri/Etxarri,71,35,36
31,Navarra,87,Elgorriaga,215,108,107
31,Navarra,89,Enériz/Eneritz,297,149,148
31,Navarra,90,Eratsun,150,89,61
31,Navarra,91,Ergoiena,373,202,171
31,Navarra,92,Erro,796,451,345
31,Navarra,94,Eslava,101,48,53
31,Navarra,95,Esparza de Salazar/Espartza Zaraitzu,74,40,34
31,Navarra,96,Espronceda,105,57,48
31,Navarra,97,Estella-Lizarra,13977,6764,7213
31,Navarra,98,Esteribar,2792,1451,1341
31,Navarra,99,Etayo,65,37,28
31,Navarra,82,Etxalar,830,437,393
31,Navarra,84,Etxarri Aranatz,2506,1290,1216
31,Navarra,85,Etxauri,633,317,316
31,Navarra,100,Eulate,275,152,123
31,Navarra,101,Ezcabarte,1817,953,864
31,Navarra,93,Ezcároz/Ezkaroze,305,169,136
31,Navarra,102,Ezkurra,138,94,44
31,Navarra,103,Ezprogui,47,22,25
31,Navarra,104,Falces,2332,1195,1137
31,Navarra,105,Fitero,2046,1018,1028
31,Navarra,106,Fontellas,1016,527,489
31,Navarra,107,Funes,2504,1333,1171
31,Navarra,108,Fustiñana,2459,1222,1237
31,Navarra,109,Galar,2299,1187,1112
31,Navarra,110,Gallipienzo/Galipentzu,103,59,44
31,Navarra,111,Gallués/Galoze,92,60,32
31,Navarra,112,Garaioa,91,52,39
31,Navarra,113,Garde,134,76,58
31,Navarra,114,Garínoain,534,284,250
31,Navarra,115,Garralda,190,96,94
31,Navarra,116,Genevilla,57,36,21
31,Navarra,117,Goizueta,694,362,332
31,Navarra,118,Goñi,163,98,65
31,Navarra,119,Güesa/Gorza,34,21,13
31,Navarra,120,Guesálaz/Gesalatz,438,253,185
31,Navarra,121,Guirguillano,70,37,33
31,Navarra,256,Hiriberri/Villanueva de Aezkoa,99,54,45
31,Navarra,122,Huarte/Uharte,7312,3680,3632
31,Navarra,124,Ibargoiti,282,159,123
31,Navarra,259,Igantzi,583,310,273
31,Navarra,125,Igúzquiza,307,152,155
31,Navarra,126,Imotz,418,231,187
31,Navarra,127,Irañeta,167,90,77
31,Navarra,904,Irurtzun,2299,1201,1098
31,Navarra,128,Isaba/Izaba,410,194,216
31,Navarra,129,Ituren,515,258,257
31,Navarra,130,Iturmendi,420,217,203
31,Navarra,131,Iza/Itza,1328,721,607
31,Navarra,132,Izagaondoa,162,107,55
31,Navarra,133,Izalzu/Itzaltzu,37,21,16
31,Navarra,134,Jaurrieta,179,103,76
31,Navarra,135,Javier,122,27,95
31,Navarra,136,Juslapeña,574,308,266
31,Navarra,138,Lakuntza,1283,669,614
31,Navarra,139,Lana,155,90,65
31,Navarra,140,Lantz,151,86,65
31,Navarra,141,Lapoblación,124,73,51
31,Navarra,142,Larraga,2062,1081,981
31,Navarra,143,Larraona,102,50,52
31,Navarra,144,Larraun,907,491,416
31,Navarra,145,Lazagurría,185,96,89
31,Navarra,146,Leache/Leatxe,32,16,16
31,Navarra,147,Legarda,137,73,64
31,Navarra,148,Legaria,108,48,60
31,Navarra,149,Leitza,3029,1555,1474
31,Navarra,908,Lekunberri,1656,840,816
31,Navarra,150,Leoz/Leotz,220,140,80
31,Navarra,151,Lerga,42,25,17
31,Navarra,152,Lerín,1756,917,839
31,Navarra,153,Lesaka,2752,1400,1352
31,Navarra,154,Lezaun,247,142,105
31,Navarra,155,Liédena,316,163,153
31,Navarra,156,Lizoain-Arriasgoiti/Lizoainibar-Arriasgoiti,309,182,127
31,Navarra,157,Lodosa,4861,2462,2399
31,Navarra,158,Lónguida/Longida,271,143,128
31,Navarra,159,Lumbier,1297,702,595
31,Navarra,160,Luquin,132,67,65
31,Navarra,248,Luzaide/Valcarlos,317,179,138
31,Navarra,161,Mañeru,436,227,209
31,Navarra,162,Marañón,49,28,21
31,Navarra,163,Marcilla,2879,1445,1434
31,Navarra,164,Mélida,714,364,350
31,Navarra,165,Mendavia,3560,1795,1765
31,Navarra,166,Mendaza,297,150,147
31,Navarra,167,Mendigorria,1124,594,530
31,Navarra,168,Metauten,284,159,125
31,Navarra,169,Milagro,3505,1797,1708
31,Navarra,170,Mirafuentes,59,29,30
31,Navarra,171,Miranda de Arga,875,464,411
31,Navarra,172,Monreal/Elo,486,269,217
31,Navarra,173,Monteagudo,1109,574,535
31,Navarra,174,Morentin,114,56,58
31,Navarra,175,Mues,82,45,37
31,Navarra,176,Murchante,4156,2103,2053
31,Navarra,177,Murieta,347,177,170
31,Navarra,178,Murillo el Cuende,664,346,318
31,Navarra,179,Murillo el Fruto,663,356,307
31,Navarra,180,Muruzábal,261,121,140
31,Navarra,181,Navascués/Nabaskoze,118,67,51
31,Navarra,182,Nazar,40,21,19
31,Navarra,88,Noáin (Valle de Elorz)/Noain (Elortzibar),8367,4192,4175
31,Navarra,183,Obanos,938,462,476
31,Navarra,185,Ochagavía/Otsagabia,495,272,223
31,Navarra,184,Oco,73,37,36
31,Navarra,186,Odieta,367,199,168
31,Navarra,187,Oiz,124,70,54
31,Navarra,188,Olaibar,395,222,173
31,Navarra,189,Olazti/Olazagutía,1490,764,726
31,Navarra,190,Olejua,49,28,21
31,Navarra,191,Olite/Erriberri,3980,2008,1972
31,Navarra,192,Olóriz/Oloritz,212,122,90
31,Navarra,195,Orbaizeta,191,92,99
31,Navarra,196,Orbara,33,18,15
31,Navarra,197,Orísoain,72,42,30
31,Navarra,906,Orkoien,4095,2052,2043
31,Navarra,198,Oronz/Orontze,49,25,24
31,Navarra,199,Oroz-Betelu/Orotz-Betelu,139,79,60
31,Navarra,211,Orreaga/Roncesvalles,19,11,8
31,Navarra,200,Oteiza,931,494,437
31,Navarra,201,Pamplona/Iruña,203418,96027,107391
31,Navarra,202,Peralta/Azkoien,5938,3006,2932
31,Navarra,203,Petilla de Aragón,30,17,13
31,Navarra,204,Piedramillera,40,24,16
31,Navarra,205,Pitillas,521,250,271
31,Navarra,206,Puente la Reina/Gares,2905,1487,1418
31,Navarra,207,Pueyo/Puiu,333,186,147
31,Navarra,208,Ribaforada,3721,1937,1784
31,Navarra,209,Romanzado,184,99,85
31,Navarra,210,Roncal/Erronkari,219,111,108
31,Navarra,212,Sada,139,78,61
31,Navarra,213,Saldías,120,66,54
31,Navarra,214,Salinas de Oro/Jaitz,106,57,49
31,Navarra,215,San Adrián,6373,3185,3188
31,Navarra,217,San Martín de Unx,370,195,175
31,Navarra,216,Sangüesa/Zangoza,4882,2475,2407
31,Navarra,219,Sansol,101,48,53
31,Navarra,220,Santacara,868,445,423
31,Navarra,222,Sarriés/Sartze,58,41,17
31,Navarra,223,Sartaguda,1312,676,636
31,Navarra,224,Sesma,1186,609,577
31,Navarra,225,Sorlada,45,24,21
31,Navarra,226,Sunbilla,677,345,332
31,Navarra,227,Tafalla,10576,5268,5308
31,Navarra,228,Tiebas-Muruarte de Reta,635,345,290
31,Navarra,229,Tirapu,56,31,25
31,Navarra,230,Torralba del Río,99,55,44
31,Navarra,231,Torres del Río,121,62,59
31,Navarra,232,Tudela,37247,18408,18839
31,Navarra,233,Tulebras,152,68,84
31,Navarra,234,Ucar,191,111,80
31,Navarra,123,Uharte Arakil,791,418,373
31,Navarra,235,Ujué/Uxue,175,97,78
31,Navarra,236,Ultzama,1647,849,798
31,Navarra,237,Unciti,234,134,100
31,Navarra,238,Unzué/Untzue,157,83,74
31,Navarra,239,Urdazubi/Urdax,330,171,159
31,Navarra,240,Urdiain,636,329,307
31,Navarra,241,Urraul Alto,138,89,49
31,Navarra,242,Urraul Bajo,324,149,175
31,Navarra,244,Urroz,177,97,80
31,Navarra,243,Urroz-Villa,399,207,192
31,Navarra,245,Urzainqui/Urzainki,85,52,33
31,Navarra,246,Uterga,165,95,70
31,Navarra,247,Uztárroz/Uztarroze,147,72,75
31,Navarra,86,Valle de Egüés/Eguesibar,21795,10907,10888
31,Navarra,194,Valle de Ollo/Ollaran,425,227,198
31,Navarra,260,Valle de Yerri/Deierri,1568,819,749
31,Navarra,249,Valtierra,2439,1231,1208
31,Navarra,251,Viana,4366,2219,2147
31,Navarra,252,Vidángoz/Bidankoze,80,48,32
31,Navarra,254,Villafranca,2945,1520,1425
31,Navarra,255,Villamayor de Monjardín,114,57,57
31,Navarra,257,Villatuerta,1272,625,647
31,Navarra,258,Villava/Atarrabia,10022,4845,5177
31,Navarra,261,Yesa,304,174,130
31,Navarra,262,Zabalza/Zabaltza,297,157,140
31,Navarra,73,Ziordia,346,186,160
31,Navarra,907,Zizur Mayor/Zizur Nagusia,15497,7589,7908
31,Navarra,263,Zubieta,296,152,144
31,Navarra,264,Zugarramurdi,202,98,104
31,Navarra,265,Zúñiga,74,48,26
32,Ourense,1,Allariz,6348,3135,3213
32,Ourense,2,Amoeiro,2369,1196,1173
32,Ourense,3,"Arnoia, A",1015,502,513
32,Ourense,4,Avión,1770,813,957
32,Ourense,5,Baltar,910,485,425
32,Ourense,6,Bande,1463,742,721
32,Ourense,7,Baños de Molgas,1489,742,747
32,Ourense,8,Barbadás,11061,5387,5674
32,Ourense,9,"Barco de Valdeorras, O",13350,6472,6878
32,Ourense,10,Beade,372,193,179
32,Ourense,11,Beariz,978,435,543
32,Ourense,12,"Blancos, Os",732,399,333
32,Ourense,13,Boborás,2219,1056,1163
32,Ourense,14,"Bola, A",1088,519,569
32,Ourense,15,"Bolo, O",824,417,407
32,Ourense,16,Calvos de Randín,678,351,327
32,Ourense,18,Carballeda de Avia,1219,596,623
32,Ourense,17,Carballeda de Valdeorras,1409,727,682
32,Ourense,19,"Carballiño, O",13932,6479,7453
32,Ourense,20,Cartelle,2578,1266,1312
32,Ourense,22,Castrelo de Miño,1315,667,648
32,Ourense,21,Castrelo do Val,969,493,476
32,Ourense,23,Castro Caldelas,1177,600,577
32,Ourense,24,Celanova,5619,2639,2980
32,Ourense,25,Cenlle,1119,551,568
32,Ourense,29,Chandrexa de Queixa,495,259,236
32,Ourense,26,Coles,3138,1577,1561
32,Ourense,27,Cortegada,1036,507,529
32,Ourense,28,Cualedro,1627,854,773
32,Ourense,30,Entrimo,1118,534,584
32,Ourense,31,Esgos,1104,558,546
32,Ourense,33,Gomesende,686,342,344
32,Ourense,34,"Gudiña, A",1180,589,591
32,Ourense,35,"Irixo, O",1366,657,709
32,Ourense,38,Larouco,440,208,232
32,Ourense,39,Laza,1205,632,573
32,Ourense,40,Leiro,1522,742,780
32,Ourense,41,Lobeira,774,390,384
32,Ourense,42,Lobios,1703,851,852
32,Ourense,43,Maceda,2853,1422,1431
32,Ourense,44,Manzaneda,828,403,425
32,Ourense,45,Maside,2753,1363,1390
32,Ourense,46,Melón,1137,555,582
32,Ourense,47,"Merca, A",1966,982,984
32,Ourense,48,"Mezquita, A",1005,524,481
32,Ourense,49,Montederramo,701,376,325
32,Ourense,50,Monterrei,2461,1255,1206
32,Ourense,51,Muíños,1424,714,710
32,Ourense,52,Nogueira de Ramuín,2081,1062,1019
32,Ourense,53,Oímbra,1730,948,782
32,Ourense,54,Ourense,103756,47089,56667
32,Ourense,55,Paderne de Allariz,1395,697,698
32,Ourense,56,Padrenda,1637,799,838
32,Ourense,57,Parada de Sil,531,284,247
32,Ourense,58,"Pereiro de Aguiar, O",6609,3419,3190
32,Ourense,59,"Peroxa, A",1805,890,915
32,Ourense,60,Petín,883,445,438
32,Ourense,61,Piñor,1146,596,550
32,Ourense,63,"Pobra de Trives, A",2019,1000,1019
32,Ourense,64,Pontedeva,479,237,242
32,Ourense,62,Porqueira,835,389,446
32,Ourense,65,Punxín,744,354,390
32,Ourense,66,Quintela de Leirado,626,290,336
32,Ourense,67,Rairiz de Veiga,1216,627,589
32,Ourense,68,Ramirás,1500,710,790
32,Ourense,69,Ribadavia,5003,2468,2535
32,Ourense,71,Riós,1432,722,710
32,Ourense,72,"Rúa, A",4186,2084,2102
32,Ourense,73,Rubiá,1376,666,710
32,Ourense,74,San Amaro,1042,500,542
32,Ourense,75,San Cibrao das Viñas,5558,2807,2751
32,Ourense,76,San Cristovo de Cea,2042,1008,1034
32,Ourense,70,San Xoán de Río,508,258,250
32,Ourense,77,Sandiás,1170,555,615
32,Ourense,78,Sarreaus,1107,542,565
32,Ourense,79,Taboadela,1471,750,721
32,Ourense,80,"Teixeira, A",345,179,166
32,Ourense,81,Toén,2388,1223,1165
32,Ourense,82,Trasmiras,1261,625,636
32,Ourense,83,"Veiga, A",901,469,432
32,Ourense,84,Verea,944,460,484
32,Ourense,85,Verín,13625,6554,7071
32,Ourense,86,Viana do Bolo,2781,1409,1372
32,Ourense,87,Vilamarín,1847,948,899
32,Ourense,88,Vilamartín de Valdeorras,1825,930,895
32,Ourense,89,Vilar de Barrio,1206,611,595
32,Ourense,90,Vilar de Santos,792,390,402
32,Ourense,91,Vilardevós,1726,914,812
32,Ourense,92,Vilariño de Conso,505,295,210
32,Ourense,32,Xinzo de Limia,9611,4659,4952
32,Ourense,36,Xunqueira de Ambía,1388,694,694
32,Ourense,37,Xunqueira de Espadanedo,723,360,363
34,Palencia,1,Abarca de Campos,43,25,18
34,Palencia,3,Abia de las Torres,169,93,76
34,Palencia,4,Aguilar de Campoo,6646,3219,3427
34,Palencia,5,Alar del Rey,909,447,462
34,Palencia,6,Alba de Cerrato,79,46,33
34,Palencia,9,Amayuelas de Arriba,40,25,15
34,Palencia,10,Ampudia,600,303,297
34,Palencia,11,Amusco,415,233,182
34,Palencia,12,Antigüedad,347,192,155
34,Palencia,15,Arconada,42,26,16
34,Palencia,17,Astudillo,1031,518,513
34,Palencia,18,Autilla del Pino,215,121,94
34,Palencia,19,Autillo de Campos,133,70,63
34,Palencia,20,Ayuela,54,34,20
34,Palencia,22,Baltanás,1206,613,593
34,Palencia,24,Baquerín de Campos,27,17,10
34,Palencia,25,Bárcena de Campos,50,25,25
34,Palencia,27,Barruelo de Santullán,1203,598,605
34,Palencia,28,Báscones de Ojeda,138,70,68
34,Palencia,29,Becerril de Campos,755,383,372
34,Palencia,31,Belmonte de Campos,32,16,16
34,Palencia,32,Berzosilla,40,22,18
34,Palencia,33,Boada de Campos,19,14,5
34,Palencia,35,Boadilla de Rioseco,111,63,48
34,Palencia,34,Boadilla del Camino,122,69,53
34,Palencia,36,Brañosera,252,141,111
34,Palencia,37,Buenavista de Valdavia,311,178,133
34,Palencia,38,Bustillo de la Vega,278,157,121
34,Palencia,39,Bustillo del Páramo de Carrión,53,32,21
34,Palencia,41,Calahorra de Boedo,89,42,47
34,Palencia,42,Calzada de los Molinos,313,174,139
34,Palencia,45,Capillas,68,38,30
34,Palencia,46,Cardeñosa de Volpejera,54,30,24
34,Palencia,47,Carrión de los Condes,2005,959,1046
34,Palencia,48,Castil de Vela,60,29,31
34,Palencia,49,Castrejón de la Peña,332,177,155
34,Palencia,50,Castrillo de Don Juan,190,106,84
34,Palencia,51,Castrillo de Onielo,108,54,54
34,Palencia,52,Castrillo de Villavega,171,95,76
34,Palencia,53,Castromocho,211,109,102
34,Palencia,55,Cervatos de la Cueza,261,144,117
34,Palencia,56,Cervera de Pisuerga,2256,1116,1140
34,Palencia,57,Cevico de la Torre,490,250,240
34,Palencia,58,Cevico Navero,189,112,77
34,Palencia,59,Cisneros,413,207,206
34,Palencia,60,Cobos de Cerrato,132,75,57
34,Palencia,61,Collazos de Boedo,97,57,40
34,Palencia,62,Congosto de Valdavia,147,88,59
34,Palencia,63,Cordovilla la Real,124,69,55
34,Palencia,66,Cubillas de Cerrato,64,37,27
34,Palencia,67,Dehesa de Montejo,136,79,57
34,Palencia,68,Dehesa de Romanos,49,31,18
34,Palencia,69,Dueñas,2592,1316,1276
34,Palencia,70,Espinosa de Cerrato,129,71,58
34,Palencia,71,Espinosa de Villagonzalo,164,88,76
34,Palencia,72,Frechilla,136,68,68
34,Palencia,73,Fresno del Río,184,88,96
34,Palencia,74,Frómista,768,389,379
34,Palencia,76,Fuentes de Nava,610,316,294
34,Palencia,77,Fuentes de Valdepero,502,258,244
34,Palencia,79,Grijota,2606,1350,1256
34,Palencia,80,Guardo,5695,2807,2888
34,Palencia,81,Guaza de Campos,56,35,21
34,Palencia,82,Hérmedes de Cerrato,78,40,38
34,Palencia,83,Herrera de Pisuerga,1894,925,969
34,Palencia,84,Herrera de Valdecañas,149,82,67
34,Palencia,86,Hontoria de Cerrato,102,54,48
34,Palencia,87,Hornillos de Cerrato,153,85,68
34,Palencia,88,Husillos,371,196,175
34,Palencia,89,Itero de la Vega,150,86,64
34,Palencia,91,Lagartos,126,72,54
34,Palencia,92,Lantadilla,288,154,134
34,Palencia,94,Ledigos,64,31,33
34,Palencia,903,Loma de Ucieza,189,115,74
34,Palencia,96,Lomas,44,29,15
34,Palencia,98,Magaz de Pisuerga,1010,528,482
34,Palencia,99,Manquillos,52,35,17
34,Palencia,100,Mantinos,141,83,58
34,Palencia,101,Marcilla de Campos,48,22,26
34,Palencia,102,Mazariegos,212,129,83
34,Palencia,103,Mazuecos de Valdeginate,90,57,33
34,Palencia,104,Melgar de Yuso,255,145,110
34,Palencia,106,Meneses de Campos,104,57,47
34,Palencia,107,Micieces de Ojeda,72,43,29
34,Palencia,108,Monzón de Campos,594,314,280
34,Palencia,109,Moratinos,63,35,28
34,Palencia,110,Mudá,80,47,33
34,Palencia,112,Nogal de las Huertas,40,23,17
34,Palencia,113,Olea de Boedo,37,14,23
34,Palencia,114,Olmos de Ojeda,195,121,74
34,Palencia,116,Osornillo,56,31,25
34,Palencia,901,Osorno la Mayor,1159,604,555
34,Palencia,120,Palencia,76302,35937,40365
34,Palencia,121,Palenzuela,212,120,92
34,Palencia,122,Páramo de Boedo,105,63,42
34,Palencia,123,Paredes de Nava,1899,975,924
34,Palencia,124,Payo de Ojeda,63,39,24
34,Palencia,125,Pedraza de Campos,76,42,34
34,Palencia,126,Pedrosa de la Vega,298,168,130
34,Palencia,127,Perales,103,49,54
34,Palencia,904,"Pernía, La",316,185,131
34,Palencia,129,Pino del Río,169,102,67
34,Palencia,130,Piña de Campos,199,106,93
34,Palencia,131,Población de Arroyo,52,28,24
34,Palencia,132,Población de Campos,132,76,56
34,Palencia,133,Población de Cerrato,107,62,45
34,Palencia,134,Polentinos,47,24,23
34,Palencia,135,Pomar de Valdivia,477,262,215
34,Palencia,136,Poza de la Vega,167,97,70
34,Palencia,137,Pozo de Urama,20,14,6
34,Palencia,139,Prádanos de Ojeda,178,99,79
34,Palencia,140,"Puebla de Valdavia, La",86,47,39
34,Palencia,141,Quintana del Puente,290,158,132
34,Palencia,143,Quintanilla de Onsoña,180,100,80
34,Palencia,146,Reinoso de Cerrato,56,35,21
34,Palencia,147,Renedo de la Vega,198,106,92
34,Palencia,149,Requena de Campos,24,13,11
34,Palencia,151,Respenda de la Peña,146,90,56
34,Palencia,152,Revenga de Campos,142,70,72
34,Palencia,154,Revilla de Collazos,80,45,35
34,Palencia,155,Ribas de Campos,147,75,72
34,Palencia,156,Riberos de la Cueza,57,35,22
34,Palencia,157,Saldaña,2905,1495,1410
34,Palencia,158,Salinas de Pisuerga,313,165,148
34,Palencia,159,San Cebrián de Campos,424,244,180
34,Palencia,160,San Cebrián de Mudá,151,84,67
34,Palencia,161,San Cristóbal de Boedo,23,15,8
34,Palencia,163,San Mamés de Campos,43,22,21
34,Palencia,165,San Román de la Cuba,59,35,24
34,Palencia,167,Santa Cecilia del Alcor,105,61,44
34,Palencia,168,Santa Cruz de Boedo,50,31,19
34,Palencia,169,Santervás de la Vega,420,237,183
34,Palencia,170,Santibáñez de Ecla,48,26,22
34,Palencia,171,Santibáñez de la Peña,978,479,499
34,Palencia,174,Santoyo,187,103,84
34,Palencia,175,"Serna, La",89,56,33
34,Palencia,177,Soto de Cerrato,187,106,81
34,Palencia,176,Sotobañado y Priorato,155,90,65
34,Palencia,178,Tabanera de Cerrato,141,75,66
34,Palencia,179,Tabanera de Valdavia,23,14,9
34,Palencia,180,Támara de Campos,73,39,34
34,Palencia,181,Tariego de Cerrato,478,255,223
34,Palencia,182,Torquemada,948,512,436
34,Palencia,184,Torremormojón,44,26,18
34,Palencia,185,Triollo,75,43,32
34,Palencia,186,Valbuena de Pisuerga,50,25,25
34,Palencia,189,Valdeolmillos,55,31,24
34,Palencia,190,Valderrábano,47,25,22
34,Palencia,192,Valde-Ucieza,84,53,31
34,Palencia,196,Valle de Cerrato,89,52,37
34,Palencia,902,Valle del Retortillo,178,95,83
34,Palencia,199,Velilla del Río Carrión,1173,602,571
34,Palencia,23,Venta de Baños,6324,3197,3127
34,Palencia,201,Vertavillo,167,87,80
34,Palencia,93,"Vid de Ojeda, La",87,53,34
34,Palencia,202,Villabasta de Valdavia,34,20,14
34,Palencia,204,Villacidaler,46,27,19
34,Palencia,205,Villaconancio,57,34,23
34,Palencia,206,Villada,875,442,433
34,Palencia,208,Villaeles de Valdavia,51,32,19
34,Palencia,210,Villahán,97,55,42
34,Palencia,211,Villaherreros,226,120,106
34,Palencia,213,Villalaco,59,33,26
34,Palencia,214,Villalba de Guardo,200,106,94
34,Palencia,215,Villalcázar de Sirga,175,90,85
34,Palencia,216,Villalcón,58,33,25
34,Palencia,217,Villalobón,1826,911,915
34,Palencia,218,Villaluenga de la Vega,553,322,231
34,Palencia,220,Villamartín de Campos,181,98,83
34,Palencia,221,Villamediana,184,108,76
34,Palencia,222,Villameriel,109,62,47
34,Palencia,223,Villamoronta,242,143,99
34,Palencia,224,Villamuera de la Cueza,38,25,13
34,Palencia,225,Villamuriel de Cerrato,6485,3341,3144
34,Palencia,227,Villanueva del Rebollar,65,34,31
34,Palencia,228,Villanuño de Valdavia,94,52,42
34,Palencia,229,Villaprovedo,50,34,16
34,Palencia,230,Villarmentero de Campos,19,12,7
34,Palencia,231,Villarrabé,186,100,86
34,Palencia,232,Villarramiel,795,422,373
34,Palencia,233,Villasarracino,127,77,50
34,Palencia,234,Villasila de Valdavia,64,43,21
34,Palencia,236,Villaturde,154,83,71
34,Palencia,237,Villaumbrales,650,322,328
34,Palencia,238,Villaviudas,361,169,192
34,Palencia,240,Villerías de Campos,82,41,41
34,Palencia,241,Villodre,17,10,7
34,Palencia,242,Villodrigo,100,52,48
34,Palencia,243,Villoldo,335,177,158
34,Palencia,245,Villota del Páramo,307,177,130
34,Palencia,246,Villovieco,68,36,32
35,"Palmas, Las",1,Agaete,5633,2841,2792
35,"Palmas, Las",2,Agüimes,32067,16164,15903
35,"Palmas, Las",20,"Aldea de San Nicolás, La",7536,3895,3641
35,"Palmas, Las",3,Antigua,12940,6801,6139
35,"Palmas, Las",4,Arrecife,63750,31987,31763
35,"Palmas, Las",5,Artenara,1030,594,436
35,"Palmas, Las",6,Arucas,38369,19054,19315
35,"Palmas, Las",7,Betancuria,789,412,377
35,"Palmas, Las",8,Firgas,7581,3836,3745
35,"Palmas, Las",9,Gáldar,24567,12299,12268
35,"Palmas, Las",10,Haría,5382,2755,2627
35,"Palmas, Las",11,Ingenio,31932,16054,15878
35,"Palmas, Las",12,Mogán,20331,10452,9879
35,"Palmas, Las",13,Moya,7870,4001,3869
35,"Palmas, Las",14,"Oliva, La",27945,14474,13471
35,"Palmas, Las",15,Pájara,20751,10782,9969
35,"Palmas, Las",16,"Palmas de Gran Canaria, Las",378797,182267,196530
35,"Palmas, Las",17,Puerto del Rosario,42024,21078,20946
35,"Palmas, Las",18,San Bartolomé,18989,9439,9550
35,"Palmas, Las",19,San Bartolomé de Tirajana,52936,27721,25215
35,"Palmas, Las",21,Santa Brígida,18341,9172,9169
35,"Palmas, Las",22,Santa Lucía de Tirajana,74560,37048,37512
35,"Palmas, Las",23,Santa María de Guía de Gran Canaria,13838,6903,6935
35,"Palmas, Las",24,Teguise,23411,11736,11675
35,"Palmas, Las",25,Tejeda,1813,992,821
35,"Palmas, Las",26,Telde,102472,50312,52160
35,"Palmas, Las",27,Teror,12667,6489,6178
35,"Palmas, Las",28,Tías,21083,10724,10359
35,"Palmas, Las",29,Tinajo,6573,3356,3217
35,"Palmas, Las",30,Tuineje,15572,7908,7664
35,"Palmas, Las",32,Valleseco,3750,1958,1792
35,"Palmas, Las",31,Valsequillo de Gran Canaria,9490,4770,4720
35,"Palmas, Las",33,Vega de San Mateo,7682,3946,3736
35,"Palmas, Las",34,Yaiza,16924,8744,8180
36,Pontevedra,20,Agolada,2252,1124,1128
36,Pontevedra,1,Arbo,2622,1362,1260
36,Pontevedra,3,Baiona,12349,6083,6266
36,Pontevedra,2,Barro,3637,1784,1853
36,Pontevedra,4,Bueu,11978,5883,6095
36,Pontevedra,5,Caldas de Reis,9678,4672,5006
36,Pontevedra,6,Cambados,13671,6595,7076
36,Pontevedra,7,Campo Lameiro,1721,817,904
36,Pontevedra,8,Cangas,26832,13325,13507
36,Pontevedra,9,"Cañiza, A",5115,2512,2603
36,Pontevedra,10,Catoira,3295,1597,1698
36,Pontevedra,902,Cerdedo-Cotobade,5697,2771,2926
36,Pontevedra,13,Covelo,2480,1283,1197
36,Pontevedra,14,Crecente,1937,942,995
36,Pontevedra,15,Cuntis,4592,2182,2410
36,Pontevedra,16,Dozón,1028,529,499
36,Pontevedra,17,"Estrada, A",20106,9680,10426
36,Pontevedra,18,Forcarei,3194,1533,1661
36,Pontevedra,19,Fornelos de Montes,1621,779,842
36,Pontevedra,21,Gondomar,14970,7469,7501
36,Pontevedra,22,"Grove, O",10809,5314,5495
36,Pontevedra,23,"Guarda, A",10013,4932,5081
36,Pontevedra,901,"Illa de Arousa, A",4878,2404,2474
36,Pontevedra,24,Lalín,20201,9859,10342
36,Pontevedra,25,"Lama, A",2499,1253,1246
36,Pontevedra,26,Marín,24034,11918,12116
36,Pontevedra,27,Meaño,5292,2575,2717
36,Pontevedra,28,Meis,4735,2285,2450
36,Pontevedra,29,Moaña,19474,9455,10019
36,Pontevedra,30,Mondariz,4448,2210,2238
36,Pontevedra,31,Mondariz-Balneario,680,346,334
36,Pontevedra,32,Moraña,4133,2005,2128
36,Pontevedra,33,Mos,15199,7522,7677
36,Pontevedra,34,"Neves, As",3746,1844,1902
36,Pontevedra,35,Nigrán,18054,8868,9186
36,Pontevedra,36,Oia,3080,1522,1558
36,Pontevedra,37,Pazos de Borbén,2998,1469,1529
36,Pontevedra,41,Poio,17276,8541,8735
36,Pontevedra,43,Ponte Caldelas,5575,2676,2899
36,Pontevedra,42,Ponteareas,23049,11152,11897
36,Pontevedra,44,Pontecesures,3079,1513,1566
36,Pontevedra,38,Pontevedra,82828,39139,43689
36,Pontevedra,39,"Porriño, O",20408,10023,10385
36,Pontevedra,40,Portas,2851,1374,1477
36,Pontevedra,45,Redondela,29055,14052,15003
36,Pontevedra,46,Ribadumia,5193,2542,2651
36,Pontevedra,47,Rodeiro,2317,1151,1166
36,Pontevedra,48,"Rosal, O",6450,3153,3297
36,Pontevedra,49,Salceda de Caselas,9380,4680,4700
36,Pontevedra,50,Salvaterra de Miño,10079,5017,5062
36,Pontevedra,51,Sanxenxo,17760,8793,8967
36,Pontevedra,52,Silleda,8860,4325,4535
36,Pontevedra,53,Soutomaior,7543,3758,3785
36,Pontevedra,54,Tomiño,13779,6934,6845
36,Pontevedra,55,Tui,17375,8476,8899
36,Pontevedra,56,Valga,5752,2807,2945
36,Pontevedra,57,Vigo,292374,137820,154554
36,Pontevedra,59,Vila de Cruces,5063,2521,2542
36,Pontevedra,58,Vilaboa,6004,2951,3053
36,Pontevedra,60,Vilagarcía de Arousa,37677,18020,19657
36,Pontevedra,61,Vilanova de Arousa,10240,4961,5279
26,"Rioja, La",1,Ábalos,260,149,111
26,"Rioja, La",2,Agoncillo,1175,648,527
26,"Rioja, La",3,Aguilar del Río Alhama,442,231,211
26,"Rioja, La",4,Ajamil de Cameros,68,46,22
26,"Rioja, La",5,Albelda de Iregua,3591,1840,1751
26,"Rioja, La",6,Alberite,2582,1319,1263
26,"Rioja, La",7,Alcanadre,647,332,315
26,"Rioja, La",8,Aldeanueva de Ebro,2786,1451,1335
26,"Rioja, La",9,Alesanco,481,254,227
26,"Rioja, La",10,Alesón,90,51,39
26,"Rioja, La",11,Alfaro,9727,4880,4847
26,"Rioja, La",12,Almarza de Cameros,37,23,14
26,"Rioja, La",13,Anguciana,446,248,198
26,"Rioja, La",14,Anguiano,524,286,238
26,"Rioja, La",15,Arenzana de Abajo,267,137,130
26,"Rioja, La",16,Arenzana de Arriba,36,24,12
26,"Rioja, La",17,Arnedillo,450,219,231
26,"Rioja, La",18,Arnedo,15017,7509,7508
26,"Rioja, La",19,Arrúbal,568,305,263
26,"Rioja, La",20,Ausejo,786,418,368
26,"Rioja, La",21,Autol,4788,2404,2384
26,"Rioja, La",22,Azofra,209,116,93
26,"Rioja, La",23,Badarán,500,254,246
26,"Rioja, La",24,Bañares,206,109,97
26,"Rioja, La",26,Baños de Río Tobía,1589,805,784
26,"Rioja, La",25,Baños de Rioja,82,49,33
26,"Rioja, La",27,Berceo,143,90,53
26,"Rioja, La",28,Bergasa,160,88,72
26,"Rioja, La",29,Bergasillas Bajera,33,17,16
26,"Rioja, La",30,Bezares,25,12,13
26,"Rioja, La",31,Bobadilla,93,48,45
26,"Rioja, La",32,Brieva de Cameros,46,30,16
26,"Rioja, La",33,Briñas,190,89,101
26,"Rioja, La",34,Briones,722,381,341
26,"Rioja, La",35,Cabezón de Cameros,19,12,7
26,"Rioja, La",36,Calahorra,24654,12093,12561
26,"Rioja, La",37,Camprovín,171,94,77
26,"Rioja, La",38,Canales de la Sierra,83,55,28
26,"Rioja, La",39,Canillas de Río Tuerto,40,22,18
26,"Rioja, La",40,Cañas,89,48,41
26,"Rioja, La",41,Cárdenas,128,70,58
26,"Rioja, La",42,Casalarreina,1074,531,543
26,"Rioja, La",43,Castañares de Rioja,395,188,207
26,"Rioja, La",44,Castroviejo,48,28,20
26,"Rioja, La",45,Cellorigo,9,4,5
26,"Rioja, La",46,Cenicero,2073,1069,1004
26,"Rioja, La",47,Cervera del Río Alhama,2273,1187,1086
26,"Rioja, La",48,Cidamón,23,12,11
26,"Rioja, La",49,Cihuri,186,95,91
26,"Rioja, La",50,Cirueña,194,122,72
26,"Rioja, La",51,Clavijo,300,173,127
26,"Rioja, La",52,Cordovín,153,75,78
26,"Rioja, La",53,Corera,286,146,140
26,"Rioja, La",54,Cornago,310,179,131
26,"Rioja, La",55,Corporales,36,23,13
26,"Rioja, La",56,Cuzcurrita de Río Tirón,526,283,243
26,"Rioja, La",57,Daroca de Rioja,56,35,21
26,"Rioja, La",58,Enciso,172,110,62
26,"Rioja, La",59,Entrena,1632,855,777
26,"Rioja, La",60,Estollo,82,51,31
26,"Rioja, La",61,Ezcaray,2055,1076,979
26,"Rioja, La",62,Foncea,93,55,38
26,"Rioja, La",63,Fonzaleche,138,89,49
26,"Rioja, La",64,Fuenmayor,3227,1629,1598
26,"Rioja, La",65,Galbárruli,75,47,28
26,"Rioja, La",66,Galilea,387,197,190
26,"Rioja, La",67,Gallinero de Cameros,17,10,7
26,"Rioja, La",68,Gimileo,109,60,49
26,"Rioja, La",69,Grañón,250,137,113
26,"Rioja, La",70,Grávalos,178,98,80
26,"Rioja, La",71,Haro,11634,5754,5880
26,"Rioja, La",72,Herce,321,164,157
26,"Rioja, La",73,Herramélluri,104,57,47
26,"Rioja, La",74,Hervías,127,67,60
26,"Rioja, La",75,Hormilla,443,231,212
26,"Rioja, La",76,Hormilleja,132,66,66
26,"Rioja, La",77,Hornillos de Cameros,23,15,8
26,"Rioja, La",78,Hornos de Moncalvillo,95,54,41
26,"Rioja, La",79,Huércanos,860,476,384
26,"Rioja, La",80,Igea,639,359,280
26,"Rioja, La",81,Jalón de Cameros,22,10,12
26,"Rioja, La",82,Laguna de Cameros,109,64,45
26,"Rioja, La",83,Lagunilla del Jubera,334,181,153
26,"Rioja, La",84,Lardero,11094,5572,5522
26,"Rioja, La",86,Ledesma de la Cogolla,16,12,4
26,"Rioja, La",87,Leiva,238,117,121
26,"Rioja, La",88,Leza de Río Leza,40,22,18
26,"Rioja, La",89,Logroño,150020,71044,78976
26,"Rioja, La",91,Lumbreras de Cameros,144,103,41
26,"Rioja, La",92,Manjarrés,110,65,45
26,"Rioja, La",93,Mansilla de la Sierra,52,39,13
26,"Rioja, La",94,Manzanares de Rioja,58,35,23
26,"Rioja, La",95,Matute,93,55,38
26,"Rioja, La",96,Medrano,339,181,158
26,"Rioja, La",98,Munilla,109,60,49
26,"Rioja, La",99,Murillo de Río Leza,1609,819,790
26,"Rioja, La",100,Muro de Aguas,63,40,23
26,"Rioja, La",101,Muro en Cameros,35,19,16
26,"Rioja, La",102,Nájera,8069,3971,4098
26,"Rioja, La",103,Nalda,1210,658,552
26,"Rioja, La",104,Navajún,9,7,2
26,"Rioja, La",105,Navarrete,3016,1506,1510
26,"Rioja, La",106,Nestares,87,50,37
26,"Rioja, La",107,Nieva de Cameros,86,56,30
26,"Rioja, La",109,Ochánduri,79,47,32
26,"Rioja, La",108,Ocón,315,192,123
26,"Rioja, La",110,Ojacastro,187,111,76
26,"Rioja, La",111,Ollauri,311,165,146
26,"Rioja, La",112,Ortigosa de Cameros,219,136,83
26,"Rioja, La",113,Pazuengos,27,22,5
26,"Rioja, La",114,Pedroso,89,55,34
26,"Rioja, La",115,Pinillos,21,10,11
26,"Rioja, La",117,Pradejón,3853,1996,1857
26,"Rioja, La",118,Pradillo,65,35,30
26,"Rioja, La",119,Préjano,204,113,91
26,"Rioja, La",120,Quel,2088,1105,983
26,"Rioja, La",121,Rabanera,31,23,8
26,"Rioja, La",122,"Rasillo de Cameros, El",145,81,64
26,"Rioja, La",123,"Redal, El",150,85,65
26,"Rioja, La",124,Ribafrecha,1027,534,493
26,"Rioja, La",125,Rincón de Soto,3942,2045,1897
26,"Rioja, La",126,Robres del Castillo,26,17,9
26,"Rioja, La",127,Rodezno,212,119,93
26,"Rioja, La",128,Sajazarra,124,71,53
26,"Rioja, La",129,San Asensio,1113,590,523
26,"Rioja, La",130,San Millán de la Cogolla,216,143,73
26,"Rioja, La",131,San Millán de Yécora,34,24,10
26,"Rioja, La",132,San Román de Cameros,126,81,45
26,"Rioja, La",139,San Torcuato,69,37,32
26,"Rioja, La",142,San Vicente de la Sonsierra,1031,534,497
26,"Rioja, La",134,Santa Coloma,92,56,36
26,"Rioja, La",135,Santa Engracia del Jubera,181,111,70
26,"Rioja, La",136,Santa Eulalia Bajera,111,64,47
26,"Rioja, La",138,Santo Domingo de la Calzada,6242,3123,3119
26,"Rioja, La",140,Santurde de Rioja,277,148,129
26,"Rioja, La",141,Santurdejo,100,61,39
26,"Rioja, La",143,Sojuela,570,312,258
26,"Rioja, La",144,Sorzano,225,124,101
26,"Rioja, La",145,Sotés,267,148,119
26,"Rioja, La",146,Soto en Cameros,81,47,34
26,"Rioja, La",147,Terroba,37,18,19
26,"Rioja, La",148,Tirgo,178,90,88
26,"Rioja, La",149,Tobía,50,27,23
26,"Rioja, La",150,Tormantos,114,63,51
26,"Rioja, La",153,Torre en Cameros,10,8,2
26,"Rioja, La",151,Torrecilla en Cameros,427,237,190
26,"Rioja, La",152,Torrecilla sobre Alesanco,48,29,19
26,"Rioja, La",154,Torremontalbo,9,8,1
26,"Rioja, La",155,Treviana,144,74,70
26,"Rioja, La",157,Tricio,371,184,187
26,"Rioja, La",158,Tudelilla,320,173,147
26,"Rioja, La",160,Uruñuela,984,502,482
26,"Rioja, La",161,Valdemadera,13,9,4
26,"Rioja, La",162,Valgañón,141,81,60
26,"Rioja, La",163,Ventosa,205,106,99
26,"Rioja, La",164,Ventrosa,53,32,21
26,"Rioja, La",165,Viguera,390,221,169
26,"Rioja, La",166,Villalba de Rioja,162,97,65
26,"Rioja, La",167,Villalobar de Rioja,67,48,19
26,"Rioja, La",168,Villamediana de Iregua,8745,4406,4339
26,"Rioja, La",169,Villanueva de Cameros,72,44,28
26,"Rioja, La",170,"Villar de Arnedo, El",593,319,274
26,"Rioja, La",171,Villar de Torre,162,100,62
26,"Rioja, La",172,Villarejo,34,25,9
26,"Rioja, La",173,Villarroya,5,3,2
26,"Rioja, La",174,Villarta-Quintana,136,79,57
26,"Rioja, La",175,Villavelayo,40,26,14
26,"Rioja, La",176,Villaverde de Rioja,55,32,23
26,"Rioja, La",177,Villoslada de Cameros,351,228,123
26,"Rioja, La",178,Viniegra de Abajo,79,51,28
26,"Rioja, La",179,Viniegra de Arriba,39,26,13
26,"Rioja, La",180,Zarratón,258,137,121
26,"Rioja, La",181,Zarzosa,12,9,3
26,"Rioja, La",183,Zorraquín,91,45,46
37,Salamanca,1,Abusejo,161,84,77
37,Salamanca,2,Agallas,131,69,62
37,Salamanca,3,Ahigal de los Aceiteros,101,56,45
37,Salamanca,4,Ahigal de Villarino,27,15,12
37,Salamanca,5,"Alameda de Gardón, La",70,35,35
37,Salamanca,6,"Alamedilla, La",117,60,57
37,Salamanca,7,Alaraz,449,237,212
37,Salamanca,8,Alba de Tormes,5092,2563,2529
37,Salamanca,9,Alba de Yeltes,211,117,94
37,Salamanca,10,"Alberca, La",1071,524,547
37,Salamanca,11,"Alberguería de Argañán, La",105,55,50
37,Salamanca,12,Alconada,142,77,65
37,Salamanca,15,Aldea del Obispo,275,151,124
37,Salamanca,13,Aldeacipreste,98,53,45
37,Salamanca,14,Aldeadávila de la Ribera,1159,574,585
37,Salamanca,16,Aldealengua,674,337,337
37,Salamanca,17,Aldeanueva de Figueroa,239,129,110
37,Salamanca,18,Aldeanueva de la Sierra,106,66,40
37,Salamanca,19,Aldearrodrigo,148,81,67
37,Salamanca,20,Aldearrubia,524,284,240
37,Salamanca,21,Aldeaseca de Alba,72,38,34
37,Salamanca,22,Aldeaseca de la Frontera,251,129,122
37,Salamanca,23,Aldeatejada,2417,1224,1193
37,Salamanca,24,Aldeavieja de Tormes,104,56,48
37,Salamanca,25,Aldehuela de la Bóveda,285,154,131
37,Salamanca,26,Aldehuela de Yeltes,191,101,90
37,Salamanca,27,Almenara de Tormes,303,167,136
37,Salamanca,28,Almendra,135,77,58
37,Salamanca,29,Anaya de Alba,185,109,76
37,Salamanca,30,Añover de Tormes,89,47,42
37,Salamanca,31,Arabayona de Mógica,338,191,147
37,Salamanca,32,Arapiles,693,371,322
37,Salamanca,33,Arcediano,97,50,47
37,Salamanca,34,"Arco, El",91,45,46
37,Salamanca,35,Armenteros,182,111,71
37,Salamanca,37,"Atalaya, La",104,59,45
37,Salamanca,38,Babilafuente,936,490,446
37,Salamanca,39,Bañobárez,286,146,140
37,Salamanca,40,Barbadillo,409,220,189
37,Salamanca,41,Barbalos,74,42,32
37,Salamanca,42,Barceo,48,29,19
37,Salamanca,44,Barruecopardo,422,235,187
37,Salamanca,45,"Bastida, La",31,18,13
37,Salamanca,46,Béjar,12099,5726,6373
37,Salamanca,47,Beleña,215,114,101
37,Salamanca,49,Bermellar,121,64,57
37,Salamanca,50,Berrocal de Huebra,77,43,34
37,Salamanca,51,Berrocal de Salvatierra,79,44,35
37,Salamanca,52,Boada,283,146,137
37,Salamanca,54,"Bodón, El",251,137,114
37,Salamanca,55,Bogajo,136,74,62
37,Salamanca,56,"Bouza, La",57,25,32
37,Salamanca,57,Bóveda del Río Almar,215,117,98
37,Salamanca,58,Brincones,51,27,24
37,Salamanca,59,Buenamadre,119,60,59
37,Salamanca,60,Buenavista,356,192,164
37,Salamanca,61,"Cabaco, El",232,123,109
37,Salamanca,63,"Cabeza de Béjar, La",57,36,21
37,Salamanca,65,Cabeza del Caballo,247,138,109
37,Salamanca,62,Cabezabellosa de la Calzada,72,42,30
37,Salamanca,67,Cabrerizos,4276,2129,2147
37,Salamanca,68,Cabrillas,333,168,165
37,Salamanca,69,Calvarrasa de Abajo,1173,606,567
37,Salamanca,70,Calvarrasa de Arriba,590,317,273
37,Salamanca,71,"Calzada de Béjar, La",87,51,36
37,Salamanca,72,Calzada de Don Diego,140,76,64
37,Salamanca,73,Calzada de Valdunciel,706,356,350
37,Salamanca,74,Campillo de Azaba,146,87,59
37,Salamanca,77,"Campo de Peñaranda, El",263,153,110
37,Salamanca,78,Candelario,871,445,426
37,Salamanca,79,Canillas de Abajo,78,52,26
37,Salamanca,80,Cantagallo,275,143,132
37,Salamanca,81,Cantalapiedra,904,460,444
37,Salamanca,82,Cantalpino,803,433,370
37,Salamanca,83,Cantaracillo,193,106,87
37,Salamanca,85,Carbajosa de la Sagrada,7424,3696,3728
37,Salamanca,86,Carpio de Azaba,115,63,52
37,Salamanca,87,Carrascal de Barregas,1356,700,656
37,Salamanca,88,Carrascal del Obispo,193,106,87
37,Salamanca,89,Casafranca,59,30,29
37,Salamanca,90,"Casas del Conde, Las",64,29,35
37,Salamanca,91,Casillas de Flores,185,87,98
37,Salamanca,92,Castellanos de Moriscos,2918,1507,1411
37,Salamanca,185,Castellanos de Villiquera,673,360,313
37,Salamanca,96,Castillejo de Martín Viejo,215,129,86
37,Salamanca,97,Castraz,36,23,13
37,Salamanca,98,Cepeda,290,149,141
37,Salamanca,99,Cereceda de la Sierra,65,33,32
37,Salamanca,100,Cerezal de Peñahorcada,71,36,35
37,Salamanca,101,Cerralbo,126,69,57
37,Salamanca,102,"Cerro, El",380,195,185
37,Salamanca,103,Cespedosa de Tormes,509,274,235
37,Salamanca,114,Chagarcía Medianero,62,34,28
37,Salamanca,104,Cilleros de la Bastida,23,12,11
37,Salamanca,106,Cipérez,247,129,118
37,Salamanca,107,Ciudad Rodrigo,11973,5744,6229
37,Salamanca,108,Coca de Alba,104,55,49
37,Salamanca,109,Colmenar de Montemayor,175,103,72
37,Salamanca,110,Cordovilla,109,60,49
37,Salamanca,112,Cristóbal,169,99,70
37,Salamanca,113,"Cubo de Don Sancho, El",412,213,199
37,Salamanca,115,Dios le Guarde,117,62,55
37,Salamanca,116,Doñinos de Ledesma,64,32,32
37,Salamanca,117,Doñinos de Salamanca,2251,1184,1067
37,Salamanca,118,Éjeme,126,74,52
37,Salamanca,120,Encina de San Silvestre,115,54,61
37,Salamanca,119,"Encina, La",101,58,43
37,Salamanca,121,Encinas de Abajo,611,320,291
37,Salamanca,122,Encinas de Arriba,235,117,118
37,Salamanca,123,Encinasola de los Comendadores,156,88,68
37,Salamanca,124,Endrinal,205,115,90
37,Salamanca,125,Escurial de la Sierra,232,128,104
37,Salamanca,126,Espadaña,33,21,12
37,Salamanca,127,Espeja,219,119,100
37,Salamanca,128,Espino de la Orbada,253,140,113
37,Salamanca,129,Florida de Liébana,243,136,107
37,Salamanca,130,Forfoleda,198,113,85
37,Salamanca,131,Frades de la Sierra,180,99,81
37,Salamanca,132,"Fregeneda, La",314,154,160
37,Salamanca,133,Fresnedoso,99,56,43
37,Salamanca,134,Fresno Alhándiga,194,106,88
37,Salamanca,135,"Fuente de San Esteban, La",1280,646,634
37,Salamanca,136,Fuenteguinaldo,667,327,340
37,Salamanca,137,Fuenteliante,91,45,46
37,Salamanca,138,Fuenterroble de Salvatierra,260,134,126
37,Salamanca,139,Fuentes de Béjar,223,116,107
37,Salamanca,140,Fuentes de Oñoro,1113,604,509
37,Salamanca,141,Gajates,142,70,72
37,Salamanca,142,Galindo y Perahuy,659,371,288
37,Salamanca,143,Galinduste,404,195,209
37,Salamanca,144,Galisancho,346,189,157
37,Salamanca,145,Gallegos de Argañán,257,128,129
37,Salamanca,146,Gallegos de Solmirón,116,67,49
37,Salamanca,147,Garcibuey,193,110,83
37,Salamanca,148,Garcihernández,426,221,205
37,Salamanca,149,Garcirrey,56,32,24
37,Salamanca,150,Gejuelo del Barro,34,20,14
37,Salamanca,151,Golpejas,148,78,70
37,Salamanca,152,Gomecello,407,216,191
37,Salamanca,154,Guadramiro,134,83,51
37,Salamanca,155,Guijo de Ávila,73,41,32
37,Salamanca,156,Guijuelo,5495,2759,2736
37,Salamanca,157,Herguijuela de Ciudad Rodrigo,69,41,28
37,Salamanca,158,Herguijuela de la Sierra,234,131,103
37,Salamanca,159,Herguijuela del Campo,68,36,32
37,Salamanca,160,Hinojosa de Duero,612,316,296
37,Salamanca,161,Horcajo de Montemayor,120,66,54
37,Salamanca,162,Horcajo Medianero,223,115,108
37,Salamanca,163,"Hoya, La",28,18,10
37,Salamanca,164,Huerta,278,154,124
37,Salamanca,165,Iruelos,28,11,17
37,Salamanca,166,Ituero de Azaba,209,109,100
37,Salamanca,167,Juzbado,197,100,97
37,Salamanca,168,Lagunilla,430,240,190
37,Salamanca,169,Larrodrigo,188,109,79
37,Salamanca,170,Ledesma,1528,750,778
37,Salamanca,171,Ledrada,451,226,225
37,Salamanca,172,Linares de Riofrío,935,519,416
37,Salamanca,173,Lumbrales,1534,778,756
37,Salamanca,175,Machacón,442,230,212
37,Salamanca,174,Macotera,999,512,487
37,Salamanca,176,Madroñal,140,79,61
37,Salamanca,177,"Maíllo, El",276,155,121
37,Salamanca,178,Malpartida,90,47,43
37,Salamanca,179,Mancera de Abajo,210,110,100
37,Salamanca,180,"Manzano, El",62,32,30
37,Salamanca,181,Martiago,267,146,121
37,Salamanca,183,Martín de Yeltes,400,203,197
37,Salamanca,182,Martinamor,77,49,28
37,Salamanca,184,Masueco,264,137,127
37,Salamanca,186,"Mata de Ledesma, La",106,60,46
37,Salamanca,187,Matilla de los Caños del Río,644,316,328
37,Salamanca,188,"Maya, La",165,96,69
37,Salamanca,189,Membribe de la Sierra,104,62,42
37,Salamanca,190,Mieza,180,92,88
37,Salamanca,191,"Milano, El",95,59,36
37,Salamanca,192,Miranda de Azán,457,248,209
37,Salamanca,193,Miranda del Castañar,396,213,183
37,Salamanca,194,Mogarraz,240,125,115
37,Salamanca,195,Molinillo,43,25,18
37,Salamanca,196,Monforte de la Sierra,59,29,30
37,Salamanca,197,Monleón,94,56,38
37,Salamanca,198,Monleras,228,113,115
37,Salamanca,199,Monsagro,135,75,60
37,Salamanca,200,Montejo,213,118,95
37,Salamanca,201,Montemayor del Río,271,144,127
37,Salamanca,202,Monterrubio de Armuña,1335,692,643
37,Salamanca,203,Monterrubio de la Sierra,142,79,63
37,Salamanca,204,Morasverdes,232,120,112
37,Salamanca,205,Morille,224,120,104
37,Salamanca,206,Moríñigo,89,47,42
37,Salamanca,207,Moriscos,523,285,238
37,Salamanca,208,Moronta,76,48,28
37,Salamanca,209,Mozárbez,510,270,240
37,Salamanca,211,Narros de Matalayegua,215,119,96
37,Salamanca,213,Nava de Béjar,82,49,33
37,Salamanca,214,Nava de Francia,125,68,57
37,Salamanca,215,Nava de Sotrobal,164,96,68
37,Salamanca,212,Navacarros,129,69,60
37,Salamanca,216,Navales,315,170,145
37,Salamanca,217,Navalmoral de Béjar,57,28,29
37,Salamanca,218,Navamorales,42,27,15
37,Salamanca,219,Navarredonda de la Rinconada,163,85,78
37,Salamanca,221,Navasfrías,395,213,182
37,Salamanca,222,Negrilla de Palencia,80,44,36
37,Salamanca,223,Olmedo de Camaces,100,55,45
37,Salamanca,224,"Orbada, La",184,95,89
37,Salamanca,225,Pajares de la Laguna,104,57,47
37,Salamanca,226,Palacios del Arzobispo,159,81,78
37,Salamanca,228,Palaciosrubios,322,169,153
37,Salamanca,229,Palencia de Negrilla,147,89,58
37,Salamanca,230,Parada de Arriba,262,135,127
37,Salamanca,231,Parada de Rubiales,258,138,120
37,Salamanca,232,Paradinas de San Juan,395,235,160
37,Salamanca,233,Pastores,52,30,22
37,Salamanca,234,"Payo, El",305,150,155
37,Salamanca,235,Pedraza de Alba,218,114,104
37,Salamanca,236,Pedrosillo de Alba,124,71,53
37,Salamanca,237,Pedrosillo de los Aires,322,189,133
37,Salamanca,238,Pedrosillo el Ralo,127,64,63
37,Salamanca,239,"Pedroso de la Armuña, El",211,108,103
37,Salamanca,240,Pelabravo,1284,684,600
37,Salamanca,241,Pelarrodríguez,166,98,68
37,Salamanca,242,Pelayos,76,46,30
37,Salamanca,243,"Peña, La",80,42,38
37,Salamanca,244,Peñacaballera,142,70,72
37,Salamanca,245,Peñaparda,326,165,161
37,Salamanca,246,Peñaranda de Bracamonte,6099,2998,3101
37,Salamanca,247,Peñarandilla,179,99,80
37,Salamanca,248,Peralejos de Abajo,170,88,82
37,Salamanca,249,Peralejos de Arriba,36,24,12
37,Salamanca,250,Pereña de la Ribera,318,178,140
37,Salamanca,251,Peromingo,121,57,64
37,Salamanca,252,Pinedas,104,62,42
37,Salamanca,253,"Pino de Tormes, El",155,86,69
37,Salamanca,254,Pitiegua,183,104,79
37,Salamanca,255,Pizarral,49,31,18
37,Salamanca,256,Poveda de las Cintas,205,117,88
37,Salamanca,257,Pozos de Hinojo,57,31,26
37,Salamanca,258,Puebla de Azaba,150,83,67
37,Salamanca,259,Puebla de San Medel,38,22,16
37,Salamanca,260,Puebla de Yeltes,148,80,68
37,Salamanca,261,Puente del Congosto,213,123,90
37,Salamanca,262,Puertas,68,40,28
37,Salamanca,263,Puerto de Béjar,359,171,188
37,Salamanca,264,Puerto Seguro,61,27,34
37,Salamanca,265,Rágama,209,102,107
37,Salamanca,266,"Redonda, La",65,37,28
37,Salamanca,267,Retortillo,180,92,88
37,Salamanca,268,"Rinconada de la Sierra, La",103,62,41
37,Salamanca,269,Robleda,458,256,202
37,Salamanca,270,Robliza de Cojos,199,107,92
37,Salamanca,271,Rollán,346,186,160
37,Salamanca,272,Saelices el Chico,171,98,73
37,Salamanca,273,"Sagrada, La",88,49,39
37,Salamanca,303,"Sahugo, El",176,96,80
37,Salamanca,274,Salamanca,142412,64452,77960
37,Salamanca,275,Saldeana,102,60,42
37,Salamanca,276,Salmoral,116,68,48
37,Salamanca,277,Salvatierra de Tormes,76,38,38
37,Salamanca,278,San Cristóbal de la Cuesta,1069,558,511
37,Salamanca,284,San Esteban de la Sierra,367,204,163
37,Salamanca,285,San Felices de los Gallegos,355,191,164
37,Salamanca,286,San Martín del Castañar,251,136,115
37,Salamanca,287,San Miguel de Valero,332,172,160
37,Salamanca,36,San Miguel del Robledo,51,29,22
37,Salamanca,288,San Morales,345,189,156
37,Salamanca,289,San Muñoz,210,106,104
37,Salamanca,291,San Pedro de Rozados,277,156,121
37,Salamanca,290,San Pedro del Valle,138,80,58
37,Salamanca,292,San Pelayo de Guareña,98,57,41
37,Salamanca,280,Sanchón de la Ribera,77,39,38
37,Salamanca,281,Sanchón de la Sagrada,37,21,16
37,Salamanca,282,Sanchotello,230,114,116
37,Salamanca,279,Sancti-Spíritus,741,401,340
37,Salamanca,283,Sando,120,69,51
37,Salamanca,293,Santa María de Sando,99,51,48
37,Salamanca,294,Santa Marta de Tormes,14661,7138,7523
37,Salamanca,296,Santiago de la Puebla,297,155,142
37,Salamanca,297,Santibáñez de Béjar,461,229,232
37,Salamanca,298,Santibáñez de la Sierra,171,97,74
37,Salamanca,299,Santiz,254,139,115
37,Salamanca,300,"Santos, Los",601,305,296
37,Salamanca,301,Sardón de los Frailes,101,56,45
37,Salamanca,302,Saucelle,266,134,132
37,Salamanca,304,Sepulcro-Hilario,163,88,75
37,Salamanca,305,Sequeros,235,112,123
37,Salamanca,306,Serradilla del Arroyo,251,137,114
37,Salamanca,307,Serradilla del Llano,144,78,66
37,Salamanca,309,"Sierpe, La",41,21,20
37,Salamanca,310,Sieteiglesias de Tormes,184,87,97
37,Salamanca,311,Sobradillo,193,100,93
37,Salamanca,312,Sorihuela,259,131,128
37,Salamanca,313,Sotoserrano,543,291,252
37,Salamanca,314,Tabera de Abajo,105,58,47
37,Salamanca,315,"Tala, La",78,44,34
37,Salamanca,316,Tamames,811,408,403
37,Salamanca,317,Tarazona de Guareña,275,150,125
37,Salamanca,318,Tardáguila,193,118,75
37,Salamanca,319,"Tejado, El",84,46,38
37,Salamanca,320,Tejeda y Segoyuela,92,52,40
37,Salamanca,321,Tenebrón,135,74,61
37,Salamanca,322,Terradillos,3094,1539,1555
37,Salamanca,323,Topas,512,268,244
37,Salamanca,324,Tordillos,332,180,152
37,Salamanca,325,"Tornadizo, El",91,52,39
37,Salamanca,327,Torresmenudas,192,105,87
37,Salamanca,328,Trabanca,175,86,89
37,Salamanca,329,Tremedal de Tormes,37,19,18
37,Salamanca,330,Valdecarros,334,171,163
37,Salamanca,331,Valdefuentes de Sangusín,192,107,85
37,Salamanca,332,Valdehijaderos,79,45,34
37,Salamanca,333,Valdelacasa,206,116,90
37,Salamanca,334,Valdelageve,66,36,30
37,Salamanca,335,Valdelosa,404,205,199
37,Salamanca,336,Valdemierque,60,38,22
37,Salamanca,337,Valderrodrigo,134,71,63
37,Salamanca,338,Valdunciel,110,57,53
37,Salamanca,339,Valero,297,167,130
37,Salamanca,343,Vallejera de Riofrío,69,38,31
37,Salamanca,340,Valsalabroso,125,69,56
37,Salamanca,341,Valverde de Valdelacasa,61,31,30
37,Salamanca,342,Valverdón,278,143,135
37,Salamanca,344,Vecinos,237,117,120
37,Salamanca,345,Vega de Tirados,160,81,79
37,Salamanca,346,"Veguillas, Las",278,137,141
37,Salamanca,347,"Vellés, La",505,273,232
37,Salamanca,348,Ventosa del Río Almar,98,57,41
37,Salamanca,349,"Vídola, La",104,52,52
37,Salamanca,351,Villaflores,258,130,128
37,Salamanca,352,Villagonzalo de Tormes,228,138,90
37,Salamanca,353,Villalba de los Llanos,120,71,49
37,Salamanca,354,Villamayor,7402,3678,3724
37,Salamanca,355,Villanueva del Conde,180,91,89
37,Salamanca,356,Villar de Argañán,99,54,45
37,Salamanca,357,Villar de Ciervo,263,140,123
37,Salamanca,358,Villar de Gallimazo,201,137,64
37,Salamanca,359,Villar de la Yegua,160,86,74
37,Salamanca,360,Villar de Peralonso,207,110,97
37,Salamanca,361,Villar de Samaniego,81,44,37
37,Salamanca,362,Villares de la Reina,6494,3216,3278
37,Salamanca,363,Villares de Yeltes,104,48,56
37,Salamanca,364,Villarino de los Aires,764,403,361
37,Salamanca,365,Villarmayor,166,94,72
37,Salamanca,366,Villarmuerto,39,27,12
37,Salamanca,367,Villasbuenas,179,99,80
37,Salamanca,368,Villasdardo,23,8,15
37,Salamanca,369,Villaseco de los Gamitos,129,74,55
37,Salamanca,370,Villaseco de los Reyes,313,183,130
37,Salamanca,371,Villasrubias,252,134,118
37,Salamanca,372,Villaverde de Guareña,139,76,63
37,Salamanca,373,Villavieja de Yeltes,714,374,340
37,Salamanca,374,Villoria,1325,670,655
37,Salamanca,375,Villoruela,754,375,379
37,Salamanca,350,Vilvestre,405,201,204
37,Salamanca,376,Vitigudino,2380,1139,1241
37,Salamanca,377,Yecla de Yeltes,224,114,110
37,Salamanca,378,Zamarra,79,45,34
37,Salamanca,379,Zamayón,197,117,80
37,Salamanca,380,Zarapicos,60,34,26
37,Salamanca,381,"Zarza de Pumareda, La",139,86,53
37,Salamanca,382,Zorita de la Frontera,159,80,79
38,Santa Cruz de Tenerife,1,Adeje,49270,24793,24477
38,Santa Cruz de Tenerife,2,Agulo,1085,545,540
38,Santa Cruz de Tenerife,3,Alajeró,2029,1078,951
38,Santa Cruz de Tenerife,4,Arafo,5623,2823,2800
38,Santa Cruz de Tenerife,5,Arico,8754,4485,4269
38,Santa Cruz de Tenerife,6,Arona,82982,41920,41062
38,Santa Cruz de Tenerife,7,Barlovento,1897,953,944
38,Santa Cruz de Tenerife,8,Breña Alta,7199,3517,3682
38,Santa Cruz de Tenerife,9,Breña Baja,5885,2975,2910
38,Santa Cruz de Tenerife,10,Buenavista del Norte,4753,2371,2382
38,Santa Cruz de Tenerife,11,Candelaria,28485,13774,14711
38,Santa Cruz de Tenerife,12,Fasnia,2849,1498,1351
38,Santa Cruz de Tenerife,13,Frontera,4329,2168,2161
38,Santa Cruz de Tenerife,14,Fuencaliente de la Palma,1800,907,893
38,Santa Cruz de Tenerife,15,Garachico,4920,2458,2462
38,Santa Cruz de Tenerife,16,Garafía,1830,943,887
38,Santa Cruz de Tenerife,17,Granadilla de Abona,52447,26168,26279
38,Santa Cruz de Tenerife,18,"Guancha, La",5561,2707,2854
38,Santa Cruz de Tenerife,19,Guía de Isora,21711,10763,10948
38,Santa Cruz de Tenerife,20,Güímar,21224,10457,10767
38,Santa Cruz de Tenerife,21,Hermigua,1795,931,864
38,Santa Cruz de Tenerife,22,Icod de los Vinos,23496,11542,11954
38,Santa Cruz de Tenerife,24,"Llanos de Aridane, Los",20551,9924,10627
38,Santa Cruz de Tenerife,25,"Matanza de Acentejo, La",9054,4539,4515
38,Santa Cruz de Tenerife,26,"Orotava, La",42434,20776,21658
38,Santa Cruz de Tenerife,27,"Paso, El",7901,3949,3952
38,Santa Cruz de Tenerife,901,"Pinar de El Hierro, El",1971,1031,940
38,Santa Cruz de Tenerife,28,Puerto de la Cruz,30349,14801,15548
38,Santa Cruz de Tenerife,29,Puntagorda,2293,1160,1133
38,Santa Cruz de Tenerife,30,Puntallana,2547,1266,1281
38,Santa Cruz de Tenerife,31,"Realejos, Los",37076,18168,18908
38,Santa Cruz de Tenerife,32,"Rosario, El",17750,9022,8728
38,Santa Cruz de Tenerife,33,San Andrés y Sauces,4170,2096,2074
38,Santa Cruz de Tenerife,23,San Cristóbal de La Laguna,157815,76000,81815
38,Santa Cruz de Tenerife,34,San Juan de la Rambla,4864,2430,2434
38,Santa Cruz de Tenerife,35,San Miguel de Abona,21915,11074,10841
38,Santa Cruz de Tenerife,36,San Sebastián de la Gomera,9342,4663,4679
38,Santa Cruz de Tenerife,37,Santa Cruz de la Palma,15361,7376,7985
38,Santa Cruz de Tenerife,38,Santa Cruz de Tenerife,208688,99312,109376
38,Santa Cruz de Tenerife,39,Santa Úrsula,15114,7501,7613
38,Santa Cruz de Tenerife,40,Santiago del Teide,11162,5537,5625
38,Santa Cruz de Tenerife,41,"Sauzal, El",9005,4485,4520
38,Santa Cruz de Tenerife,42,"Silos, Los",4644,2319,2325
38,Santa Cruz de Tenerife,43,Tacoronte,24592,12252,12340
38,Santa Cruz de Tenerife,44,"Tanque, El",2813,1377,1436
38,Santa Cruz de Tenerife,45,Tazacorte,4502,2309,2193
38,Santa Cruz de Tenerife,46,Tegueste,11359,5602,5757
38,Santa Cruz de Tenerife,47,Tijarafe,2598,1322,1276
38,Santa Cruz de Tenerife,49,Valle Gran Rey,4674,2392,2282
38,Santa Cruz de Tenerife,50,Vallehermoso,2873,1497,1376
38,Santa Cruz de Tenerife,48,Valverde,5123,2558,2565
38,Santa Cruz de Tenerife,51,"Victoria de Acentejo, La",9170,4552,4618
38,Santa Cruz de Tenerife,52,Vilaflor de Chasna,1767,897,870
38,Santa Cruz de Tenerife,53,Villa de Mazo,4905,2488,2417
40,Segovia,1,Abades,839,411,428
40,Segovia,2,Adrada de Pirón,38,21,17
40,Segovia,3,Adrados,120,68,52
40,Segovia,4,Aguilafuente,564,285,279
40,Segovia,5,Alconada de Maderuelo,24,15,9
40,Segovia,12,Aldea Real,283,153,130
40,Segovia,6,Aldealcorvo,19,11,8
40,Segovia,7,Aldealengua de Pedraza,81,49,32
40,Segovia,8,Aldealengua de Santa María,61,32,29
40,Segovia,9,Aldeanueva de la Serrezuela,41,28,13
40,Segovia,10,Aldeanueva del Codonal,114,61,53
40,Segovia,13,Aldeasoña,65,36,29
40,Segovia,14,Aldehorno,52,31,21
40,Segovia,15,Aldehuela del Codonal,23,12,11
40,Segovia,16,Aldeonte,55,32,23
40,Segovia,17,Anaya,126,61,65
40,Segovia,18,Añe,69,40,29
40,Segovia,19,Arahuetes,26,21,5
40,Segovia,20,Arcones,171,87,84
40,Segovia,21,Arevalillo de Cega,20,13,7
40,Segovia,22,Armuña,244,138,106
40,Segovia,24,Ayllón,1154,600,554
40,Segovia,25,Barbolla,141,82,59
40,Segovia,26,Basardilla,157,75,82
40,Segovia,28,Bercial,98,52,46
40,Segovia,29,Bercimuel,31,17,14
40,Segovia,30,Bernardos,489,275,214
40,Segovia,31,Bernuy de Porreros,903,467,436
40,Segovia,32,Boceguillas,682,343,339
40,Segovia,33,Brieva,94,53,41
40,Segovia,34,Caballar,72,43,29
40,Segovia,35,Cabañas de Polendos,190,99,91
40,Segovia,36,Cabezuela,643,330,313
40,Segovia,37,Calabazas de Fuentidueña,28,17,11
40,Segovia,39,Campo de San Pedro,251,141,110
40,Segovia,40,Cantalejo,3461,1720,1741
40,Segovia,41,Cantimpalos,1334,710,624
40,Segovia,161,Carabias,44,32,12
40,Segovia,43,Carbonero el Mayor,2476,1265,1211
40,Segovia,44,Carrascal del Río,146,78,68
40,Segovia,45,Casla,160,84,76
40,Segovia,46,Castillejo de Mesleón,117,64,53
40,Segovia,47,Castro de Fuentidueña,47,29,18
40,Segovia,48,Castrojimeno,31,16,15
40,Segovia,49,Castroserna de Abajo,33,19,14
40,Segovia,51,Castroserracín,39,19,20
40,Segovia,52,Cedillo de la Torre,89,45,44
40,Segovia,53,Cerezo de Abajo,122,67,55
40,Segovia,54,Cerezo de Arriba,135,73,62
40,Segovia,65,Chañe,703,363,340
40,Segovia,55,Cilleruelo de San Mamés,36,24,12
40,Segovia,56,Cobos de Fuentidueña,42,19,23
40,Segovia,57,Coca,1716,869,847
40,Segovia,58,Codorniz,326,163,163
40,Segovia,59,Collado Hermoso,130,69,61
40,Segovia,60,Condado de Castilnovo,86,45,41
40,Segovia,61,Corral de Ayllón,79,44,35
40,Segovia,902,Cozuelos de Fuentidueña,117,63,54
40,Segovia,62,Cubillo,74,47,27
40,Segovia,63,Cuéllar,9588,4820,4768
40,Segovia,905,Cuevas de Provanco,129,76,53
40,Segovia,68,Domingo García,30,19,11
40,Segovia,69,Donhierro,83,47,36
40,Segovia,70,Duruelo,184,110,74
40,Segovia,71,Encinas,40,22,18
40,Segovia,72,Encinillas,331,184,147
40,Segovia,73,Escalona del Prado,489,259,230
40,Segovia,74,Escarabajosa de Cabezas,289,152,137
40,Segovia,75,Escobar de Polendos,174,97,77
40,Segovia,76,"Espinar, El",9662,4872,4790
40,Segovia,77,Espirdo,1457,766,691
40,Segovia,78,Fresneda de Cuéllar,172,100,72
40,Segovia,79,Fresno de Cantespino,317,178,139
40,Segovia,80,Fresno de la Fuente,73,40,33
40,Segovia,81,Frumales,118,65,53
40,Segovia,82,Fuente de Santa Cruz,103,54,49
40,Segovia,83,Fuente el Olmo de Fuentidueña,180,81,99
40,Segovia,84,Fuente el Olmo de Íscar,45,26,19
40,Segovia,86,Fuentepelayo,786,415,371
40,Segovia,87,Fuentepiñel,78,45,33
40,Segovia,88,Fuenterrebollo,332,176,156
40,Segovia,89,Fuentesaúco de Fuentidueña,237,126,111
40,Segovia,91,Fuentesoto,101,60,41
40,Segovia,92,Fuentidueña,135,78,57
40,Segovia,93,Gallegos,101,54,47
40,Segovia,94,Garcillán,521,280,241
40,Segovia,95,Gomezserracín,657,340,317
40,Segovia,97,Grajera,250,145,105
40,Segovia,99,Honrubia de la Cuesta,59,35,24
40,Segovia,100,Hontalbilla,298,167,131
40,Segovia,101,Hontanares de Eresma,1558,817,741
40,Segovia,103,"Huertos, Los",176,95,81
40,Segovia,104,Ituero y Lama,424,220,204
40,Segovia,105,Juarros de Riomoros,49,30,19
40,Segovia,106,Juarros de Voltoya,193,98,95
40,Segovia,107,Labajos,102,59,43
40,Segovia,108,Laguna de Contreras,105,64,41
40,Segovia,109,Languilla,75,44,31
40,Segovia,110,Lastras de Cuéllar,322,173,149
40,Segovia,111,Lastras del Pozo,60,31,29
40,Segovia,112,"Lastrilla, La",4348,2213,2135
40,Segovia,113,"Losa, La",537,298,239
40,Segovia,115,Maderuelo,115,67,48
40,Segovia,903,Marazoleja,103,68,35
40,Segovia,118,Marazuela,53,32,21
40,Segovia,119,Martín Miguel,236,142,94
40,Segovia,120,Martín Muñoz de la Dehesa,245,129,116
40,Segovia,121,Martín Muñoz de las Posadas,261,147,114
40,Segovia,122,Marugán,730,404,326
40,Segovia,124,Mata de Cuéllar,263,139,124
40,Segovia,123,Matabuena,175,98,77
40,Segovia,125,"Matilla, La",77,46,31
40,Segovia,126,Melque de Cercos,62,35,27
40,Segovia,127,Membibre de la Hoz,39,21,18
40,Segovia,128,Migueláñez,130,70,60
40,Segovia,129,Montejo de Arévalo,171,97,74
40,Segovia,130,Montejo de la Vega de la Serrezuela,138,79,59
40,Segovia,131,Monterrubio,60,33,27
40,Segovia,132,Moral de Hornuez,45,28,17
40,Segovia,134,Mozoncillo,858,469,389
40,Segovia,135,Muñopedro,317,166,151
40,Segovia,136,Muñoveros,127,61,66
40,Segovia,138,Nava de la Asunción,2751,1413,1338
40,Segovia,139,Navafría,290,158,132
40,Segovia,140,Navalilla,99,51,48
40,Segovia,141,Navalmanzano,1033,544,489
40,Segovia,142,Navares de Ayuso,50,25,25
40,Segovia,143,Navares de Enmedio,91,53,38
40,Segovia,144,Navares de las Cuevas,22,16,6
40,Segovia,145,Navas de Oro,1272,646,626
40,Segovia,904,Navas de Riofrío,413,193,220
40,Segovia,146,Navas de San Antonio,356,191,165
40,Segovia,148,Nieva,255,124,131
40,Segovia,149,Olombrada,517,281,236
40,Segovia,150,Orejana,67,39,28
40,Segovia,151,Ortigosa de Pestaño,46,24,22
40,Segovia,901,Ortigosa del Monte,567,291,276
40,Segovia,152,Otero de Herreros,962,482,480
40,Segovia,154,Pajarejos,24,12,12
40,Segovia,155,Palazuelos de Eresma,5743,2981,2762
40,Segovia,156,Pedraza,341,189,152
40,Segovia,157,Pelayos del Arroyo,46,25,21
40,Segovia,158,Perosillo,16,12,4
40,Segovia,159,Pinarejos,173,100,73
40,Segovia,160,Pinarnegrillo,106,60,46
40,Segovia,162,Prádena,501,263,238
40,Segovia,163,Puebla de Pedraza,48,27,21
40,Segovia,164,Rapariegos,198,102,96
40,Segovia,181,Real Sitio de San Ildefonso,5188,2536,2652
40,Segovia,165,Rebollo,75,39,36
40,Segovia,166,Remondo,298,148,150
40,Segovia,168,Riaguas de San Bartolomé,29,20,9
40,Segovia,170,Riaza,2128,1129,999
40,Segovia,171,Ribota,48,34,14
40,Segovia,172,Riofrío de Riaza,37,23,14
40,Segovia,173,Roda de Eresma,225,124,101
40,Segovia,174,Sacramenia,358,174,184
40,Segovia,176,Samboal,464,248,216
40,Segovia,177,San Cristóbal de Cuéllar,152,86,66
40,Segovia,178,San Cristóbal de la Vega,88,47,41
40,Segovia,906,San Cristóbal de Segovia,3110,1561,1549
40,Segovia,182,San Martín y Mudrián,235,115,120
40,Segovia,183,San Miguel de Bernuy,135,68,67
40,Segovia,184,San Pedro de Gaíllos,282,153,129
40,Segovia,179,Sanchonuño,998,494,504
40,Segovia,180,Sangarcía,303,171,132
40,Segovia,185,Santa María la Real de Nieva,883,494,389
40,Segovia,186,Santa Marta del Cerro,39,20,19
40,Segovia,188,Santiuste de Pedraza,80,55,25
40,Segovia,189,Santiuste de San Juan Bautista,539,292,247
40,Segovia,190,Santo Domingo de Pirón,47,26,21
40,Segovia,191,Santo Tomé del Puerto,252,139,113
40,Segovia,192,Sauquillo de Cabezas,139,77,62
40,Segovia,193,Sebúlcor,265,140,125
40,Segovia,194,Segovia,50802,23726,27076
40,Segovia,195,Sepúlveda,1001,506,495
40,Segovia,196,Sequera de Fresno,43,28,15
40,Segovia,198,Sotillo,29,16,13
40,Segovia,199,Sotosalbos,133,74,59
40,Segovia,200,Tabanera la Luenga,52,27,25
40,Segovia,201,Tolocirio,42,19,23
40,Segovia,206,Torre Val de San Pedro,193,100,93
40,Segovia,202,Torreadrada,52,28,24
40,Segovia,203,Torrecaballeros,1410,735,675
40,Segovia,204,Torrecilla del Pinar,179,96,83
40,Segovia,205,Torreiglesias,263,133,130
40,Segovia,207,Trescasas,1090,561,529
40,Segovia,208,Turégano,978,504,474
40,Segovia,210,Urueñas,104,69,35
40,Segovia,211,Valdeprados,64,36,28
40,Segovia,212,Valdevacas de Montejo,31,16,15
40,Segovia,213,Valdevacas y Guijar,93,53,40
40,Segovia,218,Valle de Tabladillo,76,45,31
40,Segovia,219,Vallelado,721,379,342
40,Segovia,220,Valleruela de Pedraza,79,37,42
40,Segovia,221,Valleruela de Sepúlveda,53,25,28
40,Segovia,214,Valseca,223,122,101
40,Segovia,215,Valtiendas,82,51,31
40,Segovia,216,Valverde del Majano,1107,560,547
40,Segovia,222,Veganzones,212,113,99
40,Segovia,223,Vegas de Matute,325,187,138
40,Segovia,224,Ventosilla y Tejadilla,18,12,6
40,Segovia,225,Villacastín,1524,784,740
40,Segovia,228,Villaverde de Íscar,577,304,273
40,Segovia,229,Villaverde de Montejo,28,17,11
40,Segovia,230,Villeguillo,114,65,49
40,Segovia,231,Yanguas de Eresma,125,70,55
40,Segovia,233,Zarzuela del Monte,499,258,241
40,Segovia,234,Zarzuela del Pinar,413,216,197
41,Sevilla,1,Aguadulce,2043,1005,1038
41,Sevilla,2,Alanís,1689,845,844
41,Sevilla,3,Albaida del Aljarafe,3236,1594,1642
41,Sevilla,4,Alcalá de Guadaíra,75917,37690,38227
41,Sevilla,5,Alcalá del Río,12315,6265,6050
41,Sevilla,6,Alcolea del Río,3308,1654,1654
41,Sevilla,7,"Algaba, La",16491,8155,8336
41,Sevilla,8,Algámitas,1252,651,601
41,Sevilla,9,Almadén de la Plata,1326,685,641
41,Sevilla,10,Almensilla,6415,3205,3210
41,Sevilla,11,Arahal,19476,9673,9803
41,Sevilla,12,Aznalcázar,4664,2373,2291
41,Sevilla,13,Aznalcóllar,6011,3050,2961
41,Sevilla,14,Badolatosa,3112,1610,1502
41,Sevilla,15,Benacazón,7299,3671,3628
41,Sevilla,16,Bollullos de la Mitación,11136,5567,5569
41,Sevilla,17,Bormujos,22536,11168,11368
41,Sevilla,18,Brenes,12652,6270,6382
41,Sevilla,19,Burguillos,6907,3500,3407
41,Sevilla,20,"Cabezas de San Juan, Las",16386,8170,8216
41,Sevilla,21,Camas,27443,13432,14011
41,Sevilla,22,"Campana, La",5177,2584,2593
41,Sevilla,23,Cantillana,10751,5419,5332
41,Sevilla,901,Cañada Rosal,3379,1668,1711
41,Sevilla,24,Carmona,29279,14757,14522
41,Sevilla,25,Carrión de los Céspedes,2562,1254,1308
41,Sevilla,26,Casariche,5332,2732,2600
41,Sevilla,27,Castilblanco de los Arroyos,5027,2536,2491
41,Sevilla,28,Castilleja de Guzmán,2866,1470,1396
41,Sevilla,29,Castilleja de la Cuesta,17230,8355,8875
41,Sevilla,30,Castilleja del Campo,624,310,314
41,Sevilla,31,"Castillo de las Guardas, El",1529,805,724
41,Sevilla,32,Cazalla de la Sierra,4700,2320,2380
41,Sevilla,33,Constantina,5779,2886,2893
41,Sevilla,34,Coria del Río,30714,15255,15459
41,Sevilla,35,Coripe,1220,590,630
41,Sevilla,36,"Coronil, El",4720,2373,2347
41,Sevilla,37,"Corrales, Los",3984,2031,1953
41,Sevilla,903,"Cuervo de Sevilla, El",8623,4349,4274
41,Sevilla,38,Dos Hermanas,137561,67448,70113
41,Sevilla,39,Écija,39743,19581,20162
41,Sevilla,40,Espartinas,16401,8262,8139
41,Sevilla,41,Estepa,12390,6165,6225
41,Sevilla,42,Fuentes de Andalucía,7173,3569,3604
41,Sevilla,43,"Garrobo, El",821,419,402
41,Sevilla,44,Gelves,10317,5116,5201
41,Sevilla,45,Gerena,7774,3878,3896
41,Sevilla,46,Gilena,3702,1871,1831
41,Sevilla,47,Gines,13507,6651,6856
41,Sevilla,48,Guadalcanal,2589,1297,1292
41,Sevilla,49,Guillena,13279,6704,6575
41,Sevilla,50,Herrera,6503,3238,3265
41,Sevilla,51,Huévar del Aljarafe,3209,1655,1554
41,Sevilla,902,Isla Mayor,5767,2877,2890
41,Sevilla,52,Lantejuela,3865,1972,1893
41,Sevilla,53,Lebrija,27665,13815,13850
41,Sevilla,54,Lora de Estepa,883,460,423
41,Sevilla,55,Lora del Río,18417,9064,9353
41,Sevilla,56,"Luisiana, La",4588,2314,2274
41,Sevilla,57,"Madroño, El",290,148,142
41,Sevilla,58,Mairena del Alcor,23938,11979,11959
41,Sevilla,59,Mairena del Aljarafe,47161,22853,24308
41,Sevilla,60,Marchena,19264,9561,9703
41,Sevilla,61,Marinaleda,2579,1313,1266
41,Sevilla,62,Martín de la Jara,2643,1368,1275
41,Sevilla,63,"Molares, Los",3559,1813,1746
41,Sevilla,64,Montellano,6976,3499,3477
41,Sevilla,65,Morón de la Frontera,27357,13458,13899
41,Sevilla,66,"Navas de la Concepción, Las",1552,761,791
41,Sevilla,67,Olivares,9444,4732,4712
41,Sevilla,68,Osuna,17442,8660,8782
41,Sevilla,69,"Palacios y Villafranca, Los",38662,19311,19351
41,Sevilla,904,"Palmar de Troya, El",2343,1168,1175
41,Sevilla,70,Palomares del Río,9083,4551,4532
41,Sevilla,71,Paradas,6832,3391,3441
41,Sevilla,72,Pedrera,5110,2527,2583
41,Sevilla,73,"Pedroso, El",2039,1007,1032
41,Sevilla,74,Peñaflor,3685,1856,1829
41,Sevilla,75,Pilas,13964,6983,6981
41,Sevilla,76,Pruna,2563,1306,1257
41,Sevilla,77,"Puebla de Cazalla, La",10903,5445,5458
41,Sevilla,78,"Puebla de los Infantes, La",2990,1468,1522
41,Sevilla,79,"Puebla del Río, La",11855,5808,6047
41,Sevilla,80,"Real de la Jara, El",1510,752,758
41,Sevilla,81,"Rinconada, La",39509,19600,19909
41,Sevilla,82,"Roda de Andalucía, La",4230,2088,2142
41,Sevilla,83,"Ronquillo, El",1474,745,729
41,Sevilla,84,"Rubio, El",3352,1669,1683
41,Sevilla,85,Salteras,5616,2723,2893
41,Sevilla,86,San Juan de Aznalfarache,22138,10658,11480
41,Sevilla,88,San Nicolás del Puerto,602,312,290
41,Sevilla,87,Sanlúcar la Mayor,14120,6955,7165
41,Sevilla,89,Santiponce,8507,4220,4287
41,Sevilla,90,"Saucejo, El",4233,2103,2130
41,Sevilla,91,Sevilla,681998,323275,358723
41,Sevilla,92,Tocina,9484,4713,4771
41,Sevilla,93,Tomares,25341,12518,12823
41,Sevilla,94,Umbrete,9253,4601,4652
41,Sevilla,95,Utrera,51402,25336,26066
41,Sevilla,96,Valencina de la Concepción,7988,3895,4093
41,Sevilla,97,Villamanrique de la Condesa,4580,2238,2342
41,Sevilla,100,Villanueva de San Juan,1037,521,516
41,Sevilla,98,Villanueva del Ariscal,6715,3262,3453
41,Sevilla,99,Villanueva del Río y Minas,4934,2479,2455
41,Sevilla,101,Villaverde del Río,7711,3909,3802
41,Sevilla,102,"Viso del Alcor, El",19161,9558,9603
42,Soria,1,Abejar,273,141,132
42,Soria,3,Adradas,60,35,25
42,Soria,4,Ágreda,2983,1535,1448
42,Soria,6,Alconaba,199,130,69
42,Soria,7,Alcubilla de Avellaneda,119,61,58
42,Soria,8,Alcubilla de las Peñas,54,34,20
42,Soria,9,Aldealafuente,80,48,32
42,Soria,10,Aldealices,22,15,7
42,Soria,11,Aldealpozo,18,8,10
42,Soria,12,Aldealseñor,27,17,10
42,Soria,13,Aldehuela de Periáñez,35,18,17
42,Soria,14,"Aldehuelas, Las",58,34,24
42,Soria,15,Alentisque,26,16,10
42,Soria,16,Aliud,22,16,6
42,Soria,17,Almajano,178,92,86
42,Soria,18,Almaluez,132,78,54
42,Soria,19,Almarza,612,355,257
42,Soria,20,Almazán,5438,2770,2668
42,Soria,21,Almazul,60,41,19
42,Soria,22,Almenar de Soria,233,144,89
42,Soria,23,Alpanseque,53,32,21
42,Soria,24,Arancón,82,53,29
42,Soria,25,Arcos de Jalón,1507,772,735
42,Soria,26,Arenillas,53,29,24
42,Soria,27,Arévalo de la Sierra,72,46,26
42,Soria,28,Ausejo de la Sierra,93,51,42
42,Soria,29,Baraona,128,73,55
42,Soria,30,Barca,110,71,39
42,Soria,31,Barcones,26,16,10
42,Soria,32,Bayubas de Abajo,139,78,61
42,Soria,33,Bayubas de Arriba,60,35,25
42,Soria,34,Beratón,36,20,16
42,Soria,35,Berlanga de Duero,870,449,421
42,Soria,36,Blacos,39,20,19
42,Soria,37,Bliecos,27,17,10
42,Soria,38,Borjabad,33,20,13
42,Soria,39,Borobia,239,133,106
42,Soria,41,Buberos,29,15,14
42,Soria,42,Buitrago,71,38,33
42,Soria,43,Burgo de Osma-Ciudad de Osma,5023,2522,2501
42,Soria,44,Cabrejas del Campo,50,30,20
42,Soria,45,Cabrejas del Pinar,325,185,140
42,Soria,46,Calatañazor,47,27,20
42,Soria,48,Caltojar,53,36,17
42,Soria,49,Candilichera,95,60,35
42,Soria,50,Cañamaque,25,18,7
42,Soria,51,Carabantes,13,7,6
42,Soria,52,Caracena,14,10,4
42,Soria,53,Carrascosa de Abajo,17,11,6
42,Soria,54,Carrascosa de la Sierra,18,13,5
42,Soria,55,Casarejos,154,81,73
42,Soria,56,Castilfrío de la Sierra,37,22,15
42,Soria,58,Castillejo de Robledo,108,65,43
42,Soria,57,Castilruiz,150,81,69
42,Soria,59,Centenera de Andaluz,22,11,11
42,Soria,60,Cerbón,30,21,9
42,Soria,61,Cidones,306,185,121
42,Soria,62,Cigudosa,19,12,7
42,Soria,63,Cihuela,43,28,15
42,Soria,64,Ciria,74,40,34
42,Soria,65,Cirujales del Río,20,15,5
42,Soria,68,Coscurita,68,45,23
42,Soria,69,Covaleda,1601,828,773
42,Soria,70,Cubilla,25,16,9
42,Soria,71,Cubo de la Solana,166,96,70
42,Soria,73,Cueva de Ágreda,72,45,27
42,Soria,75,Dévanos,77,44,33
42,Soria,76,Deza,194,106,88
42,Soria,78,Duruelo de la Sierra,1063,550,513
42,Soria,79,Escobosa de Almazán,20,13,7
42,Soria,80,Espeja de San Marcelino,151,89,62
42,Soria,81,Espejón,136,71,65
42,Soria,82,Estepa de San Juan,10,7,3
42,Soria,83,Frechilla de Almazán,21,11,10
42,Soria,84,Fresno de Caracena,19,13,6
42,Soria,85,Fuentearmegil,154,92,62
42,Soria,86,Fuentecambrón,33,20,13
42,Soria,87,Fuentecantos,67,34,33
42,Soria,88,Fuentelmonge,62,36,26
42,Soria,89,Fuentelsaz de Soria,63,33,30
42,Soria,90,Fuentepinilla,81,51,30
42,Soria,92,Fuentes de Magaña,54,33,21
42,Soria,93,Fuentestrún,39,26,13
42,Soria,94,Garray,759,406,353
42,Soria,95,Golmayo,2893,1503,1390
42,Soria,96,Gómara,291,157,134
42,Soria,97,Gormaz,25,18,7
42,Soria,98,Herrera de Soria,11,8,3
42,Soria,100,Hinojosa del Campo,26,18,8
42,Soria,103,Langa de Duero,706,378,328
42,Soria,105,Liceras,48,27,21
42,Soria,106,"Losilla, La",13,9,4
42,Soria,107,Magaña,66,38,28
42,Soria,108,Maján,8,5,3
42,Soria,110,Matalebreras,66,45,21
42,Soria,111,Matamala de Almazán,269,148,121
42,Soria,113,Medinaceli,658,336,322
42,Soria,115,Miño de Medinaceli,83,50,33
42,Soria,116,Miño de San Esteban,44,29,15
42,Soria,117,Molinos de Duero,169,95,74
42,Soria,118,Momblona,18,15,3
42,Soria,119,Monteagudo de las Vicarías,186,92,94
42,Soria,120,Montejo de Tiermes,141,90,51
42,Soria,121,Montenegro de Cameros,46,31,15
42,Soria,123,Morón de Almazán,198,106,92
42,Soria,124,Muriel de la Fuente,57,38,19
42,Soria,125,Muriel Viejo,78,52,26
42,Soria,127,Nafría de Ucero,31,18,13
42,Soria,128,Narros,49,30,19
42,Soria,129,Navaleno,745,395,350
42,Soria,130,Nepas,51,35,16
42,Soria,131,Nolay,57,33,24
42,Soria,132,Noviercas,156,88,68
42,Soria,134,Ólvega,3673,1877,1796
42,Soria,135,Oncala,65,44,21
42,Soria,139,Pinilla del Campo,19,11,8
42,Soria,140,Portillo de Soria,13,9,4
42,Soria,141,"Póveda de Soria, La",114,67,47
42,Soria,142,Pozalmuro,52,27,25
42,Soria,144,Quintana Redonda,503,282,221
42,Soria,145,Quintanas de Gormaz,137,84,53
42,Soria,148,Quiñonería,10,5,5
42,Soria,149,"Rábanos, Los",458,252,206
42,Soria,151,Rebollar,38,20,18
42,Soria,152,Recuerda,67,42,25
42,Soria,153,Rello,14,8,6
42,Soria,154,Renieblas,109,71,38
42,Soria,155,Retortillo de Soria,152,87,65
42,Soria,156,Reznos,25,15,10
42,Soria,157,"Riba de Escalote, La",9,7,2
42,Soria,158,Rioseco de Soria,129,79,50
42,Soria,159,Rollamienta,45,30,15
42,Soria,160,"Royo, El",250,139,111
42,Soria,161,Salduero,145,78,67
42,Soria,162,San Esteban de Gormaz,2910,1531,1379
42,Soria,163,San Felices,61,38,23
42,Soria,164,San Leonardo de Yagüe,2037,1038,999
42,Soria,165,San Pedro Manrique,643,360,283
42,Soria,166,Santa Cruz de Yanguas,57,33,24
42,Soria,167,Santa María de Huerta,250,140,110
42,Soria,168,Santa María de las Hoyas,96,56,40
42,Soria,171,Serón de Nágima,117,66,51
42,Soria,172,Soliedra,31,17,14
42,Soria,173,Soria,39450,18624,20826
42,Soria,174,Sotillo del Rincón,189,106,83
42,Soria,175,Suellacabras,27,13,14
42,Soria,176,Tajahuerce,24,13,11
42,Soria,177,Tajueco,58,35,23
42,Soria,178,Talveila,109,66,43
42,Soria,181,Tardelcuende,432,229,203
42,Soria,182,Taroda,46,26,20
42,Soria,183,Tejado,91,55,36
42,Soria,184,Torlengua,49,30,19
42,Soria,185,Torreblacos,26,13,13
42,Soria,187,Torrubia de Soria,60,41,19
42,Soria,188,Trévago,60,29,31
42,Soria,189,Ucero,85,48,37
42,Soria,190,Vadillo,81,43,38
42,Soria,191,Valdeavellano de Tera,207,109,98
42,Soria,192,Valdegeña,39,29,10
42,Soria,193,Valdelagua del Cerro,13,8,5
42,Soria,194,Valdemaluque,148,71,77
42,Soria,195,Valdenebro,90,53,37
42,Soria,196,Valdeprado,9,4,5
42,Soria,197,Valderrodilla,65,35,30
42,Soria,198,Valtajeros,22,13,9
42,Soria,200,Velamazán,66,45,21
42,Soria,201,Velilla de la Sierra,28,17,11
42,Soria,202,Velilla de los Ajos,18,11,7
42,Soria,204,Viana de Duero,54,38,16
42,Soria,205,Villaciervos,78,47,31
42,Soria,206,Villanueva de Gormaz,8,6,2
42,Soria,207,Villar del Ala,48,26,22
42,Soria,208,Villar del Campo,26,16,10
42,Soria,209,Villar del Río,161,97,64
42,Soria,211,"Villares de Soria, Los",78,45,33
42,Soria,212,Villasayas,65,44,21
42,Soria,213,Villaseca de Arciel,24,15,9
42,Soria,215,Vinuesa,840,441,399
42,Soria,216,Vizmanos,26,17,9
42,Soria,217,Vozmediano,35,23,12
42,Soria,218,Yanguas,106,66,40
42,Soria,219,Yelo,44,28,16
43,Tarragona,1,Aiguamúrcia,961,497,464
43,Tarragona,2,Albinyana,2581,1324,1257
43,Tarragona,3,"Albiol, L'",528,282,246
43,Tarragona,4,Alcanar,9612,4852,4760
43,Tarragona,5,Alcover,5290,2620,2670
43,Tarragona,904,"Aldea, L'",4332,2351,1981
43,Tarragona,6,Aldover,862,442,420
43,Tarragona,7,"Aleixar, L'",924,477,447
43,Tarragona,8,Alfara de Carles,359,198,161
43,Tarragona,9,Alforja,1928,978,950
43,Tarragona,10,Alió,496,247,249
43,Tarragona,11,Almoster,1334,666,668
43,Tarragona,12,Altafulla,5609,2729,2880
43,Tarragona,13,"Ametlla de Mar, L'",7209,3655,3554
43,Tarragona,906,"Ampolla, L'",3563,1828,1735
43,Tarragona,14,Amposta,21807,11090,10717
43,Tarragona,16,"Arboç, L'",5604,2852,2752
43,Tarragona,15,Arbolí,122,74,48
43,Tarragona,17,"Argentera, L'",126,72,54
43,Tarragona,18,Arnes,448,222,226
43,Tarragona,19,Ascó,1601,828,773
43,Tarragona,20,Banyeres del Penedès,3271,1643,1628
43,Tarragona,21,Barberà de la Conca,486,267,219
43,Tarragona,22,Batea,1863,925,938
43,Tarragona,23,Bellmunt del Priorat,272,136,136
43,Tarragona,24,Bellvei,2346,1189,1157
43,Tarragona,25,Benifallet,739,360,379
43,Tarragona,26,Benissanet,1169,641,528
43,Tarragona,27,"Bisbal de Falset, La",219,125,94
43,Tarragona,28,"Bisbal del Penedès, La",4062,2139,1923
43,Tarragona,29,Blancafort,394,205,189
43,Tarragona,30,Bonastre,742,387,355
43,Tarragona,31,"Borges del Camp, Les",2148,1104,1044
43,Tarragona,32,Bot,566,290,276
43,Tarragona,33,Botarell,1102,567,535
43,Tarragona,34,Bràfim,687,344,343
43,Tarragona,35,Cabacés,304,161,143
43,Tarragona,36,Cabra del Camp,1254,664,590
43,Tarragona,37,Calafell,29102,14601,14501
43,Tarragona,903,Camarles,3309,1680,1629
43,Tarragona,38,Cambrils,35675,17472,18203
43,Tarragona,907,"Canonja, La",5873,2871,3002
43,Tarragona,39,Capafonts,121,68,53
43,Tarragona,40,Capçanes,407,208,199
43,Tarragona,41,Caseres,233,116,117
43,Tarragona,42,Castellvell del Camp,2946,1474,1472
43,Tarragona,43,"Catllar, El",4921,2568,2353
43,Tarragona,45,Colldejou,172,97,75
43,Tarragona,46,Conesa,109,53,56
43,Tarragona,47,Constantí,6685,3427,3258
43,Tarragona,48,Corbera d'Ebre,993,530,463
43,Tarragona,49,Cornudella de Montsant,978,527,451
43,Tarragona,50,Creixell,3981,2004,1977
43,Tarragona,51,Cunit,14622,7169,7453
43,Tarragona,901,Deltebre,11656,5882,5774
43,Tarragona,53,Duesaigües,232,128,104
43,Tarragona,54,"Espluga de Francolí, L'",3698,1807,1891
43,Tarragona,55,Falset,2740,1380,1360
43,Tarragona,56,"Fatarella, La",891,440,451
43,Tarragona,57,"Febró, La",39,24,15
43,Tarragona,58,"Figuera, La",123,71,52
43,Tarragona,59,Figuerola del Camp,332,168,164
43,Tarragona,60,Flix,3426,1722,1704
43,Tarragona,61,Forès,48,28,20
43,Tarragona,62,Freginals,388,213,175
43,Tarragona,63,"Galera, La",700,361,339
43,Tarragona,64,Gandesa,3100,1577,1523
43,Tarragona,65,Garcia,527,263,264
43,Tarragona,66,"Garidells, Els",196,98,98
43,Tarragona,67,Ginestar,790,423,367
43,Tarragona,68,Godall,609,297,312
43,Tarragona,69,Gratallops,236,130,106
43,Tarragona,70,"Guiamets, Els",279,140,139
43,Tarragona,71,Horta de Sant Joan,1154,595,559
43,Tarragona,72,"Lloar, El",104,53,51
43,Tarragona,73,Llorac,96,52,44
43,Tarragona,74,Llorenç del Penedès,2393,1177,1216
43,Tarragona,76,Marçà,593,314,279
43,Tarragona,75,Margalef,107,65,42
43,Tarragona,77,Mas de Barberans,556,274,282
43,Tarragona,78,Masdenverge,1129,587,542
43,Tarragona,79,Masllorenç,547,299,248
43,Tarragona,80,"Masó, La",285,149,136
43,Tarragona,81,Maspujols,859,443,416
43,Tarragona,82,"Masroig, El",479,263,216
43,Tarragona,83,"Milà, El",189,89,100
43,Tarragona,84,Miravet,682,357,325
43,Tarragona,85,"Molar, El",296,153,143
43,Tarragona,86,Montblanc,7410,3774,3636
43,Tarragona,88,Montbrió del Camp,3073,1588,1485
43,Tarragona,89,Montferri,419,227,192
43,Tarragona,90,"Montmell, El",1863,997,866
43,Tarragona,91,Mont-ral,173,97,76
43,Tarragona,92,Mont-roig del Camp,13101,6734,6367
43,Tarragona,93,Móra d'Ebre,5585,2806,2779
43,Tarragona,94,Móra la Nova,3198,1598,1600
43,Tarragona,95,"Morell, El",3803,1956,1847
43,Tarragona,96,"Morera de Montsant, La",160,87,73
43,Tarragona,97,"Nou de Gaià, La",636,315,321
43,Tarragona,98,Nulles,541,288,253
43,Tarragona,100,"Pallaresos, Els",4930,2477,2453
43,Tarragona,99,"Palma d'Ebre, La",341,173,168
43,Tarragona,101,Passanant i Belltall,170,103,67
43,Tarragona,102,Paüls,566,287,279
43,Tarragona,103,Perafort,1292,666,626
43,Tarragona,104,"Perelló, El",2885,1483,1402
43,Tarragona,105,"Piles, Les",224,123,101
43,Tarragona,106,"Pinell de Brai, El",1000,498,502
43,Tarragona,107,Pira,489,261,228
43,Tarragona,108,"Pla de Santa Maria, El",2340,1207,1133
43,Tarragona,109,"Pobla de Mafumet, La",4052,2040,2012
43,Tarragona,110,"Pobla de Massaluca, La",340,193,147
43,Tarragona,111,"Pobla de Montornès, La",3101,1594,1507
43,Tarragona,112,Poboleda,327,162,165
43,Tarragona,113,"Pont d'Armentera, El",492,251,241
43,Tarragona,141,Pontils,133,75,58
43,Tarragona,114,Porrera,429,223,206
43,Tarragona,115,Pradell de la Teixeta,172,85,87
43,Tarragona,116,Prades,625,332,293
43,Tarragona,117,Prat de Comte,186,98,88
43,Tarragona,118,Pratdip,693,367,326
43,Tarragona,119,Puigpelat,1199,628,571
43,Tarragona,120,Querol,572,325,247
43,Tarragona,121,Rasquera,822,402,420
43,Tarragona,122,Renau,152,82,70
43,Tarragona,123,Reus,106741,51724,55017
43,Tarragona,124,"Riba, La",552,301,251
43,Tarragona,125,Riba-roja d'Ebre,1131,603,528
43,Tarragona,126,"Riera de Gaià, La",1752,878,874
43,Tarragona,127,Riudecanyes,1279,668,611
43,Tarragona,128,Riudecols,1198,620,578
43,Tarragona,129,Riudoms,6721,3401,3320
43,Tarragona,130,Rocafort de Queralt,241,128,113
43,Tarragona,131,Roda de Berà,7591,3869,3722
43,Tarragona,132,Rodonyà,506,276,230
43,Tarragona,133,Roquetes,8193,4199,3994
43,Tarragona,134,"Rourell, El",395,212,183
43,Tarragona,135,Salomó,543,281,262
43,Tarragona,905,Salou,29028,14868,14160
43,Tarragona,136,Sant Carles de la Ràpita,14767,7196,7571
43,Tarragona,137,Sant Jaume dels Domenys,2695,1380,1315
43,Tarragona,902,Sant Jaume d'Enveja,3669,1852,1817
43,Tarragona,138,Santa Bàrbara,3791,1933,1858
43,Tarragona,139,Santa Coloma de Queralt,2755,1383,1372
43,Tarragona,140,Santa Oliva,3560,1803,1757
43,Tarragona,142,Sarral,1578,801,777
43,Tarragona,143,Savallà del Comtat,52,27,25
43,Tarragona,144,"Secuita, La",1765,883,882
43,Tarragona,145,"Selva del Camp, La",5696,2847,2849
43,Tarragona,146,Senan,44,29,15
43,Tarragona,44,"Sénia, La",5475,2747,2728
43,Tarragona,147,Solivella,628,328,300
43,Tarragona,148,Tarragona,134883,65555,69328
43,Tarragona,149,Tivenys,923,468,455
43,Tarragona,150,Tivissa,1643,837,806
43,Tarragona,151,"Torre de Fontaubella, La",125,65,60
43,Tarragona,152,"Torre de l'Espanyol, La",598,309,289
43,Tarragona,153,Torredembarra,17256,8437,8819
43,Tarragona,154,Torroja del Priorat,141,79,62
43,Tarragona,155,Tortosa,33890,16886,17004
43,Tarragona,156,Ulldecona,6241,3296,2945
43,Tarragona,157,Ulldemolins,409,222,187
43,Tarragona,158,Vallclara,88,54,34
43,Tarragona,159,Vallfogona de Riucorb,89,52,37
43,Tarragona,160,Vallmoll,1882,949,933
43,Tarragona,161,Valls,24727,12443,12284
43,Tarragona,162,Vandellòs i l'Hospitalet de l'Infant,6750,3366,3384
43,Tarragona,163,"Vendrell, El",39072,19298,19774
43,Tarragona,164,Vespella de Gaià,496,266,230
43,Tarragona,165,Vilabella,711,367,344
43,Tarragona,175,Vilalba dels Arcs,634,317,317
43,Tarragona,166,Vilallonga del Camp,2398,1214,1184
43,Tarragona,168,Vilanova de Prades,107,55,52
43,Tarragona,167,Vilanova d'Escornalbou,594,309,285
43,Tarragona,169,Vilaplana,540,286,254
43,Tarragona,170,Vila-rodona,1341,713,628
43,Tarragona,171,Vila-seca,22681,11410,11271
43,Tarragona,172,Vilaverd,453,247,206
43,Tarragona,173,"Vilella Alta, La",136,72,64
43,Tarragona,174,"Vilella Baixa, La",202,112,90
43,Tarragona,176,Vimbodí i Poblet,884,479,405
43,Tarragona,177,Vinebre,407,214,193
43,Tarragona,178,Vinyols i els Arcs,2258,1176,1082
43,Tarragona,52,Xerta,1150,570,580
44,Teruel,1,Ababuj,72,44,28
44,Teruel,2,Abejuela,56,34,22
44,Teruel,3,Aguatón,16,7,9
44,Teruel,4,Aguaviva,556,271,285
44,Teruel,5,Aguilar del Alfambra,81,44,37
44,Teruel,6,Alacón,219,113,106
44,Teruel,7,Alba,181,105,76
44,Teruel,8,Albalate del Arzobispo,1959,1006,953
44,Teruel,9,Albarracín,1008,513,495
44,Teruel,10,Albentosa,275,146,129
44,Teruel,11,Alcaine,46,29,17
44,Teruel,12,Alcalá de la Selva,383,209,174
44,Teruel,13,Alcañiz,16054,7997,8057
44,Teruel,14,Alcorisa,3252,1660,1592
44,Teruel,16,Alfambra,490,260,230
44,Teruel,17,Aliaga,323,188,135
44,Teruel,21,Allepuz,124,61,63
44,Teruel,22,Alloza,553,287,266
44,Teruel,23,Allueva,21,14,7
44,Teruel,18,Almohaja,16,11,5
44,Teruel,19,Alobras,67,46,21
44,Teruel,20,Alpeñés,20,12,8
44,Teruel,24,Anadón,33,21,12
44,Teruel,25,Andorra,7201,3617,3584
44,Teruel,26,Arcos de las Salinas,117,71,46
44,Teruel,27,Arens de Lledó,214,107,107
44,Teruel,28,Argente,208,104,104
44,Teruel,29,Ariño,665,333,332
44,Teruel,31,Azaila,105,59,46
44,Teruel,32,Bádenas,19,11,8
44,Teruel,33,Báguena,271,152,119
44,Teruel,34,Bañón,157,89,68
44,Teruel,35,Barrachina,116,63,53
44,Teruel,36,Bea,33,21,12
44,Teruel,37,Beceite,550,278,272
44,Teruel,39,Bello,230,112,118
44,Teruel,38,Belmonte de San José,136,66,70
44,Teruel,40,Berge,231,119,112
44,Teruel,41,Bezas,63,41,22
44,Teruel,42,Blancas,140,84,56
44,Teruel,43,Blesa,88,58,30
44,Teruel,44,Bordón,111,62,49
44,Teruel,45,Bronchales,435,243,192
44,Teruel,46,Bueña,51,27,24
44,Teruel,47,Burbáguena,278,163,115
44,Teruel,48,Cabra de Mora,69,43,26
44,Teruel,49,Calaceite,993,490,503
44,Teruel,50,Calamocha,4485,2234,2251
44,Teruel,51,Calanda,3755,1886,1869
44,Teruel,52,Calomarde,77,44,33
44,Teruel,53,Camañas,137,75,62
44,Teruel,54,Camarena de la Sierra,123,69,54
44,Teruel,55,Camarillas,84,50,34
44,Teruel,56,Caminreal,625,330,295
44,Teruel,59,Cantavieja,707,370,337
44,Teruel,60,Cañada de Benatanduz,35,22,13
44,Teruel,61,"Cañada de Verich, La",97,55,42
44,Teruel,62,Cañada Vellida,38,27,11
44,Teruel,63,Cañizar del Olivar,103,60,43
44,Teruel,64,Cascante del Río,66,38,28
44,Teruel,65,Castejón de Tornos,53,34,19
44,Teruel,66,Castel de Cabra,95,53,42
44,Teruel,70,"Castellar, El",55,37,18
44,Teruel,71,Castellote,677,345,332
44,Teruel,67,Castelnou,113,61,52
44,Teruel,68,Castelserás,793,420,373
44,Teruel,74,Cedrillas,634,319,315
44,Teruel,75,Celadas,362,206,156
44,Teruel,76,Cella,2611,1347,1264
44,Teruel,77,"Cerollera, La",74,48,26
44,Teruel,80,"Codoñera, La",317,165,152
44,Teruel,82,Corbalán,110,56,54
44,Teruel,84,Cortes de Aragón,62,28,34
44,Teruel,85,Cosa,50,35,15
44,Teruel,86,Cretas,563,285,278
44,Teruel,87,Crivillén,90,49,41
44,Teruel,88,"Cuba, La",42,25,17
44,Teruel,89,Cubla,60,40,20
44,Teruel,90,Cucalón,78,49,29
44,Teruel,92,"Cuervo, El",72,36,36
44,Teruel,93,Cuevas de Almudén,126,69,57
44,Teruel,94,Cuevas Labradas,133,70,63
44,Teruel,96,Ejulve,186,96,90
44,Teruel,97,Escorihuela,138,70,68
44,Teruel,99,Escucha,773,422,351
44,Teruel,100,Estercuel,205,114,91
44,Teruel,101,Ferreruela de Huerva,70,40,30
44,Teruel,102,Fonfría,30,19,11
44,Teruel,103,Formiche Alto,159,89,70
44,Teruel,105,Fórnoles,86,47,39
44,Teruel,106,Fortanete,209,121,88
44,Teruel,107,Foz-Calanda,273,139,134
44,Teruel,108,"Fresneda, La",462,251,211
44,Teruel,109,Frías de Albarracín,105,66,39
44,Teruel,110,Fuenferrada,35,24,11
44,Teruel,111,Fuentes Calientes,89,52,37
44,Teruel,112,Fuentes Claras,434,235,199
44,Teruel,113,Fuentes de Rubielos,160,86,74
44,Teruel,114,Fuentespalda,293,154,139
44,Teruel,115,Galve,150,79,71
44,Teruel,116,Gargallo,98,52,46
44,Teruel,117,Gea de Albarracín,434,242,192
44,Teruel,118,"Ginebrosa, La",200,111,89
44,Teruel,119,Griegos,140,83,57
44,Teruel,120,Guadalaviar,249,134,115
44,Teruel,121,Gúdar,73,41,32
44,Teruel,122,Híjar,1751,885,866
44,Teruel,123,Hinojosa de Jarque,106,59,47
44,Teruel,124,"Hoz de la Vieja, La",90,48,42
44,Teruel,125,Huesa del Común,71,43,28
44,Teruel,126,"Iglesuela del Cid, La",395,207,188
44,Teruel,127,Jabaloyas,65,40,25
44,Teruel,128,Jarque de la Val,56,28,28
44,Teruel,129,Jatiel,46,29,17
44,Teruel,130,Jorcas,36,20,16
44,Teruel,131,Josa,42,29,13
44,Teruel,132,Lagueruela,71,43,28
44,Teruel,133,Lanzuela,25,17,8
44,Teruel,135,Libros,102,63,39
44,Teruel,136,Lidón,53,29,24
44,Teruel,137,Linares de Mora,235,133,102
44,Teruel,141,Lledó,171,91,80
44,Teruel,138,Loscos,118,71,47
44,Teruel,142,Maicas,31,19,12
44,Teruel,143,Manzanera,533,294,239
44,Teruel,144,Martín del Río,372,177,195
44,Teruel,145,Mas de las Matas,1255,648,607
44,Teruel,146,"Mata de los Olmos, La",270,143,127
44,Teruel,147,Mazaleón,487,255,232
44,Teruel,148,Mezquita de Jarque,84,45,39
44,Teruel,149,Mirambel,111,65,46
44,Teruel,150,Miravete de la Sierra,27,20,7
44,Teruel,151,Molinos,227,121,106
44,Teruel,152,Monforte de Moyuela,75,50,25
44,Teruel,153,Monreal del Campo,2499,1245,1254
44,Teruel,154,Monroyo,312,174,138
44,Teruel,155,Montalbán,1209,616,593
44,Teruel,156,Monteagudo del Castillo,43,24,19
44,Teruel,157,Monterde de Albarracín,55,32,23
44,Teruel,158,Mora de Rubielos,1569,782,787
44,Teruel,159,Moscardón,52,28,24
44,Teruel,160,Mosqueruela,551,300,251
44,Teruel,161,Muniesa,571,311,260
44,Teruel,163,Noguera de Albarracín,138,80,58
44,Teruel,164,Nogueras,27,19,8
44,Teruel,165,Nogueruelas,205,121,84
44,Teruel,167,Obón,35,21,14
44,Teruel,168,Odón,214,106,108
44,Teruel,169,Ojos Negros,328,186,142
44,Teruel,171,Olba,266,142,124
44,Teruel,172,Oliete,330,180,150
44,Teruel,173,"Olmos, Los",120,67,53
44,Teruel,174,Orihuela del Tremedal,454,253,201
44,Teruel,175,Orrios,123,67,56
44,Teruel,176,Palomar de Arroyos,172,102,70
44,Teruel,177,Pancrudo,123,72,51
44,Teruel,178,"Parras de Castellote, Las",60,35,25
44,Teruel,179,Peñarroya de Tastavins,450,239,211
44,Teruel,180,Peracense,78,42,36
44,Teruel,181,Peralejos,85,44,41
44,Teruel,182,Perales del Alfambra,264,130,134
44,Teruel,183,Pitarque,69,35,34
44,Teruel,184,Plou,47,29,18
44,Teruel,185,"Pobo, El",106,70,36
44,Teruel,187,"Portellada, La",236,120,116
44,Teruel,189,Pozondón,48,29,19
44,Teruel,190,Pozuel del Campo,60,32,28
44,Teruel,191,"Puebla de Híjar, La",914,470,444
44,Teruel,192,"Puebla de Valverde, La",448,240,208
44,Teruel,193,Puertomingalvo,141,73,68
44,Teruel,194,Ráfales,146,85,61
44,Teruel,195,Rillo,86,52,34
44,Teruel,196,Riodeva,136,64,72
44,Teruel,197,Ródenas,62,34,28
44,Teruel,198,Royuela,225,119,106
44,Teruel,199,Rubiales,43,24,19
44,Teruel,200,Rubielos de la Cérida,32,19,13
44,Teruel,201,Rubielos de Mora,624,324,300
44,Teruel,203,Salcedillo,11,7,4
44,Teruel,204,Saldón,22,15,7
44,Teruel,205,Samper de Calanda,731,378,353
44,Teruel,206,San Agustín,134,82,52
44,Teruel,207,San Martín del Río,132,70,62
44,Teruel,208,Santa Cruz de Nogueras,25,14,11
44,Teruel,209,Santa Eulalia,1033,524,509
44,Teruel,210,Sarrión,1201,618,583
44,Teruel,211,Segura de los Baños,42,27,15
44,Teruel,212,Seno,43,19,24
44,Teruel,213,Singra,80,47,33
44,Teruel,215,Terriente,191,110,81
44,Teruel,216,Teruel,35900,17094,18806
44,Teruel,217,Toril y Masegoso,37,28,9
44,Teruel,218,Tormón,26,17,9
44,Teruel,219,Tornos,196,105,91
44,Teruel,220,Torralba de los Sisones,151,81,70
44,Teruel,223,Torre de Arcas,82,38,44
44,Teruel,224,Torre de las Arcas,24,14,10
44,Teruel,225,Torre del Compte,125,65,60
44,Teruel,227,Torre los Negros,81,42,39
44,Teruel,221,Torrecilla de Alcañiz,460,244,216
44,Teruel,222,Torrecilla del Rebollar,121,78,43
44,Teruel,226,Torrelacárcel,140,78,62
44,Teruel,228,Torremocha de Jiloca,106,58,48
44,Teruel,229,Torres de Albarracín,168,97,71
44,Teruel,230,Torrevelilla,170,88,82
44,Teruel,231,Torrijas,35,15,20
44,Teruel,232,Torrijo del Campo,482,253,229
44,Teruel,234,Tramacastiel,66,39,27
44,Teruel,235,Tramacastilla,117,57,60
44,Teruel,236,Tronchón,61,31,30
44,Teruel,237,Urrea de Gaén,440,223,217
44,Teruel,238,Utrillas,3011,1540,1471
44,Teruel,239,Valacloche,26,14,12
44,Teruel,240,Valbona,188,108,80
44,Teruel,241,Valdealgorfa,591,289,302
44,Teruel,243,Valdecuenca,31,19,12
44,Teruel,244,Valdelinares,78,47,31
44,Teruel,245,Valdeltormo,301,144,157
44,Teruel,246,Valderrobres,2498,1291,1207
44,Teruel,247,Valjunquera,337,170,167
44,Teruel,249,"Vallecillo, El",41,25,16
44,Teruel,250,Veguillas de la Sierra,21,13,8
44,Teruel,251,Villafranca del Campo,301,155,146
44,Teruel,252,Villahermosa del Campo,90,55,35
44,Teruel,256,Villanueva del Rebollar de la Sierra,44,25,19
44,Teruel,257,Villar del Cobo,165,97,68
44,Teruel,258,Villar del Salz,63,38,25
44,Teruel,260,Villarluengo,174,100,74
44,Teruel,261,Villarquemado,857,450,407
44,Teruel,262,Villarroya de los Pinares,172,92,80
44,Teruel,263,Villastar,543,271,272
44,Teruel,264,Villel,329,183,146
44,Teruel,265,Vinaceite,211,113,98
44,Teruel,266,Visiedo,118,55,63
44,Teruel,267,Vivel del Río Martín,68,37,31
44,Teruel,268,"Zoma, La",30,16,14
45,Toledo,1,Ajofrín,2290,1157,1133
45,Toledo,2,Alameda de la Sagra,3908,2036,1872
45,Toledo,3,Albarreal de Tajo,692,362,330
45,Toledo,4,Alcabón,743,374,369
45,Toledo,5,Alcañizo,277,135,142
45,Toledo,6,Alcaudete de la Jara,1614,816,798
45,Toledo,7,Alcolea de Tajo,824,415,409
45,Toledo,8,Aldea en Cabo,187,96,91
45,Toledo,9,Aldeanueva de Barbarroya,482,250,232
45,Toledo,10,Aldeanueva de San Bartolomé,416,209,207
45,Toledo,11,Almendral de la Cañada,322,166,156
45,Toledo,12,Almonacid de Toledo,885,433,452
45,Toledo,13,Almorox,2317,1208,1109
45,Toledo,14,Añover de Tajo,5225,2643,2582
45,Toledo,15,Arcicóllar,1004,498,506
45,Toledo,16,Argés,6829,3411,3418
45,Toledo,17,Azután,296,144,152
45,Toledo,18,Barcience,1003,542,461
45,Toledo,19,Bargas,10807,5430,5377
45,Toledo,20,Belvís de la Jara,1497,769,728
45,Toledo,21,Borox,4032,2129,1903
45,Toledo,22,Buenaventura,403,203,200
45,Toledo,23,Burguillos de Toledo,3473,1811,1662
45,Toledo,24,Burujón,1304,666,638
45,Toledo,25,Cabañas de la Sagra,2041,1052,989
45,Toledo,26,Cabañas de Yepes,304,157,147
45,Toledo,27,Cabezamesada,319,174,145
45,Toledo,28,Calera y Chozas,4716,2392,2324
45,Toledo,29,Caleruela,202,100,102
45,Toledo,30,Calzada de Oropesa,510,280,230
45,Toledo,31,Camarena,4283,2212,2071
45,Toledo,32,Camarenilla,610,308,302
45,Toledo,33,"Campillo de la Jara, El",336,183,153
45,Toledo,34,Camuñas,1742,903,839
45,Toledo,35,Cardiel de los Montes,394,217,177
45,Toledo,36,Carmena,777,394,383
45,Toledo,37,"Carpio de Tajo, El",1826,914,912
45,Toledo,38,Carranque,5155,2682,2473
45,Toledo,39,Carriches,276,137,139
45,Toledo,40,"Casar de Escalona, El",1891,1015,876
45,Toledo,41,Casarrubios del Monte,6441,3368,3073
45,Toledo,42,Casasbuenas,188,96,92
45,Toledo,43,Castillo de Bayuela,895,444,451
45,Toledo,45,Cazalegas,1927,998,929
45,Toledo,46,Cebolla,3201,1591,1610
45,Toledo,47,Cedillo del Condado,4101,2118,1983
45,Toledo,48,"Cerralbos, Los",397,215,182
45,Toledo,49,Cervera de los Montes,508,262,246
45,Toledo,56,Chozas de Canales,4523,2322,2201
45,Toledo,57,Chueca,249,124,125
45,Toledo,50,Ciruelos,630,340,290
45,Toledo,51,Cobeja,2482,1292,1190
45,Toledo,52,Cobisa,4427,2212,2215
45,Toledo,53,Consuegra,9886,5018,4868
45,Toledo,54,Corral de Almaguer,4827,2497,2330
45,Toledo,55,Cuerva,1248,649,599
45,Toledo,58,Domingo Pérez,306,156,150
45,Toledo,59,Dosbarrios,2273,1167,1106
45,Toledo,60,Erustes,206,109,97
45,Toledo,61,Escalona,3573,1846,1727
45,Toledo,62,Escalonilla,1440,712,728
45,Toledo,63,Espinoso del Rey,437,255,182
45,Toledo,64,Esquivias,5740,2910,2830
45,Toledo,65,"Estrella, La",194,107,87
45,Toledo,66,Fuensalida,12004,6044,5960
45,Toledo,67,Gálvez,2986,1499,1487
45,Toledo,68,Garciotum,216,105,111
45,Toledo,69,Gerindote,2518,1258,1260
45,Toledo,70,Guadamur,1774,887,887
45,Toledo,71,"Guardia, La",2163,1100,1063
45,Toledo,72,"Herencias, Las",768,410,358
45,Toledo,73,Herreruela de Oropesa,304,160,144
45,Toledo,74,Hinojosa de San Vicente,394,217,177
45,Toledo,75,Hontanar,146,87,59
45,Toledo,76,Hormigos,881,489,392
45,Toledo,77,Huecas,810,416,394
45,Toledo,78,Huerta de Valdecarábanos,1726,872,854
45,Toledo,79,"Iglesuela del Tiétar, La",471,254,217
45,Toledo,80,Illán de Vacas,3,3,0
45,Toledo,81,Illescas,30553,15336,15217
45,Toledo,82,Lagartera,1292,639,653
45,Toledo,83,Layos,845,428,417
45,Toledo,84,Lillo,2543,1326,1217
45,Toledo,85,Lominchar,2510,1317,1193
45,Toledo,86,Lucillos,571,300,271
45,Toledo,87,Madridejos,10202,5079,5123
45,Toledo,88,Magán,3875,1957,1918
45,Toledo,89,Malpica de Tajo,1688,865,823
45,Toledo,90,Manzaneque,382,185,197
45,Toledo,91,Maqueda,459,233,226
45,Toledo,92,Marjaliza,253,130,123
45,Toledo,93,Marrupe,147,76,71
45,Toledo,94,Mascaraque,414,212,202
45,Toledo,95,"Mata, La",854,416,438
45,Toledo,96,Mazarambroz,1259,652,607
45,Toledo,97,Mejorada,1354,697,657
45,Toledo,98,Menasalbas,2513,1309,1204
45,Toledo,99,Méntrida,5722,2933,2789
45,Toledo,100,Mesegar de Tajo,203,109,94
45,Toledo,101,Miguel Esteban,4791,2405,2386
45,Toledo,102,Mocejón,5004,2501,2503
45,Toledo,103,Mohedas de la Jara,389,209,180
45,Toledo,104,Montearagón,533,284,249
45,Toledo,105,Montesclaros,384,197,187
45,Toledo,106,Mora,9796,4921,4875
45,Toledo,107,Nambroca,5020,2556,2464
45,Toledo,108,"Nava de Ricomalillo, La",493,262,231
45,Toledo,109,Navahermosa,3586,1879,1707
45,Toledo,110,Navalcán,1888,987,901
45,Toledo,111,Navalmoralejo,51,26,25
45,Toledo,112,"Navalmorales, Los",2163,1117,1046
45,Toledo,113,"Navalucillos, Los",1987,1007,980
45,Toledo,114,Navamorcuende,595,296,299
45,Toledo,115,Noblejas,3857,1927,1930
45,Toledo,116,Noez,942,468,474
45,Toledo,117,Nombela,881,472,409
45,Toledo,118,Novés,3236,1674,1562
45,Toledo,119,Numancia de la Sagra,5287,2753,2534
45,Toledo,120,Nuño Gómez,145,81,64
45,Toledo,121,Ocaña,13185,6600,6585
45,Toledo,122,Olías del Rey,8469,4287,4182
45,Toledo,123,Ontígola,4752,2527,2225
45,Toledo,124,Orgaz,2584,1298,1286
45,Toledo,125,Oropesa,2607,1250,1357
45,Toledo,126,Otero,357,190,167
45,Toledo,127,Palomeque,1126,612,514
45,Toledo,128,Pantoja,3506,1746,1760
45,Toledo,129,Paredes de Escalona,122,66,56
45,Toledo,130,Parrillas,337,178,159
45,Toledo,131,Pelahustán,342,196,146
45,Toledo,132,Pepino,3003,1538,1465
45,Toledo,133,Polán,3870,1929,1941
45,Toledo,134,Portillo de Toledo,2234,1132,1102
45,Toledo,135,"Puebla de Almoradiel, La",4953,2523,2430
45,Toledo,136,"Puebla de Montalbán, La",7838,3958,3880
45,Toledo,137,"Pueblanueva, La",2166,1106,1060
45,Toledo,138,"Puente del Arzobispo, El",1153,574,579
45,Toledo,139,Puerto de San Vicente,140,77,63
45,Toledo,140,Pulgar,1491,762,729
45,Toledo,141,Quero,985,507,478
45,Toledo,142,Quintanar de la Orden,11069,5497,5572
45,Toledo,143,Quismondo,1673,834,839
45,Toledo,144,"Real de San Vicente, El",973,524,449
45,Toledo,145,Recas,4552,2499,2053
45,Toledo,146,Retamoso de la Jara,97,54,43
45,Toledo,147,Rielves,760,384,376
45,Toledo,148,Robledo del Mazo,249,133,116
45,Toledo,149,"Romeral, El",555,274,281
45,Toledo,150,San Bartolomé de las Abiertas,533,284,249
45,Toledo,151,San Martín de Montalbán,699,353,346
45,Toledo,152,San Martín de Pusa,585,315,270
45,Toledo,153,San Pablo de los Montes,1696,857,839
45,Toledo,154,San Román de los Montes,2047,1052,995
45,Toledo,155,Santa Ana de Pusa,358,204,154
45,Toledo,156,Santa Cruz de la Zarza,4097,2079,2018
45,Toledo,157,Santa Cruz del Retamar,3682,1911,1771
45,Toledo,158,Santa Olalla,3387,1715,1672
45,Toledo,901,Santo Domingo-Caudilla,1111,583,528
45,Toledo,159,Sartajada,107,66,41
45,Toledo,160,Segurilla,1366,694,672
45,Toledo,161,Seseña,28102,14431,13671
45,Toledo,162,Sevilleja de la Jara,643,361,282
45,Toledo,163,Sonseca,11084,5604,5480
45,Toledo,164,Sotillo de las Palomas,183,93,90
45,Toledo,165,Talavera de la Reina,83247,39935,43312
45,Toledo,166,Tembleque,1949,992,957
45,Toledo,167,"Toboso, El",1663,830,833
45,Toledo,168,Toledo,85085,40504,44581
45,Toledo,169,Torralba de Oropesa,193,103,90
45,Toledo,171,"Torre de Esteban Hambrán, La",1703,853,850
45,Toledo,170,Torrecilla de la Jara,208,115,93
45,Toledo,172,Torrico,691,353,338
45,Toledo,173,Torrijos,13678,6692,6986
45,Toledo,174,Totanés,358,182,176
45,Toledo,175,Turleque,721,368,353
45,Toledo,176,Ugena,5615,2888,2727
45,Toledo,177,Urda,2417,1206,1211
45,Toledo,179,Valdeverdeja,550,277,273
45,Toledo,180,Valmojado,4503,2279,2224
45,Toledo,181,Velada,2865,1477,1388
45,Toledo,182,"Ventas con Peña Aguilera, Las",1109,554,555
45,Toledo,183,"Ventas de Retamosa, Las",3806,2021,1785
45,Toledo,184,"Ventas de San Julián, Las",222,104,118
45,Toledo,186,"Villa de Don Fadrique, La",3572,1773,1799
45,Toledo,185,Villacañas,9418,4705,4713
45,Toledo,187,Villafranca de los Caballeros,4884,2450,2434
45,Toledo,188,Villaluenga de la Sagra,4081,2045,2036
45,Toledo,189,Villamiel de Toledo,1021,521,500
45,Toledo,190,Villaminaya,508,256,252
45,Toledo,191,Villamuelas,610,318,292
45,Toledo,192,Villanueva de Alcardete,3062,1581,1481
45,Toledo,193,Villanueva de Bogas,699,362,337
45,Toledo,194,Villarejo de Montalbán,75,40,35
45,Toledo,195,Villarrubia de Santiago,2509,1262,1247
45,Toledo,196,Villaseca de la Sagra,1864,936,928
45,Toledo,197,Villasequilla,2563,1316,1247
45,Toledo,198,Villatobas,2595,1336,1259
45,Toledo,199,"Viso de San Juan, El",5533,2945,2588
45,Toledo,200,"Yébenes, Los",5752,2943,2809
45,Toledo,201,Yeles,5868,3090,2778
45,Toledo,202,Yepes,5268,2675,2593
45,Toledo,203,Yuncler,4582,2368,2214
45,Toledo,204,Yunclillos,806,422,384
45,Toledo,205,Yuncos,10630,5416,5214
46,Valencia/València,1,Ademuz,1000,535,465
46,Valencia/València,2,Ador,1706,894,812
46,Valencia/València,4,Agullent,2361,1174,1187
46,Valencia/València,42,Aielo de Malferit,4589,2317,2272
46,Valencia/València,43,Aielo de Rugat,166,89,77
46,Valencia/València,5,Alaquàs,29537,14432,15105
46,Valencia/València,6,Albaida,5989,2967,3022
46,Valencia/València,7,Albal,16845,8440,8405
46,Valencia/València,8,Albalat de la Ribera,3444,1735,1709
46,Valencia/València,9,Albalat dels Sorells,4084,2011,2073
46,Valencia/València,10,Albalat dels Tarongers,1368,721,647
46,Valencia/València,11,Alberic,10710,5336,5374
46,Valencia/València,12,Alborache,1328,684,644
46,Valencia/València,13,Alboraia/Alboraya,25149,12273,12876
46,Valencia/València,14,Albuixech,4201,2028,2173
46,Valencia/València,16,Alcàntera de Xúquer,1427,720,707
46,Valencia/València,15,Alcàsser,10396,5193,5203
46,Valencia/València,18,Alcublas,607,317,290
46,Valencia/València,20,"Alcúdia de Crespins, l'",5224,2574,2650
46,Valencia/València,19,"Alcúdia, l'",12176,5997,6179
46,Valencia/València,21,Aldaia,32656,16327,16329
46,Valencia/València,22,Alfafar,21480,10551,10929
46,Valencia/València,24,Alfara de la Baronia,606,297,309
46,Valencia/València,25,Alfara del Patriarca,3315,1570,1745
46,Valencia/València,26,Alfarp,1596,821,775
46,Valencia/València,27,Alfarrasí,1217,600,617
46,Valencia/València,23,Alfauir,479,247,232
46,Valencia/València,28,Algar de Palancia,498,257,241
46,Valencia/València,29,Algemesí,27305,13527,13778
46,Valencia/València,30,Algímia d'Alfara,1106,545,561
46,Valencia/València,31,Alginet,14219,7208,7011
46,Valencia/València,32,Almàssera,7482,3646,3836
46,Valencia/València,33,Almiserà,260,132,128
46,Valencia/València,34,Almoines,2473,1230,1243
46,Valencia/València,35,Almussafes,8929,4440,4489
46,Valencia/València,36,Alpuente,670,370,300
46,Valencia/València,37,"Alqueria de la Comtessa, l'",1478,719,759
46,Valencia/València,17,Alzira,45451,22170,23281
46,Valencia/València,38,Andilla,316,207,109
46,Valencia/València,39,Anna,2583,1290,1293
46,Valencia/València,40,Antella,1130,546,584
46,Valencia/València,41,Aras de los Olmos,380,219,161
46,Valencia/València,3,Atzeneta d'Albaida,1146,581,565
46,Valencia/València,44,Ayora,5187,2569,2618
46,Valencia/València,46,Barx,1400,735,665
46,Valencia/València,45,Barxeta,1576,814,762
46,Valencia/València,47,Bèlgida,639,315,324
46,Valencia/València,48,Bellreguard,4713,2350,2363
46,Valencia/València,49,Bellús,301,156,145
46,Valencia/València,50,Benagéber,170,102,68
46,Valencia/València,51,Benaguasil,11568,5921,5647
46,Valencia/València,52,Benavites,667,322,345
46,Valencia/València,53,Beneixida,652,310,342
46,Valencia/València,54,Benetússer,15493,7553,7940
46,Valencia/València,55,Beniarjó,1791,893,898
46,Valencia/València,56,Beniatjar,207,110,97
46,Valencia/València,57,Benicolet,597,292,305
46,Valencia/València,904,Benicull de Xúquer,1102,559,543
46,Valencia/València,60,Benifaió,11877,5869,6008
46,Valencia/València,59,Benifairó de la Valldigna,1552,774,778
46,Valencia/València,58,Benifairó de les Valls,2314,1137,1177
46,Valencia/València,61,Beniflá,475,230,245
46,Valencia/València,62,Benigànim,5718,2906,2812
46,Valencia/València,63,Benimodo,2233,1134,1099
46,Valencia/València,64,Benimuslem,662,355,307
46,Valencia/València,65,Beniparrell,2020,1015,1005
46,Valencia/València,66,Benirredrà,1548,741,807
46,Valencia/València,67,Benissanó,2345,1162,1183
46,Valencia/València,68,Benissoda,456,249,207
46,Valencia/València,69,Benissuera,188,91,97
46,Valencia/València,70,Bétera,26289,13073,13216
46,Valencia/València,71,Bicorp,524,253,271
46,Valencia/València,72,Bocairent,4123,2091,2032
46,Valencia/València,73,Bolbaite,1338,669,669
46,Valencia/València,74,Bonrepòs i Mirambell,3831,1878,1953
46,Valencia/València,75,Bufali,156,84,72
46,Valencia/València,76,Bugarra,747,376,371
46,Valencia/València,77,Buñol,9503,4730,4773
46,Valencia/València,78,Burjassot,38880,18761,20119
46,Valencia/València,79,Calles,374,215,159
46,Valencia/València,80,Camporrobles,1196,607,589
46,Valencia/València,81,Canals,13187,6591,6596
46,Valencia/València,82,Canet d'En Berenguer,6942,3487,3455
46,Valencia/València,83,Carcaixent,20498,10171,10327
46,Valencia/València,84,Càrcer,1808,866,942
46,Valencia/València,85,Carlet,15945,7982,7963
46,Valencia/València,86,Carrícola,99,48,51
46,Valencia/València,87,Casas Altas,132,70,62
46,Valencia/València,88,Casas Bajas,171,91,80
46,Valencia/València,89,Casinos,2994,1524,1470
46,Valencia/València,257,Castelló,6932,3407,3525
46,Valencia/València,90,Castelló de Rugat,2315,1173,1142
46,Valencia/València,91,Castellonet de la Conquesta,137,75,62
46,Valencia/València,92,Castielfabib,291,154,137
46,Valencia/València,93,Catadau,2862,1449,1413
46,Valencia/València,94,Catarroja,28679,14189,14490
46,Valencia/València,95,Caudete de las Fuentes,701,366,335
46,Valencia/València,96,Cerdà,351,181,170
46,Valencia/València,107,Chella,2434,1203,1231
46,Valencia/València,106,Chelva,1597,824,773
46,Valencia/València,108,Chera,492,263,229
46,Valencia/València,109,Cheste,8971,4625,4346
46,Valencia/València,111,Chiva,16285,8306,7979
46,Valencia/València,112,Chulilla,692,366,326
46,Valencia/València,97,Cofrentes,1112,563,549
46,Valencia/València,98,Corbera,3097,1534,1563
46,Valencia/València,99,Cortes de Pallás,733,407,326
46,Valencia/València,100,Cotes,323,164,159
46,Valencia/València,105,Cullera,22937,11629,11308
46,Valencia/València,113,Daimús,3274,1646,1628
46,Valencia/València,114,Domeño,656,321,335
46,Valencia/València,115,Dos Aguas,325,177,148
46,Valencia/València,116,"Eliana, l'",18544,9102,9442
46,Valencia/València,117,Emperador,705,368,337
46,Valencia/València,118,Enguera,4770,2388,2382
46,Valencia/València,119,"Énova, l'",908,466,442
46,Valencia/València,120,Estivella,1559,758,801
46,Valencia/València,121,Estubeny,109,53,56
46,Valencia/València,122,Faura,3568,1800,1768
46,Valencia/València,123,Favara,2578,1316,1262
46,Valencia/València,126,Foios,7496,3670,3826
46,Valencia/València,128,"Font de la Figuera, la",2024,1021,1003
46,Valencia/València,127,"Font d'En Carròs, la",3857,1928,1929
46,Valencia/València,124,Fontanars dels Alforins,953,494,459
46,Valencia/València,125,Fortaleny,1026,507,519
46,Valencia/València,129,Fuenterrobles,690,376,314
46,Valencia/València,131,Gandia,75911,37224,38687
46,Valencia/València,902,Gátova,412,207,205
46,Valencia/València,130,Gavarda,1053,511,542
46,Valencia/València,132,"Genovés, el",2780,1406,1374
46,Valencia/València,133,Gestalgar,547,291,256
46,Valencia/València,134,Gilet,3601,1848,1753
46,Valencia/València,135,Godella,13050,6287,6763
46,Valencia/València,136,Godelleta,3942,2035,1907
46,Valencia/València,137,"Granja de la Costera, la",276,141,135
46,Valencia/València,138,Guadasséquies,475,237,238
46,Valencia/València,139,Guadassuar,5910,2864,3046
46,Valencia/València,140,Guardamar de la Safor,567,292,275
46,Valencia/València,141,Higueruelas,510,270,240
46,Valencia/València,142,Jalance,788,416,372
46,Valencia/València,144,Jarafuel,777,410,367
46,Valencia/València,154,Llanera de Ranes,1066,552,514
46,Valencia/València,155,Llaurí,1193,602,591
46,Valencia/València,147,Llíria,24036,12116,11920
46,Valencia/València,152,Llocnou de la Corona,109,58,51
46,Valencia/València,153,Llocnou de Sant Jeroni,577,292,285
46,Valencia/València,151,Llocnou d'En Fenollet,924,473,451
46,Valencia/València,156,Llombai,2648,1324,1324
46,Valencia/València,157,"Llosa de Ranes, la",3652,1856,1796
46,Valencia/València,150,Llutxent,2318,1188,1130
46,Valencia/València,148,Loriguilla,2100,1091,1009
46,Valencia/València,149,Losa del Obispo,527,268,259
46,Valencia/València,158,Macastre,1387,732,655
46,Valencia/València,159,Manises,31170,15445,15725
46,Valencia/València,160,Manuel,2496,1242,1254
46,Valencia/València,161,Marines,1942,1012,930
46,Valencia/València,162,Massalavés,1696,865,831
46,Valencia/València,163,Massalfassar,2587,1288,1299
46,Valencia/València,164,Massamagrell,16223,8020,8203
46,Valencia/València,165,Massanassa,9929,4852,5077
46,Valencia/València,166,Meliana,10881,5362,5519
46,Valencia/València,167,Millares,339,172,167
46,Valencia/València,168,Miramar,2831,1434,1397
46,Valencia/València,169,Mislata,44282,21510,22772
46,Valencia/València,170,Mogente/Moixent,4365,2193,2172
46,Valencia/València,171,Moncada,21913,10665,11248
46,Valencia/València,173,Montaverner,1627,806,821
46,Valencia/València,174,Montesa,1152,585,567
46,Valencia/València,175,Montitxelvo/Montichelvo,571,280,291
46,Valencia/València,176,Montroi/Montroy,3185,1686,1499
46,Valencia/València,172,Montserrat,9017,4694,4323
46,Valencia/València,177,Museros,6663,3405,3258
46,Valencia/València,178,Nàquera/Náquera,7728,3992,3736
46,Valencia/València,179,Navarrés,2989,1490,1499
46,Valencia/València,180,Novelé/Novetlè,861,426,435
46,Valencia/València,181,Oliva,25179,12375,12804
46,Valencia/València,183,"Olleria, l'",8355,4194,4161
46,Valencia/València,182,Olocau,2148,1138,1010
46,Valencia/València,184,Ontinyent,35946,17730,18216
46,Valencia/València,185,Otos,428,216,212
46,Valencia/València,186,Paiporta,26567,13062,13505
46,Valencia/València,187,Palma de Gandía,1686,886,800
46,Valencia/València,188,Palmera,1040,519,521
46,Valencia/València,189,"Palomar, el",566,289,277
46,Valencia/València,190,Paterna,71880,35431,36449
46,Valencia/València,191,Pedralba,2966,1567,1399
46,Valencia/València,192,Petrés,1057,533,524
46,Valencia/València,193,Picanya,11665,5758,5907
46,Valencia/València,194,Picassent,21761,10945,10816
46,Valencia/València,195,Piles,2882,1432,1450
46,Valencia/València,196,Pinet,155,75,80
46,Valencia/València,199,"Pobla de Farnals, la",8368,4204,4164
46,Valencia/València,202,"Pobla de Vallbona, la",25625,12906,12719
46,Valencia/València,200,"Pobla del Duc, la",2447,1183,1264
46,Valencia/València,203,"Pobla Llarga, la",4443,2225,2218
46,Valencia/València,197,Polinyà de Xúquer,2493,1266,1227
46,Valencia/València,198,Potries,1075,549,526
46,Valencia/València,205,Puçol,20191,9956,10235
46,Valencia/València,201,Puebla de San Miguel,59,37,22
46,Valencia/València,204,"Puig de Santa Maria, el",8792,4276,4516
46,Valencia/València,101,Quart de les Valls,1049,495,554
46,Valencia/València,102,Quart de Poblet,25167,12230,12937
46,Valencia/València,103,Quartell,1683,801,882
46,Valencia/València,104,Quatretonda,2143,1078,1065
46,Valencia/València,206,Quesa,647,333,314
46,Valencia/València,207,Rafelbunyol,9381,4575,4806
46,Valencia/València,208,Rafelcofer,1386,681,705
46,Valencia/València,209,Rafelguaraf,2360,1169,1191
46,Valencia/València,210,Ráfol de Salem,443,222,221
46,Valencia/València,212,Real,2287,1185,1102
46,Valencia/València,211,"Real de Gandia, el",2574,1294,1280
46,Valencia/València,213,Requena,20058,10047,10011
46,Valencia/València,214,Riba-roja de Túria,23050,11643,11407
46,Valencia/València,215,Riola,1793,896,897
46,Valencia/València,216,Rocafort,7603,3709,3894
46,Valencia/València,217,Rotglà i Corberà,1163,576,587
46,Valencia/València,218,Ròtova,1265,638,627
46,Valencia/València,219,Rugat,175,96,79
46,Valencia/València,220,Sagunto/Sagunt,68066,33241,34825
46,Valencia/València,221,Salem,411,211,200
46,Valencia/València,903,San Antonio de Benagéber,9874,4901,4973
46,Valencia/València,222,Sant Joanet,534,266,268
46,Valencia/València,223,Sedaví,10349,5034,5315
46,Valencia/València,224,Segart,174,91,83
46,Valencia/València,225,Sellent,380,195,185
46,Valencia/València,226,Sempere,26,15,11
46,Valencia/València,227,Senyera,1108,539,569
46,Valencia/València,228,Serra,3405,1733,1672
46,Valencia/València,229,Siete Aguas,1180,618,562
46,Valencia/València,230,Silla,19298,9574,9724
46,Valencia/València,231,Simat de la Valldigna,3271,1626,1645
46,Valencia/València,232,Sinarcas,1135,597,538
46,Valencia/València,233,Sollana,4915,2419,2496
46,Valencia/València,234,Sot de Chera,384,207,177
46,Valencia/València,235,Sueca,27738,13682,14056
46,Valencia/València,236,Sumacàrcer,1054,507,547
46,Valencia/València,237,Tavernes Blanques,9222,4459,4763
46,Valencia/València,238,Tavernes de la Valldigna,17222,8541,8681
46,Valencia/València,239,Teresa de Cofrentes,615,320,295
46,Valencia/València,240,Terrateig,287,149,138
46,Valencia/València,241,Titaguas,485,255,230
46,Valencia/València,242,Torrebaja,408,219,189
46,Valencia/València,243,Torrella,134,73,61
46,Valencia/València,244,Torrent,85142,41839,43303
46,Valencia/València,245,Torres Torres,703,382,321
46,Valencia/València,246,Tous,1312,660,652
46,Valencia/València,247,Tuéjar,1168,628,540
46,Valencia/València,248,Turís,7019,3658,3361
46,Valencia/València,249,Utiel,11482,5735,5747
46,Valencia/València,250,València,792492,376169,416323
46,Valencia/València,251,Vallada,3065,1556,1509
46,Valencia/València,252,Vallanca,128,71,57
46,Valencia/València,253,Vallés,151,85,66
46,Valencia/València,254,Venta del Moro,1180,633,547
46,Valencia/València,255,Vilallonga/Villalonga,4555,2252,2303
46,Valencia/València,256,Vilamarxant,10348,5354,4994
46,Valencia/València,258,Villar del Arzobispo,3581,1810,1771
46,Valencia/València,259,Villargordo del Cabriel,602,303,299
46,Valencia/València,260,Vinalesa,3525,1710,1815
46,Valencia/València,145,Xàtiva,29637,14453,15184
46,Valencia/València,143,Xeraco,5819,2903,2916
46,Valencia/València,146,Xeresa,2244,1141,1103
46,Valencia/València,110,Xirivella,30326,14979,15347
46,Valencia/València,261,Yátova,2169,1122,1047
46,Valencia/València,262,"Yesa, La",227,118,109
46,Valencia/València,263,Zarra,370,201,169
47,Valladolid,1,Adalia,54,32,22
47,Valladolid,2,Aguasal,19,12,7
47,Valladolid,3,Aguilar de Campos,276,166,110
47,Valladolid,4,Alaejos,1385,742,643
47,Valladolid,5,Alcazarén,643,342,301
47,Valladolid,6,Aldea de San Miguel,214,120,94
47,Valladolid,7,Aldeamayor de San Martín,5896,3047,2849
47,Valladolid,8,Almenara de Adaja,23,12,11
47,Valladolid,9,Amusquillo,99,61,38
47,Valladolid,10,Arroyo de la Encomienda,21369,10683,10686
47,Valladolid,11,Ataquines,548,302,246
47,Valladolid,12,Bahabón,93,44,49
47,Valladolid,13,Barcial de la Loma,96,56,40
47,Valladolid,14,Barruelo del Valle,43,25,18
47,Valladolid,15,Becilla de Valderaduey,211,117,94
47,Valladolid,16,Benafarces,68,38,30
47,Valladolid,17,Bercero,179,101,78
47,Valladolid,18,Berceruelo,38,23,15
47,Valladolid,19,Berrueces,101,54,47
47,Valladolid,20,Bobadilla del Campo,281,161,120
47,Valladolid,21,Bocigas,77,42,35
47,Valladolid,22,Bocos de Duero,85,44,41
47,Valladolid,23,Boecillo,4304,2172,2132
47,Valladolid,24,Bolaños de Campos,246,141,105
47,Valladolid,25,Brahojos de Medina,103,54,49
47,Valladolid,26,Bustillo de Chaves,68,40,28
47,Valladolid,27,Cabezón de Pisuerga,3769,1908,1861
47,Valladolid,28,Cabezón de Valderaduey,42,24,18
47,Valladolid,29,Cabreros del Monte,53,29,24
47,Valladolid,30,Campaspero,1042,583,459
47,Valladolid,31,"Campillo, El",202,116,86
47,Valladolid,32,Camporredondo,156,91,65
47,Valladolid,33,Canalejas de Peñafiel,237,131,106
47,Valladolid,34,Canillas de Esgueva,69,41,28
47,Valladolid,35,Carpio,967,519,448
47,Valladolid,36,Casasola de Arión,217,127,90
47,Valladolid,37,Castrejón de Trabancos,177,91,86
47,Valladolid,38,Castrillo de Duero,116,67,49
47,Valladolid,39,Castrillo-Tejeriego,161,90,71
47,Valladolid,40,Castrobol,56,30,26
47,Valladolid,41,Castrodeza,149,93,56
47,Valladolid,42,Castromembibre,51,36,15
47,Valladolid,43,Castromonte,314,168,146
47,Valladolid,44,Castronuevo de Esgueva,394,211,183
47,Valladolid,45,Castronuño,812,409,403
47,Valladolid,46,Castroponce,139,76,63
47,Valladolid,47,Castroverde de Cerrato,203,132,71
47,Valladolid,48,Ceinos de Campos,197,111,86
47,Valladolid,49,Cervillego de la Cruz,91,54,37
47,Valladolid,50,Cigales,5286,2707,2579
47,Valladolid,51,Ciguñuela,356,187,169
47,Valladolid,52,Cistérniga,9129,4605,4524
47,Valladolid,53,Cogeces de Íscar,144,73,71
47,Valladolid,54,Cogeces del Monte,630,338,292
47,Valladolid,55,Corcos,199,112,87
47,Valladolid,56,Corrales de Duero,99,60,39
47,Valladolid,57,Cubillas de Santa Marta,368,214,154
47,Valladolid,58,Cuenca de Campos,209,109,100
47,Valladolid,59,Curiel de Duero,112,72,40
47,Valladolid,60,Encinas de Esgueva,210,119,91
47,Valladolid,61,Esguevillas de Esgueva,269,145,124
47,Valladolid,62,Fombellida,181,104,77
47,Valladolid,63,Fompedraza,109,58,51
47,Valladolid,64,Fontihoyuelo,37,23,14
47,Valladolid,65,Fresno el Viejo,860,455,405
47,Valladolid,66,Fuensaldaña,2025,1048,977
47,Valladolid,67,Fuente el Sol,156,81,75
47,Valladolid,68,Fuente-Olmedo,36,19,17
47,Valladolid,69,Gallegos de Hornija,110,54,56
47,Valladolid,70,Gatón de Campos,29,17,12
47,Valladolid,71,Geria,504,239,265
47,Valladolid,73,Herrín de Campos,123,66,57
47,Valladolid,74,Hornillos de Eresma,174,98,76
47,Valladolid,75,Íscar,6302,3176,3126
47,Valladolid,76,Laguna de Duero,22642,11245,11397
47,Valladolid,77,Langayo,254,159,95
47,Valladolid,79,Llano de Olmedo,52,26,26
47,Valladolid,78,Lomoviejo,172,93,79
47,Valladolid,80,Manzanillo,54,27,27
47,Valladolid,81,Marzales,45,20,25
47,Valladolid,82,Matapozuelos,1001,504,497
47,Valladolid,83,Matilla de los Caños,99,51,48
47,Valladolid,84,Mayorga,1455,727,728
47,Valladolid,86,Medina de Rioseco,4493,2221,2272
47,Valladolid,85,Medina del Campo,20183,9829,10354
47,Valladolid,87,Megeces,434,233,201
47,Valladolid,88,Melgar de Abajo,116,63,53
47,Valladolid,89,Melgar de Arriba,168,92,76
47,Valladolid,90,Mojados,3312,1718,1594
47,Valladolid,91,Monasterio de Vega,81,44,37
47,Valladolid,92,Montealegre de Campos,104,59,45
47,Valladolid,93,Montemayor de Pililla,856,460,396
47,Valladolid,94,Moral de la Reina,151,81,70
47,Valladolid,95,Moraleja de las Panaderas,42,24,18
47,Valladolid,96,Morales de Campos,135,71,64
47,Valladolid,97,Mota del Marqués,332,184,148
47,Valladolid,98,Mucientes,659,334,325
47,Valladolid,99,"Mudarra, La",165,86,79
47,Valladolid,100,Muriel,118,60,58
47,Valladolid,101,Nava del Rey,1951,1004,947
47,Valladolid,102,Nueva Villa de las Torres,282,162,120
47,Valladolid,103,Olivares de Duero,307,174,133
47,Valladolid,104,Olmedo,3554,1772,1782
47,Valladolid,105,Olmos de Esgueva,186,100,86
47,Valladolid,106,Olmos de Peñafiel,42,22,20
47,Valladolid,109,Palazuelo de Vedija,168,84,84
47,Valladolid,110,"Parrilla, La",487,246,241
47,Valladolid,111,"Pedraja de Portillo, La",1138,587,551
47,Valladolid,112,Pedrajas de San Esteban,3371,1713,1658
47,Valladolid,113,Pedrosa del Rey,147,81,66
47,Valladolid,114,Peñafiel,5104,2591,2513
47,Valladolid,115,Peñaflor de Hornija,337,180,157
47,Valladolid,116,Pesquera de Duero,428,227,201
47,Valladolid,117,Piña de Esgueva,318,163,155
47,Valladolid,118,Piñel de Abajo,152,86,66
47,Valladolid,119,Piñel de Arriba,90,47,43
47,Valladolid,121,Pollos,614,352,262
47,Valladolid,122,Portillo,2382,1223,1159
47,Valladolid,123,Pozal de Gallinas,527,283,244
47,Valladolid,124,Pozaldez,498,266,232
47,Valladolid,125,Pozuelo de la Orden,49,28,21
47,Valladolid,126,Puras,44,24,20
47,Valladolid,127,Quintanilla de Arriba,158,89,69
47,Valladolid,129,Quintanilla de Onésimo,1014,538,476
47,Valladolid,130,Quintanilla de Trigueros,104,51,53
47,Valladolid,128,Quintanilla del Molar,53,26,27
47,Valladolid,131,Rábano,173,90,83
47,Valladolid,132,Ramiro,47,27,20
47,Valladolid,133,Renedo de Esgueva,3908,1986,1922
47,Valladolid,134,Roales de Campos,175,98,77
47,Valladolid,135,Robladillo,87,50,37
47,Valladolid,137,Roturas,30,19,11
47,Valladolid,138,Rubí de Bracamonte,213,126,87
47,Valladolid,139,Rueda,1140,592,548
47,Valladolid,140,Saelices de Mayorga,110,69,41
47,Valladolid,141,Salvador de Zapardiel,105,59,46
47,Valladolid,142,San Cebrián de Mazote,114,67,47
47,Valladolid,143,San Llorente,105,60,45
47,Valladolid,144,San Martín de Valvení,78,43,35
47,Valladolid,145,San Miguel del Arroyo,646,345,301
47,Valladolid,146,San Miguel del Pino,355,184,171
47,Valladolid,147,San Pablo de la Moraleja,111,61,50
47,Valladolid,148,San Pedro de Latarce,448,240,208
47,Valladolid,149,San Pelayo,48,22,26
47,Valladolid,150,San Román de Hornija,301,143,158
47,Valladolid,151,San Salvador,23,14,9
47,Valladolid,156,San Vicente del Palacio,158,85,73
47,Valladolid,152,Santa Eufemia del Arroyo,69,38,31
47,Valladolid,153,Santervás de Campos,105,58,47
47,Valladolid,154,Santibáñez de Valcorba,183,106,77
47,Valladolid,155,Santovenia de Pisuerga,4612,2354,2258
47,Valladolid,157,Sardón de Duero,596,320,276
47,Valladolid,158,"Seca, La",1066,559,507
47,Valladolid,159,Serrada,1124,584,540
47,Valladolid,160,Siete Iglesias de Trabancos,432,226,206
47,Valladolid,161,Simancas,5423,2752,2671
47,Valladolid,162,Tamariz de Campos,88,49,39
47,Valladolid,163,Tiedra,289,145,144
47,Valladolid,164,Tordehumos,375,204,171
47,Valladolid,165,Tordesillas,8664,4371,4293
47,Valladolid,169,Torre de Esgueva,60,33,27
47,Valladolid,170,Torre de Peñafiel,48,29,19
47,Valladolid,166,Torrecilla de la Abadesa,261,123,138
47,Valladolid,167,Torrecilla de la Orden,230,115,115
47,Valladolid,168,Torrecilla de la Torre,34,22,12
47,Valladolid,171,Torrelobatón,391,207,184
47,Valladolid,172,Torrescárcela,161,86,75
47,Valladolid,173,Traspinedo,1201,632,569
47,Valladolid,174,Trigueros del Valle,312,170,142
47,Valladolid,175,Tudela de Duero,8636,4374,4262
47,Valladolid,176,"Unión de Campos, La",209,102,107
47,Valladolid,177,Urones de Castroponce,101,61,40
47,Valladolid,178,Urueña,203,111,92
47,Valladolid,179,Valbuena de Duero,411,229,182
47,Valladolid,180,Valdearcos de la Vega,49,27,22
47,Valladolid,181,Valdenebro de los Valles,193,108,85
47,Valladolid,182,Valdestillas,1599,823,776
47,Valladolid,183,Valdunquillo,130,64,66
47,Valladolid,186,Valladolid,295639,138427,157212
47,Valladolid,184,Valoria la Buena,683,372,311
47,Valladolid,185,Valverde de Campos,81,47,34
47,Valladolid,187,Vega de Ruiponce,86,51,35
47,Valladolid,188,Vega de Valdetronco,92,51,41
47,Valladolid,189,Velascálvaro,163,85,78
47,Valladolid,190,Velilla,114,57,57
47,Valladolid,191,Velliza,119,78,41
47,Valladolid,192,Ventosa de la Cuesta,99,56,43
47,Valladolid,193,Viana de Cega,2194,1143,1051
47,Valladolid,195,Villabáñez,499,270,229
47,Valladolid,196,Villabaruz de Campos,27,13,14
47,Valladolid,197,Villabrágima,1047,560,487
47,Valladolid,198,Villacarralón,64,42,22
47,Valladolid,199,Villacid de Campos,86,49,37
47,Valladolid,200,Villaco,75,48,27
47,Valladolid,203,Villafrades de Campos,61,30,31
47,Valladolid,204,Villafranca de Duero,251,129,122
47,Valladolid,205,Villafrechós,471,262,209
47,Valladolid,206,Villafuerte,86,50,36
47,Valladolid,207,Villagarcía de Campos,288,171,117
47,Valladolid,208,Villagómez la Nueva,58,33,25
47,Valladolid,209,Villalán de Campos,38,24,14
47,Valladolid,210,Villalar de los Comuneros,493,240,253
47,Valladolid,211,Villalba de la Loma,59,30,29
47,Valladolid,212,Villalba de los Alcores,374,206,168
47,Valladolid,213,Villalbarba,102,53,49
47,Valladolid,214,Villalón de Campos,1523,752,771
47,Valladolid,215,Villamuriel de Campos,47,23,24
47,Valladolid,216,Villán de Tordesillas,128,72,56
47,Valladolid,217,Villanubla,2886,1490,1396
47,Valladolid,218,Villanueva de Duero,1238,658,580
47,Valladolid,219,Villanueva de la Condesa,58,27,31
47,Valladolid,220,Villanueva de los Caballeros,167,88,79
47,Valladolid,221,Villanueva de los Infantes,102,61,41
47,Valladolid,222,Villanueva de San Mancio,93,52,41
47,Valladolid,223,Villardefrades,149,85,64
47,Valladolid,224,Villarmentero de Esgueva,96,52,44
47,Valladolid,225,Villasexmir,72,43,29
47,Valladolid,226,Villavaquerín,163,93,70
47,Valladolid,227,Villavellid,50,30,20
47,Valladolid,228,Villaverde de Medina,522,284,238
47,Valladolid,229,Villavicencio de los Caballeros,232,122,110
47,Valladolid,194,Viloria,343,180,163
47,Valladolid,230,Wamba,309,168,141
47,Valladolid,231,Zaratán,6285,3204,3081
47,Valladolid,232,"Zarza, La",115,66,49
49,Zamora,2,Abezames,65,34,31
49,Zamora,3,Alcañices,1024,535,489
49,Zamora,4,Alcubilla de Nogales,116,61,55
49,Zamora,5,Alfaraz de Sayago,127,76,51
49,Zamora,6,Algodre,135,73,62
49,Zamora,7,Almaraz de Duero,401,211,190
49,Zamora,8,Almeida de Sayago,414,225,189
49,Zamora,9,Andavías,445,226,219
49,Zamora,10,Arcenillas,447,223,224
49,Zamora,11,Arcos de la Polvorosa,220,121,99
49,Zamora,12,Argañín,74,37,37
49,Zamora,13,Argujillo,219,113,106
49,Zamora,14,Arquillinos,117,61,56
49,Zamora,15,Arrabalde,218,114,104
49,Zamora,16,Aspariegos,231,99,132
49,Zamora,17,Asturianos,266,135,131
49,Zamora,18,Ayoó de Vidriales,273,136,137
49,Zamora,19,Barcial del Barco,236,122,114
49,Zamora,20,Belver de los Montes,253,140,113
49,Zamora,21,Benavente,17376,8366,9010
49,Zamora,22,Benegiles,294,161,133
49,Zamora,23,Bermillo de Sayago,1002,532,470
49,Zamora,24,"Bóveda de Toro, La",683,348,335
49,Zamora,25,Bretó,156,90,66
49,Zamora,26,Bretocino,201,106,95
49,Zamora,27,Brime de Sog,124,58,66
49,Zamora,28,Brime de Urz,105,63,42
49,Zamora,29,Burganes de Valverde,623,330,293
49,Zamora,30,Bustillo del Oro,86,49,37
49,Zamora,31,Cabañas de Sayago,143,78,65
49,Zamora,32,Calzadilla de Tera,302,156,146
49,Zamora,33,Camarzana de Tera,735,370,365
49,Zamora,34,Cañizal,415,221,194
49,Zamora,35,Cañizo,217,120,97
49,Zamora,36,Carbajales de Alba,487,252,235
49,Zamora,37,Carbellino,176,95,81
49,Zamora,38,Casaseca de Campeán,96,57,39
49,Zamora,39,Casaseca de las Chanas,375,200,175
49,Zamora,40,Castrillo de la Guareña,118,66,52
49,Zamora,41,Castrogonzalo,441,239,202
49,Zamora,42,Castronuevo,214,108,106
49,Zamora,43,Castroverde de Campos,276,148,128
49,Zamora,44,Cazurra,70,37,33
49,Zamora,46,Cerecinos de Campos,238,133,105
49,Zamora,47,Cerecinos del Carrizal,107,65,42
49,Zamora,48,Cernadilla,109,55,54
49,Zamora,50,Cobreros,543,296,247
49,Zamora,52,Coomonte,194,107,87
49,Zamora,53,Coreses,1049,541,508
49,Zamora,54,Corrales del Vino,960,472,488
49,Zamora,55,Cotanes del Monte,97,54,43
49,Zamora,56,Cubillos,297,141,156
49,Zamora,57,Cubo de Benavente,121,63,58
49,Zamora,58,"Cubo de Tierra del Vino, El",321,173,148
49,Zamora,59,Cuelgamures,81,51,30
49,Zamora,61,Entrala,137,76,61
49,Zamora,62,Espadañedo,113,60,53
49,Zamora,63,Faramontanos de Tábara,335,172,163
49,Zamora,64,Fariza,487,249,238
49,Zamora,65,Fermoselle,1128,572,556
49,Zamora,66,Ferreras de Abajo,482,234,248
49,Zamora,67,Ferreras de Arriba,359,201,158
49,Zamora,68,Ferreruela,429,241,188
49,Zamora,69,Figueruela de Arriba,294,139,155
49,Zamora,71,Fonfría,755,399,356
49,Zamora,75,Fresno de la Polvorosa,116,60,56
49,Zamora,76,Fresno de la Ribera,353,185,168
49,Zamora,77,Fresno de Sayago,156,77,79
49,Zamora,78,Friera de Valverde,133,72,61
49,Zamora,79,Fuente Encalada,102,55,47
49,Zamora,80,Fuentelapeña,658,349,309
49,Zamora,82,Fuentes de Ropel,366,194,172
49,Zamora,81,Fuentesaúco,1601,805,796
49,Zamora,83,Fuentesecas,48,26,22
49,Zamora,84,Fuentespreadas,281,155,126
49,Zamora,85,Galende,973,491,482
49,Zamora,86,Gallegos del Pan,111,63,48
49,Zamora,87,Gallegos del Río,478,268,210
49,Zamora,88,Gamones,94,53,41
49,Zamora,90,Gema,199,100,99
49,Zamora,91,Granja de Moreruela,259,132,127
49,Zamora,92,Granucillo,114,60,54
49,Zamora,93,Guarrate,315,166,149
49,Zamora,94,Hermisende,248,132,116
49,Zamora,95,"Hiniesta, La",309,166,143
49,Zamora,96,Jambrina,145,77,68
49,Zamora,97,Justel,69,46,23
49,Zamora,98,Losacino,203,112,91
49,Zamora,99,Losacio,86,52,34
49,Zamora,100,Lubián,305,161,144
49,Zamora,101,Luelmo,155,86,69
49,Zamora,102,"Maderal, El",175,94,81
49,Zamora,103,Madridanos,467,243,224
49,Zamora,104,Mahide,310,171,139
49,Zamora,105,Maire de Castroponce,139,75,64
49,Zamora,107,Malva,113,51,62
49,Zamora,108,Manganeses de la Lampreana,454,236,218
49,Zamora,109,Manganeses de la Polvorosa,623,303,320
49,Zamora,110,Manzanal de Arriba,345,184,161
49,Zamora,112,Manzanal de los Infantes,130,71,59
49,Zamora,111,Manzanal del Barco,134,70,64
49,Zamora,113,Matilla de Arzón,163,96,67
49,Zamora,114,Matilla la Seca,36,20,16
49,Zamora,115,Mayalde,169,96,73
49,Zamora,116,Melgar de Tera,344,180,164
49,Zamora,117,Micereces de Tera,438,225,213
49,Zamora,118,Milles de la Polvorosa,204,113,91
49,Zamora,119,Molacillos,241,133,108
49,Zamora,120,Molezuelas de la Carballeda,51,26,25
49,Zamora,121,Mombuey,403,217,186
49,Zamora,122,Monfarracinos,978,512,466
49,Zamora,123,Montamarta,558,300,258
49,Zamora,124,Moral de Sayago,258,150,108
49,Zamora,126,Moraleja de Sayago,290,143,147
49,Zamora,125,Moraleja del Vino,1756,885,871
49,Zamora,128,Morales de Rey,556,275,281
49,Zamora,129,Morales de Toro,943,488,455
49,Zamora,130,Morales de Valverde,165,84,81
49,Zamora,127,Morales del Vino,3060,1600,1460
49,Zamora,131,Moralina,227,119,108
49,Zamora,132,Moreruela de los Infanzones,326,167,159
49,Zamora,133,Moreruela de Tábara,302,159,143
49,Zamora,134,Muelas de los Caballeros,181,105,76
49,Zamora,135,Muelas del Pan,588,316,272
49,Zamora,136,Muga de Sayago,340,169,171
49,Zamora,137,Navianos de Valverde,171,98,73
49,Zamora,138,Olmillos de Castro,207,110,97
49,Zamora,139,Otero de Bodas,149,78,71
49,Zamora,141,Pajares de la Lampreana,287,149,138
49,Zamora,143,Palacios de Sanabria,246,125,121
49,Zamora,142,Palacios del Pan,252,134,118
49,Zamora,145,Pedralba de la Pradería,212,118,94
49,Zamora,146,"Pego, El",290,145,145
49,Zamora,147,Peleagonzalo,270,134,136
49,Zamora,148,Peleas de Abajo,252,115,137
49,Zamora,149,Peñausende,361,188,173
49,Zamora,150,Peque,130,56,74
49,Zamora,151,"Perdigón, El",639,337,302
49,Zamora,152,Pereruela,521,282,239
49,Zamora,153,Perilla de Castro,164,90,74
49,Zamora,154,Pías,109,63,46
49,Zamora,155,Piedrahita de Castro,106,58,48
49,Zamora,156,Pinilla de Toro,200,103,97
49,Zamora,157,Pino del Oro,180,93,87
49,Zamora,158,"Piñero, El",220,112,108
49,Zamora,160,Pobladura de Valderaduey,37,21,16
49,Zamora,159,Pobladura del Valle,288,156,132
49,Zamora,162,Porto,160,90,70
49,Zamora,163,Pozoantiguo,187,97,90
49,Zamora,164,Pozuelo de Tábara,154,85,69
49,Zamora,165,Prado,47,27,20
49,Zamora,166,Puebla de Sanabria,1357,659,698
49,Zamora,167,Pueblica de Valverde,182,96,86
49,Zamora,170,Quintanilla de Urz,109,55,54
49,Zamora,168,Quintanilla del Monte,104,61,43
49,Zamora,169,Quintanilla del Olmo,44,25,19
49,Zamora,171,Quiruelas de Vidriales,647,345,302
49,Zamora,172,Rabanales,502,267,235
49,Zamora,173,Rábano de Aliste,328,164,164
49,Zamora,174,Requejo,130,71,59
49,Zamora,175,Revellinos,252,130,122
49,Zamora,176,Riofrío de Aliste,632,352,280
49,Zamora,177,Rionegro del Puente,244,131,113
49,Zamora,178,Roales,1001,518,483
49,Zamora,179,Robleda-Cervantes,395,212,183
49,Zamora,180,Roelos de Sayago,138,69,69
49,Zamora,181,Rosinos de la Requejada,322,171,151
49,Zamora,183,Salce,89,38,51
49,Zamora,184,Samir de los Caños,163,92,71
49,Zamora,185,San Agustín del Pozo,175,87,88
49,Zamora,186,San Cebrián de Castro,253,124,129
49,Zamora,187,San Cristóbal de Entreviñas,1375,725,650
49,Zamora,188,San Esteban del Molar,108,64,44
49,Zamora,189,San Justo,197,103,94
49,Zamora,190,San Martín de Valderaduey,57,32,25
49,Zamora,191,San Miguel de la Ribera,275,141,134
49,Zamora,192,San Miguel del Valle,119,64,55
49,Zamora,193,San Pedro de Ceque,439,231,208
49,Zamora,194,San Pedro de la Nave-Almendra,336,176,160
49,Zamora,208,San Vicente de la Cabeza,336,180,156
49,Zamora,209,San Vitero,449,259,190
49,Zamora,197,Santa Clara de Avedillo,163,79,84
49,Zamora,199,Santa Colomba de las Monjas,246,123,123
49,Zamora,200,Santa Cristina de la Polvorosa,1066,548,518
49,Zamora,201,Santa Croya de Tera,291,148,143
49,Zamora,202,Santa Eufemia del Barco,174,103,71
49,Zamora,203,Santa María de la Vega,286,146,140
49,Zamora,204,Santa María de Valverde,58,28,30
49,Zamora,205,Santibáñez de Tera,360,181,179
49,Zamora,206,Santibáñez de Vidriales,889,452,437
49,Zamora,207,Santovenia,231,121,110
49,Zamora,210,Sanzoles,467,240,227
49,Zamora,214,Tábara,743,368,375
49,Zamora,216,Tapioles,137,79,58
49,Zamora,219,Toro,8448,4131,4317
49,Zamora,220,"Torre del Valle, La",137,77,60
49,Zamora,221,Torregamones,240,125,115
49,Zamora,222,Torres del Carrizal,415,213,202
49,Zamora,223,Trabazos,855,453,402
49,Zamora,224,Trefacio,185,103,82
49,Zamora,225,Uña de Quintana,132,71,61
49,Zamora,226,Vadillo de la Guareña,251,142,109
49,Zamora,227,Valcabado,391,204,187
49,Zamora,228,Valdefinjas,61,37,24
49,Zamora,229,Valdescorriel,130,68,62
49,Zamora,230,Vallesa de la Guareña,69,38,31
49,Zamora,231,Vega de Tera,311,158,153
49,Zamora,232,Vega de Villalobos,85,34,51
49,Zamora,233,Vegalatrave,81,43,38
49,Zamora,234,Venialbo,415,221,194
49,Zamora,235,Vezdemarbán,444,233,211
49,Zamora,236,Vidayanes,82,41,41
49,Zamora,237,Videmala,142,71,71
49,Zamora,238,Villabrázaro,239,126,113
49,Zamora,239,Villabuena del Puente,599,308,291
49,Zamora,240,Villadepera,183,99,84
49,Zamora,241,Villaescusa,235,127,108
49,Zamora,242,Villafáfila,458,234,224
49,Zamora,243,Villaferrueña,107,56,51
49,Zamora,244,Villageriz,45,26,19
49,Zamora,245,Villalazán,254,128,126
49,Zamora,246,Villalba de la Lampreana,229,130,99
49,Zamora,247,Villalcampo,400,203,197
49,Zamora,248,Villalobos,224,119,105
49,Zamora,249,Villalonso,70,32,38
49,Zamora,250,Villalpando,1436,699,737
49,Zamora,251,Villalube,158,85,73
49,Zamora,252,Villamayor de Campos,321,167,154
49,Zamora,255,Villamor de los Escuderos,382,203,179
49,Zamora,256,Villanázar,274,147,127
49,Zamora,257,Villanueva de Azoague,356,186,170
49,Zamora,258,Villanueva de Campeán,119,63,56
49,Zamora,259,Villanueva de las Peras,86,42,44
49,Zamora,260,Villanueva del Campo,787,389,398
49,Zamora,263,Villar de Fallaves,46,27,19
49,Zamora,264,Villar del Buey,529,278,251
49,Zamora,261,Villaralbo,1763,897,866
49,Zamora,262,Villardeciervos,400,200,200
49,Zamora,265,Villardiegua de la Ribera,114,63,51
49,Zamora,266,Villárdiga,73,42,31
49,Zamora,267,Villardondiego,125,72,53
49,Zamora,268,Villarrín de Campos,392,207,185
49,Zamora,269,Villaseco del Pan,222,105,117
49,Zamora,270,Villavendimio,152,93,59
49,Zamora,272,Villaveza de Valverde,70,36,34
49,Zamora,271,Villaveza del Agua,174,92,82
49,Zamora,273,Viñas,160,87,73
49,Zamora,275,Zamora,59475,27529,31946
50,Zaragoza,1,Abanto,89,55,34
50,Zaragoza,2,Acered,138,78,60
50,Zaragoza,3,Agón,139,79,60
50,Zaragoza,4,Aguarón,610,324,286
50,Zaragoza,5,Aguilón,244,138,106
50,Zaragoza,6,Ainzón,1066,551,515
50,Zaragoza,7,Aladrén,59,39,20
50,Zaragoza,8,Alagón,7178,3602,3576
50,Zaragoza,9,Alarba,104,59,45
50,Zaragoza,10,Alberite de San Juan,78,44,34
50,Zaragoza,11,Albeta,144,71,73
50,Zaragoza,12,Alborge,111,60,51
50,Zaragoza,13,Alcalá de Ebro,239,114,125
50,Zaragoza,14,Alcalá de Moncayo,157,88,69
50,Zaragoza,15,Alconchel de Ariza,80,47,33
50,Zaragoza,16,Aldehuela de Liestos,52,38,14
50,Zaragoza,17,Alfajarín,2434,1238,1196
50,Zaragoza,18,Alfamén,1477,764,713
50,Zaragoza,19,Alforque,64,38,26
50,Zaragoza,20,Alhama de Aragón,964,508,456
50,Zaragoza,21,Almochuel,22,12,10
50,Zaragoza,22,"Almolda, La",549,272,277
50,Zaragoza,23,Almonacid de la Cuba,234,117,117
50,Zaragoza,24,Almonacid de la Sierra,756,429,327
50,Zaragoza,25,"Almunia de Doña Godina, La",7943,4135,3808
50,Zaragoza,26,Alpartir,602,318,284
50,Zaragoza,27,Ambel,253,127,126
50,Zaragoza,28,Anento,101,71,30
50,Zaragoza,29,Aniñón,659,342,317
50,Zaragoza,30,Añón de Moncayo,202,119,83
50,Zaragoza,31,Aranda de Moncayo,132,83,49
50,Zaragoza,32,Arándiga,287,155,132
50,Zaragoza,33,Ardisa,74,47,27
50,Zaragoza,34,Ariza,1045,533,512
50,Zaragoza,35,Artieda,82,47,35
50,Zaragoza,36,Asín,104,57,47
50,Zaragoza,37,Atea,141,84,57
50,Zaragoza,38,Ateca,1690,872,818
50,Zaragoza,39,Azuara,539,301,238
50,Zaragoza,40,Badules,74,41,33
50,Zaragoza,41,Bagüés,15,7,8
50,Zaragoza,42,Balconchán,18,6,12
50,Zaragoza,43,Bárboles,297,168,129
50,Zaragoza,44,Bardallur,249,123,126
50,Zaragoza,45,Belchite,1533,768,765
50,Zaragoza,46,Belmonte de Gracián,183,100,83
50,Zaragoza,47,Berdejo,42,29,13
50,Zaragoza,48,Berrueco,32,19,13
50,Zaragoza,901,Biel,170,102,68
50,Zaragoza,50,Bijuesca,89,62,27
50,Zaragoza,51,Biota,874,443,431
50,Zaragoza,52,Bisimbre,80,43,37
50,Zaragoza,53,Boquiñeni,790,398,392
50,Zaragoza,54,Bordalba,49,30,19
50,Zaragoza,55,Borja,5054,2601,2453
50,Zaragoza,56,Botorrita,526,289,237
50,Zaragoza,57,Brea de Aragón,1547,779,768
50,Zaragoza,58,Bubierca,60,30,30
50,Zaragoza,59,Bujaraloz,1013,526,487
50,Zaragoza,60,Bulbuente,244,132,112
50,Zaragoza,61,Bureta,213,110,103
50,Zaragoza,62,"Burgo de Ebro, El",2591,1294,1297
50,Zaragoza,63,"Buste, El",71,41,30
50,Zaragoza,64,Cabañas de Ebro,491,256,235
50,Zaragoza,65,Cabolafuente,49,28,21
50,Zaragoza,66,Cadrete,4473,2355,2118
50,Zaragoza,67,Calatayud,19776,9734,10042
50,Zaragoza,68,Calatorao,2882,1502,1380
50,Zaragoza,69,Calcena,74,43,31
50,Zaragoza,70,Calmarza,63,35,28
50,Zaragoza,71,Campillo de Aragón,127,74,53
50,Zaragoza,72,Carenas,178,101,77
50,Zaragoza,73,Cariñena,3345,1686,1659
50,Zaragoza,74,Caspe,10220,5402,4818
50,Zaragoza,75,Castejón de Alarba,73,47,26
50,Zaragoza,76,Castejón de las Armas,81,43,38
50,Zaragoza,77,Castejón de Valdejasa,209,102,107
50,Zaragoza,78,Castiliscar,230,118,112
50,Zaragoza,79,Cervera de la Cañada,264,146,118
50,Zaragoza,80,Cerveruela,39,25,14
50,Zaragoza,81,Cetina,570,285,285
50,Zaragoza,92,Chiprana,515,267,248
50,Zaragoza,93,Chodes,96,53,43
50,Zaragoza,82,Cimballa,86,42,44
50,Zaragoza,83,Cinco Olivas,102,50,52
50,Zaragoza,84,Clarés de Ribota,71,39,32
50,Zaragoza,85,Codo,208,109,99
50,Zaragoza,86,Codos,232,156,76
50,Zaragoza,87,Contamina,31,18,13
50,Zaragoza,88,Cosuenda,326,167,159
50,Zaragoza,89,Cuarte de Huerva,14169,7218,6951
50,Zaragoza,90,Cubel,153,72,81
50,Zaragoza,91,"Cuerlas, Las",39,21,18
50,Zaragoza,94,Daroca,1921,943,978
50,Zaragoza,95,Ejea de los Caballeros,17124,8835,8289
50,Zaragoza,96,Embid de Ariza,31,18,13
50,Zaragoza,98,Encinacorba,185,95,90
50,Zaragoza,99,Épila,4447,2287,2160
50,Zaragoza,100,Erla,360,183,177
50,Zaragoza,101,Escatrón,1156,579,577
50,Zaragoza,102,Fabara,1088,594,494
50,Zaragoza,104,Farlete,376,186,190
50,Zaragoza,105,Fayón,397,219,178
50,Zaragoza,106,"Fayos, Los",131,72,59
50,Zaragoza,107,Figueruelas,1226,607,619
50,Zaragoza,108,Fombuena,59,35,24
50,Zaragoza,109,"Frago, El",117,74,43
50,Zaragoza,110,"Frasno, El",379,205,174
50,Zaragoza,111,Fréscano,204,114,90
50,Zaragoza,113,Fuendejalón,763,414,349
50,Zaragoza,114,Fuendetodos,144,82,62
50,Zaragoza,115,Fuentes de Ebro,4613,2387,2226
50,Zaragoza,116,Fuentes de Jiloca,208,117,91
50,Zaragoza,117,Gallocanta,120,67,53
50,Zaragoza,118,Gallur,2563,1300,1263
50,Zaragoza,119,Gelsa,1007,533,474
50,Zaragoza,120,Godojos,49,27,22
50,Zaragoza,121,Gotor,290,148,142
50,Zaragoza,122,Grisel,82,49,33
50,Zaragoza,123,Grisén,623,323,300
50,Zaragoza,124,Herrera de los Navarros,523,290,233
50,Zaragoza,125,Ibdes,384,201,183
50,Zaragoza,126,Illueca,2746,1390,1356
50,Zaragoza,128,Isuerre,33,17,16
50,Zaragoza,129,Jaraba,280,157,123
50,Zaragoza,130,Jarque de Moncayo,407,214,193
50,Zaragoza,131,Jaulín,278,150,128
50,Zaragoza,132,"Joyosa, La",1119,566,553
50,Zaragoza,133,Lagata,109,58,51
50,Zaragoza,134,Langa del Castillo,115,60,55
50,Zaragoza,135,Layana,96,56,40
50,Zaragoza,136,Lécera,634,338,296
50,Zaragoza,138,Lechón,47,28,19
50,Zaragoza,137,Leciñena,1116,567,549
50,Zaragoza,139,Letux,337,181,156
50,Zaragoza,140,Litago,194,113,81
50,Zaragoza,141,Lituénigo,121,64,57
50,Zaragoza,142,Lobera de Onsella,26,14,12
50,Zaragoza,143,Longares,882,537,345
50,Zaragoza,144,Longás,42,27,15
50,Zaragoza,146,Lucena de Jalón,226,124,102
50,Zaragoza,147,Luceni,973,485,488
50,Zaragoza,148,Luesia,333,179,154
50,Zaragoza,149,Luesma,38,21,17
50,Zaragoza,150,Lumpiaque,841,446,395
50,Zaragoza,151,Luna,694,363,331
50,Zaragoza,152,Maella,2097,1153,944
50,Zaragoza,153,Magallón,1118,576,542
50,Zaragoza,154,Mainar,170,95,75
50,Zaragoza,155,Malanquilla,90,56,34
50,Zaragoza,156,Maleján,262,137,125
50,Zaragoza,160,Mallén,2937,1512,1425
50,Zaragoza,157,Malón,392,192,200
50,Zaragoza,159,Maluenda,905,454,451
50,Zaragoza,161,Manchones,103,56,47
50,Zaragoza,162,Mara,168,84,84
50,Zaragoza,163,María de Huerva,6168,3101,3067
50,Zaragoza,902,Marracos,91,47,44
50,Zaragoza,164,Mediana de Aragón,457,227,230
50,Zaragoza,165,Mequinenza,2294,1162,1132
50,Zaragoza,166,Mesones de Isuela,272,139,133
50,Zaragoza,167,Mezalocha,232,127,105
50,Zaragoza,168,Mianos,28,15,13
50,Zaragoza,169,Miedes de Aragón,424,225,199
50,Zaragoza,170,Monegrillo,393,216,177
50,Zaragoza,171,Moneva,115,69,46
50,Zaragoza,172,Monreal de Ariza,193,114,79
50,Zaragoza,173,Monterde,133,87,46
50,Zaragoza,174,Montón,86,55,31
50,Zaragoza,175,Morata de Jalón,1101,546,555
50,Zaragoza,176,Morata de Jiloca,250,146,104
50,Zaragoza,177,Morés,332,174,158
50,Zaragoza,178,Moros,299,155,144
50,Zaragoza,179,Moyuela,251,141,110
50,Zaragoza,180,Mozota,123,65,58
50,Zaragoza,181,Muel,1479,759,720
50,Zaragoza,182,"Muela, La",6247,3245,3002
50,Zaragoza,183,Munébrega,356,193,163
50,Zaragoza,184,Murero,104,59,45
50,Zaragoza,185,Murillo de Gállego,197,114,83
50,Zaragoza,186,Navardún,35,21,14
50,Zaragoza,187,Nigüella,59,37,22
50,Zaragoza,188,Nombrevilla,35,21,14
50,Zaragoza,189,Nonaspe,1011,544,467
50,Zaragoza,190,Novallas,845,450,395
50,Zaragoza,191,Novillas,514,256,258
50,Zaragoza,192,Nuévalos,279,154,125
50,Zaragoza,193,Nuez de Ebro,889,453,436
50,Zaragoza,194,Olvés,110,61,49
50,Zaragoza,195,Orcajo,57,36,21
50,Zaragoza,196,Orera,116,60,56
50,Zaragoza,197,Orés,95,59,36
50,Zaragoza,198,Oseja,52,34,18
50,Zaragoza,199,Osera de Ebro,413,212,201
50,Zaragoza,200,Paniza,604,326,278
50,Zaragoza,201,Paracuellos de Jiloca,582,304,278
50,Zaragoza,202,Paracuellos de la Ribera,129,72,57
50,Zaragoza,203,Pastriz,1300,636,664
50,Zaragoza,204,Pedrola,3625,1869,1756
50,Zaragoza,205,"Pedrosas, Las",97,48,49
50,Zaragoza,206,Perdiguera,553,297,256
50,Zaragoza,207,Piedratajada,91,52,39
50,Zaragoza,208,Pina de Ebro,2433,1239,1194
50,Zaragoza,209,Pinseque,4278,2188,2090
50,Zaragoza,210,"Pintanos, Los",37,25,12
50,Zaragoza,211,Plasencia de Jalón,325,177,148
50,Zaragoza,212,Pleitas,38,16,22
50,Zaragoza,213,Plenas,100,54,46
50,Zaragoza,214,Pomer,26,19,7
50,Zaragoza,215,Pozuel de Ariza,24,13,11
50,Zaragoza,216,Pozuelo de Aragón,263,137,126
50,Zaragoza,217,Pradilla de Ebro,541,297,244
50,Zaragoza,218,Puebla de Albortón,129,76,53
50,Zaragoza,219,"Puebla de Alfindén, La",6442,3289,3153
50,Zaragoza,220,Puendeluna,48,30,18
50,Zaragoza,221,Purujosa,27,17,10
50,Zaragoza,222,Quinto,1916,976,940
50,Zaragoza,223,Remolinos,1035,525,510
50,Zaragoza,224,Retascón,60,32,28
50,Zaragoza,225,Ricla,2932,1585,1347
50,Zaragoza,227,Romanos,119,64,55
50,Zaragoza,228,Rueda de Jalón,317,168,149
50,Zaragoza,229,Ruesca,69,31,38
50,Zaragoza,241,Sabiñán,675,355,320
50,Zaragoza,230,Sádaba,1291,656,635
50,Zaragoza,231,Salillas de Jalón,355,175,180
50,Zaragoza,232,Salvatierra de Esca,199,99,100
50,Zaragoza,233,Samper del Salz,96,50,46
50,Zaragoza,234,San Martín de la Virgen de Moncayo,283,162,121
50,Zaragoza,235,San Mateo de Gállego,3452,1766,1686
50,Zaragoza,236,Santa Cruz de Grío,94,63,31
50,Zaragoza,237,Santa Cruz de Moncayo,125,68,57
50,Zaragoza,238,Santa Eulalia de Gállego,102,59,43
50,Zaragoza,239,Santed,66,42,24
50,Zaragoza,240,Sástago,1093,551,542
50,Zaragoza,242,Sediles,106,61,45
50,Zaragoza,243,Sestrica,349,199,150
50,Zaragoza,244,Sierra de Luna,281,145,136
50,Zaragoza,245,Sigüés,73,39,34
50,Zaragoza,246,Sisamón,45,27,18
50,Zaragoza,247,Sobradiel,1143,538,605
50,Zaragoza,248,Sos del Rey Católico,568,301,267
50,Zaragoza,249,Tabuenca,310,188,122
50,Zaragoza,250,Talamantes,64,33,31
50,Zaragoza,251,Tarazona,10565,5261,5304
50,Zaragoza,252,Tauste,6817,3405,3412
50,Zaragoza,253,Terrer,565,314,251
50,Zaragoza,254,Tierga,179,101,78
50,Zaragoza,255,Tobed,215,120,95
50,Zaragoza,256,Torralba de los Frailes,73,40,33
50,Zaragoza,257,Torralba de Ribota,168,93,75
50,Zaragoza,258,Torralbilla,51,33,18
50,Zaragoza,259,Torrehermosa,70,34,36
50,Zaragoza,260,Torrelapaja,35,24,11
50,Zaragoza,261,Torrellas,236,122,114
50,Zaragoza,262,Torres de Berrellén,1476,768,708
50,Zaragoza,263,Torrijo de la Cañada,201,118,83
50,Zaragoza,264,Tosos,162,95,67
50,Zaragoza,265,Trasmoz,89,45,44
50,Zaragoza,266,Trasobares,125,74,51
50,Zaragoza,267,Uncastillo,628,295,333
50,Zaragoza,268,Undués de Lerda,52,30,22
50,Zaragoza,269,Urrea de Jalón,448,250,198
50,Zaragoza,270,Urriés,49,24,25
50,Zaragoza,271,Used,269,144,125
50,Zaragoza,272,Utebo,18881,9376,9505
50,Zaragoza,274,Val de San Martín,60,36,24
50,Zaragoza,273,Valdehorna,27,15,12
50,Zaragoza,275,Valmadrid,110,67,43
50,Zaragoza,276,Valpalmas,134,64,70
50,Zaragoza,277,Valtorres,64,33,31
50,Zaragoza,278,Velilla de Ebro,200,107,93
50,Zaragoza,279,Velilla de Jiloca,71,35,36
50,Zaragoza,280,Vera de Moncayo,316,169,147
50,Zaragoza,281,Vierlas,80,45,35
50,Zaragoza,283,Villadoz,90,49,41
50,Zaragoza,284,Villafeliche,154,92,62
50,Zaragoza,285,Villafranca de Ebro,848,427,421
50,Zaragoza,286,Villalba de Perejil,100,46,54
50,Zaragoza,287,Villalengua,287,156,131
50,Zaragoza,903,Villamayor de Gállego,2827,1426,1401
50,Zaragoza,288,Villanueva de Gállego,4769,2389,2380
50,Zaragoza,290,Villanueva de Huerva,389,210,179
50,Zaragoza,289,Villanueva de Jiloca,68,33,35
50,Zaragoza,291,Villar de los Navarros,141,77,64
50,Zaragoza,292,Villarreal de Huerva,266,149,117
50,Zaragoza,293,Villarroya de la Sierra,435,231,204
50,Zaragoza,294,Villarroya del Campo,82,47,35
50,Zaragoza,282,"Vilueña, La",65,33,32
50,Zaragoza,295,Vistabella,52,31,21
50,Zaragoza,296,"Zaida, La",435,222,213
50,Zaragoza,297,Zaragoza,673010,321957,351053
50,Zaragoza,298,Zuera,8632,4423,4209
