CPRO,PROVINCIA,CMUN,NOMBRE,POB21,HOMBRES,MUJERES
2,Albacete,1,Abengibre,748,365,383
2,Albacete,2,Alatoz,496,272,224
2,Albacete,3,Albacete,172722,84365,88357
2,Albacete,4,Albatana,681,354,327
2,Albacete,5,Alborea,670,350,320
2,Albacete,6,Alcadozo,632,344,288
2,Albacete,7,Alcalá del Júcar,1153,621,532
2,Albacete,8,Alcaraz,1310,682,628
2,Albacete,9,Almansa,24388,12127,12261
2,Albacete,10,Alpera,2285,1189,1096
2,Albacete,11,Ayna,582,314,268
2,Albacete,12,Balazote,2363,1208,1155
2,Albacete,14,"Ballestero, El",413,217,196
2,Albacete,13,Balsa de Ves,129,73,56
2,Albacete,15,Barrax,1808,926,882
2,Albacete,16,Bienservida,595,319,276
2,Albacete,17,Bogarra,768,400,368
2,Albacete,18,Bonete,1031,536,495
2,Albacete,19,"Bonillo, El",2718,1376,1342
2,Albacete,20,Carcelén,496,265,231
2,Albacete,21,Casas de Juan Núñez,1361,729,632
2,Albacete,22,Casas de Lázaro,328,179,149
2,Albacete,23,Casas de Ves,564,295,269
2,Albacete,24,Casas-Ibáñez,4540,2274,2266
2,Albacete,25,Caudete,10077,5135,4942
2,Albacete,26,Cenizate,1186,594,592
2,Albacete,29,Chinchilla de Monte-Aragón,4344,2261,2083
2,Albacete,27,Corral-Rubio,306,165,141
2,Albacete,28,Cotillas,134,71,63
2,Albacete,30,Elche de la Sierra,3557,1745,1812
2,Albacete,31,Férez,628,309,319
2,Albacete,32,Fuensanta,280,159,121
2,Albacete,33,Fuente-Álamo,2447,1280,1167
2,Albacete,34,Fuentealbilla,1836,942,894
2,Albacete,35,"Gineta, La",2554,1321,1233
2,Albacete,36,Golosalvo,99,52,47
2,Albacete,37,Hellín,30427,15281,15146
2,Albacete,38,"Herrera, La",311,161,150
2,Albacete,39,Higueruela,1144,599,545
2,Albacete,40,Hoya-Gonzalo,598,322,276
2,Albacete,41,Jorquera,363,196,167
2,Albacete,42,Letur,909,444,465
2,Albacete,43,Lezuza,1322,684,638
2,Albacete,44,Liétor,1123,585,538
2,Albacete,45,Madrigueras,4654,2379,2275
2,Albacete,46,Mahora,1380,709,671
2,Albacete,47,Masegoso,105,61,44
2,Albacete,48,Minaya,1483,764,719
2,Albacete,49,Molinicos,829,430,399
2,Albacete,50,Montalvos,86,48,38
2,Albacete,51,Montealegre del Castillo,2038,1054,984
2,Albacete,52,Motilleja,605,330,275
2,Albacete,53,Munera,3433,1769,1664
2,Albacete,54,Navas de Jorquera,536,281,255
2,Albacete,55,Nerpio,1197,660,537
2,Albacete,56,Ontur,1963,990,973
2,Albacete,57,Ossa de Montiel,2241,1127,1114
2,Albacete,58,Paterna del Madera,323,178,145
2,Albacete,60,Peñas de San Pedro,1410,827,583
2,Albacete,59,Peñascosa,320,176,144
2,Albacete,61,Pétrola,676,356,320
2,Albacete,62,Povedilla,401,220,181
2,Albacete,901,Pozo Cañada,2797,1422,1375
2,Albacete,63,Pozohondo,1584,826,758
2,Albacete,64,Pozo-Lorente,394,204,190
2,Albacete,65,Pozuelo,465,250,215
2,Albacete,66,"Recueja, La",225,128,97
2,Albacete,67,Riópar,1326,684,642
2,Albacete,68,Robledo,391,211,180
2,Albacete,69,"Roda, La",15401,7794,7607
2,Albacete,70,Salobre,461,242,219
2,Albacete,71,San Pedro,1148,594,554
2,Albacete,72,Socovos,1750,902,848
2,Albacete,73,Tarazona de la Mancha,6184,3169,3015
2,Albacete,74,Tobarra,7691,3974,3717
2,Albacete,75,Valdeganga,1947,997,950
2,Albacete,76,Vianos,327,171,156
2,Albacete,77,Villa de Ves,62,36,26
2,Albacete,78,Villalgordo del Júcar,1081,577,504
2,Albacete,79,Villamalea,4040,2062,1978
2,Albacete,80,Villapalacios,556,285,271
2,Albacete,81,Villarrobledo,24978,12350,12628
2,Albacete,82,Villatoya,108,63,45
2,Albacete,83,Villavaliente,214,131,83
2,Albacete,84,Villaverde de Guadalimar,333,182,151
2,Albacete,85,Viveros,328,172,156
2,Albacete,86,Yeste,2567,1334,1233
3,Alicante/Alacant,2,Agost,4906,2474,2432
3,Alicante/Alacant,3,Agres,580,319,261
3,Alicante/Alacant,4,Aigües,1049,544,505
3,Alicante/Alacant,5,Albatera,12714,6420,6294
3,Alicante/Alacant,6,Alcalalí,1336,667,669
3,Alicante/Alacant,7,Alcocer de Planes,243,118,125
3,Alicante/Alacant,8,Alcoleja,181,100,81
3,Alicante/Alacant,9,Alcoy/Alcoi,59128,28964,30164
3,Alicante/Alacant,10,Alfafara,408,195,213
3,Alicante/Alacant,11,"Alfàs del Pi, l'",20495,10144,10351
3,Alicante/Alacant,12,Algorfa,3396,1731,1665
3,Alicante/Alacant,13,Algueña,1334,672,662
3,Alicante/Alacant,14,Alicante/Alacant,337304,163052,174252
3,Alicante/Alacant,15,Almoradí,21404,10773,10631
3,Alicante/Alacant,16,Almudaina,117,56,61
3,Alicante/Alacant,17,"Alqueria d'Asnar, l'",498,246,252
3,Alicante/Alacant,18,Altea,22657,11117,11540
3,Alicante/Alacant,19,Aspe,21088,10612,10476
3,Alicante/Alacant,1,"Atzúbia, l'",609,315,294
3,Alicante/Alacant,20,Balones,134,71,63
3,Alicante/Alacant,21,Banyeres de Mariola,7113,3572,3541
3,Alicante/Alacant,22,Benasau,170,79,91
3,Alicante/Alacant,23,Beneixama,1707,861,846
3,Alicante/Alacant,24,Benejúzar,5453,2736,2717
3,Alicante/Alacant,25,Benferri,1958,1010,948
3,Alicante/Alacant,26,Beniarbeig,2227,1143,1084
3,Alicante/Alacant,27,Beniardá,192,96,96
3,Alicante/Alacant,28,Beniarrés,1083,557,526
3,Alicante/Alacant,30,Benidoleig,1166,585,581
3,Alicante/Alacant,31,Benidorm,69118,34455,34663
3,Alicante/Alacant,32,Benifallim,103,56,47
3,Alicante/Alacant,33,Benifato,135,70,65
3,Alicante/Alacant,29,Benigembla,483,239,244
3,Alicante/Alacant,34,Benijófar,3323,1614,1709
3,Alicante/Alacant,35,Benilloba,737,392,345
3,Alicante/Alacant,36,Benillup,101,54,47
3,Alicante/Alacant,37,Benimantell,501,259,242
3,Alicante/Alacant,38,Benimarfull,397,203,194
3,Alicante/Alacant,39,Benimassot,97,55,42
3,Alicante/Alacant,40,Benimeli,415,189,226
3,Alicante/Alacant,41,Benissa,11462,5626,5836
3,Alicante/Alacant,42,"Benitachell/Poble Nou de Benitatxell, el",4447,2220,2227
3,Alicante/Alacant,43,Biar,3628,1776,1852
3,Alicante/Alacant,44,Bigastro,6994,3514,3480
3,Alicante/Alacant,45,Bolulla,426,222,204
3,Alicante/Alacant,46,Busot,3207,1628,1579
3,Alicante/Alacant,49,Callosa de Segura,19273,9835,9438
3,Alicante/Alacant,48,Callosa d'en Sarrià,7589,3919,3670
3,Alicante/Alacant,47,Calp,23530,11801,11729
3,Alicante/Alacant,50,"Campello, el",29013,14086,14927
3,Alicante/Alacant,51,"Campo de Mirra/Camp de Mirra, el",429,217,212
3,Alicante/Alacant,52,Cañada,1191,590,601
3,Alicante/Alacant,53,Castalla,10752,5484,5268
3,Alicante/Alacant,54,Castell de Castells,425,226,199
3,Alicante/Alacant,75,"Castell de Guadalest, el",243,118,125
3,Alicante/Alacant,55,Catral,8880,4450,4430
3,Alicante/Alacant,56,Cocentaina,11451,5783,5668
3,Alicante/Alacant,57,Confrides,271,147,124
3,Alicante/Alacant,58,Cox,7427,3768,3659
3,Alicante/Alacant,59,Crevillent,29717,15038,14679
3,Alicante/Alacant,61,Daya Nueva,1757,856,901
3,Alicante/Alacant,62,Daya Vieja,707,352,355
3,Alicante/Alacant,63,Dénia,42953,20826,22127
3,Alicante/Alacant,64,Dolores,7620,3804,3816
3,Alicante/Alacant,65,Elche/Elx,234205,116222,117983
3,Alicante/Alacant,66,Elda,52551,25618,26933
3,Alicante/Alacant,67,Facheca,105,54,51
3,Alicante/Alacant,68,Famorca,45,24,21
3,Alicante/Alacant,69,Finestrat,7402,3798,3604
3,Alicante/Alacant,77,"Fondó de les Neus, el/Hondón de las Nieves",2634,1352,1282
3,Alicante/Alacant,70,Formentera del Segura,4337,2203,2134
3,Alicante/Alacant,72,Gaianes,505,248,257
3,Alicante/Alacant,71,Gata de Gorgos,6223,3172,3051
3,Alicante/Alacant,73,Gorga,261,141,120
3,Alicante/Alacant,74,Granja de Rocamora,2609,1353,1256
3,Alicante/Alacant,76,Guardamar del Segura,15983,7779,8204
3,Alicante/Alacant,78,Hondón de los Frailes,1299,658,641
3,Alicante/Alacant,79,Ibi,23652,11845,11807
3,Alicante/Alacant,80,Jacarilla,2030,1035,995
3,Alicante/Alacant,82,Jávea/Xàbia,27983,13977,14006
3,Alicante/Alacant,83,Jijona/Xixona,6861,3328,3533
3,Alicante/Alacant,85,Llíber,883,442,441
3,Alicante/Alacant,84,"Lorcha/Orxa, l'",584,290,294
3,Alicante/Alacant,86,Millena,242,130,112
3,Alicante/Alacant,88,Monforte del Cid,8500,4417,4083
3,Alicante/Alacant,89,Monóvar/Monòver,12188,6087,6101
3,Alicante/Alacant,903,"Montesinos, Los",5123,2624,2499
3,Alicante/Alacant,91,Murla,549,255,294
3,Alicante/Alacant,92,Muro de Alcoy,9326,4653,4673
3,Alicante/Alacant,90,Mutxamel,25679,12839,12840
3,Alicante/Alacant,93,Novelda,25611,12726,12885
3,Alicante/Alacant,94,"Nucia, la",18108,9220,8888
3,Alicante/Alacant,95,Ondara,7080,3564,3516
3,Alicante/Alacant,96,Onil,7569,3770,3799
3,Alicante/Alacant,97,Orba,2233,1092,1141
3,Alicante/Alacant,99,Orihuela,78940,39105,39835
3,Alicante/Alacant,98,Orxeta,787,397,390
3,Alicante/Alacant,100,Parcent,983,489,494
3,Alicante/Alacant,101,Pedreguer,8006,3989,4017
3,Alicante/Alacant,102,Pego,10240,5085,5155
3,Alicante/Alacant,103,Penàguila,275,141,134
3,Alicante/Alacant,104,Petrer,34009,16850,17159
3,Alicante/Alacant,902,Pilar de la Horadada,22597,11611,10986
3,Alicante/Alacant,105,"Pinós, el/Pinoso",8142,4126,4016
3,Alicante/Alacant,106,Planes,693,376,317
3,Alicante/Alacant,901,"Poblets, els",2721,1296,1425
3,Alicante/Alacant,107,Polop,5069,2573,2496
3,Alicante/Alacant,60,Quatretondeta,117,63,54
3,Alicante/Alacant,109,Rafal,4597,2275,2322
3,Alicante/Alacant,110,"Ràfol d'Almúnia, el",670,346,324
3,Alicante/Alacant,111,Redován,8058,4197,3861
3,Alicante/Alacant,112,Relleu,1173,601,572
3,Alicante/Alacant,113,Rojales,15978,8162,7816
3,Alicante/Alacant,114,"Romana, la",2542,1329,1213
3,Alicante/Alacant,115,Sagra,427,201,226
3,Alicante/Alacant,116,Salinas,1642,842,800
3,Alicante/Alacant,118,San Fulgencio,8447,4275,4172
3,Alicante/Alacant,904,San Isidro,2146,1117,1029
3,Alicante/Alacant,120,San Miguel de Salinas,6553,3284,3269
3,Alicante/Alacant,122,San Vicente del Raspeig/Sant Vicent del Raspeig,58912,29148,29764
3,Alicante/Alacant,117,Sanet y Negrals,702,348,354
3,Alicante/Alacant,119,Sant Joan d'Alacant,24363,11755,12608
3,Alicante/Alacant,121,Santa Pola,34148,17132,17016
3,Alicante/Alacant,123,Sax,9935,5012,4923
3,Alicante/Alacant,124,Sella,578,305,273
3,Alicante/Alacant,125,Senija,605,312,293
3,Alicante/Alacant,127,Tàrbena,642,338,304
3,Alicante/Alacant,128,Teulada,11466,5723,5743
3,Alicante/Alacant,129,Tibi,1691,892,799
3,Alicante/Alacant,130,Tollos,37,23,14
3,Alicante/Alacant,131,Tormos,327,156,171
3,Alicante/Alacant,132,"Torremanzanas/Torre de les Maçanes, la",681,355,326
3,Alicante/Alacant,133,Torrevieja,82842,40721,42121
3,Alicante/Alacant,134,"Vall d'Alcalà, la",163,90,73
3,Alicante/Alacant,136,Vall de Gallinera,557,293,264
3,Alicante/Alacant,137,"Vall de Laguar, la",843,419,424
3,Alicante/Alacant,135,"Vall d'Ebo, la",204,105,99
3,Alicante/Alacant,138,"Verger, el",4841,2412,2429
3,Alicante/Alacant,139,"Villajoyosa/Vila Joiosa, la",34684,17216,17468
3,Alicante/Alacant,140,Villena,34025,17068,16957
3,Alicante/Alacant,81,Xaló,2892,1448,1444
4,Almería,1,Abla,1258,646,612
4,Almería,2,Abrucena,1208,639,569
4,Almería,3,Adra,25501,13058,12443
4,Almería,4,Albanchez,726,379,347
4,Almería,5,Alboloduy,612,297,315
4,Almería,6,Albox,12070,6186,5884
4,Almería,7,Alcolea,849,438,411
4,Almería,8,Alcóntar,542,304,238
4,Almería,9,Alcudia de Monteagud,129,69,60
4,Almería,10,Alhabia,675,354,321
4,Almería,11,Alhama de Almería,3733,1872,1861
4,Almería,12,Alicún,204,103,101
4,Almería,13,Almería,200753,98141,102612
4,Almería,14,Almócita,197,104,93
4,Almería,15,Alsodux,131,79,52
4,Almería,16,Antas,3355,1743,1612
4,Almería,17,Arboleas,4685,2356,2329
4,Almería,18,Armuña de Almanzora,313,156,157
4,Almería,19,Bacares,249,135,114
4,Almería,904,Balanegra,2959,1568,1391
4,Almería,20,Bayárcal,317,173,144
4,Almería,21,Bayarque,219,101,118
4,Almería,22,Bédar,974,500,474
4,Almería,23,Beires,132,63,69
4,Almería,24,Benahadux,4526,2246,2280
4,Almería,26,Benitagla,59,33,26
4,Almería,27,Benizalón,263,148,115
4,Almería,28,Bentarique,239,132,107
4,Almería,29,Berja,12708,6508,6200
4,Almería,30,Canjáyar,1178,619,559
4,Almería,31,Cantoria,3547,1790,1757
4,Almería,32,Carboneras,8183,4205,3978
4,Almería,33,Castro de Filabres,115,61,54
4,Almería,36,Chercos,288,143,145
4,Almería,37,Chirivel,1501,769,732
4,Almería,34,Cóbdar,170,92,78
4,Almería,35,Cuevas del Almanzora,14623,7592,7031
4,Almería,38,Dalías,4102,2031,2071
4,Almería,902,"Ejido, El",84005,43349,40656
4,Almería,41,Enix,540,298,242
4,Almería,43,Felix,664,381,283
4,Almería,44,Fines,2160,1131,1029
4,Almería,45,Fiñana,1977,1001,976
4,Almería,46,Fondón,1032,533,499
4,Almería,47,Gádor,3008,1564,1444
4,Almería,48,"Gallardos, Los",3003,1517,1486
4,Almería,49,Garrucha,9875,5220,4655
4,Almería,50,Gérgal,1107,587,520
4,Almería,51,Huécija,491,244,247
4,Almería,52,Huércal de Almería,17974,9131,8843
4,Almería,53,Huércal-Overa,19744,9799,9945
4,Almería,54,Íllar,436,229,207
4,Almería,55,Instinción,462,239,223
4,Almería,56,Laroya,197,110,87
4,Almería,57,Láujar de Andarax,1591,802,789
4,Almería,58,Líjar,398,210,188
4,Almería,59,Lubrín,1489,759,730
4,Almería,60,Lucainena de las Torres,584,303,281
4,Almería,61,Lúcar,772,388,384
4,Almería,62,Macael,5449,2800,2649
4,Almería,63,María,1235,632,603
4,Almería,64,Mojácar,7257,3546,3711
4,Almería,903,"Mojonera, La",9086,5107,3979
4,Almería,65,Nacimiento,485,251,234
4,Almería,66,Níjar,31458,17679,13779
4,Almería,67,Ohanes,561,292,269
4,Almería,68,Olula de Castro,190,106,84
4,Almería,69,Olula del Río,6258,3201,3057
4,Almería,70,Oria,2215,1145,1070
4,Almería,71,Padules,436,237,199
4,Almería,72,Partaloa,1065,527,538
4,Almería,73,Paterna del Río,387,220,167
4,Almería,74,Pechina,4143,2102,2041
4,Almería,75,Pulpí,10342,5297,5045
4,Almería,76,Purchena,1636,854,782
4,Almería,77,Rágol,305,154,151
4,Almería,78,Rioja,1488,761,727
4,Almería,79,Roquetas de Mar,98725,50709,48016
4,Almería,80,Santa Cruz de Marchena,203,104,99
4,Almería,81,Santa Fe de Mondújar,477,257,220
4,Almería,82,Senés,291,162,129
4,Almería,83,Serón,2039,1044,995
4,Almería,84,Sierro,380,202,178
4,Almería,85,Somontín,444,221,223
4,Almería,86,Sorbas,2471,1285,1186
4,Almería,87,Suflí,197,111,86
4,Almería,88,Tabernas,3887,2014,1873
4,Almería,89,Taberno,996,488,508
4,Almería,90,Tahal,349,180,169
4,Almería,91,Terque,372,195,177
4,Almería,92,Tíjola,3528,1773,1755
4,Almería,901,"Tres Villas, Las",564,310,254
4,Almería,93,Turre,3892,2021,1871
4,Almería,94,Turrillas,260,146,114
4,Almería,95,Uleila del Campo,816,401,415
4,Almería,96,Urrácal,369,190,179
4,Almería,97,Velefique,235,132,103
4,Almería,98,Vélez-Blanco,1946,992,954
4,Almería,99,Vélez-Rubio,6521,3188,3333
4,Almería,100,Vera,17700,9009,8691
4,Almería,101,Viator,6039,3099,2940
4,Almería,102,Vícar,27398,14898,12500
4,Almería,103,Zurgena,2895,1466,1429
1,Araba/Álava,51,Agurain/Salvatierra,5029,2522,2507
1,Araba/Álava,1,Alegría-Dulantzi,2925,1517,1408
1,Araba/Álava,2,Amurrio,10307,5084,5223
1,Araba/Álava,49,Añana,155,94,61
1,Araba/Álava,3,Aramaio,1456,756,700
1,Araba/Álava,6,Armiñón,231,117,114
1,Araba/Álava,37,Arraia-Maeztu,800,447,353
1,Araba/Álava,8,Arratzua-Ubarrundia,1017,550,467
1,Araba/Álava,4,Artziniega,1809,888,921
1,Araba/Álava,9,Asparrena,1633,830,803
1,Araba/Álava,10,Ayala/Aiara,2951,1502,1449
1,Araba/Álava,11,Baños de Ebro/Mañueta,287,158,129
1,Araba/Álava,13,Barrundia,895,493,402
1,Araba/Álava,14,Berantevilla,465,242,223
1,Araba/Álava,16,Bernedo,538,314,224
1,Araba/Álava,17,Campezo/Kanpezu,1081,576,505
1,Araba/Álava,21,Elburgo/Burgelu,634,332,302
1,Araba/Álava,22,Elciego,996,499,497
1,Araba/Álava,23,Elvillar/Bilar,327,159,168
1,Araba/Álava,47,Erriberabeitia,1421,764,657
1,Araba/Álava,46,Erriberagoitia/Ribera Alta,826,475,351
1,Araba/Álava,56,Harana/Valle de Arana,226,125,101
1,Araba/Álava,901,Iruña Oka/Iruña de Oca,3468,1825,1643
1,Araba/Álava,27,Iruraiz-Gauna,529,290,239
1,Araba/Álava,19,Kripan,175,91,84
1,Araba/Álava,20,Kuartango,396,227,169
1,Araba/Álava,28,Labastida/Bastida,1532,789,743
1,Araba/Álava,30,Lagrán,171,97,74
1,Araba/Álava,31,Laguardia,1464,751,713
1,Araba/Álava,32,Lanciego/Lantziego,692,366,326
1,Araba/Álava,902,Lantarón,915,514,401
1,Araba/Álava,33,Lapuebla de Labarca,858,436,422
1,Araba/Álava,36,Laudio/Llodio,18009,8767,9242
1,Araba/Álava,58,Legutio,1993,1054,939
1,Araba/Álava,34,Leza,219,112,107
1,Araba/Álava,39,Moreda de Álava/Moreda Araba,209,107,102
1,Araba/Álava,41,Navaridas,197,111,86
1,Araba/Álava,42,Okondo,1196,626,570
1,Araba/Álava,43,Oyón-Oion,3418,1737,1681
1,Araba/Álava,44,Peñacerrada-Urizaharra,299,177,122
1,Araba/Álava,52,Samaniego,308,147,161
1,Araba/Álava,53,San Millán/Donemiliaga,716,389,327
1,Araba/Álava,54,Urkabustaiz,1414,733,681
1,Araba/Álava,55,Valdegovía/Gaubea,1049,568,481
1,Araba/Álava,57,Villabuena de Álava/Eskuernaga,287,148,139
1,Araba/Álava,59,Vitoria-Gasteiz,253093,123092,130001
1,Araba/Álava,60,Yécora/Iekora,266,135,131
1,Araba/Álava,61,Zalduondo,192,105,87
1,Araba/Álava,62,Zambrana,432,231,201
1,Araba/Álava,18,Zigoitia,1802,972,830
1,Araba/Álava,63,Zuia,2318,1211,1107
33,Asturias,1,Allande,1620,800,820
33,Asturias,2,Aller,10346,5109,5237
33,Asturias,3,Amieva,616,353,263
33,Asturias,4,Avilés,76874,36292,40582
33,Asturias,5,Belmonte de Miranda,1439,770,669
33,Asturias,6,Bimenes,1691,816,875
33,Asturias,7,Boal,1452,732,720
33,Asturias,8,Cabrales,1942,977,965
33,Asturias,9,Cabranes,1111,565,546
33,Asturias,10,Candamo,1967,964,1003
33,Asturias,12,Cangas de Onís,6195,2996,3199
33,Asturias,11,Cangas del Narcea,11966,5865,6101
33,Asturias,13,Caravia,507,269,238
33,Asturias,14,Carreño,10288,4970,5318
33,Asturias,15,Caso,1441,824,617
33,Asturias,16,Castrillón,22299,10809,11490
33,Asturias,17,Castropol,3335,1631,1704
33,Asturias,18,Coaña,3312,1621,1691
33,Asturias,19,Colunga,3236,1600,1636
33,Asturias,20,Corvera de Asturias,15570,7614,7956
33,Asturias,21,Cudillero,4968,2461,2507
33,Asturias,22,Degaña,852,433,419
33,Asturias,23,"Franco, El",3780,1850,1930
33,Asturias,24,Gijón,268896,126485,142411
33,Asturias,25,Gozón,10412,5099,5313
33,Asturias,26,Grado,9644,4692,4952
33,Asturias,27,Grandas de Salime,792,403,389
33,Asturias,28,Ibias,1182,679,503
33,Asturias,29,Illano,320,162,158
33,Asturias,30,Illas,1045,529,516
33,Asturias,31,Langreo,38683,18413,20270
33,Asturias,32,Laviana,12754,6136,6618
33,Asturias,33,Lena,10596,5112,5484
33,Asturias,35,Llanera,13790,6828,6962
33,Asturias,36,Llanes,13611,6632,6979
33,Asturias,37,Mieres,37026,17576,19450
33,Asturias,38,Morcín,2543,1271,1272
33,Asturias,39,Muros de Nalón,1921,921,1000
33,Asturias,40,Nava,5264,2585,2679
33,Asturias,41,Navia,8302,4008,4294
33,Asturias,42,Noreña,5113,2445,2668
33,Asturias,43,Onís,729,393,336
33,Asturias,44,Oviedo,217552,100622,116930
33,Asturias,45,Parres,5292,2585,2707
33,Asturias,46,Peñamellera Alta,512,279,233
33,Asturias,47,Peñamellera Baja,1244,617,627
33,Asturias,48,Pesoz,141,78,63
33,Asturias,49,Piloña,6921,3400,3521
33,Asturias,50,Ponga,574,339,235
33,Asturias,51,Pravia,7936,3868,4068
33,Asturias,52,Proaza,722,423,299
33,Asturias,53,Quirós,1207,701,506
33,Asturias,54,"Regueras, Las",1877,951,926
33,Asturias,55,Ribadedeva,1724,832,892
33,Asturias,56,Ribadesella,5686,2696,2990
33,Asturias,57,Ribera de Arriba,1851,939,912
33,Asturias,58,Riosa,1836,933,903
33,Asturias,59,Salas,4878,2410,2468
33,Asturias,61,San Martín de Oscos,353,180,173
33,Asturias,60,San Martín del Rey Aurelio,15665,7523,8142
33,Asturias,63,San Tirso de Abres,419,205,214
33,Asturias,62,Santa Eulalia de Oscos,434,221,213
33,Asturias,64,Santo Adriano,277,138,139
33,Asturias,65,Sariego,1297,628,669
33,Asturias,66,Siero,51608,25270,26338
33,Asturias,67,Sobrescobio,829,440,389
33,Asturias,68,Somiedo,1104,651,453
33,Asturias,69,Soto del Barco,3850,1895,1955
33,Asturias,70,Tapia de Casariego,3683,1788,1895
33,Asturias,71,Taramundi,592,278,314
33,Asturias,72,Teverga,1584,866,718
33,Asturias,73,Tineo,9096,4608,4488
33,Asturias,34,Valdés,11281,5540,5741
33,Asturias,74,Vegadeo,3914,1872,2042
33,Asturias,75,Villanueva de Oscos,275,138,137
33,Asturias,76,Villaviciosa,14869,7394,7475
33,Asturias,77,Villayón,1151,599,552
33,Asturias,78,Yernes y Tameza,128,68,60
5,Ávila,1,Adanero,196,106,90
5,Ávila,2,"Adrada, La",2757,1408,1349
5,Ávila,5,Albornos,172,88,84
5,Ávila,7,Aldeanueva de Santa Cruz,113,59,54
5,Ávila,8,Aldeaseca,219,105,114
5,Ávila,10,"Aldehuela, La",147,75,72
5,Ávila,12,Amavida,128,72,56
5,Ávila,13,"Arenal, El",943,473,470
5,Ávila,14,Arenas de San Pedro,6434,3118,3316
5,Ávila,15,Arevalillo,67,32,35
5,Ávila,16,Arévalo,7881,3838,4043
5,Ávila,17,Aveinte,82,48,34
5,Ávila,18,Avellaneda,26,15,11
5,Ávila,19,Ávila,57949,27608,30341
5,Ávila,21,"Barco de Ávila, El",2298,1103,1195
5,Ávila,22,"Barraco, El",1973,1010,963
5,Ávila,23,Barromán,181,96,85
5,Ávila,24,Becedas,183,94,89
5,Ávila,25,Becedillas,77,40,37
5,Ávila,26,Bercial de Zapardiel,195,102,93
5,Ávila,27,"Berlanas, Las",334,177,157
5,Ávila,29,Bernuy-Zapardiel,90,51,39
5,Ávila,30,Berrocalejo de Aragona,49,27,22
5,Ávila,33,Blascomillán,181,94,87
5,Ávila,34,Blasconuño de Matacabras,14,8,6
5,Ávila,35,Blascosancho,101,50,51
5,Ávila,36,"Bohodón, El",117,63,54
5,Ávila,37,Bohoyo,231,131,100
5,Ávila,38,Bonilla de la Sierra,131,78,53
5,Ávila,39,Brabos,42,26,16
5,Ávila,40,Bularros,63,42,21
5,Ávila,41,Burgohondo,1231,651,580
5,Ávila,42,Cabezas de Alambre,160,76,84
5,Ávila,43,Cabezas del Pozo,68,36,32
5,Ávila,44,Cabezas del Villar,257,141,116
5,Ávila,45,Cabizuela,80,43,37
5,Ávila,46,Canales,39,23,16
5,Ávila,47,Candeleda,5049,2550,2499
5,Ávila,48,Cantiveros,100,60,40
5,Ávila,49,Cardeñosa,427,231,196
5,Ávila,51,"Carrera, La",164,92,72
5,Ávila,52,Casas del Puerto,83,45,38
5,Ávila,53,Casasola,68,40,28
5,Ávila,54,Casavieja,1422,731,691
5,Ávila,55,Casillas,646,348,298
5,Ávila,56,Castellanos de Zapardiel,94,54,40
5,Ávila,57,Cebreros,3246,1690,1556
5,Ávila,58,Cepeda la Mora,70,40,30
5,Ávila,67,Chamartín,68,41,27
5,Ávila,59,Cillán,82,50,32
5,Ávila,60,Cisla,104,55,49
5,Ávila,61,"Colilla, La",341,175,166
5,Ávila,62,Collado de Contreras,158,80,78
5,Ávila,63,Collado del Mirón,29,19,10
5,Ávila,64,Constanzana,107,61,46
5,Ávila,65,Crespos,494,263,231
5,Ávila,66,Cuevas del Valle,514,284,230
5,Ávila,903,Diego del Carpio,117,66,51
5,Ávila,69,Donjimeno,72,39,33
5,Ávila,70,Donvidas,30,18,12
5,Ávila,72,Espinosa de los Caballeros,109,56,53
5,Ávila,73,Flores de Ávila,287,156,131
5,Ávila,74,Fontiveros,734,383,351
5,Ávila,75,Fresnedilla,110,57,53
5,Ávila,76,"Fresno, El",589,316,273
5,Ávila,77,Fuente el Saúz,157,89,68
5,Ávila,78,Fuentes de Año,96,55,41
5,Ávila,79,Gallegos de Altamiros,63,36,27
5,Ávila,80,Gallegos de Sobrinos,36,18,18
5,Ávila,81,Garganta del Villar,42,28,14
5,Ávila,82,Gavilanes,576,306,270
5,Ávila,83,Gemuño,147,76,71
5,Ávila,85,Gil García,42,19,23
5,Ávila,84,Gilbuena,60,36,24
5,Ávila,86,Gimialcón,74,46,28
5,Ávila,87,Gotarrendura,169,63,106
5,Ávila,88,Grandes y San Martín,26,13,13
5,Ávila,89,Guisando,522,261,261
5,Ávila,90,Gutierre-Muñoz,71,37,34
5,Ávila,92,Hernansancho,156,90,66
5,Ávila,93,Herradón de Pinares,436,243,193
5,Ávila,94,Herreros de Suso,131,72,59
5,Ávila,95,Higuera de las Dueñas,266,150,116
5,Ávila,96,"Hija de Dios, La",80,48,32
5,Ávila,97,"Horcajada, La",495,257,238
5,Ávila,99,Horcajo de las Torres,481,273,208
5,Ávila,100,"Hornillo, El",281,149,132
5,Ávila,102,"Hoyo de Pinares, El",2163,1106,1057
5,Ávila,101,Hoyocasero,278,164,114
5,Ávila,103,Hoyorredondo,60,31,29
5,Ávila,106,Hoyos de Miguel Muñoz,26,13,13
5,Ávila,104,Hoyos del Collado,31,18,13
5,Ávila,105,Hoyos del Espino,371,194,177
5,Ávila,107,Hurtumpascual,45,28,17
5,Ávila,108,Junciana,40,24,16
5,Ávila,109,Langa,467,244,223
5,Ávila,110,Lanzahíta,815,423,392
5,Ávila,113,"Llanos de Tormes, Los",58,30,28
5,Ávila,112,"Losar del Barco, El",109,60,49
5,Ávila,114,Madrigal de las Altas Torres,1380,698,682
5,Ávila,115,Maello,636,336,300
5,Ávila,116,Malpartida de Corneja,90,45,45
5,Ávila,117,Mamblas,202,114,88
5,Ávila,118,Mancera de Arriba,72,41,31
5,Ávila,119,Manjabálago y Ortigosa de Rioalmar,21,12,9
5,Ávila,120,Marlín,32,21,11
5,Ávila,121,Martiherrero,336,172,164
5,Ávila,122,Martínez,111,59,52
5,Ávila,123,Mediana de Voltoya,119,58,61
5,Ávila,124,Medinilla,104,48,56
5,Ávila,125,Mengamuñoz,59,28,31
5,Ávila,126,Mesegar de Corneja,57,34,23
5,Ávila,127,Mijares,743,402,341
5,Ávila,128,Mingorría,377,196,181
5,Ávila,129,"Mirón, El",114,70,44
5,Ávila,130,Mironcillo,105,54,51
5,Ávila,131,Mirueña de los Infanzones,84,49,35
5,Ávila,132,Mombeltrán,934,483,451
5,Ávila,133,Monsalupe,60,32,28
5,Ávila,134,Moraleja de Matacabras,52,28,24
5,Ávila,135,Muñana,342,188,154
5,Ávila,136,Muñico,80,45,35
5,Ávila,138,Muñogalindo,325,161,164
5,Ávila,139,Muñogrande,71,40,31
5,Ávila,140,Muñomer del Peco,108,56,52
5,Ávila,141,Muñopepe,99,55,44
5,Ávila,142,Muñosancho,91,46,45
5,Ávila,143,Muñotello,66,30,36
5,Ávila,144,Narrillos del Álamo,71,37,34
5,Ávila,145,Narrillos del Rebollar,38,24,14
5,Ávila,149,Narros de Saldueña,106,59,47
5,Ávila,147,Narros del Castillo,159,88,71
5,Ávila,148,Narros del Puerto,29,16,13
5,Ávila,152,Nava de Arévalo,714,370,344
5,Ávila,153,Nava del Barco,79,41,38
5,Ávila,151,Navacepedilla de Corneja,91,49,42
5,Ávila,154,Navadijos,32,21,11
5,Ávila,155,Navaescurial,46,28,18
5,Ávila,156,Navahondilla,358,216,142
5,Ávila,157,Navalacruz,221,123,98
5,Ávila,158,Navalmoral,340,178,162
5,Ávila,159,Navalonguilla,209,105,104
5,Ávila,160,Navalosa,322,182,140
5,Ávila,161,Navalperal de Pinares,765,409,356
5,Ávila,162,Navalperal de Tormes,87,50,37
5,Ávila,163,Navaluenga,2135,1068,1067
5,Ávila,164,Navaquesera,22,10,12
5,Ávila,165,Navarredonda de Gredos,424,216,208
5,Ávila,166,Navarredondilla,175,86,89
5,Ávila,167,Navarrevisca,272,153,119
5,Ávila,168,"Navas del Marqués, Las",5231,2676,2555
5,Ávila,169,Navatalgordo,243,136,107
5,Ávila,170,Navatejares,55,25,30
5,Ávila,171,Neila de San Miguel,65,35,30
5,Ávila,172,Niharra,188,114,74
5,Ávila,173,Ojos-Albos,82,47,35
5,Ávila,174,Orbita,73,43,30
5,Ávila,175,"Oso, El",149,85,64
5,Ávila,176,Padiernos,280,153,127
5,Ávila,177,Pajares de Adaja,137,74,63
5,Ávila,178,Palacios de Goda,387,208,179
5,Ávila,179,Papatrigo,228,110,118
5,Ávila,180,"Parral, El",61,36,25
5,Ávila,181,Pascualcobo,41,27,14
5,Ávila,182,Pedro Bernardo,807,425,382
5,Ávila,183,Pedro-Rodríguez,135,68,67
5,Ávila,184,Peguerinos,273,156,117
5,Ávila,185,Peñalba de Ávila,116,63,53
5,Ávila,186,Piedrahíta,1754,848,906
5,Ávila,187,Piedralaves,2136,1067,1069
5,Ávila,188,Poveda,38,23,15
5,Ávila,189,Poyales del Hoyo,428,231,197
5,Ávila,190,Pozanco,49,29,20
5,Ávila,191,Pradosegar,104,56,48
5,Ávila,192,Puerto Castilla,114,70,44
5,Ávila,193,Rasueros,168,94,74
5,Ávila,194,Riocabado,131,76,55
5,Ávila,195,Riofrío,196,120,76
5,Ávila,196,Rivilla de Barajas,67,32,35
5,Ávila,197,Salobral,118,62,56
5,Ávila,198,Salvadiós,67,33,34
5,Ávila,199,San Bartolomé de Béjar,44,22,22
5,Ávila,200,San Bartolomé de Corneja,40,24,16
5,Ávila,201,San Bartolomé de Pinares,521,284,237
5,Ávila,206,San Esteban de los Patos,23,15,8
5,Ávila,208,San Esteban de Zapardiel,45,25,20
5,Ávila,207,San Esteban del Valle,736,385,351
5,Ávila,209,San García de Ingelmos,71,45,26
5,Ávila,901,San Juan de Gredos,255,144,111
5,Ávila,210,San Juan de la Encinilla,74,37,37
5,Ávila,211,San Juan de la Nava,466,258,208
5,Ávila,212,San Juan del Molinillo,206,116,90
5,Ávila,213,San Juan del Olmo,85,57,28
5,Ávila,214,San Lorenzo de Tormes,33,17,16
5,Ávila,215,San Martín de la Vega del Alberche,163,94,69
5,Ávila,216,San Martín del Pimpollar,188,113,75
5,Ávila,217,San Miguel de Corneja,53,30,23
5,Ávila,218,San Miguel de Serrezuela,112,58,54
5,Ávila,219,San Pascual,43,25,18
5,Ávila,220,San Pedro del Arroyo,445,236,209
5,Ávila,231,San Vicente de Arévalo,172,94,78
5,Ávila,204,Sanchidrián,727,372,355
5,Ávila,205,Sanchorreja,85,41,44
5,Ávila,222,Santa Cruz de Pinares,162,92,70
5,Ávila,221,Santa Cruz del Valle,324,168,156
5,Ávila,226,Santa María de los Caballeros,66,41,25
5,Ávila,224,Santa María del Arroyo,105,56,49
5,Ávila,225,Santa María del Berrocal,373,198,175
5,Ávila,902,Santa María del Cubillo,314,178,136
5,Ávila,227,Santa María del Tiétar,484,256,228
5,Ávila,228,Santiago del Collado,168,108,60
5,Ávila,904,Santiago del Tormes,110,63,47
5,Ávila,229,Santo Domingo de las Posadas,72,41,31
5,Ávila,230,Santo Tomé de Zabarcos,69,39,30
5,Ávila,232,"Serrada, La",134,68,66
5,Ávila,233,Serranillos,245,134,111
5,Ávila,234,Sigeres,41,18,23
5,Ávila,235,Sinlabajos,141,70,71
5,Ávila,236,Solana de Ávila,112,63,49
5,Ávila,237,Solana de Rioalmar,145,88,57
5,Ávila,238,Solosancho,815,439,376
5,Ávila,239,Sotalbo,230,134,96
5,Ávila,240,Sotillo de la Adrada,4721,2330,2391
5,Ávila,241,"Tiemblo, El",4414,2237,2177
5,Ávila,242,Tiñosillos,766,397,369
5,Ávila,243,Tolbaños,76,45,31
5,Ávila,244,Tormellas,37,23,14
5,Ávila,245,Tornadizos de Ávila,429,216,213
5,Ávila,247,"Torre, La",219,118,101
5,Ávila,246,Tórtoles,47,26,21
5,Ávila,249,Umbrías,103,53,50
5,Ávila,251,Vadillo de la Sierra,58,40,18
5,Ávila,252,Valdecasa,60,36,24
5,Ávila,253,Vega de Santa María,71,39,32
5,Ávila,254,Velayos,212,106,106
5,Ávila,256,Villaflor,103,56,47
5,Ávila,257,Villafranca de la Sierra,141,79,62
5,Ávila,905,Villanueva de Ávila,217,113,104
5,Ávila,258,Villanueva de Gómez,116,67,49
5,Ávila,259,Villanueva del Aceral,105,49,56
5,Ávila,260,Villanueva del Campillo,107,59,48
5,Ávila,261,Villar de Corneja,37,22,15
5,Ávila,262,Villarejo del Valle,332,176,156
5,Ávila,263,Villatoro,159,93,66
5,Ávila,264,Viñegra de Moraña,50,28,22
5,Ávila,265,Vita,80,48,32
5,Ávila,266,Zapardiel de la Cañada,85,47,38
5,Ávila,267,Zapardiel de la Ribera,100,54,46
6,Badajoz,1,Acedera,820,419,401
6,Badajoz,2,Aceuchal,5467,2725,2742
6,Badajoz,3,Ahillones,851,424,427
6,Badajoz,4,Alange,1850,948,902
6,Badajoz,5,"Albuera, La",2026,1054,972
6,Badajoz,6,Alburquerque,5245,2614,2631
6,Badajoz,7,Alconchel,1654,833,821
6,Badajoz,8,Alconera,744,367,377
6,Badajoz,9,Aljucén,250,138,112
6,Badajoz,10,Almendral,1223,609,614
6,Badajoz,11,Almendralejo,33741,16700,17041
6,Badajoz,12,Arroyo de San Serván,4081,2066,2015
6,Badajoz,13,Atalaya,288,150,138
6,Badajoz,14,Azuaga,7702,3817,3885
6,Badajoz,15,Badajoz,150610,72942,77668
6,Badajoz,16,Barcarrota,3498,1779,1719
6,Badajoz,17,Baterno,258,140,118
6,Badajoz,18,Benquerencia de la Serena,808,405,403
6,Badajoz,19,Berlanga,2306,1141,1165
6,Badajoz,20,Bienvenida,2087,1074,1013
6,Badajoz,21,Bodonal de la Sierra,1017,518,499
6,Badajoz,22,Burguillos del Cerro,3076,1518,1558
6,Badajoz,23,Cabeza del Buey,4732,2351,2381
6,Badajoz,24,Cabeza la Vaca,1298,665,633
6,Badajoz,25,Calamonte,6152,3034,3118
6,Badajoz,26,Calera de León,946,479,467
6,Badajoz,27,Calzadilla de los Barros,721,358,363
6,Badajoz,28,Campanario,4823,2375,2448
6,Badajoz,29,Campillo de Llerena,1333,666,667
6,Badajoz,30,Capilla,165,84,81
6,Badajoz,31,Carmonita,532,267,265
6,Badajoz,32,"Carrascalejo, El",90,43,47
6,Badajoz,33,Casas de Don Pedro,1456,747,709
6,Badajoz,34,Casas de Reina,202,102,100
6,Badajoz,35,Castilblanco,903,461,442
6,Badajoz,36,Castuera,5708,2817,2891
6,Badajoz,42,Cheles,1172,571,601
6,Badajoz,37,"Codosera, La",2049,1068,981
6,Badajoz,38,Cordobilla de Lácara,878,455,423
6,Badajoz,39,"Coronada, La",2175,1058,1117
6,Badajoz,40,Corte de Peleas,1207,587,620
6,Badajoz,41,Cristina,551,283,268
6,Badajoz,43,Don Álvaro,784,416,368
6,Badajoz,44,Don Benito,37275,18378,18897
6,Badajoz,45,Entrín Bajo,552,283,269
6,Badajoz,46,Esparragalejo,1474,729,745
6,Badajoz,47,Esparragosa de la Serena,994,505,489
6,Badajoz,48,Esparragosa de Lares,895,445,450
6,Badajoz,49,Feria,1077,514,563
6,Badajoz,50,Fregenal de la Sierra,4811,2349,2462
6,Badajoz,51,Fuenlabrada de los Montes,1793,878,915
6,Badajoz,52,Fuente de Cantos,4684,2332,2352
6,Badajoz,53,Fuente del Arco,681,351,330
6,Badajoz,54,Fuente del Maestre,6704,3320,3384
6,Badajoz,55,Fuentes de León,2244,1104,1140
6,Badajoz,56,Garbayuela,510,275,235
6,Badajoz,57,Garlitos,554,287,267
6,Badajoz,58,"Garrovilla, La",2334,1147,1187
6,Badajoz,59,Granja de Torrehermosa,1965,975,990
6,Badajoz,903,Guadiana,2465,1212,1253
6,Badajoz,60,Guareña,6812,3419,3393
6,Badajoz,61,"Haba, La",1206,601,605
6,Badajoz,62,Helechosa de los Montes,612,341,271
6,Badajoz,63,Herrera del Duque,3465,1745,1720
6,Badajoz,64,Higuera de la Serena,937,479,458
6,Badajoz,65,Higuera de Llerena,335,173,162
6,Badajoz,66,Higuera de Vargas,1930,984,946
6,Badajoz,67,Higuera la Real,2202,1108,1094
6,Badajoz,68,Hinojosa del Valle,476,229,247
6,Badajoz,69,Hornachos,3509,1753,1756
6,Badajoz,70,Jerez de los Caballeros,9171,4512,4659
6,Badajoz,71,"Lapa, La",277,141,136
6,Badajoz,73,Llera,823,424,399
6,Badajoz,74,Llerena,5697,2821,2876
6,Badajoz,72,Lobón,2760,1408,1352
6,Badajoz,75,Magacela,511,264,247
6,Badajoz,76,Maguilla,960,480,480
6,Badajoz,77,Malcocinado,351,192,159
6,Badajoz,78,Malpartida de la Serena,536,280,256
6,Badajoz,79,Manchita,769,389,380
6,Badajoz,80,Medellín,2247,1144,1103
6,Badajoz,81,Medina de las Torres,1163,602,561
6,Badajoz,82,Mengabril,489,268,221
6,Badajoz,83,Mérida,59424,28920,30504
6,Badajoz,84,Mirandilla,1247,624,623
6,Badajoz,85,Monesterio,4267,2206,2061
6,Badajoz,86,Montemolín,1365,661,704
6,Badajoz,87,Monterrubio de la Serena,2312,1137,1175
6,Badajoz,88,Montijo,15483,7636,7847
6,Badajoz,89,"Morera, La",714,366,348
6,Badajoz,90,"Nava de Santiago, La",933,472,461
6,Badajoz,91,Navalvillar de Pela,4392,2200,2192
6,Badajoz,92,Nogales,646,322,324
6,Badajoz,93,Oliva de la Frontera,5083,2556,2527
6,Badajoz,94,Oliva de Mérida,1710,868,842
6,Badajoz,95,Olivenza,11871,5901,5970
6,Badajoz,96,Orellana de la Sierra,255,132,123
6,Badajoz,97,Orellana la Vieja,2627,1358,1269
6,Badajoz,98,Palomas,673,335,338
6,Badajoz,99,"Parra, La",1322,685,637
6,Badajoz,100,Peñalsordo,870,430,440
6,Badajoz,101,Peraleda del Zaucejo,490,251,239
6,Badajoz,102,Puebla de Alcocer,1174,574,600
6,Badajoz,103,Puebla de la Calzada,5861,2949,2912
6,Badajoz,104,Puebla de la Reina,719,355,364
6,Badajoz,107,Puebla de Obando,1839,938,901
6,Badajoz,108,Puebla de Sancho Pérez,2665,1355,1310
6,Badajoz,105,Puebla del Maestre,665,347,318
6,Badajoz,106,Puebla del Prior,469,241,228
6,Badajoz,902,Pueblonuevo del Guadiana,1989,996,993
6,Badajoz,109,Quintana de la Serena,4576,2309,2267
6,Badajoz,110,Reina,151,79,72
6,Badajoz,111,Rena,607,317,290
6,Badajoz,112,Retamal de Llerena,432,225,207
6,Badajoz,113,Ribera del Fresno,3268,1637,1631
6,Badajoz,114,Risco,130,63,67
6,Badajoz,115,"Roca de la Sierra, La",1442,705,737
6,Badajoz,116,Salvaleón,1692,848,844
6,Badajoz,117,Salvatierra de los Barros,1608,788,820
6,Badajoz,119,San Pedro de Mérida,852,439,413
6,Badajoz,123,San Vicente de Alcántara,5340,2701,2639
6,Badajoz,118,Sancti-Spíritus,163,91,72
6,Badajoz,120,Santa Amalia,3957,1984,1973
6,Badajoz,121,Santa Marta,4094,2047,2047
6,Badajoz,122,"Santos de Maimona, Los",8064,4056,4008
6,Badajoz,124,Segura de León,1834,917,917
6,Badajoz,125,Siruela,1852,937,915
6,Badajoz,126,Solana de los Barros,2575,1282,1293
6,Badajoz,127,Talarrubias,3355,1667,1688
6,Badajoz,128,Talavera la Real,5311,2651,2660
6,Badajoz,129,Táliga,674,331,343
6,Badajoz,130,Tamurejo,211,108,103
6,Badajoz,131,Torre de Miguel Sesmero,1235,631,604
6,Badajoz,132,Torremayor,985,483,502
6,Badajoz,133,Torremejía,2249,1167,1082
6,Badajoz,134,Trasierra,617,326,291
6,Badajoz,135,Trujillanos,1389,715,674
6,Badajoz,136,Usagre,1761,869,892
6,Badajoz,137,Valdecaballeros,1088,564,524
6,Badajoz,901,Valdelacalzada,2731,1387,1344
6,Badajoz,138,Valdetorres,1170,571,599
6,Badajoz,139,Valencia de las Torres,519,274,245
6,Badajoz,140,Valencia del Mombuey,715,366,349
6,Badajoz,141,Valencia del Ventoso,1931,966,965
6,Badajoz,146,Valle de la Serena,1160,585,575
6,Badajoz,147,Valle de Matamoros,358,181,177
6,Badajoz,148,Valle de Santa Ana,1129,552,577
6,Badajoz,142,Valverde de Burguillos,278,146,132
6,Badajoz,143,Valverde de Leganés,4157,2087,2070
6,Badajoz,144,Valverde de Llerena,566,278,288
6,Badajoz,145,Valverde de Mérida,1036,525,511
6,Badajoz,149,Villafranca de los Barros,12534,6175,6359
6,Badajoz,150,Villagarcía de la Torre,910,464,446
6,Badajoz,151,Villagonzalo,1231,592,639
6,Badajoz,152,Villalba de los Barros,1472,733,739
6,Badajoz,153,Villanueva de la Serena,25837,12538,13299
6,Badajoz,154,Villanueva del Fresno,3335,1671,1664
6,Badajoz,156,Villar de Rena,1332,687,645
6,Badajoz,155,Villar del Rey,2103,1137,966
6,Badajoz,157,Villarta de los Montes,418,213,205
6,Badajoz,158,Zafra,16786,8068,8718
6,Badajoz,159,Zahínos,2780,1379,1401
6,Badajoz,160,Zalamea de la Serena,3473,1745,1728
6,Badajoz,162,"Zarza, La",3380,1695,1685
6,Badajoz,161,Zarza-Capilla,296,149,147
7,"Balears, Illes",2,Alaior,9477,4776,4701
7,"Balears, Illes",1,Alaró,5741,2777,2964
7,"Balears, Illes",3,Alcúdia,20651,10443,10208
7,"Balears, Illes",4,Algaida,5963,3026,2937
7,"Balears, Illes",5,Andratx,11571,5830,5741
7,"Balears, Illes",901,Ariany,897,458,439
7,"Balears, Illes",6,Artà,7984,3992,3992
7,"Balears, Illes",7,Banyalbufar,542,286,256
7,"Balears, Illes",8,Binissalem,8895,4472,4423
7,"Balears, Illes",9,Búger,1084,578,506
7,"Balears, Illes",10,Bunyola,7037,3456,3581
7,"Balears, Illes",11,Calvià,51567,25858,25709
7,"Balears, Illes",12,Campanet,2684,1352,1332
7,"Balears, Illes",13,Campos,11425,5698,5727
7,"Balears, Illes",14,Capdepera,12003,6078,5925
7,"Balears, Illes",64,"Castell, Es",7530,3824,3706
7,"Balears, Illes",15,Ciutadella de Menorca,30638,15286,15352
7,"Balears, Illes",16,Consell,4243,2111,2132
7,"Balears, Illes",17,Costitx,1379,681,698
7,"Balears, Illes",18,Deià,674,327,347
7,"Balears, Illes",26,Eivissa,50643,25538,25105
7,"Balears, Illes",19,Escorca,181,110,71
7,"Balears, Illes",20,Esporles,5134,2544,2590
7,"Balears, Illes",21,Estellencs,326,173,153
7,"Balears, Illes",22,Felanitx,18164,9163,9001
7,"Balears, Illes",23,Ferreries,4892,2455,2437
7,"Balears, Illes",24,Formentera,11708,6121,5587
7,"Balears, Illes",25,Fornalutx,682,340,342
7,"Balears, Illes",27,Inca,33726,16940,16786
7,"Balears, Illes",28,Lloret de Vistalegre,1465,746,719
7,"Balears, Illes",29,Lloseta,6250,3131,3119
7,"Balears, Illes",30,Llubí,2385,1191,1194
7,"Balears, Illes",31,Llucmajor,38224,19355,18869
7,"Balears, Illes",33,Manacor,44809,22419,22390
7,"Balears, Illes",34,Mancor de la Vall,1569,792,777
7,"Balears, Illes",32,Maó-Mahón,29578,14399,15179
7,"Balears, Illes",35,Maria de la Salut,2242,1157,1085
7,"Balears, Illes",36,Marratxí,38357,19253,19104
7,"Balears, Illes",37,"Mercadal, Es",5444,2768,2676
7,"Balears, Illes",902,"Migjorn Gran, Es",1500,748,752
7,"Balears, Illes",38,Montuïri,3087,1551,1536
7,"Balears, Illes",39,Muro,7515,3827,3688
7,"Balears, Illes",40,Palma,419366,205249,214117
7,"Balears, Illes",41,Petra,3028,1498,1530
7,"Balears, Illes",44,"Pobla, Sa",13873,6998,6875
7,"Balears, Illes",42,Pollença,16969,8474,8495
7,"Balears, Illes",43,Porreres,5624,2853,2771
7,"Balears, Illes",45,Puigpunyent,2057,1020,1037
7,"Balears, Illes",59,"Salines, Ses",5010,2532,2478
7,"Balears, Illes",46,Sant Antoni de Portmany,27205,14274,12931
7,"Balears, Illes",49,Sant Joan,2185,1076,1109
7,"Balears, Illes",50,Sant Joan de Labritja,6635,3358,3277
7,"Balears, Illes",48,Sant Josep de sa Talaia,28299,14602,13697
7,"Balears, Illes",51,Sant Llorenç des Cardassar,8920,4477,4443
7,"Balears, Illes",52,Sant Lluís,6877,3503,3374
7,"Balears, Illes",53,Santa Eugènia,1724,860,864
7,"Balears, Illes",54,Santa Eulària des Riu,40038,20177,19861
7,"Balears, Illes",55,Santa Margalida,12767,6575,6192
7,"Balears, Illes",56,Santa María del Camí,7507,3754,3753
7,"Balears, Illes",57,Santanyí,12342,6201,6141
7,"Balears, Illes",58,Selva,4126,2036,2090
7,"Balears, Illes",47,Sencelles,3542,1791,1751
7,"Balears, Illes",60,Sineu,4122,2050,2072
7,"Balears, Illes",61,Sóller,13491,6720,6771
7,"Balears, Illes",62,Son Servera,11835,5886,5949
7,"Balears, Illes",63,Valldemossa,2042,1040,1002
7,"Balears, Illes",65,Vilafranca de Bonany,3558,1819,1739
8,Barcelona,1,Abrera,12620,6373,6247
8,Barcelona,2,Aguilar de Segarra,286,154,132
8,Barcelona,14,Aiguafreda,2556,1239,1317
8,Barcelona,3,Alella,9954,4879,5075
8,Barcelona,4,Alpens,269,143,126
8,Barcelona,5,"Ametlla del Vallès, L'",8787,4427,4360
8,Barcelona,6,Arenys de Mar,15942,7749,8193
8,Barcelona,7,Arenys de Munt,9191,4649,4542
8,Barcelona,8,Argençola,220,114,106
8,Barcelona,9,Argentona,12629,6280,6349
8,Barcelona,10,Artés,5782,2908,2874
8,Barcelona,11,Avià,2199,1100,1099
8,Barcelona,12,Avinyó,2286,1148,1138
8,Barcelona,13,Avinyonet del Penedès,1701,906,795
8,Barcelona,15,Badalona,223006,110001,113005
8,Barcelona,904,Badia del Vallès,13228,6473,6755
8,Barcelona,16,Bagà,2145,1065,1080
8,Barcelona,17,Balenyà,3900,1956,1944
8,Barcelona,18,Balsareny,3278,1632,1646
8,Barcelona,252,Barberà del Vallès,33016,16237,16779
8,Barcelona,19,Barcelona,1636732,778744,857988
8,Barcelona,20,Begues,7356,3685,3671
8,Barcelona,21,Bellprat,73,46,27
8,Barcelona,22,Berga,16682,8253,8429
8,Barcelona,23,Bigues i Riells,9542,4850,4692
8,Barcelona,24,Borredà,455,257,198
8,Barcelona,25,"Bruc, El",2177,1160,1017
8,Barcelona,26,"Brull, El",275,149,126
8,Barcelona,27,"Cabanyes, Les",1005,515,490
8,Barcelona,28,Cabrera d'Anoia,1521,803,718
8,Barcelona,29,Cabrera de Mar,4787,2399,2388
8,Barcelona,30,Cabrils,7567,3752,3815
8,Barcelona,31,Calaf,3597,1805,1792
8,Barcelona,34,Calders,1063,539,524
8,Barcelona,33,Caldes de Montbui,17797,8850,8947
8,Barcelona,32,Caldes d'Estrac,3097,1472,1625
8,Barcelona,35,Calella,19236,9356,9880
8,Barcelona,37,Calldetenes,2504,1274,1230
8,Barcelona,38,Callús,2098,1036,1062
8,Barcelona,36,Calonge de Segarra,194,95,99
8,Barcelona,39,Campins,540,277,263
8,Barcelona,40,Canet de Mar,14810,7227,7583
8,Barcelona,41,Canovelles,16872,8753,8119
8,Barcelona,42,Cànoves i Samalús,3219,1642,1577
8,Barcelona,43,Canyelles,4886,2533,2353
8,Barcelona,44,Capellades,5314,2647,2667
8,Barcelona,45,Capolat,84,40,44
8,Barcelona,46,Cardedeu,18609,9066,9543
8,Barcelona,47,Cardona,4593,2256,2337
8,Barcelona,48,Carme,768,397,371
8,Barcelona,49,Casserres,1636,812,824
8,Barcelona,57,Castell de l'Areny,72,40,32
8,Barcelona,52,Castellar de n'Hug,167,87,80
8,Barcelona,50,Castellar del Riu,171,98,73
8,Barcelona,51,Castellar del Vallès,24659,12192,12467
8,Barcelona,53,Castellbell i el Vilar,3853,1985,1868
8,Barcelona,54,Castellbisbal,12610,6348,6262
8,Barcelona,55,Castellcir,753,392,361
8,Barcelona,56,Castelldefels,67226,32930,34296
8,Barcelona,58,Castellet i la Gornal,2452,1278,1174
8,Barcelona,60,Castellfollit de Riubregós,163,88,75
8,Barcelona,59,Castellfollit del Boix,448,233,215
8,Barcelona,61,Castellgalí,2179,1143,1036
8,Barcelona,62,Castellnou de Bages,1420,752,668
8,Barcelona,63,Castellolí,653,317,336
8,Barcelona,64,Castellterçol,2632,1333,1299
8,Barcelona,65,Castellví de la Marca,1597,820,777
8,Barcelona,66,Castellví de Rosanes,1996,986,1010
8,Barcelona,67,Centelles,7595,3736,3859
8,Barcelona,268,Cercs,1190,596,594
8,Barcelona,266,Cerdanyola del Vallès,57217,27911,29306
8,Barcelona,68,Cervelló,9233,4633,4600
8,Barcelona,69,Collbató,4655,2414,2241
8,Barcelona,70,Collsuspina,387,193,194
8,Barcelona,71,Copons,322,158,164
8,Barcelona,72,Corbera de Llobregat,15017,7532,7485
8,Barcelona,73,Cornellà de Llobregat,89300,43334,45966
8,Barcelona,74,Cubelles,16051,8073,7978
8,Barcelona,75,Dosrius,5685,2867,2818
8,Barcelona,76,Esparreguera,22358,11298,11060
8,Barcelona,77,Esplugues de Llobregat,46777,22274,24503
8,Barcelona,78,"Espunyola, L'",258,129,129
8,Barcelona,254,"Esquirol, L'",2198,1109,1089
8,Barcelona,79,"Estany, L'",408,215,193
8,Barcelona,134,Figaró-Montmany,1127,550,577
8,Barcelona,80,Fígols,46,27,19
8,Barcelona,82,Fogars de la Selva,1540,793,747
8,Barcelona,81,Fogars de Montclús,467,251,216
8,Barcelona,83,Folgueroles,2269,1140,1129
8,Barcelona,84,Fonollosa,1495,766,729
8,Barcelona,85,Font-rubí,1440,752,688
8,Barcelona,86,"Franqueses del Vallès, Les",20351,10307,10044
8,Barcelona,90,Gaià,189,102,87
8,Barcelona,87,Gallifa,183,97,86
8,Barcelona,88,"Garriga, La",16733,8073,8660
8,Barcelona,89,Gavà,46931,22963,23968
8,Barcelona,91,Gelida,7723,3863,3860
8,Barcelona,92,Gironella,4916,2434,2482
8,Barcelona,93,Gisclareny,27,18,9
8,Barcelona,94,"Granada, La",2207,1106,1101
8,Barcelona,95,Granera,85,55,30
8,Barcelona,96,Granollers,62475,30903,31572
8,Barcelona,97,Gualba,1585,805,780
8,Barcelona,99,Guardiola de Berguedà,929,479,450
8,Barcelona,100,Gurb,2705,1386,1319
8,Barcelona,101,"Hospitalet de Llobregat, L'",264657,127991,136666
8,Barcelona,162,"Hostalets de Pierola, Els",3064,1547,1517
8,Barcelona,102,Igualada,40875,20124,20751
8,Barcelona,103,Jorba,825,422,403
8,Barcelona,104,"Llacuna, La",917,491,426
8,Barcelona,105,"Llagosta, La",13259,6515,6744
8,Barcelona,107,Lliçà d'Amunt,15673,7992,7681
8,Barcelona,108,Lliçà de Vall,6580,3361,3219
8,Barcelona,106,Llinars del Vallès,10116,5039,5077
8,Barcelona,109,Lluçà,271,134,137
8,Barcelona,110,Malgrat de Mar,18950,9428,9522
8,Barcelona,111,Malla,276,141,135
8,Barcelona,112,Manlleu,20804,10491,10313
8,Barcelona,113,Manresa,78192,38330,39862
8,Barcelona,242,Marganell,271,135,136
8,Barcelona,114,Martorell,28667,14623,14044
8,Barcelona,115,Martorelles,4823,2434,2389
8,Barcelona,116,"Masies de Roda, Les",704,357,347
8,Barcelona,117,"Masies de Voltregà, Les",3178,1565,1613
8,Barcelona,118,"Masnou, El",23848,11505,12343
8,Barcelona,119,Masquefa,9623,4904,4719
8,Barcelona,120,Matadepera,9672,4844,4828
8,Barcelona,121,Mataró,129120,64086,65034
8,Barcelona,122,Mediona,2419,1228,1191
8,Barcelona,138,Moià,6474,3329,3145
8,Barcelona,123,Molins de Rei,26104,12718,13386
8,Barcelona,124,Mollet del Vallès,51151,25180,25971
8,Barcelona,128,Monistrol de Calders,716,380,336
8,Barcelona,127,Monistrol de Montserrat,3178,1637,1541
8,Barcelona,125,Montcada i Reixac,36794,18179,18615
8,Barcelona,130,Montclar,136,70,66
8,Barcelona,131,Montesquiu,1048,525,523
8,Barcelona,126,Montgat,12260,6036,6224
8,Barcelona,132,Montmajor,472,236,236
8,Barcelona,133,Montmaneu,158,87,71
8,Barcelona,135,Montmeló,8798,4288,4510
8,Barcelona,136,Montornès del Vallès,16804,8482,8322
8,Barcelona,137,Montseny,362,189,173
8,Barcelona,129,Muntanyola,655,350,305
8,Barcelona,139,Mura,231,121,110
8,Barcelona,140,Navarcles,6068,2972,3096
8,Barcelona,141,Navàs,5973,2951,3022
8,Barcelona,142,"Nou de Berguedà, La",176,94,82
8,Barcelona,143,Òdena,3681,1896,1785
8,Barcelona,145,Olèrdola,3847,1989,1858
8,Barcelona,146,Olesa de Bonesvalls,1923,1004,919
8,Barcelona,147,Olesa de Montserrat,24132,12061,12071
8,Barcelona,148,Olivella,4127,2129,1998
8,Barcelona,149,Olost,1190,578,612
8,Barcelona,144,Olvan,874,425,449
8,Barcelona,150,Orís,339,174,165
8,Barcelona,151,Oristà,547,282,265
8,Barcelona,152,Orpí,154,78,76
8,Barcelona,153,Òrrius,779,397,382
8,Barcelona,154,Pacs del Penedès,915,466,449
8,Barcelona,155,Palafolls,9646,4840,4806
8,Barcelona,156,Palau-solità i Plegamans,14917,7294,7623
8,Barcelona,157,Pallejà,11636,5799,5837
8,Barcelona,905,"Palma de Cervelló, La",3015,1489,1526
8,Barcelona,158,"Papiol, El",4232,2102,2130
8,Barcelona,159,Parets del Vallès,18907,9416,9491
8,Barcelona,160,Perafita,412,211,201
8,Barcelona,161,Piera,16411,8386,8025
8,Barcelona,163,Pineda de Mar,27974,13933,14041
8,Barcelona,164,"Pla del Penedès, El",1306,656,650
8,Barcelona,165,"Pobla de Claramunt, La",2207,1124,1083
8,Barcelona,166,"Pobla de Lillet, La",1063,513,550
8,Barcelona,167,Polinyà,8494,4309,4185
8,Barcelona,182,"Pont de Vilomara i Rocafort, El",4016,2072,1944
8,Barcelona,168,Pontons,523,286,237
8,Barcelona,169,"Prat de Llobregat, El",65532,32073,33459
8,Barcelona,171,Prats de Lluçanès,2634,1320,1314
8,Barcelona,170,"Prats de Rei, Els",551,296,255
8,Barcelona,230,Premià de Dalt,10419,5203,5216
8,Barcelona,172,Premià de Mar,28523,13902,14621
8,Barcelona,174,Puigdàlber,551,265,286
8,Barcelona,175,Puig-reig,4289,2120,2169
8,Barcelona,176,Pujalt,206,114,92
8,Barcelona,177,"Quar, La",51,28,23
8,Barcelona,178,Rajadell,549,278,271
8,Barcelona,179,Rellinars,868,448,420
8,Barcelona,180,Ripollet,39139,19350,19789
8,Barcelona,181,"Roca del Vallès, La",10676,5334,5342
8,Barcelona,183,Roda de Ter,6449,3217,3232
8,Barcelona,184,Rubí,78549,38782,39767
8,Barcelona,185,Rubió,236,140,96
8,Barcelona,901,Rupit i Pruit,296,149,147
8,Barcelona,187,Sabadell,216204,105076,111128
8,Barcelona,188,Sagàs,151,79,72
8,Barcelona,190,Saldes,283,163,120
8,Barcelona,191,Sallent,6717,3249,3468
8,Barcelona,194,Sant Adrià de Besòs,37283,18357,18926
8,Barcelona,195,Sant Agustí de Lluçanès,92,47,45
8,Barcelona,196,Sant Andreu de la Barca,27175,13417,13758
8,Barcelona,197,Sant Andreu de Llavaneres,11150,5518,5632
8,Barcelona,198,Sant Antoni de Vilamajor,6383,3173,3210
8,Barcelona,199,Sant Bartomeu del Grau,913,485,428
8,Barcelona,200,Sant Boi de Llobregat,83755,40823,42932
8,Barcelona,201,Sant Boi de Lluçanès,573,293,280
8,Barcelona,203,Sant Cebrià de Vallalta,3570,1858,1712
8,Barcelona,202,Sant Celoni,18176,9063,9113
8,Barcelona,204,Sant Climent de Llobregat,4193,2099,2094
8,Barcelona,205,Sant Cugat del Vallès,94012,45711,48301
8,Barcelona,206,Sant Cugat Sesgarrigues,1004,494,510
8,Barcelona,207,Sant Esteve de Palautordera,2997,1478,1519
8,Barcelona,208,Sant Esteve Sesrovires,7771,3910,3861
8,Barcelona,210,Sant Feliu de Codines,6406,3234,3172
8,Barcelona,211,Sant Feliu de Llobregat,45463,22089,23374
8,Barcelona,212,Sant Feliu Sasserra,617,329,288
8,Barcelona,209,Sant Fost de Campsentelles,8997,4478,4519
8,Barcelona,213,Sant Fruitós de Bages,8936,4401,4535
8,Barcelona,215,Sant Hipòlit de Voltregà,3547,1788,1759
8,Barcelona,193,Sant Iscle de Vallalta,1438,773,665
8,Barcelona,216,Sant Jaume de Frontanyà,28,17,11
8,Barcelona,218,Sant Joan de Vilatorrada,10871,5438,5433
8,Barcelona,217,Sant Joan Despí,34130,16622,17508
8,Barcelona,903,Sant Julià de Cerdanyola,235,131,104
8,Barcelona,220,Sant Julià de Vilatorta,3152,1566,1586
8,Barcelona,221,Sant Just Desvern,19379,9331,10048
8,Barcelona,222,Sant Llorenç d'Hortons,2459,1244,1215
8,Barcelona,223,Sant Llorenç Savall,2514,1262,1252
8,Barcelona,225,Sant Martí d'Albars,107,53,54
8,Barcelona,224,Sant Martí de Centelles,1186,609,577
8,Barcelona,226,Sant Martí de Tous,1236,634,602
8,Barcelona,227,Sant Martí Sarroca,3286,1616,1670
8,Barcelona,228,Sant Martí Sesgueioles,344,182,162
8,Barcelona,229,Sant Mateu de Bages,614,315,299
8,Barcelona,231,Sant Pere de Ribes,31525,15727,15798
8,Barcelona,232,Sant Pere de Riudebitlles,2411,1218,1193
8,Barcelona,233,Sant Pere de Torelló,2488,1286,1202
8,Barcelona,234,Sant Pere de Vilamajor,4671,2350,2321
8,Barcelona,189,Sant Pere Sallavinera,159,84,75
8,Barcelona,235,Sant Pol de Mar,5538,2750,2788
8,Barcelona,236,Sant Quintí de Mediona,2367,1214,1153
8,Barcelona,237,Sant Quirze de Besora,2145,1035,1110
8,Barcelona,238,Sant Quirze del Vallès,20156,9875,10281
8,Barcelona,239,Sant Quirze Safaja,660,361,299
8,Barcelona,240,Sant Sadurní d'Anoia,12840,6315,6525
8,Barcelona,241,Sant Sadurní d'Osormort,76,47,29
8,Barcelona,98,Sant Salvador de Guardiola,3243,1646,1597
8,Barcelona,262,Sant Vicenç de Castellet,9868,4959,4909
8,Barcelona,264,Sant Vicenç de Montalt,6523,3280,3243
8,Barcelona,265,Sant Vicenç de Torelló,2077,1031,1046
8,Barcelona,263,Sant Vicenç dels Horts,28115,13930,14185
8,Barcelona,243,Santa Cecília de Voltregà,179,99,80
8,Barcelona,244,Santa Coloma de Cervelló,8273,4041,4232
8,Barcelona,245,Santa Coloma de Gramenet,119289,58879,60410
8,Barcelona,246,Santa Eugènia de Berga,2259,1149,1110
8,Barcelona,247,Santa Eulàlia de Riuprimer,1409,705,704
8,Barcelona,248,Santa Eulàlia de Ronçana,7538,3782,3756
8,Barcelona,249,Santa Fe del Penedès,378,183,195
8,Barcelona,250,Santa Margarida de Montbui,10192,5145,5047
8,Barcelona,251,Santa Margarida i els Monjos,7664,3908,3756
8,Barcelona,253,Santa Maria de Besora,161,85,76
8,Barcelona,256,Santa Maria de Martorelles,882,442,440
8,Barcelona,255,Santa Maria de Merlès,180,91,89
8,Barcelona,257,Santa Maria de Miralles,129,69,60
8,Barcelona,259,Santa Maria de Palautordera,9666,4852,4814
8,Barcelona,258,Santa Maria d'Oló,1065,525,540
8,Barcelona,260,Santa Perpètua de Mogoda,26033,13099,12934
8,Barcelona,261,Santa Susanna,3650,1838,1812
8,Barcelona,192,Santpedor,7566,3765,3801
8,Barcelona,267,Sentmenat,9347,4731,4616
8,Barcelona,269,Seva,3696,1903,1793
8,Barcelona,270,Sitges,30217,15109,15108
8,Barcelona,271,Sobremunt,78,33,45
8,Barcelona,272,Sora,211,116,95
8,Barcelona,273,Subirats,3149,1638,1511
8,Barcelona,274,Súria,5923,2871,3052
8,Barcelona,276,Tagamanent,325,162,163
8,Barcelona,277,Talamanca,222,124,98
8,Barcelona,278,Taradell,6687,3342,3345
8,Barcelona,275,Tavèrnoles,329,165,164
8,Barcelona,280,Tavertet,113,55,58
8,Barcelona,281,Teià,6532,3227,3305
8,Barcelona,279,Terrassa,223011,109645,113366
8,Barcelona,282,Tiana,9009,4346,4663
8,Barcelona,283,Tona,8368,4148,4220
8,Barcelona,284,Tordera,17788,9012,8776
8,Barcelona,285,Torelló,14553,7265,7288
8,Barcelona,286,"Torre de Claramunt, La",3852,1993,1859
8,Barcelona,287,Torrelavit,1429,723,706
8,Barcelona,288,Torrelles de Foix,2479,1315,1164
8,Barcelona,289,Torrelles de Llobregat,6126,3030,3096
8,Barcelona,290,Ullastrell,2096,1053,1043
8,Barcelona,291,Vacarisses,7082,3653,3429
8,Barcelona,292,Vallbona d'Anoia,1375,702,673
8,Barcelona,293,Vallcebre,258,143,115
8,Barcelona,294,Vallgorguina,3052,1553,1499
8,Barcelona,295,Vallirana,15438,7724,7714
8,Barcelona,296,Vallromanes,2594,1353,1241
8,Barcelona,297,Veciana,179,97,82
8,Barcelona,298,Vic,47319,23954,23365
8,Barcelona,299,Vilada,424,230,194
8,Barcelona,301,Viladecans,66707,32907,33800
8,Barcelona,300,Viladecavalls,7621,3795,3826
8,Barcelona,305,Vilafranca del Penedès,39969,19433,20536
8,Barcelona,306,Vilalba Sasserra,758,386,372
8,Barcelona,303,Vilanova de Sau,314,150,164
8,Barcelona,302,Vilanova del Camí,12736,6382,6354
8,Barcelona,902,Vilanova del Vallès,5535,2794,2741
8,Barcelona,307,Vilanova i la Geltrú,67458,32616,34842
8,Barcelona,214,Vilassar de Dalt,9074,4475,4599
8,Barcelona,219,Vilassar de Mar,20936,10128,10808
8,Barcelona,304,Vilobí del Penedès,1128,585,543
8,Barcelona,308,Viver i Serrateix,175,88,87
48,Bizkaia,1,Abadiño,7618,3829,3789
48,Bizkaia,2,Abanto y Ciérvana-Abanto Zierbena,9436,4683,4753
48,Bizkaia,911,Ajangiz,483,254,229
48,Bizkaia,912,Alonsotegi,2944,1448,1496
48,Bizkaia,3,Amorebieta-Etxano,19576,9643,9933
48,Bizkaia,4,Amoroto,414,215,199
48,Bizkaia,5,Arakaldo,160,76,84
48,Bizkaia,6,Arantzazu,399,196,203
48,Bizkaia,93,Areatza,1271,619,652
48,Bizkaia,9,Arrankudiaga,989,485,504
48,Bizkaia,914,Arratzu,424,203,221
48,Bizkaia,10,Arrieta,575,298,277
48,Bizkaia,11,Arrigorriaga,12140,5919,6221
48,Bizkaia,23,Artea,742,377,365
48,Bizkaia,8,Artzentales,726,384,342
48,Bizkaia,91,Atxondo,1366,699,667
48,Bizkaia,70,Aulesti,646,319,327
48,Bizkaia,12,Bakio,2775,1400,1375
48,Bizkaia,90,Balmaseda,7651,3675,3976
48,Bizkaia,13,Barakaldo,100907,48656,52251
48,Bizkaia,14,Barrika,1554,788,766
48,Bizkaia,15,Basauri,40535,19551,20984
48,Bizkaia,92,Bedia,1076,517,559
48,Bizkaia,16,Berango,7271,3566,3705
48,Bizkaia,17,Bermeo,16784,8250,8534
48,Bizkaia,18,Berriatua,1232,673,559
48,Bizkaia,19,Berriz,4537,2261,2276
48,Bizkaia,20,Bilbao,346405,163802,182603
48,Bizkaia,21,Busturia,1649,825,824
48,Bizkaia,901,Derio,6780,3308,3472
48,Bizkaia,26,Dima,1472,758,714
48,Bizkaia,27,Durango,29935,14586,15349
48,Bizkaia,28,Ea,820,435,385
48,Bizkaia,31,Elantxobe,344,169,175
48,Bizkaia,32,Elorrio,7383,3646,3737
48,Bizkaia,902,Erandio,24489,11858,12631
48,Bizkaia,33,Ereño,263,148,115
48,Bizkaia,34,Ermua,15791,7823,7968
48,Bizkaia,79,Errigoiti,489,262,227
48,Bizkaia,29,Etxebarri,11664,5836,5828
48,Bizkaia,30,Etxebarria,790,403,387
48,Bizkaia,906,Forua,910,447,463
48,Bizkaia,35,Fruiz,548,272,276
48,Bizkaia,36,Galdakao,29404,14490,14914
48,Bizkaia,37,Galdames,842,447,395
48,Bizkaia,38,Gamiz-Fika,1383,695,688
48,Bizkaia,39,Garai,329,164,165
48,Bizkaia,40,Gatika,1674,843,831
48,Bizkaia,41,Gautegiz Arteaga,854,426,428
48,Bizkaia,46,Gernika-Lumo,17093,8226,8867
48,Bizkaia,44,Getxo,77139,36176,40963
48,Bizkaia,47,Gizaburuaga,200,103,97
48,Bizkaia,42,Gordexola,1723,878,845
48,Bizkaia,43,Gorliz,6022,2972,3050
48,Bizkaia,45,Güeñes,6699,3246,3453
48,Bizkaia,48,Ibarrangelu,670,344,326
48,Bizkaia,94,Igorre,4314,2128,2186
48,Bizkaia,49,Ispaster,754,397,357
48,Bizkaia,910,Iurreta,3696,1814,1882
48,Bizkaia,50,Izurtza,240,152,88
48,Bizkaia,22,Karrantza Harana/Valle de Carranza,2759,1435,1324
48,Bizkaia,907,Kortezubi,439,209,230
48,Bizkaia,51,Lanestosa,261,142,119
48,Bizkaia,52,Larrabetzu,2081,1021,1060
48,Bizkaia,53,Laukiz,1237,602,635
48,Bizkaia,54,Leioa,32188,15709,16479
48,Bizkaia,57,Lekeitio,7271,3581,3690
48,Bizkaia,55,Lemoa,3489,1746,1743
48,Bizkaia,56,Lemoiz,1297,679,618
48,Bizkaia,81,Lezama,2454,1226,1228
48,Bizkaia,903,Loiu,2363,1194,1169
48,Bizkaia,58,Mallabia,1172,595,577
48,Bizkaia,59,Mañaria,521,261,260
48,Bizkaia,60,Markina-Xemein,5072,2566,2506
48,Bizkaia,61,Maruri-Jatabe,992,511,481
48,Bizkaia,62,Mendata,379,199,180
48,Bizkaia,63,Mendexa,422,215,207
48,Bizkaia,64,Meñaka,753,395,358
48,Bizkaia,66,Morga,408,214,194
48,Bizkaia,68,Mundaka,1862,915,947
48,Bizkaia,69,Mungia,17701,8618,9083
48,Bizkaia,7,Munitibar-Arbatzegi Gerrikaitz,484,263,221
48,Bizkaia,908,Murueta,323,168,155
48,Bizkaia,71,Muskiz,7438,3617,3821
48,Bizkaia,67,Muxika,1475,776,699
48,Bizkaia,909,Nabarniz,267,130,137
48,Bizkaia,73,Ondarroa,8326,4158,4168
48,Bizkaia,75,Orozko,2658,1306,1352
48,Bizkaia,83,Ortuella,8379,4080,4299
48,Bizkaia,72,Otxandio,1359,697,662
48,Bizkaia,77,Plentzia,4414,2145,2269
48,Bizkaia,78,Portugalete,45285,21649,23636
48,Bizkaia,82,Santurtzi,46085,22150,23935
48,Bizkaia,84,Sestao,27342,13235,14107
48,Bizkaia,904,Sondika,4555,2203,2352
48,Bizkaia,85,Sopela,14276,7061,7215
48,Bizkaia,86,Sopuerta,2638,1304,1334
48,Bizkaia,76,Sukarrieta,347,187,160
48,Bizkaia,87,Trucios-Turtzioz,502,262,240
48,Bizkaia,88,Ubide,162,86,76
48,Bizkaia,65,Ugao-Miraballes,4114,2066,2048
48,Bizkaia,89,Urduliz,5034,2490,2544
48,Bizkaia,74,Urduña/Orduña,4199,2165,2034
48,Bizkaia,80,Valle de Trápaga-Trapagaran,11911,5788,6123
48,Bizkaia,95,Zaldibar,3038,1533,1505
48,Bizkaia,96,Zalla,8416,4137,4279
48,Bizkaia,905,Zamudio,3277,1628,1649
48,Bizkaia,97,Zaratamo,1647,822,825
48,Bizkaia,24,Zeanuri,1248,629,619
48,Bizkaia,25,Zeberio,1088,564,524
48,Bizkaia,913,Zierbena,1516,806,710
48,Bizkaia,915,Ziortza-Bolibar,411,215,196
9,Burgos,1,Abajas,29,19,10
9,Burgos,3,Adrada de Haza,197,97,100
9,Burgos,6,Aguas Cándidas,56,35,21
9,Burgos,7,Aguilar de Bureba,52,33,19
9,Burgos,9,Albillos,221,116,105
9,Burgos,10,Alcocero de Mola,33,23,10
9,Burgos,11,Alfoz de Bricia,73,45,28
9,Burgos,907,Alfoz de Quintanadueñas,2163,1138,1025
9,Burgos,12,Alfoz de Santa Gadea,105,59,46
9,Burgos,13,Altable,47,28,19
9,Burgos,14,"Altos, Los",191,111,80
9,Burgos,16,Ameyugo,116,59,57
9,Burgos,17,Anguix,158,94,64
9,Burgos,18,Aranda de Duero,33084,16021,17063
9,Burgos,19,Arandilla,158,103,55
9,Burgos,20,Arauzo de Miel,288,162,126
9,Burgos,21,Arauzo de Salce,47,27,20
9,Burgos,22,Arauzo de Torre,71,44,27
9,Burgos,23,Arcos,1816,948,868
9,Burgos,24,Arenillas de Riopisuerga,176,106,70
9,Burgos,25,Arija,118,63,55
9,Burgos,26,Arlanzón,419,248,171
9,Burgos,27,Arraya de Oca,46,25,21
9,Burgos,29,Atapuerca,182,106,76
9,Burgos,30,"Ausines, Los",131,81,50
9,Burgos,32,Avellanosa de Muñó,103,55,48
9,Burgos,33,Bahabón de Esgueva,80,45,35
9,Burgos,34,"Balbases, Los",321,176,145
9,Burgos,35,Baños de Valdearados,322,191,131
9,Burgos,36,Bañuelos de Bureba,31,18,13
9,Burgos,37,Barbadillo de Herreros,112,71,41
9,Burgos,38,Barbadillo del Mercado,144,77,67
9,Burgos,39,Barbadillo del Pez,65,37,28
9,Burgos,41,Barrio de Muñó,32,18,14
9,Burgos,43,"Barrios de Bureba, Los",186,108,78
9,Burgos,44,Barrios de Colina,51,28,23
9,Burgos,45,Basconcillos del Tozo,292,167,125
9,Burgos,46,Bascuñana,21,13,8
9,Burgos,47,Belbimbre,57,30,27
9,Burgos,48,Belorado,1754,890,864
9,Burgos,50,Berberana,54,33,21
9,Burgos,51,Berlangas de Roa,180,95,85
9,Burgos,52,Berzosa de Bureba,27,21,6
9,Burgos,54,Bozoó,100,61,39
9,Burgos,55,Brazacorta,51,30,21
9,Burgos,56,Briviesca,6465,3227,3238
9,Burgos,57,Bugedo,196,122,74
9,Burgos,58,Buniel,605,329,276
9,Burgos,59,Burgos,174051,82859,91192
9,Burgos,60,Busto de Bureba,138,76,62
9,Burgos,61,Cabañes de Esgueva,166,93,73
9,Burgos,62,Cabezón de la Sierra,40,16,24
9,Burgos,64,Caleruega,419,206,213
9,Burgos,65,Campillo de Aranda,169,99,70
9,Burgos,66,Campolara,56,40,16
9,Burgos,67,Canicosa de la Sierra,436,234,202
9,Burgos,68,Cantabrana,25,15,10
9,Burgos,70,Carazo,30,20,10
9,Burgos,71,Carcedo de Bureba,45,24,21
9,Burgos,72,Carcedo de Burgos,448,235,213
9,Burgos,73,Cardeñadijo,1414,779,635
9,Burgos,74,Cardeñajimeno,1175,626,549
9,Burgos,75,Cardeñuela Riopico,109,64,45
9,Burgos,76,Carrias,25,18,7
9,Burgos,77,Cascajares de Bureba,29,14,15
9,Burgos,78,Cascajares de la Sierra,32,18,14
9,Burgos,79,Castellanos de Castro,49,29,20
9,Burgos,83,Castil de Peones,25,13,12
9,Burgos,82,Castildelgado,33,19,14
9,Burgos,84,Castrillo de la Reina,173,116,57
9,Burgos,85,Castrillo de la Vega,648,346,302
9,Burgos,88,Castrillo de Riopisuerga,57,33,24
9,Burgos,86,Castrillo del Val,814,460,354
9,Burgos,90,Castrillo Mota de Judíos,49,26,23
9,Burgos,91,Castrojeriz,758,405,353
9,Burgos,63,Cavia,248,144,104
9,Burgos,93,Cayuela,190,104,86
9,Burgos,94,Cebrecos,54,34,20
9,Burgos,95,Celada del Camino,102,48,54
9,Burgos,98,Cerezo de Río Tirón,532,290,242
9,Burgos,100,Cerratón de Juarros,52,35,17
9,Burgos,101,Ciadoncha,78,49,29
9,Burgos,102,Cillaperlata,35,23,12
9,Burgos,103,Cilleruelo de Abajo,218,125,93
9,Burgos,104,Cilleruelo de Arriba,41,21,20
9,Burgos,105,Ciruelos de Cervera,104,61,43
9,Burgos,108,Cogollos,592,335,257
9,Burgos,109,Condado de Treviño,1416,778,638
9,Burgos,110,Contreras,81,52,29
9,Burgos,112,Coruña del Conde,105,67,38
9,Burgos,113,Covarrubias,539,287,252
9,Burgos,114,Cubillo del Campo,102,60,42
9,Burgos,115,Cubo de Bureba,105,61,44
9,Burgos,117,"Cueva de Roa, La",106,54,52
9,Burgos,119,Cuevas de San Clemente,42,18,24
9,Burgos,120,Encío,43,21,22
9,Burgos,122,Espinosa de Cervera,90,58,32
9,Burgos,124,Espinosa de los Monteros,1674,861,813
9,Burgos,123,Espinosa del Camino,46,27,19
9,Burgos,125,Estépar,604,357,247
9,Burgos,127,Fontioso,50,31,19
9,Burgos,128,Frandovínez,97,55,42
9,Burgos,129,Fresneda de la Sierra Tirón,94,57,37
9,Burgos,130,Fresneña,69,44,25
9,Burgos,131,Fresnillo de las Dueñas,695,356,339
9,Burgos,132,Fresno de Río Tirón,178,105,73
9,Burgos,133,Fresno de Rodilla,46,26,20
9,Burgos,134,Frías,270,142,128
9,Burgos,135,Fuentebureba,40,24,16
9,Burgos,136,Fuentecén,223,120,103
9,Burgos,137,Fuentelcésped,257,129,128
9,Burgos,138,Fuentelisendo,106,58,48
9,Burgos,139,Fuentemolinos,99,68,31
9,Burgos,140,Fuentenebro,150,92,58
9,Burgos,141,Fuentespina,770,402,368
9,Burgos,143,Galbarros,30,18,12
9,Burgos,144,"Gallega, La",44,30,14
9,Burgos,148,Grijalba,111,55,56
9,Burgos,149,Grisaleña,65,45,20
9,Burgos,151,Gumiel de Izán,556,309,247
9,Burgos,152,Gumiel de Mercado,374,202,172
9,Burgos,154,Hacinas,151,91,60
9,Burgos,155,Haza,28,19,9
9,Burgos,159,Hontanas,72,44,28
9,Burgos,160,Hontangas,91,59,32
9,Burgos,162,Hontoria de la Cantera,153,84,69
9,Burgos,164,Hontoria de Valdearados,169,102,67
9,Burgos,163,Hontoria del Pinar,644,350,294
9,Burgos,166,"Hormazas, Las",98,54,44
9,Burgos,167,Hornillos del Camino,56,31,25
9,Burgos,168,"Horra, La",312,174,138
9,Burgos,169,Hortigüela,100,66,34
9,Burgos,170,Hoyales de Roa,226,117,109
9,Burgos,172,Huérmeces,164,94,70
9,Burgos,173,Huerta de Arriba,128,71,57
9,Burgos,174,Huerta de Rey,908,485,423
9,Burgos,175,Humada,123,83,40
9,Burgos,176,Hurones,57,39,18
9,Burgos,177,Ibeas de Juarros,1438,771,667
9,Burgos,178,Ibrillos,37,25,12
9,Burgos,179,Iglesiarrubia,43,23,20
9,Burgos,180,Iglesias,146,77,69
9,Burgos,181,Isar,291,151,140
9,Burgos,182,Itero del Castillo,82,48,34
9,Burgos,183,Jaramillo de la Fuente,42,28,14
9,Burgos,184,Jaramillo Quemado,10,9,1
9,Burgos,189,Junta de Traslaloma,123,67,56
9,Burgos,190,Junta de Villalba de Losa,87,47,40
9,Burgos,191,Jurisdicción de Lara,31,19,12
9,Burgos,192,Jurisdicción de San Zadornil,62,37,25
9,Burgos,194,Lerma,2609,1308,1301
9,Burgos,195,Llano de Bureba,53,37,16
9,Burgos,196,Madrigal del Monte,155,94,61
9,Burgos,197,Madrigalejo del Monte,179,116,63
9,Burgos,198,Mahamud,111,61,50
9,Burgos,199,Mambrilla de Castrejón,104,65,39
9,Burgos,200,Mambrillas de Lara,46,28,18
9,Burgos,201,Mamolar,27,17,10
9,Burgos,202,Manciles,22,14,8
9,Burgos,206,Mazuela,59,35,24
9,Burgos,208,Mecerreyes,196,107,89
9,Burgos,209,Medina de Pomar,5834,2950,2884
9,Burgos,211,Melgar de Fernamental,1553,846,707
9,Burgos,213,Merindad de Cuesta-Urria,284,163,121
9,Burgos,214,Merindad de Montija,730,434,296
9,Burgos,906,Merindad de Río Ubierna,1436,808,628
9,Burgos,215,Merindad de Sotoscueva,409,234,175
9,Burgos,216,Merindad de Valdeporres,431,226,205
9,Burgos,217,Merindad de Valdivielso,386,220,166
9,Burgos,218,Milagros,438,243,195
9,Burgos,219,Miranda de Ebro,35528,17515,18013
9,Burgos,220,Miraveche,85,54,31
9,Burgos,221,Modúbar de la Emparedada,768,418,350
9,Burgos,223,Monasterio de la Sierra,40,24,16
9,Burgos,224,Monasterio de Rodilla,164,90,74
9,Burgos,225,Moncalvillo,83,49,34
9,Burgos,226,Monterrubio de la Demanda,58,35,23
9,Burgos,227,Montorio,152,85,67
9,Burgos,228,Moradillo de Roa,163,89,74
9,Burgos,229,Nava de Roa,206,110,96
9,Burgos,230,Navas de Bureba,31,14,17
9,Burgos,231,Nebreda,51,37,14
9,Burgos,232,Neila,144,82,62
9,Burgos,235,Olmedillo de Roa,190,105,85
9,Burgos,236,Olmillos de Muñó,36,21,15
9,Burgos,238,Oña,1008,527,481
9,Burgos,239,Oquillas,48,27,21
9,Burgos,241,Orbaneja Riopico,355,203,152
9,Burgos,242,Padilla de Abajo,75,45,30
9,Burgos,243,Padilla de Arriba,86,53,33
9,Burgos,244,Padrones de Bureba,45,20,25
9,Burgos,246,Palacios de la Sierra,702,357,345
9,Burgos,247,Palacios de Riopisuerga,22,11,11
9,Burgos,248,Palazuelos de la Sierra,87,54,33
9,Burgos,249,Palazuelos de Muñó,53,28,25
9,Burgos,250,Pampliega,287,158,129
9,Burgos,251,Pancorbo,423,223,200
9,Burgos,253,Pardilla,115,68,47
9,Burgos,255,Partido de la Sierra en Tobalina,84,52,32
9,Burgos,256,Pedrosa de Duero,485,281,204
9,Burgos,259,Pedrosa de Río Úrbel,252,151,101
9,Burgos,257,Pedrosa del Páramo,84,51,33
9,Burgos,258,Pedrosa del Príncipe,165,90,75
9,Burgos,261,Peñaranda de Duero,511,262,249
9,Burgos,262,Peral de Arlanza,175,98,77
9,Burgos,265,Piérnigas,37,21,16
9,Burgos,266,Pineda de la Sierra,99,64,35
9,Burgos,267,Pineda Trasmonte,117,67,50
9,Burgos,268,Pinilla de los Barruecos,99,60,39
9,Burgos,269,Pinilla de los Moros,40,21,19
9,Burgos,270,Pinilla Trasmonte,165,94,71
9,Burgos,272,Poza de la Sal,294,161,133
9,Burgos,273,Prádanos de Bureba,56,35,21
9,Burgos,274,Pradoluengo,1120,569,551
9,Burgos,275,Presencio,190,113,77
9,Burgos,276,"Puebla de Arganzón, La",513,278,235
9,Burgos,277,Puentedura,120,78,42
9,Burgos,279,Quemada,255,156,99
9,Burgos,281,Quintana del Pidio,157,86,71
9,Burgos,280,Quintanabureba,30,18,12
9,Burgos,283,Quintanaélez,43,23,20
9,Burgos,287,Quintanaortuño,274,150,124
9,Burgos,288,Quintanapalla,117,60,57
9,Burgos,289,Quintanar de la Sierra,1596,840,756
9,Burgos,292,Quintanavides,74,43,31
9,Burgos,294,Quintanilla de la Mata,117,71,46
9,Burgos,901,Quintanilla del Agua y Tordueles,357,193,164
9,Burgos,295,Quintanilla del Coco,50,25,25
9,Burgos,298,Quintanilla San García,79,46,33
9,Burgos,301,Quintanilla Vivar,872,476,396
9,Burgos,297,"Quintanillas, Las",379,220,159
9,Burgos,302,Rabanera del Pinar,98,60,38
9,Burgos,303,Rábanos,82,49,33
9,Burgos,304,Rabé de las Calzadas,232,116,116
9,Burgos,306,Rebolledo de la Torre,95,55,40
9,Burgos,307,Redecilla del Camino,104,67,37
9,Burgos,308,Redecilla del Campo,63,36,27
9,Burgos,309,Regumiel de la Sierra,336,176,160
9,Burgos,310,Reinoso,15,11,4
9,Burgos,311,Retuerta,66,39,27
9,Burgos,314,Revilla del Campo,106,63,43
9,Burgos,316,Revilla Vallejera,101,60,41
9,Burgos,312,"Revilla y Ahedo, La",102,58,44
9,Burgos,315,Revillarruz,564,295,269
9,Burgos,317,Rezmondo,21,8,13
9,Burgos,318,Riocavado de la Sierra,57,37,20
9,Burgos,321,Roa,2196,1108,1088
9,Burgos,323,Rojas,64,44,20
9,Burgos,325,Royuela de Río Franco,177,105,72
9,Burgos,326,Rubena,193,112,81
9,Burgos,327,Rublacedo de Abajo,29,15,14
9,Burgos,328,Rucandio,64,31,33
9,Burgos,329,Salas de Bureba,135,79,56
9,Burgos,330,Salas de los Infantes,1980,1021,959
9,Burgos,332,Saldaña de Burgos,189,109,80
9,Burgos,334,Salinillas de Bureba,51,38,13
9,Burgos,335,San Adrián de Juarros,94,61,33
9,Burgos,337,San Juan del Monte,156,85,71
9,Burgos,338,San Mamés de Burgos,318,179,139
9,Burgos,339,San Martín de Rubiales,151,90,61
9,Burgos,340,San Millán de Lara,69,49,20
9,Burgos,360,San Vicente del Valle,27,20,7
9,Burgos,343,Santa Cecilia,100,60,40
9,Burgos,345,Santa Cruz de la Salceda,132,83,49
9,Burgos,346,Santa Cruz del Valle Urbión,101,68,33
9,Burgos,347,Santa Gadea del Cid,152,81,71
9,Burgos,348,Santa Inés,147,84,63
9,Burgos,350,Santa María del Campo,518,281,237
9,Burgos,351,Santa María del Invierno,66,48,18
9,Burgos,352,Santa María del Mercadillo,104,66,38
9,Burgos,353,Santa María Rivarredonda,95,58,37
9,Burgos,354,Santa Olalla de Bureba,35,24,11
9,Burgos,355,Santibáñez de Esgueva,85,48,37
9,Burgos,356,Santibáñez del Val,54,33,21
9,Burgos,358,Santo Domingo de Silos,262,166,96
9,Burgos,361,Sargentes de la Lora,115,66,49
9,Burgos,362,Sarracín,257,135,122
9,Burgos,363,Sasamón,963,558,405
9,Burgos,365,"Sequera de Haza, La",25,18,7
9,Burgos,366,Solarana,73,43,30
9,Burgos,368,Sordillos,28,16,12
9,Burgos,369,Sotillo de la Ribera,469,248,221
9,Burgos,372,Sotragero,289,158,131
9,Burgos,373,Sotresgudo,445,257,188
9,Burgos,374,Susinos del Páramo,113,71,42
9,Burgos,375,Tamarón,41,22,19
9,Burgos,377,Tardajos,800,430,370
9,Burgos,378,Tejada,34,19,15
9,Burgos,380,Terradillos de Esgueva,73,36,37
9,Burgos,381,Tinieblas de la Sierra,28,15,13
9,Burgos,382,Tobar,22,16,6
9,Burgos,384,Tordómar,329,182,147
9,Burgos,386,Torrecilla del Monte,73,40,33
9,Burgos,387,Torregalindo,120,74,46
9,Burgos,388,Torrelara,33,19,14
9,Burgos,389,Torrepadre,76,44,32
9,Burgos,390,Torresandino,591,316,275
9,Burgos,391,Tórtoles de Esgueva,397,213,184
9,Burgos,392,Tosantos,56,31,25
9,Burgos,394,Trespaderne,757,372,385
9,Burgos,395,Tubilla del Agua,142,86,56
9,Burgos,396,Tubilla del Lago,167,89,78
9,Burgos,398,Úrbel del Castillo,68,45,23
9,Burgos,400,Vadocondes,355,194,161
9,Burgos,403,Valdeande,99,58,41
9,Burgos,405,Valdezate,124,72,52
9,Burgos,406,Valdorros,342,196,146
9,Burgos,408,Vallarta de Bureba,45,29,16
9,Burgos,904,Valle de las Navas,530,310,220
9,Burgos,908,Valle de Losa,488,280,208
9,Burgos,409,Valle de Manzanedo,132,68,64
9,Burgos,410,Valle de Mena,3987,2032,1955
9,Burgos,411,Valle de Oca,169,102,67
9,Burgos,902,Valle de Santibáñez,482,282,200
9,Burgos,905,Valle de Sedano,409,237,172
9,Burgos,412,Valle de Tobalina,901,491,410
9,Burgos,413,Valle de Valdebezana,456,244,212
9,Burgos,414,Valle de Valdelaguna,194,117,77
9,Burgos,415,Valle de Valdelucio,339,190,149
9,Burgos,416,Valle de Zamanzas,50,32,18
9,Burgos,417,Vallejera,40,23,17
9,Burgos,418,Valles de Palenzuela,81,40,41
9,Burgos,419,Valluércanes,67,45,22
9,Burgos,407,Valmala,24,12,12
9,Burgos,422,"Vid de Bureba, La",19,11,8
9,Burgos,421,"Vid y Barrios, La",276,163,113
9,Burgos,423,Vileña,26,16,10
9,Burgos,427,Villadiego,1484,825,659
9,Burgos,428,Villaescusa de Roa,97,53,44
9,Burgos,429,Villaescusa la Sombría,57,42,15
9,Burgos,430,Villaespasa,27,16,11
9,Burgos,431,Villafranca Montes de Oca,115,69,46
9,Burgos,432,Villafruela,168,98,70
9,Burgos,433,Villagalijo,58,34,24
9,Burgos,434,Villagonzalo Pedernales,1853,980,873
9,Burgos,437,Villahoz,291,153,138
9,Burgos,438,Villalba de Duero,707,373,334
9,Burgos,439,Villalbilla de Burgos,1454,788,666
9,Burgos,440,Villalbilla de Gumiel,86,54,32
9,Burgos,441,Villaldemiro,99,56,43
9,Burgos,442,Villalmanzo,415,227,188
9,Burgos,443,Villamayor de los Montes,155,76,79
9,Burgos,444,Villamayor de Treviño,64,33,31
9,Burgos,445,Villambistia,44,32,12
9,Burgos,446,Villamedianilla,10,7,3
9,Burgos,447,Villamiel de la Sierra,44,27,17
9,Burgos,448,Villangómez,225,136,89
9,Burgos,449,Villanueva de Argaño,114,64,50
9,Burgos,450,Villanueva de Carazo,24,16,8
9,Burgos,451,Villanueva de Gumiel,274,142,132
9,Burgos,454,Villanueva de Teba,39,26,13
9,Burgos,455,Villaquirán de la Puebla,48,29,19
9,Burgos,456,Villaquirán de los Infantes,151,79,72
9,Burgos,903,Villarcayo de Merindad de Castilla la Vieja,4029,2074,1955
9,Burgos,458,Villariezo,690,380,310
9,Burgos,460,Villasandino,176,100,76
9,Burgos,463,Villasur de Herreros,258,161,97
9,Burgos,464,Villatuelda,42,22,20
9,Burgos,466,Villaverde del Monte,122,73,49
9,Burgos,467,Villaverde-Mogina,74,51,23
9,Burgos,471,Villayerno Morquillas,209,111,98
9,Burgos,472,Villazopeque,52,30,22
9,Burgos,473,Villegas,90,51,39
9,Burgos,476,Villoruebo,68,46,22
9,Burgos,424,Viloria de Rioja,38,23,15
9,Burgos,425,Vilviestre del Pinar,532,295,237
9,Burgos,478,Vizcaínos,46,34,12
9,Burgos,480,Zael,117,58,59
9,Burgos,482,Zarzosa de Río Pisuerga,34,21,13
9,Burgos,483,Zazuar,207,106,101
9,Burgos,485,Zuñeda,56,30,26
10,Cáceres,1,Abadía,359,193,166
10,Cáceres,2,Abertura,400,204,196
10,Cáceres,3,Acebo,560,271,289
10,Cáceres,4,Acehúche,813,413,400
10,Cáceres,5,Aceituna,587,299,288
10,Cáceres,6,Ahigal,1393,711,682
10,Cáceres,903,Alagón del Río,933,461,472
10,Cáceres,7,Albalá,681,355,326
10,Cáceres,8,Alcántara,1386,689,697
10,Cáceres,9,Alcollarín,279,139,140
10,Cáceres,10,Alcuéscar,2486,1286,1200
10,Cáceres,12,Aldea del Cano,610,287,323
10,Cáceres,13,"Aldea del Obispo, La",299,163,136
10,Cáceres,11,Aldeacentenera,568,296,272
10,Cáceres,14,Aldeanueva de la Vera,2035,997,1038
10,Cáceres,15,Aldeanueva del Camino,729,362,367
10,Cáceres,16,Aldehuela de Jerte,372,195,177
10,Cáceres,17,Alía,783,407,376
10,Cáceres,18,Aliseda,1751,895,856
10,Cáceres,19,Almaraz,1700,869,831
10,Cáceres,20,Almoharín,1796,879,917
10,Cáceres,21,Arroyo de la Luz,5663,2802,2861
10,Cáceres,23,Arroyomolinos,844,434,410
10,Cáceres,22,Arroyomolinos de la Vera,433,215,218
10,Cáceres,24,Baños de Montemayor,749,356,393
10,Cáceres,25,Barrado,363,188,175
10,Cáceres,26,Belvís de Monroy,745,390,355
10,Cáceres,27,Benquerencia,79,47,32
10,Cáceres,28,Berrocalejo,102,56,46
10,Cáceres,29,Berzocana,416,217,199
10,Cáceres,30,Bohonal de Ibor,485,243,242
10,Cáceres,31,Botija,187,95,92
10,Cáceres,32,Brozas,1790,886,904
10,Cáceres,33,Cabañas del Castillo,419,216,203
10,Cáceres,34,Cabezabellosa,344,172,172
10,Cáceres,35,Cabezuela del Valle,2141,1099,1042
10,Cáceres,36,Cabrero,323,181,142
10,Cáceres,37,Cáceres,95418,45735,49683
10,Cáceres,38,Cachorrilla,95,47,48
10,Cáceres,39,Cadalso,417,211,206
10,Cáceres,40,Calzadilla,464,233,231
10,Cáceres,41,Caminomorisco,1161,604,557
10,Cáceres,42,Campillo de Deleitosa,78,36,42
10,Cáceres,43,Campo Lugar,824,407,417
10,Cáceres,44,Cañamero,1622,852,770
10,Cáceres,45,Cañaveral,1024,506,518
10,Cáceres,46,Carbajo,198,100,98
10,Cáceres,47,Carcaboso,1080,544,536
10,Cáceres,48,Carrascalejo,225,116,109
10,Cáceres,49,Casar de Cáceres,4516,2228,2288
10,Cáceres,50,Casar de Palomero,1059,543,516
10,Cáceres,51,Casares de las Hurdes,383,196,187
10,Cáceres,52,Casas de Don Antonio,178,91,87
10,Cáceres,53,Casas de Don Gómez,277,149,128
10,Cáceres,56,Casas de Millán,556,280,276
10,Cáceres,57,Casas de Miravete,129,81,48
10,Cáceres,54,Casas del Castañar,531,261,270
10,Cáceres,55,Casas del Monte,787,406,381
10,Cáceres,58,Casatejada,1343,700,643
10,Cáceres,59,Casillas de Coria,344,171,173
10,Cáceres,60,Castañar de Ibor,1021,529,492
10,Cáceres,61,Ceclavín,1801,916,885
10,Cáceres,62,Cedillo,424,219,205
10,Cáceres,63,Cerezo,153,77,76
10,Cáceres,64,Cilleros,1617,817,800
10,Cáceres,65,Collado de la Vera,217,124,93
10,Cáceres,66,Conquista de la Sierra,192,112,80
10,Cáceres,67,Coria,12330,6048,6282
10,Cáceres,68,Cuacos de Yuste,847,430,417
10,Cáceres,69,"Cumbre, La",837,424,413
10,Cáceres,70,Deleitosa,684,352,332
10,Cáceres,71,Descargamaría,107,62,45
10,Cáceres,72,Eljas,897,464,433
10,Cáceres,73,Escurial,862,453,409
10,Cáceres,75,Fresnedoso de Ibor,264,141,123
10,Cáceres,76,Galisteo,902,450,452
10,Cáceres,77,Garciaz,700,360,340
10,Cáceres,79,Garganta la Olla,924,491,433
10,Cáceres,78,"Garganta, La",358,193,165
10,Cáceres,80,Gargantilla,374,193,181
10,Cáceres,81,Gargüera,178,96,82
10,Cáceres,82,Garrovillas de Alconétar,1955,969,986
10,Cáceres,83,Garvín,96,51,45
10,Cáceres,84,Gata,1413,722,691
10,Cáceres,85,"Gordo, El",382,202,180
10,Cáceres,86,"Granja, La",318,161,157
10,Cáceres,87,Guadalupe,1822,910,912
10,Cáceres,88,Guijo de Coria,197,107,90
10,Cáceres,89,Guijo de Galisteo,1513,764,749
10,Cáceres,90,Guijo de Granadilla,514,272,242
10,Cáceres,91,Guijo de Santa Bárbara,388,202,186
10,Cáceres,92,Herguijuela,268,142,126
10,Cáceres,93,Hernán-Pérez,415,202,213
10,Cáceres,94,Herrera de Alcántara,230,119,111
10,Cáceres,95,Herreruela,329,169,160
10,Cáceres,96,Hervás,3952,1933,2019
10,Cáceres,97,Higuera,106,62,44
10,Cáceres,98,Hinojal,391,202,189
10,Cáceres,99,Holguera,620,315,305
10,Cáceres,100,Hoyos,882,429,453
10,Cáceres,101,Huélaga,210,105,105
10,Cáceres,102,Ibahernando,540,267,273
10,Cáceres,103,Jaraicejo,457,224,233
10,Cáceres,104,Jaraíz de la Vera,6499,3255,3244
10,Cáceres,105,Jarandilla de la Vera,2843,1414,1429
10,Cáceres,106,Jarilla,136,68,68
10,Cáceres,107,Jerte,1256,624,632
10,Cáceres,108,Ladrillar,185,108,77
10,Cáceres,109,Logrosán,1944,990,954
10,Cáceres,110,Losar de la Vera,2658,1359,1299
10,Cáceres,111,Madrigal de la Vera,1566,819,747
10,Cáceres,112,Madrigalejo,1694,860,834
10,Cáceres,113,Madroñera,2446,1227,1219
10,Cáceres,114,Majadas,1345,677,668
10,Cáceres,115,Malpartida de Cáceres,4060,2023,2037
10,Cáceres,116,Malpartida de Plasencia,4637,2282,2355
10,Cáceres,117,Marchagaz,247,137,110
10,Cáceres,118,Mata de Alcántara,284,147,137
10,Cáceres,119,Membrío,587,290,297
10,Cáceres,120,Mesas de Ibor,162,82,80
10,Cáceres,121,Miajadas,9503,4732,4771
10,Cáceres,122,Millanes,255,130,125
10,Cáceres,123,Mirabel,669,333,336
10,Cáceres,124,Mohedas de Granadilla,849,429,420
10,Cáceres,125,Monroy,920,473,447
10,Cáceres,126,Montánchez,1654,832,822
10,Cáceres,127,Montehermoso,5680,2896,2784
10,Cáceres,128,Moraleja,6685,3321,3364
10,Cáceres,129,Morcillo,371,175,196
10,Cáceres,130,Navaconcejo,2035,1030,1005
10,Cáceres,131,Navalmoral de la Mata,17010,8233,8777
10,Cáceres,132,Navalvillar de Ibor,393,196,197
10,Cáceres,133,Navas del Madroño,1261,626,635
10,Cáceres,134,Navezuelas,631,325,306
10,Cáceres,135,Nuñomoral,1224,650,574
10,Cáceres,136,Oliva de Plasencia,286,165,121
10,Cáceres,137,Palomero,396,208,188
10,Cáceres,138,Pasarón de la Vera,606,292,314
10,Cáceres,139,Pedroso de Acim,77,44,33
10,Cáceres,140,Peraleda de la Mata,1401,709,692
10,Cáceres,141,Peraleda de San Román,297,164,133
10,Cáceres,142,Perales del Puerto,943,473,470
10,Cáceres,143,Pescueza,138,60,78
10,Cáceres,144,"Pesga, La",1013,525,488
10,Cáceres,145,Piedras Albas,137,66,71
10,Cáceres,146,Pinofranqueado,1682,888,794
10,Cáceres,147,Piornal,1485,749,736
10,Cáceres,148,Plasencia,39558,19023,20535
10,Cáceres,149,Plasenzuela,477,234,243
10,Cáceres,150,Portaje,371,193,178
10,Cáceres,151,Portezuelo,220,118,102
10,Cáceres,152,Pozuelo de Zarzón,435,218,217
10,Cáceres,905,Pueblonuevo de Miramontes,767,383,384
10,Cáceres,153,Puerto de Santa Cruz,287,147,140
10,Cáceres,154,Rebollar,208,105,103
10,Cáceres,155,Riolobos,1197,604,593
10,Cáceres,156,Robledillo de Gata,85,48,37
10,Cáceres,157,Robledillo de la Vera,262,131,131
10,Cáceres,158,Robledillo de Trujillo,362,183,179
10,Cáceres,159,Robledollano,286,155,131
10,Cáceres,160,Romangordo,259,129,130
10,Cáceres,901,Rosalejo,1383,715,668
10,Cáceres,161,Ruanes,86,45,41
10,Cáceres,162,Salorino,566,295,271
10,Cáceres,163,Salvatierra de Santiago,284,145,139
10,Cáceres,164,San Martín de Trevejo,754,376,378
10,Cáceres,165,Santa Ana,273,142,131
10,Cáceres,166,Santa Cruz de la Sierra,324,165,159
10,Cáceres,167,Santa Cruz de Paniagua,296,167,129
10,Cáceres,168,Santa Marta de Magasca,301,151,150
10,Cáceres,169,Santiago de Alcántara,488,240,248
10,Cáceres,170,Santiago del Campo,234,123,111
10,Cáceres,171,Santibáñez el Alto,354,191,163
10,Cáceres,172,Santibáñez el Bajo,748,383,365
10,Cáceres,173,Saucedilla,869,448,421
10,Cáceres,174,Segura de Toro,190,94,96
10,Cáceres,175,Serradilla,1503,755,748
10,Cáceres,176,Serrejón,409,215,194
10,Cáceres,177,Sierra de Fuentes,1984,1021,963
10,Cáceres,178,Talaván,796,412,384
10,Cáceres,179,Talaveruela de la Vera,316,163,153
10,Cáceres,180,Talayuela,7328,3902,3426
10,Cáceres,181,Tejeda de Tiétar,770,406,364
10,Cáceres,904,Tiétar,878,475,403
10,Cáceres,182,Toril,155,101,54
10,Cáceres,183,Tornavacas,1065,569,496
10,Cáceres,184,"Torno, El",843,438,405
10,Cáceres,187,Torre de Don Miguel,495,259,236
10,Cáceres,188,Torre de Santa María,528,262,266
10,Cáceres,185,Torrecilla de los Ángeles,648,336,312
10,Cáceres,186,Torrecillas de la Tiesa,1075,545,530
10,Cáceres,190,Torrejón el Rubio,550,278,272
10,Cáceres,189,Torrejoncillo,2894,1397,1497
10,Cáceres,191,Torremenga,587,309,278
10,Cáceres,192,Torremocha,770,384,386
10,Cáceres,193,Torreorgaz,1675,826,849
10,Cáceres,194,Torrequemada,566,277,289
10,Cáceres,195,Trujillo,8821,4303,4518
10,Cáceres,196,Valdastillas,312,158,154
10,Cáceres,197,Valdecañas de Tajo,113,55,58
10,Cáceres,198,Valdefuentes,1147,561,586
10,Cáceres,199,Valdehúncar,179,96,83
10,Cáceres,200,Valdelacasa de Tajo,346,188,158
10,Cáceres,201,Valdemorales,207,104,103
10,Cáceres,202,Valdeobispo,654,319,335
10,Cáceres,203,Valencia de Alcántara,5325,2618,2707
10,Cáceres,204,Valverde de la Vera,438,226,212
10,Cáceres,205,Valverde del Fresno,2190,1106,1084
10,Cáceres,902,Vegaviana,845,437,408
10,Cáceres,206,Viandar de la Vera,213,110,103
10,Cáceres,207,Villa del Campo,456,217,239
10,Cáceres,208,Villa del Rey,128,63,65
10,Cáceres,209,Villamesías,263,134,129
10,Cáceres,210,Villamiel,405,205,200
10,Cáceres,211,Villanueva de la Sierra,470,242,228
10,Cáceres,212,Villanueva de la Vera,2114,1059,1055
10,Cáceres,214,Villar de Plasencia,239,127,112
10,Cáceres,213,Villar del Pedroso,560,285,275
10,Cáceres,215,Villasbuenas de Gata,388,188,200
10,Cáceres,216,Zarza de Granadilla,1792,914,878
10,Cáceres,217,Zarza de Montánchez,529,268,261
10,Cáceres,218,Zarza la Mayor,1192,594,598
10,Cáceres,219,Zorita,1324,662,662
11,Cádiz,1,Alcalá de los Gazules,5245,2697,2548
11,Cádiz,2,Alcalá del Valle,5031,2526,2505
11,Cádiz,3,Algar,1442,739,703
11,Cádiz,4,Algeciras,122982,60664,62318
11,Cádiz,5,Algodonales,5526,2784,2742
11,Cádiz,6,Arcos de la Frontera,30902,15427,15475
11,Cádiz,7,Barbate,22761,11407,11354
11,Cádiz,8,"Barrios, Los",23983,12032,11951
11,Cádiz,901,Benalup-Casas Viejas,7020,3558,3462
11,Cádiz,9,Benaocaz,695,373,322
11,Cádiz,10,Bornos,7655,3822,3833
11,Cádiz,11,"Bosque, El",2223,1130,1093
11,Cádiz,12,Cádiz,114244,53995,60249
11,Cádiz,13,Castellar de la Frontera,3070,1528,1542
11,Cádiz,15,Chiclana de la Frontera,86306,43131,43175
11,Cádiz,16,Chipiona,19368,9686,9682
11,Cádiz,14,Conil de la Frontera,23182,11661,11521
11,Cádiz,17,Espera,3845,1923,1922
11,Cádiz,18,"Gastor, El",1709,865,844
11,Cádiz,19,Grazalema,2030,1006,1024
11,Cádiz,20,Jerez de la Frontera,212801,103879,108922
11,Cádiz,21,Jimena de la Frontera,6665,3405,3260
11,Cádiz,22,"Línea de la Concepción, La",63365,31010,32355
11,Cádiz,23,Medina Sidonia,11813,5983,5830
11,Cádiz,24,Olvera,8016,3931,4085
11,Cádiz,25,Paterna de Rivera,5470,2830,2640
11,Cádiz,26,Prado del Rey,5655,2811,2844
11,Cádiz,27,"Puerto de Santa María, El",89060,43569,45491
11,Cádiz,28,Puerto Real,41771,20973,20798
11,Cádiz,29,Puerto Serrano,6954,3522,3432
11,Cádiz,30,Rota,29326,14564,14762
11,Cádiz,31,San Fernando,94867,46277,48590
11,Cádiz,902,San José del Valle,4432,2261,2171
11,Cádiz,903,San Martín del Tesorillo,2821,1460,1361
11,Cádiz,33,San Roque,32178,16042,16136
11,Cádiz,32,Sanlúcar de Barrameda,69507,34632,34875
11,Cádiz,34,Setenil de las Bodegas,2698,1387,1311
11,Cádiz,35,Tarifa,18466,9275,9191
11,Cádiz,36,Torre Alháquime,800,400,400
11,Cádiz,37,Trebujena,7042,3499,3543
11,Cádiz,38,Ubrique,16482,8138,8344
11,Cádiz,39,Vejer de la Frontera,12572,6253,6319
11,Cádiz,40,Villaluenga del Rosario,464,237,227
11,Cádiz,41,Villamartín,12125,6089,6036
11,Cádiz,42,Zahara,1391,703,688
39,Cantabria,1,Alfoz de Lloredo,2437,1263,1174
39,Cantabria,2,Ampuero,4368,2189,2179
39,Cantabria,3,Anievas,266,146,120
39,Cantabria,4,Arenas de Iguña,1703,858,845
39,Cantabria,5,Argoños,1834,946,888
39,Cantabria,6,Arnuero,2144,1067,1077
39,Cantabria,7,Arredondo,470,269,201
39,Cantabria,8,"Astillero, El",18116,8824,9292
39,Cantabria,9,Bárcena de Cicero,4399,2252,2147
39,Cantabria,10,Bárcena de Pie de Concha,671,337,334
39,Cantabria,11,Bareyo,2129,1075,1054
39,Cantabria,12,Cabezón de la Sal,8273,3953,4320
39,Cantabria,13,Cabezón de Liébana,580,328,252
39,Cantabria,14,Cabuérniga,985,523,462
39,Cantabria,15,Camaleño,956,535,421
39,Cantabria,16,Camargo,30497,14897,15600
39,Cantabria,27,Campoo de Enmedio,3692,1876,1816
39,Cantabria,17,Campoo de Yuso,680,371,309
39,Cantabria,18,Cartes,5750,2872,2878
39,Cantabria,19,Castañeda,3029,1548,1481
39,Cantabria,20,Castro-Urdiales,32975,16325,16650
39,Cantabria,21,Cieza,548,280,268
39,Cantabria,22,Cillorigo de Liébana,1299,681,618
39,Cantabria,23,Colindres,8504,4203,4301
39,Cantabria,24,Comillas,2117,1000,1117
39,Cantabria,25,"Corrales de Buelna, Los",10703,5200,5503
39,Cantabria,26,Corvera de Toranzo,2054,1033,1021
39,Cantabria,28,Entrambasaguas,5357,2683,2674
39,Cantabria,29,Escalante,762,396,366
39,Cantabria,30,Guriezo,2410,1257,1153
39,Cantabria,31,Hazas de Cesto,1644,802,842
39,Cantabria,32,Hermandad de Campoo de Suso,1604,887,717
39,Cantabria,33,Herrerías,589,328,261
39,Cantabria,34,Lamasón,268,170,98
39,Cantabria,35,Laredo,10996,5227,5769
39,Cantabria,36,Liendo,1216,627,589
39,Cantabria,37,Liérganes,2403,1184,1219
39,Cantabria,38,Limpias,1961,974,987
39,Cantabria,39,Luena,623,338,285
39,Cantabria,40,Marina de Cudeyo,5186,2588,2598
39,Cantabria,41,Mazcuerras,2080,1070,1010
39,Cantabria,42,Medio Cudeyo,7606,3675,3931
39,Cantabria,43,Meruelo,2174,1077,1097
39,Cantabria,44,Miengo,5059,2594,2465
39,Cantabria,45,Miera,386,202,184
39,Cantabria,46,Molledo,1494,743,751
39,Cantabria,47,Noja,2650,1321,1329
39,Cantabria,48,Penagos,2168,1096,1072
39,Cantabria,49,Peñarrubia,318,170,148
39,Cantabria,50,Pesaguero,294,171,123
39,Cantabria,51,Pesquera,82,49,33
39,Cantabria,52,Piélagos,26035,12873,13162
39,Cantabria,53,Polaciones,215,136,79
39,Cantabria,54,Polanco,5978,2958,3020
39,Cantabria,55,Potes,1322,628,694
39,Cantabria,56,Puente Viesgo,2902,1464,1438
39,Cantabria,57,Ramales de la Victoria,2902,1466,1436
39,Cantabria,58,Rasines,971,495,476
39,Cantabria,59,Reinosa,8810,4168,4642
39,Cantabria,60,Reocín,8382,4137,4245
39,Cantabria,61,Ribamontán al Mar,4629,2367,2262
39,Cantabria,62,Ribamontán al Monte,2382,1220,1162
39,Cantabria,63,Rionansa,1042,581,461
39,Cantabria,64,Riotuerto,1645,790,855
39,Cantabria,65,"Rozas de Valdearroyo, Las",257,143,114
39,Cantabria,66,Ruente,1034,559,475
39,Cantabria,67,Ruesga,826,453,373
39,Cantabria,68,Ruiloba,741,375,366
39,Cantabria,69,San Felices de Buelna,2355,1194,1161
39,Cantabria,70,San Miguel de Aguayo,148,78,70
39,Cantabria,71,San Pedro del Romeral,474,264,210
39,Cantabria,72,San Roque de Riomiera,337,197,140
39,Cantabria,80,San Vicente de la Barquera,4073,2000,2073
39,Cantabria,73,Santa Cruz de Bezana,13292,6498,6794
39,Cantabria,74,Santa María de Cayón,9205,4587,4618
39,Cantabria,75,Santander,172221,79453,92768
39,Cantabria,76,Santillana del Mar,4231,2058,2173
39,Cantabria,77,Santiurde de Reinosa,244,142,102
39,Cantabria,78,Santiurde de Toranzo,1695,894,801
39,Cantabria,79,Santoña,11011,5364,5647
39,Cantabria,81,Saro,519,272,247
39,Cantabria,82,Selaya,1854,936,918
39,Cantabria,83,Soba,1153,641,512
39,Cantabria,84,Solórzano,1048,556,492
39,Cantabria,85,Suances,9026,4449,4577
39,Cantabria,86,"Tojos, Los",397,235,162
39,Cantabria,87,Torrelavega,51237,24160,27077
39,Cantabria,88,Tresviso,59,40,19
39,Cantabria,89,Tudanca,148,104,44
39,Cantabria,90,Udías,930,468,462
39,Cantabria,95,Val de San Vicente,2786,1428,1358
39,Cantabria,91,Valdáliga,2157,1128,1029
39,Cantabria,92,Valdeolea,922,490,432
39,Cantabria,93,Valdeprado del Río,316,176,140
39,Cantabria,94,Valderredible,961,547,414
39,Cantabria,101,Valle de Villaverde,276,151,125
39,Cantabria,96,Vega de Liébana,718,375,343
39,Cantabria,97,Vega de Pas,748,401,347
39,Cantabria,98,Villacarriedo,1625,844,781
39,Cantabria,99,Villaescusa,3958,1940,2018
39,Cantabria,100,Villafufre,1012,526,486
39,Cantabria,102,Voto,2789,1489,1300
12,Castellón/Castelló,2,Aín,135,71,64
12,Castellón/Castelló,3,Albocàsser,1253,633,620
12,Castellón/Castelló,4,Alcalà de Xivert,6691,3427,3264
12,Castellón/Castelló,5,"Alcora, l'",10428,5280,5148
12,Castellón/Castelló,6,Alcudia de Veo,196,107,89
12,Castellón/Castelló,7,Alfondeguilla,870,432,438
12,Castellón/Castelló,8,Algimia de Almonacid,240,136,104
12,Castellón/Castelló,9,Almassora,26878,13485,13393
12,Castellón/Castelló,10,Almedíjar,254,140,114
12,Castellón/Castelló,11,Almenara,6254,3143,3111
12,Castellón/Castelló,901,"Alqueries, les/Alquerías del Niño Perdido",4539,2270,2269
12,Castellón/Castelló,12,Altura,3658,1891,1767
12,Castellón/Castelló,13,Arañuel,152,82,70
12,Castellón/Castelló,14,Ares del Maestrat,175,104,71
12,Castellón/Castelló,15,Argelita,147,81,66
12,Castellón/Castelló,16,Artana,1970,999,971
12,Castellón/Castelló,1,Atzeneta del Maestrat,1292,655,637
12,Castellón/Castelló,17,Ayódar,158,85,73
12,Castellón/Castelló,18,Azuébar,319,172,147
12,Castellón/Castelló,20,Barracas,185,101,84
12,Castellón/Castelló,22,Bejís,390,218,172
12,Castellón/Castelló,24,Benafer,173,94,79
12,Castellón/Castelló,25,Benafigos,145,84,61
12,Castellón/Castelló,26,Benassal,1055,539,516
12,Castellón/Castelló,27,Benicarló,27658,13799,13859
12,Castellón/Castelló,28,Benicasim/Benicàssim,18991,9437,9554
12,Castellón/Castelló,29,Benlloc,1075,552,523
12,Castellón/Castelló,21,Betxí,5605,2773,2832
12,Castellón/Castelló,32,Borriana/Burriana,34903,17321,17582
12,Castellón/Castelló,31,Borriol,5552,2835,2717
12,Castellón/Castelló,33,Cabanes,3027,1537,1490
12,Castellón/Castelló,34,Càlig,2002,1012,990
12,Castellón/Castelló,36,Canet lo Roig,687,346,341
12,Castellón/Castelló,37,Castell de Cabres,22,13,9
12,Castellón/Castelló,38,Castellfort,179,97,82
12,Castellón/Castelló,39,Castellnovo,914,464,450
12,Castellón/Castelló,40,Castelló de la Plana,172589,83337,89252
12,Castellón/Castelló,41,Castillo de Villamalefa,103,68,35
12,Castellón/Castelló,42,Catí,714,358,356
12,Castellón/Castelló,43,Caudiel,663,344,319
12,Castellón/Castelló,44,Cervera del Maestre,577,276,301
12,Castellón/Castelló,53,Chilches/Xilxes,2795,1441,1354
12,Castellón/Castelló,55,Chodos/Xodos,109,67,42
12,Castellón/Castelló,56,Chóvar,302,158,144
12,Castellón/Castelló,45,Cinctorres,404,198,206
12,Castellón/Castelló,46,Cirat,211,118,93
12,Castellón/Castelló,48,Cortes de Arenoso,291,155,136
12,Castellón/Castelló,49,Costur,531,278,253
12,Castellón/Castelló,50,"Coves de Vinromà, les",1792,902,890
12,Castellón/Castelló,51,Culla,510,257,253
12,Castellón/Castelló,57,Eslida,749,376,373
12,Castellón/Castelló,58,Espadilla,84,46,38
12,Castellón/Castelló,59,Fanzara,273,136,137
12,Castellón/Castelló,60,Figueroles,531,264,267
12,Castellón/Castelló,61,Forcall,454,218,236
12,Castellón/Castelló,63,Fuente la Reina,49,30,19
12,Castellón/Castelló,64,Fuentes de Ayódar,93,52,41
12,Castellón/Castelló,65,Gaibiel,186,103,83
12,Castellón/Castelló,67,Geldo,628,315,313
12,Castellón/Castelló,68,Herbers,53,33,20
12,Castellón/Castelló,69,Higueras,49,26,23
12,Castellón/Castelló,70,"Jana, la",664,340,324
12,Castellón/Castelló,71,Jérica,1650,842,808
12,Castellón/Castelló,74,"Llosa, la",983,477,506
12,Castellón/Castelló,72,Llucena/Lucena del Cid,1308,658,650
12,Castellón/Castelló,73,Ludiente,155,86,69
12,Castellón/Castelló,75,"Mata de Morella, la",169,92,77
12,Castellón/Castelló,76,Matet,73,44,29
12,Castellón/Castelló,77,Moncofa,6958,3590,3368
12,Castellón/Castelló,78,Montán,365,184,181
12,Castellón/Castelló,79,Montanejos,544,284,260
12,Castellón/Castelló,80,Morella,2406,1176,1230
12,Castellón/Castelló,81,Navajas,750,385,365
12,Castellón/Castelló,82,Nules,13256,6628,6628
12,Castellón/Castelló,83,Olocau del Rey,117,62,55
12,Castellón/Castelló,84,Onda,24939,12504,12435
12,Castellón/Castelló,85,Oropesa del Mar/Orpesa,9755,4974,4781
12,Castellón/Castelló,87,Palanques,36,21,15
12,Castellón/Castelló,88,Pavías,72,45,27
12,Castellón/Castelló,89,Peníscola/Peñíscola,7882,4002,3880
12,Castellón/Castelló,90,Pina de Montalgrao,114,59,55
12,Castellón/Castelló,93,"Pobla de Benifassà, la",213,122,91
12,Castellón/Castelló,94,"Pobla Tornesa, la",1239,632,607
12,Castellón/Castelló,91,Portell de Morella,181,92,89
12,Castellón/Castelló,92,Puebla de Arenoso,158,86,72
12,Castellón/Castelló,95,Ribesalbes,1156,598,558
12,Castellón/Castelló,96,Rossell,904,476,428
12,Castellón/Castelló,97,Sacañet,57,38,19
12,Castellón/Castelló,98,"Salzadella, la",683,353,330
12,Castellón/Castelló,101,San Rafael del Río,468,235,233
12,Castellón/Castelló,902,Sant Joan de Moró,3307,1714,1593
12,Castellón/Castelló,99,Sant Jordi/San Jorge,1063,567,496
12,Castellón/Castelló,100,Sant Mateu,1968,974,994
12,Castellón/Castelló,102,Santa Magdalena de Pulpis,755,391,364
12,Castellón/Castelló,104,Segorbe,9139,4551,4588
12,Castellón/Castelló,103,"Serratella, la",92,45,47
12,Castellón/Castelló,105,Sierra Engarcerán,992,525,467
12,Castellón/Castelló,106,Soneja,1479,735,744
12,Castellón/Castelló,107,Sot de Ferrer,428,229,199
12,Castellón/Castelló,108,Sueras/Suera,554,293,261
12,Castellón/Castelló,109,Tales,843,433,410
12,Castellón/Castelló,110,Teresa,245,131,114
12,Castellón/Castelló,111,Tírig,419,211,208
12,Castellón/Castelló,112,Todolella,145,84,61
12,Castellón/Castelló,113,Toga,101,54,47
12,Castellón/Castelló,114,Torás,247,138,109
12,Castellón/Castelló,115,"Toro, El",239,132,107
12,Castellón/Castelló,116,Torralba del Pinar,63,30,33
12,Castellón/Castelló,119,"Torre d'En Besora, la",167,92,75
12,Castellón/Castelló,120,"Torre d'en Doménec, la",157,80,77
12,Castellón/Castelló,117,Torreblanca,5606,2845,2761
12,Castellón/Castelló,118,Torrechiva,93,49,44
12,Castellón/Castelló,121,Traiguera,1358,693,665
12,Castellón/Castelló,122,"Useras/Useres, les",968,507,461
12,Castellón/Castelló,124,Vall d'Alba,2943,1541,1402
12,Castellón/Castelló,125,Vall de Almonacid,286,143,143
12,Castellón/Castelló,126,"Vall d'Uixó, la",31549,15506,16043
12,Castellón/Castelló,123,Vallat,57,28,29
12,Castellón/Castelló,127,Vallibona,67,40,27
12,Castellón/Castelló,128,Vilafamés,1840,991,849
12,Castellón/Castelló,129,Vilafranca/Villafranca del Cid,2201,1085,1116
12,Castellón/Castelló,132,Vilanova d'Alcolea,578,297,281
12,Castellón/Castelló,134,Vilar de Canes,174,88,86
12,Castellón/Castelló,135,Vila-real,51130,25400,25730
12,Castellón/Castelló,136,"Vilavella, la",3111,1549,1562
12,Castellón/Castelló,130,Villahermosa del Río,476,268,208
12,Castellón/Castelló,131,Villamalur,92,61,31
12,Castellón/Castelló,133,Villanueva de Viver,82,43,39
12,Castellón/Castelló,137,Villores,46,22,24
12,Castellón/Castelló,138,Vinaròs,28862,14267,14595
12,Castellón/Castelló,139,Vistabella del Maestrat,337,183,154
12,Castellón/Castelló,140,Viver,1661,851,810
12,Castellón/Castelló,52,Xert,686,335,351
12,Castellón/Castelló,141,Zorita del Maestrazgo,116,60,56
12,Castellón/Castelló,142,Zucaina,175,98,77
51,Ceuta,1,Ceuta,83517,42208,41309
13,Ciudad Real,1,Abenójar,1339,691,648
13,Ciudad Real,2,Agudo,1638,824,814
13,Ciudad Real,3,Alamillo,470,242,228
13,Ciudad Real,4,Albaladejo,1099,561,538
13,Ciudad Real,5,Alcázar de San Juan,30548,14876,15672
13,Ciudad Real,6,Alcoba,540,274,266
13,Ciudad Real,7,Alcolea de Calatrava,1363,693,670
13,Ciudad Real,8,Alcubillas,466,225,241
13,Ciudad Real,9,Aldea del Rey,1598,805,793
13,Ciudad Real,10,Alhambra,989,500,489
13,Ciudad Real,11,Almadén,5105,2445,2660
13,Ciudad Real,12,Almadenejos,398,206,192
13,Ciudad Real,13,Almagro,8896,4395,4501
13,Ciudad Real,14,Almedina,497,269,228
13,Ciudad Real,15,Almodóvar del Campo,5947,2989,2958
13,Ciudad Real,16,Almuradiel,750,376,374
13,Ciudad Real,17,Anchuras,274,143,131
13,Ciudad Real,903,Arenales de San Gregorio,572,295,277
13,Ciudad Real,18,Arenas de San Juan,1033,529,504
13,Ciudad Real,19,Argamasilla de Alba,6844,3435,3409
13,Ciudad Real,20,Argamasilla de Calatrava,5853,2921,2932
13,Ciudad Real,21,Arroba de los Montes,408,222,186
13,Ciudad Real,22,Ballesteros de Calatrava,370,179,191
13,Ciudad Real,23,Bolaños de Calatrava,11992,6165,5827
13,Ciudad Real,24,Brazatortas,1002,523,479
13,Ciudad Real,25,Cabezarados,307,168,139
13,Ciudad Real,26,Cabezarrubias del Puerto,465,244,221
13,Ciudad Real,27,Calzada de Calatrava,3615,1801,1814
13,Ciudad Real,28,Campo de Criptana,13229,6614,6615
13,Ciudad Real,29,Cañada de Calatrava,105,60,45
13,Ciudad Real,30,Caracuel de Calatrava,116,68,48
13,Ciudad Real,31,Carrión de Calatrava,3086,1559,1527
13,Ciudad Real,32,Carrizosa,1175,599,576
13,Ciudad Real,33,Castellar de Santiago,1833,936,897
13,Ciudad Real,38,Chillón,1777,863,914
13,Ciudad Real,34,Ciudad Real,75104,35566,39538
13,Ciudad Real,35,Corral de Calatrava,1102,531,571
13,Ciudad Real,36,"Cortijos, Los",876,473,403
13,Ciudad Real,37,Cózar,923,467,456
13,Ciudad Real,39,Daimiel,17771,8913,8858
13,Ciudad Real,40,Fernán Caballero,979,501,478
13,Ciudad Real,41,Fontanarejo,248,141,107
13,Ciudad Real,42,Fuencaliente,1018,527,491
13,Ciudad Real,43,Fuenllana,214,114,100
13,Ciudad Real,44,Fuente el Fresno,3141,1610,1531
13,Ciudad Real,45,Granátula de Calatrava,719,356,363
13,Ciudad Real,46,Guadalmez,725,353,372
13,Ciudad Real,47,Herencia,8510,4314,4196
13,Ciudad Real,48,Hinojosas de Calatrava,503,265,238
13,Ciudad Real,49,Horcajo de los Montes,826,430,396
13,Ciudad Real,50,"Labores, Las",563,287,276
13,Ciudad Real,904,Llanos del Caudillo,700,344,356
13,Ciudad Real,51,Luciana,365,195,170
13,Ciudad Real,52,Malagón,7842,3878,3964
13,Ciudad Real,53,Manzanares,17845,8844,9001
13,Ciudad Real,54,Membrilla,5927,2971,2956
13,Ciudad Real,55,Mestanza,662,339,323
13,Ciudad Real,56,Miguelturra,15658,7880,7778
13,Ciudad Real,57,Montiel,1256,650,606
13,Ciudad Real,58,Moral de Calatrava,5211,2638,2573
13,Ciudad Real,59,Navalpino,208,111,97
13,Ciudad Real,60,Navas de Estena,287,160,127
13,Ciudad Real,61,Pedro Muñoz,7325,3694,3631
13,Ciudad Real,62,Picón,661,343,318
13,Ciudad Real,63,Piedrabuena,4390,2227,2163
13,Ciudad Real,64,Poblete,2759,1425,1334
13,Ciudad Real,65,Porzuna,3495,1808,1687
13,Ciudad Real,66,Pozuelo de Calatrava,3623,1851,1772
13,Ciudad Real,67,"Pozuelos de Calatrava, Los",352,188,164
13,Ciudad Real,68,Puebla de Don Rodrigo,1141,635,506
13,Ciudad Real,69,Puebla del Príncipe,687,364,323
13,Ciudad Real,70,Puerto Lápice,890,445,445
13,Ciudad Real,71,Puertollano,46036,22214,23822
13,Ciudad Real,72,Retuerta del Bullaque,930,518,412
13,Ciudad Real,901,"Robledo, El",1058,552,506
13,Ciudad Real,902,Ruidera,563,277,286
13,Ciudad Real,73,Saceruela,540,282,258
13,Ciudad Real,74,San Carlos del Valle,1087,559,528
13,Ciudad Real,75,San Lorenzo de Calatrava,211,119,92
13,Ciudad Real,76,Santa Cruz de los Cáñamos,515,250,265
13,Ciudad Real,77,Santa Cruz de Mudela,4017,2002,2015
13,Ciudad Real,78,Socuéllamos,12067,6081,5986
13,Ciudad Real,80,Solana del Pino,322,172,150
13,Ciudad Real,79,"Solana, La",15357,7802,7555
13,Ciudad Real,81,Terrinches,633,331,302
13,Ciudad Real,82,Tomelloso,35984,17902,18082
13,Ciudad Real,83,Torralba de Calatrava,2990,1487,1503
13,Ciudad Real,84,Torre de Juan Abad,990,486,504
13,Ciudad Real,85,Torrenueva,2708,1375,1333
13,Ciudad Real,86,Valdemanco del Esteras,164,86,78
13,Ciudad Real,87,Valdepeñas,30218,14768,15450
13,Ciudad Real,88,Valenzuela de Calatrava,658,303,355
13,Ciudad Real,89,Villahermosa,1770,876,894
13,Ciudad Real,90,Villamanrique,1114,547,567
13,Ciudad Real,91,Villamayor de Calatrava,612,302,310
13,Ciudad Real,92,Villanueva de la Fuente,1985,1023,962
13,Ciudad Real,93,Villanueva de los Infantes,4852,2425,2427
13,Ciudad Real,94,Villanueva de San Carlos,280,145,135
13,Ciudad Real,95,Villar del Pozo,56,33,23
13,Ciudad Real,96,Villarrubia de los Ojos,9722,4859,4863
13,Ciudad Real,97,Villarta de San Juan,2723,1369,1354
13,Ciudad Real,98,Viso del Marqués,2224,1085,1139
14,Córdoba,1,Adamuz,4141,2122,2019
14,Córdoba,2,Aguilar de la Frontera,13398,6684,6714
14,Córdoba,3,Alcaracejos,1481,716,765
14,Córdoba,4,Almedinilla,2352,1170,1182
14,Córdoba,5,Almodóvar del Río,8036,4004,4032
14,Córdoba,6,Añora,1526,754,772
14,Córdoba,7,Baena,18885,9455,9430
14,Córdoba,8,Belalcázar,3207,1557,1650
14,Córdoba,9,Belmez,2905,1407,1498
14,Córdoba,10,Benamejí,4982,2471,2511
14,Córdoba,11,"Blázquez, Los",659,337,322
14,Córdoba,12,Bujalance,7316,3658,3658
14,Córdoba,13,Cabra,20245,9870,10375
14,Córdoba,14,Cañete de las Torres,2888,1489,1399
14,Córdoba,15,Carcabuey,2374,1203,1171
14,Córdoba,16,Cardeña,1473,746,727
14,Córdoba,17,"Carlota, La",14228,7070,7158
14,Córdoba,18,"Carpio, El",4382,2163,2219
14,Córdoba,19,Castro del Río,7740,3826,3914
14,Córdoba,20,Conquista,372,192,180
14,Córdoba,21,Córdoba,322071,154617,167454
14,Córdoba,22,Doña Mencía,4603,2239,2364
14,Córdoba,23,Dos Torres,2399,1191,1208
14,Córdoba,24,Encinas Reales,2256,1116,1140
14,Córdoba,25,Espejo,3272,1641,1631
14,Córdoba,26,Espiel,2424,1210,1214
14,Córdoba,27,Fernán-Núñez,9667,4809,4858
14,Córdoba,901,Fuente Carreteros,1133,586,547
14,Córdoba,28,Fuente la Lancha,337,165,172
14,Córdoba,29,Fuente Obejuna,4505,2331,2174
14,Córdoba,30,Fuente Palmera,9803,4890,4913
14,Córdoba,31,Fuente-Tójar,676,328,348
14,Córdoba,32,"Granjuela, La",432,217,215
14,Córdoba,33,Guadalcázar,1562,779,783
14,Córdoba,902,"Guijarrosa, La",1365,699,666
14,Córdoba,34,"Guijo, El",349,179,170
14,Córdoba,35,Hinojosa del Duque,6684,3297,3387
14,Córdoba,36,Hornachuelos,4517,2249,2268
14,Córdoba,37,Iznájar,4106,2074,2032
14,Córdoba,38,Lucena,42712,21254,21458
14,Córdoba,39,Luque,2945,1483,1462
14,Córdoba,40,Montalbán de Córdoba,4517,2232,2285
14,Córdoba,41,Montemayor,3851,1929,1922
14,Córdoba,42,Montilla,22633,11214,11419
14,Córdoba,43,Montoro,9231,4558,4673
14,Córdoba,44,Monturque,1948,967,981
14,Córdoba,45,Moriles,3721,1868,1853
14,Córdoba,46,Nueva Carteya,5341,2717,2624
14,Córdoba,47,Obejo,2025,1054,971
14,Córdoba,48,Palenciana,1463,742,721
14,Córdoba,49,Palma del Río,20910,10407,10503
14,Córdoba,50,Pedro Abad,2808,1409,1399
14,Córdoba,51,Pedroche,1491,746,745
14,Córdoba,52,Peñarroya-Pueblonuevo,10508,5091,5417
14,Córdoba,53,Posadas,7296,3615,3681
14,Córdoba,54,Pozoblanco,17156,8321,8835
14,Córdoba,55,Priego de Córdoba,22251,10867,11384
14,Córdoba,56,Puente Genil,29767,14685,15082
14,Córdoba,57,"Rambla, La",7515,3763,3752
14,Córdoba,58,Rute,9835,4918,4917
14,Córdoba,59,San Sebastián de los Ballesteros,829,420,409
14,Córdoba,61,Santa Eufemia,747,374,373
14,Córdoba,60,Santaella,4611,2319,2292
14,Córdoba,62,Torrecampo,1020,503,517
14,Córdoba,63,Valenzuela,1098,553,545
14,Córdoba,64,Valsequillo,346,169,177
14,Córdoba,65,"Victoria, La",2336,1173,1163
14,Córdoba,66,Villa del Río,7016,3482,3534
14,Córdoba,67,Villafranca de Córdoba,4897,2507,2390
14,Córdoba,68,Villaharta,640,319,321
14,Córdoba,69,Villanueva de Córdoba,8662,4294,4368
14,Córdoba,70,Villanueva del Duque,1451,734,717
14,Córdoba,71,Villanueva del Rey,997,496,501
14,Córdoba,72,Villaralto,1102,557,545
14,Córdoba,73,Villaviciosa de Córdoba,3191,1636,1555
14,Córdoba,74,"Viso, El",2537,1267,1270
14,Córdoba,75,Zuheros,634,319,315
15,"Coruña, A",1,Abegondo,5494,2701,2793
15,"Coruña, A",2,Ames,31993,15379,16614
15,"Coruña, A",3,Aranga,1833,941,892
15,"Coruña, A",4,Ares,5997,2951,3046
15,"Coruña, A",5,Arteixo,32894,16272,16622
15,"Coruña, A",6,Arzúa,5964,2981,2983
15,"Coruña, A",7,"Baña, A",3389,1597,1792
15,"Coruña, A",8,Bergondo,6817,3331,3486
15,"Coruña, A",9,Betanzos,13030,6187,6843
15,"Coruña, A",10,Boimorto,1943,972,971
15,"Coruña, A",11,Boiro,18955,9206,9749
15,"Coruña, A",12,Boqueixón,4186,2050,2136
15,"Coruña, A",13,Brión,7957,3817,4140
15,"Coruña, A",14,Cabana de Bergantiños,4185,2022,2163
15,"Coruña, A",15,Cabanas,3359,1645,1714
15,"Coruña, A",16,Camariñas,5224,2552,2672
15,"Coruña, A",17,Cambre,24616,11986,12630
15,"Coruña, A",18,"Capela, A",1242,617,625
15,"Coruña, A",19,Carballo,31414,15347,16067
15,"Coruña, A",901,Cariño,3763,1855,1908
15,"Coruña, A",20,Carnota,3854,1821,2033
15,"Coruña, A",21,Carral,6574,3232,3342
15,"Coruña, A",22,Cedeira,6650,3324,3326
15,"Coruña, A",23,Cee,7568,3617,3951
15,"Coruña, A",24,Cerceda,4996,2466,2530
15,"Coruña, A",25,Cerdido,1075,528,547
15,"Coruña, A",27,Coirós,1873,929,944
15,"Coruña, A",28,Corcubión,1606,795,811
15,"Coruña, A",29,Coristanco,5878,2824,3054
15,"Coruña, A",30,"Coruña, A",245468,113806,131662
15,"Coruña, A",31,Culleredo,30758,14820,15938
15,"Coruña, A",32,Curtis,4081,2048,2033
15,"Coruña, A",33,Dodro,2710,1304,1406
15,"Coruña, A",34,Dumbría,2927,1405,1522
15,"Coruña, A",35,Fene,12832,6114,6718
15,"Coruña, A",36,Ferrol,64785,30473,34312
15,"Coruña, A",37,Fisterra,4714,2393,2321
15,"Coruña, A",38,Frades,2306,1135,1171
15,"Coruña, A",39,Irixoa,1340,677,663
15,"Coruña, A",41,"Laracha, A",11521,5669,5852
15,"Coruña, A",40,Laxe,3004,1511,1493
15,"Coruña, A",42,Lousame,3235,1618,1617
15,"Coruña, A",43,Malpica de Bergantiños,5332,2605,2727
15,"Coruña, A",44,Mañón,1309,646,663
15,"Coruña, A",45,Mazaricos,3806,1809,1997
15,"Coruña, A",46,Melide,7427,3661,3766
15,"Coruña, A",47,Mesía,2479,1233,1246
15,"Coruña, A",48,Miño,6423,3214,3209
15,"Coruña, A",49,Moeche,1200,573,627
15,"Coruña, A",50,Monfero,1908,977,931
15,"Coruña, A",51,Mugardos,5226,2542,2684
15,"Coruña, A",53,Muros,8399,4048,4351
15,"Coruña, A",52,Muxía,4564,2193,2371
15,"Coruña, A",54,Narón,38913,18851,20062
15,"Coruña, A",55,Neda,5032,2451,2581
15,"Coruña, A",56,Negreira,6775,3268,3507
15,"Coruña, A",57,Noia,14240,6810,7430
15,"Coruña, A",58,Oleiros,36922,17831,19091
15,"Coruña, A",59,Ordes,12605,6160,6445
15,"Coruña, A",60,Oroso,7530,3718,3812
15,"Coruña, A",61,Ortigueira,5485,2594,2891
15,"Coruña, A",62,Outes,6150,2957,3193
15,"Coruña, A",902,Oza-Cesuras,5170,2611,2559
15,"Coruña, A",64,Paderne,2393,1185,1208
15,"Coruña, A",65,Padrón,8317,4011,4306
15,"Coruña, A",66,"Pino, O",4639,2349,2290
15,"Coruña, A",67,"Pobra do Caramiñal, A",9291,4543,4748
15,"Coruña, A",68,Ponteceso,5457,2730,2727
15,"Coruña, A",69,Pontedeume,7687,3683,4004
15,"Coruña, A",70,"Pontes de García Rodríguez, As",10032,4900,5132
15,"Coruña, A",71,Porto do Son,9155,4557,4598
15,"Coruña, A",72,Rianxo,11004,5382,5622
15,"Coruña, A",73,Ribeira,26839,13234,13605
15,"Coruña, A",74,Rois,4493,2145,2348
15,"Coruña, A",75,Sada,16382,8006,8376
15,"Coruña, A",76,San Sadurniño,2812,1395,1417
15,"Coruña, A",77,Santa Comba,9359,4538,4821
15,"Coruña, A",78,Santiago de Compostela,97858,45505,52353
15,"Coruña, A",79,Santiso,1529,794,735
15,"Coruña, A",80,Sobrado,1778,923,855
15,"Coruña, A",81,"Somozas, As",1076,547,529
15,"Coruña, A",82,Teo,18778,9187,9591
15,"Coruña, A",83,Toques,1101,564,537
15,"Coruña, A",84,Tordoia,3228,1534,1694
15,"Coruña, A",85,Touro,3495,1730,1765
15,"Coruña, A",86,Trazo,3059,1503,1556
15,"Coruña, A",88,Val do Dubra,3816,1829,1987
15,"Coruña, A",87,Valdoviño,6872,3357,3515
15,"Coruña, A",89,Vedra,5032,2478,2554
15,"Coruña, A",91,Vilarmaior,1219,626,593
15,"Coruña, A",90,Vilasantar,1219,643,576
15,"Coruña, A",92,Vimianzo,6925,3348,3577
15,"Coruña, A",93,Zas,4384,2108,2276
16,Cuenca,1,Abia de la Obispalía,57,35,22
16,Cuenca,2,"Acebrón, El",227,107,120
16,Cuenca,3,Alarcón,151,69,82
16,Cuenca,4,Albaladejo del Cuende,236,125,111
16,Cuenca,5,Albalate de las Nogueras,256,137,119
16,Cuenca,6,Albendea,122,58,64
16,Cuenca,7,"Alberca de Záncara, La",1581,808,773
16,Cuenca,8,Alcalá de la Vega,85,52,33
16,Cuenca,9,Alcantud,48,27,21
16,Cuenca,10,Alcázar del Rey,128,68,60
16,Cuenca,11,Alcohujate,29,16,13
16,Cuenca,12,Alconchel de la Estrella,86,49,37
16,Cuenca,13,Algarra,24,11,13
16,Cuenca,14,Aliaguilla,644,331,313
16,Cuenca,15,"Almarcha, La",414,227,187
16,Cuenca,16,Almendros,234,129,105
16,Cuenca,17,Almodóvar del Pinar,383,199,184
16,Cuenca,18,Almonacid del Marquesado,440,227,213
16,Cuenca,19,Altarejos,200,105,95
16,Cuenca,20,Arandilla del Arroyo,7,5,2
16,Cuenca,905,Arcas,1867,932,935
16,Cuenca,22,Arcos de la Sierra,73,44,29
16,Cuenca,24,Arguisuelas,135,68,67
16,Cuenca,25,Arrancacepas,20,11,9
16,Cuenca,26,Atalaya del Cañavate,103,54,49
16,Cuenca,27,Barajas de Melo,1005,532,473
16,Cuenca,29,Barchín del Hoyo,94,63,31
16,Cuenca,30,Bascuñana de San Pedro,20,17,3
16,Cuenca,31,Beamud,38,20,18
16,Cuenca,32,Belinchón,369,190,179
16,Cuenca,33,Belmonte,1810,891,919
16,Cuenca,34,Belmontejo,143,83,60
16,Cuenca,35,Beteta,230,113,117
16,Cuenca,36,Boniches,139,69,70
16,Cuenca,38,Buciegas,32,22,10
16,Cuenca,39,Buenache de Alarcón,454,242,212
16,Cuenca,40,Buenache de la Sierra,105,59,46
16,Cuenca,41,Buendía,410,221,189
16,Cuenca,42,Campillo de Altobuey,1246,623,623
16,Cuenca,43,Campillos-Paravientos,101,61,40
16,Cuenca,44,Campillos-Sierra,32,15,17
16,Cuenca,901,Campos del Paraíso,714,372,342
16,Cuenca,45,Canalejas del Arroyo,170,94,76
16,Cuenca,46,Cañada del Hoyo,224,116,108
16,Cuenca,47,Cañada Juncosa,241,133,108
16,Cuenca,48,Cañamares,459,253,206
16,Cuenca,49,"Cañavate, El",140,67,73
16,Cuenca,50,Cañaveras,236,117,119
16,Cuenca,51,Cañaveruelas,130,66,64
16,Cuenca,52,Cañete,766,396,370
16,Cuenca,53,Cañizares,428,232,196
16,Cuenca,55,Carboneras de Guadazaón,778,402,376
16,Cuenca,56,Cardenete,488,254,234
16,Cuenca,57,Carrascosa,67,40,27
16,Cuenca,58,Carrascosa de Haro,101,51,50
16,Cuenca,60,Casas de Benítez,816,397,419
16,Cuenca,61,Casas de Fernando Alonso,1147,597,550
16,Cuenca,62,Casas de Garcimolina,29,18,11
16,Cuenca,63,Casas de Guijarro,119,62,57
16,Cuenca,64,Casas de Haro,835,445,390
16,Cuenca,65,Casas de los Pinos,417,202,215
16,Cuenca,66,Casasimarro,3089,1601,1488
16,Cuenca,67,Castejón,122,68,54
16,Cuenca,68,Castillejo de Iniesta,129,70,59
16,Cuenca,70,Castillejo-Sierra,29,16,13
16,Cuenca,72,Castillo de Garcimuñoz,128,75,53
16,Cuenca,71,Castillo-Albaráñez,20,9,11
16,Cuenca,73,Cervera del Llano,217,113,104
16,Cuenca,23,Chillarón de Cuenca,698,364,334
16,Cuenca,81,Chumillas,58,32,26
16,Cuenca,74,"Cierva, La",34,20,14
16,Cuenca,78,Cuenca,53988,25588,28400
16,Cuenca,79,Cueva del Hierro,35,22,13
16,Cuenca,82,Enguídanos,303,165,138
16,Cuenca,83,Fresneda de Altarejos,37,21,16
16,Cuenca,84,Fresneda de la Sierra,49,28,21
16,Cuenca,85,"Frontera, La",143,76,67
16,Cuenca,86,Fuente de Pedro Naharro,1209,625,584
16,Cuenca,87,Fuentelespino de Haro,246,126,120
16,Cuenca,88,Fuentelespino de Moya,103,55,48
16,Cuenca,904,Fuentenava de Jábaga,527,273,254
16,Cuenca,89,Fuentes,466,242,224
16,Cuenca,91,Fuertescusa,57,31,26
16,Cuenca,92,Gabaldón,170,100,70
16,Cuenca,93,Garaballa,63,33,30
16,Cuenca,94,Gascueña,148,86,62
16,Cuenca,95,Graja de Campalbo,91,50,41
16,Cuenca,96,Graja de Iniesta,354,185,169
16,Cuenca,97,Henarejos,137,72,65
16,Cuenca,98,"Herrumblar, El",690,353,337
16,Cuenca,99,"Hinojosa, La",195,99,96
16,Cuenca,100,"Hinojosos, Los",765,388,377
16,Cuenca,101,"Hito, El",159,83,76
16,Cuenca,102,Honrubia,1507,747,760
16,Cuenca,103,Hontanaya,250,144,106
16,Cuenca,104,Hontecillas,62,32,30
16,Cuenca,106,Horcajo de Santiago,3545,1801,1744
16,Cuenca,107,Huélamo,78,43,35
16,Cuenca,108,Huelves,84,48,36
16,Cuenca,109,Huérguina,53,29,24
16,Cuenca,110,Huerta de la Obispalía,126,73,53
16,Cuenca,111,Huerta del Marquesado,185,103,82
16,Cuenca,112,Huete,1746,896,850
16,Cuenca,113,Iniesta,4355,2153,2202
16,Cuenca,115,Laguna del Marquesado,54,31,23
16,Cuenca,116,Lagunaseca,55,33,22
16,Cuenca,117,Landete,1211,621,590
16,Cuenca,118,Ledaña,1562,778,784
16,Cuenca,119,Leganiel,209,108,101
16,Cuenca,121,"Majadas, Las",234,123,111
16,Cuenca,122,Mariana,304,158,146
16,Cuenca,123,Masegosa,61,34,27
16,Cuenca,124,"Mesas, Las",2310,1188,1122
16,Cuenca,125,Minglanilla,2237,1146,1091
16,Cuenca,126,Mira,908,453,455
16,Cuenca,128,Monreal del Llano,52,30,22
16,Cuenca,129,Montalbanejo,99,50,49
16,Cuenca,130,Montalbo,670,346,324
16,Cuenca,131,Monteagudo de las Salinas,119,69,50
16,Cuenca,132,Mota de Altarejos,32,20,12
16,Cuenca,133,Mota del Cuervo,6035,3007,3028
16,Cuenca,134,Motilla del Palancar,5964,2968,2996
16,Cuenca,135,Moya,129,76,53
16,Cuenca,137,Narboneta,42,22,20
16,Cuenca,139,Olivares de Júcar,295,152,143
16,Cuenca,140,Olmeda de la Cuesta,21,13,8
16,Cuenca,141,Olmeda del Rey,130,64,66
16,Cuenca,142,Olmedilla de Alarcón,142,85,57
16,Cuenca,143,Olmedilla de Eliz,15,12,3
16,Cuenca,145,Osa de la Vega,455,236,219
16,Cuenca,146,Pajarón,77,36,41
16,Cuenca,147,Pajaroncillo,56,35,21
16,Cuenca,148,Palomares del Campo,571,292,279
16,Cuenca,149,Palomera,157,76,81
16,Cuenca,150,Paracuellos,91,47,44
16,Cuenca,151,Paredes,57,33,24
16,Cuenca,152,"Parra de las Vegas, La",33,24,9
16,Cuenca,153,"Pedernoso, El",1132,559,573
16,Cuenca,154,"Pedroñeras, Las",6638,3399,3239
16,Cuenca,155,"Peral, El",633,356,277
16,Cuenca,156,"Peraleja, La",93,57,36
16,Cuenca,157,"Pesquera, La",209,115,94
16,Cuenca,158,"Picazo, El",660,337,323
16,Cuenca,159,Pinarejo,191,96,95
16,Cuenca,160,Pineda de Gigüela,61,42,19
16,Cuenca,161,Piqueras del Castillo,45,25,20
16,Cuenca,162,Portalrubio de Guadamejud,35,19,16
16,Cuenca,163,Portilla,58,31,27
16,Cuenca,165,Poyatos,58,32,26
16,Cuenca,166,Pozoamargo,289,159,130
16,Cuenca,908,Pozorrubielos de la Mancha,191,102,89
16,Cuenca,167,Pozorrubio de Santiago,322,153,169
16,Cuenca,169,"Pozuelo, El",40,28,12
16,Cuenca,170,Priego,892,451,441
16,Cuenca,171,"Provencio, El",2416,1208,1208
16,Cuenca,172,Puebla de Almenara,334,178,156
16,Cuenca,174,Puebla del Salvador,185,100,85
16,Cuenca,175,Quintanar del Rey,7616,3933,3683
16,Cuenca,176,Rada de Haro,53,34,19
16,Cuenca,177,Reíllo,111,58,53
16,Cuenca,181,Rozalén del Monte,60,30,30
16,Cuenca,185,Saceda-Trasierra,42,27,15
16,Cuenca,186,Saelices,459,236,223
16,Cuenca,187,Salinas del Manzano,74,44,30
16,Cuenca,188,Salmeroncillos,100,58,42
16,Cuenca,189,Salvacañete,287,147,140
16,Cuenca,190,San Clemente,6953,3506,3447
16,Cuenca,191,San Lorenzo de la Parrilla,1052,537,515
16,Cuenca,192,San Martín de Boniches,45,24,21
16,Cuenca,193,San Pedro Palmiches,50,29,21
16,Cuenca,194,Santa Cruz de Moya,232,121,111
16,Cuenca,196,Santa María de los Llanos,681,362,319
16,Cuenca,195,Santa María del Campo Rus,534,270,264
16,Cuenca,197,Santa María del Val,62,35,27
16,Cuenca,198,Sisante,1619,826,793
16,Cuenca,199,Solera de Gabaldón,27,15,12
16,Cuenca,909,Sotorribas,681,360,321
16,Cuenca,202,Talayuelas,849,452,397
16,Cuenca,203,Tarancón,15645,7735,7910
16,Cuenca,204,Tébar,292,155,137
16,Cuenca,205,Tejadillos,115,52,63
16,Cuenca,206,Tinajas,201,109,92
16,Cuenca,209,Torralba,109,64,45
16,Cuenca,211,Torrejoncillo del Rey,358,198,160
16,Cuenca,212,Torrubia del Campo,281,136,145
16,Cuenca,213,Torrubia del Castillo,36,21,15
16,Cuenca,215,Tragacete,261,148,113
16,Cuenca,216,Tresjuncos,268,145,123
16,Cuenca,217,Tribaldos,97,52,45
16,Cuenca,218,Uclés,226,118,108
16,Cuenca,219,Uña,89,48,41
16,Cuenca,906,"Valdecolmenas, Los",70,45,25
16,Cuenca,224,Valdemeca,73,44,29
16,Cuenca,225,Valdemorillo de la Sierra,56,32,24
16,Cuenca,227,Valdemoro-Sierra,112,61,51
16,Cuenca,228,Valdeolivas,204,127,77
16,Cuenca,902,Valdetórtola,124,73,51
16,Cuenca,903,"Valeras, Las",1479,781,698
16,Cuenca,231,Valhermoso de la Fuente,46,23,23
16,Cuenca,173,"Valle de Altomira, El",198,106,92
16,Cuenca,234,Valsalobre,21,11,10
16,Cuenca,236,Valverde de Júcar,1108,561,547
16,Cuenca,237,Valverdejo,95,52,43
16,Cuenca,238,Vara de Rey,473,243,230
16,Cuenca,239,Vega del Codorno,130,81,49
16,Cuenca,240,Vellisca,112,63,49
16,Cuenca,242,Villaconejos de Trabaque,323,165,158
16,Cuenca,243,Villaescusa de Haro,471,237,234
16,Cuenca,244,Villagarcía del Llano,719,361,358
16,Cuenca,245,Villalba de la Sierra,469,233,236
16,Cuenca,246,Villalba del Rey,492,262,230
16,Cuenca,247,Villalgordo del Marquesado,73,40,33
16,Cuenca,248,Villalpardo,993,498,495
16,Cuenca,249,Villamayor de Santiago,2466,1260,1206
16,Cuenca,250,Villanueva de Guadamejud,67,41,26
16,Cuenca,251,Villanueva de la Jara,2280,1155,1125
16,Cuenca,253,Villar de Cañas,386,203,183
16,Cuenca,254,Villar de Domingo García,207,101,106
16,Cuenca,255,Villar de la Encina,147,78,69
16,Cuenca,263,Villar de Olalla,1313,697,616
16,Cuenca,258,Villar del Humo,173,99,74
16,Cuenca,259,Villar del Infantado,45,25,20
16,Cuenca,910,Villar y Velasco,73,42,31
16,Cuenca,264,Villarejo de Fuentes,401,202,199
16,Cuenca,265,Villarejo de la Peñuela,23,12,11
16,Cuenca,266,Villarejo-Periesteban,384,191,193
16,Cuenca,269,Villares del Saz,447,230,217
16,Cuenca,270,Villarrubio,200,112,88
16,Cuenca,271,Villarta,808,403,405
16,Cuenca,272,Villas de la Ventosa,214,121,93
16,Cuenca,273,Villaverde y Pasaconsol,335,174,161
16,Cuenca,274,Víllora,120,65,55
16,Cuenca,275,Vindel,11,7,4
16,Cuenca,276,Yémeda,17,12,5
16,Cuenca,277,Zafra de Záncara,106,60,46
16,Cuenca,278,Zafrilla,57,31,26
16,Cuenca,279,Zarza de Tajo,269,146,123
16,Cuenca,280,Zarzuela,159,87,72
20,Gipuzkoa,1,Abaltzisketa,312,168,144
20,Gipuzkoa,2,Aduna,482,258,224
20,Gipuzkoa,16,Aia,2056,1087,969
20,Gipuzkoa,3,Aizarnazabal,795,405,390
20,Gipuzkoa,4,Albiztur,316,160,156
20,Gipuzkoa,5,Alegia,1762,910,852
20,Gipuzkoa,6,Alkiza,362,175,187
20,Gipuzkoa,906,Altzaga,177,84,93
20,Gipuzkoa,7,Altzo,447,229,218
20,Gipuzkoa,8,Amezketa,945,504,441
20,Gipuzkoa,9,Andoain,14631,7230,7401
20,Gipuzkoa,10,Anoeta,2086,1075,1011
20,Gipuzkoa,11,Antzuola,2081,1041,1040
20,Gipuzkoa,12,Arama,200,97,103
20,Gipuzkoa,13,Aretxabaleta,7108,3565,3543
20,Gipuzkoa,55,Arrasate/Mondragón,21867,10738,11129
20,Gipuzkoa,14,Asteasu,1549,792,757
20,Gipuzkoa,903,Astigarraga,7185,3665,3520
20,Gipuzkoa,15,Ataun,1697,872,825
20,Gipuzkoa,17,Azkoitia,11657,5802,5855
20,Gipuzkoa,18,Azpeitia,15191,7605,7586
20,Gipuzkoa,904,Baliarrain,153,86,67
20,Gipuzkoa,19,Beasain,13949,6999,6950
20,Gipuzkoa,20,Beizama,144,88,56
20,Gipuzkoa,21,Belauntza,253,131,122
20,Gipuzkoa,22,Berastegi,1099,559,540
20,Gipuzkoa,74,Bergara,14584,7243,7341
20,Gipuzkoa,23,Berrobi,598,314,284
20,Gipuzkoa,24,Bidania-Goiatz,534,286,248
20,Gipuzkoa,29,Deba,5441,2696,2745
20,Gipuzkoa,69,Donostia/San Sebastián,188102,88861,99241
20,Gipuzkoa,30,Eibar,27467,13379,14088
20,Gipuzkoa,31,Elduain,244,124,120
20,Gipuzkoa,33,Elgeta,1141,580,561
20,Gipuzkoa,32,Elgoibar,11464,5635,5829
20,Gipuzkoa,67,Errenteria,39219,18951,20268
20,Gipuzkoa,66,Errezil,578,301,277
20,Gipuzkoa,34,Eskoriatza,4131,2076,2055
20,Gipuzkoa,35,Ezkio-Itsaso,614,317,297
20,Gipuzkoa,38,Gabiria,502,272,230
20,Gipuzkoa,37,Gaintza,126,72,54
20,Gipuzkoa,907,Gaztelu,173,90,83
20,Gipuzkoa,39,Getaria,2794,1398,1396
20,Gipuzkoa,40,Hernani,20362,9974,10388
20,Gipuzkoa,41,Hernialde,321,167,154
20,Gipuzkoa,36,Hondarribia,16852,8390,8462
20,Gipuzkoa,42,Ibarra,4220,2096,2124
20,Gipuzkoa,43,Idiazabal,2281,1152,1129
20,Gipuzkoa,44,Ikaztegieta,485,250,235
20,Gipuzkoa,45,Irun,62933,30835,32098
20,Gipuzkoa,46,Irura,1877,986,891
20,Gipuzkoa,47,Itsasondo,658,338,320
20,Gipuzkoa,48,Larraul,259,148,111
20,Gipuzkoa,902,Lasarte-Oria,18893,9170,9723
20,Gipuzkoa,49,Lazkao,6007,3000,3007
20,Gipuzkoa,50,Leaburu,380,204,176
20,Gipuzkoa,51,Legazpi,8367,4211,4156
20,Gipuzkoa,52,Legorreta,1440,720,720
20,Gipuzkoa,68,Leintz-Gatzaga,211,118,93
20,Gipuzkoa,53,Lezo,6062,3023,3039
20,Gipuzkoa,54,Lizartza,625,329,296
20,Gipuzkoa,901,Mendaro,1983,1000,983
20,Gipuzkoa,57,Mutiloa,256,135,121
20,Gipuzkoa,56,Mutriku,5284,2644,2640
20,Gipuzkoa,63,Oiartzun,10291,5074,5217
20,Gipuzkoa,58,Olaberria,938,472,466
20,Gipuzkoa,59,Oñati,11428,5620,5808
20,Gipuzkoa,76,Ordizia,10420,5200,5220
20,Gipuzkoa,905,Orendain,230,112,118
20,Gipuzkoa,60,Orexa,117,66,51
20,Gipuzkoa,61,Orio,6096,3045,3051
20,Gipuzkoa,62,Ormaiztegi,1248,626,622
20,Gipuzkoa,64,Pasaia,15867,7617,8250
20,Gipuzkoa,70,Segura,1461,729,732
20,Gipuzkoa,65,Soraluze-Placencia de las Armas,3903,1966,1937
20,Gipuzkoa,71,Tolosa,19795,9559,10236
20,Gipuzkoa,72,Urnieta,6197,3119,3078
20,Gipuzkoa,77,Urretxu,6773,3359,3414
20,Gipuzkoa,73,Usurbil,6132,3064,3068
20,Gipuzkoa,75,Villabona,5864,2928,2936
20,Gipuzkoa,78,Zaldibia,1636,838,798
20,Gipuzkoa,79,Zarautz,23271,11298,11973
20,Gipuzkoa,25,Zegama,1550,784,766
20,Gipuzkoa,26,Zerain,282,137,145
20,Gipuzkoa,27,Zestoa,3769,1974,1795
20,Gipuzkoa,28,Zizurkil,3001,1518,1483
20,Gipuzkoa,81,Zumaia,10124,5036,5088
20,Gipuzkoa,80,Zumarraga,9668,4766,4902
17,Girona,1,Agullana,885,445,440
17,Girona,2,Aiguaviva,789,395,394
17,Girona,3,Albanyà,178,90,88
17,Girona,4,Albons,798,407,391
17,Girona,6,Alp,1645,849,796
17,Girona,7,Amer,2383,1170,1213
17,Girona,8,Anglès,5709,2850,2859
17,Girona,9,Arbúcies,6507,3355,3152
17,Girona,10,Argelaguer,417,212,205
17,Girona,11,"Armentera, L'",998,503,495
17,Girona,12,Avinyonet de Puigventós,1657,825,832
17,Girona,15,Banyoles,20168,10040,10128
17,Girona,16,Bàscara,1015,523,492
17,Girona,13,Begur,4039,2020,2019
17,Girona,18,Bellcaire d'Empordà,699,330,369
17,Girona,19,Besalú,2502,1175,1327
17,Girona,20,Bescanó,5094,2567,2527
17,Girona,21,Beuda,187,96,91
17,Girona,22,"Bisbal d'Empordà, La",11190,5596,5594
17,Girona,234,Biure,244,127,117
17,Girona,23,Blanes,40274,20054,20220
17,Girona,29,Boadella i les Escaules,271,138,133
17,Girona,24,Bolvir,489,256,233
17,Girona,25,Bordils,1796,904,892
17,Girona,26,Borrassà,752,388,364
17,Girona,27,Breda,3836,1894,1942
17,Girona,28,Brunyola i Sant Martí Sapresa,390,200,190
17,Girona,31,Cabanelles,266,148,118
17,Girona,30,Cabanes,941,504,437
17,Girona,32,Cadaqués,2820,1378,1442
17,Girona,33,Caldes de Malavella,8051,4024,4027
17,Girona,34,Calonge i Sant Antoni,11484,5762,5722
17,Girona,35,Camós,711,354,357
17,Girona,36,Campdevànol,3225,1567,1658
17,Girona,37,Campelles,149,76,73
17,Girona,38,Campllong,533,264,269
17,Girona,39,Camprodon,2435,1193,1242
17,Girona,40,Canet d'Adri,749,387,362
17,Girona,41,Cantallops,305,154,151
17,Girona,42,Capmany,618,313,305
17,Girona,44,Cassà de la Selva,10505,5346,5159
17,Girona,46,Castellfollit de la Roca,939,486,453
17,Girona,47,Castelló d'Empúries,11154,5629,5525
17,Girona,48,Castell-Platja d'Aro,11455,5654,5801
17,Girona,189,"Cellera de Ter, La",1973,964,1009
17,Girona,49,Celrà,5606,2808,2798
17,Girona,50,Cervià de Ter,973,498,475
17,Girona,51,Cistella,282,137,145
17,Girona,54,Colera,462,229,233
17,Girona,55,Colomers,188,92,96
17,Girona,57,Corçà,1275,655,620
17,Girona,56,Cornellà del Terri,2422,1227,1195
17,Girona,58,Crespià,270,138,132
17,Girona,901,"Cruïlles, Monells i Sant Sadurní de l'Heura",1327,664,663
17,Girona,60,Darnius,540,274,266
17,Girona,61,Das,248,129,119
17,Girona,62,"Escala, L'",10497,5324,5173
17,Girona,63,Espinelves,239,120,119
17,Girona,64,Espolla,412,204,208
17,Girona,65,Esponellà,469,240,229
17,Girona,5,"Far d'Empordà, El",619,318,301
17,Girona,66,Figueres,47043,23220,23823
17,Girona,67,Flaçà,1147,556,591
17,Girona,68,Foixà,299,149,150
17,Girona,69,Fontanals de Cerdanya,506,258,248
17,Girona,70,Fontanilles,157,88,69
17,Girona,71,Fontcoberta,1468,727,741
17,Girona,902,Forallac,1708,842,866
17,Girona,73,Fornells de la Selva,2700,1339,1361
17,Girona,74,Fortià,793,396,397
17,Girona,75,Garrigàs,464,243,221
17,Girona,76,Garrigoles,170,92,78
17,Girona,77,Garriguella,909,458,451
17,Girona,78,Ger,502,263,239
17,Girona,79,Girona,101932,49050,52882
17,Girona,80,Gombrèn,196,96,100
17,Girona,81,Gualta,421,242,179
17,Girona,82,Guils de Cerdanya,588,314,274
17,Girona,83,Hostalric,4332,2170,2162
17,Girona,84,Isòvol,314,173,141
17,Girona,85,Jafre,382,204,178
17,Girona,86,"Jonquera, La",3340,1676,1664
17,Girona,87,Juià,327,169,158
17,Girona,88,Lladó,845,417,428
17,Girona,89,Llagostera,8851,4456,4395
17,Girona,90,Llambilles,730,371,359
17,Girona,91,Llanars,535,274,261
17,Girona,92,Llançà,4842,2381,2461
17,Girona,93,Llers,1252,626,626
17,Girona,94,Llívia,1504,790,714
17,Girona,95,Lloret de Mar,38402,19552,18850
17,Girona,96,"Llosses, Les",209,122,87
17,Girona,102,Maçanet de Cabrenys,729,367,362
17,Girona,103,Maçanet de la Selva,7349,3796,3553
17,Girona,97,Madremanya,296,140,156
17,Girona,98,Maià de Montcal,469,255,214
17,Girona,100,Masarac,284,149,135
17,Girona,101,Massanes,803,427,376
17,Girona,99,Meranges,97,53,44
17,Girona,105,Mieres,349,178,171
17,Girona,106,Mollet de Peralada,197,106,91
17,Girona,107,Molló,347,167,180
17,Girona,109,Montagut i Oix,951,495,456
17,Girona,110,Mont-ras,1672,851,821
17,Girona,111,Navata,1434,698,736
17,Girona,112,Ogassa,240,133,107
17,Girona,114,Olot,36299,18284,18015
17,Girona,115,Ordis,369,198,171
17,Girona,116,Osor,426,225,201
17,Girona,117,Palafrugell,23046,11471,11575
17,Girona,118,Palamós,18196,8887,9309
17,Girona,119,Palau de Santa Eulàlia,111,62,49
17,Girona,121,Palau-sator,323,171,152
17,Girona,120,Palau-saverdera,1490,752,738
17,Girona,123,Palol de Revardit,446,219,227
17,Girona,124,Pals,2516,1305,1211
17,Girona,125,Pardines,166,90,76
17,Girona,126,Parlavà,413,206,207
17,Girona,128,Pau,588,294,294
17,Girona,129,Pedret i Marzà,187,93,94
17,Girona,130,"Pera, La",448,224,224
17,Girona,132,Peralada,1945,964,981
17,Girona,133,"Planes d'Hostoles, Les",1711,867,844
17,Girona,134,Planoles,311,167,144
17,Girona,135,Pont de Molins,518,261,257
17,Girona,136,Pontós,264,145,119
17,Girona,137,Porqueres,4701,2317,2384
17,Girona,140,"Port de la Selva, El",1010,524,486
17,Girona,138,Portbou,1095,547,548
17,Girona,139,"Preses, Les",1875,929,946
17,Girona,141,Puigcerdà,9518,4733,4785
17,Girona,142,Quart,3856,1951,1905
17,Girona,43,Queralbs,191,99,92
17,Girona,143,Rabós,206,99,107
17,Girona,144,Regencós,282,151,131
17,Girona,145,Ribes de Freser,1787,894,893
17,Girona,146,Riells i Viabrea,4268,2151,2117
17,Girona,147,Ripoll,10721,5329,5392
17,Girona,148,Riudarenes,2283,1187,1096
17,Girona,149,Riudaura,511,253,258
17,Girona,150,Riudellots de la Selva,2076,1049,1027
17,Girona,151,Riumors,244,127,117
17,Girona,152,Roses,19921,10106,9815
17,Girona,153,Rupià,296,148,148
17,Girona,154,Sales de Llierca,164,79,85
17,Girona,155,Salt,32230,16926,15304
17,Girona,157,Sant Andreu Salou,156,76,80
17,Girona,183,Sant Aniol de Finestres,353,179,174
17,Girona,158,Sant Climent Sescebes,712,432,280
17,Girona,159,Sant Feliu de Buixalleu,808,415,393
17,Girona,160,Sant Feliu de Guíxols,22210,10908,11302
17,Girona,161,Sant Feliu de Pallerols,1456,736,720
17,Girona,162,Sant Ferriol,247,131,116
17,Girona,163,Sant Gregori,4012,2066,1946
17,Girona,164,Sant Hilari Sacalm,5758,2903,2855
17,Girona,165,Sant Jaume de Llierca,852,421,431
17,Girona,167,Sant Joan de les Abadesses,3250,1613,1637
17,Girona,168,Sant Joan de Mollet,501,248,253
17,Girona,185,Sant Joan les Fonts,3050,1547,1503
17,Girona,166,Sant Jordi Desvalls,796,391,405
17,Girona,169,Sant Julià de Ramis,3612,1818,1794
17,Girona,903,Sant Julià del Llor i Bonmatí,1314,667,647
17,Girona,171,Sant Llorenç de la Muga,267,139,128
17,Girona,172,Sant Martí de Llémena,663,340,323
17,Girona,173,Sant Martí Vell,244,130,114
17,Girona,174,Sant Miquel de Campmajor,243,134,109
17,Girona,175,Sant Miquel de Fluvià,755,390,365
17,Girona,176,Sant Mori,157,78,79
17,Girona,177,Sant Pau de Segúries,725,359,366
17,Girona,178,Sant Pere Pescador,2083,1120,963
17,Girona,180,Santa Coloma de Farners,13459,6800,6659
17,Girona,181,Santa Cristina d'Aro,5408,2725,2683
17,Girona,182,Santa Llogaia d'Àlguema,378,193,185
17,Girona,184,Santa Pau,1585,814,771
17,Girona,186,Sarrià de Ter,5231,2585,2646
17,Girona,187,"Saus, Camallera i Llampaies",865,440,425
17,Girona,188,"Selva de Mar, La",212,109,103
17,Girona,190,Serinyà,1143,576,567
17,Girona,191,Serra de Daró,235,128,107
17,Girona,192,Setcases,185,102,83
17,Girona,193,Sils,6349,3257,3092
17,Girona,52,Siurana,179,85,94
17,Girona,194,Susqueda,99,59,40
17,Girona,195,"Tallada d'Empordà, La",466,247,219
17,Girona,196,Terrades,334,164,170
17,Girona,197,Torrent,160,88,72
17,Girona,198,Torroella de Fluvià,726,372,354
17,Girona,199,Torroella de Montgrí,12023,6107,5916
17,Girona,200,Tortellà,816,394,422
17,Girona,201,Toses,178,104,74
17,Girona,202,Tossa de Mar,5930,3010,2920
17,Girona,204,Ullà,1167,643,524
17,Girona,205,Ullastret,258,128,130
17,Girona,203,Ultramort,226,118,108
17,Girona,206,Urús,210,105,105
17,Girona,14,"Vajol, La",88,48,40
17,Girona,208,"Vall de Bianya, La",1315,664,651
17,Girona,207,"Vall d'en Bas, La",3115,1581,1534
17,Girona,170,Vallfogona de Ripollès,213,112,101
17,Girona,209,Vall-llobrega,918,464,454
17,Girona,210,Ventalló,914,464,450
17,Girona,211,Verges,1183,589,594
17,Girona,212,Vidrà,186,95,91
17,Girona,213,Vidreres,8073,4186,3887
17,Girona,214,Vilabertran,969,483,486
17,Girona,215,Vilablareix,3225,1609,1616
17,Girona,217,Viladamat,471,237,234
17,Girona,216,Viladasens,214,115,99
17,Girona,218,Vilademuls,835,431,404
17,Girona,220,Viladrau,1102,542,560
17,Girona,221,Vilafant,5480,2693,2787
17,Girona,223,Vilajuïga,1124,556,568
17,Girona,224,Vilallonga de Ter,386,209,177
17,Girona,225,Vilamacolum,371,218,153
17,Girona,226,Vilamalla,1154,584,570
17,Girona,227,Vilamaniscle,205,116,89
17,Girona,228,Vilanant,399,201,198
17,Girona,230,Vila-sacra,761,372,389
17,Girona,222,Vilaür,162,83,79
17,Girona,233,Vilobí d'Onyar,3310,1719,1591
17,Girona,232,Vilopriu,230,122,108
18,Granada,1,Agrón,255,131,124
18,Granada,2,Alamedilla,564,286,278
18,Granada,3,Albolote,19128,9428,9700
18,Granada,4,Albondón,722,398,324
18,Granada,5,Albuñán,403,208,195
18,Granada,6,Albuñol,7473,4135,3338
18,Granada,7,Albuñuelas,786,386,400
18,Granada,10,Aldeire,623,322,301
18,Granada,11,Alfacar,5497,2808,2689
18,Granada,12,Algarinejo,2440,1258,1182
18,Granada,13,Alhama de Granada,5667,2994,2673
18,Granada,14,Alhendín,9674,4900,4774
18,Granada,15,Alicún de Ortega,468,233,235
18,Granada,16,Almegíjar,330,161,169
18,Granada,17,Almuñécar,25890,12769,13121
18,Granada,904,Alpujarra de la Sierra,952,536,416
18,Granada,18,Alquife,561,276,285
18,Granada,20,Arenas del Rey,624,332,292
18,Granada,21,Armilla,24388,12006,12382
18,Granada,22,Atarfe,19198,9627,9571
18,Granada,23,Baza,20281,10028,10253
18,Granada,24,Beas de Granada,980,513,467
18,Granada,25,Beas de Guadix,323,162,161
18,Granada,27,Benalúa,3289,1620,1669
18,Granada,28,Benalúa de las Villas,1064,545,519
18,Granada,29,Benamaurel,2284,1134,1150
18,Granada,30,Bérchules,715,384,331
18,Granada,32,Bubión,322,172,150
18,Granada,33,Busquístar,286,152,134
18,Granada,34,Cacín,555,284,271
18,Granada,35,Cádiar,1492,799,693
18,Granada,36,Cájar,5262,2592,2670
18,Granada,114,"Calahorra, La",664,339,325
18,Granada,37,Calicasas,644,320,324
18,Granada,38,Campotéjar,1228,619,609
18,Granada,39,Caniles,4038,2065,1973
18,Granada,40,Cáñar,388,213,175
18,Granada,42,Capileira,580,283,297
18,Granada,43,Carataunas,200,106,94
18,Granada,44,Cástaras,240,145,95
18,Granada,45,Castilléjar,1288,671,617
18,Granada,46,Castril,2018,1048,970
18,Granada,47,Cenes de la Vega,8181,4077,4104
18,Granada,59,Chauchina,5624,2795,2829
18,Granada,61,Chimeneas,1244,656,588
18,Granada,62,Churriana de la Vega,15741,7760,7981
18,Granada,48,Cijuela,3472,1784,1688
18,Granada,49,Cogollos de Guadix,630,356,274
18,Granada,50,Cogollos de la Vega,2015,1029,986
18,Granada,51,Colomera,1298,675,623
18,Granada,53,Cortes de Baza,1870,932,938
18,Granada,54,Cortes y Graena,990,514,476
18,Granada,912,Cuevas del Campo,1742,877,865
18,Granada,56,Cúllar,4079,2033,2046
18,Granada,57,Cúllar Vega,7719,3927,3792
18,Granada,63,Darro,1636,832,804
18,Granada,64,Dehesas de Guadix,412,199,213
18,Granada,65,Dehesas Viejas,685,356,329
18,Granada,66,Deifontes,2625,1329,1296
18,Granada,67,Diezma,776,416,360
18,Granada,68,Dílar,2137,1069,1068
18,Granada,69,Dólar,637,345,292
18,Granada,915,Domingo Pérez de Granada,862,447,415
18,Granada,70,Dúdar,362,192,170
18,Granada,71,Dúrcal,7168,3580,3588
18,Granada,72,Escúzar,806,420,386
18,Granada,74,Ferreira,293,151,142
18,Granada,76,Fonelas,955,505,450
18,Granada,77,Fornes,534,274,260
18,Granada,78,Freila,936,502,434
18,Granada,79,Fuente Vaqueros,4415,2208,2207
18,Granada,905,"Gabias, Las",22051,11156,10895
18,Granada,82,Galera,1107,567,540
18,Granada,83,Gobernador,220,109,111
18,Granada,84,Gójar,5993,3036,2957
18,Granada,85,Gor,729,380,349
18,Granada,86,Gorafe,382,192,190
18,Granada,87,Granada,231775,106987,124788
18,Granada,88,Guadahortuna,1839,952,887
18,Granada,89,Guadix,18462,9191,9271
18,Granada,906,"Guájares, Los",1074,581,493
18,Granada,93,Gualchos,5287,2822,2465
18,Granada,94,Güéjar Sierra,2906,1550,1356
18,Granada,95,Güevéjar,2658,1398,1260
18,Granada,96,Huélago,384,195,189
18,Granada,97,Huéneja,1193,639,554
18,Granada,98,Huéscar,7236,3574,3662
18,Granada,99,Huétor de Santillán,1897,979,918
18,Granada,100,Huétor Tájar,10514,5288,5226
18,Granada,101,Huétor Vega,12120,6083,6037
18,Granada,102,Íllora,10080,5083,4997
18,Granada,103,Ítrabo,974,475,499
18,Granada,105,Iznalloz,5094,2605,2489
18,Granada,106,Játar,609,336,273
18,Granada,107,Jayena,1045,538,507
18,Granada,108,Jérez del Marquesado,954,491,463
18,Granada,109,Jete,985,518,467
18,Granada,111,Jun,3928,1986,1942
18,Granada,112,Juviles,136,70,66
18,Granada,115,Láchar,3550,1808,1742
18,Granada,116,Lanjarón,3612,1829,1783
18,Granada,117,Lanteira,571,309,262
18,Granada,119,Lecrín,2197,1098,1099
18,Granada,120,Lentegí,337,173,164
18,Granada,121,Lobras,130,67,63
18,Granada,122,Loja,20465,10224,10241
18,Granada,123,Lugros,311,163,148
18,Granada,124,Lújar,476,256,220
18,Granada,126,"Malahá, La",1788,899,889
18,Granada,127,Maracena,22358,10928,11430
18,Granada,128,Marchal,414,202,212
18,Granada,132,Moclín,3613,1791,1822
18,Granada,133,Molvízar,2748,1408,1340
18,Granada,134,Monachil,8137,4170,3967
18,Granada,135,Montefrío,5336,2765,2571
18,Granada,136,Montejícar,2072,1072,1000
18,Granada,137,Montillana,1127,594,533
18,Granada,138,Moraleda de Zafayona,3106,1568,1538
18,Granada,909,Morelábor,589,317,272
18,Granada,140,Motril,58545,28786,29759
18,Granada,141,Murtas,460,260,200
18,Granada,903,Nevada,1116,578,538
18,Granada,143,Nigüelas,1198,613,585
18,Granada,144,Nívar,1094,565,529
18,Granada,145,Ogíjares,14559,7223,7336
18,Granada,146,Orce,1192,601,591
18,Granada,147,Órgiva,5866,2915,2951
18,Granada,148,Otívar,1012,516,496
18,Granada,150,Padul,8934,4461,4473
18,Granada,151,Pampaneira,315,159,156
18,Granada,152,Pedro Martínez,1148,576,572
18,Granada,153,Peligros,11544,5707,5837
18,Granada,154,"Peza, La",1170,601,569
18,Granada,910,"Pinar, El",886,470,416
18,Granada,157,Pinos Genil,1518,784,734
18,Granada,158,Pinos Puente,9853,4918,4935
18,Granada,159,Píñar,1102,597,505
18,Granada,161,Polícar,261,138,123
18,Granada,162,Polopos,1714,959,755
18,Granada,163,Pórtugos,387,198,189
18,Granada,164,Puebla de Don Fadrique,2227,1130,1097
18,Granada,165,Pulianas,5480,2755,2725
18,Granada,167,Purullena,2320,1169,1151
18,Granada,168,Quéntar,987,514,473
18,Granada,170,Rubite,384,213,171
18,Granada,171,Salar,2638,1322,1316
18,Granada,173,Salobreña,12472,6230,6242
18,Granada,174,Santa Cruz del Comercio,543,277,266
18,Granada,175,Santa Fe,15175,7474,7701
18,Granada,176,Soportújar,259,134,125
18,Granada,177,Sorvilán,524,290,234
18,Granada,901,"Taha, La",715,354,361
18,Granada,178,Torre-Cardela,715,384,331
18,Granada,916,Torrenueva Costa,2892,1491,1401
18,Granada,179,Torvizcón,634,339,295
18,Granada,180,Trevélez,721,380,341
18,Granada,181,Turón,232,140,92
18,Granada,182,Ugíjar,2550,1262,1288
18,Granada,914,Valderrubio,2059,1016,1043
18,Granada,907,Valle del Zalabí,2117,1076,1041
18,Granada,902,"Valle, El",917,458,459
18,Granada,183,Válor,705,371,334
18,Granada,911,Vegas del Genil,11678,5947,5731
18,Granada,184,Vélez de Benaudalla,2923,1475,1448
18,Granada,185,Ventas de Huelma,666,363,303
18,Granada,149,Villa de Otura,7173,3622,3551
18,Granada,908,Villamena,963,500,463
18,Granada,187,Villanueva de las Torres,561,298,263
18,Granada,188,Villanueva Mesía,2038,998,1040
18,Granada,189,Víznar,1000,523,477
18,Granada,192,Zafarraya,2096,1096,1000
18,Granada,913,Zagra,914,483,431
18,Granada,193,"Zubia, La",19473,9649,9824
18,Granada,194,Zújar,2516,1275,1241
19,Guadalajara,1,Abánades,55,34,21
19,Guadalajara,2,Ablanque,60,33,27
19,Guadalajara,3,Adobes,32,18,14
19,Guadalajara,4,Alaminos,57,26,31
19,Guadalajara,5,Alarilla,127,82,45
19,Guadalajara,6,Albalate de Zorita,1080,599,481
19,Guadalajara,7,Albares,479,250,229
19,Guadalajara,8,Albendiego,45,31,14
19,Guadalajara,9,Alcocer,326,164,162
19,Guadalajara,10,Alcolea de las Peñas,16,9,7
19,Guadalajara,11,Alcolea del Pinar,326,191,135
19,Guadalajara,13,Alcoroches,128,78,50
19,Guadalajara,15,Aldeanueva de Guadalajara,99,57,42
19,Guadalajara,16,Algar de Mesa,53,38,15
19,Guadalajara,17,Algora,82,51,31
19,Guadalajara,18,Alhóndiga,157,88,69
19,Guadalajara,19,Alique,15,7,8
19,Guadalajara,20,Almadrones,55,36,19
19,Guadalajara,21,Almoguera,1307,662,645
19,Guadalajara,22,Almonacid de Zorita,694,358,336
19,Guadalajara,23,Alocén,161,82,79
19,Guadalajara,24,Alovera,13051,6657,6394
19,Guadalajara,27,Alustante,153,89,64
19,Guadalajara,31,Angón,8,7,1
19,Guadalajara,32,Anguita,152,78,74
19,Guadalajara,33,Anquela del Ducado,59,35,24
19,Guadalajara,34,Anquela del Pedregal,26,16,10
19,Guadalajara,36,Aranzueque,370,206,164
19,Guadalajara,37,Arbancón,139,82,57
19,Guadalajara,38,Arbeteta,20,16,4
19,Guadalajara,39,Argecilla,70,45,25
19,Guadalajara,40,Armallones,55,32,23
19,Guadalajara,41,Armuña de Tajuña,240,123,117
19,Guadalajara,42,Arroyo de las Fraguas,22,12,10
19,Guadalajara,43,Atanzón,100,66,34
19,Guadalajara,44,Atienza,395,227,168
19,Guadalajara,45,Auñón,140,80,60
19,Guadalajara,46,Azuqueca de Henares,35236,17777,17459
19,Guadalajara,47,Baides,63,33,30
19,Guadalajara,48,Baños de Tajo,21,15,6
19,Guadalajara,49,Bañuelos,13,11,2
19,Guadalajara,50,Barriopedro,17,11,6
19,Guadalajara,51,Berninches,53,35,18
19,Guadalajara,52,"Bodera, La",21,14,7
19,Guadalajara,53,Brihuega,2467,1297,1170
19,Guadalajara,54,Budia,201,121,80
19,Guadalajara,55,Bujalaro,48,23,25
19,Guadalajara,57,Bustares,76,46,30
19,Guadalajara,58,Cabanillas del Campo,10844,5447,5397
19,Guadalajara,59,Campillo de Dueñas,75,48,27
19,Guadalajara,60,Campillo de Ranas,167,98,69
19,Guadalajara,61,Campisábalos,66,46,20
19,Guadalajara,64,Canredondo,76,50,26
19,Guadalajara,65,Cantalojas,146,82,64
19,Guadalajara,66,Cañizar,57,34,23
19,Guadalajara,67,"Cardoso de la Sierra, El",56,35,21
19,Guadalajara,70,Casa de Uceda,98,51,47
19,Guadalajara,71,"Casar, El",12710,6458,6252
19,Guadalajara,73,Casas de San Galindo,19,14,5
19,Guadalajara,74,Caspueñas,116,72,44
19,Guadalajara,75,Castejón de Henares,61,39,22
19,Guadalajara,76,Castellar de la Muela,32,19,13
19,Guadalajara,78,Castilforte,60,37,23
19,Guadalajara,79,Castilnuevo,6,5,1
19,Guadalajara,80,Cendejas de Enmedio,66,33,33
19,Guadalajara,81,Cendejas de la Torre,24,17,7
19,Guadalajara,82,Centenera,143,82,61
19,Guadalajara,103,Checa,286,174,112
19,Guadalajara,104,Chequilla,17,9,8
19,Guadalajara,106,Chillarón del Rey,84,48,36
19,Guadalajara,105,Chiloeches,3797,1964,1833
19,Guadalajara,86,Cifuentes,1611,823,788
19,Guadalajara,87,Cincovillas,20,11,9
19,Guadalajara,88,Ciruelas,117,65,52
19,Guadalajara,89,Ciruelos del Pinar,23,14,9
19,Guadalajara,90,Cobeta,109,53,56
19,Guadalajara,91,Cogollor,21,14,7
19,Guadalajara,92,Cogolludo,552,328,224
19,Guadalajara,95,Condemios de Abajo,10,8,2
19,Guadalajara,96,Condemios de Arriba,111,65,46
19,Guadalajara,97,Congostrina,12,9,3
19,Guadalajara,98,Copernal,31,19,12
19,Guadalajara,99,Corduente,342,189,153
19,Guadalajara,102,"Cubillo de Uceda, El",129,72,57
19,Guadalajara,107,Driebes,361,194,167
19,Guadalajara,108,Durón,105,59,46
19,Guadalajara,109,Embid,33,19,14
19,Guadalajara,110,Escamilla,57,37,20
19,Guadalajara,111,Escariche,201,125,76
19,Guadalajara,112,Escopete,64,31,33
19,Guadalajara,113,Espinosa de Henares,627,322,305
19,Guadalajara,114,Esplegares,39,22,17
19,Guadalajara,115,Establés,29,18,11
19,Guadalajara,116,Estriégana,10,8,2
19,Guadalajara,117,Fontanar,2523,1323,1200
19,Guadalajara,118,Fuembellida,13,8,5
19,Guadalajara,119,Fuencemillán,86,52,34
19,Guadalajara,120,Fuentelahiguera de Albatages,132,78,54
19,Guadalajara,121,Fuentelencina,299,159,140
19,Guadalajara,122,Fuentelsaz,92,48,44
19,Guadalajara,123,Fuentelviejo,54,31,23
19,Guadalajara,124,Fuentenovilla,566,313,253
19,Guadalajara,125,Gajanejos,57,34,23
19,Guadalajara,126,Galápagos,2579,1346,1233
19,Guadalajara,127,Galve de Sorbe,95,53,42
19,Guadalajara,129,Gascueña de Bornova,31,19,12
19,Guadalajara,130,Guadalajara,87064,41856,45208
19,Guadalajara,132,Henche,86,46,40
19,Guadalajara,133,Heras de Ayuso,239,141,98
19,Guadalajara,134,Herrería,26,15,11
19,Guadalajara,135,Hiendelaencina,117,72,45
19,Guadalajara,136,Hijes,18,9,9
19,Guadalajara,138,Hita,292,162,130
19,Guadalajara,139,Hombrados,39,25,14
19,Guadalajara,142,Hontoba,378,211,167
19,Guadalajara,143,Horche,2702,1359,1343
19,Guadalajara,145,Hortezuela de Océn,38,23,15
19,Guadalajara,146,"Huerce, La",52,32,20
19,Guadalajara,147,Huérmeces del Cerro,41,29,12
19,Guadalajara,148,Huertahernando,58,37,21
19,Guadalajara,150,Hueva,105,63,42
19,Guadalajara,151,Humanes,1577,796,781
19,Guadalajara,152,Illana,776,434,342
19,Guadalajara,153,Iniéstola,22,15,7
19,Guadalajara,154,"Inviernas, Las",61,43,18
19,Guadalajara,155,Irueste,82,50,32
19,Guadalajara,156,Jadraque,1383,728,655
19,Guadalajara,157,Jirueque,51,35,16
19,Guadalajara,159,Ledanca,113,56,57
19,Guadalajara,160,Loranca de Tajuña,1396,752,644
19,Guadalajara,161,Lupiana,268,141,127
19,Guadalajara,162,Luzaga,65,37,28
19,Guadalajara,163,Luzón,65,32,33
19,Guadalajara,165,Majaelrayo,58,35,23
19,Guadalajara,166,Málaga del Fresno,180,102,78
19,Guadalajara,167,Malaguilla,175,96,79
19,Guadalajara,168,Mandayona,290,141,149
19,Guadalajara,169,Mantiel,30,20,10
19,Guadalajara,170,Maranchón,232,122,110
19,Guadalajara,171,Marchamalo,7889,3956,3933
19,Guadalajara,172,Masegoso de Tajuña,49,28,21
19,Guadalajara,173,Matarrubia,65,42,23
19,Guadalajara,174,Matillas,97,55,42
19,Guadalajara,175,Mazarete,31,17,14
19,Guadalajara,176,Mazuecos,270,151,119
19,Guadalajara,177,Medranda,63,33,30
19,Guadalajara,178,Megina,35,22,13
19,Guadalajara,179,Membrillera,102,60,42
19,Guadalajara,181,Miedes de Atienza,54,36,18
19,Guadalajara,182,"Mierla, La",40,26,14
19,Guadalajara,184,Millana,108,63,45
19,Guadalajara,183,Milmarcos,73,45,28
19,Guadalajara,185,"Miñosa, La",34,20,14
19,Guadalajara,186,Mirabueno,78,47,31
19,Guadalajara,187,Miralrío,59,32,27
19,Guadalajara,188,Mochales,42,23,19
19,Guadalajara,189,Mohernando,174,96,78
19,Guadalajara,190,Molina de Aragón,3217,1606,1611
19,Guadalajara,191,Monasterio,14,6,8
19,Guadalajara,192,Mondéjar,2745,1422,1323
19,Guadalajara,193,Montarrón,28,18,10
19,Guadalajara,194,Moratilla de los Meleros,102,58,44
19,Guadalajara,195,Morenilla,50,28,22
19,Guadalajara,196,Muduex,101,53,48
19,Guadalajara,197,"Navas de Jadraque, Las",31,21,10
19,Guadalajara,198,Negredo,17,9,8
19,Guadalajara,199,Ocentejo,17,12,5
19,Guadalajara,200,"Olivar, El",69,39,30
19,Guadalajara,201,Olmeda de Cobeta,63,35,28
19,Guadalajara,202,"Olmeda de Jadraque, La",15,10,5
19,Guadalajara,203,"Ordial, El",37,23,14
19,Guadalajara,204,Orea,210,119,91
19,Guadalajara,208,Pálmaces de Jadraque,44,29,15
19,Guadalajara,209,Pardos,40,24,16
19,Guadalajara,210,Paredes de Sigüenza,24,10,14
19,Guadalajara,211,Pareja,455,268,187
19,Guadalajara,212,Pastrana,839,417,422
19,Guadalajara,213,"Pedregal, El",66,43,23
19,Guadalajara,214,Peñalén,75,43,32
19,Guadalajara,215,Peñalver,151,95,56
19,Guadalajara,216,Peralejos de las Truchas,155,82,73
19,Guadalajara,217,Peralveche,40,30,10
19,Guadalajara,218,Pinilla de Jadraque,51,30,21
19,Guadalajara,219,Pinilla de Molina,10,8,2
19,Guadalajara,220,Pioz,4687,2447,2240
19,Guadalajara,221,Piqueras,49,33,16
19,Guadalajara,222,"Pobo de Dueñas, El",104,55,49
19,Guadalajara,223,Poveda de la Sierra,116,59,57
19,Guadalajara,224,Pozo de Almoguera,104,63,41
19,Guadalajara,225,Pozo de Guadalajara,1392,740,652
19,Guadalajara,226,Prádena de Atienza,40,28,12
19,Guadalajara,227,Prados Redondos,57,41,16
19,Guadalajara,228,Puebla de Beleña,35,21,14
19,Guadalajara,229,Puebla de Valles,59,32,27
19,Guadalajara,230,Quer,921,483,438
19,Guadalajara,231,Rebollosa de Jadraque,10,7,3
19,Guadalajara,232,"Recuenco, El",62,36,26
19,Guadalajara,233,Renera,109,66,43
19,Guadalajara,234,Retiendas,52,35,17
19,Guadalajara,235,Riba de Saelices,106,65,41
19,Guadalajara,237,Rillo de Gallo,47,29,18
19,Guadalajara,238,Riofrío del Llano,61,36,25
19,Guadalajara,239,Robledillo de Mohernando,127,71,56
19,Guadalajara,240,Robledo de Corpes,40,23,17
19,Guadalajara,241,Romanillos de Atienza,34,23,11
19,Guadalajara,242,Romanones,104,54,50
19,Guadalajara,243,Rueda de la Sierra,40,28,12
19,Guadalajara,244,Sacecorbo,91,52,39
19,Guadalajara,245,Sacedón,1530,796,734
19,Guadalajara,246,Saelices de la Sal,39,21,18
19,Guadalajara,247,Salmerón,141,82,59
19,Guadalajara,248,San Andrés del Congosto,74,47,27
19,Guadalajara,249,San Andrés del Rey,39,21,18
19,Guadalajara,250,Santiuste,15,10,5
19,Guadalajara,251,Saúca,54,32,22
19,Guadalajara,252,Sayatón,64,36,28
19,Guadalajara,254,Selas,43,21,22
19,Guadalajara,901,Semillas,36,22,14
19,Guadalajara,255,Setiles,85,46,39
19,Guadalajara,256,Sienes,49,29,20
19,Guadalajara,257,Sigüenza,4298,2170,2128
19,Guadalajara,258,Solanillos del Extremo,87,53,34
19,Guadalajara,259,Somolinos,30,16,14
19,Guadalajara,260,"Sotillo, El",41,21,20
19,Guadalajara,261,Sotodosos,30,18,12
19,Guadalajara,262,Tamajón,146,81,65
19,Guadalajara,263,Taragudo,45,28,17
19,Guadalajara,264,Taravilla,33,22,11
19,Guadalajara,265,Tartanedo,144,83,61
19,Guadalajara,266,Tendilla,298,165,133
19,Guadalajara,267,Terzaga,20,12,8
19,Guadalajara,268,Tierzo,48,27,21
19,Guadalajara,269,"Toba, La",80,51,29
19,Guadalajara,271,Tordellego,50,29,21
19,Guadalajara,270,Tordelrábano,10,6,4
19,Guadalajara,272,Tordesilos,94,54,40
19,Guadalajara,274,Torija,1577,829,748
19,Guadalajara,279,Torre del Burgo,470,269,201
19,Guadalajara,277,Torrecuadrada de Molina,18,13,5
19,Guadalajara,278,Torrecuadradilla,28,16,12
19,Guadalajara,280,Torrejón del Rey,5892,3072,2820
19,Guadalajara,281,Torremocha de Jadraque,20,11,9
19,Guadalajara,282,Torremocha del Campo,174,100,74
19,Guadalajara,283,Torremocha del Pinar,38,19,19
19,Guadalajara,284,Torremochuela,8,6,2
19,Guadalajara,285,Torrubia,23,14,9
19,Guadalajara,286,Tórtola de Henares,1240,668,572
19,Guadalajara,287,Tortuera,184,96,88
19,Guadalajara,288,Tortuero,17,12,5
19,Guadalajara,289,Traíd,27,17,10
19,Guadalajara,290,Trijueque,1327,728,599
19,Guadalajara,291,Trillo,1363,709,654
19,Guadalajara,293,Uceda,2933,1506,1427
19,Guadalajara,294,Ujados,30,15,15
19,Guadalajara,296,Utande,37,28,9
19,Guadalajara,297,Valdarachas,43,21,22
19,Guadalajara,298,Valdearenas,82,51,31
19,Guadalajara,299,Valdeavellano,100,54,46
19,Guadalajara,300,Valdeaveruelo,1144,601,543
19,Guadalajara,301,Valdeconcha,38,21,17
19,Guadalajara,302,Valdegrudas,52,33,19
19,Guadalajara,303,Valdelcubo,39,26,13
19,Guadalajara,304,Valdenuño Fernández,299,157,142
19,Guadalajara,305,Valdepeñas de la Sierra,145,84,61
19,Guadalajara,306,Valderrebollo,25,13,12
19,Guadalajara,307,Valdesotos,24,15,9
19,Guadalajara,308,Valfermoso de Tajuña,64,42,22
19,Guadalajara,309,Valhermoso,25,14,11
19,Guadalajara,310,Valtablado del Río,8,5,3
19,Guadalajara,311,Valverde de los Arroyos,92,49,43
19,Guadalajara,314,Viana de Jadraque,45,31,14
19,Guadalajara,317,Villanueva de Alcorón,138,78,60
19,Guadalajara,318,Villanueva de Argecilla,40,22,18
19,Guadalajara,319,Villanueva de la Torre,6591,3331,3260
19,Guadalajara,321,Villares de Jadraque,48,31,17
19,Guadalajara,322,Villaseca de Henares,25,13,12
19,Guadalajara,323,Villaseca de Uceda,40,21,19
19,Guadalajara,324,Villel de Mesa,180,107,73
19,Guadalajara,325,Viñuelas,182,91,91
19,Guadalajara,326,Yebes,4636,2412,2224
19,Guadalajara,327,Yebra,465,249,216
19,Guadalajara,329,Yélamos de Abajo,62,30,32
19,Guadalajara,330,Yélamos de Arriba,77,47,30
19,Guadalajara,331,Yunquera de Henares,4364,2241,2123
19,Guadalajara,332,"Yunta, La",91,53,38
19,Guadalajara,333,Zaorejas,104,73,31
19,Guadalajara,334,Zarzuela de Jadraque,56,35,21
19,Guadalajara,335,Zorita de los Canes,63,35,28
21,Huelva,1,Alájar,814,417,397
21,Huelva,2,Aljaraque,21706,10810,10896
21,Huelva,3,"Almendro, El",835,440,395
21,Huelva,4,Almonaster la Real,1786,954,832
21,Huelva,5,Almonte,24577,11922,12655
21,Huelva,6,Alosno,3929,1934,1995
21,Huelva,7,Aracena,8215,4051,4164
21,Huelva,8,Aroche,3046,1519,1527
21,Huelva,9,Arroyomolinos de León,950,482,468
21,Huelva,10,Ayamonte,21510,10786,10724
21,Huelva,11,Beas,4464,2231,2233
21,Huelva,12,Berrocal,312,156,156
21,Huelva,13,Bollullos Par del Condado,14392,7142,7250
21,Huelva,14,Bonares,6075,3036,3039
21,Huelva,15,Cabezas Rubias,716,377,339
21,Huelva,16,Cala,1158,584,574
21,Huelva,17,Calañas,2763,1408,1355
21,Huelva,18,"Campillo, El",1996,967,1029
21,Huelva,19,Campofrío,731,373,358
21,Huelva,20,Cañaveral de León,401,197,204
21,Huelva,21,Cartaya,20314,10337,9977
21,Huelva,22,Castaño del Robledo,230,126,104
21,Huelva,23,"Cerro de Andévalo, El",2320,1156,1164
21,Huelva,30,Chucena,2242,1123,1119
21,Huelva,24,Corteconcepción,571,307,264
21,Huelva,25,Cortegana,4635,2335,2300
21,Huelva,26,Cortelazor,303,141,162
21,Huelva,27,Cumbres de Enmedio,53,29,24
21,Huelva,28,Cumbres de San Bartolomé,374,187,187
21,Huelva,29,Cumbres Mayores,1734,858,876
21,Huelva,31,Encinasola,1292,659,633
21,Huelva,32,Escacena del Campo,2294,1117,1177
21,Huelva,33,Fuenteheridos,751,387,364
21,Huelva,34,Galaroza,1373,680,693
21,Huelva,35,Gibraleón,12810,6398,6412
21,Huelva,36,"Granada de Río-Tinto, La",242,120,122
21,Huelva,37,"Granado, El",517,272,245
21,Huelva,38,Higuera de la Sierra,1326,694,632
21,Huelva,39,Hinojales,338,169,169
21,Huelva,40,Hinojos,3903,1971,1932
21,Huelva,41,Huelva,142538,68393,74145
21,Huelva,42,Isla Cristina,21516,10786,10730
21,Huelva,43,Jabugo,2247,1127,1120
21,Huelva,44,Lepe,28293,14593,13700
21,Huelva,45,Linares de la Sierra,268,132,136
21,Huelva,46,Lucena del Puerto,3187,1673,1514
21,Huelva,47,Manzanilla,2152,1102,1050
21,Huelva,48,"Marines, Los",410,222,188
21,Huelva,49,Minas de Riotinto,3778,1837,1941
21,Huelva,50,Moguer,22061,11059,11002
21,Huelva,51,"Nava, La",255,135,120
21,Huelva,52,Nerva,5127,2458,2669
21,Huelva,53,Niebla,4158,2087,2071
21,Huelva,54,"Palma del Condado, La",10787,5386,5401
21,Huelva,55,Palos de la Frontera,12001,6145,5856
21,Huelva,56,Paterna del Campo,3478,1772,1706
21,Huelva,57,Paymogo,1149,569,580
21,Huelva,58,Puebla de Guzmán,3154,1622,1532
21,Huelva,59,Puerto Moral,281,136,145
21,Huelva,60,Punta Umbría,15891,8063,7828
21,Huelva,61,Rociana del Condado,7834,3906,3928
21,Huelva,62,Rosal de la Frontera,1682,833,849
21,Huelva,63,San Bartolomé de la Torre,3846,1917,1929
21,Huelva,64,San Juan del Puerto,9503,4777,4726
21,Huelva,66,San Silvestre de Guzmán,653,336,317
21,Huelva,65,Sanlúcar de Guadiana,380,189,191
21,Huelva,67,Santa Ana la Real,489,226,263
21,Huelva,68,Santa Bárbara de Casa,1055,522,533
21,Huelva,69,Santa Olalla del Cala,2034,1041,993
21,Huelva,70,Trigueros,7906,3919,3987
21,Huelva,71,Valdelarco,236,111,125
21,Huelva,72,Valverde del Camino,12714,6247,6467
21,Huelva,73,Villablanca,2911,1458,1453
21,Huelva,74,Villalba del Alcor,3334,1655,1679
21,Huelva,75,Villanueva de las Cruces,385,180,205
21,Huelva,76,Villanueva de los Castillejos,2849,1438,1411
21,Huelva,77,Villarrasa,2203,1111,1092
21,Huelva,78,Zalamea la Real,3055,1530,1525
21,Huelva,902,"Zarza-Perrunal, La",1252,629,623
21,Huelva,79,Zufre,785,407,378
22,Huesca,1,Abiego,271,138,133
22,Huesca,2,Abizanda,143,73,70
22,Huesca,3,Adahuesca,190,106,84
22,Huesca,4,Agüero,139,79,60
22,Huesca,907,Aínsa-Sobrarbe,2312,1159,1153
22,Huesca,6,Aisa,336,183,153
22,Huesca,7,Albalate de Cinca,1125,617,508
22,Huesca,8,Albalatillo,188,99,89
22,Huesca,9,Albelda,686,358,328
22,Huesca,11,Albero Alto,118,66,52
22,Huesca,12,Albero Bajo,137,75,62
22,Huesca,13,Alberuela de Tubo,306,154,152
22,Huesca,14,Alcalá de Gurrea,230,120,110
22,Huesca,15,Alcalá del Obispo,337,191,146
22,Huesca,16,Alcampell,627,297,330
22,Huesca,17,Alcolea de Cinca,1200,654,546
22,Huesca,18,Alcubierre,372,202,170
22,Huesca,19,Alerre,208,112,96
22,Huesca,20,Alfántega,133,71,62
22,Huesca,21,Almudévar,2412,1213,1199
22,Huesca,22,Almunia de San Juan,689,354,335
22,Huesca,23,Almuniente,454,240,214
22,Huesca,24,Alquézar,338,173,165
22,Huesca,25,Altorricón,1441,787,654
22,Huesca,27,Angüés,370,199,171
22,Huesca,28,Ansó,397,199,198
22,Huesca,29,Antillón,137,71,66
22,Huesca,32,Aragüés del Puerto,116,63,53
22,Huesca,35,Arén,318,177,141
22,Huesca,36,Argavieso,114,67,47
22,Huesca,37,Arguis,153,84,69
22,Huesca,39,Ayerbe,1028,508,520
22,Huesca,40,Azanuy-Alins,177,87,90
22,Huesca,41,Azara,162,86,76
22,Huesca,42,Azlor,148,65,83
22,Huesca,43,Baélls,94,54,40
22,Huesca,44,Bailo,263,160,103
22,Huesca,45,Baldellou,71,41,30
22,Huesca,46,Ballobar,849,440,409
22,Huesca,47,Banastás,327,169,158
22,Huesca,48,Barbastro,17146,8342,8804
22,Huesca,49,Barbués,91,55,36
22,Huesca,50,Barbuñales,100,50,50
22,Huesca,51,Bárcabo,106,57,49
22,Huesca,52,Belver de Cinca,1307,757,550
22,Huesca,53,Benabarre,1162,601,561
22,Huesca,54,Benasque,2239,1212,1027
22,Huesca,246,Beranuy,74,42,32
22,Huesca,55,Berbegal,308,165,143
22,Huesca,57,Bielsa,481,258,223
22,Huesca,58,Bierge,254,141,113
22,Huesca,59,Biescas,1550,813,737
22,Huesca,60,Binaced,1597,874,723
22,Huesca,61,Binéfar,9888,5234,4654
22,Huesca,62,Bisaurri,176,91,85
22,Huesca,63,Biscarrués,191,103,88
22,Huesca,64,Blecua y Torres,179,99,80
22,Huesca,66,Boltaña,1065,573,492
22,Huesca,67,Bonansa,90,51,39
22,Huesca,68,Borau,83,46,37
22,Huesca,69,Broto,564,317,247
22,Huesca,72,Caldearenas,222,129,93
22,Huesca,74,Campo,459,239,220
22,Huesca,75,Camporrélls,123,67,56
22,Huesca,76,Canal de Berdún,348,191,157
22,Huesca,77,Candasnos,402,217,185
22,Huesca,78,Canfranc,599,332,267
22,Huesca,79,Capdesaso,208,88,120
22,Huesca,80,Capella,350,182,168
22,Huesca,81,Casbas de Huesca,290,163,127
22,Huesca,83,Castejón de Monegros,497,265,232
22,Huesca,84,Castejón de Sos,791,396,395
22,Huesca,82,Castejón del Puente,345,179,166
22,Huesca,85,Castelflorite,103,51,52
22,Huesca,86,Castiello de Jaca,240,134,106
22,Huesca,87,Castigaleu,80,50,30
22,Huesca,88,Castillazuelo,164,84,80
22,Huesca,89,Castillonroy,333,174,159
22,Huesca,94,Chalamera,114,60,54
22,Huesca,95,Chía,83,52,31
22,Huesca,96,Chimillas,411,208,203
22,Huesca,90,Colungo,118,66,52
22,Huesca,99,Esplús,649,335,314
22,Huesca,102,Estada,204,119,85
22,Huesca,103,Estadilla,803,403,400
22,Huesca,105,Estopiñán del Castillo,120,62,58
22,Huesca,106,Fago,21,11,10
22,Huesca,107,Fanlo,103,67,36
22,Huesca,109,Fiscal,344,185,159
22,Huesca,110,Fonz,845,431,414
22,Huesca,111,Foradada del Toscar,158,86,72
22,Huesca,112,Fraga,15250,7830,7420
22,Huesca,113,"Fueva, La",612,329,283
22,Huesca,114,Gistaín,133,76,57
22,Huesca,115,"Grado, El",393,205,188
22,Huesca,116,Grañén,1740,907,833
22,Huesca,117,Graus,3434,1707,1727
22,Huesca,119,Gurrea de Gállego,1478,756,722
22,Huesca,122,Hoz de Jaca,68,36,32
22,Huesca,908,Hoz y Costean,240,136,104
22,Huesca,124,Huerto,227,123,104
22,Huesca,125,Huesca,53429,25516,27913
22,Huesca,126,Ibieca,113,61,52
22,Huesca,127,Igriés,703,375,328
22,Huesca,128,Ilche,185,92,93
22,Huesca,129,Isábena,247,127,120
22,Huesca,130,Jaca,13344,6544,6800
22,Huesca,131,Jasa,94,55,39
22,Huesca,133,Labuerda,154,85,69
22,Huesca,135,Laluenga,194,103,91
22,Huesca,136,Lalueza,885,460,425
22,Huesca,137,Lanaja,1195,623,572
22,Huesca,139,Laperdiguera,92,50,42
22,Huesca,141,Lascellas-Ponzano,133,81,52
22,Huesca,142,Lascuarre,147,74,73
22,Huesca,143,Laspaúles,222,124,98
22,Huesca,144,Laspuña,288,159,129
22,Huesca,149,Loarre,345,190,155
22,Huesca,150,Loporzano,574,322,252
22,Huesca,151,Loscorrales,93,48,45
22,Huesca,905,Lupiñén-Ortilla,348,176,172
22,Huesca,155,Monesma y Cajigar,69,37,32
22,Huesca,156,Monflorite-Lascasas,432,228,204
22,Huesca,157,Montanuy,215,121,94
22,Huesca,158,Monzón,17362,8791,8571
22,Huesca,160,Naval,261,141,120
22,Huesca,162,Novales,147,72,75
22,Huesca,163,Nueno,587,330,257
22,Huesca,164,Olvena,58,30,28
22,Huesca,165,Ontiñena,500,250,250
22,Huesca,167,Osso de Cinca,671,377,294
22,Huesca,168,Palo,28,14,14
22,Huesca,170,Panticosa,849,450,399
22,Huesca,172,Peñalba,692,385,307
22,Huesca,173,"Peñas de Riglos, Las",255,156,99
22,Huesca,174,Peralta de Alcofea,576,297,279
22,Huesca,175,Peralta de Calasanz,226,124,102
22,Huesca,176,Peraltilla,224,108,116
22,Huesca,177,Perarrúa,107,56,51
22,Huesca,178,Pertusa,129,78,51
22,Huesca,181,Piracés,96,49,47
22,Huesca,182,Plan,274,141,133
22,Huesca,184,Poleñino,199,104,95
22,Huesca,186,Pozán de Vero,234,116,118
22,Huesca,187,"Puebla de Castro, La",391,206,185
22,Huesca,188,Puente de Montañana,96,42,54
22,Huesca,902,Puente la Reina de Jaca,251,133,118
22,Huesca,189,Puértolas,212,115,97
22,Huesca,190,"Pueyo de Araguás, El",167,94,73
22,Huesca,193,Pueyo de Santa Cruz,326,163,163
22,Huesca,195,Quicena,291,139,152
22,Huesca,197,Robres,525,274,251
22,Huesca,199,Sabiñánigo,9352,4685,4667
22,Huesca,200,Sahún,302,147,155
22,Huesca,201,Salas Altas,309,160,149
22,Huesca,202,Salas Bajas,193,95,98
22,Huesca,203,Salillas,107,59,48
22,Huesca,204,Sallent de Gállego,1519,751,768
22,Huesca,205,San Esteban de Litera,570,300,270
22,Huesca,207,San Juan de Plan,148,83,65
22,Huesca,903,San Miguel del Cinca,795,413,382
22,Huesca,206,Sangarrén,219,112,107
22,Huesca,208,Santa Cilia,245,125,120
22,Huesca,209,Santa Cruz de la Serós,193,110,83
22,Huesca,906,Santa María de Dulcis,204,106,98
22,Huesca,212,Santaliestra y San Quílez,75,40,35
22,Huesca,213,Sariñena,4173,2186,1987
22,Huesca,214,Secastilla,149,67,82
22,Huesca,215,Seira,154,88,66
22,Huesca,217,Sena,491,258,233
22,Huesca,218,Senés de Alcubierre,45,23,22
22,Huesca,220,Sesa,162,94,68
22,Huesca,221,Sesué,123,57,66
22,Huesca,222,Siétamo,710,396,314
22,Huesca,223,Sopeira,93,53,40
22,Huesca,904,"Sotonera, La",903,484,419
22,Huesca,225,Tamarite de Litera,3449,1776,1673
22,Huesca,226,Tardienta,938,466,472
22,Huesca,227,Tella-Sin,224,128,96
22,Huesca,228,Tierz,800,394,406
22,Huesca,229,Tolva,126,68,58
22,Huesca,230,Torla-Ordesa,299,160,139
22,Huesca,232,Torralba de Aragón,109,63,46
22,Huesca,233,Torre la Ribera,95,50,45
22,Huesca,234,Torrente de Cinca,1279,724,555
22,Huesca,235,Torres de Alcanadre,91,52,39
22,Huesca,236,Torres de Barbués,251,121,130
22,Huesca,239,Tramaced,100,63,37
22,Huesca,242,Valfarta,65,38,27
22,Huesca,243,Valle de Bardají,64,39,25
22,Huesca,901,Valle de Hecho,817,432,385
22,Huesca,244,Valle de Lierp,46,27,19
22,Huesca,245,Velilla de Cinca,480,251,229
22,Huesca,909,Vencillón,399,216,183
22,Huesca,247,Viacamp y Litera,41,26,15
22,Huesca,248,Vicién,122,72,50
22,Huesca,249,Villanova,171,86,85
22,Huesca,250,Villanúa,524,275,249
22,Huesca,251,Villanueva de Sigena,364,196,168
22,Huesca,252,Yebra de Basa,152,91,61
22,Huesca,253,Yésero,60,34,26
22,Huesca,254,Zaidín,1860,978,882
23,Jaén,1,Albanchez de Mágina,992,519,473
23,Jaén,2,Alcalá la Real,21623,10662,10961
23,Jaén,3,Alcaudete,10434,5105,5329
23,Jaén,4,Aldeaquemada,487,260,227
23,Jaén,5,Andújar,36212,17697,18515
23,Jaén,6,Arjona,5450,2691,2759
23,Jaén,7,Arjonilla,3545,1794,1751
23,Jaén,8,Arquillos,1708,863,845
23,Jaén,905,Arroyo del Ojanco,2243,1134,1109
23,Jaén,9,Baeza,15762,7799,7963
23,Jaén,10,Bailén,17498,8688,8810
23,Jaén,11,Baños de la Encina,2596,1344,1252
23,Jaén,12,Beas de Segura,5115,2678,2437
23,Jaén,902,Bedmar y Garcíez,2656,1344,1312
23,Jaén,14,Begíjar,2998,1503,1495
23,Jaén,15,Bélmez de la Moraleda,1542,768,774
23,Jaén,16,Benatae,443,226,217
23,Jaén,17,Cabra del Santo Cristo,1786,937,849
23,Jaén,18,Cambil,2662,1389,1273
23,Jaén,19,Campillo de Arenas,1743,878,865
23,Jaén,20,Canena,1822,944,878
23,Jaén,21,Carboneros,608,314,294
23,Jaén,901,Cárcheles,1320,696,624
23,Jaén,24,"Carolina, La",15048,7442,7606
23,Jaén,25,Castellar,3267,1648,1619
23,Jaén,26,Castillo de Locubín,4019,1994,2025
23,Jaén,27,Cazalilla,775,393,382
23,Jaén,28,Cazorla,7248,3512,3736
23,Jaén,29,Chiclana de Segura,917,457,460
23,Jaén,30,Chilluévar,1392,685,707
23,Jaén,31,Escañuela,940,465,475
23,Jaén,32,Espeluy,609,296,313
23,Jaén,33,Frailes,1599,796,803
23,Jaén,34,Fuensanta de Martos,3011,1511,1500
23,Jaén,35,Fuerte del Rey,1313,677,636
23,Jaén,37,Génave,593,324,269
23,Jaén,38,"Guardia de Jaén, La",5082,2584,2498
23,Jaén,39,Guarromán,2714,1370,1344
23,Jaén,41,Higuera de Calatrava,601,316,285
23,Jaén,42,Hinojares,356,188,168
23,Jaén,43,Hornos,601,294,307
23,Jaén,44,Huelma,5682,2827,2855
23,Jaén,45,Huesa,2475,1251,1224
23,Jaén,46,Ibros,2808,1402,1406
23,Jaén,47,"Iruela, La",1892,952,940
23,Jaén,48,Iznatoraf,907,455,452
23,Jaén,49,Jabalquinto,2013,1014,999
23,Jaén,50,Jaén,111932,53799,58133
23,Jaén,51,Jamilena,3302,1668,1634
23,Jaén,52,Jimena,1249,605,644
23,Jaén,53,Jódar,11583,5783,5800
23,Jaén,40,Lahiguera,1652,816,836
23,Jaén,54,Larva,467,243,224
23,Jaén,55,Linares,56525,27620,28905
23,Jaén,56,Lopera,3640,1845,1795
23,Jaén,57,Lupión,830,408,422
23,Jaén,58,Mancha Real,11315,5638,5677
23,Jaén,59,Marmolejo,6726,3333,3393
23,Jaén,60,Martos,24271,12017,12254
23,Jaén,61,Mengíbar,9973,4960,5013
23,Jaén,62,Montizón,1635,840,795
23,Jaén,63,Navas de San Juan,4473,2257,2216
23,Jaén,64,Noalejo,1884,957,927
23,Jaén,65,Orcera,1761,889,872
23,Jaén,66,Peal de Becerro,5325,2659,2666
23,Jaén,67,Pegalajar,2859,1434,1425
23,Jaén,69,Porcuna,6115,3079,3036
23,Jaén,70,Pozo Alcón,4706,2428,2278
23,Jaén,71,Puente de Génave,2166,1091,1075
23,Jaén,72,"Puerta de Segura, La",2250,1137,1113
23,Jaén,73,Quesada,5161,2625,2536
23,Jaén,74,Rus,3516,1792,1724
23,Jaén,75,Sabiote,3867,1908,1959
23,Jaén,76,Santa Elena,887,464,423
23,Jaén,77,Santiago de Calatrava,670,355,315
23,Jaén,904,Santiago-Pontones,2832,1464,1368
23,Jaén,79,Santisteban del Puerto,4472,2316,2156
23,Jaén,80,Santo Tomé,2118,1077,1041
23,Jaén,81,Segura de la Sierra,1771,873,898
23,Jaén,82,Siles,2209,1128,1081
23,Jaén,84,Sorihuela del Guadalimar,1075,558,517
23,Jaén,85,Torreblascopedro,2422,1227,1195
23,Jaén,86,Torredelcampo,14059,7042,7017
23,Jaén,87,Torredonjimeno,13545,6679,6866
23,Jaén,88,Torreperogil,7194,3529,3665
23,Jaén,90,Torres,1350,696,654
23,Jaén,91,Torres de Albánchez,760,399,361
23,Jaén,92,Úbeda,34208,16725,17483
23,Jaén,93,Valdepeñas de Jaén,3649,1819,1830
23,Jaén,94,Vilches,4376,2194,2182
23,Jaén,95,Villacarrillo,10545,5316,5229
23,Jaén,96,Villanueva de la Reina,3026,1527,1499
23,Jaén,97,Villanueva del Arzobispo,7967,4072,3895
23,Jaén,98,Villardompardo,956,483,473
23,Jaén,99,"Villares, Los",6106,3067,3039
23,Jaén,101,Villarrodrigo,392,206,186
23,Jaén,903,Villatorres,4311,2190,2121
24,León,1,Acebedo,185,106,79
24,León,2,Algadefe,283,150,133
24,León,3,Alija del Infantado,594,313,281
24,León,4,Almanza,596,342,254
24,León,5,"Antigua, La",351,199,152
24,León,6,Ardón,562,298,264
24,León,7,Arganza,788,397,391
24,León,8,Astorga,10553,4940,5613
24,León,9,Balboa,287,159,128
24,León,10,"Bañeza, La",10068,4853,5215
24,León,11,Barjas,167,92,75
24,León,12,"Barrios de Luna, Los",308,179,129
24,León,14,Bembibre,8455,4067,4388
24,León,15,Benavides,2426,1198,1228
24,León,16,Benuza,464,277,187
24,León,17,Bercianos del Páramo,541,273,268
24,León,18,Bercianos del Real Camino,178,95,83
24,León,19,Berlanga del Bierzo,347,158,189
24,León,20,Boca de Huérgano,444,267,177
24,León,21,Boñar,1819,928,891
24,León,22,Borrenes,306,164,142
24,León,23,Brazuelo,306,172,134
24,León,24,"Burgo Ranero, El",725,383,342
24,León,25,Burón,294,172,122
24,León,26,Bustillo del Páramo,1113,575,538
24,León,27,Cabañas Raras,1331,688,643
24,León,28,Cabreros del Río,409,228,181
24,León,29,Cabrillanes,731,388,343
24,León,30,Cacabelos,4888,2410,2478
24,León,31,Calzada del Coto,217,128,89
24,León,32,Campazas,113,54,59
24,León,33,Campo de Villavidel,211,119,92
24,León,34,Camponaraya,4105,2017,2088
24,León,36,Candín,255,142,113
24,León,37,Cármenes,335,187,148
24,León,38,Carracedelo,3403,1705,1698
24,León,39,Carrizo,2266,1131,1135
24,León,40,Carrocera,452,238,214
24,León,41,Carucedo,511,253,258
24,León,42,Castilfalé,65,38,27
24,León,43,Castrillo de Cabrera,108,65,43
24,León,44,Castrillo de la Valduerna,149,70,79
24,León,46,Castrocalbón,940,489,451
24,León,47,Castrocontrigo,720,398,322
24,León,49,Castropodame,1605,837,768
24,León,50,Castrotierra de Valmadrigal,111,57,54
24,León,51,Cea,402,216,186
24,León,52,Cebanico,141,85,56
24,León,53,Cebrones del Río,423,236,187
24,León,65,Chozas de Abajo,2596,1344,1252
24,León,54,Cimanes de la Vega,441,227,214
24,León,55,Cimanes del Tejar,737,405,332
24,León,56,Cistierna,3038,1497,1541
24,León,57,Congosto,1431,711,720
24,León,58,Corbillos de los Oteros,193,112,81
24,León,59,Corullón,862,432,430
24,León,60,Crémenes,522,287,235
24,León,61,Cuadros,2057,1040,1017
24,León,62,Cubillas de los Oteros,133,75,58
24,León,63,Cubillas de Rueda,389,212,177
24,León,64,Cubillos del Sil,1796,937,859
24,León,66,Destriana,441,207,234
24,León,67,Encinedo,661,353,308
24,León,68,"Ercina, La",450,248,202
24,León,69,Escobar de Campos,33,19,14
24,León,70,Fabero,4346,2116,2230
24,León,71,Folgoso de la Ribera,1034,503,531
24,León,73,Fresno de la Vega,478,244,234
24,León,74,Fuentes de Carbajal,81,50,31
24,León,76,Garrafe de Torío,1589,850,739
24,León,77,Gordaliza del Pino,255,124,131
24,León,78,Gordoncillo,350,170,180
24,León,79,Gradefes,925,512,413
24,León,80,Grajal de Campos,205,100,105
24,León,81,Gusendos de los Oteros,127,67,60
24,León,82,Hospital de Órbigo,977,489,488
24,León,83,Igüeña,1109,577,532
24,León,84,Izagre,150,77,73
24,León,86,Joarilla de las Matas,270,142,128
24,León,87,Laguna Dalga,633,341,292
24,León,88,Laguna de Negrillos,1057,536,521
24,León,89,León,122051,55166,66885
24,León,92,Llamas de la Ribera,807,422,385
24,León,90,Lucillo,377,199,178
24,León,91,Luyego,564,305,259
24,León,93,Magaz de Cepeda,358,191,167
24,León,94,Mansilla de las Mulas,1708,853,855
24,León,95,Mansilla Mayor,326,173,153
24,León,96,Maraña,113,68,45
24,León,97,Matadeón de los Oteros,229,116,113
24,León,98,Matallana de Torío,1278,665,613
24,León,99,Matanza,167,89,78
24,León,100,Molinaseca,891,494,397
24,León,101,Murias de Paredes,367,190,177
24,León,102,Noceda del Bierzo,625,322,303
24,León,103,Oencia,273,155,118
24,León,104,"Omañas, Las",261,140,121
24,León,105,Onzonilla,1857,959,898
24,León,106,Oseja de Sajambre,231,140,91
24,León,107,Pajares de los Oteros,232,140,92
24,León,108,Palacios de la Valduerna,373,184,189
24,León,109,Palacios del Sil,912,499,413
24,León,110,Páramo del Sil,1244,638,606
24,León,112,Peranzanes,269,156,113
24,León,113,Pobladura de Pelayo García,388,199,189
24,León,114,"Pola de Gordón, La",3060,1548,1512
24,León,115,Ponferrada,63747,30144,33603
24,León,116,Posada de Valdeón,424,243,181
24,León,117,Pozuelo del Páramo,404,202,202
24,León,118,Prado de la Guzpeña,99,57,42
24,León,119,Priaranza del Bierzo,754,380,374
24,León,120,Prioro,337,199,138
24,León,121,Puebla de Lillo,672,390,282
24,León,122,Puente de Domingo Flórez,1438,749,689
24,León,123,Quintana del Castillo,718,399,319
24,León,124,Quintana del Marco,356,192,164
24,León,125,Quintana y Congosto,411,218,193
24,León,127,Regueras de Arriba,271,143,128
24,León,129,Reyero,131,68,63
24,León,130,Riaño,471,259,212
24,León,131,Riego de la Vega,708,381,327
24,León,132,Riello,616,347,269
24,León,133,Rioseco de Tapia,386,219,167
24,León,134,"Robla, La",3714,1845,1869
24,León,136,Roperuelos del Páramo,512,264,248
24,León,137,Sabero,1108,567,541
24,León,139,Sahagún,2441,1210,1231
24,León,141,San Adrián del Valle,100,57,43
24,León,142,San Andrés del Rabanedo,30160,14358,15802
24,León,144,San Cristóbal de la Polantera,658,346,312
24,León,145,San Emiliano,630,355,275
24,León,146,San Esteban de Nogales,252,133,119
24,León,148,San Justo de la Vega,1780,917,863
24,León,149,San Millán de los Caballeros,173,91,82
24,León,150,San Pedro Bercianos,230,121,109
24,León,143,Sancedo,536,269,267
24,León,151,Santa Colomba de Curueño,478,251,227
24,León,152,Santa Colomba de Somoza,518,285,233
24,León,153,Santa Cristina de Valmadrigal,262,135,127
24,León,154,Santa Elena de Jamuz,1029,540,489
24,León,155,Santa María de la Isla,468,243,225
24,León,158,Santa María de Ordás,332,179,153
24,León,156,Santa María del Monte de Cea,217,117,100
24,León,157,Santa María del Páramo,3109,1513,1596
24,León,159,Santa Marina del Rey,1848,936,912
24,León,160,Santas Martas,728,386,342
24,León,161,Santiago Millas,343,192,151
24,León,162,Santovenia de la Valdoncina,2079,1059,1020
24,León,163,Sariegos,5170,2599,2571
24,León,164,Sena de Luna,367,183,184
24,León,165,Sobrado,292,149,143
24,León,166,Soto de la Vega,1518,791,727
24,León,167,Soto y Amío,770,393,377
24,León,168,Toral de los Guzmanes,508,276,232
24,León,206,Toral de los Vados,1809,902,907
24,León,169,Toreno,3017,1503,1514
24,León,170,Torre del Bierzo,2079,1060,1019
24,León,171,Trabadelo,336,185,151
24,León,172,Truchas,418,221,197
24,León,173,Turcia,1003,517,486
24,León,174,Urdiales del Páramo,480,257,223
24,León,185,Val de San Lorenzo,496,247,249
24,León,175,Valdefresno,2208,1155,1053
24,León,176,Valdefuentes del Páramo,310,167,143
24,León,177,Valdelugueros,515,292,223
24,León,178,Valdemora,70,31,39
24,León,179,Valdepiélago,309,175,134
24,León,180,Valdepolo,1207,660,547
24,León,181,Valderas,1575,794,781
24,León,182,Valderrey,435,225,210
24,León,183,Valderrueda,836,446,390
24,León,184,Valdesamario,195,112,83
24,León,187,Valdevimbre,936,489,447
24,León,188,Valencia de Don Juan,5159,2535,2624
24,León,191,Vallecillo,123,72,51
24,León,189,Valverde de la Virgen,7442,3840,3602
24,León,190,Valverde-Enrique,152,77,75
24,León,193,"Vecilla, La",414,221,193
24,León,196,Vega de Espinareda,2005,1021,984
24,León,197,Vega de Infanzones,824,415,409
24,León,198,Vega de Valcarce,578,300,278
24,León,194,Vegacervera,262,137,125
24,León,199,Vegaquemada,426,244,182
24,León,201,Vegas del Condado,1149,663,486
24,León,202,Villablino,8226,3998,4228
24,León,203,Villabraz,92,52,40
24,León,205,Villadangos del Páramo,1214,653,561
24,León,207,Villademor de la Vega,299,158,141
24,León,209,Villafranca del Bierzo,2806,1351,1455
24,León,210,Villagatón,636,347,289
24,León,211,Villamandos,292,159,133
24,León,901,Villamanín,912,460,452
24,León,212,Villamañán,1083,553,530
24,León,213,Villamartín de Don Sancho,156,86,70
24,León,214,Villamejil,682,367,315
24,León,215,Villamol,150,78,72
24,León,216,Villamontán de la Valduerna,711,373,338
24,León,217,Villamoratiel de las Matas,129,72,57
24,León,218,Villanueva de las Manzanas,495,257,238
24,León,219,Villaobispo de Otero,515,287,228
24,León,902,Villaornate y Castro,318,165,153
24,León,221,Villaquejida,828,425,403
24,León,222,Villaquilambre,18597,9204,9393
24,León,223,Villarejo de Órbigo,2945,1439,1506
24,León,224,Villares de Órbigo,587,313,274
24,León,225,Villasabariego,1121,575,546
24,León,226,Villaselán,181,104,77
24,León,227,Villaturiel,1865,983,882
24,León,228,Villazala,636,344,292
24,León,229,Villazanzo de Valderaduey,392,228,164
24,León,230,Zotes del Páramo,419,237,182
25,Lleida,1,Abella de la Conca,171,89,82
25,Lleida,2,Àger,588,322,266
25,Lleida,3,Agramunt,5464,2763,2701
25,Lleida,38,Aitona,2493,1311,1182
25,Lleida,4,"Alamús, Els",773,390,383
25,Lleida,5,Alàs i Cerc,322,155,167
25,Lleida,6,"Albagés, L'",357,189,168
25,Lleida,7,Albatàrrec,2224,1148,1076
25,Lleida,8,Albesa,1561,847,714
25,Lleida,9,"Albi, L'",749,383,366
25,Lleida,10,Alcanó,233,118,115
25,Lleida,11,Alcarràs,9678,5070,4608
25,Lleida,12,Alcoletge,3492,1843,1649
25,Lleida,13,Alfarràs,2759,1427,1332
25,Lleida,14,Alfés,301,162,139
25,Lleida,15,Algerri,423,232,191
25,Lleida,16,Alguaire,3065,1632,1433
25,Lleida,17,Alins,279,147,132
25,Lleida,19,Almacelles,6875,3682,3193
25,Lleida,20,Almatret,310,173,137
25,Lleida,21,Almenar,3365,1778,1587
25,Lleida,22,Alòs de Balaguer,122,74,48
25,Lleida,23,Alpicat,6274,3159,3115
25,Lleida,24,Alt Àneu,430,250,180
25,Lleida,27,Anglesola,1356,686,670
25,Lleida,29,Arbeca,2141,1114,1027
25,Lleida,31,Arres,67,44,23
25,Lleida,32,Arsèguel,85,49,36
25,Lleida,33,Artesa de Lleida,1525,808,717
25,Lleida,34,Artesa de Segre,3441,1772,1669
25,Lleida,36,Aspa,207,103,104
25,Lleida,37,"Avellanes i Santa Linya, Les",447,250,197
25,Lleida,39,Baix Pallars,342,184,158
25,Lleida,40,Balaguer,17409,8918,8491
25,Lleida,41,Barbens,943,518,425
25,Lleida,42,"Baronia de Rialb, La",229,118,111
25,Lleida,44,Bassella,224,119,105
25,Lleida,45,Bausen,66,34,32
25,Lleida,46,Belianes,521,257,264
25,Lleida,170,Bellaguarda,292,154,138
25,Lleida,47,Bellcaire d'Urgell,1225,629,596
25,Lleida,48,Bell-lloc d'Urgell,2329,1155,1174
25,Lleida,49,Bellmunt d'Urgell,182,90,92
25,Lleida,50,Bellpuig,5151,2737,2414
25,Lleida,51,Bellver de Cerdanya,2135,1106,1029
25,Lleida,52,Bellvís,2258,1153,1105
25,Lleida,53,Benavent de Segrià,1533,810,723
25,Lleida,55,Biosca,178,96,82
25,Lleida,57,"Bòrdes, Es",285,158,127
25,Lleida,58,"Borges Blanques, Les",6195,3167,3028
25,Lleida,59,Bossòst,1120,546,574
25,Lleida,56,Bovera,261,147,114
25,Lleida,60,Cabanabona,60,28,32
25,Lleida,61,Cabó,94,47,47
25,Lleida,62,Camarasa,807,408,399
25,Lleida,63,Canejan,89,45,44
25,Lleida,904,Castell de Mur,169,97,72
25,Lleida,64,Castellar de la Ribera,136,68,68
25,Lleida,67,Castelldans,900,481,419
25,Lleida,68,Castellnou de Seana,692,359,333
25,Lleida,69,Castelló de Farfanya,529,287,242
25,Lleida,70,Castellserà,976,498,478
25,Lleida,71,Cava,46,32,14
25,Lleida,72,Cervera,9328,4763,4565
25,Lleida,73,Cervià de les Garrigues,665,354,311
25,Lleida,74,Ciutadilla,202,104,98
25,Lleida,75,Clariana de Cardener,158,83,75
25,Lleida,76,"Cogul, El",143,81,62
25,Lleida,77,Coll de Nargó,548,280,268
25,Lleida,163,"Coma i la Pedra, La",277,162,115
25,Lleida,161,Conca de Dalt,421,215,206
25,Lleida,78,Corbins,1499,839,660
25,Lleida,79,Cubells,357,182,175
25,Lleida,81,"Espluga Calba, L'",328,165,163
25,Lleida,82,Espot,366,196,170
25,Lleida,88,Estamariu,129,73,56
25,Lleida,85,Estaràs,172,87,85
25,Lleida,86,Esterri d'Àneu,832,406,426
25,Lleida,87,Esterri de Cardós,64,32,32
25,Lleida,89,Farrera,116,67,49
25,Lleida,908,Fígols i Alinyà,260,146,114
25,Lleida,92,"Floresta, La",145,79,66
25,Lleida,93,Fondarella,781,390,391
25,Lleida,94,Foradada,195,123,72
25,Lleida,96,"Fuliola, La",1247,635,612
25,Lleida,97,Fulleda,101,50,51
25,Lleida,98,Gavet de la Conca,262,133,129
25,Lleida,912,Gimenells i el Pla de la Font,1118,597,521
25,Lleida,99,Golmés,1855,931,924
25,Lleida,100,Gósol,232,133,99
25,Lleida,101,"Granadella, La",705,385,320
25,Lleida,102,"Granja d'Escarp, La",931,523,408
25,Lleida,103,Granyanella,145,82,63
25,Lleida,105,Granyena de les Garrigues,154,93,61
25,Lleida,104,Granyena de Segarra,159,86,73
25,Lleida,109,Guimerà,263,141,122
25,Lleida,903,"Guingueta d'Àneu, La",300,163,137
25,Lleida,110,Guissona,7291,3917,3374
25,Lleida,111,Guixers,126,76,50
25,Lleida,115,Isona i Conca Dellà,1060,578,482
25,Lleida,112,Ivars de Noguera,335,175,160
25,Lleida,113,Ivars d'Urgell,1553,818,735
25,Lleida,114,Ivorra,110,61,49
25,Lleida,910,Josa i Tuixén,100,58,42
25,Lleida,118,Juncosa,397,206,191
25,Lleida,119,Juneda,3569,1916,1653
25,Lleida,121,Les,966,475,491
25,Lleida,122,Linyola,2724,1380,1344
25,Lleida,123,Lladorre,244,124,120
25,Lleida,124,Lladurs,187,98,89
25,Lleida,125,Llardecans,429,229,200
25,Lleida,126,Llavorsí,345,176,169
25,Lleida,120,Lleida,140080,69390,70690
25,Lleida,127,Lles de Cerdanya,288,164,124
25,Lleida,128,Llimiana,155,90,65
25,Lleida,129,Llobera,187,108,79
25,Lleida,133,Maials,926,510,416
25,Lleida,130,Maldà,237,120,117
25,Lleida,131,Massalcoreig,599,344,255
25,Lleida,132,Massoteres,223,124,99
25,Lleida,134,Menàrguens,789,428,361
25,Lleida,135,Miralcamp,1366,713,653
25,Lleida,137,Mollerussa,14545,7462,7083
25,Lleida,136,"Molsosa, La",102,51,51
25,Lleida,139,Montellà i Martinet,596,328,268
25,Lleida,140,Montferrer i Castellbò,1081,588,493
25,Lleida,138,Montgai,655,346,309
25,Lleida,142,Montoliu de Lleida,493,259,234
25,Lleida,141,Montoliu de Segarra,191,105,86
25,Lleida,143,Montornès de Segarra,91,43,48
25,Lleida,145,Nalec,88,46,42
25,Lleida,25,Naut Aran,1941,1013,928
25,Lleida,146,Navès,293,148,145
25,Lleida,148,Odèn,253,149,104
25,Lleida,149,Oliana,1857,929,928
25,Lleida,150,Oliola,201,108,93
25,Lleida,151,Olius,962,519,443
25,Lleida,152,"Oluges, Les",169,92,77
25,Lleida,153,"Omellons, Els",202,109,93
25,Lleida,154,"Omells de na Gaia, Els",127,71,56
25,Lleida,155,Organyà,766,378,388
25,Lleida,156,Os de Balaguer,1000,513,487
25,Lleida,157,Ossó de Sió,196,94,102
25,Lleida,158,"Palau d'Anglesola, El",2205,1101,1104
25,Lleida,164,Penelles,443,254,189
25,Lleida,165,Peramola,348,174,174
25,Lleida,166,Pinell de Solsonès,188,109,79
25,Lleida,167,Pinós,290,155,135
25,Lleida,911,"Plans de Sió, Els",503,277,226
25,Lleida,168,"Poal, El",667,345,322
25,Lleida,169,"Pobla de Cérvoles, La",198,104,94
25,Lleida,171,"Pobla de Segur, La",3050,1522,1528
25,Lleida,30,"Pont de Bar, El",174,105,69
25,Lleida,173,"Pont de Suert, El",2331,1169,1162
25,Lleida,172,Ponts,2629,1338,1291
25,Lleida,174,"Portella, La",727,409,318
25,Lleida,175,Prats i Sansor,251,132,119
25,Lleida,176,Preixana,391,207,184
25,Lleida,177,Preixens,421,211,210
25,Lleida,179,Prullans,246,115,131
25,Lleida,180,Puiggròs,265,134,131
25,Lleida,181,Puigverd d'Agramunt,230,131,99
25,Lleida,182,Puigverd de Lleida,1384,711,673
25,Lleida,183,Rialp,658,327,331
25,Lleida,905,Ribera d'Ondara,431,219,212
25,Lleida,185,Ribera d'Urgellet,947,489,458
25,Lleida,186,Riner,281,139,142
25,Lleida,913,Riu de Cerdanya,93,56,37
25,Lleida,189,Rosselló,3186,1627,1559
25,Lleida,190,Salàs de Pallars,343,187,156
25,Lleida,191,Sanaüja,396,207,189
25,Lleida,196,Sant Esteve de la Sarga,122,74,48
25,Lleida,192,Sant Guim de Freixenet,1059,551,508
25,Lleida,197,Sant Guim de la Plana,184,101,83
25,Lleida,193,Sant Llorenç de Morunys,985,483,502
25,Lleida,902,Sant Martí de Riucorb,649,341,308
25,Lleida,194,Sant Ramon,497,261,236
25,Lleida,201,Sarroca de Bellera,120,69,51
25,Lleida,200,Sarroca de Lleida,357,196,161
25,Lleida,202,Senterada,150,88,62
25,Lleida,35,"Sentiu de Sió, La",426,222,204
25,Lleida,204,Seròs,1923,1038,885
25,Lleida,203,"Seu d'Urgell, La",12252,5949,6303
25,Lleida,205,Sidamon,755,403,352
25,Lleida,206,"Soleràs, El",337,181,156
25,Lleida,207,Solsona,9175,4533,4642
25,Lleida,208,Soriguera,431,229,202
25,Lleida,209,Sort,2181,1073,1108
25,Lleida,210,Soses,1781,935,846
25,Lleida,211,Sudanell,844,465,379
25,Lleida,212,Sunyer,334,187,147
25,Lleida,215,Talarn,489,288,201
25,Lleida,216,Talavera,287,158,129
25,Lleida,217,Tàrrega,17649,8752,8897
25,Lleida,218,Tarrés,105,51,54
25,Lleida,219,Tarroja de Segarra,187,103,84
25,Lleida,220,Térmens,1330,682,648
25,Lleida,221,Tírvia,131,63,68
25,Lleida,222,Tiurana,73,33,40
25,Lleida,223,Torà,1209,607,602
25,Lleida,224,"Torms, Els",145,78,67
25,Lleida,225,Tornabous,826,444,382
25,Lleida,227,"Torre de Cabdella, La",765,388,377
25,Lleida,226,Torrebesses,298,169,129
25,Lleida,228,Torrefarrera,4702,2379,2323
25,Lleida,907,Torrefeta i Florejacs,602,330,272
25,Lleida,230,Torregrossa,2157,1125,1032
25,Lleida,231,Torrelameu,759,471,288
25,Lleida,232,Torres de Segre,2381,1257,1124
25,Lleida,233,Torre-serona,383,200,183
25,Lleida,234,Tremp,5893,2892,3001
25,Lleida,43,"Vall de Boí, La",1060,562,498
25,Lleida,901,Vall de Cardós,382,204,178
25,Lleida,238,Vallbona de les Monges,236,122,114
25,Lleida,240,Vallfogona de Balaguer,1912,959,953
25,Lleida,906,"Valls d'Aguilar, Les",264,149,115
25,Lleida,239,"Valls de Valira, Les",800,412,388
25,Lleida,909,"Vansa i Fórnols, La",156,81,75
25,Lleida,242,Verdú,880,409,471
25,Lleida,243,Vielha e Mijaran,5674,2888,2786
25,Lleida,244,Vilagrassa,587,310,277
25,Lleida,245,Vilaller,554,293,261
25,Lleida,247,Vilamòs,164,90,74
25,Lleida,248,Vilanova de Bellpuig,1178,601,577
25,Lleida,254,Vilanova de la Barca,1127,625,502
25,Lleida,249,Vilanova de l'Aguda,194,95,99
25,Lleida,250,Vilanova de Meià,427,263,164
25,Lleida,251,Vilanova de Segrià,1000,544,456
25,Lleida,252,Vila-sana,761,378,383
25,Lleida,253,"Vilosell, El",192,100,92
25,Lleida,255,Vinaixa,464,244,220
27,Lugo,1,Abadín,2297,1144,1153
27,Lugo,2,Alfoz,1610,781,829
27,Lugo,3,Antas de Ulla,1935,954,981
27,Lugo,4,Baleira,1190,641,549
27,Lugo,901,Baralla,2445,1279,1166
27,Lugo,5,Barreiros,3001,1458,1543
27,Lugo,6,Becerreá,2826,1414,1412
27,Lugo,7,Begonte,2976,1492,1484
27,Lugo,8,Bóveda,1407,718,689
27,Lugo,902,Burela,9428,4717,4711
27,Lugo,9,Carballedo,2123,1065,1058
27,Lugo,10,Castro de Rei,5110,2533,2577
27,Lugo,11,Castroverde,2609,1343,1266
27,Lugo,12,Cervantes,1288,742,546
27,Lugo,13,Cervo,4192,2071,2121
27,Lugo,16,Chantada,8134,3931,4203
27,Lugo,14,"Corgo, O",3440,1766,1674
27,Lugo,15,Cospeito,4374,2142,2232
27,Lugo,17,Folgoso do Courel,989,512,477
27,Lugo,18,"Fonsagrada, A",3328,1751,1577
27,Lugo,19,Foz,10078,4880,5198
27,Lugo,20,Friol,3682,1874,1808
27,Lugo,22,Guitiriz,5455,2735,2720
27,Lugo,23,Guntín,2638,1354,1284
27,Lugo,24,"Incio, O",1521,771,750
27,Lugo,26,Láncara,2551,1305,1246
27,Lugo,27,Lourenzá,2129,1032,1097
27,Lugo,28,Lugo,97613,45039,52574
27,Lugo,29,Meira,1731,876,855
27,Lugo,30,Mondoñedo,3480,1629,1851
27,Lugo,31,Monforte de Lemos,18242,8675,9567
27,Lugo,32,Monterroso,3562,1771,1791
27,Lugo,33,Muras,611,310,301
27,Lugo,34,Navia de Suarna,1041,584,457
27,Lugo,35,Negueira de Muñiz,223,120,103
27,Lugo,37,"Nogais, As",1018,541,477
27,Lugo,38,Ourol,984,506,478
27,Lugo,39,Outeiro de Rei,5216,2685,2531
27,Lugo,40,Palas de Rei,3316,1679,1637
27,Lugo,41,Pantón,2429,1205,1224
27,Lugo,42,Paradela,1723,861,862
27,Lugo,43,"Páramo, O",1347,675,672
27,Lugo,44,"Pastoriza, A",2918,1474,1444
27,Lugo,45,Pedrafita do Cebreiro,943,512,431
27,Lugo,47,"Pobra do Brollón, A",1615,794,821
27,Lugo,46,Pol,1634,816,818
27,Lugo,48,"Pontenova, A",2207,1058,1149
27,Lugo,49,Portomarín,1382,717,665
27,Lugo,50,Quiroga,3151,1481,1670
27,Lugo,56,Rábade,1524,754,770
27,Lugo,51,Ribadeo,9871,4677,5194
27,Lugo,52,Ribas de Sil,946,481,465
27,Lugo,53,Ribeira de Piquín,513,270,243
27,Lugo,54,Riotorto,1213,607,606
27,Lugo,55,Samos,1222,648,574
27,Lugo,57,Sarria,13257,6446,6811
27,Lugo,58,"Saviñao, O",3589,1805,1784
27,Lugo,59,Sober,2243,1100,1143
27,Lugo,60,Taboada,2689,1289,1400
27,Lugo,61,Trabada,1114,538,576
27,Lugo,62,Triacastela,627,313,314
27,Lugo,63,"Valadouro, O",1960,935,1025
27,Lugo,64,"Vicedo, O",1657,812,845
27,Lugo,65,Vilalba,14006,6728,7278
27,Lugo,66,Viveiro,15312,7485,7827
27,Lugo,21,Xermade,1768,867,901
27,Lugo,25,Xove,3360,1724,1636
28,Madrid,1,"Acebeda, La",55,26,29
28,Madrid,2,Ajalvir,4676,2437,2239
28,Madrid,3,Alameda del Valle,246,148,98
28,Madrid,4,"Álamo, El",9908,4892,5016
28,Madrid,5,Alcalá de Henares,195982,95061,100921
28,Madrid,6,Alcobendas,116589,55719,60870
28,Madrid,7,Alcorcón,170817,81998,88819
28,Madrid,8,Aldea del Fresno,3085,1574,1511
28,Madrid,9,Algete,20749,10184,10565
28,Madrid,10,Alpedrete,14959,7351,7608
28,Madrid,11,Ambite,662,330,332
28,Madrid,12,Anchuelo,1359,701,658
28,Madrid,13,Aranjuez,59833,29126,30707
28,Madrid,14,Arganda del Rey,56386,28161,28225
28,Madrid,15,Arroyomolinos,33687,16775,16912
28,Madrid,16,"Atazar, El",109,62,47
28,Madrid,17,Batres,1820,924,896
28,Madrid,18,Becerril de la Sierra,6108,3042,3066
28,Madrid,19,Belmonte de Tajo,1751,902,849
28,Madrid,21,"Berrueco, El",796,407,389
28,Madrid,20,Berzosa del Lozoya,216,124,92
28,Madrid,22,Boadilla del Monte,59052,28833,30219
28,Madrid,23,"Boalo, El",8009,4025,3984
28,Madrid,24,Braojos,218,132,86
28,Madrid,25,Brea de Tajo,523,302,221
28,Madrid,26,Brunete,10726,5284,5442
28,Madrid,27,Buitrago del Lozoya,1940,930,1010
28,Madrid,28,Bustarviejo,2701,1366,1335
28,Madrid,29,Cabanillas de la Sierra,837,433,404
28,Madrid,30,"Cabrera, La",2782,1357,1425
28,Madrid,31,Cadalso de los Vidrios,3203,1651,1552
28,Madrid,32,Camarma de Esteruelas,7555,3799,3756
28,Madrid,33,Campo Real,6416,3251,3165
28,Madrid,34,Canencia,461,247,214
28,Madrid,35,Carabaña,2142,1076,1066
28,Madrid,36,Casarrubuelos,3939,2012,1927
28,Madrid,37,Cenicientos,2083,1043,1040
28,Madrid,38,Cercedilla,7359,3645,3714
28,Madrid,39,Cervera de Buitrago,158,96,62
28,Madrid,51,Chapinería,2494,1256,1238
28,Madrid,52,Chinchón,5506,2766,2740
28,Madrid,40,Ciempozuelos,25083,12652,12431
28,Madrid,41,Cobeña,7444,3646,3798
28,Madrid,46,Collado Mediano,7348,3654,3694
28,Madrid,47,Collado Villalba,63825,30921,32904
28,Madrid,43,Colmenar de Oreja,8303,4189,4114
28,Madrid,42,Colmenar del Arroyo,1875,980,895
28,Madrid,45,Colmenar Viejo,52480,25888,26592
28,Madrid,44,Colmenarejo,9376,4578,4798
28,Madrid,48,Corpa,742,381,361
28,Madrid,49,Coslada,81273,39711,41562
28,Madrid,50,Cubas de la Sagra,6642,3304,3338
28,Madrid,53,Daganzo de Arriba,10520,5242,5278
28,Madrid,54,"Escorial, El",16594,8155,8439
28,Madrid,55,Estremera,1381,716,665
28,Madrid,56,Fresnedillas de la Oliva,1742,878,864
28,Madrid,57,Fresno de Torote,2416,1279,1137
28,Madrid,58,Fuenlabrada,192233,94533,97700
28,Madrid,59,Fuente el Saz de Jarama,6883,3470,3413
28,Madrid,60,Fuentidueña de Tajo,2228,1115,1113
28,Madrid,61,Galapagar,34712,16926,17786
28,Madrid,62,Garganta de los Montes,411,216,195
28,Madrid,63,Gargantilla del Lozoya y Pinilla de Buitrago,344,192,152
28,Madrid,64,Gascones,191,103,88
28,Madrid,65,Getafe,183095,89299,93796
28,Madrid,66,Griñón,10467,5210,5257
28,Madrid,67,Guadalix de la Sierra,6594,3320,3274
28,Madrid,68,Guadarrama,16747,8275,8472
28,Madrid,69,"Hiruela, La",72,50,22
28,Madrid,70,Horcajo de la Sierra-Aoslos,170,88,82
28,Madrid,71,Horcajuelo de la Sierra,106,57,49
28,Madrid,72,Hoyo de Manzanares,8680,4363,4317
28,Madrid,73,Humanes de Madrid,19736,9807,9929
28,Madrid,74,Leganés,187762,90732,97030
28,Madrid,75,Loeches,8860,4458,4402
28,Madrid,76,Lozoya,593,318,275
28,Madrid,901,Lozoyuela-Navas-Sieteiglesias,1407,728,679
28,Madrid,78,Madarcos,57,33,24
28,Madrid,79,Madrid,3305408,1540894,1764514
28,Madrid,80,Majadahonda,72034,34119,37915
28,Madrid,82,Manzanares el Real,9202,4657,4545
28,Madrid,83,Meco,14903,7533,7370
28,Madrid,84,Mejorada del Campo,23737,11788,11949
28,Madrid,85,Miraflores de la Sierra,6585,3377,3208
28,Madrid,86,"Molar, El",9291,4714,4577
28,Madrid,87,"Molinos, Los",4563,2239,2324
28,Madrid,88,Montejo de la Sierra,365,187,178
28,Madrid,89,Moraleja de Enmedio,5294,2654,2640
28,Madrid,90,Moralzarzal,13573,6775,6798
28,Madrid,91,Morata de Tajuña,7924,4011,3913
28,Madrid,92,Móstoles,209639,101892,107747
28,Madrid,93,Navacerrada,3220,1611,1609
28,Madrid,94,Navalafuente,1573,809,764
28,Madrid,95,Navalagamella,2720,1396,1324
28,Madrid,96,Navalcarnero,30695,15285,15410
28,Madrid,97,Navarredonda y San Mamés,141,89,52
28,Madrid,99,Navas del Rey,3062,1596,1466
28,Madrid,100,Nuevo Baztán,6630,3403,3227
28,Madrid,101,Olmeda de las Fuentes,357,183,174
28,Madrid,102,Orusco de Tajuña,1291,661,630
28,Madrid,104,Paracuellos de Jarama,26235,13164,13071
28,Madrid,106,Parla,131689,65505,66184
28,Madrid,107,Patones,524,254,270
28,Madrid,108,Pedrezuela,6226,3113,3113
28,Madrid,109,Pelayos de la Presa,2827,1442,1385
28,Madrid,110,Perales de Tajuña,3059,1545,1514
28,Madrid,111,Pezuela de las Torres,927,495,432
28,Madrid,112,Pinilla del Valle,196,106,90
28,Madrid,113,Pinto,53537,26464,27073
28,Madrid,114,Piñuécar-Gandullas,185,96,89
28,Madrid,115,Pozuelo de Alarcón,87134,41716,45418
28,Madrid,116,Pozuelo del Rey,1190,617,573
28,Madrid,117,Prádena del Rincón,149,80,69
28,Madrid,118,Puebla de la Sierra,75,47,28
28,Madrid,902,Puentes Viejas,719,396,323
28,Madrid,119,Quijorna,3593,1800,1793
28,Madrid,120,Rascafría,1754,955,799
28,Madrid,121,Redueña,294,165,129
28,Madrid,122,Ribatejada,863,444,419
28,Madrid,123,Rivas-Vaciamadrid,92925,46032,46893
28,Madrid,124,Robledillo de la Jara,97,50,47
28,Madrid,125,Robledo de Chavela,4479,2352,2127
28,Madrid,126,Robregordo,71,42,29
28,Madrid,127,"Rozas de Madrid, Las",94862,45806,49056
28,Madrid,128,Rozas de Puerto Real,590,341,249
28,Madrid,129,San Agustín del Guadalix,13538,6640,6898
28,Madrid,130,San Fernando de Henares,39313,19140,20173
28,Madrid,131,San Lorenzo de El Escorial,18454,8835,9619
28,Madrid,132,San Martín de la Vega,19853,10133,9720
28,Madrid,133,San Martín de Valdeiglesias,8760,4356,4404
28,Madrid,134,San Sebastián de los Reyes,90962,44221,46741
28,Madrid,135,Santa María de la Alameda,1436,769,667
28,Madrid,136,Santorcaz,925,467,458
28,Madrid,137,"Santos de la Humosa, Los",2729,1395,1334
28,Madrid,138,"Serna del Monte, La",96,53,43
28,Madrid,140,Serranillos del Valle,4429,2194,2235
28,Madrid,141,Sevilla la Nueva,9345,4598,4747
28,Madrid,143,Somosierra,87,49,38
28,Madrid,144,Soto del Real,9091,4458,4633
28,Madrid,145,Talamanca de Jarama,4123,2032,2091
28,Madrid,146,Tielmes,2781,1418,1363
28,Madrid,147,Titulcia,1360,697,663
28,Madrid,148,Torrejón de Ardoz,132771,65240,67531
28,Madrid,149,Torrejón de la Calzada,9549,4737,4812
28,Madrid,150,Torrejón de Velasco,4594,2273,2321
28,Madrid,151,Torrelaguna,4897,2448,2449
28,Madrid,152,Torrelodones,24122,11634,12488
28,Madrid,153,Torremocha de Jarama,1079,552,527
28,Madrid,154,Torres de la Alameda,7729,3946,3783
28,Madrid,903,Tres Cantos,48751,23678,25073
28,Madrid,155,Valdaracete,612,314,298
28,Madrid,156,Valdeavero,1670,861,809
28,Madrid,157,Valdelaguna,1026,517,509
28,Madrid,158,Valdemanco,1012,523,489
28,Madrid,159,Valdemaqueda,789,405,384
28,Madrid,160,Valdemorillo,13245,6691,6554
28,Madrid,161,Valdemoro,77587,38185,39402
28,Madrid,162,Valdeolmos-Alalpardo,4309,2215,2094
28,Madrid,163,Valdepiélagos,612,316,296
28,Madrid,164,Valdetorres de Jarama,4696,2353,2343
28,Madrid,165,Valdilecha,3079,1581,1498
28,Madrid,166,Valverde de Alcalá,518,275,243
28,Madrid,167,Velilla de San Antonio,12543,6311,6232
28,Madrid,168,"Vellón, El",2083,1088,995
28,Madrid,169,Venturada,2387,1240,1147
28,Madrid,171,Villa del Prado,6837,3484,3353
28,Madrid,170,Villaconejos,3464,1771,1693
28,Madrid,172,Villalbilla,15049,7601,7448
28,Madrid,173,Villamanrique de Tajo,762,393,369
28,Madrid,174,Villamanta,2643,1336,1307
28,Madrid,175,Villamantilla,1514,744,770
28,Madrid,176,Villanueva de la Cañada,22580,11005,11575
28,Madrid,178,Villanueva de Perales,1599,825,774
28,Madrid,177,Villanueva del Pardillo,17310,8407,8903
28,Madrid,179,Villar del Olmo,2211,1100,1111
28,Madrid,180,Villarejo de Salvanés,7552,3764,3788
28,Madrid,181,Villaviciosa de Odón,28030,13559,14471
28,Madrid,182,Villavieja del Lozoya,276,150,126
28,Madrid,183,Zarzalejo,1786,908,878
29,Málaga,1,Alameda,5453,2765,2688
29,Málaga,2,Alcaucín,2366,1210,1156
29,Málaga,3,Alfarnate,1057,541,516
29,Málaga,4,Alfarnatejo,358,185,173
29,Málaga,5,Algarrobo,6551,3298,3253
29,Málaga,6,Algatocín,825,429,396
29,Málaga,7,Alhaurín de la Torre,41868,20802,21066
29,Málaga,8,Alhaurín el Grande,26095,13022,13073
29,Málaga,9,Almáchar,1843,940,903
29,Málaga,10,Almargen,1944,990,954
29,Málaga,11,Almogía,3859,2002,1857
29,Málaga,12,Álora,13336,6764,6572
29,Málaga,13,Alozaina,2090,1057,1033
29,Málaga,14,Alpandeire,261,127,134
29,Málaga,15,Antequera,41348,20247,21101
29,Málaga,16,Árchez,398,204,194
29,Málaga,17,Archidona,8114,4128,3986
29,Málaga,18,Ardales,2518,1281,1237
29,Málaga,19,Arenas,1181,615,566
29,Málaga,20,Arriate,4112,2036,2076
29,Málaga,21,Atajate,179,100,79
29,Málaga,22,Benadalid,236,118,118
29,Málaga,23,Benahavís,7829,3871,3958
29,Málaga,24,Benalauría,436,227,209
29,Málaga,25,Benalmádena,70204,34383,35821
29,Málaga,26,Benamargosa,1535,787,748
29,Málaga,27,Benamocarra,3030,1516,1514
29,Málaga,28,Benaoján,1470,747,723
29,Málaga,29,Benarrabá,438,231,207
29,Málaga,30,"Borge, El",906,461,445
29,Málaga,31,"Burgo, El",1805,917,888
29,Málaga,32,Campillos,8301,4162,4139
29,Málaga,33,Canillas de Aceituno,1704,886,818
29,Málaga,34,Canillas de Albaida,811,396,415
29,Málaga,35,Cañete la Real,1633,811,822
29,Málaga,36,Carratraca,719,376,343
29,Málaga,37,Cartajima,259,138,121
29,Málaga,38,Cártama,27436,13883,13553
29,Málaga,39,Casabermeja,3712,1939,1773
29,Málaga,40,Casarabonela,2532,1349,1183
29,Málaga,41,Casares,7342,3764,3578
29,Málaga,42,Coín,23375,11697,11678
29,Málaga,43,Colmenar,3450,1776,1674
29,Málaga,44,Comares,1349,735,614
29,Málaga,45,Cómpeta,3866,1939,1927
29,Málaga,46,Cortes de la Frontera,3034,1567,1467
29,Málaga,47,Cuevas Bajas,1355,661,694
29,Málaga,49,Cuevas de San Marcos,3614,1811,1803
29,Málaga,48,Cuevas del Becerro,1601,783,818
29,Málaga,50,Cútar,602,313,289
29,Málaga,51,Estepona,71925,35203,36722
29,Málaga,52,Faraján,250,124,126
29,Málaga,53,Frigiliana,3198,1584,1614
29,Málaga,54,Fuengirola,82585,40285,42300
29,Málaga,55,Fuente de Piedra,2770,1389,1381
29,Málaga,56,Gaucín,1595,826,769
29,Málaga,57,Genalguacil,391,196,195
29,Málaga,58,Guaro,2326,1191,1135
29,Málaga,59,Humilladero,3293,1640,1653
29,Málaga,60,Igualeja,740,371,369
29,Málaga,61,Istán,1520,758,762
29,Málaga,62,Iznate,912,474,438
29,Málaga,63,Jimera de Líbar,388,202,186
29,Málaga,64,Jubrique,553,279,274
29,Málaga,65,Júzcar,235,135,100
29,Málaga,66,Macharaviaya,524,286,238
29,Málaga,67,Málaga,577405,277234,300171
29,Málaga,68,Manilva,16849,8488,8361
29,Málaga,69,Marbella,147958,70871,77087
29,Málaga,70,Mijas,86744,43088,43656
29,Málaga,71,Moclinejo,1244,651,593
29,Málaga,72,Mollina,5341,2675,2666
29,Málaga,73,Monda,2762,1437,1325
29,Málaga,903,Montecorto,572,303,269
29,Málaga,74,Montejaque,938,468,470
29,Málaga,75,Nerja,21018,10357,10661
29,Málaga,76,Ojén,4023,2062,1961
29,Málaga,77,Parauta,251,129,122
29,Málaga,79,Periana,3159,1644,1515
29,Málaga,80,Pizarra,9572,4801,4771
29,Málaga,81,Pujerra,298,154,144
29,Málaga,82,Rincón de la Victoria,49790,24348,25442
29,Málaga,83,Riogordo,2734,1423,1311
29,Málaga,84,Ronda,33624,16295,17329
29,Málaga,85,Salares,173,88,85
29,Málaga,86,Sayalonga,1614,832,782
29,Málaga,87,Sedella,592,336,256
29,Málaga,904,Serrato,473,237,236
29,Málaga,88,Sierra de Yeguas,3386,1714,1672
29,Málaga,89,Teba,3727,1873,1854
29,Málaga,90,Tolox,2203,1111,1092
29,Málaga,901,Torremolinos,68056,34047,34009
29,Málaga,91,Torrox,18937,9547,9390
29,Málaga,92,Totalán,725,368,357
29,Málaga,93,Valle de Abdalajís,2483,1259,1224
29,Málaga,94,Vélez-Málaga,82967,40919,42048
29,Málaga,95,Villanueva de Algaidas,4129,2119,2010
29,Málaga,902,Villanueva de la Concepción,3277,1592,1685
29,Málaga,98,Villanueva de Tapia,1437,728,709
29,Málaga,96,Villanueva del Rosario,3374,1633,1741
29,Málaga,97,Villanueva del Trabuco,5360,2688,2672
29,Málaga,99,Viñuela,2045,1062,983
29,Málaga,100,Yunquera,2866,1465,1401
52,Melilla,1,Melilla,86261,43603,42658
30,Murcia,1,Abanilla,6116,3099,3017
30,Murcia,2,Abarán,13066,6531,6535
30,Murcia,3,Águilas,35956,17929,18027
30,Murcia,4,Albudeite,1388,705,683
30,Murcia,5,Alcantarilla,42559,21073,21486
30,Murcia,902,"Alcázares, Los",16935,8677,8258
30,Murcia,6,Aledo,1083,538,545
30,Murcia,7,Alguazas,9842,5071,4771
30,Murcia,8,Alhama de Murcia,22240,11262,10978
30,Murcia,9,Archena,19500,10221,9279
30,Murcia,10,Beniel,11508,6008,5500
30,Murcia,11,Blanca,6608,3390,3218
30,Murcia,12,Bullas,11619,5824,5795
30,Murcia,13,Calasparra,10133,5141,4992
30,Murcia,14,Campos del Río,2061,982,1079
30,Murcia,15,Caravaca de la Cruz,25611,12803,12808
30,Murcia,16,Cartagena,216365,107458,108907
30,Murcia,17,Cehegín,14798,7412,7386
30,Murcia,18,Ceutí,12199,6154,6045
30,Murcia,19,Cieza,35301,17768,17533
30,Murcia,20,Fortuna,10512,5577,4935
30,Murcia,21,Fuente Álamo de Murcia,17225,8944,8281
30,Murcia,22,Jumilla,26234,13683,12551
30,Murcia,23,Librilla,5351,2736,2615
30,Murcia,24,Lorca,96238,49260,46978
30,Murcia,25,Lorquí,7320,3698,3622
30,Murcia,26,Mazarrón,32988,17021,15967
30,Murcia,27,Molina de Segura,73498,36682,36816
30,Murcia,28,Moratalla,7797,3959,3838
30,Murcia,29,Mula,17074,8761,8313
30,Murcia,30,Murcia,460349,225606,234743
30,Murcia,31,Ojós,495,259,236
30,Murcia,32,Pliego,3868,2004,1864
30,Murcia,33,Puerto Lumbreras,16060,8174,7886
30,Murcia,34,Ricote,1265,676,589
30,Murcia,35,San Javier,33645,16873,16772
30,Murcia,36,San Pedro del Pinatar,26320,13250,13070
30,Murcia,901,Santomera,16154,8092,8062
30,Murcia,37,Torre-Pacheco,37299,19235,18064
30,Murcia,38,"Torres de Cotillas, Las",21837,11063,10774
30,Murcia,39,Totana,32316,16616,15700
30,Murcia,40,Ulea,866,447,419
30,Murcia,41,"Unión, La",20536,10415,10121
30,Murcia,42,Villanueva del Río Segura,3268,1652,1616
30,Murcia,43,Yecla,35083,17633,17450
31,Navarra,1,Abáigar,84,49,35
31,Navarra,2,Abárzuza/Abartzuza,538,270,268
31,Navarra,3,Abaurregaina/Abaurrea Alta,128,80,48
31,Navarra,4,Abaurrepea/Abaurrea Baja,29,19,10
31,Navarra,5,Aberin,346,187,159
31,Navarra,6,Ablitas,2480,1252,1228
31,Navarra,7,Adiós,167,94,73
31,Navarra,8,Aguilar de Codés,69,43,26
31,Navarra,9,Aibar/Oibar,782,409,373
31,Navarra,11,Allín/Allin,884,477,407
31,Navarra,12,Allo,925,478,447
31,Navarra,10,Altsasu/Alsasua,7441,3755,3686
31,Navarra,13,Améscoa Baja,721,399,322
31,Navarra,14,Ancín/Antzin,330,185,145
31,Navarra,15,Andosilla,2752,1390,1362
31,Navarra,16,Ansoáin/Antsoain,10732,5275,5457
31,Navarra,17,Anue,493,263,230
31,Navarra,18,Añorbe,614,337,277
31,Navarra,19,Aoiz/Agoitz,2791,1411,1380
31,Navarra,20,Araitz,512,284,228
31,Navarra,25,Arakil,966,506,460
31,Navarra,21,Aranarache/Aranaratxe,69,40,29
31,Navarra,23,Aranguren,11726,5920,5806
31,Navarra,24,Arano,114,61,53
31,Navarra,22,Arantza,606,320,286
31,Navarra,26,Aras,153,81,72
31,Navarra,27,Arbizu,1113,581,532
31,Navarra,28,Arce/Artzi,253,142,111
31,Navarra,29,"Arcos, Los",1132,560,572
31,Navarra,30,Arellano,164,84,80
31,Navarra,31,Areso,275,142,133
31,Navarra,32,Arguedas,2310,1189,1121
31,Navarra,33,Aria,49,30,19
31,Navarra,34,Aribe,32,18,14
31,Navarra,35,Armañanzas,47,25,22
31,Navarra,36,Arróniz,1049,565,484
31,Navarra,37,Arruazu,100,53,47
31,Navarra,38,Artajona,1741,893,848
31,Navarra,39,Artazu,117,59,58
31,Navarra,40,Atez/Atetz,221,124,97
31,Navarra,58,Auritz/Burguete,228,125,103
31,Navarra,41,Ayegui/Aiegi,2430,1265,1165
31,Navarra,42,Azagra,3781,1910,1871
31,Navarra,43,Azuelo,27,11,16
31,Navarra,44,Bakaiku,353,187,166
31,Navarra,901,Barañáin/Barañain,19853,9633,10220
31,Navarra,45,Barásoain,613,324,289
31,Navarra,46,Barbarin,48,25,23
31,Navarra,47,Bargota,254,127,127
31,Navarra,48,Barillas,236,131,105
31,Navarra,49,Basaburua,838,478,360
31,Navarra,50,Baztan,7863,3973,3890
31,Navarra,137,Beintza-Labaien,214,126,88
31,Navarra,51,Beire,301,154,147
31,Navarra,52,Belascoáin,117,62,55
31,Navarra,250,Bera,3759,1851,1908
31,Navarra,53,Berbinzana,677,345,332
31,Navarra,905,Beriáin,4132,2028,2104
31,Navarra,902,Berrioplano/Berriobeiti,7468,3802,3666
31,Navarra,903,Berriozar,10723,5378,5345
31,Navarra,54,Bertizarana,596,290,306
31,Navarra,55,Betelu,377,191,186
31,Navarra,253,Bidaurreta,165,85,80
31,Navarra,56,Biurrun-Olcoz,227,126,101
31,Navarra,57,Buñuel,2238,1096,1142
31,Navarra,59,Burgui/Burgi,193,110,83
31,Navarra,60,Burlada/Burlata,19723,9557,10166
31,Navarra,61,"Busto, El",53,25,28
31,Navarra,62,Cabanillas,1335,698,637
31,Navarra,63,Cabredo,85,47,38
31,Navarra,64,Cadreita,2045,1069,976
31,Navarra,65,Caparroso,2784,1468,1316
31,Navarra,66,Cárcar,1120,567,553
31,Navarra,67,Carcastillo,2487,1265,1222
31,Navarra,68,Cascante,3962,1963,1999
31,Navarra,69,Cáseda,952,486,466
31,Navarra,70,Castejón,4306,2162,2144
31,Navarra,71,Castillonuevo,18,11,7
31,Navarra,193,Cendea de Olza/Oltza Zendea,1868,926,942
31,Navarra,72,Cintruénigo,8051,4159,3892
31,Navarra,74,Cirauqui/Zirauki,488,248,240
31,Navarra,75,Ciriza/Ziritza,163,80,83
31,Navarra,76,Cizur,3890,2001,1889
31,Navarra,77,Corella,8220,4159,4061
31,Navarra,78,Cortes,3164,1618,1546
31,Navarra,79,Desojo,72,41,31
31,Navarra,80,Dicastillo,589,305,284
31,Navarra,81,Donamaria,451,223,228
31,Navarra,221,Doneztebe/Santesteban,1826,909,917
31,Navarra,83,Echarri/Etxarri,78,39,39
31,Navarra,87,Elgorriaga,214,108,106
31,Navarra,89,Enériz/Eneritz,296,146,150
31,Navarra,90,Eratsun,146,89,57
31,Navarra,91,Ergoiena,366,197,169
31,Navarra,92,Erro,790,447,343
31,Navarra,94,Eslava,106,49,57
31,Navarra,95,Esparza de Salazar/Espartza Zaraitzu,74,40,34
31,Navarra,96,Espronceda,103,58,45
31,Navarra,97,Estella-Lizarra,13911,6692,7219
31,Navarra,98,Esteribar,2790,1445,1345
31,Navarra,99,Etayo,65,36,29
31,Navarra,82,Etxalar,828,434,394
31,Navarra,84,Etxarri Aranatz,2489,1293,1196
31,Navarra,85,Etxauri,645,325,320
31,Navarra,100,Eulate,279,156,123
31,Navarra,101,Ezcabarte,1809,939,870
31,Navarra,93,Ezcároz/Ezkaroze,308,169,139
31,Navarra,102,Ezkurra,136,93,43
31,Navarra,103,Ezprogui,43,20,23
31,Navarra,104,Falces,2316,1190,1126
31,Navarra,105,Fitero,2081,1035,1046
31,Navarra,106,Fontellas,999,508,491
31,Navarra,107,Funes,2455,1303,1152
31,Navarra,108,Fustiñana,2490,1256,1234
31,Navarra,109,Galar,2274,1184,1090
31,Navarra,110,Gallipienzo/Galipentzu,102,58,44
31,Navarra,111,Gallués/Galoze,96,62,34
31,Navarra,112,Garaioa,96,54,42
31,Navarra,113,Garde,137,81,56
31,Navarra,114,Garínoain,503,267,236
31,Navarra,115,Garralda,190,95,95
31,Navarra,116,Genevilla,61,37,24
31,Navarra,117,Goizueta,688,366,322
31,Navarra,118,Goñi,165,101,64
31,Navarra,119,Güesa/Gorza,34,21,13
31,Navarra,120,Guesálaz/Gesalatz,438,251,187
31,Navarra,121,Guirguillano,80,42,38
31,Navarra,256,Hiriberri/Villanueva de Aezkoa,101,55,46
31,Navarra,122,Huarte/Uharte,7286,3670,3616
31,Navarra,124,Ibargoiti,265,154,111
31,Navarra,259,Igantzi,587,314,273
31,Navarra,125,Igúzquiza,317,161,156
31,Navarra,126,Imotz,435,238,197
31,Navarra,127,Irañeta,168,92,76
31,Navarra,904,Irurtzun,2296,1188,1108
31,Navarra,128,Isaba/Izaba,410,197,213
31,Navarra,129,Ituren,508,256,252
31,Navarra,130,Iturmendi,431,225,206
31,Navarra,131,Iza/Itza,1293,701,592
31,Navarra,132,Izagaondoa,172,111,61
31,Navarra,133,Izalzu/Itzaltzu,38,22,16
31,Navarra,134,Jaurrieta,181,104,77
31,Navarra,135,Javier,125,29,96
31,Navarra,136,Juslapeña,585,319,266
31,Navarra,138,Lakuntza,1268,672,596
31,Navarra,139,Lana,162,91,71
31,Navarra,140,Lantz,151,88,63
31,Navarra,141,Lapoblación,126,72,54
31,Navarra,142,Larraga,2108,1115,993
31,Navarra,143,Larraona,99,48,51
31,Navarra,144,Larraun,916,501,415
31,Navarra,145,Lazagurría,175,90,85
31,Navarra,146,Leache/Leatxe,32,17,15
31,Navarra,147,Legarda,124,64,60
31,Navarra,148,Legaria,108,47,61
31,Navarra,149,Leitza,3010,1547,1463
31,Navarra,908,Lekunberri,1624,826,798
31,Navarra,150,Leoz/Leotz,226,146,80
31,Navarra,151,Lerga,46,29,17
31,Navarra,152,Lerín,1775,918,857
31,Navarra,153,Lesaka,2744,1395,1349
31,Navarra,154,Lezaun,239,137,102
31,Navarra,155,Liédena,316,161,155
31,Navarra,156,Lizoáin-Arriasgoiti,314,184,130
31,Navarra,157,Lodosa,4844,2457,2387
31,Navarra,158,Lónguida/Longida,280,145,135
31,Navarra,159,Lumbier,1293,700,593
31,Navarra,160,Luquin,132,65,67
31,Navarra,248,Luzaide/Valcarlos,320,177,143
31,Navarra,161,Mañeru,423,218,205
31,Navarra,162,Marañón,51,28,23
31,Navarra,163,Marcilla,2866,1437,1429
31,Navarra,164,Mélida,733,375,358
31,Navarra,165,Mendavia,3505,1788,1717
31,Navarra,166,Mendaza,299,148,151
31,Navarra,167,Mendigorria,1112,583,529
31,Navarra,168,Metauten,289,162,127
31,Navarra,169,Milagro,3470,1798,1672
31,Navarra,170,Mirafuentes,61,31,30
31,Navarra,171,Miranda de Arga,852,450,402
31,Navarra,172,Monreal/Elo,480,267,213
31,Navarra,173,Monteagudo,1105,566,539
31,Navarra,174,Morentin,116,59,57
31,Navarra,175,Mues,85,48,37
31,Navarra,176,Murchante,4135,2094,2041
31,Navarra,177,Murieta,359,188,171
31,Navarra,178,Murillo el Cuende,673,351,322
31,Navarra,179,Murillo el Fruto,665,358,307
31,Navarra,180,Muruzábal,254,116,138
31,Navarra,181,Navascués/Nabaskoze,124,74,50
31,Navarra,182,Nazar,36,22,14
31,Navarra,88,Noáin (Valle de Elorz)/Noain (Elortzibar),8354,4191,4163
31,Navarra,183,Obanos,928,459,469
31,Navarra,185,Ochagavía/Otsagabia,496,269,227
31,Navarra,184,Oco,74,38,36
31,Navarra,186,Odieta,362,198,164
31,Navarra,187,Oiz,132,75,57
31,Navarra,188,Olaibar,389,219,170
31,Navarra,189,Olazti/Olazagutía,1485,752,733
31,Navarra,190,Olejua,51,29,22
31,Navarra,191,Olite/Erriberri,3998,2022,1976
31,Navarra,192,Olóriz/Oloritz,210,121,89
31,Navarra,195,Orbaizeta,191,92,99
31,Navarra,196,Orbara,32,17,15
31,Navarra,197,Orísoain,87,47,40
31,Navarra,906,Orkoien,4160,2103,2057
31,Navarra,198,Oronz/Orontze,49,25,24
31,Navarra,199,Oroz-Betelu/Orotz-Betelu,139,78,61
31,Navarra,211,Orreaga/Roncesvalles,19,10,9
31,Navarra,200,Oteiza,941,502,439
31,Navarra,201,Pamplona/Iruña,203081,95849,107232
31,Navarra,202,Peralta/Azkoien,5965,3014,2951
31,Navarra,203,Petilla de Aragón,30,16,14
31,Navarra,204,Piedramillera,39,24,15
31,Navarra,205,Pitillas,532,260,272
31,Navarra,206,Puente la Reina/Gares,2920,1501,1419
31,Navarra,207,Pueyo,345,190,155
31,Navarra,208,Ribaforada,3718,1949,1769
31,Navarra,209,Romanzado,187,102,85
31,Navarra,210,Roncal/Erronkari,206,104,102
31,Navarra,212,Sada,136,78,58
31,Navarra,213,Saldías,114,62,52
31,Navarra,214,Salinas de Oro/Jaitz,108,57,51
31,Navarra,215,San Adrián,6369,3179,3190
31,Navarra,217,San Martín de Unx,393,207,186
31,Navarra,216,Sangüesa/Zangoza,4872,2480,2392
31,Navarra,219,Sansol,98,50,48
31,Navarra,220,Santacara,865,448,417
31,Navarra,222,Sarriés/Sartze,61,43,18
31,Navarra,223,Sartaguda,1287,671,616
31,Navarra,224,Sesma,1149,585,564
31,Navarra,225,Sorlada,51,29,22
31,Navarra,226,Sunbilla,674,344,330
31,Navarra,227,Tafalla,10582,5256,5326
31,Navarra,228,Tiebas-Muruarte de Reta,646,348,298
31,Navarra,229,Tirapu,47,30,17
31,Navarra,230,Torralba del Río,91,49,42
31,Navarra,231,Torres del Río,122,61,61
31,Navarra,232,Tudela,37008,18239,18769
31,Navarra,233,Tulebras,136,59,77
31,Navarra,234,Ucar,185,104,81
31,Navarra,123,Uharte Arakil,781,408,373
31,Navarra,235,Ujué/Uxue,175,96,79
31,Navarra,236,Ultzama,1669,859,810
31,Navarra,237,Unciti,227,129,98
31,Navarra,238,Unzué/Untzue,160,84,76
31,Navarra,239,Urdazubi/Urdax,348,176,172
31,Navarra,240,Urdiain,664,347,317
31,Navarra,241,Urraul Alto,142,90,52
31,Navarra,242,Urraul Bajo,307,146,161
31,Navarra,244,Urroz,179,99,80
31,Navarra,243,Urroz-Villa,400,208,192
31,Navarra,245,Urzainqui/Urzainki,88,55,33
31,Navarra,246,Uterga,170,99,71
31,Navarra,247,Uztárroz/Uztarroze,150,76,74
31,Navarra,86,Valle de Egüés/Eguesibar,21556,10811,10745
31,Navarra,194,Valle de Ollo/Ollaran,413,225,188
31,Navarra,260,Valle de Yerri/Deierri,1563,807,756
31,Navarra,249,Valtierra,2439,1219,1220
31,Navarra,251,Viana,4341,2219,2122
31,Navarra,252,Vidángoz/Bidankoze,82,48,34
31,Navarra,254,Villafranca,2907,1489,1418
31,Navarra,255,Villamayor de Monjardín,117,60,57
31,Navarra,257,Villatuerta,1258,623,635
31,Navarra,258,Villava/Atarrabia,10131,4938,5193
31,Navarra,261,Yesa,288,168,120
31,Navarra,262,Zabalza/Zabaltza,303,163,140
31,Navarra,73,Ziordia,352,189,163
31,Navarra,907,Zizur Mayor/Zizur Nagusia,15198,7442,7756
31,Navarra,263,Zubieta,304,157,147
31,Navarra,264,Zugarramurdi,211,104,107
31,Navarra,265,Zúñiga,78,51,27
32,Ourense,1,Allariz,6314,3134,3180
32,Ourense,2,Amoeiro,2333,1179,1154
32,Ourense,3,"Arnoia, A",952,473,479
32,Ourense,4,Avión,1738,790,948
32,Ourense,5,Baltar,919,496,423
32,Ourense,6,Bande,1490,755,735
32,Ourense,7,Baños de Molgas,1483,743,740
32,Ourense,8,Barbadás,11022,5395,5627
32,Ourense,9,"Barco de Valdeorras, O",13384,6496,6888
32,Ourense,10,Beade,379,198,181
32,Ourense,11,Beariz,971,440,531
32,Ourense,12,"Blancos, Os",745,404,341
32,Ourense,13,Boborás,2206,1052,1154
32,Ourense,14,"Bola, A",1075,508,567
32,Ourense,15,"Bolo, O",828,420,408
32,Ourense,16,Calvos de Randín,717,367,350
32,Ourense,18,Carballeda de Avia,1249,610,639
32,Ourense,17,Carballeda de Valdeorras,1460,759,701
32,Ourense,19,"Carballiño, O",13911,6462,7449
32,Ourense,20,Cartelle,2570,1265,1305
32,Ourense,22,Castrelo de Miño,1321,668,653
32,Ourense,21,Castrelo do Val,979,489,490
32,Ourense,23,Castro Caldelas,1182,599,583
32,Ourense,24,Celanova,5652,2653,2999
32,Ourense,25,Cenlle,1094,542,552
32,Ourense,29,Chandrexa de Queixa,482,263,219
32,Ourense,26,Coles,3125,1594,1531
32,Ourense,27,Cortegada,1061,523,538
32,Ourense,28,Cualedro,1639,860,779
32,Ourense,30,Entrimo,1128,539,589
32,Ourense,31,Esgos,1109,564,545
32,Ourense,33,Gomesende,693,342,351
32,Ourense,34,"Gudiña, A",1232,625,607
32,Ourense,35,"Irixo, O",1401,674,727
32,Ourense,38,Larouco,427,208,219
32,Ourense,39,Laza,1222,632,590
32,Ourense,40,Leiro,1510,743,767
32,Ourense,41,Lobeira,769,383,386
32,Ourense,42,Lobios,1672,838,834
32,Ourense,43,Maceda,2849,1416,1433
32,Ourense,44,Manzaneda,846,415,431
32,Ourense,45,Maside,2718,1350,1368
32,Ourense,46,Melón,1135,548,587
32,Ourense,47,"Merca, A",1939,968,971
32,Ourense,48,"Mezquita, A",1006,528,478
32,Ourense,49,Montederramo,705,378,327
32,Ourense,50,Monterrei,2501,1280,1221
32,Ourense,51,Muíños,1447,732,715
32,Ourense,52,Nogueira de Ramuín,2067,1053,1014
32,Ourense,53,Oímbra,1713,936,777
32,Ourense,54,Ourense,104596,47408,57188
32,Ourense,55,Paderne de Allariz,1373,674,699
32,Ourense,56,Padrenda,1653,799,854
32,Ourense,57,Parada de Sil,544,288,256
32,Ourense,58,"Pereiro de Aguiar, O",6470,3353,3117
32,Ourense,59,"Peroxa, A",1826,906,920
32,Ourense,60,Petín,879,436,443
32,Ourense,61,Piñor,1162,597,565
32,Ourense,63,"Pobra de Trives, A",2015,1000,1015
32,Ourense,64,Pontedeva,491,241,250
32,Ourense,62,Porqueira,827,381,446
32,Ourense,65,Punxín,704,340,364
32,Ourense,66,Quintela de Leirado,614,272,342
32,Ourense,67,Rairiz de Veiga,1223,625,598
32,Ourense,68,Ramirás,1507,705,802
32,Ourense,69,Ribadavia,5005,2451,2554
32,Ourense,71,Riós,1459,749,710
32,Ourense,72,"Rúa, A",4245,2109,2136
32,Ourense,73,Rubiá,1390,682,708
32,Ourense,74,San Amaro,1048,502,546
32,Ourense,75,San Cibrao das Viñas,5509,2781,2728
32,Ourense,76,San Cristovo de Cea,2072,1016,1056
32,Ourense,70,San Xoán de Río,505,262,243
32,Ourense,77,Sandiás,1181,565,616
32,Ourense,78,Sarreaus,1114,547,567
32,Ourense,79,Taboadela,1452,738,714
32,Ourense,80,"Teixeira, A",336,172,164
32,Ourense,81,Toén,2374,1218,1156
32,Ourense,82,Trasmiras,1261,632,629
32,Ourense,83,"Veiga, A",886,452,434
32,Ourense,84,Verea,914,441,473
32,Ourense,85,Verín,13644,6544,7100
32,Ourense,86,Viana do Bolo,2787,1415,1372
32,Ourense,87,Vilamarín,1882,978,904
32,Ourense,88,Vilamartín de Valdeorras,1837,940,897
32,Ourense,89,Vilar de Barrio,1258,636,622
32,Ourense,90,Vilar de Santos,791,384,407
32,Ourense,91,Vilardevós,1781,938,843
32,Ourense,92,Vilariño de Conso,513,293,220
32,Ourense,32,Xinzo de Limia,9621,4682,4939
32,Ourense,36,Xunqueira de Ambía,1366,689,677
32,Ourense,37,Xunqueira de Espadanedo,738,365,373
34,Palencia,1,Abarca de Campos,45,28,17
34,Palencia,3,Abia de las Torres,167,90,77
34,Palencia,4,Aguilar de Campoo,6711,3232,3479
34,Palencia,5,Alar del Rey,908,444,464
34,Palencia,6,Alba de Cerrato,83,47,36
34,Palencia,9,Amayuelas de Arriba,36,23,13
34,Palencia,10,Ampudia,600,306,294
34,Palencia,11,Amusco,414,232,182
34,Palencia,12,Antigüedad,362,202,160
34,Palencia,15,Arconada,43,26,17
34,Palencia,17,Astudillo,1021,516,505
34,Palencia,18,Autilla del Pino,217,119,98
34,Palencia,19,Autillo de Campos,132,69,63
34,Palencia,20,Ayuela,54,34,20
34,Palencia,22,Baltanás,1219,628,591
34,Palencia,24,Baquerín de Campos,26,16,10
34,Palencia,25,Bárcena de Campos,52,23,29
34,Palencia,27,Barruelo de Santullán,1187,585,602
34,Palencia,28,Báscones de Ojeda,138,71,67
34,Palencia,29,Becerril de Campos,762,392,370
34,Palencia,31,Belmonte de Campos,26,12,14
34,Palencia,32,Berzosilla,39,22,17
34,Palencia,33,Boada de Campos,18,13,5
34,Palencia,35,Boadilla de Rioseco,114,65,49
34,Palencia,34,Boadilla del Camino,121,70,51
34,Palencia,36,Brañosera,255,142,113
34,Palencia,37,Buenavista de Valdavia,308,172,136
34,Palencia,38,Bustillo de la Vega,278,156,122
34,Palencia,39,Bustillo del Páramo de Carrión,60,33,27
34,Palencia,41,Calahorra de Boedo,85,41,44
34,Palencia,42,Calzada de los Molinos,317,177,140
34,Palencia,45,Capillas,72,39,33
34,Palencia,46,Cardeñosa de Volpejera,56,29,27
34,Palencia,47,Carrión de los Condes,2011,963,1048
34,Palencia,48,Castil de Vela,58,28,30
34,Palencia,49,Castrejón de la Peña,346,187,159
34,Palencia,50,Castrillo de Don Juan,196,113,83
34,Palencia,51,Castrillo de Onielo,104,51,53
34,Palencia,52,Castrillo de Villavega,173,99,74
34,Palencia,53,Castromocho,212,108,104
34,Palencia,55,Cervatos de la Cueza,269,147,122
34,Palencia,56,Cervera de Pisuerga,2288,1138,1150
34,Palencia,57,Cevico de la Torre,479,244,235
34,Palencia,58,Cevico Navero,186,111,75
34,Palencia,59,Cisneros,429,212,217
34,Palencia,60,Cobos de Cerrato,131,75,56
34,Palencia,61,Collazos de Boedo,104,62,42
34,Palencia,62,Congosto de Valdavia,150,88,62
34,Palencia,63,Cordovilla la Real,98,57,41
34,Palencia,66,Cubillas de Cerrato,63,38,25
34,Palencia,67,Dehesa de Montejo,127,74,53
34,Palencia,68,Dehesa de Romanos,56,33,23
34,Palencia,69,Dueñas,2592,1321,1271
34,Palencia,70,Espinosa de Cerrato,134,73,61
34,Palencia,71,Espinosa de Villagonzalo,165,89,76
34,Palencia,72,Frechilla,148,74,74
34,Palencia,73,Fresno del Río,186,90,96
34,Palencia,74,Frómista,777,397,380
34,Palencia,76,Fuentes de Nava,625,318,307
34,Palencia,77,Fuentes de Valdepero,497,258,239
34,Palencia,79,Grijota,2496,1296,1200
34,Palencia,80,Guardo,5786,2851,2935
34,Palencia,81,Guaza de Campos,58,35,23
34,Palencia,82,Hérmedes de Cerrato,78,39,39
34,Palencia,83,Herrera de Pisuerga,1889,931,958
34,Palencia,84,Herrera de Valdecañas,154,87,67
34,Palencia,86,Hontoria de Cerrato,102,51,51
34,Palencia,87,Hornillos de Cerrato,143,81,62
34,Palencia,88,Husillos,358,195,163
34,Palencia,89,Itero de la Vega,152,90,62
34,Palencia,91,Lagartos,128,74,54
34,Palencia,92,Lantadilla,284,153,131
34,Palencia,94,Ledigos,65,33,32
34,Palencia,903,Loma de Ucieza,199,118,81
34,Palencia,96,Lomas,45,29,16
34,Palencia,98,Magaz de Pisuerga,1024,533,491
34,Palencia,99,Manquillos,61,38,23
34,Palencia,100,Mantinos,140,79,61
34,Palencia,101,Marcilla de Campos,45,21,24
34,Palencia,102,Mazariegos,217,129,88
34,Palencia,103,Mazuecos de Valdeginate,93,58,35
34,Palencia,104,Melgar de Yuso,254,147,107
34,Palencia,106,Meneses de Campos,120,70,50
34,Palencia,107,Micieces de Ojeda,71,42,29
34,Palencia,108,Monzón de Campos,596,315,281
34,Palencia,109,Moratinos,63,33,30
34,Palencia,110,Mudá,81,46,35
34,Palencia,112,Nogal de las Huertas,39,22,17
34,Palencia,113,Olea de Boedo,41,15,26
34,Palencia,114,Olmos de Ojeda,187,118,69
34,Palencia,116,Osornillo,56,29,27
34,Palencia,901,Osorno la Mayor,1171,609,562
34,Palencia,120,Palencia,77090,36352,40738
34,Palencia,121,Palenzuela,214,123,91
34,Palencia,122,Páramo de Boedo,106,62,44
34,Palencia,123,Paredes de Nava,1875,960,915
34,Palencia,124,Payo de Ojeda,63,39,24
34,Palencia,125,Pedraza de Campos,74,39,35
34,Palencia,126,Pedrosa de la Vega,288,163,125
34,Palencia,127,Perales,91,44,47
34,Palencia,904,"Pernía, La",316,184,132
34,Palencia,129,Pino del Río,174,101,73
34,Palencia,130,Piña de Campos,203,102,101
34,Palencia,131,Población de Arroyo,56,31,25
34,Palencia,132,Población de Campos,135,76,59
34,Palencia,133,Población de Cerrato,112,65,47
34,Palencia,134,Polentinos,44,24,20
34,Palencia,135,Pomar de Valdivia,475,264,211
34,Palencia,136,Poza de la Vega,175,102,73
34,Palencia,137,Pozo de Urama,21,14,7
34,Palencia,139,Prádanos de Ojeda,185,103,82
34,Palencia,140,"Puebla de Valdavia, La",92,48,44
34,Palencia,141,Quintana del Puente,290,160,130
34,Palencia,143,Quintanilla de Onsoña,179,100,79
34,Palencia,146,Reinoso de Cerrato,58,36,22
34,Palencia,147,Renedo de la Vega,191,102,89
34,Palencia,149,Requena de Campos,22,10,12
34,Palencia,151,Respenda de la Peña,147,89,58
34,Palencia,152,Revenga de Campos,147,74,73
34,Palencia,154,Revilla de Collazos,79,46,33
34,Palencia,155,Ribas de Campos,137,66,71
34,Palencia,156,Riberos de la Cueza,54,33,21
34,Palencia,157,Saldaña,2950,1515,1435
34,Palencia,158,Salinas de Pisuerga,311,160,151
34,Palencia,159,San Cebrián de Campos,413,228,185
34,Palencia,160,San Cebrián de Mudá,154,86,68
34,Palencia,161,San Cristóbal de Boedo,23,15,8
34,Palencia,163,San Mamés de Campos,49,26,23
34,Palencia,165,San Román de la Cuba,62,37,25
34,Palencia,167,Santa Cecilia del Alcor,107,61,46
34,Palencia,168,Santa Cruz de Boedo,49,30,19
34,Palencia,169,Santervás de la Vega,413,236,177
34,Palencia,170,Santibáñez de Ecla,48,27,21
34,Palencia,171,Santibáñez de la Peña,1002,492,510
34,Palencia,174,Santoyo,188,104,84
34,Palencia,175,"Serna, La",94,61,33
34,Palencia,177,Soto de Cerrato,192,110,82
34,Palencia,176,Sotobañado y Priorato,144,83,61
34,Palencia,178,Tabanera de Cerrato,137,73,64
34,Palencia,179,Tabanera de Valdavia,24,14,10
34,Palencia,180,Támara de Campos,74,39,35
34,Palencia,181,Tariego de Cerrato,485,255,230
34,Palencia,182,Torquemada,970,530,440
34,Palencia,184,Torremormojón,47,25,22
34,Palencia,185,Triollo,71,39,32
34,Palencia,186,Valbuena de Pisuerga,46,23,23
34,Palencia,189,Valdeolmillos,57,32,25
34,Palencia,190,Valderrábano,48,26,22
34,Palencia,192,Valde-Ucieza,81,51,30
34,Palencia,196,Valle de Cerrato,88,51,37
34,Palencia,902,Valle del Retortillo,174,98,76
34,Palencia,199,Velilla del Río Carrión,1187,607,580
34,Palencia,23,Venta de Baños,6399,3230,3169
34,Palencia,201,Vertavillo,169,90,79
34,Palencia,93,"Vid de Ojeda, La",88,53,35
34,Palencia,202,Villabasta de Valdavia,32,18,14
34,Palencia,204,Villacidaler,45,27,18
34,Palencia,205,Villaconancio,60,37,23
34,Palencia,206,Villada,897,454,443
34,Palencia,208,Villaeles de Valdavia,53,32,21
34,Palencia,210,Villahán,95,52,43
34,Palencia,211,Villaherreros,203,107,96
34,Palencia,213,Villalaco,52,30,22
34,Palencia,214,Villalba de Guardo,191,103,88
34,Palencia,215,Villalcázar de Sirga,168,86,82
34,Palencia,216,Villalcón,61,36,25
34,Palencia,217,Villalobón,1768,884,884
34,Palencia,218,Villaluenga de la Vega,566,328,238
34,Palencia,220,Villamartín de Campos,187,103,84
34,Palencia,221,Villamediana,182,105,77
34,Palencia,222,Villameriel,108,62,46
34,Palencia,223,Villamoronta,243,143,100
34,Palencia,224,Villamuera de la Cueza,36,24,12
34,Palencia,225,Villamuriel de Cerrato,6470,3344,3126
34,Palencia,227,Villanueva del Rebollar,68,35,33
34,Palencia,228,Villanuño de Valdavia,92,53,39
34,Palencia,229,Villaprovedo,52,34,18
34,Palencia,230,Villarmentero de Campos,18,12,6
34,Palencia,231,Villarrabé,192,99,93
34,Palencia,232,Villarramiel,833,439,394
34,Palencia,233,Villasarracino,138,83,55
34,Palencia,234,Villasila de Valdavia,64,43,21
34,Palencia,236,Villaturde,158,86,72
34,Palencia,237,Villaumbrales,653,324,329
34,Palencia,238,Villaviudas,355,169,186
34,Palencia,240,Villerías de Campos,86,43,43
34,Palencia,241,Villodre,17,9,8
34,Palencia,242,Villodrigo,109,59,50
34,Palencia,243,Villoldo,325,173,152
34,Palencia,245,Villota del Páramo,315,180,135
34,Palencia,246,Villovieco,68,37,31
35,"Palmas, Las",1,Agaete,5695,2856,2839
35,"Palmas, Las",2,Agüimes,32105,16197,15908
35,"Palmas, Las",20,"Aldea de San Nicolás, La",7516,3867,3649
35,"Palmas, Las",3,Antigua,12783,6716,6067
35,"Palmas, Las",4,Arrecife,64497,32389,32108
35,"Palmas, Las",5,Artenara,1046,594,452
35,"Palmas, Las",6,Arucas,38535,19155,19380
35,"Palmas, Las",7,Betancuria,762,394,368
35,"Palmas, Las",8,Firgas,7513,3792,3721
35,"Palmas, Las",9,Gáldar,24455,12247,12208
35,"Palmas, Las",10,Haría,5365,2767,2598
35,"Palmas, Las",11,Ingenio,31887,15999,15888
35,"Palmas, Las",12,Mogán,20572,10618,9954
35,"Palmas, Las",13,Moya,7833,3981,3852
35,"Palmas, Las",14,"Oliva, La",27768,14398,13370
35,"Palmas, Las",15,Pájara,21014,10946,10068
35,"Palmas, Las",16,"Palmas de Gran Canaria, Las",378675,182571,196104
35,"Palmas, Las",17,Puerto del Rosario,41786,21069,20717
35,"Palmas, Las",18,San Bartolomé,19058,9528,9530
35,"Palmas, Las",19,San Bartolomé de Tirajana,53066,27752,25314
35,"Palmas, Las",21,Santa Brígida,18297,9115,9182
35,"Palmas, Las",22,Santa Lucía de Tirajana,73573,36635,36938
35,"Palmas, Las",23,Santa María de Guía de Gran Canaria,13871,6905,6966
35,"Palmas, Las",24,Teguise,23044,11595,11449
35,"Palmas, Las",25,Tejeda,1865,1015,850
35,"Palmas, Las",26,Telde,102769,50464,52305
35,"Palmas, Las",27,Teror,12634,6457,6177
35,"Palmas, Las",28,Tías,20801,10641,10160
35,"Palmas, Las",29,Tinajo,6447,3318,3129
35,"Palmas, Las",30,Tuineje,15549,7910,7639
35,"Palmas, Las",32,Valleseco,3754,1968,1786
35,"Palmas, Las",31,Valsequillo de Gran Canaria,9382,4697,4685
35,"Palmas, Las",33,Vega de San Mateo,7645,3944,3701
35,"Palmas, Las",34,Yaiza,16977,8781,8196
36,Pontevedra,20,Agolada,2228,1115,1113
36,Pontevedra,1,Arbo,2599,1350,1249
36,Pontevedra,3,Baiona,12286,6043,6243
36,Pontevedra,2,Barro,3622,1778,1844
36,Pontevedra,4,Bueu,11987,5889,6098
36,Pontevedra,5,Caldas de Reis,9788,4728,5060
36,Pontevedra,6,Cambados,13673,6600,7073
36,Pontevedra,7,Campo Lameiro,1769,831,938
36,Pontevedra,8,Cangas,26708,13265,13443
36,Pontevedra,9,"Cañiza, A",5115,2512,2603
36,Pontevedra,10,Catoira,3316,1604,1712
36,Pontevedra,902,Cerdedo-Cotobade,5719,2780,2939
36,Pontevedra,13,Covelo,2455,1264,1191
36,Pontevedra,14,Crecente,1961,952,1009
36,Pontevedra,15,Cuntis,4643,2214,2429
36,Pontevedra,16,Dozón,1057,550,507
36,Pontevedra,17,"Estrada, A",20261,9736,10525
36,Pontevedra,18,Forcarei,3268,1557,1711
36,Pontevedra,19,Fornelos de Montes,1594,766,828
36,Pontevedra,21,Gondomar,14920,7437,7483
36,Pontevedra,22,"Grove, O",10699,5249,5450
36,Pontevedra,23,"Guarda, A",9991,4896,5095
36,Pontevedra,901,"Illa de Arousa, A",4951,2435,2516
36,Pontevedra,24,Lalín,20199,9855,10344
36,Pontevedra,25,"Lama, A",2410,1195,1215
36,Pontevedra,26,Marín,24248,12095,12153
36,Pontevedra,27,Meaño,5314,2591,2723
36,Pontevedra,28,Meis,4796,2311,2485
36,Pontevedra,29,Moaña,19496,9469,10027
36,Pontevedra,30,Mondariz,4394,2177,2217
36,Pontevedra,31,Mondariz-Balneario,675,343,332
36,Pontevedra,32,Moraña,4121,1998,2123
36,Pontevedra,33,Mos,15190,7498,7692
36,Pontevedra,34,"Neves, As",3770,1850,1920
36,Pontevedra,35,Nigrán,18005,8857,9148
36,Pontevedra,36,Oia,3104,1537,1567
36,Pontevedra,37,Pazos de Borbén,2975,1459,1516
36,Pontevedra,41,Poio,17230,8546,8684
36,Pontevedra,43,Ponte Caldelas,5548,2685,2863
36,Pontevedra,42,Ponteareas,22942,11121,11821
36,Pontevedra,44,Pontecesures,3081,1511,1570
36,Pontevedra,38,Pontevedra,83114,39314,43800
36,Pontevedra,39,"Porriño, O",20212,9915,10297
36,Pontevedra,40,Portas,2860,1385,1475
36,Pontevedra,45,Redondela,29192,14150,15042
36,Pontevedra,46,Ribadumia,5157,2516,2641
36,Pontevedra,47,Rodeiro,2361,1192,1169
36,Pontevedra,48,"Rosal, O",6376,3139,3237
36,Pontevedra,49,Salceda de Caselas,9249,4635,4614
36,Pontevedra,50,Salvaterra de Miño,10048,5027,5021
36,Pontevedra,51,Sanxenxo,17635,8711,8924
36,Pontevedra,52,Silleda,8845,4296,4549
36,Pontevedra,53,Soutomaior,7482,3733,3749
36,Pontevedra,54,Tomiño,13730,6892,6838
36,Pontevedra,55,Tui,17398,8446,8952
36,Pontevedra,56,Valga,5768,2835,2933
36,Pontevedra,57,Vigo,293837,138634,155203
36,Pontevedra,59,Vila de Cruces,5097,2531,2566
36,Pontevedra,58,Vilaboa,5955,2915,3040
36,Pontevedra,60,Vilagarcía de Arousa,37545,17999,19546
36,Pontevedra,61,Vilanova de Arousa,10306,4996,5310
26,"Rioja, La",1,Ábalos,248,144,104
26,"Rioja, La",2,Agoncillo,1153,636,517
26,"Rioja, La",3,Aguilar del Río Alhama,457,238,219
26,"Rioja, La",4,Ajamil de Cameros,67,47,20
26,"Rioja, La",5,Albelda de Iregua,3484,1794,1690
26,"Rioja, La",6,Alberite,2518,1287,1231
26,"Rioja, La",7,Alcanadre,647,339,308
26,"Rioja, La",8,Aldeanueva de Ebro,2794,1452,1342
26,"Rioja, La",9,Alesanco,500,261,239
26,"Rioja, La",10,Alesón,92,52,40
26,"Rioja, La",11,Alfaro,9562,4794,4768
26,"Rioja, La",12,Almarza de Cameros,36,22,14
26,"Rioja, La",13,Anguciana,423,230,193
26,"Rioja, La",14,Anguiano,511,279,232
26,"Rioja, La",15,Arenzana de Abajo,244,128,116
26,"Rioja, La",16,Arenzana de Arriba,28,20,8
26,"Rioja, La",17,Arnedillo,452,217,235
26,"Rioja, La",18,Arnedo,14954,7476,7478
26,"Rioja, La",19,Arrúbal,537,282,255
26,"Rioja, La",20,Ausejo,780,414,366
26,"Rioja, La",21,Autol,4702,2363,2339
26,"Rioja, La",22,Azofra,225,126,99
26,"Rioja, La",23,Badarán,502,255,247
26,"Rioja, La",24,Bañares,220,116,104
26,"Rioja, La",26,Baños de Río Tobía,1583,800,783
26,"Rioja, La",25,Baños de Rioja,84,49,35
26,"Rioja, La",27,Berceo,146,92,54
26,"Rioja, La",28,Bergasa,147,81,66
26,"Rioja, La",29,Bergasillas Bajera,34,18,16
26,"Rioja, La",30,Bezares,25,12,13
26,"Rioja, La",31,Bobadilla,99,51,48
26,"Rioja, La",32,Brieva de Cameros,46,30,16
26,"Rioja, La",33,Briñas,187,88,99
26,"Rioja, La",34,Briones,754,391,363
26,"Rioja, La",35,Cabezón de Cameros,19,12,7
26,"Rioja, La",36,Calahorra,24579,12055,12524
26,"Rioja, La",37,Camprovín,171,89,82
26,"Rioja, La",38,Canales de la Sierra,78,51,27
26,"Rioja, La",39,Canillas de Río Tuerto,40,22,18
26,"Rioja, La",40,Cañas,91,47,44
26,"Rioja, La",41,Cárdenas,134,72,62
26,"Rioja, La",42,Casalarreina,1090,538,552
26,"Rioja, La",43,Castañares de Rioja,407,197,210
26,"Rioja, La",44,Castroviejo,45,27,18
26,"Rioja, La",45,Cellorigo,10,4,6
26,"Rioja, La",46,Cenicero,2106,1084,1022
26,"Rioja, La",47,Cervera del Río Alhama,2313,1204,1109
26,"Rioja, La",48,Cidamón,24,12,12
26,"Rioja, La",49,Cihuri,184,97,87
26,"Rioja, La",50,Cirueña,180,114,66
26,"Rioja, La",51,Clavijo,291,171,120
26,"Rioja, La",52,Cordovín,158,80,78
26,"Rioja, La",53,Corera,262,139,123
26,"Rioja, La",54,Cornago,322,190,132
26,"Rioja, La",55,Corporales,38,24,14
26,"Rioja, La",56,Cuzcurrita de Río Tirón,522,274,248
26,"Rioja, La",57,Daroca de Rioja,62,40,22
26,"Rioja, La",58,Enciso,174,112,62
26,"Rioja, La",59,Entrena,1613,848,765
26,"Rioja, La",60,Estollo,84,52,32
26,"Rioja, La",61,Ezcaray,2076,1092,984
26,"Rioja, La",62,Foncea,98,58,40
26,"Rioja, La",63,Fonzaleche,146,95,51
26,"Rioja, La",64,Fuenmayor,3191,1618,1573
26,"Rioja, La",65,Galbárruli,78,48,30
26,"Rioja, La",66,Galilea,385,200,185
26,"Rioja, La",67,Gallinero de Cameros,19,12,7
26,"Rioja, La",68,Gimileo,113,59,54
26,"Rioja, La",69,Grañón,249,138,111
26,"Rioja, La",70,Grávalos,182,98,84
26,"Rioja, La",71,Haro,11633,5743,5890
26,"Rioja, La",72,Herce,332,171,161
26,"Rioja, La",73,Herramélluri,102,56,46
26,"Rioja, La",74,Hervías,117,60,57
26,"Rioja, La",75,Hormilla,429,229,200
26,"Rioja, La",76,Hormilleja,141,70,71
26,"Rioja, La",77,Hornillos de Cameros,22,14,8
26,"Rioja, La",78,Hornos de Moncalvillo,96,58,38
26,"Rioja, La",79,Huércanos,866,482,384
26,"Rioja, La",80,Igea,631,359,272
26,"Rioja, La",81,Jalón de Cameros,19,9,10
26,"Rioja, La",82,Laguna de Cameros,110,66,44
26,"Rioja, La",83,Lagunilla del Jubera,333,182,151
26,"Rioja, La",84,Lardero,11042,5543,5499
26,"Rioja, La",86,Ledesma de la Cogolla,18,13,5
26,"Rioja, La",87,Leiva,237,117,120
26,"Rioja, La",88,Leza de Río Leza,42,23,19
26,"Rioja, La",89,Logroño,150808,71462,79346
26,"Rioja, La",91,Lumbreras de Cameros,150,102,48
26,"Rioja, La",92,Manjarrés,117,71,46
26,"Rioja, La",93,Mansilla de la Sierra,54,39,15
26,"Rioja, La",94,Manzanares de Rioja,60,37,23
26,"Rioja, La",95,Matute,97,55,42
26,"Rioja, La",96,Medrano,341,180,161
26,"Rioja, La",98,Munilla,108,62,46
26,"Rioja, La",99,Murillo de Río Leza,1617,825,792
26,"Rioja, La",100,Muro de Aguas,67,41,26
26,"Rioja, La",101,Muro en Cameros,35,19,16
26,"Rioja, La",102,Nájera,8060,3964,4096
26,"Rioja, La",103,Nalda,1127,617,510
26,"Rioja, La",104,Navajún,10,8,2
26,"Rioja, La",105,Navarrete,2996,1505,1491
26,"Rioja, La",106,Nestares,86,48,38
26,"Rioja, La",107,Nieva de Cameros,89,60,29
26,"Rioja, La",109,Ochánduri,79,47,32
26,"Rioja, La",108,Ocón,332,200,132
26,"Rioja, La",110,Ojacastro,182,110,72
26,"Rioja, La",111,Ollauri,310,165,145
26,"Rioja, La",112,Ortigosa de Cameros,224,135,89
26,"Rioja, La",113,Pazuengos,26,21,5
26,"Rioja, La",114,Pedroso,83,53,30
26,"Rioja, La",115,Pinillos,20,10,10
26,"Rioja, La",117,Pradejón,3928,2034,1894
26,"Rioja, La",118,Pradillo,64,35,29
26,"Rioja, La",119,Préjano,207,114,93
26,"Rioja, La",120,Quel,2074,1103,971
26,"Rioja, La",121,Rabanera,32,22,10
26,"Rioja, La",122,"Rasillo de Cameros, El",136,75,61
26,"Rioja, La",123,"Redal, El",148,85,63
26,"Rioja, La",124,Ribafrecha,1009,521,488
26,"Rioja, La",125,Rincón de Soto,3900,2005,1895
26,"Rioja, La",126,Robres del Castillo,26,16,10
26,"Rioja, La",127,Rodezno,212,118,94
26,"Rioja, La",128,Sajazarra,129,70,59
26,"Rioja, La",129,San Asensio,1111,590,521
26,"Rioja, La",130,San Millán de la Cogolla,224,146,78
26,"Rioja, La",131,San Millán de Yécora,34,24,10
26,"Rioja, La",132,San Román de Cameros,131,83,48
26,"Rioja, La",139,San Torcuato,68,36,32
26,"Rioja, La",142,San Vicente de la Sonsierra,1015,533,482
26,"Rioja, La",134,Santa Coloma,97,60,37
26,"Rioja, La",135,Santa Engracia del Jubera,174,108,66
26,"Rioja, La",136,Santa Eulalia Bajera,108,62,46
26,"Rioja, La",138,Santo Domingo de la Calzada,6222,3118,3104
26,"Rioja, La",140,Santurde de Rioja,278,152,126
26,"Rioja, La",141,Santurdejo,99,63,36
26,"Rioja, La",143,Sojuela,465,256,209
26,"Rioja, La",144,Sorzano,230,125,105
26,"Rioja, La",145,Sotés,276,154,122
26,"Rioja, La",146,Soto en Cameros,84,48,36
26,"Rioja, La",147,Terroba,37,19,18
26,"Rioja, La",148,Tirgo,183,91,92
26,"Rioja, La",149,Tobía,49,26,23
26,"Rioja, La",150,Tormantos,116,64,52
26,"Rioja, La",153,Torre en Cameros,10,8,2
26,"Rioja, La",151,Torrecilla en Cameros,454,251,203
26,"Rioja, La",152,Torrecilla sobre Alesanco,35,22,13
26,"Rioja, La",154,Torremontalbo,11,8,3
26,"Rioja, La",155,Treviana,145,76,69
26,"Rioja, La",157,Tricio,360,176,184
26,"Rioja, La",158,Tudelilla,334,182,152
26,"Rioja, La",160,Uruñuela,975,492,483
26,"Rioja, La",161,Valdemadera,10,6,4
26,"Rioja, La",162,Valgañón,137,80,57
26,"Rioja, La",163,Ventosa,214,108,106
26,"Rioja, La",164,Ventrosa,55,34,21
26,"Rioja, La",165,Viguera,397,229,168
26,"Rioja, La",166,Villalba de Rioja,163,97,66
26,"Rioja, La",167,Villalobar de Rioja,69,49,20
26,"Rioja, La",168,Villamediana de Iregua,8608,4346,4262
26,"Rioja, La",169,Villanueva de Cameros,73,43,30
26,"Rioja, La",170,"Villar de Arnedo, El",590,310,280
26,"Rioja, La",171,Villar de Torre,163,100,63
26,"Rioja, La",172,Villarejo,34,24,10
26,"Rioja, La",173,Villarroya,5,3,2
26,"Rioja, La",174,Villarta-Quintana,136,79,57
26,"Rioja, La",175,Villavelayo,39,26,13
26,"Rioja, La",176,Villaverde de Rioja,59,34,25
26,"Rioja, La",177,Villoslada de Cameros,354,228,126
26,"Rioja, La",178,Viniegra de Abajo,81,50,31
26,"Rioja, La",179,Viniegra de Arriba,37,25,12
26,"Rioja, La",180,Zarratón,256,139,117
26,"Rioja, La",181,Zarzosa,13,9,4
26,"Rioja, La",183,Zorraquín,90,45,45
37,Salamanca,1,Abusejo,166,87,79
37,Salamanca,2,Agallas,128,65,63
37,Salamanca,3,Ahigal de los Aceiteros,114,62,52
37,Salamanca,4,Ahigal de Villarino,24,14,10
37,Salamanca,5,"Alameda de Gardón, La",67,36,31
37,Salamanca,6,"Alamedilla, La",121,62,59
37,Salamanca,7,Alaraz,429,226,203
37,Salamanca,8,Alba de Tormes,5159,2586,2573
37,Salamanca,9,Alba de Yeltes,216,120,96
37,Salamanca,10,"Alberca, La",1065,523,542
37,Salamanca,11,"Alberguería de Argañán, La",107,55,52
37,Salamanca,12,Alconada,144,77,67
37,Salamanca,15,Aldea del Obispo,252,136,116
37,Salamanca,13,Aldeacipreste,100,53,47
37,Salamanca,14,Aldeadávila de la Ribera,1181,584,597
37,Salamanca,16,Aldealengua,673,336,337
37,Salamanca,17,Aldeanueva de Figueroa,244,131,113
37,Salamanca,18,Aldeanueva de la Sierra,110,69,41
37,Salamanca,19,Aldearrodrigo,147,79,68
37,Salamanca,20,Aldearrubia,519,285,234
37,Salamanca,21,Aldeaseca de Alba,73,40,33
37,Salamanca,22,Aldeaseca de la Frontera,253,132,121
37,Salamanca,23,Aldeatejada,2307,1165,1142
37,Salamanca,24,Aldeavieja de Tormes,100,55,45
37,Salamanca,25,Aldehuela de la Bóveda,279,151,128
37,Salamanca,26,Aldehuela de Yeltes,193,103,90
37,Salamanca,27,Almenara de Tormes,289,157,132
37,Salamanca,28,Almendra,140,80,60
37,Salamanca,29,Anaya de Alba,188,115,73
37,Salamanca,30,Añover de Tormes,91,47,44
37,Salamanca,31,Arabayona de Mógica,339,192,147
37,Salamanca,32,Arapiles,669,363,306
37,Salamanca,33,Arcediano,96,49,47
37,Salamanca,34,"Arco, El",93,47,46
37,Salamanca,35,Armenteros,192,114,78
37,Salamanca,37,"Atalaya, La",108,60,48
37,Salamanca,38,Babilafuente,932,488,444
37,Salamanca,39,Bañobárez,287,145,142
37,Salamanca,40,Barbadillo,402,217,185
37,Salamanca,41,Barbalos,74,42,32
37,Salamanca,42,Barceo,44,26,18
37,Salamanca,44,Barruecopardo,443,247,196
37,Salamanca,45,"Bastida, La",32,18,14
37,Salamanca,46,Béjar,12269,5811,6458
37,Salamanca,47,Beleña,227,120,107
37,Salamanca,49,Bermellar,133,68,65
37,Salamanca,50,Berrocal de Huebra,79,44,35
37,Salamanca,51,Berrocal de Salvatierra,83,45,38
37,Salamanca,52,Boada,299,151,148
37,Salamanca,54,"Bodón, El",256,140,116
37,Salamanca,55,Bogajo,134,72,62
37,Salamanca,56,"Bouza, La",55,24,31
37,Salamanca,57,Bóveda del Río Almar,221,122,99
37,Salamanca,58,Brincones,53,28,25
37,Salamanca,59,Buenamadre,119,60,59
37,Salamanca,60,Buenavista,365,196,169
37,Salamanca,61,"Cabaco, El",223,119,104
37,Salamanca,63,"Cabeza de Béjar, La",60,39,21
37,Salamanca,65,Cabeza del Caballo,257,141,116
37,Salamanca,62,Cabezabellosa de la Calzada,75,44,31
37,Salamanca,67,Cabrerizos,4284,2132,2152
37,Salamanca,68,Cabrillas,355,180,175
37,Salamanca,69,Calvarrasa de Abajo,1169,620,549
37,Salamanca,70,Calvarrasa de Arriba,594,318,276
37,Salamanca,71,"Calzada de Béjar, La",91,51,40
37,Salamanca,72,Calzada de Don Diego,148,81,67
37,Salamanca,73,Calzada de Valdunciel,698,349,349
37,Salamanca,74,Campillo de Azaba,155,91,64
37,Salamanca,77,"Campo de Peñaranda, El",249,147,102
37,Salamanca,78,Candelario,874,449,425
37,Salamanca,79,Canillas de Abajo,80,56,24
37,Salamanca,80,Cantagallo,267,140,127
37,Salamanca,81,Cantalapiedra,923,475,448
37,Salamanca,82,Cantalpino,821,443,378
37,Salamanca,83,Cantaracillo,197,106,91
37,Salamanca,85,Carbajosa de la Sagrada,7368,3673,3695
37,Salamanca,86,Carpio de Azaba,116,65,51
37,Salamanca,87,Carrascal de Barregas,1295,666,629
37,Salamanca,88,Carrascal del Obispo,194,106,88
37,Salamanca,89,Casafranca,61,31,30
37,Salamanca,90,"Casas del Conde, Las",64,29,35
37,Salamanca,91,Casillas de Flores,191,93,98
37,Salamanca,92,Castellanos de Moriscos,2809,1453,1356
37,Salamanca,185,Castellanos de Villiquera,653,358,295
37,Salamanca,96,Castillejo de Martín Viejo,211,126,85
37,Salamanca,97,Castraz,38,24,14
37,Salamanca,98,Cepeda,293,149,144
37,Salamanca,99,Cereceda de la Sierra,67,33,34
37,Salamanca,100,Cerezal de Peñahorcada,64,31,33
37,Salamanca,101,Cerralbo,131,71,60
37,Salamanca,102,"Cerro, El",397,205,192
37,Salamanca,103,Cespedosa de Tormes,518,276,242
37,Salamanca,114,Chagarcía Medianero,64,34,30
37,Salamanca,104,Cilleros de la Bastida,21,10,11
37,Salamanca,106,Cipérez,255,132,123
37,Salamanca,107,Ciudad Rodrigo,12065,5797,6268
37,Salamanca,108,Coca de Alba,106,53,53
37,Salamanca,109,Colmenar de Montemayor,177,101,76
37,Salamanca,110,Cordovilla,112,60,52
37,Salamanca,112,Cristóbal,159,92,67
37,Salamanca,113,"Cubo de Don Sancho, El",427,221,206
37,Salamanca,115,Dios le Guarde,117,63,54
37,Salamanca,116,Doñinos de Ledesma,63,32,31
37,Salamanca,117,Doñinos de Salamanca,2214,1152,1062
37,Salamanca,118,Éjeme,129,75,54
37,Salamanca,120,Encina de San Silvestre,114,56,58
37,Salamanca,119,"Encina, La",104,62,42
37,Salamanca,121,Encinas de Abajo,617,323,294
37,Salamanca,122,Encinas de Arriba,240,121,119
37,Salamanca,123,Encinasola de los Comendadores,157,88,69
37,Salamanca,124,Endrinal,210,119,91
37,Salamanca,125,Escurial de la Sierra,241,134,107
37,Salamanca,126,Espadaña,38,24,14
37,Salamanca,127,Espeja,220,117,103
37,Salamanca,128,Espino de la Orbada,252,142,110
37,Salamanca,129,Florida de Liébana,254,138,116
37,Salamanca,130,Forfoleda,198,113,85
37,Salamanca,131,Frades de la Sierra,182,102,80
37,Salamanca,132,"Fregeneda, La",315,153,162
37,Salamanca,133,Fresnedoso,101,58,43
37,Salamanca,134,Fresno Alhándiga,196,107,89
37,Salamanca,135,"Fuente de San Esteban, La",1270,646,624
37,Salamanca,136,Fuenteguinaldo,674,327,347
37,Salamanca,137,Fuenteliante,97,48,49
37,Salamanca,138,Fuenterroble de Salvatierra,264,134,130
37,Salamanca,139,Fuentes de Béjar,216,107,109
37,Salamanca,140,Fuentes de Oñoro,1119,606,513
37,Salamanca,141,Gajates,152,70,82
37,Salamanca,142,Galindo y Perahuy,645,371,274
37,Salamanca,143,Galinduste,414,202,212
37,Salamanca,144,Galisancho,353,195,158
37,Salamanca,145,Gallegos de Argañán,268,134,134
37,Salamanca,146,Gallegos de Solmirón,115,67,48
37,Salamanca,147,Garcibuey,189,107,82
37,Salamanca,148,Garcihernández,427,223,204
37,Salamanca,149,Garcirrey,58,34,24
37,Salamanca,150,Gejuelo del Barro,34,20,14
37,Salamanca,151,Golpejas,146,75,71
37,Salamanca,152,Gomecello,432,226,206
37,Salamanca,154,Guadramiro,133,82,51
37,Salamanca,155,Guijo de Ávila,71,41,30
37,Salamanca,156,Guijuelo,5550,2776,2774
37,Salamanca,157,Herguijuela de Ciudad Rodrigo,68,41,27
37,Salamanca,158,Herguijuela de la Sierra,241,135,106
37,Salamanca,159,Herguijuela del Campo,69,37,32
37,Salamanca,160,Hinojosa de Duero,616,312,304
37,Salamanca,161,Horcajo de Montemayor,133,71,62
37,Salamanca,162,Horcajo Medianero,223,116,107
37,Salamanca,163,"Hoya, La",29,18,11
37,Salamanca,164,Huerta,287,159,128
37,Salamanca,165,Iruelos,31,13,18
37,Salamanca,166,Ituero de Azaba,204,105,99
37,Salamanca,167,Juzbado,199,100,99
37,Salamanca,168,Lagunilla,447,244,203
37,Salamanca,169,Larrodrigo,185,107,78
37,Salamanca,170,Ledesma,1553,757,796
37,Salamanca,171,Ledrada,466,240,226
37,Salamanca,172,Linares de Riofrío,938,518,420
37,Salamanca,173,Lumbrales,1550,780,770
37,Salamanca,175,Machacón,446,231,215
37,Salamanca,174,Macotera,1001,511,490
37,Salamanca,176,Madroñal,136,76,60
37,Salamanca,177,"Maíllo, El",271,154,117
37,Salamanca,178,Malpartida,96,51,45
37,Salamanca,179,Mancera de Abajo,212,109,103
37,Salamanca,180,"Manzano, El",65,34,31
37,Salamanca,181,Martiago,254,139,115
37,Salamanca,183,Martín de Yeltes,408,212,196
37,Salamanca,182,Martinamor,81,53,28
37,Salamanca,184,Masueco,274,143,131
37,Salamanca,186,"Mata de Ledesma, La",85,48,37
37,Salamanca,187,Matilla de los Caños del Río,639,316,323
37,Salamanca,188,"Maya, La",167,97,70
37,Salamanca,189,Membribe de la Sierra,111,66,45
37,Salamanca,190,Mieza,189,98,91
37,Salamanca,191,"Milano, El",99,60,39
37,Salamanca,192,Miranda de Azán,449,240,209
37,Salamanca,193,Miranda del Castañar,382,205,177
37,Salamanca,194,Mogarraz,260,134,126
37,Salamanca,195,Molinillo,42,25,17
37,Salamanca,196,Monforte de la Sierra,61,31,30
37,Salamanca,197,Monleón,96,55,41
37,Salamanca,198,Monleras,226,110,116
37,Salamanca,199,Monsagro,135,74,61
37,Salamanca,200,Montejo,207,118,89
37,Salamanca,201,Montemayor del Río,267,141,126
37,Salamanca,202,Monterrubio de Armuña,1319,686,633
37,Salamanca,203,Monterrubio de la Sierra,154,86,68
37,Salamanca,204,Morasverdes,245,125,120
37,Salamanca,205,Morille,227,125,102
37,Salamanca,206,Moríñigo,96,52,44
37,Salamanca,207,Moriscos,487,264,223
37,Salamanca,208,Moronta,75,48,27
37,Salamanca,209,Mozárbez,507,270,237
37,Salamanca,211,Narros de Matalayegua,210,117,93
37,Salamanca,213,Nava de Béjar,86,51,35
37,Salamanca,214,Nava de Francia,118,61,57
37,Salamanca,215,Nava de Sotrobal,163,95,68
37,Salamanca,212,Navacarros,121,64,57
37,Salamanca,216,Navales,317,169,148
37,Salamanca,217,Navalmoral de Béjar,58,27,31
37,Salamanca,218,Navamorales,47,27,20
37,Salamanca,219,Navarredonda de la Rinconada,165,83,82
37,Salamanca,221,Navasfrías,408,219,189
37,Salamanca,222,Negrilla de Palencia,81,46,35
37,Salamanca,223,Olmedo de Camaces,103,54,49
37,Salamanca,224,"Orbada, La",190,102,88
37,Salamanca,225,Pajares de la Laguna,104,57,47
37,Salamanca,226,Palacios del Arzobispo,175,86,89
37,Salamanca,228,Palaciosrubios,329,175,154
37,Salamanca,229,Palencia de Negrilla,151,92,59
37,Salamanca,230,Parada de Arriba,255,130,125
37,Salamanca,231,Parada de Rubiales,257,139,118
37,Salamanca,232,Paradinas de San Juan,388,228,160
37,Salamanca,233,Pastores,51,31,20
37,Salamanca,234,"Payo, El",313,152,161
37,Salamanca,235,Pedraza de Alba,222,117,105
37,Salamanca,236,Pedrosillo de Alba,125,74,51
37,Salamanca,237,Pedrosillo de los Aires,323,182,141
37,Salamanca,238,Pedrosillo el Ralo,122,64,58
37,Salamanca,239,"Pedroso de la Armuña, El",217,112,105
37,Salamanca,240,Pelabravo,1225,653,572
37,Salamanca,241,Pelarrodríguez,173,102,71
37,Salamanca,242,Pelayos,80,48,32
37,Salamanca,243,"Peña, La",87,47,40
37,Salamanca,244,Peñacaballera,138,68,70
37,Salamanca,245,Peñaparda,339,169,170
37,Salamanca,246,Peñaranda de Bracamonte,6123,3012,3111
37,Salamanca,247,Peñarandilla,175,95,80
37,Salamanca,248,Peralejos de Abajo,170,90,80
37,Salamanca,249,Peralejos de Arriba,37,25,12
37,Salamanca,250,Pereña de la Ribera,327,178,149
37,Salamanca,251,Peromingo,125,58,67
37,Salamanca,252,Pinedas,104,61,43
37,Salamanca,253,"Pino de Tormes, El",158,85,73
37,Salamanca,254,Pitiegua,186,102,84
37,Salamanca,255,Pizarral,54,34,20
37,Salamanca,256,Poveda de las Cintas,203,115,88
37,Salamanca,257,Pozos de Hinojo,53,28,25
37,Salamanca,258,Puebla de Azaba,140,79,61
37,Salamanca,259,Puebla de San Medel,37,22,15
37,Salamanca,260,Puebla de Yeltes,147,78,69
37,Salamanca,261,Puente del Congosto,218,125,93
37,Salamanca,262,Puertas,73,42,31
37,Salamanca,263,Puerto de Béjar,370,177,193
37,Salamanca,264,Puerto Seguro,58,28,30
37,Salamanca,265,Rágama,210,106,104
37,Salamanca,266,"Redonda, La",66,39,27
37,Salamanca,267,Retortillo,182,98,84
37,Salamanca,268,"Rinconada de la Sierra, La",104,61,43
37,Salamanca,269,Robleda,470,261,209
37,Salamanca,270,Robliza de Cojos,198,103,95
37,Salamanca,271,Rollán,352,190,162
37,Salamanca,272,Saelices el Chico,159,90,69
37,Salamanca,273,"Sagrada, La",89,50,39
37,Salamanca,303,"Sahugo, El",186,101,85
37,Salamanca,274,Salamanca,143269,64867,78402
37,Salamanca,275,Saldeana,98,56,42
37,Salamanca,276,Salmoral,124,71,53
37,Salamanca,277,Salvatierra de Tormes,76,39,37
37,Salamanca,278,San Cristóbal de la Cuesta,1029,537,492
37,Salamanca,284,San Esteban de la Sierra,357,201,156
37,Salamanca,285,San Felices de los Gallegos,367,197,170
37,Salamanca,286,San Martín del Castañar,228,124,104
37,Salamanca,287,San Miguel de Valero,332,171,161
37,Salamanca,36,San Miguel del Robledo,54,31,23
37,Salamanca,288,San Morales,332,179,153
37,Salamanca,289,San Muñoz,209,105,104
37,Salamanca,291,San Pedro de Rozados,276,157,119
37,Salamanca,290,San Pedro del Valle,132,77,55
37,Salamanca,292,San Pelayo de Guareña,96,54,42
37,Salamanca,280,Sanchón de la Ribera,79,42,37
37,Salamanca,281,Sanchón de la Sagrada,38,22,16
37,Salamanca,282,Sanchotello,231,115,116
37,Salamanca,279,Sancti-Spíritus,775,419,356
37,Salamanca,283,Sando,116,67,49
37,Salamanca,293,Santa María de Sando,100,51,49
37,Salamanca,294,Santa Marta de Tormes,14646,7142,7504
37,Salamanca,296,Santiago de la Puebla,297,153,144
37,Salamanca,297,Santibáñez de Béjar,462,230,232
37,Salamanca,298,Santibáñez de la Sierra,178,100,78
37,Salamanca,299,Santiz,253,138,115
37,Salamanca,300,"Santos, Los",595,302,293
37,Salamanca,301,Sardón de los Frailes,99,57,42
37,Salamanca,302,Saucelle,275,135,140
37,Salamanca,304,Sepulcro-Hilario,157,87,70
37,Salamanca,305,Sequeros,240,116,124
37,Salamanca,306,Serradilla del Arroyo,248,137,111
37,Salamanca,307,Serradilla del Llano,147,77,70
37,Salamanca,309,"Sierpe, La",41,21,20
37,Salamanca,310,Sieteiglesias de Tormes,184,85,99
37,Salamanca,311,Sobradillo,196,99,97
37,Salamanca,312,Sorihuela,258,133,125
37,Salamanca,313,Sotoserrano,553,298,255
37,Salamanca,314,Tabera de Abajo,109,58,51
37,Salamanca,315,"Tala, La",80,44,36
37,Salamanca,316,Tamames,783,394,389
37,Salamanca,317,Tarazona de Guareña,288,156,132
37,Salamanca,318,Tardáguila,196,116,80
37,Salamanca,319,"Tejado, El",82,44,38
37,Salamanca,320,Tejeda y Segoyuela,90,49,41
37,Salamanca,321,Tenebrón,135,72,63
37,Salamanca,322,Terradillos,3096,1531,1565
37,Salamanca,323,Topas,534,283,251
37,Salamanca,324,Tordillos,328,179,149
37,Salamanca,325,"Tornadizo, El",92,52,40
37,Salamanca,327,Torresmenudas,201,106,95
37,Salamanca,328,Trabanca,174,85,89
37,Salamanca,329,Tremedal de Tormes,37,19,18
37,Salamanca,330,Valdecarros,328,168,160
37,Salamanca,331,Valdefuentes de Sangusín,188,107,81
37,Salamanca,332,Valdehijaderos,73,41,32
37,Salamanca,333,Valdelacasa,211,120,91
37,Salamanca,334,Valdelageve,65,35,30
37,Salamanca,335,Valdelosa,404,205,199
37,Salamanca,336,Valdemierque,64,41,23
37,Salamanca,337,Valderrodrigo,136,72,64
37,Salamanca,338,Valdunciel,103,53,50
37,Salamanca,339,Valero,302,171,131
37,Salamanca,343,Vallejera de Riofrío,69,36,33
37,Salamanca,340,Valsalabroso,133,75,58
37,Salamanca,341,Valverde de Valdelacasa,66,34,32
37,Salamanca,342,Valverdón,277,144,133
37,Salamanca,344,Vecinos,239,119,120
37,Salamanca,345,Vega de Tirados,159,86,73
37,Salamanca,346,"Veguillas, Las",284,142,142
37,Salamanca,347,"Vellés, La",514,282,232
37,Salamanca,348,Ventosa del Río Almar,101,58,43
37,Salamanca,349,"Vídola, La",107,52,55
37,Salamanca,351,Villaflores,260,129,131
37,Salamanca,352,Villagonzalo de Tormes,237,140,97
37,Salamanca,353,Villalba de los Llanos,117,68,49
37,Salamanca,354,Villamayor,7371,3699,3672
37,Salamanca,355,Villanueva del Conde,171,87,84
37,Salamanca,356,Villar de Argañán,91,48,43
37,Salamanca,357,Villar de Ciervo,260,137,123
37,Salamanca,358,Villar de Gallimazo,210,141,69
37,Salamanca,359,Villar de la Yegua,162,88,74
37,Salamanca,360,Villar de Peralonso,212,113,99
37,Salamanca,361,Villar de Samaniego,87,49,38
37,Salamanca,362,Villares de la Reina,6491,3211,3280
37,Salamanca,363,Villares de Yeltes,111,51,60
37,Salamanca,364,Villarino de los Aires,789,414,375
37,Salamanca,365,Villarmayor,173,98,75
37,Salamanca,366,Villarmuerto,42,27,15
37,Salamanca,367,Villasbuenas,181,99,82
37,Salamanca,368,Villasdardo,24,8,16
37,Salamanca,369,Villaseco de los Gamitos,134,78,56
37,Salamanca,370,Villaseco de los Reyes,314,184,130
37,Salamanca,371,Villasrubias,251,135,116
37,Salamanca,372,Villaverde de Guareña,139,78,61
37,Salamanca,373,Villavieja de Yeltes,745,384,361
37,Salamanca,374,Villoria,1344,685,659
37,Salamanca,375,Villoruela,761,379,382
37,Salamanca,350,Vilvestre,411,204,207
37,Salamanca,376,Vitigudino,2410,1164,1246
37,Salamanca,377,Yecla de Yeltes,227,118,109
37,Salamanca,378,Zamarra,82,48,34
37,Salamanca,379,Zamayón,198,114,84
37,Salamanca,380,Zarapicos,59,34,25
37,Salamanca,381,"Zarza de Pumareda, La",138,84,54
37,Salamanca,382,Zorita de la Frontera,170,83,87
38,Santa Cruz de Tenerife,1,Adeje,48733,24562,24171
38,Santa Cruz de Tenerife,2,Agulo,1099,547,552
38,Santa Cruz de Tenerife,3,Alajeró,2047,1080,967
38,Santa Cruz de Tenerife,4,Arafo,5604,2794,2810
38,Santa Cruz de Tenerife,5,Arico,8234,4235,3999
38,Santa Cruz de Tenerife,6,Arona,82563,41804,40759
38,Santa Cruz de Tenerife,7,Barlovento,1921,970,951
38,Santa Cruz de Tenerife,8,Breña Alta,7196,3509,3687
38,Santa Cruz de Tenerife,9,Breña Baja,5866,2957,2909
38,Santa Cruz de Tenerife,10,Buenavista del Norte,4766,2385,2381
38,Santa Cruz de Tenerife,11,Candelaria,28463,13766,14697
38,Santa Cruz de Tenerife,12,Fasnia,2807,1470,1337
38,Santa Cruz de Tenerife,13,Frontera,4278,2137,2141
38,Santa Cruz de Tenerife,14,Fuencaliente de la Palma,1756,885,871
38,Santa Cruz de Tenerife,15,Garachico,4895,2448,2447
38,Santa Cruz de Tenerife,16,Garafía,1813,944,869
38,Santa Cruz de Tenerife,17,Granadilla de Abona,51850,25952,25898
38,Santa Cruz de Tenerife,18,"Guancha, La",5553,2713,2840
38,Santa Cruz de Tenerife,19,Guía de Isora,21827,10809,11018
38,Santa Cruz de Tenerife,20,Güímar,21000,10342,10658
38,Santa Cruz de Tenerife,21,Hermigua,1767,914,853
38,Santa Cruz de Tenerife,22,Icod de los Vinos,23310,11489,11821
38,Santa Cruz de Tenerife,24,"Llanos de Aridane, Los",20648,10001,10647
38,Santa Cruz de Tenerife,25,"Matanza de Acentejo, La",9114,4577,4537
38,Santa Cruz de Tenerife,26,"Orotava, La",42219,20691,21528
38,Santa Cruz de Tenerife,27,"Paso, El",7745,3868,3877
38,Santa Cruz de Tenerife,901,"Pinar de El Hierro, El",1936,1020,916
38,Santa Cruz de Tenerife,28,Puerto de la Cruz,30179,14681,15498
38,Santa Cruz de Tenerife,29,Puntagorda,2234,1133,1101
38,Santa Cruz de Tenerife,30,Puntallana,2549,1286,1263
38,Santa Cruz de Tenerife,31,"Realejos, Los",36824,18051,18773
38,Santa Cruz de Tenerife,32,"Rosario, El",17590,8920,8670
38,Santa Cruz de Tenerife,33,San Andrés y Sauces,4213,2101,2112
38,Santa Cruz de Tenerife,23,San Cristóbal de La Laguna,158010,76117,81893
38,Santa Cruz de Tenerife,34,San Juan de la Rambla,4854,2410,2444
38,Santa Cruz de Tenerife,35,San Miguel de Abona,21872,10989,10883
38,Santa Cruz de Tenerife,36,San Sebastián de la Gomera,9261,4644,4617
38,Santa Cruz de Tenerife,37,Santa Cruz de la Palma,15446,7430,8016
38,Santa Cruz de Tenerife,38,Santa Cruz de Tenerife,208563,99438,109125
38,Santa Cruz de Tenerife,39,Santa Úrsula,14987,7452,7535
38,Santa Cruz de Tenerife,40,Santiago del Teide,11115,5515,5600
38,Santa Cruz de Tenerife,41,"Sauzal, El",8918,4437,4481
38,Santa Cruz de Tenerife,42,"Silos, Los",4692,2347,2345
38,Santa Cruz de Tenerife,43,Tacoronte,24346,12094,12252
38,Santa Cruz de Tenerife,44,"Tanque, El",2829,1371,1458
38,Santa Cruz de Tenerife,45,Tazacorte,4558,2342,2216
38,Santa Cruz de Tenerife,46,Tegueste,11326,5595,5731
38,Santa Cruz de Tenerife,47,Tijarafe,2560,1304,1256
38,Santa Cruz de Tenerife,49,Valle Gran Rey,4643,2374,2269
38,Santa Cruz de Tenerife,50,Vallehermoso,2917,1519,1398
38,Santa Cruz de Tenerife,48,Valverde,5084,2552,2532
38,Santa Cruz de Tenerife,51,"Victoria de Acentejo, La",9161,4568,4593
38,Santa Cruz de Tenerife,52,Vilaflor de Chasna,1789,907,882
38,Santa Cruz de Tenerife,53,Villa de Mazo,4875,2453,2422
40,Segovia,1,Abades,835,417,418
40,Segovia,2,Adrada de Pirón,39,20,19
40,Segovia,3,Adrados,125,74,51
40,Segovia,4,Aguilafuente,557,278,279
40,Segovia,5,Alconada de Maderuelo,22,14,8
40,Segovia,12,Aldea Real,281,151,130
40,Segovia,6,Aldealcorvo,19,10,9
40,Segovia,7,Aldealengua de Pedraza,80,48,32
40,Segovia,8,Aldealengua de Santa María,61,31,30
40,Segovia,9,Aldeanueva de la Serrezuela,42,30,12
40,Segovia,10,Aldeanueva del Codonal,116,63,53
40,Segovia,13,Aldeasoña,62,38,24
40,Segovia,14,Aldehorno,52,33,19
40,Segovia,15,Aldehuela del Codonal,24,14,10
40,Segovia,16,Aldeonte,56,32,24
40,Segovia,17,Anaya,122,60,62
40,Segovia,18,Añe,68,40,28
40,Segovia,19,Arahuetes,28,23,5
40,Segovia,20,Arcones,171,86,85
40,Segovia,21,Arevalillo de Cega,17,11,6
40,Segovia,22,Armuña,246,143,103
40,Segovia,24,Ayllón,1153,592,561
40,Segovia,25,Barbolla,139,77,62
40,Segovia,26,Basardilla,168,77,91
40,Segovia,28,Bercial,104,55,49
40,Segovia,29,Bercimuel,20,12,8
40,Segovia,30,Bernardos,486,274,212
40,Segovia,31,Bernuy de Porreros,788,412,376
40,Segovia,32,Boceguillas,701,362,339
40,Segovia,33,Brieva,94,53,41
40,Segovia,34,Caballar,76,44,32
40,Segovia,35,Cabañas de Polendos,184,96,88
40,Segovia,36,Cabezuela,640,332,308
40,Segovia,37,Calabazas de Fuentidueña,27,17,10
40,Segovia,39,Campo de San Pedro,250,137,113
40,Segovia,40,Cantalejo,3522,1742,1780
40,Segovia,41,Cantimpalos,1346,716,630
40,Segovia,161,Carabias,50,36,14
40,Segovia,43,Carbonero el Mayor,2502,1283,1219
40,Segovia,44,Carrascal del Río,150,82,68
40,Segovia,45,Casla,159,82,77
40,Segovia,46,Castillejo de Mesleón,120,65,55
40,Segovia,47,Castro de Fuentidueña,47,29,18
40,Segovia,48,Castrojimeno,32,17,15
40,Segovia,49,Castroserna de Abajo,33,17,16
40,Segovia,51,Castroserracín,45,23,22
40,Segovia,52,Cedillo de la Torre,89,47,42
40,Segovia,53,Cerezo de Abajo,115,62,53
40,Segovia,54,Cerezo de Arriba,134,73,61
40,Segovia,65,Chañe,708,361,347
40,Segovia,55,Cilleruelo de San Mamés,34,23,11
40,Segovia,56,Cobos de Fuentidueña,34,15,19
40,Segovia,57,Coca,1726,867,859
40,Segovia,58,Codorniz,322,162,160
40,Segovia,59,Collado Hermoso,129,66,63
40,Segovia,60,Condado de Castilnovo,85,46,39
40,Segovia,61,Corral de Ayllón,71,41,30
40,Segovia,902,Cozuelos de Fuentidueña,120,63,57
40,Segovia,62,Cubillo,76,48,28
40,Segovia,63,Cuéllar,9620,4856,4764
40,Segovia,905,Cuevas de Provanco,127,73,54
40,Segovia,68,Domingo García,32,19,13
40,Segovia,69,Donhierro,85,47,38
40,Segovia,70,Duruelo,190,110,80
40,Segovia,71,Encinas,40,21,19
40,Segovia,72,Encinillas,319,178,141
40,Segovia,73,Escalona del Prado,498,261,237
40,Segovia,74,Escarabajosa de Cabezas,289,154,135
40,Segovia,75,Escobar de Polendos,168,93,75
40,Segovia,76,"Espinar, El",9476,4797,4679
40,Segovia,77,Espirdo,1452,767,685
40,Segovia,78,Fresneda de Cuéllar,166,100,66
40,Segovia,79,Fresno de Cantespino,313,179,134
40,Segovia,80,Fresno de la Fuente,78,40,38
40,Segovia,81,Frumales,111,60,51
40,Segovia,82,Fuente de Santa Cruz,108,57,51
40,Segovia,83,Fuente el Olmo de Fuentidueña,135,68,67
40,Segovia,84,Fuente el Olmo de Íscar,49,28,21
40,Segovia,86,Fuentepelayo,804,429,375
40,Segovia,87,Fuentepiñel,81,48,33
40,Segovia,88,Fuenterrebollo,332,176,156
40,Segovia,89,Fuentesaúco de Fuentidueña,234,124,110
40,Segovia,91,Fuentesoto,108,63,45
40,Segovia,92,Fuentidueña,132,78,54
40,Segovia,93,Gallegos,99,57,42
40,Segovia,94,Garcillán,512,268,244
40,Segovia,95,Gomezserracín,660,348,312
40,Segovia,97,Grajera,245,145,100
40,Segovia,99,Honrubia de la Cuesta,54,32,22
40,Segovia,100,Hontalbilla,292,163,129
40,Segovia,101,Hontanares de Eresma,1502,786,716
40,Segovia,103,"Huertos, Los",171,95,76
40,Segovia,104,Ituero y Lama,397,204,193
40,Segovia,105,Juarros de Riomoros,46,27,19
40,Segovia,106,Juarros de Voltoya,188,97,91
40,Segovia,107,Labajos,102,59,43
40,Segovia,108,Laguna de Contreras,106,64,42
40,Segovia,109,Languilla,70,41,29
40,Segovia,110,Lastras de Cuéllar,335,179,156
40,Segovia,111,Lastras del Pozo,55,30,25
40,Segovia,112,"Lastrilla, La",4186,2138,2048
40,Segovia,113,"Losa, La",521,292,229
40,Segovia,115,Maderuelo,125,71,54
40,Segovia,903,Marazoleja,103,68,35
40,Segovia,118,Marazuela,52,32,20
40,Segovia,119,Martín Miguel,230,138,92
40,Segovia,120,Martín Muñoz de la Dehesa,244,128,116
40,Segovia,121,Martín Muñoz de las Posadas,277,152,125
40,Segovia,122,Marugán,714,393,321
40,Segovia,124,Mata de Cuéllar,259,135,124
40,Segovia,123,Matabuena,183,103,80
40,Segovia,125,"Matilla, La",80,47,33
40,Segovia,126,Melque de Cercos,59,32,27
40,Segovia,127,Membibre de la Hoz,35,18,17
40,Segovia,128,Migueláñez,129,68,61
40,Segovia,129,Montejo de Arévalo,174,93,81
40,Segovia,130,Montejo de la Vega de la Serrezuela,141,81,60
40,Segovia,131,Monterrubio,60,32,28
40,Segovia,132,Moral de Hornuez,47,28,19
40,Segovia,134,Mozoncillo,851,466,385
40,Segovia,135,Muñopedro,315,166,149
40,Segovia,136,Muñoveros,141,69,72
40,Segovia,138,Nava de la Asunción,2748,1400,1348
40,Segovia,139,Navafría,299,163,136
40,Segovia,140,Navalilla,94,49,45
40,Segovia,141,Navalmanzano,1048,547,501
40,Segovia,142,Navares de Ayuso,52,26,26
40,Segovia,143,Navares de Enmedio,92,55,37
40,Segovia,144,Navares de las Cuevas,22,15,7
40,Segovia,145,Navas de Oro,1304,666,638
40,Segovia,904,Navas de Riofrío,367,178,189
40,Segovia,146,Navas de San Antonio,366,197,169
40,Segovia,148,Nieva,260,127,133
40,Segovia,149,Olombrada,519,285,234
40,Segovia,150,Orejana,66,39,27
40,Segovia,151,Ortigosa de Pestaño,46,23,23
40,Segovia,901,Ortigosa del Monte,580,300,280
40,Segovia,152,Otero de Herreros,957,483,474
40,Segovia,154,Pajarejos,21,11,10
40,Segovia,155,Palazuelos de Eresma,5597,2921,2676
40,Segovia,156,Pedraza,342,194,148
40,Segovia,157,Pelayos del Arroyo,52,30,22
40,Segovia,158,Perosillo,15,12,3
40,Segovia,159,Pinarejos,175,100,75
40,Segovia,160,Pinarnegrillo,100,57,43
40,Segovia,162,Prádena,508,268,240
40,Segovia,163,Puebla de Pedraza,43,23,20
40,Segovia,164,Rapariegos,202,101,101
40,Segovia,181,Real Sitio de San Ildefonso,5237,2560,2677
40,Segovia,165,Rebollo,73,38,35
40,Segovia,166,Remondo,308,155,153
40,Segovia,168,Riaguas de San Bartolomé,26,18,8
40,Segovia,170,Riaza,2135,1135,1000
40,Segovia,171,Ribota,45,35,10
40,Segovia,172,Riofrío de Riaza,34,21,13
40,Segovia,173,Roda de Eresma,201,109,92
40,Segovia,174,Sacramenia,373,181,192
40,Segovia,176,Samboal,448,240,208
40,Segovia,177,San Cristóbal de Cuéllar,147,80,67
40,Segovia,178,San Cristóbal de la Vega,88,49,39
40,Segovia,906,San Cristóbal de Segovia,3102,1543,1559
40,Segovia,182,San Martín y Mudrián,243,116,127
40,Segovia,183,San Miguel de Bernuy,138,69,69
40,Segovia,184,San Pedro de Gaíllos,278,150,128
40,Segovia,179,Sanchonuño,980,486,494
40,Segovia,180,Sangarcía,306,173,133
40,Segovia,185,Santa María la Real de Nieva,926,507,419
40,Segovia,186,Santa Marta del Cerro,40,21,19
40,Segovia,188,Santiuste de Pedraza,85,57,28
40,Segovia,189,Santiuste de San Juan Bautista,535,290,245
40,Segovia,190,Santo Domingo de Pirón,59,34,25
40,Segovia,191,Santo Tomé del Puerto,259,141,118
40,Segovia,192,Sauquillo de Cabezas,141,78,63
40,Segovia,193,Sebúlcor,264,143,121
40,Segovia,194,Segovia,51258,23880,27378
40,Segovia,195,Sepúlveda,987,510,477
40,Segovia,196,Sequera de Fresno,32,21,11
40,Segovia,198,Sotillo,29,16,13
40,Segovia,199,Sotosalbos,137,75,62
40,Segovia,200,Tabanera la Luenga,47,24,23
40,Segovia,201,Tolocirio,45,21,24
40,Segovia,206,Torre Val de San Pedro,197,102,95
40,Segovia,202,Torreadrada,50,26,24
40,Segovia,203,Torrecaballeros,1389,719,670
40,Segovia,204,Torrecilla del Pinar,174,92,82
40,Segovia,205,Torreiglesias,261,130,131
40,Segovia,207,Trescasas,1072,551,521
40,Segovia,208,Turégano,998,508,490
40,Segovia,210,Urueñas,104,66,38
40,Segovia,211,Valdeprados,70,39,31
40,Segovia,212,Valdevacas de Montejo,28,14,14
40,Segovia,213,Valdevacas y Guijar,96,53,43
40,Segovia,218,Valle de Tabladillo,79,49,30
40,Segovia,219,Vallelado,718,372,346
40,Segovia,220,Valleruela de Pedraza,73,34,39
40,Segovia,221,Valleruela de Sepúlveda,53,26,27
40,Segovia,214,Valseca,230,126,104
40,Segovia,215,Valtiendas,79,48,31
40,Segovia,216,Valverde del Majano,1112,567,545
40,Segovia,222,Veganzones,216,115,101
40,Segovia,223,Vegas de Matute,313,183,130
40,Segovia,224,Ventosilla y Tejadilla,17,11,6
40,Segovia,225,Villacastín,1491,772,719
40,Segovia,228,Villaverde de Íscar,560,295,265
40,Segovia,229,Villaverde de Montejo,31,20,11
40,Segovia,230,Villeguillo,103,58,45
40,Segovia,231,Yanguas de Eresma,126,71,55
40,Segovia,233,Zarzuela del Monte,512,266,246
40,Segovia,234,Zarzuela del Pinar,421,219,202
41,Sevilla,1,Aguadulce,2022,999,1023
41,Sevilla,2,Alanís,1716,854,862
41,Sevilla,3,Albaida del Aljarafe,3221,1589,1632
41,Sevilla,4,Alcalá de Guadaíra,75546,37521,38025
41,Sevilla,5,Alcalá del Río,12264,6215,6049
41,Sevilla,6,Alcolea del Río,3348,1664,1684
41,Sevilla,7,"Algaba, La",16484,8171,8313
41,Sevilla,8,Algámitas,1253,652,601
41,Sevilla,9,Almadén de la Plata,1331,689,642
41,Sevilla,10,Almensilla,6287,3147,3140
41,Sevilla,11,Arahal,19497,9651,9846
41,Sevilla,12,Aznalcázar,4614,2344,2270
41,Sevilla,13,Aznalcóllar,6060,3072,2988
41,Sevilla,14,Badolatosa,3099,1600,1499
41,Sevilla,15,Benacazón,7322,3688,3634
41,Sevilla,16,Bollullos de la Mitación,11099,5546,5553
41,Sevilla,17,Bormujos,22390,11110,11280
41,Sevilla,18,Brenes,12581,6221,6360
41,Sevilla,19,Burguillos,6902,3481,3421
41,Sevilla,20,"Cabezas de San Juan, Las",16335,8139,8196
41,Sevilla,21,Camas,27490,13482,14008
41,Sevilla,22,"Campana, La",5228,2619,2609
41,Sevilla,23,Cantillana,10755,5447,5308
41,Sevilla,901,Cañada Rosal,3347,1652,1695
41,Sevilla,24,Carmona,29123,14675,14448
41,Sevilla,25,Carrión de los Céspedes,2587,1256,1331
41,Sevilla,26,Casariche,5384,2764,2620
41,Sevilla,27,Castilblanco de los Arroyos,5059,2562,2497
41,Sevilla,28,Castilleja de Guzmán,2860,1464,1396
41,Sevilla,29,Castilleja de la Cuesta,17366,8395,8971
41,Sevilla,30,Castilleja del Campo,633,320,313
41,Sevilla,31,"Castillo de las Guardas, El",1512,801,711
41,Sevilla,32,Cazalla de la Sierra,4752,2334,2418
41,Sevilla,33,Constantina,5864,2910,2954
41,Sevilla,34,Coria del Río,30774,15307,15467
41,Sevilla,35,Coripe,1241,607,634
41,Sevilla,36,"Coronil, El",4699,2357,2342
41,Sevilla,37,"Corrales, Los",3985,2034,1951
41,Sevilla,903,"Cuervo de Sevilla, El",8667,4366,4301
41,Sevilla,38,Dos Hermanas,136250,66833,69417
41,Sevilla,39,Écija,39838,19621,20217
41,Sevilla,40,Espartinas,16048,8043,8005
41,Sevilla,41,Estepa,12459,6205,6254
41,Sevilla,42,Fuentes de Andalucía,7160,3567,3593
41,Sevilla,43,"Garrobo, El",812,419,393
41,Sevilla,44,Gelves,10295,5111,5184
41,Sevilla,45,Gerena,7740,3854,3886
41,Sevilla,46,Gilena,3709,1859,1850
41,Sevilla,47,Gines,13529,6665,6864
41,Sevilla,48,Guadalcanal,2588,1307,1281
41,Sevilla,49,Guillena,13054,6562,6492
41,Sevilla,50,Herrera,6504,3232,3272
41,Sevilla,51,Huévar del Aljarafe,3129,1603,1526
41,Sevilla,902,Isla Mayor,5826,2913,2913
41,Sevilla,52,Lantejuela,3856,1969,1887
41,Sevilla,53,Lebrija,27616,13778,13838
41,Sevilla,54,Lora de Estepa,875,448,427
41,Sevilla,55,Lora del Río,18578,9177,9401
41,Sevilla,56,"Luisiana, La",4587,2322,2265
41,Sevilla,57,"Madroño, El",300,153,147
41,Sevilla,58,Mairena del Alcor,23893,11958,11935
41,Sevilla,59,Mairena del Aljarafe,46895,22747,24148
41,Sevilla,60,Marchena,19317,9610,9707
41,Sevilla,61,Marinaleda,2618,1335,1283
41,Sevilla,62,Martín de la Jara,2663,1368,1295
41,Sevilla,63,"Molares, Los",3563,1824,1739
41,Sevilla,64,Montellano,7014,3519,3495
41,Sevilla,65,Morón de la Frontera,27582,13560,14022
41,Sevilla,66,"Navas de la Concepción, Las",1538,759,779
41,Sevilla,67,Olivares,9452,4719,4733
41,Sevilla,68,Osuna,17594,8740,8854
41,Sevilla,69,"Palacios y Villafranca, Los",38678,19349,19329
41,Sevilla,904,"Palmar de Troya, El",2340,1172,1168
41,Sevilla,70,Palomares del Río,9020,4522,4498
41,Sevilla,71,Paradas,6850,3401,3449
41,Sevilla,72,Pedrera,5147,2541,2606
41,Sevilla,73,"Pedroso, El",2038,1013,1025
41,Sevilla,74,Peñaflor,3648,1831,1817
41,Sevilla,75,Pilas,13856,6933,6923
41,Sevilla,76,Pruna,2604,1319,1285
41,Sevilla,77,"Puebla de Cazalla, La",10896,5463,5433
41,Sevilla,78,"Puebla de los Infantes, La",2999,1477,1522
41,Sevilla,79,"Puebla del Río, La",11873,5843,6030
41,Sevilla,80,"Real de la Jara, El",1513,752,761
41,Sevilla,81,"Rinconada, La",39204,19395,19809
41,Sevilla,82,"Roda de Andalucía, La",4223,2085,2138
41,Sevilla,83,"Ronquillo, El",1431,713,718
41,Sevilla,84,"Rubio, El",3376,1683,1693
41,Sevilla,85,Salteras,5646,2724,2922
41,Sevilla,86,San Juan de Aznalfarache,22088,10632,11456
41,Sevilla,88,San Nicolás del Puerto,608,315,293
41,Sevilla,87,Sanlúcar la Mayor,14026,6902,7124
41,Sevilla,89,Santiponce,8491,4222,4269
41,Sevilla,90,"Saucejo, El",4247,2102,2145
41,Sevilla,91,Sevilla,684234,324312,359922
41,Sevilla,92,Tocina,9508,4712,4796
41,Sevilla,93,Tomares,25370,12519,12851
41,Sevilla,94,Umbrete,9086,4538,4548
41,Sevilla,95,Utrera,51145,25205,25940
41,Sevilla,96,Valencina de la Concepción,7894,3878,4016
41,Sevilla,97,Villamanrique de la Condesa,4531,2218,2313
41,Sevilla,100,Villanueva de San Juan,1076,533,543
41,Sevilla,98,Villanueva del Ariscal,6673,3254,3419
41,Sevilla,99,Villanueva del Río y Minas,4892,2465,2427
41,Sevilla,101,Villaverde del Río,7811,3951,3860
41,Sevilla,102,"Viso del Alcor, El",19251,9624,9627
42,Soria,1,Abejar,273,142,131
42,Soria,3,Adradas,55,29,26
42,Soria,4,Ágreda,3006,1546,1460
42,Soria,6,Alconaba,196,128,68
42,Soria,7,Alcubilla de Avellaneda,116,63,53
42,Soria,8,Alcubilla de las Peñas,51,30,21
42,Soria,9,Aldealafuente,86,51,35
42,Soria,10,Aldealices,29,20,9
42,Soria,11,Aldealpozo,17,7,10
42,Soria,12,Aldealseñor,32,19,13
42,Soria,13,Aldehuela de Periáñez,33,19,14
42,Soria,14,"Aldehuelas, Las",56,32,24
42,Soria,15,Alentisque,26,16,10
42,Soria,16,Aliud,22,16,6
42,Soria,17,Almajano,188,99,89
42,Soria,18,Almaluez,124,74,50
42,Soria,19,Almarza,640,372,268
42,Soria,20,Almazán,5411,2759,2652
42,Soria,21,Almazul,65,43,22
42,Soria,22,Almenar de Soria,233,141,92
42,Soria,23,Alpanseque,54,34,20
42,Soria,24,Arancón,84,55,29
42,Soria,25,Arcos de Jalón,1477,762,715
42,Soria,26,Arenillas,47,28,19
42,Soria,27,Arévalo de la Sierra,73,46,27
42,Soria,28,Ausejo de la Sierra,91,51,40
42,Soria,29,Baraona,127,72,55
42,Soria,30,Barca,108,69,39
42,Soria,31,Barcones,21,14,7
42,Soria,32,Bayubas de Abajo,135,73,62
42,Soria,33,Bayubas de Arriba,61,35,26
42,Soria,34,Beratón,38,20,18
42,Soria,35,Berlanga de Duero,872,454,418
42,Soria,36,Blacos,41,21,20
42,Soria,37,Bliecos,29,18,11
42,Soria,38,Borjabad,33,20,13
42,Soria,39,Borobia,242,134,108
42,Soria,41,Buberos,29,15,14
42,Soria,42,Buitrago,72,40,32
42,Soria,43,Burgo de Osma-Ciudad de Osma,5034,2533,2501
42,Soria,44,Cabrejas del Campo,48,29,19
42,Soria,45,Cabrejas del Pinar,346,194,152
42,Soria,46,Calatañazor,49,27,22
42,Soria,48,Caltojar,57,39,18
42,Soria,49,Candilichera,100,61,39
42,Soria,50,Cañamaque,32,22,10
42,Soria,51,Carabantes,15,8,7
42,Soria,52,Caracena,14,10,4
42,Soria,53,Carrascosa de Abajo,18,12,6
42,Soria,54,Carrascosa de la Sierra,17,12,5
42,Soria,55,Casarejos,156,82,74
42,Soria,56,Castilfrío de la Sierra,35,21,14
42,Soria,58,Castillejo de Robledo,104,63,41
42,Soria,57,Castilruiz,153,83,70
42,Soria,59,Centenera de Andaluz,21,11,10
42,Soria,60,Cerbón,30,20,10
42,Soria,61,Cidones,302,181,121
42,Soria,62,Cigudosa,20,14,6
42,Soria,63,Cihuela,47,28,19
42,Soria,64,Ciria,76,40,36
42,Soria,65,Cirujales del Río,20,15,5
42,Soria,68,Coscurita,72,46,26
42,Soria,69,Covaleda,1621,841,780
42,Soria,70,Cubilla,27,15,12
42,Soria,71,Cubo de la Solana,179,103,76
42,Soria,73,Cueva de Ágreda,67,42,25
42,Soria,75,Dévanos,79,44,35
42,Soria,76,Deza,211,113,98
42,Soria,78,Duruelo de la Sierra,1066,553,513
42,Soria,79,Escobosa de Almazán,20,13,7
42,Soria,80,Espeja de San Marcelino,158,95,63
42,Soria,81,Espejón,147,80,67
42,Soria,82,Estepa de San Juan,9,6,3
42,Soria,83,Frechilla de Almazán,20,10,10
42,Soria,84,Fresno de Caracena,20,14,6
42,Soria,85,Fuentearmegil,160,95,65
42,Soria,86,Fuentecambrón,32,20,12
42,Soria,87,Fuentecantos,66,33,33
42,Soria,88,Fuentelmonge,64,37,27
42,Soria,89,Fuentelsaz de Soria,63,33,30
42,Soria,90,Fuentepinilla,82,50,32
42,Soria,92,Fuentes de Magaña,54,33,21
42,Soria,93,Fuentestrún,42,29,13
42,Soria,94,Garray,750,404,346
42,Soria,95,Golmayo,2844,1482,1362
42,Soria,96,Gómara,294,158,136
42,Soria,97,Gormaz,21,16,5
42,Soria,98,Herrera de Soria,9,7,2
42,Soria,100,Hinojosa del Campo,28,19,9
42,Soria,103,Langa de Duero,694,368,326
42,Soria,105,Liceras,47,25,22
42,Soria,106,"Losilla, La",12,8,4
42,Soria,107,Magaña,68,37,31
42,Soria,108,Maján,9,6,3
42,Soria,110,Matalebreras,64,42,22
42,Soria,111,Matamala de Almazán,266,147,119
42,Soria,113,Medinaceli,664,339,325
42,Soria,115,Miño de Medinaceli,83,52,31
42,Soria,116,Miño de San Esteban,43,29,14
42,Soria,117,Molinos de Duero,158,84,74
42,Soria,118,Momblona,17,13,4
42,Soria,119,Monteagudo de las Vicarías,179,89,90
42,Soria,120,Montejo de Tiermes,148,93,55
42,Soria,121,Montenegro de Cameros,51,34,17
42,Soria,123,Morón de Almazán,191,99,92
42,Soria,124,Muriel de la Fuente,54,35,19
42,Soria,125,Muriel Viejo,82,53,29
42,Soria,127,Nafría de Ucero,33,19,14
42,Soria,128,Narros,48,29,19
42,Soria,129,Navaleno,755,400,355
42,Soria,130,Nepas,51,36,15
42,Soria,131,Nolay,58,34,24
42,Soria,132,Noviercas,160,88,72
42,Soria,134,Ólvega,3668,1871,1797
42,Soria,135,Oncala,67,42,25
42,Soria,139,Pinilla del Campo,20,12,8
42,Soria,140,Portillo de Soria,14,10,4
42,Soria,141,"Póveda de Soria, La",112,69,43
42,Soria,142,Pozalmuro,53,27,26
42,Soria,144,Quintana Redonda,496,280,216
42,Soria,145,Quintanas de Gormaz,141,88,53
42,Soria,148,Quiñonería,8,4,4
42,Soria,149,"Rábanos, Los",465,254,211
42,Soria,151,Rebollar,41,20,21
42,Soria,152,Recuerda,71,42,29
42,Soria,153,Rello,15,9,6
42,Soria,154,Renieblas,111,72,39
42,Soria,155,Retortillo de Soria,160,93,67
42,Soria,156,Reznos,31,20,11
42,Soria,157,"Riba de Escalote, La",11,7,4
42,Soria,158,Rioseco de Soria,125,76,49
42,Soria,159,Rollamienta,41,27,14
42,Soria,160,"Royo, El",260,140,120
42,Soria,161,Salduero,147,79,68
42,Soria,162,San Esteban de Gormaz,2948,1552,1396
42,Soria,163,San Felices,59,36,23
42,Soria,164,San Leonardo de Yagüe,2042,1032,1010
42,Soria,165,San Pedro Manrique,655,361,294
42,Soria,166,Santa Cruz de Yanguas,62,35,27
42,Soria,167,Santa María de Huerta,265,147,118
42,Soria,168,Santa María de las Hoyas,87,52,35
42,Soria,171,Serón de Nágima,130,73,57
42,Soria,172,Soliedra,31,17,14
42,Soria,173,Soria,39695,18740,20955
42,Soria,174,Sotillo del Rincón,178,95,83
42,Soria,175,Suellacabras,25,13,12
42,Soria,176,Tajahuerce,24,13,11
42,Soria,177,Tajueco,60,36,24
42,Soria,178,Talveila,107,64,43
42,Soria,181,Tardelcuende,420,221,199
42,Soria,182,Taroda,46,26,20
42,Soria,183,Tejado,92,54,38
42,Soria,184,Torlengua,51,31,20
42,Soria,185,Torreblacos,26,13,13
42,Soria,187,Torrubia de Soria,61,41,20
42,Soria,188,Trévago,43,20,23
42,Soria,189,Ucero,63,37,26
42,Soria,190,Vadillo,86,45,41
42,Soria,191,Valdeavellano de Tera,204,109,95
42,Soria,192,Valdegeña,38,29,9
42,Soria,193,Valdelagua del Cerro,12,7,5
42,Soria,194,Valdemaluque,148,68,80
42,Soria,195,Valdenebro,96,54,42
42,Soria,196,Valdeprado,6,3,3
42,Soria,197,Valderrodilla,67,36,31
42,Soria,198,Valtajeros,22,13,9
42,Soria,200,Velamazán,72,49,23
42,Soria,201,Velilla de la Sierra,28,17,11
42,Soria,202,Velilla de los Ajos,19,11,8
42,Soria,204,Viana de Duero,54,36,18
42,Soria,205,Villaciervos,72,44,28
42,Soria,206,Villanueva de Gormaz,8,6,2
42,Soria,207,Villar del Ala,50,27,23
42,Soria,208,Villar del Campo,26,17,9
42,Soria,209,Villar del Río,154,93,61
42,Soria,211,"Villares de Soria, Los",81,45,36
42,Soria,212,Villasayas,66,41,25
42,Soria,213,Villaseca de Arciel,24,15,9
42,Soria,215,Vinuesa,837,442,395
42,Soria,216,Vizmanos,26,16,10
42,Soria,217,Vozmediano,37,24,13
42,Soria,218,Yanguas,113,71,42
42,Soria,219,Yelo,47,29,18
43,Tarragona,1,Aiguamúrcia,960,495,465
43,Tarragona,2,Albinyana,2504,1294,1210
43,Tarragona,3,"Albiol, L'",515,278,237
43,Tarragona,4,Alcanar,9579,4862,4717
43,Tarragona,5,Alcover,5185,2569,2616
43,Tarragona,904,"Aldea, L'",4160,2219,1941
43,Tarragona,6,Aldover,911,464,447
43,Tarragona,7,"Aleixar, L'",912,469,443
43,Tarragona,8,Alfara de Carles,376,203,173
43,Tarragona,9,Alforja,1843,937,906
43,Tarragona,10,Alió,478,237,241
43,Tarragona,11,Almoster,1322,658,664
43,Tarragona,12,Altafulla,5512,2679,2833
43,Tarragona,13,"Ametlla de Mar, L'",7131,3620,3511
43,Tarragona,906,"Ampolla, L'",3444,1778,1666
43,Tarragona,14,Amposta,21317,10776,10541
43,Tarragona,16,"Arboç, L'",5625,2886,2739
43,Tarragona,15,Arbolí,126,76,50
43,Tarragona,17,"Argentera, L'",126,72,54
43,Tarragona,18,Arnes,441,218,223
43,Tarragona,19,Ascó,1611,820,791
43,Tarragona,20,Banyeres del Penedès,3280,1659,1621
43,Tarragona,21,Barberà de la Conca,472,262,210
43,Tarragona,22,Batea,1879,937,942
43,Tarragona,23,Bellmunt del Priorat,281,143,138
43,Tarragona,24,Bellvei,2303,1183,1120
43,Tarragona,25,Benifallet,741,358,383
43,Tarragona,26,Benissanet,1129,615,514
43,Tarragona,27,"Bisbal de Falset, La",218,124,94
43,Tarragona,28,"Bisbal del Penedès, La",3830,2012,1818
43,Tarragona,29,Blancafort,398,209,189
43,Tarragona,30,Bonastre,727,384,343
43,Tarragona,31,"Borges del Camp, Les",2104,1077,1027
43,Tarragona,32,Bot,566,289,277
43,Tarragona,33,Botarell,1094,559,535
43,Tarragona,34,Bràfim,695,347,348
43,Tarragona,35,Cabacés,312,165,147
43,Tarragona,36,Cabra del Camp,1230,647,583
43,Tarragona,37,Calafell,28463,14280,14183
43,Tarragona,903,Camarles,3220,1647,1573
43,Tarragona,38,Cambrils,35064,17150,17914
43,Tarragona,907,"Canonja, La",5933,2892,3041
43,Tarragona,39,Capafonts,125,68,57
43,Tarragona,40,Capçanes,394,200,194
43,Tarragona,41,Caseres,226,116,110
43,Tarragona,42,Castellvell del Camp,2873,1441,1432
43,Tarragona,43,"Catllar, El",4740,2467,2273
43,Tarragona,45,Colldejou,167,93,74
43,Tarragona,46,Conesa,106,52,54
43,Tarragona,47,Constantí,6724,3470,3254
43,Tarragona,48,Corbera d'Ebre,981,510,471
43,Tarragona,49,Cornudella de Montsant,965,509,456
43,Tarragona,50,Creixell,3912,1970,1942
43,Tarragona,51,Cunit,14081,6956,7125
43,Tarragona,901,Deltebre,11539,5801,5738
43,Tarragona,53,Duesaigües,234,131,103
43,Tarragona,54,"Espluga de Francolí, L'",3717,1821,1896
43,Tarragona,55,Falset,2724,1368,1356
43,Tarragona,56,"Fatarella, La",917,447,470
43,Tarragona,57,"Febró, La",41,25,16
43,Tarragona,58,"Figuera, La",117,66,51
43,Tarragona,59,Figuerola del Camp,336,167,169
43,Tarragona,60,Flix,3451,1740,1711
43,Tarragona,61,Forès,48,27,21
43,Tarragona,62,Freginals,391,210,181
43,Tarragona,63,"Galera, La",723,375,348
43,Tarragona,64,Gandesa,3098,1587,1511
43,Tarragona,65,Garcia,535,261,274
43,Tarragona,66,"Garidells, Els",198,98,100
43,Tarragona,67,Ginestar,787,420,367
43,Tarragona,68,Godall,614,304,310
43,Tarragona,69,Gratallops,237,131,106
43,Tarragona,70,"Guiamets, Els",276,134,142
43,Tarragona,71,Horta de Sant Joan,1138,589,549
43,Tarragona,72,"Lloar, El",111,57,54
43,Tarragona,73,Llorac,92,49,43
43,Tarragona,74,Llorenç del Penedès,2381,1169,1212
43,Tarragona,76,Marçà,612,320,292
43,Tarragona,75,Margalef,104,61,43
43,Tarragona,77,Mas de Barberans,572,286,286
43,Tarragona,78,Masdenverge,1109,572,537
43,Tarragona,79,Masllorenç,508,276,232
43,Tarragona,80,"Masó, La",283,148,135
43,Tarragona,81,Maspujols,826,420,406
43,Tarragona,82,"Masroig, El",499,278,221
43,Tarragona,83,"Milà, El",191,91,100
43,Tarragona,84,Miravet,685,364,321
43,Tarragona,85,"Molar, El",298,157,141
43,Tarragona,86,Montblanc,7433,3771,3662
43,Tarragona,88,Montbrió del Camp,2985,1539,1446
43,Tarragona,89,Montferri,397,211,186
43,Tarragona,90,"Montmell, El",1730,924,806
43,Tarragona,91,Mont-ral,169,94,75
43,Tarragona,92,Mont-roig del Camp,12689,6514,6175
43,Tarragona,93,Móra d'Ebre,5585,2797,2788
43,Tarragona,94,Móra la Nova,3120,1562,1558
43,Tarragona,95,"Morell, El",3732,1918,1814
43,Tarragona,96,"Morera de Montsant, La",163,87,76
43,Tarragona,97,"Nou de Gaià, La",616,304,312
43,Tarragona,98,Nulles,516,280,236
43,Tarragona,100,"Pallaresos, Els",4872,2441,2431
43,Tarragona,99,"Palma d'Ebre, La",334,168,166
43,Tarragona,101,Passanant i Belltall,167,98,69
43,Tarragona,102,Paüls,563,287,276
43,Tarragona,103,Perafort,1275,662,613
43,Tarragona,104,"Perelló, El",2846,1453,1393
43,Tarragona,105,"Piles, Les",218,117,101
43,Tarragona,106,"Pinell de Brai, El",998,503,495
43,Tarragona,107,Pira,498,267,231
43,Tarragona,108,"Pla de Santa Maria, El",2340,1222,1118
43,Tarragona,109,"Pobla de Mafumet, La",4025,2036,1989
43,Tarragona,110,"Pobla de Massaluca, La",341,192,149
43,Tarragona,111,"Pobla de Montornès, La",2999,1543,1456
43,Tarragona,112,Poboleda,328,165,163
43,Tarragona,113,"Pont d'Armentera, El",493,245,248
43,Tarragona,141,Pontils,138,74,64
43,Tarragona,114,Porrera,428,224,204
43,Tarragona,115,Pradell de la Teixeta,164,78,86
43,Tarragona,116,Prades,602,322,280
43,Tarragona,117,Prat de Comte,186,98,88
43,Tarragona,118,Pratdip,680,353,327
43,Tarragona,119,Puigpelat,1196,629,567
43,Tarragona,120,Querol,544,305,239
43,Tarragona,121,Rasquera,846,420,426
43,Tarragona,122,Renau,155,83,72
43,Tarragona,123,Reus,106084,51298,54786
43,Tarragona,124,"Riba, La",575,310,265
43,Tarragona,125,Riba-roja d'Ebre,1117,595,522
43,Tarragona,126,"Riera de Gaià, La",1737,864,873
43,Tarragona,127,Riudecanyes,1194,635,559
43,Tarragona,128,Riudecols,1225,631,594
43,Tarragona,129,Riudoms,6617,3364,3253
43,Tarragona,130,Rocafort de Queralt,230,123,107
43,Tarragona,131,Roda de Berà,7127,3653,3474
43,Tarragona,132,Rodonyà,507,273,234
43,Tarragona,133,Roquetes,8159,4207,3952
43,Tarragona,134,"Rourell, El",402,205,197
43,Tarragona,135,Salomó,544,280,264
43,Tarragona,905,Salou,28512,14673,13839
43,Tarragona,136,Sant Carles de la Ràpita,14931,7312,7619
43,Tarragona,137,Sant Jaume dels Domenys,2666,1369,1297
43,Tarragona,902,Sant Jaume d'Enveja,3552,1775,1777
43,Tarragona,138,Santa Bàrbara,3762,1928,1834
43,Tarragona,139,Santa Coloma de Queralt,2702,1344,1358
43,Tarragona,140,Santa Oliva,3450,1756,1694
43,Tarragona,142,Sarral,1549,803,746
43,Tarragona,143,Savallà del Comtat,53,27,26
43,Tarragona,144,"Secuita, La",1728,869,859
43,Tarragona,145,"Selva del Camp, La",5694,2854,2840
43,Tarragona,146,Senan,42,28,14
43,Tarragona,44,"Sénia, La",5530,2774,2756
43,Tarragona,147,Solivella,640,332,308
43,Tarragona,148,Tarragona,135436,66116,69320
43,Tarragona,149,Tivenys,900,457,443
43,Tarragona,150,Tivissa,1639,830,809
43,Tarragona,151,"Torre de Fontaubella, La",128,66,62
43,Tarragona,152,"Torre de l'Espanyol, La",598,309,289
43,Tarragona,153,Torredembarra,17057,8366,8691
43,Tarragona,154,Torroja del Priorat,141,79,62
43,Tarragona,155,Tortosa,33572,16730,16842
43,Tarragona,156,Ulldecona,6317,3335,2982
43,Tarragona,157,Ulldemolins,400,227,173
43,Tarragona,158,Vallclara,91,55,36
43,Tarragona,159,Vallfogona de Riucorb,77,48,29
43,Tarragona,160,Vallmoll,1793,900,893
43,Tarragona,161,Valls,24553,12297,12256
43,Tarragona,162,Vandellòs i l'Hospitalet de l'Infant,6645,3301,3344
43,Tarragona,163,"Vendrell, El",38891,19299,19592
43,Tarragona,164,Vespella de Gaià,458,249,209
43,Tarragona,165,Vilabella,705,359,346
43,Tarragona,175,Vilalba dels Arcs,630,313,317
43,Tarragona,166,Vilallonga del Camp,2385,1222,1163
43,Tarragona,168,Vilanova de Prades,108,54,54
43,Tarragona,167,Vilanova d'Escornalbou,582,303,279
43,Tarragona,169,Vilaplana,536,287,249
43,Tarragona,170,Vila-rodona,1299,688,611
43,Tarragona,171,Vila-seca,22522,11309,11213
43,Tarragona,172,Vilaverd,445,243,202
43,Tarragona,173,"Vilella Alta, La",131,69,62
43,Tarragona,174,"Vilella Baixa, La",208,113,95
43,Tarragona,176,Vimbodí i Poblet,880,474,406
43,Tarragona,177,Vinebre,427,212,215
43,Tarragona,178,Vinyols i els Arcs,2193,1154,1039
43,Tarragona,52,Xerta,1159,573,586
44,Teruel,1,Ababuj,76,44,32
44,Teruel,2,Abejuela,57,36,21
44,Teruel,3,Aguatón,17,8,9
44,Teruel,4,Aguaviva,547,267,280
44,Teruel,5,Aguilar del Alfambra,76,41,35
44,Teruel,6,Alacón,235,121,114
44,Teruel,7,Alba,184,103,81
44,Teruel,8,Albalate del Arzobispo,1977,1013,964
44,Teruel,9,Albarracín,990,505,485
44,Teruel,10,Albentosa,294,160,134
44,Teruel,11,Alcaine,46,29,17
44,Teruel,12,Alcalá de la Selva,352,193,159
44,Teruel,13,Alcañiz,16029,7994,8035
44,Teruel,14,Alcorisa,3293,1685,1608
44,Teruel,16,Alfambra,483,258,225
44,Teruel,17,Aliaga,333,190,143
44,Teruel,21,Allepuz,128,64,64
44,Teruel,22,Alloza,577,303,274
44,Teruel,23,Allueva,22,14,8
44,Teruel,18,Almohaja,14,10,4
44,Teruel,19,Alobras,65,43,22
44,Teruel,20,Alpeñés,20,12,8
44,Teruel,24,Anadón,32,20,12
44,Teruel,25,Andorra,7327,3682,3645
44,Teruel,26,Arcos de las Salinas,112,65,47
44,Teruel,27,Arens de Lledó,221,113,108
44,Teruel,28,Argente,199,98,101
44,Teruel,29,Ariño,685,350,335
44,Teruel,31,Azaila,100,52,48
44,Teruel,32,Bádenas,18,11,7
44,Teruel,33,Báguena,278,153,125
44,Teruel,34,Bañón,149,85,64
44,Teruel,35,Barrachina,113,60,53
44,Teruel,36,Bea,31,18,13
44,Teruel,37,Beceite,544,279,265
44,Teruel,39,Bello,224,112,112
44,Teruel,38,Belmonte de San José,123,59,64
44,Teruel,40,Berge,237,117,120
44,Teruel,41,Bezas,63,40,23
44,Teruel,42,Blancas,132,79,53
44,Teruel,43,Blesa,85,56,29
44,Teruel,44,Bordón,116,66,50
44,Teruel,45,Bronchales,424,240,184
44,Teruel,46,Bueña,52,28,24
44,Teruel,47,Burbáguena,207,116,91
44,Teruel,48,Cabra de Mora,68,44,24
44,Teruel,49,Calaceite,982,482,500
44,Teruel,50,Calamocha,4473,2216,2257
44,Teruel,51,Calanda,3753,1864,1889
44,Teruel,52,Calomarde,78,46,32
44,Teruel,53,Camañas,140,78,62
44,Teruel,54,Camarena de la Sierra,116,70,46
44,Teruel,55,Camarillas,82,50,32
44,Teruel,56,Caminreal,634,332,302
44,Teruel,59,Cantavieja,734,388,346
44,Teruel,60,Cañada de Benatanduz,34,22,12
44,Teruel,61,"Cañada de Verich, La",101,58,43
44,Teruel,62,Cañada Vellida,37,26,11
44,Teruel,63,Cañizar del Olivar,105,60,45
44,Teruel,64,Cascante del Río,69,41,28
44,Teruel,65,Castejón de Tornos,52,34,18
44,Teruel,66,Castel de Cabra,95,52,43
44,Teruel,70,"Castellar, El",56,38,18
44,Teruel,71,Castellote,687,349,338
44,Teruel,67,Castelnou,120,63,57
44,Teruel,68,Castelserás,789,416,373
44,Teruel,74,Cedrillas,609,298,311
44,Teruel,75,Celadas,374,213,161
44,Teruel,76,Cella,2578,1334,1244
44,Teruel,77,"Cerollera, La",84,52,32
44,Teruel,80,"Codoñera, La",317,167,150
44,Teruel,82,Corbalán,108,56,52
44,Teruel,84,Cortes de Aragón,63,28,35
44,Teruel,85,Cosa,55,36,19
44,Teruel,86,Cretas,555,284,271
44,Teruel,87,Crivillén,87,48,39
44,Teruel,88,"Cuba, La",42,25,17
44,Teruel,89,Cubla,52,35,17
44,Teruel,90,Cucalón,82,50,32
44,Teruel,92,"Cuervo, El",74,36,38
44,Teruel,93,Cuevas de Almudén,118,64,54
44,Teruel,94,Cuevas Labradas,137,73,64
44,Teruel,96,Ejulve,178,93,85
44,Teruel,97,Escorihuela,141,73,68
44,Teruel,99,Escucha,782,424,358
44,Teruel,100,Estercuel,209,115,94
44,Teruel,101,Ferreruela de Huerva,74,43,31
44,Teruel,102,Fonfría,29,18,11
44,Teruel,103,Formiche Alto,155,87,68
44,Teruel,105,Fórnoles,81,43,38
44,Teruel,106,Fortanete,200,116,84
44,Teruel,107,Foz-Calanda,271,135,136
44,Teruel,108,"Fresneda, La",457,251,206
44,Teruel,109,Frías de Albarracín,105,67,38
44,Teruel,110,Fuenferrada,40,25,15
44,Teruel,111,Fuentes Calientes,92,55,37
44,Teruel,112,Fuentes Claras,433,236,197
44,Teruel,113,Fuentes de Rubielos,154,83,71
44,Teruel,114,Fuentespalda,293,151,142
44,Teruel,115,Galve,163,83,80
44,Teruel,116,Gargallo,98,50,48
44,Teruel,117,Gea de Albarracín,378,208,170
44,Teruel,118,"Ginebrosa, La",201,111,90
44,Teruel,119,Griegos,138,86,52
44,Teruel,120,Guadalaviar,253,136,117
44,Teruel,121,Gúdar,79,43,36
44,Teruel,122,Híjar,1771,909,862
44,Teruel,123,Hinojosa de Jarque,110,62,48
44,Teruel,124,"Hoz de la Vieja, La",91,46,45
44,Teruel,125,Huesa del Común,73,45,28
44,Teruel,126,"Iglesuela del Cid, La",407,214,193
44,Teruel,127,Jabaloyas,61,38,23
44,Teruel,128,Jarque de la Val,60,31,29
44,Teruel,129,Jatiel,45,30,15
44,Teruel,130,Jorcas,34,19,15
44,Teruel,131,Josa,36,25,11
44,Teruel,132,Lagueruela,66,37,29
44,Teruel,133,Lanzuela,25,18,7
44,Teruel,135,Libros,104,63,41
44,Teruel,136,Lidón,54,30,24
44,Teruel,137,Linares de Mora,226,132,94
44,Teruel,141,Lledó,172,87,85
44,Teruel,138,Loscos,122,72,50
44,Teruel,142,Maicas,31,19,12
44,Teruel,143,Manzanera,527,293,234
44,Teruel,144,Martín del Río,372,174,198
44,Teruel,145,Mas de las Matas,1271,666,605
44,Teruel,146,"Mata de los Olmos, La",257,133,124
44,Teruel,147,Mazaleón,503,269,234
44,Teruel,148,Mezquita de Jarque,87,49,38
44,Teruel,149,Mirambel,111,67,44
44,Teruel,150,Miravete de la Sierra,38,28,10
44,Teruel,151,Molinos,238,126,112
44,Teruel,152,Monforte de Moyuela,71,49,22
44,Teruel,153,Monreal del Campo,2522,1256,1266
44,Teruel,154,Monroyo,318,182,136
44,Teruel,155,Montalbán,1237,629,608
44,Teruel,156,Monteagudo del Castillo,51,28,23
44,Teruel,157,Monterde de Albarracín,57,34,23
44,Teruel,158,Mora de Rubielos,1539,770,769
44,Teruel,159,Moscardón,53,29,24
44,Teruel,160,Mosqueruela,531,288,243
44,Teruel,161,Muniesa,571,306,265
44,Teruel,163,Noguera de Albarracín,142,80,62
44,Teruel,164,Nogueras,28,19,9
44,Teruel,165,Nogueruelas,207,120,87
44,Teruel,167,Obón,32,16,16
44,Teruel,168,Odón,218,111,107
44,Teruel,169,Ojos Negros,330,183,147
44,Teruel,171,Olba,264,140,124
44,Teruel,172,Oliete,340,181,159
44,Teruel,173,"Olmos, Los",118,64,54
44,Teruel,174,Orihuela del Tremedal,454,250,204
44,Teruel,175,Orrios,130,71,59
44,Teruel,176,Palomar de Arroyos,168,100,68
44,Teruel,177,Pancrudo,119,70,49
44,Teruel,178,"Parras de Castellote, Las",56,32,24
44,Teruel,179,Peñarroya de Tastavins,450,241,209
44,Teruel,180,Peracense,85,45,40
44,Teruel,181,Peralejos,85,47,38
44,Teruel,182,Perales del Alfambra,251,130,121
44,Teruel,183,Pitarque,69,36,33
44,Teruel,184,Plou,48,30,18
44,Teruel,185,"Pobo, El",112,73,39
44,Teruel,187,"Portellada, La",230,119,111
44,Teruel,189,Pozondón,47,28,19
44,Teruel,190,Pozuel del Campo,62,34,28
44,Teruel,191,"Puebla de Híjar, La",909,459,450
44,Teruel,192,"Puebla de Valverde, La",445,244,201
44,Teruel,193,Puertomingalvo,125,64,61
44,Teruel,194,Ráfales,144,86,58
44,Teruel,195,Rillo,92,56,36
44,Teruel,196,Riodeva,128,63,65
44,Teruel,197,Ródenas,61,34,27
44,Teruel,198,Royuela,212,115,97
44,Teruel,199,Rubiales,42,24,18
44,Teruel,200,Rubielos de la Cérida,37,23,14
44,Teruel,201,Rubielos de Mora,632,324,308
44,Teruel,203,Salcedillo,11,7,4
44,Teruel,204,Saldón,25,16,9
44,Teruel,205,Samper de Calanda,731,373,358
44,Teruel,206,San Agustín,138,85,53
44,Teruel,207,San Martín del Río,137,70,67
44,Teruel,208,Santa Cruz de Nogueras,30,13,17
44,Teruel,209,Santa Eulalia,1066,544,522
44,Teruel,210,Sarrión,1194,619,575
44,Teruel,211,Segura de los Baños,38,24,14
44,Teruel,212,Seno,44,20,24
44,Teruel,213,Singra,80,48,32
44,Teruel,215,Terriente,181,103,78
44,Teruel,216,Teruel,35994,17166,18828
44,Teruel,217,Toril y Masegoso,36,28,8
44,Teruel,218,Tormón,25,15,10
44,Teruel,219,Tornos,201,105,96
44,Teruel,220,Torralba de los Sisones,162,88,74
44,Teruel,223,Torre de Arcas,93,45,48
44,Teruel,224,Torre de las Arcas,25,15,10
44,Teruel,225,Torre del Compte,122,60,62
44,Teruel,227,Torre los Negros,82,44,38
44,Teruel,221,Torrecilla de Alcañiz,450,234,216
44,Teruel,222,Torrecilla del Rebollar,122,80,42
44,Teruel,226,Torrelacárcel,142,79,63
44,Teruel,228,Torremocha de Jiloca,108,58,50
44,Teruel,229,Torres de Albarracín,171,97,74
44,Teruel,230,Torrevelilla,180,91,89
44,Teruel,231,Torrijas,38,18,20
44,Teruel,232,Torrijo del Campo,470,244,226
44,Teruel,234,Tramacastiel,67,39,28
44,Teruel,235,Tramacastilla,105,51,54
44,Teruel,236,Tronchón,65,33,32
44,Teruel,237,Urrea de Gaén,435,224,211
44,Teruel,238,Utrillas,3003,1539,1464
44,Teruel,239,Valacloche,24,14,10
44,Teruel,240,Valbona,184,107,77
44,Teruel,241,Valdealgorfa,589,293,296
44,Teruel,243,Valdecuenca,29,17,12
44,Teruel,244,Valdelinares,82,51,31
44,Teruel,245,Valdeltormo,293,141,152
44,Teruel,246,Valderrobres,2457,1263,1194
44,Teruel,247,Valjunquera,342,176,166
44,Teruel,249,"Vallecillo, El",39,25,14
44,Teruel,250,Veguillas de la Sierra,21,13,8
44,Teruel,251,Villafranca del Campo,302,160,142
44,Teruel,252,Villahermosa del Campo,88,53,35
44,Teruel,256,Villanueva del Rebollar de la Sierra,42,26,16
44,Teruel,257,Villar del Cobo,163,97,66
44,Teruel,258,Villar del Salz,66,39,27
44,Teruel,260,Villarluengo,169,97,72
44,Teruel,261,Villarquemado,846,443,403
44,Teruel,262,Villarroya de los Pinares,175,92,83
44,Teruel,263,Villastar,548,272,276
44,Teruel,264,Villel,325,181,144
44,Teruel,265,Vinaceite,215,117,98
44,Teruel,266,Visiedo,124,60,64
44,Teruel,267,Vivel del Río Martín,75,41,34
44,Teruel,268,"Zoma, La",31,17,14
45,Toledo,1,Ajofrín,2236,1128,1108
45,Toledo,2,Alameda de la Sagra,3757,1960,1797
45,Toledo,3,Albarreal de Tajo,708,371,337
45,Toledo,4,Alcabón,678,344,334
45,Toledo,5,Alcañizo,274,139,135
45,Toledo,6,Alcaudete de la Jara,1644,832,812
45,Toledo,7,Alcolea de Tajo,843,422,421
45,Toledo,8,Aldea en Cabo,179,92,87
45,Toledo,9,Aldeanueva de Barbarroya,495,257,238
45,Toledo,10,Aldeanueva de San Bartolomé,413,210,203
45,Toledo,11,Almendral de la Cañada,327,170,157
45,Toledo,12,Almonacid de Toledo,843,414,429
45,Toledo,13,Almorox,2318,1218,1100
45,Toledo,14,Añover de Tajo,5202,2626,2576
45,Toledo,15,Arcicóllar,964,475,489
45,Toledo,16,Argés,6621,3307,3314
45,Toledo,17,Azután,303,152,151
45,Toledo,18,Barcience,940,515,425
45,Toledo,19,Bargas,10611,5313,5298
45,Toledo,20,Belvís de la Jara,1543,776,767
45,Toledo,21,Borox,3981,2088,1893
45,Toledo,22,Buenaventura,419,207,212
45,Toledo,23,Burguillos de Toledo,3390,1758,1632
45,Toledo,24,Burujón,1316,666,650
45,Toledo,25,Cabañas de la Sagra,1955,1018,937
45,Toledo,26,Cabañas de Yepes,301,156,145
45,Toledo,27,Cabezamesada,330,185,145
45,Toledo,28,Calera y Chozas,4641,2347,2294
45,Toledo,29,Caleruela,214,106,108
45,Toledo,30,Calzada de Oropesa,513,284,229
45,Toledo,31,Camarena,4243,2215,2028
45,Toledo,32,Camarenilla,588,300,288
45,Toledo,33,"Campillo de la Jara, El",356,188,168
45,Toledo,34,Camuñas,1726,894,832
45,Toledo,35,Cardiel de los Montes,380,208,172
45,Toledo,36,Carmena,780,389,391
45,Toledo,37,"Carpio de Tajo, El",1817,913,904
45,Toledo,38,Carranque,5022,2630,2392
45,Toledo,39,Carriches,278,143,135
45,Toledo,40,"Casar de Escalona, El",1791,959,832
45,Toledo,41,Casarrubios del Monte,6177,3233,2944
45,Toledo,42,Casasbuenas,182,92,90
45,Toledo,43,Castillo de Bayuela,918,463,455
45,Toledo,45,Cazalegas,1854,956,898
45,Toledo,46,Cebolla,3204,1587,1617
45,Toledo,47,Cedillo del Condado,4025,2078,1947
45,Toledo,48,"Cerralbos, Los",418,229,189
45,Toledo,49,Cervera de los Montes,504,260,244
45,Toledo,56,Chozas de Canales,4335,2246,2089
45,Toledo,57,Chueca,253,127,126
45,Toledo,50,Ciruelos,616,333,283
45,Toledo,51,Cobeja,2412,1261,1151
45,Toledo,52,Cobisa,4377,2187,2190
45,Toledo,53,Consuegra,9942,5052,4890
45,Toledo,54,Corral de Almaguer,5068,2624,2444
45,Toledo,55,Cuerva,1277,661,616
45,Toledo,58,Domingo Pérez,325,164,161
45,Toledo,59,Dosbarrios,2263,1166,1097
45,Toledo,60,Erustes,191,98,93
45,Toledo,61,Escalona,3441,1781,1660
45,Toledo,62,Escalonilla,1397,690,707
45,Toledo,63,Espinoso del Rey,435,252,183
45,Toledo,64,Esquivias,5747,2919,2828
45,Toledo,65,"Estrella, La",205,109,96
45,Toledo,66,Fuensalida,11785,5961,5824
45,Toledo,67,Gálvez,3015,1519,1496
45,Toledo,68,Garciotum,206,109,97
45,Toledo,69,Gerindote,2395,1203,1192
45,Toledo,70,Guadamur,1806,902,904
45,Toledo,71,"Guardia, La",2226,1131,1095
45,Toledo,72,"Herencias, Las",742,402,340
45,Toledo,73,Herreruela de Oropesa,306,157,149
45,Toledo,74,Hinojosa de San Vicente,411,228,183
45,Toledo,75,Hontanar,137,82,55
45,Toledo,76,Hormigos,806,454,352
45,Toledo,77,Huecas,773,399,374
45,Toledo,78,Huerta de Valdecarábanos,1683,842,841
45,Toledo,79,"Iglesuela del Tiétar, La",461,249,212
45,Toledo,80,Illán de Vacas,3,3,0
45,Toledo,81,Illescas,30229,15247,14982
45,Toledo,82,Lagartera,1331,669,662
45,Toledo,83,Layos,810,397,413
45,Toledo,84,Lillo,2574,1338,1236
45,Toledo,85,Lominchar,2527,1328,1199
45,Toledo,86,Lucillos,591,314,277
45,Toledo,87,Madridejos,10230,5090,5140
45,Toledo,88,Magán,3894,1970,1924
45,Toledo,89,Malpica de Tajo,1709,880,829
45,Toledo,90,Manzaneque,376,184,192
45,Toledo,91,Maqueda,451,227,224
45,Toledo,92,Marjaliza,263,136,127
45,Toledo,93,Marrupe,154,79,75
45,Toledo,94,Mascaraque,413,208,205
45,Toledo,95,"Mata, La",823,408,415
45,Toledo,96,Mazarambroz,1258,650,608
45,Toledo,97,Mejorada,1293,667,626
45,Toledo,98,Menasalbas,2544,1327,1217
45,Toledo,99,Méntrida,5662,2900,2762
45,Toledo,100,Mesegar de Tajo,206,111,95
45,Toledo,101,Miguel Esteban,4809,2410,2399
45,Toledo,102,Mocejón,5009,2512,2497
45,Toledo,103,Mohedas de la Jara,399,218,181
45,Toledo,104,Montearagón,522,273,249
45,Toledo,105,Montesclaros,389,203,186
45,Toledo,106,Mora,9781,4902,4879
45,Toledo,107,Nambroca,4954,2530,2424
45,Toledo,108,"Nava de Ricomalillo, La",521,276,245
45,Toledo,109,Navahermosa,3600,1878,1722
45,Toledo,110,Navalcán,1925,1002,923
45,Toledo,111,Navalmoralejo,56,30,26
45,Toledo,112,"Navalmorales, Los",2202,1125,1077
45,Toledo,113,"Navalucillos, Los",2011,1026,985
45,Toledo,114,Navamorcuende,611,309,302
45,Toledo,115,Noblejas,3721,1874,1847
45,Toledo,116,Noez,879,437,442
45,Toledo,117,Nombela,877,462,415
45,Toledo,118,Novés,3179,1628,1551
45,Toledo,119,Numancia de la Sagra,5170,2706,2464
45,Toledo,120,Nuño Gómez,137,79,58
45,Toledo,121,Ocaña,13023,6564,6459
45,Toledo,122,Olías del Rey,8225,4179,4046
45,Toledo,123,Ontígola,4743,2523,2220
45,Toledo,124,Orgaz,2625,1311,1314
45,Toledo,125,Oropesa,2626,1260,1366
45,Toledo,126,Otero,310,167,143
45,Toledo,127,Palomeque,1081,582,499
45,Toledo,128,Pantoja,3408,1713,1695
45,Toledo,129,Paredes de Escalona,110,58,52
45,Toledo,130,Parrillas,325,171,154
45,Toledo,131,Pelahustán,345,191,154
45,Toledo,132,Pepino,3060,1570,1490
45,Toledo,133,Polán,3908,1961,1947
45,Toledo,134,Portillo de Toledo,2223,1137,1086
45,Toledo,135,"Puebla de Almoradiel, La",5041,2562,2479
45,Toledo,136,"Puebla de Montalbán, La",7841,3965,3876
45,Toledo,137,"Pueblanueva, La",2169,1103,1066
45,Toledo,138,"Puente del Arzobispo, El",1190,593,597
45,Toledo,139,Puerto de San Vicente,145,80,65
45,Toledo,140,Pulgar,1484,755,729
45,Toledo,141,Quero,977,498,479
45,Toledo,142,Quintanar de la Orden,11129,5538,5591
45,Toledo,143,Quismondo,1633,827,806
45,Toledo,144,"Real de San Vicente, El",956,512,444
45,Toledo,145,Recas,4536,2487,2049
45,Toledo,146,Retamoso de la Jara,97,53,44
45,Toledo,147,Rielves,768,388,380
45,Toledo,148,Robledo del Mazo,260,144,116
45,Toledo,149,"Romeral, El",568,282,286
45,Toledo,150,San Bartolomé de las Abiertas,427,223,204
45,Toledo,151,San Martín de Montalbán,725,366,359
45,Toledo,152,San Martín de Pusa,610,325,285
45,Toledo,153,San Pablo de los Montes,1723,864,859
45,Toledo,154,San Román de los Montes,1969,1023,946
45,Toledo,155,Santa Ana de Pusa,346,198,148
45,Toledo,156,Santa Cruz de la Zarza,4085,2081,2004
45,Toledo,157,Santa Cruz del Retamar,3554,1856,1698
45,Toledo,158,Santa Olalla,3391,1729,1662
45,Toledo,901,Santo Domingo-Caudilla,1094,577,517
45,Toledo,159,Sartajada,97,60,37
45,Toledo,160,Segurilla,1346,680,666
45,Toledo,161,Seseña,27466,14116,13350
45,Toledo,162,Sevilleja de la Jara,640,356,284
45,Toledo,163,Sonseca,11070,5614,5456
45,Toledo,164,Sotillo de las Palomas,191,100,91
45,Toledo,165,Talavera de la Reina,83477,40020,43457
45,Toledo,166,Tembleque,1967,993,974
45,Toledo,167,"Toboso, El",1699,853,846
45,Toledo,168,Toledo,85449,40753,44696
45,Toledo,169,Torralba de Oropesa,188,101,87
45,Toledo,171,"Torre de Esteban Hambrán, La",1693,848,845
45,Toledo,170,Torrecilla de la Jara,212,117,95
45,Toledo,172,Torrico,696,352,344
45,Toledo,173,Torrijos,13583,6637,6946
45,Toledo,174,Totanés,346,176,170
45,Toledo,175,Turleque,736,369,367
45,Toledo,176,Ugena,5626,2889,2737
45,Toledo,177,Urda,2420,1207,1213
45,Toledo,179,Valdeverdeja,547,271,276
45,Toledo,180,Valmojado,4430,2237,2193
45,Toledo,181,Velada,2905,1492,1413
45,Toledo,182,"Ventas con Peña Aguilera, Las",1084,546,538
45,Toledo,183,"Ventas de Retamosa, Las",3684,1929,1755
45,Toledo,184,"Ventas de San Julián, Las",233,110,123
45,Toledo,186,"Villa de Don Fadrique, La",3576,1774,1802
45,Toledo,185,Villacañas,9434,4705,4729
45,Toledo,187,Villafranca de los Caballeros,4866,2435,2431
45,Toledo,188,Villaluenga de la Sagra,4034,2022,2012
45,Toledo,189,Villamiel de Toledo,997,515,482
45,Toledo,190,Villaminaya,513,257,256
45,Toledo,191,Villamuelas,613,322,291
45,Toledo,192,Villanueva de Alcardete,3130,1619,1511
45,Toledo,193,Villanueva de Bogas,694,361,333
45,Toledo,194,Villarejo de Montalbán,73,40,33
45,Toledo,195,Villarrubia de Santiago,2508,1265,1243
45,Toledo,196,Villaseca de la Sagra,1858,941,917
45,Toledo,197,Villasequilla,2593,1326,1267
45,Toledo,198,Villatobas,2570,1325,1245
45,Toledo,199,"Viso de San Juan, El",5255,2793,2462
45,Toledo,200,"Yébenes, Los",5796,2969,2827
45,Toledo,201,Yeles,5779,3025,2754
45,Toledo,202,Yepes,5302,2710,2592
45,Toledo,203,Yuncler,4344,2244,2100
45,Toledo,204,Yunclillos,789,417,372
45,Toledo,205,Yuncos,10813,5517,5296
46,Valencia/València,1,Ademuz,1027,556,471
46,Valencia/València,2,Ador,1772,931,841
46,Valencia/València,4,Agullent,2369,1184,1185
46,Valencia/València,42,Aielo de Malferit,4592,2320,2272
46,Valencia/València,43,Aielo de Rugat,160,88,72
46,Valencia/València,5,Alaquàs,29649,14501,15148
46,Valencia/València,6,Albaida,5975,2962,3013
46,Valencia/València,7,Albal,16646,8319,8327
46,Valencia/València,8,Albalat de la Ribera,3368,1701,1667
46,Valencia/València,9,Albalat dels Sorells,4110,2014,2096
46,Valencia/València,10,Albalat dels Tarongers,1324,699,625
46,Valencia/València,11,Alberic,10571,5258,5313
46,Valencia/València,12,Alborache,1283,660,623
46,Valencia/València,13,Alboraia/Alboraya,24904,12182,12722
46,Valencia/València,14,Albuixech,4189,2030,2159
46,Valencia/València,16,Alcàntera de Xúquer,1402,701,701
46,Valencia/València,15,Alcàsser,10266,5145,5121
46,Valencia/València,18,Alcublas,610,328,282
46,Valencia/València,20,"Alcúdia de Crespins, l'",5144,2546,2598
46,Valencia/València,19,"Alcúdia, l'",12193,5966,6227
46,Valencia/València,21,Aldaia,32313,16121,16192
46,Valencia/València,22,Alfafar,21415,10498,10917
46,Valencia/València,24,Alfara de la Baronia,590,289,301
46,Valencia/València,25,Alfara del Patriarca,3301,1576,1725
46,Valencia/València,26,Alfarp,1564,799,765
46,Valencia/València,27,Alfarrasí,1206,599,607
46,Valencia/València,23,Alfauir,467,244,223
46,Valencia/València,28,Algar de Palancia,499,254,245
46,Valencia/València,29,Algemesí,27305,13532,13773
46,Valencia/València,30,Algímia d'Alfara,1079,535,544
46,Valencia/València,31,Alginet,13942,7056,6886
46,Valencia/València,32,Almàssera,7433,3619,3814
46,Valencia/València,33,Almiserà,264,136,128
46,Valencia/València,34,Almoines,2528,1263,1265
46,Valencia/València,35,Almussafes,8984,4493,4491
46,Valencia/València,36,Alpuente,659,359,300
46,Valencia/València,37,"Alqueria de la Comtessa, l'",1481,715,766
46,Valencia/València,17,Alzira,44865,21930,22935
46,Valencia/València,38,Andilla,315,200,115
46,Valencia/València,39,Anna,2627,1327,1300
46,Valencia/València,40,Antella,1127,542,585
46,Valencia/València,41,Aras de los Olmos,374,215,159
46,Valencia/València,3,Atzeneta d'Albaida,1139,575,564
46,Valencia/València,44,Ayora,5215,2582,2633
46,Valencia/València,46,Barx,1354,703,651
46,Valencia/València,45,Barxeta,1604,821,783
46,Valencia/València,47,Bèlgida,654,320,334
46,Valencia/València,48,Bellreguard,4632,2298,2334
46,Valencia/València,49,Bellús,311,161,150
46,Valencia/València,50,Benagéber,184,103,81
46,Valencia/València,51,Benaguasil,11369,5831,5538
46,Valencia/València,52,Benavites,653,314,339
46,Valencia/València,53,Beneixida,639,307,332
46,Valencia/València,54,Benetússer,15430,7511,7919
46,Valencia/València,55,Beniarjó,1780,891,889
46,Valencia/València,56,Beniatjar,207,113,94
46,Valencia/València,57,Benicolet,587,284,303
46,Valencia/València,904,Benicull de Xúquer,1095,561,534
46,Valencia/València,60,Benifaió,11967,5918,6049
46,Valencia/València,59,Benifairó de la Valldigna,1542,772,770
46,Valencia/València,58,Benifairó de les Valls,2268,1119,1149
46,Valencia/València,61,Beniflá,463,229,234
46,Valencia/València,62,Benigànim,5742,2917,2825
46,Valencia/València,63,Benimodo,2253,1146,1107
46,Valencia/València,64,Benimuslem,653,348,305
46,Valencia/València,65,Beniparrell,2024,1025,999
46,Valencia/València,66,Benirredrà,1547,743,804
46,Valencia/València,67,Benissanó,2334,1154,1180
46,Valencia/València,68,Benissoda,441,243,198
46,Valencia/València,69,Benissuera,183,86,97
46,Valencia/València,70,Bétera,25423,12655,12768
46,Valencia/València,71,Bicorp,527,249,278
46,Valencia/València,72,Bocairent,4101,2068,2033
46,Valencia/València,73,Bolbaite,1336,674,662
46,Valencia/València,74,Bonrepòs i Mirambell,3780,1852,1928
46,Valencia/València,75,Bufali,163,90,73
46,Valencia/València,76,Bugarra,728,368,360
46,Valencia/València,77,Buñol,9438,4719,4719
46,Valencia/València,78,Burjassot,38712,18672,20040
46,Valencia/València,79,Calles,368,212,156
46,Valencia/València,80,Camporrobles,1204,616,588
46,Valencia/València,81,Canals,13257,6636,6621
46,Valencia/València,82,Canet d'En Berenguer,6812,3468,3344
46,Valencia/València,83,Carcaixent,20494,10163,10331
46,Valencia/València,84,Càrcer,1822,873,949
46,Valencia/València,85,Carlet,15851,7947,7904
46,Valencia/València,86,Carrícola,102,49,53
46,Valencia/València,87,Casas Altas,132,70,62
46,Valencia/València,88,Casas Bajas,164,87,77
46,Valencia/València,89,Casinos,2881,1475,1406
46,Valencia/València,257,Castelló,6996,3435,3561
46,Valencia/València,90,Castelló de Rugat,2316,1185,1131
46,Valencia/València,91,Castellonet de la Conquesta,139,76,63
46,Valencia/València,92,Castielfabib,299,160,139
46,Valencia/València,93,Catadau,2846,1431,1415
46,Valencia/València,94,Catarroja,28509,14086,14423
46,Valencia/València,95,Caudete de las Fuentes,701,365,336
46,Valencia/València,96,Cerdà,345,181,164
46,Valencia/València,107,Chella,2437,1209,1228
46,Valencia/València,106,Chelva,1583,805,778
46,Valencia/València,108,Chera,490,264,226
46,Valencia/València,109,Cheste,8871,4545,4326
46,Valencia/València,111,Chiva,15769,8063,7706
46,Valencia/València,112,Chulilla,700,375,325
46,Valencia/València,97,Cofrentes,1122,565,557
46,Valencia/València,98,Corbera,3088,1545,1543
46,Valencia/València,99,Cortes de Pallás,758,423,335
46,Valencia/València,100,Cotes,326,164,162
46,Valencia/València,105,Cullera,22708,11428,11280
46,Valencia/València,113,Daimús,3277,1623,1654
46,Valencia/València,114,Domeño,670,330,340
46,Valencia/València,115,Dos Aguas,312,177,135
46,Valencia/València,116,"Eliana, l'",18302,8975,9327
46,Valencia/València,117,Emperador,698,357,341
46,Valencia/València,118,Enguera,4779,2398,2381
46,Valencia/València,119,"Ènova, l'",912,471,441
46,Valencia/València,120,Estivella,1491,726,765
46,Valencia/València,121,Estubeny,114,56,58
46,Valencia/València,122,Faura,3563,1786,1777
46,Valencia/València,123,Favara,2563,1310,1253
46,Valencia/València,126,Foios,7502,3698,3804
46,Valencia/València,128,"Font de la Figuera, la",2025,1028,997
46,Valencia/València,127,"Font d'En Carròs, la",3793,1891,1902
46,Valencia/València,124,Fontanars dels Alforins,959,499,460
46,Valencia/València,125,Fortaleny,1011,501,510
46,Valencia/València,129,Fuenterrobles,694,385,309
46,Valencia/València,131,Gandia,75970,37304,38666
46,Valencia/València,902,Gátova,419,209,210
46,Valencia/València,130,Gavarda,1035,499,536
46,Valencia/València,132,"Genovés, el",2785,1406,1379
46,Valencia/València,133,Gestalgar,541,292,249
46,Valencia/València,134,Gilet,3501,1808,1693
46,Valencia/València,135,Godella,13027,6270,6757
46,Valencia/València,136,Godelleta,3714,1912,1802
46,Valencia/València,137,"Granja de la Costera, la",281,143,138
46,Valencia/València,138,Guadasséquies,459,229,230
46,Valencia/València,139,Guadassuar,5938,2886,3052
46,Valencia/València,140,Guardamar de la Safor,547,285,262
46,Valencia/València,141,Higueruelas,524,275,249
46,Valencia/València,142,Jalance,795,417,378
46,Valencia/València,144,Jarafuel,772,409,363
46,Valencia/València,154,Llanera de Ranes,1056,548,508
46,Valencia/València,155,Llaurí,1169,597,572
46,Valencia/València,147,Llíria,23648,11910,11738
46,Valencia/València,152,Llocnou de la Corona,124,69,55
46,Valencia/València,153,Llocnou de Sant Jeroni,557,283,274
46,Valencia/València,151,Llocnou d'En Fenollet,912,475,437
46,Valencia/València,156,Llombai,2651,1324,1327
46,Valencia/València,157,"Llosa de Ranes, la",3687,1884,1803
46,Valencia/València,150,Llutxent,2315,1195,1120
46,Valencia/València,148,Loriguilla,2027,1050,977
46,Valencia/València,149,Losa del Obispo,531,265,266
46,Valencia/València,158,Macastre,1338,713,625
46,Valencia/València,159,Manises,31287,15467,15820
46,Valencia/València,160,Manuel,2452,1209,1243
46,Valencia/València,161,Marines,1894,991,903
46,Valencia/València,162,Massalavés,1632,842,790
46,Valencia/València,163,Massalfassar,2574,1284,1290
46,Valencia/València,164,Massamagrell,16132,7985,8147
46,Valencia/València,165,Massanassa,9845,4833,5012
46,Valencia/València,166,Meliana,10926,5377,5549
46,Valencia/València,167,Millares,341,171,170
46,Valencia/València,168,Miramar,2740,1381,1359
46,Valencia/València,169,Mislata,44320,21468,22852
46,Valencia/València,170,Mogente/Moixent,4326,2171,2155
46,Valencia/València,171,Moncada,21875,10672,11203
46,Valencia/València,173,Montaverner,1630,801,829
46,Valencia/València,174,Montesa,1149,581,568
46,Valencia/València,175,Montitxelvo/Montichelvo,588,294,294
46,Valencia/València,176,Montroi/Montroy,3069,1640,1429
46,Valencia/València,172,Montserrat,8655,4476,4179
46,Valencia/València,177,Museros,6618,3409,3209
46,Valencia/València,178,Nàquera/Náquera,7301,3777,3524
46,Valencia/València,179,Navarrés,3004,1495,1509
46,Valencia/València,180,Novelé/Novetlè,853,417,436
46,Valencia/València,181,Oliva,25119,12330,12789
46,Valencia/València,183,"Olleria, l'",8404,4210,4194
46,Valencia/València,182,Olocau,2028,1078,950
46,Valencia/València,184,Ontinyent,35946,17743,18203
46,Valencia/València,185,Otos,428,215,213
46,Valencia/València,186,Paiporta,26401,13016,13385
46,Valencia/València,187,Palma de Gandía,1660,870,790
46,Valencia/València,188,Palmera,1024,516,508
46,Valencia/València,189,"Palomar, el",562,283,279
46,Valencia/València,190,Paterna,71361,35252,36109
46,Valencia/València,191,Pedralba,2852,1511,1341
46,Valencia/València,192,Petrés,1012,507,505
46,Valencia/València,193,Picanya,11692,5774,5918
46,Valencia/València,194,Picassent,21487,10810,10677
46,Valencia/València,195,Piles,2742,1370,1372
46,Valencia/València,196,Pinet,161,78,83
46,Valencia/València,199,"Pobla de Farnals, la",8205,4126,4079
46,Valencia/València,202,"Pobla de Vallbona, la",25275,12763,12512
46,Valencia/València,200,"Pobla del Duc, la",2483,1191,1292
46,Valencia/València,203,"Pobla Llarga, la",4440,2228,2212
46,Valencia/València,197,Polinyà de Xúquer,2495,1283,1212
46,Valencia/València,198,Potries,1065,547,518
46,Valencia/València,205,Puçol,19975,9839,10136
46,Valencia/València,201,Puebla de San Miguel,60,38,22
46,Valencia/València,204,"Puig de Santa Maria, el",8737,4249,4488
46,Valencia/València,101,Quart de les Valls,1050,500,550
46,Valencia/València,102,Quart de Poblet,25035,12181,12854
46,Valencia/València,103,Quartell,1640,786,854
46,Valencia/València,104,Quatretonda,2146,1069,1077
46,Valencia/València,206,Quesa,669,344,325
46,Valencia/València,207,Rafelbunyol,9351,4594,4757
46,Valencia/València,208,Rafelcofer,1365,664,701
46,Valencia/València,209,Rafelguaraf,2358,1169,1189
46,Valencia/València,210,Ráfol de Salem,449,220,229
46,Valencia/València,212,Real,2250,1165,1085
46,Valencia/València,211,"Real de Gandia, el",2551,1285,1266
46,Valencia/València,213,Requena,20235,10085,10150
46,Valencia/València,214,Riba-roja de Túria,22799,11553,11246
46,Valencia/València,215,Riola,1780,896,884
46,Valencia/València,216,Rocafort,7445,3638,3807
46,Valencia/València,217,Rotglà i Corberà,1146,568,578
46,Valencia/València,218,Ròtova,1271,645,626
46,Valencia/València,219,Rugat,180,99,81
46,Valencia/València,220,Sagunto/Sagunt,67043,32822,34221
46,Valencia/València,221,Salem,414,212,202
46,Valencia/València,903,San Antonio de Benagéber,9501,4680,4821
46,Valencia/València,222,Sant Joanet,519,263,256
46,Valencia/València,223,Sedaví,10344,5034,5310
46,Valencia/València,224,Segart,177,92,85
46,Valencia/València,225,Sellent,377,192,185
46,Valencia/València,226,Sempere,26,14,12
46,Valencia/València,227,Senyera,1132,553,579
46,Valencia/València,228,Serra,3326,1705,1621
46,Valencia/València,229,Siete Aguas,1183,617,566
46,Valencia/València,230,Silla,19211,9565,9646
46,Valencia/València,231,Simat de la Valldigna,3286,1635,1651
46,Valencia/València,232,Sinarcas,1109,589,520
46,Valencia/València,233,Sollana,4911,2403,2508
46,Valencia/València,234,Sot de Chera,387,214,173
46,Valencia/València,235,Sueca,27617,13590,14027
46,Valencia/València,236,Sumacàrcer,1072,527,545
46,Valencia/València,237,Tavernes Blanques,9205,4480,4725
46,Valencia/València,238,Tavernes de la Valldigna,17162,8524,8638
46,Valencia/València,239,Teresa de Cofrentes,618,326,292
46,Valencia/València,240,Terrateig,276,144,132
46,Valencia/València,241,Titaguas,470,249,221
46,Valencia/València,242,Torrebaja,403,219,184
46,Valencia/València,243,Torrella,135,75,60
46,Valencia/València,244,Torrent,84025,41389,42636
46,Valencia/València,245,Torres Torres,672,364,308
46,Valencia/València,246,Tous,1284,645,639
46,Valencia/València,247,Tuéjar,1164,615,549
46,Valencia/València,248,Turís,6910,3619,3291
46,Valencia/València,249,Utiel,11478,5712,5766
46,Valencia/València,250,València,789744,374937,414807
46,Valencia/València,251,Vallada,3092,1568,1524
46,Valencia/València,252,Vallanca,136,77,59
46,Valencia/València,253,Vallés,152,81,71
46,Valencia/València,254,Venta del Moro,1194,634,560
46,Valencia/València,255,Vilallonga/Villalonga,4453,2191,2262
46,Valencia/València,256,Vilamarxant,10097,5213,4884
46,Valencia/València,258,Villar del Arzobispo,3578,1811,1767
46,Valencia/València,259,Villargordo del Cabriel,585,296,289
46,Valencia/València,260,Vinalesa,3451,1674,1777
46,Valencia/València,145,Xàtiva,29459,14372,15087
46,Valencia/València,143,Xeraco,5771,2902,2869
46,Valencia/València,146,Xeresa,2256,1155,1101
46,Valencia/València,110,Xirivella,30208,14953,15255
46,Valencia/València,261,Yátova,2112,1094,1018
46,Valencia/València,262,"Yesa, La",230,125,105
46,Valencia/València,263,Zarra,364,197,167
47,Valladolid,1,Adalia,52,30,22
47,Valladolid,2,Aguasal,17,11,6
47,Valladolid,3,Aguilar de Campos,257,150,107
47,Valladolid,4,Alaejos,1380,740,640
47,Valladolid,5,Alcazarén,632,338,294
47,Valladolid,6,Aldea de San Miguel,217,123,94
47,Valladolid,7,Aldeamayor de San Martín,5789,3001,2788
47,Valladolid,8,Almenara de Adaja,23,12,11
47,Valladolid,9,Amusquillo,100,61,39
47,Valladolid,10,Arroyo de la Encomienda,20716,10377,10339
47,Valladolid,11,Ataquines,564,309,255
47,Valladolid,12,Bahabón,98,47,51
47,Valladolid,13,Barcial de la Loma,86,48,38
47,Valladolid,14,Barruelo del Valle,47,29,18
47,Valladolid,15,Becilla de Valderaduey,218,122,96
47,Valladolid,16,Benafarces,68,35,33
47,Valladolid,17,Bercero,195,110,85
47,Valladolid,18,Berceruelo,38,23,15
47,Valladolid,19,Berrueces,102,54,48
47,Valladolid,20,Bobadilla del Campo,292,165,127
47,Valladolid,21,Bocigas,80,47,33
47,Valladolid,22,Bocos de Duero,69,32,37
47,Valladolid,23,Boecillo,4219,2147,2072
47,Valladolid,24,Bolaños de Campos,277,159,118
47,Valladolid,25,Brahojos de Medina,106,55,51
47,Valladolid,26,Bustillo de Chaves,63,36,27
47,Valladolid,27,Cabezón de Pisuerga,3747,1907,1840
47,Valladolid,28,Cabezón de Valderaduey,41,24,17
47,Valladolid,29,Cabreros del Monte,63,33,30
47,Valladolid,30,Campaspero,1047,584,463
47,Valladolid,31,"Campillo, El",219,126,93
47,Valladolid,32,Camporredondo,153,90,63
47,Valladolid,33,Canalejas de Peñafiel,241,136,105
47,Valladolid,34,Canillas de Esgueva,78,45,33
47,Valladolid,35,Carpio,965,518,447
47,Valladolid,36,Casasola de Arión,235,134,101
47,Valladolid,37,Castrejón de Trabancos,170,85,85
47,Valladolid,38,Castrillo de Duero,103,59,44
47,Valladolid,39,Castrillo-Tejeriego,162,89,73
47,Valladolid,40,Castrobol,54,29,25
47,Valladolid,41,Castrodeza,151,91,60
47,Valladolid,42,Castromembibre,53,38,15
47,Valladolid,43,Castromonte,314,169,145
47,Valladolid,44,Castronuevo de Esgueva,379,204,175
47,Valladolid,45,Castronuño,825,411,414
47,Valladolid,46,Castroponce,148,77,71
47,Valladolid,47,Castroverde de Cerrato,196,126,70
47,Valladolid,48,Ceinos de Campos,209,117,92
47,Valladolid,49,Cervillego de la Cruz,83,51,32
47,Valladolid,50,Cigales,5299,2695,2604
47,Valladolid,51,Ciguñuela,375,195,180
47,Valladolid,52,Cistérniga,9109,4604,4505
47,Valladolid,53,Cogeces de Íscar,142,70,72
47,Valladolid,54,Cogeces del Monte,637,339,298
47,Valladolid,55,Corcos,203,114,89
47,Valladolid,56,Corrales de Duero,109,63,46
47,Valladolid,57,Cubillas de Santa Marta,352,202,150
47,Valladolid,58,Cuenca de Campos,208,108,100
47,Valladolid,59,Curiel de Duero,118,77,41
47,Valladolid,60,Encinas de Esgueva,221,126,95
47,Valladolid,61,Esguevillas de Esgueva,269,148,121
47,Valladolid,62,Fombellida,166,94,72
47,Valladolid,63,Fompedraza,103,55,48
47,Valladolid,64,Fontihoyuelo,36,20,16
47,Valladolid,65,Fresno el Viejo,848,457,391
47,Valladolid,66,Fuensaldaña,1996,1027,969
47,Valladolid,67,Fuente el Sol,148,78,70
47,Valladolid,68,Fuente-Olmedo,34,17,17
47,Valladolid,69,Gallegos de Hornija,111,56,55
47,Valladolid,70,Gatón de Campos,27,15,12
47,Valladolid,71,Geria,512,239,273
47,Valladolid,73,Herrín de Campos,119,64,55
47,Valladolid,74,Hornillos de Eresma,174,95,79
47,Valladolid,75,Íscar,6298,3164,3134
47,Valladolid,76,Laguna de Duero,22633,11260,11373
47,Valladolid,77,Langayo,242,152,90
47,Valladolid,79,Llano de Olmedo,59,30,29
47,Valladolid,78,Lomoviejo,178,97,81
47,Valladolid,80,Manzanillo,49,26,23
47,Valladolid,81,Marzales,43,20,23
47,Valladolid,82,Matapozuelos,1039,522,517
47,Valladolid,83,Matilla de los Caños,94,48,46
47,Valladolid,84,Mayorga,1471,731,740
47,Valladolid,86,Medina de Rioseco,4550,2235,2315
47,Valladolid,85,Medina del Campo,20271,9862,10409
47,Valladolid,87,Megeces,433,232,201
47,Valladolid,88,Melgar de Abajo,120,64,56
47,Valladolid,89,Melgar de Arriba,153,85,68
47,Valladolid,90,Mojados,3311,1733,1578
47,Valladolid,91,Monasterio de Vega,79,43,36
47,Valladolid,92,Montealegre de Campos,103,60,43
47,Valladolid,93,Montemayor de Pililla,852,463,389
47,Valladolid,94,Moral de la Reina,150,83,67
47,Valladolid,95,Moraleja de las Panaderas,47,25,22
47,Valladolid,96,Morales de Campos,141,73,68
47,Valladolid,97,Mota del Marqués,349,189,160
47,Valladolid,98,Mucientes,642,322,320
47,Valladolid,99,"Mudarra, La",156,80,76
47,Valladolid,100,Muriel,117,60,57
47,Valladolid,101,Nava del Rey,1968,1016,952
47,Valladolid,102,Nueva Villa de las Torres,276,161,115
47,Valladolid,103,Olivares de Duero,313,180,133
47,Valladolid,104,Olmedo,3574,1778,1796
47,Valladolid,105,Olmos de Esgueva,185,101,84
47,Valladolid,106,Olmos de Peñafiel,53,30,23
47,Valladolid,109,Palazuelo de Vedija,174,88,86
47,Valladolid,110,"Parrilla, La",482,242,240
47,Valladolid,111,"Pedraja de Portillo, La",1122,577,545
47,Valladolid,112,Pedrajas de San Esteban,3334,1694,1640
47,Valladolid,113,Pedrosa del Rey,155,84,71
47,Valladolid,114,Peñafiel,5068,2560,2508
47,Valladolid,115,Peñaflor de Hornija,330,179,151
47,Valladolid,116,Pesquera de Duero,434,234,200
47,Valladolid,117,Piña de Esgueva,318,165,153
47,Valladolid,118,Piñel de Abajo,172,97,75
47,Valladolid,119,Piñel de Arriba,92,49,43
47,Valladolid,121,Pollos,611,343,268
47,Valladolid,122,Portillo,2383,1232,1151
47,Valladolid,123,Pozal de Gallinas,537,296,241
47,Valladolid,124,Pozaldez,473,251,222
47,Valladolid,125,Pozuelo de la Orden,45,27,18
47,Valladolid,126,Puras,42,23,19
47,Valladolid,127,Quintanilla de Arriba,160,89,71
47,Valladolid,129,Quintanilla de Onésimo,1031,550,481
47,Valladolid,130,Quintanilla de Trigueros,105,50,55
47,Valladolid,128,Quintanilla del Molar,57,28,29
47,Valladolid,131,Rábano,169,89,80
47,Valladolid,132,Ramiro,49,27,22
47,Valladolid,133,Renedo de Esgueva,3875,1984,1891
47,Valladolid,134,Roales de Campos,160,88,72
47,Valladolid,135,Robladillo,89,52,37
47,Valladolid,137,Roturas,29,18,11
47,Valladolid,138,Rubí de Bracamonte,215,123,92
47,Valladolid,139,Rueda,1204,632,572
47,Valladolid,140,Saelices de Mayorga,113,69,44
47,Valladolid,141,Salvador de Zapardiel,110,64,46
47,Valladolid,142,San Cebrián de Mazote,122,71,51
47,Valladolid,143,San Llorente,110,63,47
47,Valladolid,144,San Martín de Valvení,80,43,37
47,Valladolid,145,San Miguel del Arroyo,658,351,307
47,Valladolid,146,San Miguel del Pino,350,180,170
47,Valladolid,147,San Pablo de la Moraleja,108,59,49
47,Valladolid,148,San Pedro de Latarce,461,248,213
47,Valladolid,149,San Pelayo,48,23,25
47,Valladolid,150,San Román de Hornija,303,141,162
47,Valladolid,151,San Salvador,24,14,10
47,Valladolid,156,San Vicente del Palacio,160,86,74
47,Valladolid,152,Santa Eufemia del Arroyo,71,38,33
47,Valladolid,153,Santervás de Campos,110,62,48
47,Valladolid,154,Santibáñez de Valcorba,181,105,76
47,Valladolid,155,Santovenia de Pisuerga,4604,2353,2251
47,Valladolid,157,Sardón de Duero,602,319,283
47,Valladolid,158,"Seca, La",1066,556,510
47,Valladolid,159,Serrada,1111,576,535
47,Valladolid,160,Siete Iglesias de Trabancos,427,228,199
47,Valladolid,161,Simancas,5315,2707,2608
47,Valladolid,162,Tamariz de Campos,68,41,27
47,Valladolid,163,Tiedra,285,140,145
47,Valladolid,164,Tordehumos,406,217,189
47,Valladolid,165,Tordesillas,8762,4436,4326
47,Valladolid,169,Torre de Esgueva,66,36,30
47,Valladolid,170,Torre de Peñafiel,45,28,17
47,Valladolid,166,Torrecilla de la Abadesa,270,127,143
47,Valladolid,167,Torrecilla de la Orden,240,119,121
47,Valladolid,168,Torrecilla de la Torre,36,23,13
47,Valladolid,171,Torrelobatón,390,203,187
47,Valladolid,172,Torrescárcela,168,87,81
47,Valladolid,173,Traspinedo,1149,606,543
47,Valladolid,174,Trigueros del Valle,309,169,140
47,Valladolid,175,Tudela de Duero,8648,4396,4252
47,Valladolid,176,"Unión de Campos, La",216,107,109
47,Valladolid,177,Urones de Castroponce,108,67,41
47,Valladolid,178,Urueña,191,105,86
47,Valladolid,179,Valbuena de Duero,436,244,192
47,Valladolid,180,Valdearcos de la Vega,52,28,24
47,Valladolid,181,Valdenebro de los Valles,193,104,89
47,Valladolid,182,Valdestillas,1607,825,782
47,Valladolid,183,Valdunquillo,138,65,73
47,Valladolid,186,Valladolid,297775,139534,158241
47,Valladolid,184,Valoria la Buena,678,373,305
47,Valladolid,185,Valverde de Campos,88,52,36
47,Valladolid,187,Vega de Ruiponce,85,51,34
47,Valladolid,188,Vega de Valdetronco,96,53,43
47,Valladolid,189,Velascálvaro,168,90,78
47,Valladolid,190,Velilla,115,58,57
47,Valladolid,191,Velliza,118,77,41
47,Valladolid,192,Ventosa de la Cuesta,98,57,41
47,Valladolid,193,Viana de Cega,2160,1126,1034
47,Valladolid,195,Villabáñez,492,266,226
47,Valladolid,196,Villabaruz de Campos,26,11,15
47,Valladolid,197,Villabrágima,1044,557,487
47,Valladolid,198,Villacarralón,72,45,27
47,Valladolid,199,Villacid de Campos,81,49,32
47,Valladolid,200,Villaco,75,47,28
47,Valladolid,203,Villafrades de Campos,61,31,30
47,Valladolid,204,Villafranca de Duero,268,138,130
47,Valladolid,205,Villafrechós,462,257,205
47,Valladolid,206,Villafuerte,86,51,35
47,Valladolid,207,Villagarcía de Campos,282,169,113
47,Valladolid,208,Villagómez la Nueva,63,34,29
47,Valladolid,209,Villalán de Campos,35,22,13
47,Valladolid,210,Villalar de los Comuneros,473,229,244
47,Valladolid,211,Villalba de la Loma,46,24,22
47,Valladolid,212,Villalba de los Alcores,370,201,169
47,Valladolid,213,Villalbarba,109,55,54
47,Valladolid,214,Villalón de Campos,1526,751,775
47,Valladolid,215,Villamuriel de Campos,49,25,24
47,Valladolid,216,Villán de Tordesillas,123,69,54
47,Valladolid,217,Villanubla,2828,1451,1377
47,Valladolid,218,Villanueva de Duero,1227,647,580
47,Valladolid,219,Villanueva de la Condesa,58,28,30
47,Valladolid,220,Villanueva de los Caballeros,178,93,85
47,Valladolid,221,Villanueva de los Infantes,105,62,43
47,Valladolid,222,Villanueva de San Mancio,89,52,37
47,Valladolid,223,Villardefrades,153,88,65
47,Valladolid,224,Villarmentero de Esgueva,102,56,46
47,Valladolid,225,Villasexmir,73,43,30
47,Valladolid,226,Villavaquerín,162,90,72
47,Valladolid,227,Villavellid,51,31,20
47,Valladolid,228,Villaverde de Medina,518,275,243
47,Valladolid,229,Villavicencio de los Caballeros,233,123,110
47,Valladolid,194,Viloria,348,183,165
47,Valladolid,230,Wamba,307,166,141
47,Valladolid,231,Zaratán,6249,3203,3046
47,Valladolid,232,"Zarza, La",118,63,55
49,Zamora,2,Abezames,58,29,29
49,Zamora,3,Alcañices,1042,553,489
49,Zamora,4,Alcubilla de Nogales,117,63,54
49,Zamora,5,Alfaraz de Sayago,137,80,57
49,Zamora,6,Algodre,135,73,62
49,Zamora,7,Almaraz de Duero,407,212,195
49,Zamora,8,Almeida de Sayago,423,231,192
49,Zamora,9,Andavías,449,225,224
49,Zamora,10,Arcenillas,429,223,206
49,Zamora,11,Arcos de la Polvorosa,218,120,98
49,Zamora,12,Argañín,72,36,36
49,Zamora,13,Argujillo,224,116,108
49,Zamora,14,Arquillinos,120,62,58
49,Zamora,15,Arrabalde,218,113,105
49,Zamora,16,Aspariegos,234,104,130
49,Zamora,17,Asturianos,260,136,124
49,Zamora,18,Ayoó de Vidriales,287,142,145
49,Zamora,19,Barcial del Barco,241,127,114
49,Zamora,20,Belver de los Montes,263,145,118
49,Zamora,21,Benavente,17523,8428,9095
49,Zamora,22,Benegiles,302,163,139
49,Zamora,23,Bermillo de Sayago,1008,533,475
49,Zamora,24,"Bóveda de Toro, La",692,345,347
49,Zamora,25,Bretó,160,91,69
49,Zamora,26,Bretocino,207,110,97
49,Zamora,27,Brime de Sog,128,61,67
49,Zamora,28,Brime de Urz,98,61,37
49,Zamora,29,Burganes de Valverde,639,338,301
49,Zamora,30,Bustillo del Oro,81,45,36
49,Zamora,31,Cabañas de Sayago,152,83,69
49,Zamora,32,Calzadilla de Tera,289,147,142
49,Zamora,33,Camarzana de Tera,767,388,379
49,Zamora,34,Cañizal,428,227,201
49,Zamora,35,Cañizo,220,121,99
49,Zamora,36,Carbajales de Alba,491,250,241
49,Zamora,37,Carbellino,175,93,82
49,Zamora,38,Casaseca de Campeán,103,60,43
49,Zamora,39,Casaseca de las Chanas,373,194,179
49,Zamora,40,Castrillo de la Guareña,116,62,54
49,Zamora,41,Castrogonzalo,456,248,208
49,Zamora,42,Castronuevo,220,109,111
49,Zamora,43,Castroverde de Campos,270,147,123
49,Zamora,44,Cazurra,73,37,36
49,Zamora,46,Cerecinos de Campos,247,137,110
49,Zamora,47,Cerecinos del Carrizal,112,65,47
49,Zamora,48,Cernadilla,113,57,56
49,Zamora,50,Cobreros,552,304,248
49,Zamora,52,Coomonte,198,111,87
49,Zamora,53,Coreses,1059,547,512
49,Zamora,54,Corrales del Vino,934,460,474
49,Zamora,55,Cotanes del Monte,96,53,43
49,Zamora,56,Cubillos,304,147,157
49,Zamora,57,Cubo de Benavente,120,63,57
49,Zamora,58,"Cubo de Tierra del Vino, El",314,166,148
49,Zamora,59,Cuelgamures,83,52,31
49,Zamora,61,Entrala,147,80,67
49,Zamora,62,Espadañedo,109,57,52
49,Zamora,63,Faramontanos de Tábara,332,169,163
49,Zamora,64,Fariza,489,252,237
49,Zamora,65,Fermoselle,1136,576,560
49,Zamora,66,Ferreras de Abajo,494,245,249
49,Zamora,67,Ferreras de Arriba,350,193,157
49,Zamora,68,Ferreruela,441,245,196
49,Zamora,69,Figueruela de Arriba,317,151,166
49,Zamora,71,Fonfría,744,392,352
49,Zamora,75,Fresno de la Polvorosa,124,68,56
49,Zamora,76,Fresno de la Ribera,362,187,175
49,Zamora,77,Fresno de Sayago,159,80,79
49,Zamora,78,Friera de Valverde,142,77,65
49,Zamora,79,Fuente Encalada,103,56,47
49,Zamora,80,Fuentelapeña,667,356,311
49,Zamora,82,Fuentes de Ropel,372,198,174
49,Zamora,81,Fuentesaúco,1608,816,792
49,Zamora,83,Fuentesecas,44,23,21
49,Zamora,84,Fuentespreadas,278,150,128
49,Zamora,85,Galende,960,481,479
49,Zamora,86,Gallegos del Pan,109,63,46
49,Zamora,87,Gallegos del Río,464,260,204
49,Zamora,88,Gamones,93,54,39
49,Zamora,90,Gema,204,104,100
49,Zamora,91,Granja de Moreruela,265,136,129
49,Zamora,92,Granucillo,117,59,58
49,Zamora,93,Guarrate,321,166,155
49,Zamora,94,Hermisende,214,110,104
49,Zamora,95,"Hiniesta, La",304,161,143
49,Zamora,96,Jambrina,149,81,68
49,Zamora,97,Justel,70,47,23
49,Zamora,98,Losacino,208,117,91
49,Zamora,99,Losacio,90,54,36
49,Zamora,100,Lubián,306,160,146
49,Zamora,101,Luelmo,145,80,65
49,Zamora,102,"Maderal, El",177,93,84
49,Zamora,103,Madridanos,455,239,216
49,Zamora,104,Mahide,298,169,129
49,Zamora,105,Maire de Castroponce,140,75,65
49,Zamora,107,Malva,117,53,64
49,Zamora,108,Manganeses de la Lampreana,448,231,217
49,Zamora,109,Manganeses de la Polvorosa,627,303,324
49,Zamora,110,Manzanal de Arriba,346,186,160
49,Zamora,112,Manzanal de los Infantes,125,70,55
49,Zamora,111,Manzanal del Barco,130,68,62
49,Zamora,113,Matilla de Arzón,164,98,66
49,Zamora,114,Matilla la Seca,39,22,17
49,Zamora,115,Mayalde,176,99,77
49,Zamora,116,Melgar de Tera,360,189,171
49,Zamora,117,Micereces de Tera,443,227,216
49,Zamora,118,Milles de la Polvorosa,208,116,92
49,Zamora,119,Molacillos,239,130,109
49,Zamora,120,Molezuelas de la Carballeda,46,25,21
49,Zamora,121,Mombuey,407,218,189
49,Zamora,122,Monfarracinos,971,510,461
49,Zamora,123,Montamarta,559,296,263
49,Zamora,124,Moral de Sayago,259,149,110
49,Zamora,126,Moraleja de Sayago,283,143,140
49,Zamora,125,Moraleja del Vino,1740,877,863
49,Zamora,128,Morales de Rey,570,286,284
49,Zamora,129,Morales de Toro,940,489,451
49,Zamora,130,Morales de Valverde,155,79,76
49,Zamora,127,Morales del Vino,3030,1582,1448
49,Zamora,131,Moralina,232,120,112
49,Zamora,132,Moreruela de los Infanzones,334,175,159
49,Zamora,133,Moreruela de Tábara,310,164,146
49,Zamora,134,Muelas de los Caballeros,171,99,72
49,Zamora,135,Muelas del Pan,607,322,285
49,Zamora,136,Muga de Sayago,350,169,181
49,Zamora,137,Navianos de Valverde,176,103,73
49,Zamora,138,Olmillos de Castro,208,112,96
49,Zamora,139,Otero de Bodas,151,80,71
49,Zamora,141,Pajares de la Lampreana,298,155,143
49,Zamora,143,Palacios de Sanabria,225,115,110
49,Zamora,142,Palacios del Pan,246,130,116
49,Zamora,145,Pedralba de la Pradería,199,111,88
49,Zamora,146,"Pego, El",272,137,135
49,Zamora,147,Peleagonzalo,274,133,141
49,Zamora,148,Peleas de Abajo,273,125,148
49,Zamora,149,Peñausende,381,199,182
49,Zamora,150,Peque,126,54,72
49,Zamora,151,"Perdigón, El",647,341,306
49,Zamora,152,Pereruela,514,280,234
49,Zamora,153,Perilla de Castro,163,90,73
49,Zamora,154,Pías,108,61,47
49,Zamora,155,Piedrahita de Castro,97,54,43
49,Zamora,156,Pinilla de Toro,205,107,98
49,Zamora,157,Pino del Oro,183,96,87
49,Zamora,158,"Piñero, El",222,114,108
49,Zamora,160,Pobladura de Valderaduey,39,23,16
49,Zamora,159,Pobladura del Valle,295,157,138
49,Zamora,162,Porto,156,87,69
49,Zamora,163,Pozoantiguo,180,90,90
49,Zamora,164,Pozuelo de Tábara,155,84,71
49,Zamora,165,Prado,48,28,20
49,Zamora,166,Puebla de Sanabria,1366,660,706
49,Zamora,167,Pueblica de Valverde,186,98,88
49,Zamora,170,Quintanilla de Urz,98,47,51
49,Zamora,168,Quintanilla del Monte,104,62,42
49,Zamora,169,Quintanilla del Olmo,42,23,19
49,Zamora,171,Quiruelas de Vidriales,640,341,299
49,Zamora,172,Rabanales,499,263,236
49,Zamora,173,Rábano de Aliste,343,170,173
49,Zamora,174,Requejo,141,73,68
49,Zamora,175,Revellinos,257,135,122
49,Zamora,176,Riofrío de Aliste,629,349,280
49,Zamora,177,Rionegro del Puente,250,130,120
49,Zamora,178,Roales,987,514,473
49,Zamora,179,Robleda-Cervantes,392,209,183
49,Zamora,180,Roelos de Sayago,143,71,72
49,Zamora,181,Rosinos de la Requejada,342,182,160
49,Zamora,183,Salce,89,38,51
49,Zamora,184,Samir de los Caños,169,93,76
49,Zamora,185,San Agustín del Pozo,183,94,89
49,Zamora,186,San Cebrián de Castro,238,115,123
49,Zamora,187,San Cristóbal de Entreviñas,1362,720,642
49,Zamora,188,San Esteban del Molar,113,67,46
49,Zamora,189,San Justo,197,106,91
49,Zamora,190,San Martín de Valderaduey,50,27,23
49,Zamora,191,San Miguel de la Ribera,285,144,141
49,Zamora,192,San Miguel del Valle,128,67,61
49,Zamora,193,San Pedro de Ceque,437,230,207
49,Zamora,194,San Pedro de la Nave-Almendra,342,174,168
49,Zamora,208,San Vicente de la Cabeza,350,187,163
49,Zamora,209,San Vitero,473,270,203
49,Zamora,197,Santa Clara de Avedillo,157,76,81
49,Zamora,199,Santa Colomba de las Monjas,246,121,125
49,Zamora,200,Santa Cristina de la Polvorosa,1070,551,519
49,Zamora,201,Santa Croya de Tera,290,149,141
49,Zamora,202,Santa Eufemia del Barco,177,102,75
49,Zamora,203,Santa María de la Vega,289,149,140
49,Zamora,204,Santa María de Valverde,54,27,27
49,Zamora,205,Santibáñez de Tera,369,186,183
49,Zamora,206,Santibáñez de Vidriales,918,464,454
49,Zamora,207,Santovenia,235,121,114
49,Zamora,210,Sanzoles,471,241,230
49,Zamora,214,Tábara,751,372,379
49,Zamora,216,Tapioles,139,80,59
49,Zamora,219,Toro,8532,4198,4334
49,Zamora,220,"Torre del Valle, La",138,77,61
49,Zamora,221,Torregamones,237,125,112
49,Zamora,222,Torres del Carrizal,414,210,204
49,Zamora,223,Trabazos,835,446,389
49,Zamora,224,Trefacio,186,102,84
49,Zamora,225,Uña de Quintana,135,72,63
49,Zamora,226,Vadillo de la Guareña,248,134,114
49,Zamora,227,Valcabado,397,204,193
49,Zamora,228,Valdefinjas,57,34,23
49,Zamora,229,Valdescorriel,126,63,63
49,Zamora,230,Vallesa de la Guareña,78,42,36
49,Zamora,231,Vega de Tera,309,152,157
49,Zamora,232,Vega de Villalobos,92,39,53
49,Zamora,233,Vegalatrave,81,43,38
49,Zamora,234,Venialbo,416,225,191
49,Zamora,235,Vezdemarbán,448,233,215
49,Zamora,236,Vidayanes,83,43,40
49,Zamora,237,Videmala,141,73,68
49,Zamora,238,Villabrázaro,228,123,105
49,Zamora,239,Villabuena del Puente,623,327,296
49,Zamora,240,Villadepera,189,103,86
49,Zamora,241,Villaescusa,244,133,111
49,Zamora,242,Villafáfila,475,246,229
49,Zamora,243,Villaferrueña,107,54,53
49,Zamora,244,Villageriz,48,27,21
49,Zamora,245,Villalazán,251,128,123
49,Zamora,246,Villalba de la Lampreana,223,126,97
49,Zamora,247,Villalcampo,405,207,198
49,Zamora,248,Villalobos,227,119,108
49,Zamora,249,Villalonso,68,35,33
49,Zamora,250,Villalpando,1451,715,736
49,Zamora,251,Villalube,161,87,74
49,Zamora,252,Villamayor de Campos,328,167,161
49,Zamora,255,Villamor de los Escuderos,384,202,182
49,Zamora,256,Villanázar,273,141,132
49,Zamora,257,Villanueva de Azoague,360,184,176
49,Zamora,258,Villanueva de Campeán,116,61,55
49,Zamora,259,Villanueva de las Peras,78,37,41
49,Zamora,260,Villanueva del Campo,810,399,411
49,Zamora,263,Villar de Fallaves,44,25,19
49,Zamora,264,Villar del Buey,535,279,256
49,Zamora,261,Villaralbo,1804,909,895
49,Zamora,262,Villardeciervos,403,201,202
49,Zamora,265,Villardiegua de la Ribera,113,64,49
49,Zamora,266,Villárdiga,77,44,33
49,Zamora,267,Villardondiego,101,58,43
49,Zamora,268,Villarrín de Campos,387,204,183
49,Zamora,269,Villaseco del Pan,222,103,119
49,Zamora,270,Villavendimio,160,97,63
49,Zamora,272,Villaveza de Valverde,70,37,33
49,Zamora,271,Villaveza del Agua,179,97,82
49,Zamora,273,Viñas,159,86,73
49,Zamora,275,Zamora,60297,27979,32318
50,Zaragoza,1,Abanto,89,53,36
50,Zaragoza,2,Acered,140,82,58
50,Zaragoza,3,Agón,135,79,56
50,Zaragoza,4,Aguarón,616,327,289
50,Zaragoza,5,Aguilón,234,134,100
50,Zaragoza,6,Ainzón,1067,548,519
50,Zaragoza,7,Aladrén,58,37,21
50,Zaragoza,8,Alagón,7121,3568,3553
50,Zaragoza,9,Alarba,112,64,48
50,Zaragoza,10,Alberite de San Juan,77,46,31
50,Zaragoza,11,Albeta,140,68,72
50,Zaragoza,12,Alborge,111,57,54
50,Zaragoza,13,Alcalá de Ebro,245,121,124
50,Zaragoza,14,Alcalá de Moncayo,153,88,65
50,Zaragoza,15,Alconchel de Ariza,79,45,34
50,Zaragoza,16,Aldehuela de Liestos,52,37,15
50,Zaragoza,17,Alfajarín,2374,1216,1158
50,Zaragoza,18,Alfamén,1446,756,690
50,Zaragoza,19,Alforque,62,36,26
50,Zaragoza,20,Alhama de Aragón,1002,524,478
50,Zaragoza,21,Almochuel,24,13,11
50,Zaragoza,22,"Almolda, La",555,276,279
50,Zaragoza,23,Almonacid de la Cuba,234,115,119
50,Zaragoza,24,Almonacid de la Sierra,771,428,343
50,Zaragoza,25,"Almunia de Doña Godina, La",7983,4115,3868
50,Zaragoza,26,Alpartir,604,316,288
50,Zaragoza,27,Ambel,252,124,128
50,Zaragoza,28,Anento,91,61,30
50,Zaragoza,29,Aniñón,671,354,317
50,Zaragoza,30,Añón de Moncayo,205,121,84
50,Zaragoza,31,Aranda de Moncayo,140,88,52
50,Zaragoza,32,Arándiga,274,143,131
50,Zaragoza,33,Ardisa,76,48,28
50,Zaragoza,34,Ariza,1068,549,519
50,Zaragoza,35,Artieda,78,46,32
50,Zaragoza,36,Asín,97,54,43
50,Zaragoza,37,Atea,149,90,59
50,Zaragoza,38,Ateca,1729,893,836
50,Zaragoza,39,Azuara,544,311,233
50,Zaragoza,40,Badules,70,37,33
50,Zaragoza,41,Bagüés,16,7,9
50,Zaragoza,42,Balconchán,19,6,13
50,Zaragoza,43,Bárboles,297,164,133
50,Zaragoza,44,Bardallur,254,125,129
50,Zaragoza,45,Belchite,1540,777,763
50,Zaragoza,46,Belmonte de Gracián,194,107,87
50,Zaragoza,47,Berdejo,40,26,14
50,Zaragoza,48,Berrueco,35,21,14
50,Zaragoza,901,Biel,171,102,69
50,Zaragoza,50,Bijuesca,90,62,28
50,Zaragoza,51,Biota,912,465,447
50,Zaragoza,52,Bisimbre,87,47,40
50,Zaragoza,53,Boquiñeni,778,391,387
50,Zaragoza,54,Bordalba,51,32,19
50,Zaragoza,55,Borja,5037,2577,2460
50,Zaragoza,56,Botorrita,516,281,235
50,Zaragoza,57,Brea de Aragón,1559,793,766
50,Zaragoza,58,Bubierca,64,32,32
50,Zaragoza,59,Bujaraloz,975,496,479
50,Zaragoza,60,Bulbuente,233,127,106
50,Zaragoza,61,Bureta,206,107,99
50,Zaragoza,62,"Burgo de Ebro, El",2538,1274,1264
50,Zaragoza,63,"Buste, El",69,40,29
50,Zaragoza,64,Cabañas de Ebro,487,255,232
50,Zaragoza,65,Cabolafuente,49,29,20
50,Zaragoza,66,Cadrete,4334,2281,2053
50,Zaragoza,67,Calatayud,19870,9778,10092
50,Zaragoza,68,Calatorao,2921,1527,1394
50,Zaragoza,69,Calcena,78,46,32
50,Zaragoza,70,Calmarza,64,36,28
50,Zaragoza,71,Campillo de Aragón,132,78,54
50,Zaragoza,72,Carenas,182,105,77
50,Zaragoza,73,Cariñena,3370,1705,1665
50,Zaragoza,74,Caspe,10183,5401,4782
50,Zaragoza,75,Castejón de Alarba,78,49,29
50,Zaragoza,76,Castejón de las Armas,82,43,39
50,Zaragoza,77,Castejón de Valdejasa,216,104,112
50,Zaragoza,78,Castiliscar,248,131,117
50,Zaragoza,79,Cervera de la Cañada,264,149,115
50,Zaragoza,80,Cerveruela,37,24,13
50,Zaragoza,81,Cetina,578,296,282
50,Zaragoza,92,Chiprana,503,266,237
50,Zaragoza,93,Chodes,100,55,45
50,Zaragoza,82,Cimballa,93,45,48
50,Zaragoza,83,Cinco Olivas,105,51,54
50,Zaragoza,84,Clarés de Ribota,68,38,30
50,Zaragoza,85,Codo,206,109,97
50,Zaragoza,86,Codos,237,155,82
50,Zaragoza,87,Contamina,33,18,15
50,Zaragoza,88,Cosuenda,335,171,164
50,Zaragoza,89,Cuarte de Huerva,13773,7006,6767
50,Zaragoza,90,Cubel,146,68,78
50,Zaragoza,91,"Cuerlas, Las",42,22,20
50,Zaragoza,94,Daroca,1914,930,984
50,Zaragoza,95,Ejea de los Caballeros,17036,8758,8278
50,Zaragoza,96,Embid de Ariza,32,18,14
50,Zaragoza,98,Encinacorba,186,100,86
50,Zaragoza,99,Épila,4368,2258,2110
50,Zaragoza,100,Erla,356,181,175
50,Zaragoza,101,Escatrón,1120,556,564
50,Zaragoza,102,Fabara,1096,595,501
50,Zaragoza,104,Farlete,378,187,191
50,Zaragoza,105,Fayón,382,209,173
50,Zaragoza,106,"Fayos, Los",134,73,61
50,Zaragoza,107,Figueruelas,1239,618,621
50,Zaragoza,108,Fombuena,59,36,23
50,Zaragoza,109,"Frago, El",115,73,42
50,Zaragoza,110,"Frasno, El",394,215,179
50,Zaragoza,111,Fréscano,200,111,89
50,Zaragoza,113,Fuendejalón,766,411,355
50,Zaragoza,114,Fuendetodos,142,82,60
50,Zaragoza,115,Fuentes de Ebro,4600,2382,2218
50,Zaragoza,116,Fuentes de Jiloca,211,117,94
50,Zaragoza,117,Gallocanta,128,69,59
50,Zaragoza,118,Gallur,2555,1297,1258
50,Zaragoza,119,Gelsa,997,524,473
50,Zaragoza,120,Godojos,49,27,22
50,Zaragoza,121,Gotor,311,157,154
50,Zaragoza,122,Grisel,83,49,34
50,Zaragoza,123,Grisén,605,318,287
50,Zaragoza,124,Herrera de los Navarros,496,274,222
50,Zaragoza,125,Ibdes,388,198,190
50,Zaragoza,126,Illueca,2778,1387,1391
50,Zaragoza,128,Isuerre,33,17,16
50,Zaragoza,129,Jaraba,282,154,128
50,Zaragoza,130,Jarque de Moncayo,413,216,197
50,Zaragoza,131,Jaulín,275,146,129
50,Zaragoza,132,"Joyosa, La",1132,579,553
50,Zaragoza,133,Lagata,114,61,53
50,Zaragoza,134,Langa del Castillo,116,60,56
50,Zaragoza,135,Layana,92,52,40
50,Zaragoza,136,Lécera,642,339,303
50,Zaragoza,138,Lechón,47,28,19
50,Zaragoza,137,Leciñena,1132,579,553
50,Zaragoza,139,Letux,343,184,159
50,Zaragoza,140,Litago,190,112,78
50,Zaragoza,141,Lituénigo,119,63,56
50,Zaragoza,142,Lobera de Onsella,25,13,12
50,Zaragoza,143,Longares,876,532,344
50,Zaragoza,144,Longás,36,24,12
50,Zaragoza,146,Lucena de Jalón,227,124,103
50,Zaragoza,147,Luceni,987,493,494
50,Zaragoza,148,Luesia,342,183,159
50,Zaragoza,149,Luesma,40,23,17
50,Zaragoza,150,Lumpiaque,836,436,400
50,Zaragoza,151,Luna,709,370,339
50,Zaragoza,152,Maella,2062,1118,944
50,Zaragoza,153,Magallón,1133,578,555
50,Zaragoza,154,Mainar,162,88,74
50,Zaragoza,155,Malanquilla,95,60,35
50,Zaragoza,156,Maleján,260,136,124
50,Zaragoza,160,Mallén,2977,1546,1431
50,Zaragoza,157,Malón,371,186,185
50,Zaragoza,159,Maluenda,920,455,465
50,Zaragoza,161,Manchones,104,56,48
50,Zaragoza,162,Mara,167,86,81
50,Zaragoza,163,María de Huerva,6021,3037,2984
50,Zaragoza,902,Marracos,92,49,43
50,Zaragoza,164,Mediana de Aragón,465,230,235
50,Zaragoza,165,Mequinenza,2292,1162,1130
50,Zaragoza,166,Mesones de Isuela,265,135,130
50,Zaragoza,167,Mezalocha,238,136,102
50,Zaragoza,168,Mianos,28,14,14
50,Zaragoza,169,Miedes de Aragón,429,226,203
50,Zaragoza,170,Monegrillo,389,214,175
50,Zaragoza,171,Moneva,121,73,48
50,Zaragoza,172,Monreal de Ariza,193,111,82
50,Zaragoza,173,Monterde,135,87,48
50,Zaragoza,174,Montón,89,53,36
50,Zaragoza,175,Morata de Jalón,1077,537,540
50,Zaragoza,176,Morata de Jiloca,260,149,111
50,Zaragoza,177,Morés,338,181,157
50,Zaragoza,178,Moros,304,157,147
50,Zaragoza,179,Moyuela,262,145,117
50,Zaragoza,180,Mozota,124,62,62
50,Zaragoza,181,Muel,1436,739,697
50,Zaragoza,182,"Muela, La",6125,3184,2941
50,Zaragoza,183,Munébrega,360,193,167
50,Zaragoza,184,Murero,97,54,43
50,Zaragoza,185,Murillo de Gállego,187,110,77
50,Zaragoza,186,Navardún,34,21,13
50,Zaragoza,187,Nigüella,62,38,24
50,Zaragoza,188,Nombrevilla,35,20,15
50,Zaragoza,189,Nonaspe,998,541,457
50,Zaragoza,190,Novallas,833,444,389
50,Zaragoza,191,Novillas,502,249,253
50,Zaragoza,192,Nuévalos,297,164,133
50,Zaragoza,193,Nuez de Ebro,880,447,433
50,Zaragoza,194,Olvés,105,59,46
50,Zaragoza,195,Orcajo,58,36,22
50,Zaragoza,196,Orera,116,61,55
50,Zaragoza,197,Orés,107,66,41
50,Zaragoza,198,Oseja,45,29,16
50,Zaragoza,199,Osera de Ebro,395,202,193
50,Zaragoza,200,Paniza,609,325,284
50,Zaragoza,201,Paracuellos de Jiloca,567,296,271
50,Zaragoza,202,Paracuellos de la Ribera,131,71,60
50,Zaragoza,203,Pastriz,1294,628,666
50,Zaragoza,204,Pedrola,3572,1850,1722
50,Zaragoza,205,"Pedrosas, Las",96,47,49
50,Zaragoza,206,Perdiguera,567,305,262
50,Zaragoza,207,Piedratajada,93,52,41
50,Zaragoza,208,Pina de Ebro,2390,1224,1166
50,Zaragoza,209,Pinseque,4184,2136,2048
50,Zaragoza,210,"Pintanos, Los",38,26,12
50,Zaragoza,211,Plasencia de Jalón,309,173,136
50,Zaragoza,212,Pleitas,33,14,19
50,Zaragoza,213,Plenas,100,54,46
50,Zaragoza,214,Pomer,25,18,7
50,Zaragoza,215,Pozuel de Ariza,17,10,7
50,Zaragoza,216,Pozuelo de Aragón,265,140,125
50,Zaragoza,217,Pradilla de Ebro,534,289,245
50,Zaragoza,218,Puebla de Albortón,125,74,51
50,Zaragoza,219,"Puebla de Alfindén, La",6446,3287,3159
50,Zaragoza,220,Puendeluna,49,30,19
50,Zaragoza,221,Purujosa,26,16,10
50,Zaragoza,222,Quinto,1937,981,956
50,Zaragoza,223,Remolinos,1052,536,516
50,Zaragoza,224,Retascón,65,35,30
50,Zaragoza,225,Ricla,2922,1572,1350
50,Zaragoza,227,Romanos,132,67,65
50,Zaragoza,228,Rueda de Jalón,313,170,143
50,Zaragoza,229,Ruesca,76,36,40
50,Zaragoza,241,Sabiñán,686,365,321
50,Zaragoza,230,Sádaba,1294,662,632
50,Zaragoza,231,Salillas de Jalón,338,167,171
50,Zaragoza,232,Salvatierra de Esca,210,106,104
50,Zaragoza,233,Samper del Salz,101,54,47
50,Zaragoza,234,San Martín de la Virgen de Moncayo,276,157,119
50,Zaragoza,235,San Mateo de Gállego,3415,1750,1665
50,Zaragoza,236,Santa Cruz de Grío,102,65,37
50,Zaragoza,237,Santa Cruz de Moncayo,134,72,62
50,Zaragoza,238,Santa Eulalia de Gállego,103,61,42
50,Zaragoza,239,Santed,64,41,23
50,Zaragoza,240,Sástago,1122,568,554
50,Zaragoza,242,Sediles,108,62,46
50,Zaragoza,243,Sestrica,338,192,146
50,Zaragoza,244,Sierra de Luna,285,144,141
50,Zaragoza,245,Sigüés,79,40,39
50,Zaragoza,246,Sisamón,33,22,11
50,Zaragoza,247,Sobradiel,1150,548,602
50,Zaragoza,248,Sos del Rey Católico,574,304,270
50,Zaragoza,249,Tabuenca,320,188,132
50,Zaragoza,250,Talamantes,64,32,32
50,Zaragoza,251,Tarazona,10494,5225,5269
50,Zaragoza,252,Tauste,6777,3398,3379
50,Zaragoza,253,Terrer,530,290,240
50,Zaragoza,254,Tierga,190,103,87
50,Zaragoza,255,Tobed,225,121,104
50,Zaragoza,256,Torralba de los Frailes,74,39,35
50,Zaragoza,257,Torralba de Ribota,163,89,74
50,Zaragoza,258,Torralbilla,59,36,23
50,Zaragoza,259,Torrehermosa,63,33,30
50,Zaragoza,260,Torrelapaja,35,24,11
50,Zaragoza,261,Torrellas,241,123,118
50,Zaragoza,262,Torres de Berrellén,1460,751,709
50,Zaragoza,263,Torrijo de la Cañada,204,120,84
50,Zaragoza,264,Tosos,176,103,73
50,Zaragoza,265,Trasmoz,82,42,40
50,Zaragoza,266,Trasobares,129,77,52
50,Zaragoza,267,Uncastillo,634,300,334
50,Zaragoza,268,Undués de Lerda,56,32,24
50,Zaragoza,269,Urrea de Jalón,447,259,188
50,Zaragoza,270,Urriés,49,24,25
50,Zaragoza,271,Used,271,145,126
50,Zaragoza,272,Utebo,18856,9390,9466
50,Zaragoza,274,Val de San Martín,59,36,23
50,Zaragoza,273,Valdehorna,29,16,13
50,Zaragoza,275,Valmadrid,98,63,35
50,Zaragoza,276,Valpalmas,135,65,70
50,Zaragoza,277,Valtorres,63,30,33
50,Zaragoza,278,Velilla de Ebro,203,109,94
50,Zaragoza,279,Velilla de Jiloca,76,35,41
50,Zaragoza,280,Vera de Moncayo,314,167,147
50,Zaragoza,281,Vierlas,83,45,38
50,Zaragoza,283,Villadoz,90,53,37
50,Zaragoza,284,Villafeliche,147,85,62
50,Zaragoza,285,Villafranca de Ebro,848,429,419
50,Zaragoza,286,Villalba de Perejil,100,51,49
50,Zaragoza,287,Villalengua,291,161,130
50,Zaragoza,903,Villamayor de Gállego,2768,1387,1381
50,Zaragoza,288,Villanueva de Gállego,4725,2366,2359
50,Zaragoza,290,Villanueva de Huerva,412,215,197
50,Zaragoza,289,Villanueva de Jiloca,57,28,29
50,Zaragoza,291,Villar de los Navarros,130,74,56
50,Zaragoza,292,Villarreal de Huerva,272,155,117
50,Zaragoza,293,Villarroya de la Sierra,445,236,209
50,Zaragoza,294,Villarroya del Campo,89,48,41
50,Zaragoza,282,"Vilueña, La",71,36,35
50,Zaragoza,295,Vistabella,51,29,22
50,Zaragoza,296,"Zaida, La",432,221,211
50,Zaragoza,297,Zaragoza,675301,323111,352190
50,Zaragoza,298,Zuera,8591,4427,4164
