province_code,province_name,cmun,municipality_name,population_total,population_male,population_female
01,Álava,1,Alegría-Dulantzi,1707,885,822
01,Álava,2,Amurrio,9555,4743,4812
01,Álava,49,Añana,185,97,88
01,Álava,3,Aramaio,1489,789,700
01,Álava,6,Armiñón,170,87,83
01,Álava,37,Arraia-Maeztu,738,409,329
01,Álava,8,Arrazua-Ubarrundia,717,387,330
01,Álava,4,Artziniega,1381,679,702
01,Álava,9,Asparrena,1577,789,788
01,Álava,10,Ayala/Aiara,2236,1129,1107
01,Álava,11,Baños de Ebro/Mañueta,345,190,155
01,Álava,13,Barrundia,704,389,315
01,Álava,14,Berantevilla,464,238,226
01,Álava,16,Bernedo,544,321,223
01,Álava,17,Campezo/Kanpezu,1063,559,504
01,Álava,21,Elburgo/Burgelu,435,238,197
01,Álava,22,Elciego,943,472,471
01,Álava,23,Elvillar/Bilar,375,204,171
01,Álava,56,Harana/Valle de Arana,336,192,144
01,Álava,901,Iruña Oka/Iruña de Oca,2006,1081,925
01,Álava,27,Iruraiz-Gauna,458,241,217
01,Álava,19,Kripan,191,102,89
01,Álava,20,Kuartango,367,208,159
01,Álava,28,Labastida,1302,699,603
01,Álava,30,Lagrán,191,106,85
01,Álava,31,Laguardia,1463,762,701
01,Álava,32,Lanciego/Lantziego,648,342,306
01,Álava,902,Lantarón,929,512,417
01,Álava,33,Lapuebla de Labarca,865,449,416
01,Álava,58,Legutiano,1442,760,682
01,Álava,34,Leza,210,112,98
01,Álava,36,Llodio,18871,9418,9453
01,Álava,39,Moreda de Álava,280,145,135
01,Álava,41,Navaridas,207,110,97
01,Álava,42,Okondo,964,514,450
01,Álava,43,Oyón-Oion,2564,1310,1254
01,Álava,44,Peñacerrada-Urizaharra,265,145,120
01,Álava,46,Ribera Alta,569,330,239
01,Álava,47,Ribera Baja/Erribera Beitia,856,476,380
01,Álava,51,Salvatierra/Agurain,4044,1999,2045
01,Álava,52,Samaniego,317,160,157
01,Álava,53,San Millán/Donemiliaga,685,387,298
01,Álava,54,Urkabustaiz,917,499,418
01,Álava,55,Valdegovía,1010,560,450
01,Álava,57,Villabuena de Álava/Eskuernaga,336,167,169
01,Álava,59,Vitoria-Gasteiz,223257,110052,113205
01,Álava,60,Yécora/Iekora,255,123,132
01,Álava,61,Zalduondo,146,76,70
01,Álava,62,Zambrana,352,187,165
01,Álava,18,Zigoitia,1331,737,594
01,Álava,63,Zuia,2098,1085,1013
02,Albacete,1,Abengibre,959,480,479
02,Albacete,2,Alatoz,625,328,297
02,Albacete,3,Albacete,155142,76251,78891
02,Albacete,4,Albatana,852,415,437
02,Albacete,5,Alborea,792,406,386
02,Albacete,6,Alcadozo,751,391,360
02,Albacete,7,Alcalá del Júcar,1427,741,686
02,Albacete,8,Alcaraz,1697,826,871
02,Albacete,9,Almansa,24454,12064,12390
02,Albacete,10,Alpera,2337,1212,1125
02,Albacete,11,Ayna,945,475,470
02,Albacete,12,Balazote,2485,1337,1148
02,Albacete,13,Balsa de Ves,224,123,101
02,Albacete,14,Ballestero (El),545,276,269
02,Albacete,15,Barrax,1979,979,1000
02,Albacete,16,Bienservida,835,419,416
02,Albacete,17,Bogarra,1192,620,572
02,Albacete,18,Bonete,1232,632,600
02,Albacete,19,Bonillo (El),3226,1652,1574
02,Albacete,20,Carcelén,637,337,300
02,Albacete,21,Casas de Juan Núñez,1287,664,623
02,Albacete,22,Casas de Lázaro,437,232,205
02,Albacete,23,Casas de Ves,821,431,390
02,Albacete,24,Casas-Ibáñez,4287,2171,2116
02,Albacete,25,Caudete,9388,4755,4633
02,Albacete,26,Cenizate,1137,586,551
02,Albacete,27,Corral-Rubio,491,249,242
02,Albacete,28,Cotillas,174,87,87
02,Albacete,29,Chinchilla de Monte-Aragón,3193,1685,1508
02,Albacete,30,Elche de la Sierra,3873,1920,1953
02,Albacete,31,Férez,812,410,402
02,Albacete,32,Fuensanta,358,193,165
02,Albacete,33,Fuente-Álamo,2663,1382,1281
02,Albacete,34,Fuentealbilla,1881,971,910
02,Albacete,35,Gineta (La),2081,1038,1043
02,Albacete,36,Golosalvo,108,51,57
02,Albacete,37,Hellín,28890,14431,14459
02,Albacete,38,Herrera (La),376,192,184
02,Albacete,39,Higueruela,1322,671,651
02,Albacete,40,Hoya-Gonzalo,793,403,390
02,Albacete,41,Jorquera,548,287,261
02,Albacete,42,Letur,1264,623,641
02,Albacete,43,Lezuza,1713,878,835
02,Albacete,44,Liétor,1602,832,770
02,Albacete,45,Madrigueras,4553,2309,2244
02,Albacete,46,Mahora,1385,684,701
02,Albacete,47,Masegoso,143,82,61
02,Albacete,48,Minaya,1707,884,823
02,Albacete,49,Molinicos,1204,625,579
02,Albacete,50,Montalvos,154,77,77
02,Albacete,51,Montealegre del Castillo,2295,1166,1129
02,Albacete,52,Motilleja,516,261,255
02,Albacete,53,Munera,4015,2036,1979
02,Albacete,54,Navas de Jorquera,532,269,263
02,Albacete,55,Nerpio,1668,897,771
02,Albacete,56,Ontur,2395,1185,1210
02,Albacete,57,Ossa de Montiel,2766,1373,1393
02,Albacete,58,Paterna del Madera,510,263,247
02,Albacete,60,Peñas de San Pedro,1182,632,550
02,Albacete,59,Peñascosa,403,206,197
02,Albacete,61,Pétrola,867,441,426
02,Albacete,62,Povedilla,652,348,304
02,Albacete,901,Pozo Cañada,2661,1311,1350
02,Albacete,63,Pozohondo,1846,951,895
02,Albacete,64,Pozo-Lorente,559,277,282
02,Albacete,65,Pozuelo,661,357,304
02,Albacete,66,Recueja (La),323,159,164
02,Albacete,67,Riópar,1487,760,727
02,Albacete,68,Robledo,429,224,205
02,Albacete,69,Roda (La),14331,7246,7085
02,Albacete,70,Salobre,600,306,294
02,Albacete,71,San Pedro,1301,662,639
02,Albacete,72,Socovos,1965,999,966
02,Albacete,73,Tarazona de la Mancha,6392,3258,3134
02,Albacete,74,Tobarra,7734,3939,3795
02,Albacete,75,Valdeganga,1897,954,943
02,Albacete,76,Vianos,465,225,240
02,Albacete,77,Villa de Ves,71,34,37
02,Albacete,78,Villalgordo del Júcar,1258,624,634
02,Albacete,79,Villamalea,3778,1924,1854
02,Albacete,80,Villapalacios,745,372,373
02,Albacete,81,Villarrobledo,24074,12044,12030
02,Albacete,82,Villatoya,174,90,84
02,Albacete,83,Villavaliente,287,148,139
02,Albacete,84,Villaverde de Guadalimar,461,243,218
02,Albacete,85,Viveros,494,266,228
02,Albacete,86,Yeste,3781,1922,1859
03,Alicante/Alacant,1,Adsubia,587,316,271
03,Alicante/Alacant,2,Agost,4451,2250,2201
03,Alicante/Alacant,3,Agres,622,338,284
03,Alicante/Alacant,4,Aigües,637,323,314
03,Alicante/Alacant,5,Albatera,9636,4927,4709
03,Alicante/Alacant,6,Alcalalí,1150,612,538
03,Alicante/Alacant,7,Alcocer de Planes,164,73,91
03,Alicante/Alacant,8,Alcoleja,244,124,120
03,Alicante/Alacant,9,Alcoy/Alcoi,60036,29047,30989
03,Alicante/Alacant,10,Alfafara,411,202,209
03,Alicante/Alacant,11,Alfàs del Pi (l'),16164,7947,8217
03,Alicante/Alacant,12,Algorfa,1782,908,874
03,Alicante/Alacant,13,Algueña,1449,709,740
03,Alicante/Alacant,14,Alicante/Alacant,305911,147984,157927
03,Alicante/Alacant,15,Almoradí,14904,7643,7261
03,Alicante/Alacant,16,Almudaina,108,60,48
03,Alicante/Alacant,17,Alqueria d'Asnar (l'),402,204,198
03,Alicante/Alacant,18,Altea,18976,9408,9568
03,Alicante/Alacant,19,Aspe,17423,8749,8674
03,Alicante/Alacant,20,Balones,172,80,92
03,Alicante/Alacant,21,Banyeres de Mariola,7321,3644,3677
03,Alicante/Alacant,22,Benasau,233,110,123
03,Alicante/Alacant,23,Beneixama,1931,971,960
03,Alicante/Alacant,24,Benejúzar,5114,2528,2586
03,Alicante/Alacant,25,Benferri,1188,616,572
03,Alicante/Alacant,26,Beniarbeig,1358,678,680
03,Alicante/Alacant,27,Beniardá,215,110,105
03,Alicante/Alacant,28,Beniarrés,1396,694,702
03,Alicante/Alacant,30,Benidoleig,972,482,490
03,Alicante/Alacant,31,Benidorm,64267,32061,32206
03,Alicante/Alacant,32,Benifallim,138,65,73
03,Alicante/Alacant,33,Benifato,168,84,84
03,Alicante/Alacant,29,Benigembla,509,260,249
03,Alicante/Alacant,34,Benijófar,2830,1401,1429
03,Alicante/Alacant,35,Benilloba,903,453,450
03,Alicante/Alacant,36,Benillup,92,45,47
03,Alicante/Alacant,37,Benimantell,443,220,223
03,Alicante/Alacant,38,Benimarfull,443,216,227
03,Alicante/Alacant,39,Benimassot,140,76,64
03,Alicante/Alacant,40,Benimeli,332,169,163
03,Alicante/Alacant,41,Benissa,12098,6037,6061
03,Alicante/Alacant,42,Benitachell/Poble Nou de Benitatxell (el),3316,1693,1623
03,Alicante/Alacant,43,Biar,3550,1734,1816
03,Alicante/Alacant,44,Bigastro,5421,2749,2672
03,Alicante/Alacant,45,Bolulla,357,181,176
03,Alicante/Alacant,46,Busot,1998,1010,988
03,Alicante/Alacant,47,Calpe/Calp,22446,11416,11030
03,Alicante/Alacant,49,Callosa de Segura,16375,8287,8088
03,Alicante/Alacant,48,Callosa d'En Sarrià,8060,4294,3766
03,Alicante/Alacant,50,Campello (el),21761,10705,11056
03,Alicante/Alacant,51,Campo de Mirra/Camp de Mirra (el),414,202,212
03,Alicante/Alacant,52,Cañada,1179,571,608
03,Alicante/Alacant,53,Castalla,8193,4129,4064
03,Alicante/Alacant,54,Castell de Castells,465,229,236
03,Alicante/Alacant,75,Castell de Guadalest (el),194,98,96
03,Alicante/Alacant,55,Catral,5596,2832,2764
03,Alicante/Alacant,56,Cocentaina,10673,5259,5414
03,Alicante/Alacant,57,Confrides,325,184,141
03,Alicante/Alacant,58,Cox,6355,3293,3062
03,Alicante/Alacant,59,Crevillent,26260,13325,12935
03,Alicante/Alacant,61,Daya Nueva,1272,666,606
03,Alicante/Alacant,62,Daya Vieja,222,116,106
03,Alicante/Alacant,63,Dénia,37773,18644,19129
03,Alicante/Alacant,64,Dolores,6561,3346,3215
03,Alicante/Alacant,65,Elche/Elx,207163,103170,103993
03,Alicante/Alacant,66,Elda,54086,26420,27666
03,Alicante/Alacant,67,Facheca,112,59,53
03,Alicante/Alacant,68,Famorca,71,31,40
03,Alicante/Alacant,69,Finestrat,2858,1451,1407
03,Alicante/Alacant,70,Formentera del Segura,2403,1202,1201
03,Alicante/Alacant,72,Gaianes,329,154,175
03,Alicante/Alacant,71,Gata de Gorgos,5120,2588,2532
03,Alicante/Alacant,73,Gorga,252,131,121
03,Alicante/Alacant,74,Granja de Rocamora,2039,1045,994
03,Alicante/Alacant,76,Guardamar del Segura,11587,5842,5745
03,Alicante/Alacant,77,Hondón de las Nieves,1770,875,895
03,Alicante/Alacant,78,Hondón de los Frailes,709,369,340
03,Alicante/Alacant,79,Ibi,22744,11332,11412
03,Alicante/Alacant,80,Jacarilla,1638,822,816
03,Alicante/Alacant,81,Jalón/Xaló,2404,1187,1217
03,Alicante/Alacant,82,Jávea/Xàbia,28493,14375,14118
03,Alicante/Alacant,83,Jijona/Xixona,7369,3492,3877
03,Alicante/Alacant,84,Lorcha/Orxa (l'),735,366,369
03,Alicante/Alacant,85,Llíber,757,380,377
03,Alicante/Alacant,86,Millena,178,87,91
03,Alicante/Alacant,88,Monforte del Cid,5705,2976,2729
03,Alicante/Alacant,89,Monóvar/Monòver,12369,6117,6252
03,Alicante/Alacant,903,Montesinos (Los),2964,1514,1450
03,Alicante/Alacant,91,Murla,446,212,234
03,Alicante/Alacant,92,Muro de Alcoy,7652,3816,3836
03,Alicante/Alacant,90,Mutxamel,16971,8435,8536
03,Alicante/Alacant,93,Novelda,25399,12721,12678
03,Alicante/Alacant,94,Nucia (la),11522,5791,5731
03,Alicante/Alacant,95,Ondara,5712,2902,2810
03,Alicante/Alacant,96,Onil,7144,3562,3582
03,Alicante/Alacant,97,Orba,1824,889,935
03,Alicante/Alacant,99,Orihuela,67731,34354,33377
03,Alicante/Alacant,98,Orxeta,285,144,141
03,Alicante/Alacant,100,Parcent,896,438,458
03,Alicante/Alacant,101,Pedreguer,6483,3230,3253
03,Alicante/Alacant,102,Pego,10659,5500,5159
03,Alicante/Alacant,103,Penàguila,358,183,175
03,Alicante/Alacant,104,Petrer,31255,15601,15654
03,Alicante/Alacant,902,Pilar de la Horadada,14958,8036,6922
03,Alicante/Alacant,105,Pinoso,6645,3333,3312
03,Alicante/Alacant,106,Planes,789,393,396
03,Alicante/Alacant,901,Poblets (els),2274,1092,1182
03,Alicante/Alacant,107,Polop,2489,1258,1231
03,Alicante/Alacant,60,Quatretondeta,160,83,77
03,Alicante/Alacant,109,Rafal,3506,1781,1725
03,Alicante/Alacant,110,"Ràfol d'Almúnia, el",498,247,251
03,Alicante/Alacant,111,Redován,5956,3048,2908
03,Alicante/Alacant,112,Relleu,856,429,427
03,Alicante/Alacant,113,Rojales,10681,5363,5318
03,Alicante/Alacant,114,Romana (la),2122,1080,1042
03,Alicante/Alacant,115,Sagra,421,206,215
03,Alicante/Alacant,116,Salinas,1388,706,682
03,Alicante/Alacant,118,San Fulgencio,5700,2890,2810
03,Alicante/Alacant,904,San Isidro,1338,696,642
03,Alicante/Alacant,120,San Miguel de Salinas,5333,2731,2602
03,Alicante/Alacant,122,San Vicente del Raspeig/Sant Vicent del Raspeig,42647,21208,21439
03,Alicante/Alacant,117,Sanet y Negrals,600,281,319
03,Alicante/Alacant,119,Sant Joan d'Alacant,18107,8893,9214
03,Alicante/Alacant,121,Santa Pola,22253,11157,11096
03,Alicante/Alacant,123,Sax,8953,4497,4456
03,Alicante/Alacant,124,Sella,591,303,288
03,Alicante/Alacant,125,Senija,542,285,257
03,Alicante/Alacant,127,Tárbena,736,373,363
03,Alicante/Alacant,128,Teulada,12299,6211,6088
03,Alicante/Alacant,129,Tibi,1299,678,621
03,Alicante/Alacant,130,Tollos,38,22,16
03,Alicante/Alacant,131,Tormos,303,148,155
03,Alicante/Alacant,132,Torremanzanas/Torre de les Maçanes (la),709,368,341
03,Alicante/Alacant,133,Torrevieja,77943,39515,38428
03,Alicante/Alacant,134,Vall d'Alcalà (la),176,89,87
03,Alicante/Alacant,135,Vall de Ebo,323,161,162
03,Alicante/Alacant,136,Vall de Gallinera,595,310,285
03,Alicante/Alacant,137,Vall de Laguar (la),884,416,468
03,Alicante/Alacant,138,Verger (el),4071,2061,2010
03,Alicante/Alacant,139,Villajoyosa/Vila Joiosa (la),26433,13219,13214
03,Alicante/Alacant,140,Villena,33455,16555,16900
04,Almería,1,Abla,1480,741,739
04,Almería,2,Abrucena,1391,689,702
04,Almería,3,Adra,21704,10939,10765
04,Almería,4,Albánchez,638,331,307
04,Almería,5,Alboloduy,765,367,398
04,Almería,6,Albox,10409,5460,4949
04,Almería,7,Alcolea,1018,522,496
04,Almería,8,Alcóntar,627,328,299
04,Almería,9,Alcudia de Monteagud,152,76,76
04,Almería,10,Alhabia,676,329,347
04,Almería,11,Alhama de Almería,3253,1633,1620
04,Almería,12,Alicún,242,123,119
04,Almería,13,Almería,176727,86072,90655
04,Almería,14,Almócita,161,85,76
04,Almería,15,Alsodux,109,55,54
04,Almería,16,Antas,3026,1537,1489
04,Almería,17,Arboleas,2000,1011,989
04,Almería,18,Armuña de Almanzora,303,154,149
04,Almería,19,Bacares,287,146,141
04,Almería,20,Bayárcal,315,167,148
04,Almería,21,Bayarque,233,115,118
04,Almería,22,Bédar,668,345,323
04,Almería,23,Beires,121,58,63
04,Almería,24,Benahadux,2983,1442,1541
04,Almería,26,Benitagla,68,38,30
04,Almería,27,Benizalón,305,153,152
04,Almería,28,Bentarique,281,148,133
04,Almería,29,Berja,13670,6725,6945
04,Almería,30,Canjáyar,1582,821,761
04,Almería,31,Cantoria,3230,1633,1597
04,Almería,32,Carboneras,6996,3585,3411
04,Almería,33,Castro de Filabres,166,80,86
04,Almería,34,Cóbdar,233,117,116
04,Almería,35,Cuevas del Almanzora,10695,5500,5195
04,Almería,36,Chercos,286,151,135
04,Almería,37,Chirivel,1776,885,891
04,Almería,38,Dalías,3660,1811,1849
04,Almería,902,Ejido (El),61265,33534,27731
04,Almería,41,Enix,302,163,139
04,Almería,43,Felix,557,285,272
04,Almería,44,Fines,1903,993,910
04,Almería,45,Fiñana,2450,1207,1243
04,Almería,46,Fondón,943,487,456
04,Almería,47,Gádor,2717,1379,1338
04,Almería,48,Gallardos (Los),2252,1162,1090
04,Almería,49,Garrucha,6123,3135,2988
04,Almería,50,Gérgal,1062,535,527
04,Almería,51,Huécija,551,278,273
04,Almería,52,Huércal de Almería,9298,4741,4557
04,Almería,53,Huércal-Overa,15059,7426,7633
04,Almería,54,Illar,435,212,223
04,Almería,55,Instinción,533,261,272
04,Almería,56,Laroya,102,54,48
04,Almería,57,Láujar de Andarax,1827,900,927
04,Almería,58,Líjar,514,260,254
04,Almería,59,Lubrín,1636,775,861
04,Almería,60,Lucainena de las Torres,621,338,283
04,Almería,61,Lúcar,791,390,401
04,Almería,62,Macael,5893,3016,2877
04,Almería,63,María,1595,809,786
04,Almería,64,Mojácar,5959,2973,2986
04,Almería,903,Mojonera (La),7670,4260,3410
04,Almería,65,Nacimiento,466,243,223
04,Almería,66,Níjar,20810,11611,9199
04,Almería,67,Ohanes,766,385,381
04,Almería,68,Olula de Castro,165,87,78
04,Almería,69,Olula del Río,6338,3188,3150
04,Almería,70,Oria,2293,1175,1118
04,Almería,71,Padules,449,220,229
04,Almería,72,Partaloa,469,229,240
04,Almería,73,Paterna del Río,419,220,199
04,Almería,74,Pechina,3024,1521,1503
04,Almería,75,Pulpí,7353,3873,3480
04,Almería,76,Purchena,1676,859,817
04,Almería,77,Rágol,386,182,204
04,Almería,78,Rioja,1213,600,613
04,Almería,79,Roquetas de Mar,53815,27701,26114
04,Almería,80,Santa Cruz de Marchena,204,95,109
04,Almería,81,Santa Fe de Mondújar,437,216,221
04,Almería,82,Senés,309,154,155
04,Almería,83,Serón,2414,1182,1232
04,Almería,84,Sierro,452,219,233
04,Almería,85,Somontín,501,249,252
04,Almería,86,Sorbas,2749,1450,1299
04,Almería,87,Suflí,242,125,117
04,Almería,88,Tabernas,3110,1614,1496
04,Almería,89,Taberno,1032,525,507
04,Almería,90,Tahal,373,191,182
04,Almería,91,Terque,470,246,224
04,Almería,92,Tíjola,3798,1865,1933
04,Almería,901,Tres Villas (Las),663,344,319
04,Almería,93,Turre,2547,1283,1264
04,Almería,94,Turrillas,235,131,104
04,Almería,95,Uleila del Campo,995,506,489
04,Almería,96,Urrácal,330,159,171
04,Almería,97,Velefique,284,147,137
04,Almería,98,Vélez-Blanco,2052,1063,989
04,Almería,99,Vélez-Rubio,6736,3287,3449
04,Almería,100,Vera,8717,4393,4324
04,Almería,101,Viator,3793,1905,1888
04,Almería,102,Vícar,16747,8810,7937
04,Almería,103,Zurgena,2184,1094,1090
05,Ávila,1,Adanero,323,172,151
05,Ávila,2,Adrada (La),2025,1047,978
05,Ávila,5,Albornos,222,124,98
05,Ávila,7,Aldeanueva de Santa Cruz,179,98,81
05,Ávila,8,Aldeaseca,319,159,160
05,Ávila,10,Aldehuela (La),242,120,122
05,Ávila,12,Amavida,190,98,92
05,Ávila,13,Arenal (El),1042,511,531
05,Ávila,14,Arenas de San Pedro,6581,3231,3350
05,Ávila,15,Arevalillo,126,62,64
05,Ávila,16,Arévalo,7614,3681,3933
05,Ávila,17,Aveinte,113,59,54
05,Ávila,18,Avellaneda,39,18,21
05,Ávila,19,Ávila,52078,24925,27153
05,Ávila,21,Barco de Ávila (El),2419,1168,1251
05,Ávila,22,Barraco (El),2064,1034,1030
05,Ávila,23,Barromán,229,128,101
05,Ávila,24,Becedas,376,192,184
05,Ávila,25,Becedillas,150,80,70
05,Ávila,26,Bercial de Zapardiel,297,142,155
05,Ávila,27,Berlanas (Las),356,189,167
05,Ávila,29,Bernuy-Zapardiel,199,111,88
05,Ávila,30,Berrocalejo de Aragona,56,33,23
05,Ávila,33,Blascomillán,265,122,143
05,Ávila,34,Blasconuño de Matacabras,19,10,9
05,Ávila,35,Blascosancho,135,69,66
05,Ávila,36,Bohodón (El),165,85,80
05,Ávila,37,Bohoyo,424,216,208
05,Ávila,38,Bonilla de la Sierra,175,98,77
05,Ávila,39,Brabos,67,38,29
05,Ávila,40,Bularros,102,56,46
05,Ávila,41,Burgohondo,1183,607,576
05,Ávila,42,Cabezas de Alambre,209,106,103
05,Ávila,43,Cabezas del Pozo,143,75,68
05,Ávila,44,Cabezas del Villar,424,221,203
05,Ávila,45,Cabizuela,134,68,66
05,Ávila,46,Canales,59,31,28
05,Ávila,47,Candeleda,5026,2611,2415
05,Ávila,48,Cantiveros,181,93,88
05,Ávila,49,Cardeñosa,524,277,247
05,Ávila,51,Carrera (La),251,126,125
05,Ávila,52,Casas del Puerto de Villatoro,113,58,55
05,Ávila,53,Casasola,136,73,63
05,Ávila,54,Casavieja,1505,788,717
05,Ávila,55,Casillas,800,418,382
05,Ávila,56,Castellanos de Zapardiel,131,72,59
05,Ávila,57,Cebreros,3223,1622,1601
05,Ávila,58,Cepeda la Mora,123,68,55
05,Ávila,59,Cillán,137,76,61
05,Ávila,60,Cisla,189,97,92
05,Ávila,61,Colilla (La),222,110,112
05,Ávila,62,Collado de Contreras,256,139,117
05,Ávila,63,Collado del Mirón,71,39,32
05,Ávila,64,Constanzana,175,98,77
05,Ávila,65,Crespos,663,342,321
05,Ávila,66,Cuevas del Valle,589,318,271
05,Ávila,67,Chamartín,107,63,44
05,Ávila,903,Diego del Carpio,268,140,128
05,Ávila,69,Donjimeno,133,72,61
05,Ávila,70,Donvidas,72,37,35
05,Ávila,72,Espinosa de los Caballeros,103,60,43
05,Ávila,73,Flores de Ávila,402,212,190
05,Ávila,74,Fontiveros,968,495,473
05,Ávila,75,Fresnedilla,96,41,55
05,Ávila,76,Fresno (El),500,259,241
05,Ávila,77,Fuente el Saúz,275,150,125
05,Ávila,78,Fuentes de Año,168,93,75
05,Ávila,79,Gallegos de Altamiros,97,56,41
05,Ávila,80,Gallegos de Sobrinos,98,48,50
05,Ávila,81,Garganta del Villar,62,35,27
05,Ávila,82,Gavilanes,701,396,305
05,Ávila,83,Gemuño,198,96,102
05,Ávila,85,Gil García,58,26,32
05,Ávila,84,Gilbuena,106,59,47
05,Ávila,86,Gimialcón,101,58,43
05,Ávila,87,Gotarrendura,168,62,106
05,Ávila,88,Grandes y San Martín,49,25,24
05,Ávila,89,Guisando,636,335,301
05,Ávila,90,Gutierre-Muñoz,128,63,65
05,Ávila,92,Hernansancho,215,114,101
05,Ávila,93,Herradón de Pinares,515,269,246
05,Ávila,94,Herreros de Suso,205,104,101
05,Ávila,95,Higuera de las Dueñas,309,178,131
05,Ávila,96,Hija de Dios (La),91,50,41
05,Ávila,97,Horcajada (La),726,356,370
05,Ávila,99,Horcajo de las Torres,731,407,324
05,Ávila,100,Hornillo (El),399,201,198
05,Ávila,102,Hoyo de Pinares (El),2275,1179,1096
05,Ávila,101,Hoyocasero,386,196,190
05,Ávila,103,Hoyorredondo,113,61,52
05,Ávila,106,Hoyos de Miguel Muñoz,48,26,22
05,Ávila,104,Hoyos del Collado,43,26,17
05,Ávila,105,Hoyos del Espino,451,254,197
05,Ávila,107,Hurtumpascual,108,64,44
05,Ávila,108,Junciana,95,52,43
05,Ávila,109,Langa,574,298,276
05,Ávila,110,Lanzahíta,936,490,446
05,Ávila,112,Losar del Barco (El),124,60,64
05,Ávila,113,Llanos de Tormes (Los),114,58,56
05,Ávila,114,Madrigal de las Altas Torres,1894,968,926
05,Ávila,115,Maello,659,336,323
05,Ávila,116,Malpartida de Corneja,186,94,92
05,Ávila,117,Mamblas,263,149,114
05,Ávila,118,Mancera de Arriba,126,67,59
05,Ávila,119,Manjabálago,59,28,31
05,Ávila,120,Marlín,37,22,15
05,Ávila,121,Martiherrero,180,96,84
05,Ávila,122,Martínez,214,117,97
05,Ávila,123,Mediana de Voltoya,110,58,52
05,Ávila,124,Medinilla,181,85,96
05,Ávila,125,Mengamuñoz,69,32,37
05,Ávila,126,Mesegar de Corneja,106,55,51
05,Ávila,127,Mijares,898,459,439
05,Ávila,128,Mingorría,462,238,224
05,Ávila,129,Mirón (El),222,133,89
05,Ávila,130,Mironcillo,140,76,64
05,Ávila,131,Mirueña de los Infanzones,167,86,81
05,Ávila,132,Mombeltrán,1128,580,548
05,Ávila,133,Monsalupe,78,34,44
05,Ávila,134,Moraleja de Matacabras,70,35,35
05,Ávila,135,Muñana,541,272,269
05,Ávila,136,Muñico,133,70,63
05,Ávila,138,Muñogalindo,436,240,196
05,Ávila,139,Muñogrande,96,50,46
05,Ávila,140,Muñomer del Peco,123,63,60
05,Ávila,141,Muñopepe,106,60,46
05,Ávila,142,Muñosancho,147,68,79
05,Ávila,143,Muñotello,107,56,51
05,Ávila,144,Narrillos del Álamo,137,73,64
05,Ávila,145,Narrillos del Rebollar,64,35,29
05,Ávila,149,Narros de Saldueña,154,87,67
05,Ávila,147,Narros del Castillo,217,119,98
05,Ávila,148,Narros del Puerto,46,25,21
05,Ávila,152,Nava de Arévalo,955,495,460
05,Ávila,153,Nava del Barco,150,74,76
05,Ávila,151,Navacepedilla de Corneja,166,90,76
05,Ávila,154,Navadijos,57,33,24
05,Ávila,155,Navaescurial,75,42,33
05,Ávila,156,Navahondilla,175,96,79
05,Ávila,157,Navalacruz,268,130,138
05,Ávila,158,Navalmoral,509,269,240
05,Ávila,159,Navalonguilla,412,209,203
05,Ávila,160,Navalosa,455,240,215
05,Ávila,161,Navalperal de Pinares,733,356,377
05,Ávila,162,Navalperal de Tormes,123,69,54
05,Ávila,163,Navaluenga,2052,1037,1015
05,Ávila,164,Navaquesera,49,20,29
05,Ávila,165,Navarredonda de Gredos,471,243,228
05,Ávila,166,Navarredondilla,267,128,139
05,Ávila,167,Navarrevisca,384,190,194
05,Ávila,168,Navas del Marqués (Las),4649,2394,2255
05,Ávila,169,Navatalgordo,310,160,150
05,Ávila,170,Navatejares,75,36,39
05,Ávila,171,Neila de San Miguel,107,60,47
05,Ávila,172,Niharra,189,98,91
05,Ávila,173,Ojos-Albos,59,36,23
05,Ávila,174,Orbita,100,46,54
05,Ávila,175,Oso (El),223,124,99
05,Ávila,176,Padiernos,232,123,109
05,Ávila,177,Pajares de Adaja,178,94,84
05,Ávila,178,Palacios de Goda,463,230,233
05,Ávila,179,Papatrigo,307,162,145
05,Ávila,180,Parral (El),125,67,58
05,Ávila,181,Pascualcobo,46,27,19
05,Ávila,182,Pedro Bernardo,1141,584,557
05,Ávila,183,Pedro-Rodríguez,225,110,115
05,Ávila,184,Peguerinos,308,165,143
05,Ávila,185,Peñalba de Ávila,128,71,57
05,Ávila,186,Piedrahíta,2056,1002,1054
05,Ávila,187,Piedralaves,2098,1058,1040
05,Ávila,188,Poveda,81,48,33
05,Ávila,189,Poyales del Hoyo,649,319,330
05,Ávila,190,Pozanco,57,33,24
05,Ávila,191,Pradosegar,168,95,73
05,Ávila,192,Puerto Castilla,147,84,63
05,Ávila,193,Rasueros,309,164,145
05,Ávila,194,Riocabado,200,110,90
05,Ávila,195,Riofrío,333,187,146
05,Ávila,196,Rivilla de Barajas,90,46,44
05,Ávila,197,Salobral,122,64,58
05,Ávila,198,Salvadiós,114,58,56
05,Ávila,199,San Bartolomé de Béjar,64,27,37
05,Ávila,200,San Bartolomé de Corneja,85,45,40
05,Ávila,201,San Bartolomé de Pinares,710,380,330
05,Ávila,206,San Esteban de los Patos,43,23,20
05,Ávila,208,San Esteban de Zapardiel,68,38,30
05,Ávila,207,San Esteban del Valle,869,450,419
05,Ávila,209,San García de Ingelmos,147,81,66
05,Ávila,901,San Juan de Gredos,402,217,185
05,Ávila,210,San Juan de la Encinilla,125,61,64
05,Ávila,211,San Juan de la Nava,643,335,308
05,Ávila,212,San Juan del Molinillo,333,190,143
05,Ávila,213,San Juan del Olmo,160,91,69
05,Ávila,214,San Lorenzo de Tormes,49,23,26
05,Ávila,215,San Martín de la Vega del Alberche,264,151,113
05,Ávila,216,San Martín del Pimpollar,292,160,132
05,Ávila,217,San Miguel de Corneja,106,50,56
05,Ávila,218,San Miguel de Serrezuela,193,104,89
05,Ávila,219,San Pascual,51,33,18
05,Ávila,220,San Pedro del Arroyo,487,244,243
05,Ávila,231,San Vicente de Arévalo,228,113,115
05,Ávila,204,Sanchidrián,760,381,379
05,Ávila,205,Sanchorreja,138,66,72
05,Ávila,222,Santa Cruz de Pinares,205,109,96
05,Ávila,221,Santa Cruz del Valle,532,275,257
05,Ávila,226,Santa María de los Caballeros,120,62,58
05,Ávila,224,Santa María del Arroyo,122,65,57
05,Ávila,225,Santa María del Berrocal,528,251,277
05,Ávila,902,Santa María del Cubillo,400,227,173
05,Ávila,227,Santa María del Tiétar,411,216,195
05,Ávila,228,Santiago del Collado,262,164,98
05,Ávila,904,Santiago del Tormes,215,108,107
05,Ávila,229,Santo Domingo de las Posadas,99,51,48
05,Ávila,230,Santo Tomé de Zabarcos,93,53,40
05,Ávila,232,Serrada (La),139,71,68
05,Ávila,233,Serranillos,373,196,177
05,Ávila,234,Sigeres,76,37,39
05,Ávila,235,Sinlabajos,208,113,95
05,Ávila,236,Solana de Ávila,201,107,94
05,Ávila,237,Solana de Rioalmar,270,142,128
05,Ávila,238,Solosancho,1043,546,497
05,Ávila,239,Sotalbo,274,146,128
05,Ávila,240,Sotillo de la Adrada,3806,1879,1927
05,Ávila,241,Tiemblo (El),3640,1833,1807
05,Ávila,242,Tiñosillos,788,417,371
05,Ávila,243,Tolbaños,115,55,60
05,Ávila,244,Tormellas,99,53,46
05,Ávila,245,Tornadizos de Ávila,376,186,190
05,Ávila,247,Torre (La),372,206,166
05,Ávila,246,Tórtoles,108,57,51
05,Ávila,249,Umbrías,156,83,73
05,Ávila,251,Vadillo de la Sierra,127,66,61
05,Ávila,252,Valdecasa,100,53,47
05,Ávila,253,Vega de Santa María,138,79,59
05,Ávila,254,Velayos,243,118,125
05,Ávila,256,Villaflor,153,79,74
05,Ávila,257,Villafranca de la Sierra,181,94,87
05,Ávila,905,Villanueva de Ávila,349,176,173
05,Ávila,258,Villanueva de Gómez,143,68,75
05,Ávila,259,Villanueva del Aceral,169,78,91
05,Ávila,260,Villanueva del Campillo,189,100,89
05,Ávila,261,Villar de Corneja,74,38,36
05,Ávila,262,Villarejo del Valle,496,258,238
05,Ávila,263,Villatoro,230,131,99
05,Ávila,264,Viñegra de Moraña,92,48,44
05,Ávila,265,Vita,108,68,40
05,Ávila,266,Zapardiel de la Cañada,157,76,81
05,Ávila,267,Zapardiel de la Ribera,127,60,67
06,Badajoz,1,Acedera,904,471,433
06,Badajoz,2,Aceuchal,5322,2628,2694
06,Badajoz,3,Ahillones,1124,556,568
06,Badajoz,4,Alange,2021,1040,981
06,Badajoz,5,Albuera (La),1797,911,886
06,Badajoz,6,Alburquerque,5614,2830,2784
06,Badajoz,7,Alconchel,1986,1011,975
06,Badajoz,8,Alconera,725,359,366
06,Badajoz,9,Aljucén,239,128,111
06,Badajoz,10,Almendral,1377,676,701
06,Badajoz,11,Almendralejo,28595,14114,14481
06,Badajoz,12,Arroyo de San Serván,3926,2017,1909
06,Badajoz,13,Atalaya,350,168,182
06,Badajoz,14,Azuaga,8402,4274,4128
06,Badajoz,15,Badajoz,138415,67081,71334
06,Badajoz,16,Barcarrota,3675,1870,1805
06,Badajoz,17,Baterno,375,194,181
06,Badajoz,18,Benquerencia de la Serena,972,483,489
06,Badajoz,19,Berlanga,2580,1250,1330
06,Badajoz,20,Bienvenida,2361,1216,1145
06,Badajoz,21,Bodonal de la Sierra,1197,612,585
06,Badajoz,22,Burguillos del Cerro,3193,1522,1671
06,Badajoz,23,Cabeza del Buey,5809,2851,2958
06,Badajoz,24,Cabeza la Vaca,1601,799,802
06,Badajoz,25,Calamonte,6108,3057,3051
06,Badajoz,26,Calera de León,1074,535,539
06,Badajoz,27,Calzadilla de los Barros,845,417,428
06,Badajoz,28,Campanario,5677,2762,2915
06,Badajoz,29,Campillo de Llerena,1682,827,855
06,Badajoz,30,Capilla,203,99,104
06,Badajoz,31,Carmonita,644,332,312
06,Badajoz,32,Carrascalejo (El),76,40,36
06,Badajoz,33,Casas de Don Pedro,1700,835,865
06,Badajoz,34,Casas de Reina,213,98,115
06,Badajoz,35,Castilblanco,1233,599,634
06,Badajoz,36,Castuera,6847,3389,3458
06,Badajoz,37,Codosera (La),2248,1185,1063
06,Badajoz,38,Cordobilla de Lácara,1030,523,507
06,Badajoz,39,Coronada (La),2367,1171,1196
06,Badajoz,40,Corte de Peleas,1253,622,631
06,Badajoz,41,Cristina,543,290,253
06,Badajoz,42,Cheles,1307,655,652
06,Badajoz,43,Don Álvaro,651,322,329
06,Badajoz,44,Don Benito,32168,15853,16315
06,Badajoz,45,Entrín Bajo,623,311,312
06,Badajoz,46,Esparragalejo,1513,733,780
06,Badajoz,47,Esparragosa de la Serena,1123,555,568
06,Badajoz,48,Esparragosa de Lares,1078,527,551
06,Badajoz,49,Feria,1424,707,717
06,Badajoz,50,Fregenal de la Sierra,5257,2533,2724
06,Badajoz,51,Fuenlabrada de los Montes,1981,986,995
06,Badajoz,52,Fuente de Cantos,5012,2486,2526
06,Badajoz,53,Fuente del Arco,744,377,367
06,Badajoz,54,Fuente del Maestre,6789,3377,3412
06,Badajoz,55,Fuentes de León,2683,1325,1358
06,Badajoz,56,Garbayuela,549,291,258
06,Badajoz,57,Garlitos,752,383,369
06,Badajoz,58,Garrovilla (La),2557,1294,1263
06,Badajoz,59,Granja de Torrehermosa,2477,1220,1257
06,Badajoz,60,Guareña,7329,3691,3638
06,Badajoz,61,Haba (La),1451,733,718
06,Badajoz,62,Helechosa de los Montes,750,425,325
06,Badajoz,63,Herrera del Duque,3741,1896,1845
06,Badajoz,64,Higuera de la Serena,1157,600,557
06,Badajoz,65,Higuera de Llerena,409,202,207
06,Badajoz,66,Higuera de Vargas,2166,1084,1082
06,Badajoz,67,Higuera la Real,2521,1281,1240
06,Badajoz,68,Hinojosa del Valle,585,298,287
06,Badajoz,69,Hornachos,3827,1966,1861
06,Badajoz,70,Jerez de los Caballeros,9664,4811,4853
06,Badajoz,71,Lapa (La),314,162,152
06,Badajoz,72,Lobón,2627,1362,1265
06,Badajoz,73,Llera,953,492,461
06,Badajoz,74,Llerena,5588,2739,2849
06,Badajoz,75,Magacela,646,335,311
06,Badajoz,76,Maguilla,1112,555,557
06,Badajoz,77,Malcocinado,521,278,243
06,Badajoz,78,Malpartida de la Serena,750,384,366
06,Badajoz,79,Manchita,754,381,373
06,Badajoz,80,Medellín,2357,1195,1162
06,Badajoz,81,Medina de las Torres,1446,710,736
06,Badajoz,82,Mengabril,452,232,220
06,Badajoz,83,Mérida,52110,25299,26811
06,Badajoz,84,Mirandilla,1344,677,667
06,Badajoz,85,Monesterio,4399,2225,2174
06,Badajoz,86,Montemolín,1632,846,786
06,Badajoz,87,Monterrubio de la Serena,2823,1357,1466
06,Badajoz,88,Montijo,15422,7628,7794
06,Badajoz,89,Morera (La),781,391,390
06,Badajoz,90,Nava de Santiago (La),1131,567,564
06,Badajoz,91,Navalvillar de Pela,4860,2466,2394
06,Badajoz,92,Nogales,736,365,371
06,Badajoz,93,Oliva de la Frontera,5835,2884,2951
06,Badajoz,94,Oliva de Mérida,1903,936,967
06,Badajoz,95,Olivenza,11018,5483,5535
06,Badajoz,96,Orellana de la Sierra,323,171,152
06,Badajoz,97,Orellana la Vieja,3237,1626,1611
06,Badajoz,98,Palomas,725,379,346
06,Badajoz,99,Parra (La),1420,715,705
06,Badajoz,100,Peñalsordo,1410,688,722
06,Badajoz,101,Peraleda del Zaucejo,612,310,302
06,Badajoz,102,Puebla de Alcocer,1368,670,698
06,Badajoz,103,Puebla de la Calzada,5547,2720,2827
06,Badajoz,104,Puebla de la Reina,908,471,437
06,Badajoz,107,Puebla de Obando,2032,1029,1003
06,Badajoz,108,Puebla de Sancho Pérez,2872,1442,1430
06,Badajoz,105,Puebla del Maestre,876,427,449
06,Badajoz,106,Puebla del Prior,551,276,275
06,Badajoz,902,Pueblonuevo del Guadiana,1976,1005,971
06,Badajoz,109,Quintana de la Serena,5210,2647,2563
06,Badajoz,110,Reina,209,105,104
06,Badajoz,111,Rena,641,311,330
06,Badajoz,112,Retamal de Llerena,523,276,247
06,Badajoz,113,Ribera del Fresno,3372,1660,1712
06,Badajoz,114,Risco,206,99,107
06,Badajoz,115,Roca de la Sierra (La),1586,787,799
06,Badajoz,116,Salvaleón,2181,1091,1090
06,Badajoz,117,Salvatierra de los Barros,1886,953,933
06,Badajoz,119,San Pedro de Mérida,821,414,407
06,Badajoz,123,San Vicente de Alcántara,5883,2902,2981
06,Badajoz,118,Sancti-Spíritus,263,125,138
06,Badajoz,120,Santa Amalia,4394,2207,2187
06,Badajoz,121,Santa Marta,4124,2041,2083
06,Badajoz,122,Santos de Maimona (Los),7862,3928,3934
06,Badajoz,124,Segura de León,2241,1126,1115
06,Badajoz,125,Siruela,2329,1161,1168
06,Badajoz,126,Solana de los Barros,2710,1361,1349
06,Badajoz,127,Talarrubias,3599,1781,1818
06,Badajoz,128,Talavera la Real,5204,2622,2582
06,Badajoz,129,Táliga,719,360,359
06,Badajoz,130,Tamurejo,270,137,133
06,Badajoz,131,Torre de Miguel Sesmero,1249,623,626
06,Badajoz,132,Torremayor,1017,486,531
06,Badajoz,133,Torremejía,2108,1088,1020
06,Badajoz,134,Trasierra,706,373,333
06,Badajoz,135,Trujillanos,1324,698,626
06,Badajoz,136,Usagre,2033,1026,1007
06,Badajoz,137,Valdecaballeros,1330,668,662
06,Badajoz,901,Valdelacalzada,2572,1337,1235
06,Badajoz,138,Valdetorres,1355,680,675
06,Badajoz,139,Valencia de las Torres,760,388,372
06,Badajoz,140,Valencia del Mombuey,795,398,397
06,Badajoz,141,Valencia del Ventoso,2279,1132,1147
06,Badajoz,142,Valverde de Burguillos,355,180,175
06,Badajoz,143,Valverde de Leganés,3786,1910,1876
06,Badajoz,144,Valverde de Llerena,790,371,419
06,Badajoz,145,Valverde de Mérida,1131,557,574
06,Badajoz,146,Valle de la Serena,1510,732,778
06,Badajoz,147,Valle de Matamoros,473,233,240
06,Badajoz,148,Valle de Santa Ana,1223,620,603
06,Badajoz,149,Villafranca de los Barros,12614,6242,6372
06,Badajoz,150,Villagarcía de la Torre,1010,505,505
06,Badajoz,151,Villagonzalo,1373,673,700
06,Badajoz,152,Villalba de los Barros,1667,851,816
06,Badajoz,153,Villanueva de la Serena,24512,12034,12478
06,Badajoz,154,Villanueva del Fresno,3493,1726,1767
06,Badajoz,156,Villar de Rena,1571,817,754
06,Badajoz,155,Villar del Rey,2303,1190,1113
06,Badajoz,157,Villarta de los Montes,641,313,328
06,Badajoz,158,Zafra,15477,7460,8017
06,Badajoz,159,Zahínos,2995,1513,1482
06,Badajoz,160,Zalamea de la Serena,4431,2189,2242
06,Badajoz,162,Zarza (La),3585,1804,1781
06,Badajoz,161,Zarza-Capilla,479,249,230
07,Balears (Illes),2,Alaior,8197,4121,4076
07,Balears (Illes),1,Alaró,4540,2226,2314
07,Balears (Illes),3,Alcúdia,14690,7493,7197
07,Balears (Illes),4,Algaida,3997,2059,1938
07,Balears (Illes),5,Andratx,9841,4937,4904
07,Balears (Illes),901,Ariany,783,397,386
07,Balears (Illes),6,Artà,6578,3303,3275
07,Balears (Illes),7,Banyalbufar,584,317,267
07,Balears (Illes),8,Binissalem,5874,2899,2975
07,Balears (Illes),9,Búger,984,504,480
07,Balears (Illes),10,Bunyola,5237,2626,2611
07,Balears (Illes),11,Calvià,42983,21775,21208
07,Balears (Illes),12,Campanet,2437,1207,1230
07,Balears (Illes),13,Campos,7625,3848,3777
07,Balears (Illes),14,Capdepera,9561,4797,4764
07,Balears (Illes),64,Castell (Es),7022,3541,3481
07,Balears (Illes),15,Ciutadella de Menorca,25406,12717,12689
07,Balears (Illes),16,Consell,2586,1297,1289
07,Balears (Illes),17,Costitx,973,478,495
07,Balears (Illes),18,Deyá,749,394,355
07,Balears (Illes),26,Eivissa,40175,20386,19789
07,Balears (Illes),19,Escorca,307,170,137
07,Balears (Illes),20,Esporles,4322,2135,2187
07,Balears (Illes),21,Estellencs,388,205,183
07,Balears (Illes),22,Felanitx,16459,8376,8083
07,Balears (Illes),23,Ferreries,4290,2235,2055
07,Balears (Illes),24,Formentera,7607,3909,3698
07,Balears (Illes),25,Fornalutx,678,345,333
07,Balears (Illes),27,Inca,25362,12793,12569
07,Balears (Illes),28,Lloret de Vistalegre,1058,534,524
07,Balears (Illes),29,Lloseta,5119,2603,2516
07,Balears (Illes),30,Llubí,1955,973,982
07,Balears (Illes),31,Llucmajor,27759,14004,13755
07,Balears (Illes),32,Mahón,26066,12884,13182
07,Balears (Illes),33,Manacor,34335,17310,17025
07,Balears (Illes),34,Mancor de la Vall,963,476,487
07,Balears (Illes),35,Maria de la Salut,1990,1005,985
07,Balears (Illes),36,Marratxí,25799,13058,12741
07,Balears (Illes),37,Mercadal (Es),3654,1880,1774
07,Balears (Illes),902,Migjorn Gran (Es),1216,621,595
07,Balears (Illes),38,Montuïri,2521,1280,1241
07,Balears (Illes),39,Muro,6572,3345,3227
07,Balears (Illes),40,Palma de Mallorca,367277,180458,186819
07,Balears (Illes),41,Petra,2697,1335,1362
07,Balears (Illes),44,Pobla (Sa),11446,6035,5411
07,Balears (Illes),42,Pollença,15566,7804,7762
07,Balears (Illes),43,Porreres,4568,2401,2167
07,Balears (Illes),45,Puigpunyent,1477,764,713
07,Balears (Illes),59,Salines (Ses),4116,2093,2023
07,Balears (Illes),46,Sant Antoni de Portmany,17261,8883,8378
07,Balears (Illes),49,Sant Joan,1803,913,890
07,Balears (Illes),50,Sant Joan de Labritja,4673,2403,2270
07,Balears (Illes),48,Sant Josep de sa Talaia,17076,8909,8167
07,Balears (Illes),51,Sant Llorenç des Cardassar,7246,3707,3539
07,Balears (Illes),52,Sant Lluís,5216,2608,2608
07,Balears (Illes),53,Santa Eugènia,1358,695,663
07,Balears (Illes),54,Santa Eulalia del Río,25918,13317,12601
07,Balears (Illes),55,Santa Margalida,9074,4598,4476
07,Balears (Illes),56,Santa María del Camí,5074,2524,2550
07,Balears (Illes),57,Santanyí,10253,5230,5023
07,Balears (Illes),58,Selva,3096,1521,1575
07,Balears (Illes),47,Sencelles,2464,1247,1217
07,Balears (Illes),60,Sineu,2868,1420,1448
07,Balears (Illes),61,Sóller,12472,6268,6204
07,Balears (Illes),62,Son Servera,10750,5461,5289
07,Balears (Illes),63,Valldemossa,1820,907,913
07,Balears (Illes),65,Vilafranca de Bonany,2550,1284,1266
08,Barcelona,1,Abrera,9166,4753,4413
08,Barcelona,2,Aguilar de Segarra,224,117,107
08,Barcelona,14,Aiguafreda,2206,1075,1131
08,Barcelona,3,Alella,8847,4408,4439
08,Barcelona,4,Alpens,287,154,133
08,Barcelona,5,Ametlla del Vallès (L'),6757,3364,3393
08,Barcelona,6,Arenys de Mar,13431,6549,6882
08,Barcelona,7,Arenys de Munt,6977,3509,3468
08,Barcelona,8,Argençola,202,110,92
08,Barcelona,9,Argentona,10302,5137,5165
08,Barcelona,10,Artés,4696,2364,2332
08,Barcelona,11,Avià,1935,978,957
08,Barcelona,12,Avinyó,2049,1024,1025
08,Barcelona,13,Avinyonet del Penedès,1334,720,614
08,Barcelona,15,Badalona,214440,106935,107505
08,Barcelona,904,Badia del Vallès,14553,7272,7281
08,Barcelona,16,Bagà,2119,1026,1093
08,Barcelona,17,Balenyà,3280,1638,1642
08,Barcelona,18,Balsareny,3256,1609,1647
08,Barcelona,252,Barberà del Vallès,27153,13642,13511
08,Barcelona,19,Barcelona,1582738,748149,834589
08,Barcelona,20,Begues,5023,2516,2507
08,Barcelona,21,Bellprat,92,51,41
08,Barcelona,22,Berga,15437,7591,7846
08,Barcelona,23,Bigues i Riells,6400,3345,3055
08,Barcelona,24,Borredà,498,257,241
08,Barcelona,25,Bruc (El),1379,723,656
08,Barcelona,26,Brull (El),195,106,89
08,Barcelona,27,Cabanyes (Les),603,313,290
08,Barcelona,29,Cabrera de Mar,3869,1957,1912
08,Barcelona,28,Cabrera d'Igualada,727,399,328
08,Barcelona,30,Cabrils,5703,2786,2917
08,Barcelona,31,Calaf,3110,1601,1509
08,Barcelona,34,Calders,781,396,385
08,Barcelona,33,Caldes de Montbui,13803,6886,6917
08,Barcelona,32,Caldes d'Estrac,2310,1134,1176
08,Barcelona,35,Calella,15400,7576,7824
08,Barcelona,36,Calonge de Segarra,192,98,94
08,Barcelona,37,Calldetenes,2098,1098,1000
08,Barcelona,38,Callús,1417,698,719
08,Barcelona,39,Campins,313,159,154
08,Barcelona,40,Canet de Mar,11722,5812,5910
08,Barcelona,41,Canovelles,13701,7034,6667
08,Barcelona,42,Cànoves i Samalús,2155,1134,1021
08,Barcelona,43,Canyelles,2485,1327,1158
08,Barcelona,44,Capellades,5111,2509,2602
08,Barcelona,45,Capolat,70,35,35
08,Barcelona,46,Cardedeu,13870,6917,6953
08,Barcelona,47,Cardona,5312,2589,2723
08,Barcelona,48,Carme,721,371,350
08,Barcelona,49,Casserres,1547,751,796
08,Barcelona,57,Castell de l'Areny,66,37,29
08,Barcelona,52,Castellar de n'Hug,197,105,92
08,Barcelona,50,Castellar del Riu,138,80,58
08,Barcelona,51,Castellar del Vallès,18934,9482,9452
08,Barcelona,53,Castellbell i el Vilar,3080,1580,1500
08,Barcelona,54,Castellbisbal,9791,5042,4749
08,Barcelona,55,Castellcir,452,243,209
08,Barcelona,56,Castelldefels,52405,26201,26204
08,Barcelona,58,Castellet i la Gornal,1562,794,768
08,Barcelona,60,Castellfollit de Riubregós,217,108,109
08,Barcelona,59,Castellfollit del Boix,389,193,196
08,Barcelona,61,Castellgalí,1066,559,507
08,Barcelona,62,Castellnou de Bages,670,357,313
08,Barcelona,63,Castellolí,441,223,218
08,Barcelona,64,Castellterçol,2168,1063,1105
08,Barcelona,65,Castellví de la Marca,1497,762,735
08,Barcelona,66,Castellví de Rosanes,1281,653,628
08,Barcelona,67,Centelles,6155,3039,3116
08,Barcelona,268,Cercs,1376,699,677
08,Barcelona,266,Cerdanyola del Vallès,55731,27868,27863
08,Barcelona,68,Cervelló,6848,3483,3365
08,Barcelona,69,Collbató,2752,1465,1287
08,Barcelona,70,Collsuspina,283,151,132
08,Barcelona,71,Copons,281,136,145
08,Barcelona,72,Corbera de Llobregat,10903,5565,5338
08,Barcelona,73,Cornellà de Llobregat,82817,41066,41751
08,Barcelona,74,Cubelles,8548,4344,4204
08,Barcelona,75,Dosrius,3504,1768,1736
08,Barcelona,76,Esparreguera,19403,9865,9538
08,Barcelona,77,Esplugues de Llobregat,46447,22826,23621
08,Barcelona,78,Espunyola (L'),270,138,132
08,Barcelona,79,Estany (L'),408,194,214
08,Barcelona,134,Figaró-Montmany,957,491,466
08,Barcelona,80,Fígols,50,29,21
08,Barcelona,82,Fogars de la Selva,920,488,432
08,Barcelona,81,Fogars de Montclús,368,200,168
08,Barcelona,83,Folgueroles,1778,885,893
08,Barcelona,84,Fonollosa,1097,562,535
08,Barcelona,85,Font-rubí,1297,686,611
08,Barcelona,86,Franqueses del Vallès (Les),14121,7163,6958
08,Barcelona,90,Gaià,155,78,77
08,Barcelona,87,Gallifa,200,104,96
08,Barcelona,88,Garriga (La),12634,6153,6481
08,Barcelona,89,Gavà,42304,21173,21131
08,Barcelona,91,Gelida,4929,2510,2419
08,Barcelona,92,Gironella,4908,2408,2500
08,Barcelona,93,Gisclareny,30,17,13
08,Barcelona,94,Granada (La),1479,735,744
08,Barcelona,95,Granera,77,48,29
08,Barcelona,96,Granollers,55913,27710,28203
08,Barcelona,97,Gualba,912,471,441
08,Barcelona,99,Guardiola de Berguedà,937,482,455
08,Barcelona,100,Gurb,2049,1041,1008
08,Barcelona,101,Hospitalet de Llobregat (L'),246415,120707,125708
08,Barcelona,162,Hostalets de Pierola (Els),1611,834,777
08,Barcelona,102,Igualada,34391,16926,17465
08,Barcelona,103,Jorba,599,286,313
08,Barcelona,104,Llacuna (La),884,475,409
08,Barcelona,105,Llagosta (La),12630,6346,6284
08,Barcelona,107,Lliçà d'Amunt,11435,5904,5531
08,Barcelona,108,Lliçà de Vall,5529,2860,2669
08,Barcelona,106,Llinars del Vallès,7631,3833,3798
08,Barcelona,109,Lluçà,263,143,120
08,Barcelona,110,Malgrat de Mar,15614,7862,7752
08,Barcelona,111,Malla,250,116,134
08,Barcelona,112,Manlleu,18549,9440,9109
08,Barcelona,113,Manresa,67269,32913,34356
08,Barcelona,242,Marganell,245,112,133
08,Barcelona,114,Martorell,24549,12663,11886
08,Barcelona,115,Martorelles,4915,2466,2449
08,Barcelona,116,Masies de Roda (Les),697,344,353
08,Barcelona,117,Masies de Voltregà (Les),2922,1433,1489
08,Barcelona,118,Masnou (El),21001,10170,10831
08,Barcelona,119,Masquefa,6209,3191,3018
08,Barcelona,120,Matadepera,7423,3740,3683
08,Barcelona,121,Mataró,111879,55707,56172
08,Barcelona,122,Mediona,1638,855,783
08,Barcelona,138,Moià,4647,2321,2326
08,Barcelona,123,Molins de Rei,21958,10829,11129
08,Barcelona,124,Mollet del Vallès,50001,25332,24669
08,Barcelona,128,Monistrol de Calders,623,309,314
08,Barcelona,127,Monistrol de Montserrat,2559,1296,1263
08,Barcelona,125,Montcada i Reixac,30354,15033,15321
08,Barcelona,130,Montclar,121,62,59
08,Barcelona,131,Montesquiu,851,434,417
08,Barcelona,126,Montgat,8775,4368,4407
08,Barcelona,132,Montmajor,457,239,218
08,Barcelona,133,Montmaneu,193,101,92
08,Barcelona,135,Montmeló,8754,4419,4335
08,Barcelona,136,Montornès del Vallès,13484,6916,6568
08,Barcelona,137,Montseny,310,161,149
08,Barcelona,129,Muntanyola,361,196,165
08,Barcelona,139,Mura,225,118,107
08,Barcelona,140,Navarcles,5442,2698,2744
08,Barcelona,141,Navàs,5629,2798,2831
08,Barcelona,142,Nou de Berguedà (La),155,79,76
08,Barcelona,143,Òdena,2737,1365,1372
08,Barcelona,145,Olèrdola,2578,1335,1243
08,Barcelona,146,Olesa de Bonesvalls,1173,622,551
08,Barcelona,147,Olesa de Montserrat,19800,10056,9744
08,Barcelona,148,Olivella,1737,947,790
08,Barcelona,149,Olost,1192,595,597
08,Barcelona,144,Olvan,896,438,458
08,Barcelona,150,Orís,242,121,121
08,Barcelona,151,Oristà,616,295,321
08,Barcelona,152,Orpí,145,83,62
08,Barcelona,153,Òrrius,350,182,168
08,Barcelona,154,Pacs del Penedès,701,359,342
08,Barcelona,155,Palafolls,6329,3191,3138
08,Barcelona,156,Palau-solità i Plegamans,11919,6068,5851
08,Barcelona,905,Palma de Cervelló (La),2898,1471,1427
08,Barcelona,157,Pallejà,8544,4334,4210
08,Barcelona,158,Papiol (El),3518,1773,1745
08,Barcelona,159,Parets del Vallès,15752,7998,7754
08,Barcelona,160,Perafita,364,176,188
08,Barcelona,161,Piera,10869,5597,5272
08,Barcelona,163,Pineda de Mar,22843,11567,11276
08,Barcelona,164,Pla del Penedès (El),893,449,444
08,Barcelona,165,Pobla de Claramunt (La),1874,977,897
08,Barcelona,166,Pobla de Lillet (La),1359,658,701
08,Barcelona,167,Polinyà,5514,2830,2684
08,Barcelona,182,Pont de Vilomara i Rocafort (El),2838,1457,1381
08,Barcelona,168,Pontons,450,238,212
08,Barcelona,169,Prat de Llobregat (El),63312,31799,31513
08,Barcelona,171,Prats de Lluçanès,2704,1364,1340
08,Barcelona,170,Prats de Rei (Els),530,273,257
08,Barcelona,230,Premià de Dalt,9543,4782,4761
08,Barcelona,172,Premià de Mar,27326,13710,13616
08,Barcelona,174,Puigdàlber,376,175,201
08,Barcelona,175,Puig-reig,4225,2052,2173
08,Barcelona,176,Pujalt,191,100,91
08,Barcelona,177,Quar (La),70,40,30
08,Barcelona,178,Rajadell,405,211,194
08,Barcelona,179,Rellinars,547,278,269
08,Barcelona,180,Ripollet,32429,16383,16046
08,Barcelona,181,Roca del Vallès (La),8362,4220,4142
08,Barcelona,183,Roda de Ter,5361,2625,2736
08,Barcelona,184,Rubí,64848,32720,32128
08,Barcelona,185,Rubió,131,73,58
08,Barcelona,901,Rupit i Pruit,354,178,176
08,Barcelona,187,Sabadell,191057,93221,97836
08,Barcelona,188,Sagàs,146,73,73
08,Barcelona,190,Saldes,325,184,141
08,Barcelona,191,Sallent,7101,3438,3663
08,Barcelona,194,Sant Adrià de Besòs,32845,16232,16613
08,Barcelona,195,Sant Agustí de Lluçanès,104,56,48
08,Barcelona,196,Sant Andreu de la Barca,23307,12003,11304
08,Barcelona,197,Sant Andreu de Llavaneres,8450,4224,4226
08,Barcelona,198,Sant Antoni de Vilamajor,4189,2110,2079
08,Barcelona,199,Sant Bartomeu del Grau,1141,605,536
08,Barcelona,200,Sant Boi de Llobregat,80738,40243,40495
08,Barcelona,201,Sant Boi de Lluçanès,577,293,284
08,Barcelona,203,Sant Cebrià de Vallalta,2195,1181,1014
08,Barcelona,202,Sant Celoni,13759,6901,6858
08,Barcelona,204,Sant Climent de Llobregat,3233,1629,1604
08,Barcelona,205,Sant Cugat del Vallès,63132,31139,31993
08,Barcelona,206,Sant Cugat Sesgarrigues,814,429,385
08,Barcelona,207,Sant Esteve de Palautordera,1699,846,853
08,Barcelona,208,Sant Esteve Sesrovires,5783,2965,2818
08,Barcelona,210,Sant Feliu de Codines,4897,2504,2393
08,Barcelona,211,Sant Feliu de Llobregat,41543,20513,21030
08,Barcelona,212,Sant Feliu Sasserra,649,323,326
08,Barcelona,209,Sant Fost de Campsentelles,6852,3474,3378
08,Barcelona,213,Sant Fruitós de Bages,6342,3181,3161
08,Barcelona,215,Sant Hipòlit de Voltregà,3119,1549,1570
08,Barcelona,193,Sant Iscle de Vallalta,995,528,467
08,Barcelona,216,Sant Jaume de Frontanyà,27,14,13
08,Barcelona,218,Sant Joan de Vilatorrada,9688,4853,4835
08,Barcelona,217,Sant Joan Despí,29982,14823,15159
08,Barcelona,903,Sant Julià de Cerdanyola,240,129,111
08,Barcelona,220,Sant Julià de Vilatorta,2593,1279,1314
08,Barcelona,221,Sant Just Desvern,14809,7099,7710
08,Barcelona,222,Sant Llorenç d'Hortons,1838,926,912
08,Barcelona,223,Sant Llorenç Savall,2166,1100,1066
08,Barcelona,225,Sant Martí d'Albars,125,64,61
08,Barcelona,224,Sant Martí de Centelles,833,430,403
08,Barcelona,226,Sant Martí de Tous,1037,525,512
08,Barcelona,227,Sant Martí Sarroca,2569,1306,1263
08,Barcelona,228,Sant Martí Sesgueioles,350,176,174
08,Barcelona,229,Sant Mateu de Bages,679,332,347
08,Barcelona,231,Sant Pere de Ribes,24741,12518,12223
08,Barcelona,232,Sant Pere de Riudebitlles,2112,1047,1065
08,Barcelona,233,Sant Pere de Torelló,2231,1122,1109
08,Barcelona,234,Sant Pere de Vilamajor,3039,1582,1457
08,Barcelona,189,Sant Pere Sallavinera,153,76,77
08,Barcelona,235,Sant Pol de Mar,4276,2182,2094
08,Barcelona,236,Sant Quintí de Mediona,1906,993,913
08,Barcelona,237,Sant Quirze de Besora,1963,968,995
08,Barcelona,238,Sant Quirze del Vallès,14720,7335,7385
08,Barcelona,239,Sant Quirze Safaja,446,249,197
08,Barcelona,240,Sant Sadurní d'Anoia,10708,5370,5338
08,Barcelona,241,Sant Sadurní d'Osormort,86,44,42
08,Barcelona,98,Sant Salvador de Guardiola,2390,1241,1149
08,Barcelona,262,Sant Vicenç de Castellet,7334,3537,3797
08,Barcelona,264,Sant Vicenç de Montalt,4326,2196,2130
08,Barcelona,265,Sant Vicenç de Torelló,1869,914,955
08,Barcelona,263,Sant Vicenç dels Horts,26008,13165,12843
08,Barcelona,243,Santa Cecília de Voltregà,198,109,89
08,Barcelona,244,Santa Coloma de Cervelló,6212,3127,3085
08,Barcelona,245,Santa Coloma de Gramenet,116012,58194,57818
08,Barcelona,246,Santa Eugènia de Berga,1995,1036,959
08,Barcelona,247,Santa Eulàlia de Riuprimer,866,445,421
08,Barcelona,248,Santa Eulàlia de Ronçana,5175,2606,2569
08,Barcelona,249,Santa Fe del Penedès,334,164,170
08,Barcelona,250,Santa Margarida de Montbui,9236,4639,4597
08,Barcelona,251,Santa Margarida i els Monjos,5545,2903,2642
08,Barcelona,253,Santa Maria de Besora,184,95,89
08,Barcelona,254,Santa Maria de Corcó,2247,1101,1146
08,Barcelona,256,Santa Maria de Martorelles,709,346,363
08,Barcelona,255,Santa Maria de Merlès,154,82,72
08,Barcelona,257,Santa Maria de Miralles,102,49,53
08,Barcelona,259,Santa Maria de Palautordera,7318,3779,3539
08,Barcelona,258,Santa Maria d'Oló,1018,519,499
08,Barcelona,260,Santa Perpètua de Mogoda,20652,10471,10181
08,Barcelona,261,Santa Susanna,2413,1240,1173
08,Barcelona,192,Santpedor,5610,2782,2828
08,Barcelona,267,Sentmenat,6402,3193,3209
08,Barcelona,269,Seva,2741,1401,1340
08,Barcelona,270,Sitges,22625,11124,11501
08,Barcelona,271,Sobremunt,89,41,48
08,Barcelona,272,Sora,198,103,95
08,Barcelona,273,Subirats,2665,1331,1334
08,Barcelona,274,Súria,6154,3031,3123
08,Barcelona,276,Tagamanent,239,125,114
08,Barcelona,277,Talamanca,114,63,51
08,Barcelona,278,Taradell,5469,2765,2704
08,Barcelona,275,Tavèrnoles,277,140,137
08,Barcelona,280,Tavertet,143,76,67
08,Barcelona,281,Teià,5724,2851,2873
08,Barcelona,279,Terrassa,184829,91613,93216
08,Barcelona,282,Tiana,6519,3213,3306
08,Barcelona,283,Tona,6486,3278,3208
08,Barcelona,284,Tordera,10850,5518,5332
08,Barcelona,285,Torelló,12543,6207,6336
08,Barcelona,286,Torre de Claramunt (La),2794,1422,1372
08,Barcelona,287,Torrelavit,1138,598,540
08,Barcelona,288,Torrelles de Foix,1842,990,852
08,Barcelona,289,Torrelles de Llobregat,4115,2080,2035
08,Barcelona,290,Ullastrell,1340,684,656
08,Barcelona,291,Vacarisses,3467,1830,1637
08,Barcelona,292,Vallbona d'Anoia,1111,560,551
08,Barcelona,293,Vallcebre,270,140,130
08,Barcelona,294,Vallgorguina,1597,840,757
08,Barcelona,295,Vallirana,11110,5593,5517
08,Barcelona,296,Vallromanes,1697,876,821
08,Barcelona,297,Veciana,168,90,78
08,Barcelona,298,Vic,35354,17799,17555
08,Barcelona,299,Vilada,515,261,254
08,Barcelona,301,Viladecans,59343,29958,29385
08,Barcelona,300,Viladecavalls,6639,3365,3274
08,Barcelona,305,Vilafranca del Penedès,33381,16611,16770
08,Barcelona,306,Vilalba Sasserra,524,275,249
08,Barcelona,303,Vilanova de Sau,335,154,181
08,Barcelona,302,Vilanova del Camí,10793,5451,5342
08,Barcelona,902,Vilanova del Vallès,2796,1421,1375
08,Barcelona,307,Vilanova i la Geltrú,57300,28283,29017
08,Barcelona,214,Vilassar de Dalt,7814,3898,3916
08,Barcelona,219,Vilassar de Mar,18321,8948,9373
08,Barcelona,304,Vilobí del Penedès,944,496,448
08,Barcelona,308,Viver i Serrateix,192,100,92
09,Burgos,1,Abajas,46,25,21
09,Burgos,3,Adrada de Haza,266,150,116
09,Burgos,6,Aguas Cándidas,94,53,41
09,Burgos,7,Aguilar de Bureba,80,42,38
09,Burgos,9,Albillos,182,102,80
09,Burgos,10,Alcocero de Mola,54,34,20
09,Burgos,11,Alfoz de Bricia,132,72,60
09,Burgos,907,Alfoz de Quintanadueñas,1222,661,561
09,Burgos,12,Alfoz de Santa Gadea,139,71,68
09,Burgos,13,Altable,62,38,24
09,Burgos,14,Altos (Los),214,128,86
09,Burgos,16,Ameyugo,91,51,40
09,Burgos,17,Anguix,147,74,73
09,Burgos,18,Aranda de Duero,30706,15342,15364
09,Burgos,19,Arandilla,195,113,82
09,Burgos,20,Arauzo de Miel,373,211,162
09,Burgos,21,Arauzo de Salce,69,41,28
09,Burgos,22,Arauzo de Torre,106,60,46
09,Burgos,23,Arcos,383,199,184
09,Burgos,24,Arenillas de Riopisuerga,222,121,101
09,Burgos,25,Arija,206,102,104
09,Burgos,26,Arlanzón,401,224,177
09,Burgos,27,Arraya de Oca,57,30,27
09,Burgos,29,Atapuerca,199,101,98
09,Burgos,30,Ausines (Los),140,79,61
09,Burgos,32,Avellanosa de Muñó,148,78,70
09,Burgos,33,Bahabón de Esgueva,129,76,53
09,Burgos,34,Balbases (Los),343,183,160
09,Burgos,35,Baños de Valdearados,437,246,191
09,Burgos,36,Bañuelos de Bureba,41,27,14
09,Burgos,37,Barbadillo de Herreros,145,82,63
09,Burgos,38,Barbadillo del Mercado,174,96,78
09,Burgos,39,Barbadillo del Pez,90,53,37
09,Burgos,41,Barrio de Muñó,32,18,14
09,Burgos,43,Barrios de Bureba (Los),242,131,111
09,Burgos,44,Barrios de Colina,77,42,35
09,Burgos,45,Basconcillos del Tozo,385,208,177
09,Burgos,46,Bascuñana,61,33,28
09,Burgos,47,Belbimbre,80,45,35
09,Burgos,48,Belorado,2127,1073,1054
09,Burgos,50,Berberana,82,45,37
09,Burgos,51,Berlangas de Roa,234,122,112
09,Burgos,52,Berzosa de Bureba,51,32,19
09,Burgos,54,Bozoó,116,64,52
09,Burgos,55,Brazacorta,90,49,41
09,Burgos,56,Briviesca,6604,3317,3287
09,Burgos,57,Bugedo,152,99,53
09,Burgos,58,Buniel,190,104,86
09,Burgos,59,Burgos,169317,81477,87840
09,Burgos,60,Busto de Bureba,220,118,102
09,Burgos,61,Cabañes de Esgueva,253,132,121
09,Burgos,62,Cabezón de la Sierra,70,29,41
09,Burgos,63,Cabia,246,136,110
09,Burgos,64,Caleruega,426,216,210
09,Burgos,65,Campillo de Aranda,183,96,87
09,Burgos,66,Campolara,95,56,39
09,Burgos,67,Canicosa de la Sierra,588,304,284
09,Burgos,68,Cantabrana,42,26,16
09,Burgos,70,Carazo,47,28,19
09,Burgos,71,Carcedo de Bureba,47,24,23
09,Burgos,72,Carcedo de Burgos,186,111,75
09,Burgos,73,Cardeñadijo,654,350,304
09,Burgos,74,Cardeñajimeno,574,311,263
09,Burgos,75,Cardeñuela Riopico,101,59,42
09,Burgos,76,Carrias,46,31,15
09,Burgos,77,Cascajares de Bureba,55,31,24
09,Burgos,78,Cascajares de la Sierra,30,14,16
09,Burgos,79,Castellanos de Castro,60,35,25
09,Burgos,83,Castil de Peones,31,16,15
09,Burgos,82,Castildelgado,76,39,37
09,Burgos,84,Castrillo de la Reina,261,161,100
09,Burgos,85,Castrillo de la Vega,607,329,278
09,Burgos,88,Castrillo de Riopisuerga,76,41,35
09,Burgos,86,Castrillo del Val,514,301,213
09,Burgos,90,Castrillo Matajudíos,75,36,39
09,Burgos,91,Castrojeriz,980,493,487
09,Burgos,93,Cayuela,136,76,60
09,Burgos,94,Cebrecos,70,39,31
09,Burgos,95,Celada del Camino,96,45,51
09,Burgos,98,Cerezo de Río Tirón,748,406,342
09,Burgos,100,Cerratón de Juarros,72,40,32
09,Burgos,101,Ciadoncha,107,62,45
09,Burgos,102,Cillaperlata,51,32,19
09,Burgos,103,Cilleruelo de Abajo,318,179,139
09,Burgos,104,Cilleruelo de Arriba,77,40,37
09,Burgos,105,Ciruelos de Cervera,152,89,63
09,Burgos,108,Cogollos,297,162,135
09,Burgos,109,Condado de Treviño,1179,666,513
09,Burgos,110,Contreras,110,69,41
09,Burgos,112,Coruña del Conde,170,98,72
09,Burgos,113,Covarrubias,651,338,313
09,Burgos,114,Cubillo del Campo,79,41,38
09,Burgos,115,Cubo de Bureba,109,61,48
09,Burgos,117,Cueva de Roa (La),110,60,50
09,Burgos,119,Cuevas de San Clemente,62,29,33
09,Burgos,120,Encío,65,36,29
09,Burgos,122,Espinosa de Cervera,101,56,45
09,Burgos,124,Espinosa de los Monteros,2052,1042,1010
09,Burgos,123,Espinosa del Camino,37,19,18
09,Burgos,125,Estépar,811,448,363
09,Burgos,127,Fontioso,68,37,31
09,Burgos,128,Frandovínez,88,48,40
09,Burgos,129,Fresneda de la Sierra Tirón,118,66,52
09,Burgos,130,Fresneña,103,56,47
09,Burgos,131,Fresnillo de las Dueñas,317,167,150
09,Burgos,132,Fresno de Río Tirón,230,133,97
09,Burgos,133,Fresno de Rodilla,49,30,19
09,Burgos,134,Frías,269,139,130
09,Burgos,135,Fuentebureba,69,37,32
09,Burgos,136,Fuentecén,272,145,127
09,Burgos,137,Fuentelcésped,178,89,89
09,Burgos,138,Fuentelisendo,113,63,50
09,Burgos,139,Fuentemolinos,117,67,50
09,Burgos,140,Fuentenebro,177,97,80
09,Burgos,141,Fuentespina,658,348,310
09,Burgos,143,Galbarros,32,22,10
09,Burgos,144,Gallega (La),83,47,36
09,Burgos,148,Grijalba,122,60,62
09,Burgos,149,Grisaleña,51,34,17
09,Burgos,151,Gumiel de Izán,626,347,279
09,Burgos,152,Gumiel de Mercado,397,232,165
09,Burgos,154,Hacinas,198,105,93
09,Burgos,155,Haza,38,21,17
09,Burgos,159,Hontanas,68,38,30
09,Burgos,160,Hontangas,140,91,49
09,Burgos,162,Hontoria de la Cantera,133,68,65
09,Burgos,164,Hontoria de Valdearados,211,133,78
09,Burgos,163,Hontoria del Pinar,783,417,366
09,Burgos,166,Hormazas (Las),136,73,63
09,Burgos,167,Hornillos del Camino,70,40,30
09,Burgos,168,Horra (La),429,229,200
09,Burgos,169,Hortigüela,127,78,49
09,Burgos,170,Hoyales de Roa,267,130,137
09,Burgos,172,Huérmeces,135,73,62
09,Burgos,173,Huerta de Arriba,168,91,77
09,Burgos,174,Huerta de Rey,1187,624,563
09,Burgos,175,Humada,181,110,71
09,Burgos,176,Hurones,68,42,26
09,Burgos,177,Ibeas de Juarros,1101,603,498
09,Burgos,178,Ibrillos,95,55,40
09,Burgos,179,Iglesiarrubia,55,31,24
09,Burgos,180,Iglesias,176,102,74
09,Burgos,181,Isar,384,173,211
09,Burgos,182,Itero del Castillo,118,62,56
09,Burgos,183,Jaramillo de la Fuente,30,19,11
09,Burgos,184,Jaramillo Quemado,15,10,5
09,Burgos,189,Junta de Traslaloma,203,111,92
09,Burgos,190,Junta de Villalba de Losa,115,54,61
09,Burgos,191,Jurisdicción de Lara,61,35,26
09,Burgos,192,Jurisdicción de San Zadornil,118,54,64
09,Burgos,194,Lerma,2579,1256,1323
09,Burgos,195,Llano de Bureba,58,34,24
09,Burgos,196,Madrigal del Monte,195,108,87
09,Burgos,197,Madrigalejo del Monte,216,127,89
09,Burgos,198,Mahamud,164,82,82
09,Burgos,199,Mambrilla de Castrejón,145,75,70
09,Burgos,200,Mambrillas de Lara,70,35,35
09,Burgos,201,Mamolar,62,34,28
09,Burgos,202,Manciles,39,22,17
09,Burgos,206,Mazuela,77,44,33
09,Burgos,208,Mecerreyes,298,154,144
09,Burgos,209,Medina de Pomar,4987,2550,2437
09,Burgos,211,Melgar de Fernamental,1990,1038,952
09,Burgos,213,Merindad de Cuesta-Urria,511,285,226
09,Burgos,214,Merindad de Montija,890,489,401
09,Burgos,906,Merindad de Río Ubierna,1366,718,648
09,Burgos,215,Merindad de Sotoscueva,535,302,233
09,Burgos,216,Merindad de Valdeporres,494,253,241
09,Burgos,217,Merindad de Valdivielso,513,275,238
09,Burgos,218,Milagros,447,245,202
09,Burgos,219,Miranda de Ebro,36907,18277,18630
09,Burgos,220,Miraveche,110,64,46
09,Burgos,221,Modúbar de la Emparedada,355,192,163
09,Burgos,223,Monasterio de la Sierra,39,24,15
09,Burgos,224,Monasterio de Rodilla,232,130,102
09,Burgos,225,Moncalvillo,105,65,40
09,Burgos,226,Monterrubio de la Demanda,98,48,50
09,Burgos,227,Montorio,174,93,81
09,Burgos,228,Moradillo de Roa,205,111,94
09,Burgos,229,Nava de Roa,253,133,120
09,Burgos,230,Navas de Bureba,47,22,25
09,Burgos,231,Nebreda,99,62,37
09,Burgos,232,Neila,219,116,103
09,Burgos,235,Olmedillo de Roa,204,105,99
09,Burgos,236,Olmillos de Muñó,43,25,18
09,Burgos,238,Oña,1533,789,744
09,Burgos,239,Oquillas,73,40,33
09,Burgos,241,Orbaneja Riopico,182,105,77
09,Burgos,242,Padilla de Abajo,100,60,40
09,Burgos,243,Padilla de Arriba,121,64,57
09,Burgos,244,Padrones de Bureba,60,34,26
09,Burgos,246,Palacios de la Sierra,860,443,417
09,Burgos,247,Palacios de Riopisuerga,31,16,15
09,Burgos,248,Palazuelos de la Sierra,74,43,31
09,Burgos,249,Palazuelos de Muñó,69,43,26
09,Burgos,250,Pampliega,401,213,188
09,Burgos,251,Pancorbo,464,243,221
09,Burgos,253,Pardilla,130,70,60
09,Burgos,255,Partido de la Sierra en Tobalina,69,45,24
09,Burgos,256,Pedrosa de Duero,502,271,231
09,Burgos,259,Pedrosa de Río Úrbel,269,160,109
09,Burgos,257,Pedrosa del Páramo,109,59,50
09,Burgos,258,Pedrosa del Príncipe,228,118,110
09,Burgos,261,Peñaranda de Duero,575,302,273
09,Burgos,262,Peral de Arlanza,226,118,108
09,Burgos,265,Piérnigas,38,26,12
09,Burgos,266,Pineda de la Sierra,128,69,59
09,Burgos,267,Pineda Trasmonte,169,96,73
09,Burgos,268,Pinilla de los Barruecos,131,72,59
09,Burgos,269,Pinilla de los Moros,47,30,17
09,Burgos,270,Pinilla Trasmonte,219,124,95
09,Burgos,272,Poza de la Sal,392,193,199
09,Burgos,273,Prádanos de Bureba,57,36,21
09,Burgos,274,Pradoluengo,1659,834,825
09,Burgos,275,Presencio,254,136,118
09,Burgos,276,Puebla de Arganzón (La),437,241,196
09,Burgos,277,Puentedura,122,72,50
09,Burgos,279,Quemada,250,142,108
09,Burgos,281,Quintana del Pidio,178,92,86
09,Burgos,280,Quintanabureba,42,23,19
09,Burgos,283,Quintanaélez,91,42,49
09,Burgos,287,Quintanaortuño,176,94,82
09,Burgos,288,Quintanapalla,116,63,53
09,Burgos,289,Quintanar de la Sierra,1976,1022,954
09,Burgos,292,Quintanavides,76,38,38
09,Burgos,294,Quintanilla de la Mata,162,87,75
09,Burgos,901,Quintanilla del Agua y Tordueles,603,315,288
09,Burgos,295,Quintanilla del Coco,108,60,48
09,Burgos,298,Quintanilla San García,103,55,48
09,Burgos,301,Quintanilla Vivar,571,294,277
09,Burgos,297,Quintanillas (Las),369,205,164
09,Burgos,302,Rabanera del Pinar,138,75,63
09,Burgos,303,Rábanos,87,51,36
09,Burgos,304,Rabé de las Calzadas,158,85,73
09,Burgos,306,Rebolledo de la Torre,165,93,72
09,Burgos,307,Redecilla del Camino,156,88,68
09,Burgos,308,Redecilla del Campo,79,43,36
09,Burgos,309,Regumiel de la Sierra,446,218,228
09,Burgos,310,Reinoso,23,15,8
09,Burgos,311,Retuerta,72,40,32
09,Burgos,314,Revilla del Campo,113,63,50
09,Burgos,316,Revilla Vallejera,125,73,52
09,Burgos,312,Revilla y Ahedo (La),121,72,49
09,Burgos,315,Revillarruz,175,87,88
09,Burgos,317,Rezmondo,26,11,15
09,Burgos,318,Riocavado de la Sierra,71,44,27
09,Burgos,321,Roa,2300,1193,1107
09,Burgos,323,Rojas,87,53,34
09,Burgos,325,Royuela de Río Franco,301,170,131
09,Burgos,326,Rubena,177,94,83
09,Burgos,327,Rublacedo de Abajo,36,21,15
09,Burgos,328,Rucandio,99,51,48
09,Burgos,329,Salas de Bureba,147,83,64
09,Burgos,330,Salas de los Infantes,2108,1078,1030
09,Burgos,332,Saldaña de Burgos,140,77,63
09,Burgos,334,Salinillas de Bureba,53,30,23
09,Burgos,335,San Adrián de Juarros,52,32,20
09,Burgos,337,San Juan del Monte,165,86,79
09,Burgos,338,San Mamés de Burgos,226,128,98
09,Burgos,339,San Martín de Rubiales,223,117,106
09,Burgos,340,San Millán de Lara,82,56,26
09,Burgos,360,San Vicente del Valle,43,26,17
09,Burgos,343,Santa Cecilia,119,68,51
09,Burgos,345,Santa Cruz de la Salceda,166,97,69
09,Burgos,346,Santa Cruz del Valle Urbión,115,66,49
09,Burgos,347,Santa Gadea del Cid,182,99,83
09,Burgos,348,Santa Inés,188,105,83
09,Burgos,350,Santa María del Campo,715,378,337
09,Burgos,351,Santa María del Invierno,68,47,21
09,Burgos,352,Santa María del Mercadillo,172,101,71
09,Burgos,353,Santa María Rivarredonda,120,60,60
09,Burgos,354,Santa Olalla de Bureba,36,16,20
09,Burgos,355,Santibáñez de Esgueva,151,75,76
09,Burgos,356,Santibáñez del Val,68,44,24
09,Burgos,358,Santo Domingo de Silos,301,184,117
09,Burgos,361,Sargentes de la Lora,189,104,85
09,Burgos,362,Sarracín,262,144,118
09,Burgos,363,Sasamón,1388,757,631
09,Burgos,365,Sequera de Haza (La),57,36,21
09,Burgos,366,Solarana,107,63,44
09,Burgos,368,Sordillos,30,17,13
09,Burgos,369,Sotillo de la Ribera,605,330,275
09,Burgos,372,Sotragero,199,102,97
09,Burgos,373,Sotresgudo,668,371,297
09,Burgos,374,Susinos del Páramo,112,56,56
09,Burgos,375,Tamarón,50,32,18
09,Burgos,377,Tardajos,590,315,275
09,Burgos,378,Tejada,47,28,19
09,Burgos,380,Terradillos de Esgueva,124,62,62
09,Burgos,381,Tinieblas de la Sierra,49,25,24
09,Burgos,382,Tobar,45,27,18
09,Burgos,384,Tordómar,364,210,154
09,Burgos,386,Torrecilla del Monte,85,46,39
09,Burgos,387,Torregalindo,132,73,59
09,Burgos,388,Torrelara,25,13,12
09,Burgos,389,Torrepadre,99,61,38
09,Burgos,390,Torresandino,825,438,387
09,Burgos,391,Tórtoles de Esgueva,529,293,236
09,Burgos,392,Tosantos,54,27,27
09,Burgos,394,Trespaderne,1034,544,490
09,Burgos,395,Tubilla del Agua,183,118,65
09,Burgos,396,Tubilla del Lago,172,98,74
09,Burgos,398,Úrbel del Castillo,100,59,41
09,Burgos,400,Vadocondes,426,226,200
09,Burgos,403,Valdeande,134,83,51
09,Burgos,405,Valdezate,180,94,86
09,Burgos,406,Valdorros,156,86,70
09,Burgos,407,Valmala,37,18,19
09,Burgos,408,Vallarta de Bureba,62,38,24
09,Burgos,904,Valle de las Navas,612,333,279
09,Burgos,908,Valle de Losa,631,356,275
09,Burgos,409,Valle de Manzanedo,127,70,57
09,Burgos,410,Valle de Mena,3412,1746,1666
09,Burgos,411,Valle de Oca,227,122,105
09,Burgos,902,Valle de Santibáñez,600,313,287
09,Burgos,905,Valle de Sedano,553,306,247
09,Burgos,412,Valle de Tobalina,1075,570,505
09,Burgos,413,Valle de Valdebezana,714,393,321
09,Burgos,414,Valle de Valdelaguna,219,125,94
09,Burgos,415,Valle de Valdelucio,355,189,166
09,Burgos,416,Valle de Zamanzas,79,42,37
09,Burgos,417,Vallejera,51,32,19
09,Burgos,418,Valles de Palenzuela,107,55,52
09,Burgos,419,Valluércanes,107,59,48
09,Burgos,422,Vid de Bureba (La),35,15,20
09,Burgos,421,Vid y Barrios (La),319,183,136
09,Burgos,423,Vileña,33,22,11
09,Burgos,424,Viloria de Rioja,64,36,28
09,Burgos,425,Vilviestre del Pinar,762,397,365
09,Burgos,427,Villadiego,1889,1028,861
09,Burgos,428,Villaescusa de Roa,170,94,76
09,Burgos,429,Villaescusa la Sombría,58,37,21
09,Burgos,430,Villaespasa,26,14,12
09,Burgos,431,Villafranca Montes de Oca,181,94,87
09,Burgos,432,Villafruela,262,150,112
09,Burgos,433,Villagalijo,76,47,29
09,Burgos,434,Villagonzalo Pedernales,970,508,462
09,Burgos,437,Villahoz,383,200,183
09,Burgos,438,Villalba de Duero,638,341,297
09,Burgos,439,Villalbilla de Burgos,768,410,358
09,Burgos,440,Villalbilla de Gumiel,122,72,50
09,Burgos,441,Villaldemiro,72,41,31
09,Burgos,442,Villalmanzo,487,263,224
09,Burgos,443,Villamayor de los Montes,230,111,119
09,Burgos,444,Villamayor de Treviño,110,63,47
09,Burgos,445,Villambistia,65,36,29
09,Burgos,446,Villamedianilla,26,13,13
09,Burgos,447,Villamiel de la Sierra,37,21,16
09,Burgos,448,Villangómez,314,183,131
09,Burgos,449,Villanueva de Argaño,129,76,53
09,Burgos,450,Villanueva de Carazo,26,16,10
09,Burgos,451,Villanueva de Gumiel,290,153,137
09,Burgos,454,Villanueva de Teba,57,33,24
09,Burgos,455,Villaquirán de la Puebla,60,35,25
09,Burgos,456,Villaquirán de los Infantes,201,104,97
09,Burgos,903,Villarcayo de Merindad de Castilla la Vieja,3926,1990,1936
09,Burgos,458,Villariezo,319,170,149
09,Burgos,460,Villasandino,240,129,111
09,Burgos,463,Villasur de Herreros,310,170,140
09,Burgos,464,Villatuelda,61,36,25
09,Burgos,466,Villaverde del Monte,184,101,83
09,Burgos,467,Villaverde-Mogina,116,71,45
09,Burgos,471,Villayerno Morquillas,196,102,94
09,Burgos,472,Villazopeque,80,47,33
09,Burgos,473,Villegas,121,69,52
09,Burgos,476,Villoruebo,58,36,22
09,Burgos,478,Vizcaínos,61,34,27
09,Burgos,480,Zael,133,71,62
09,Burgos,482,Zarzosa de Río Pisuerga,53,30,23
09,Burgos,483,Zazuar,267,141,126
09,Burgos,485,Zuñeda,78,43,35
10,Cáceres,1,Abadía,290,164,126
10,Cáceres,2,Abertura,501,259,242
10,Cáceres,3,Acebo,752,406,346
10,Cáceres,4,Acehúche,888,434,454
10,Cáceres,5,Aceituna,663,341,322
10,Cáceres,6,Ahigal,1636,845,791
10,Cáceres,7,Albalá,858,414,444
10,Cáceres,8,Alcántara,1739,868,871
10,Cáceres,9,Alcollarín,323,159,164
10,Cáceres,10,Alcuéscar,3006,1565,1441
10,Cáceres,12,Aldea del Cano,737,359,378
10,Cáceres,13,Aldea del Obispo (La),362,195,167
10,Cáceres,11,Aldeacentenera,863,438,425
10,Cáceres,14,Aldeanueva de la Vera,2427,1197,1230
10,Cáceres,15,Aldeanueva del Camino,849,414,435
10,Cáceres,16,Aldehuela de Jerte,359,205,154
10,Cáceres,17,Alía,1262,642,620
10,Cáceres,18,Aliseda,2032,1020,1012
10,Cáceres,19,Almaraz,1411,724,687
10,Cáceres,20,Almoharín,2090,1045,1045
10,Cáceres,21,Arroyo de la Luz,6580,3275,3305
10,Cáceres,23,Arroyomolinos,1076,562,514
10,Cáceres,22,Arroyomolinos de la Vera,565,275,290
10,Cáceres,24,Baños de Montemayor,710,328,382
10,Cáceres,25,Barrado,518,267,251
10,Cáceres,26,Belvís de Monroy,645,324,321
10,Cáceres,27,Benquerencia,108,62,46
10,Cáceres,28,Berrocalejo,121,56,65
10,Cáceres,29,Berzocana,547,276,271
10,Cáceres,30,Bohonal de Ibor,548,286,262
10,Cáceres,31,Botija,154,69,85
10,Cáceres,32,Brozas,2291,1138,1153
10,Cáceres,33,Cabañas del Castillo,522,270,252
10,Cáceres,34,Cabezabellosa,474,233,241
10,Cáceres,35,Cabezuela del Valle,2222,1153,1069
10,Cáceres,36,Cabrero,394,212,182
10,Cáceres,37,Cáceres,87088,41870,45218
10,Cáceres,38,Cachorrilla,99,47,52
10,Cáceres,39,Cadalso,581,305,276
10,Cáceres,40,Calzadilla,514,267,247
10,Cáceres,41,Caminomorisco,1280,666,614
10,Cáceres,42,Campillo de Deleitosa,111,52,59
10,Cáceres,43,Campo Lugar,1166,596,570
10,Cáceres,44,Cañamero,1748,888,860
10,Cáceres,45,Cañaveral,1351,653,698
10,Cáceres,46,Carbajo,254,131,123
10,Cáceres,47,Carcaboso,1050,586,464
10,Cáceres,48,Carrascalejo,392,209,183
10,Cáceres,49,Casar de Cáceres,4729,2364,2365
10,Cáceres,50,Casar de Palomero,1280,644,636
10,Cáceres,51,Casares de las Hurdes,650,325,325
10,Cáceres,52,Casas de Don Antonio,224,104,120
10,Cáceres,53,Casas de Don Gómez,342,180,162
10,Cáceres,56,Casas de Millán,739,371,368
10,Cáceres,57,Casas de Miravete,197,107,90
10,Cáceres,54,Casas del Castañar,670,340,330
10,Cáceres,55,Casas del Monte,890,464,426
10,Cáceres,58,Casatejada,1240,623,617
10,Cáceres,59,Casillas de Coria,505,239,266
10,Cáceres,60,Castañar de Ibor,1231,632,599
10,Cáceres,61,Ceclavín,2152,1086,1066
10,Cáceres,62,Cedillo,547,284,263
10,Cáceres,63,Cerezo,210,99,111
10,Cáceres,64,Cilleros,2043,1047,996
10,Cáceres,65,Collado,218,112,106
10,Cáceres,66,Conquista de la Sierra,212,110,102
10,Cáceres,67,Coria,12610,6348,6262
10,Cáceres,68,Cuacos de Yuste,956,508,448
10,Cáceres,69,Cumbre (La),1073,543,530
10,Cáceres,70,Deleitosa,846,434,412
10,Cáceres,71,Descargamaría,266,150,116
10,Cáceres,72,Eljas,1162,589,573
10,Cáceres,73,Escurial,917,470,447
10,Cáceres,75,Fresnedoso de Ibor,351,174,177
10,Cáceres,76,Galisteo,1935,974,961
10,Cáceres,77,Garciaz,942,481,461
10,Cáceres,78,Garganta (La),587,318,269
10,Cáceres,79,Garganta la Olla,1151,605,546
10,Cáceres,80,Gargantilla,468,246,222
10,Cáceres,81,Gargüera,176,91,85
10,Cáceres,82,Garrovillas de Alconétar,2433,1202,1231
10,Cáceres,83,Garvín,113,62,51
10,Cáceres,84,Gata,1800,919,881
10,Cáceres,85,Gordo (El),274,135,139
10,Cáceres,86,Granja (La),364,204,160
10,Cáceres,87,Guadalupe,2191,1092,1099
10,Cáceres,88,Guijo de Coria,263,140,123
10,Cáceres,89,Guijo de Galisteo,1530,841,689
10,Cáceres,90,Guijo de Granadilla,694,343,351
10,Cáceres,91,Guijo de Santa Bárbara,457,232,225
10,Cáceres,92,Herguijuela,376,197,179
10,Cáceres,93,Hernán-Pérez,506,264,242
10,Cáceres,94,Herrera de Alcántara,314,158,156
10,Cáceres,95,Herreruela,405,206,199
10,Cáceres,96,Hervás,3846,1891,1955
10,Cáceres,97,Higuera,105,58,47
10,Cáceres,98,Hinojal,426,214,212
10,Cáceres,99,Holguera,806,407,399
10,Cáceres,100,Hoyos,1009,517,492
10,Cáceres,101,Huélaga,191,91,100
10,Cáceres,102,Ibahernando,629,301,328
10,Cáceres,103,Jaraicejo,652,321,331
10,Cáceres,104,Jaraíz de la Vera,6870,3532,3338
10,Cáceres,105,Jarandilla de la Vera,3207,1599,1608
10,Cáceres,106,Jarilla,149,75,74
10,Cáceres,107,Jerte,1333,685,648
10,Cáceres,108,Ladrillar,280,152,128
10,Cáceres,109,Logrosán,2277,1173,1104
10,Cáceres,110,Losar de la Vera,3176,1675,1501
10,Cáceres,111,Madrigal de la Vera,1745,908,837
10,Cáceres,112,Madrigalejo,2109,1043,1066
10,Cáceres,113,Madroñera,3081,1542,1539
10,Cáceres,114,Majadas,1152,623,529
10,Cáceres,115,Malpartida de Cáceres,4371,2213,2158
10,Cáceres,116,Malpartida de Plasencia,4293,2137,2156
10,Cáceres,117,Marchagaz,302,152,150
10,Cáceres,118,Mata de Alcántara,349,174,175
10,Cáceres,119,Membrío,885,428,457
10,Cáceres,120,Mesas de Ibor,205,107,98
10,Cáceres,121,Miajadas,9580,4781,4799
10,Cáceres,122,Millanes,204,111,93
10,Cáceres,123,Mirabel,757,385,372
10,Cáceres,124,Mohedas de Granadilla,1081,541,540
10,Cáceres,125,Monroy,981,507,474
10,Cáceres,126,Montánchez,2073,1040,1033
10,Cáceres,127,Montehermoso,5616,2845,2771
10,Cáceres,128,Moraleja,7793,3916,3877
10,Cáceres,129,Morcillo,446,220,226
10,Cáceres,130,Navaconcejo,2070,1048,1022
10,Cáceres,131,Navalmoral de la Mata,16382,8250,8132
10,Cáceres,132,Navalvillar de Ibor,474,252,222
10,Cáceres,133,Navas del Madroño,1496,752,744
10,Cáceres,134,Navezuelas,721,380,341
10,Cáceres,135,Nuñomoral,1614,852,762
10,Cáceres,136,Oliva de Plasencia,269,141,128
10,Cáceres,137,Palomero,520,265,255
10,Cáceres,138,Pasarón de la Vera,708,350,358
10,Cáceres,139,Pedroso de Acim,122,64,58
10,Cáceres,140,Peraleda de la Mata,1478,757,721
10,Cáceres,141,Peraleda de San Román,376,186,190
10,Cáceres,142,Perales del Puerto,1013,504,509
10,Cáceres,143,Pescueza,185,88,97
10,Cáceres,144,Pesga (La),1173,614,559
10,Cáceres,145,Piedras Albas,168,84,84
10,Cáceres,146,Pinofranqueado,1618,878,740
10,Cáceres,147,Piornal,1542,756,786
10,Cáceres,148,Plasencia,38576,18892,19684
10,Cáceres,149,Plasenzuela,583,280,303
10,Cáceres,150,Portaje,394,196,198
10,Cáceres,151,Portezuelo,290,139,151
10,Cáceres,152,Pozuelo de Zarzón,599,287,312
10,Cáceres,153,Puerto de Santa Cruz,410,211,199
10,Cáceres,154,Rebollar,231,117,114
10,Cáceres,155,Riolobos,1421,750,671
10,Cáceres,156,Robledillo de Gata,161,87,74
10,Cáceres,157,Robledillo de la Vera,338,167,171
10,Cáceres,158,Robledillo de Trujillo,473,245,228
10,Cáceres,159,Robledollano,396,216,180
10,Cáceres,160,Romangordo,173,86,87
10,Cáceres,901,Rosalejo,1597,894,703
10,Cáceres,161,Ruanes,88,46,42
10,Cáceres,162,Salorino,747,372,375
10,Cáceres,163,Salvatierra de Santiago,406,198,208
10,Cáceres,164,San Martín de Trevejo,926,456,470
10,Cáceres,165,Santa Ana,336,172,164
10,Cáceres,166,Santa Cruz de la Sierra,336,177,159
10,Cáceres,167,Santa Cruz de Paniagua,399,216,183
10,Cáceres,168,Santa Marta de Magasca,270,131,139
10,Cáceres,169,Santiago de Alcántara,727,366,361
10,Cáceres,170,Santiago del Campo,311,154,157
10,Cáceres,171,Santibáñez el Alto,518,267,251
10,Cáceres,172,Santibáñez el Bajo,947,479,468
10,Cáceres,173,Saucedilla,662,342,320
10,Cáceres,174,Segura de Toro,190,92,98
10,Cáceres,175,Serradilla,1846,942,904
10,Cáceres,176,Serrejón,468,240,228
10,Cáceres,177,Sierra de Fuentes,1849,949,900
10,Cáceres,178,Talaván,926,467,459
10,Cáceres,179,Talaveruela de la Vera,413,199,214
10,Cáceres,180,Talayuela,10126,6108,4018
10,Cáceres,181,Tejeda de Tiétar,1000,524,476
10,Cáceres,182,Toril,215,131,84
10,Cáceres,183,Tornavacas,1289,689,600
10,Cáceres,184,Torno (El),941,487,454
10,Cáceres,187,Torre de Don Miguel,633,328,305
10,Cáceres,188,Torre de Santa María,670,340,330
10,Cáceres,185,Torrecilla de los Ángeles,745,382,363
10,Cáceres,186,Torrecillas de la Tiesa,1107,563,544
10,Cáceres,190,Torrejón el Rubio,612,318,294
10,Cáceres,189,Torrejoncillo,3422,1672,1750
10,Cáceres,191,Torremenga,620,323,297
10,Cáceres,192,Torremocha,1152,570,582
10,Cáceres,193,Torreorgaz,1664,821,843
10,Cáceres,194,Torrequemada,597,280,317
10,Cáceres,195,Trujillo,9564,4698,4866
10,Cáceres,196,Valdastillas,350,176,174
10,Cáceres,197,Valdecañas de Tajo,196,109,87
10,Cáceres,198,Valdefuentes,1535,777,758
10,Cáceres,199,Valdehúncar,207,107,100
10,Cáceres,200,Valdelacasa de Tajo,596,286,310
10,Cáceres,201,Valdemorales,260,129,131
10,Cáceres,202,Valdeobispo,800,394,406
10,Cáceres,203,Valencia de Alcántara,6096,2998,3098
10,Cáceres,204,Valverde de la Vera,507,257,250
10,Cáceres,205,Valverde del Fresno,2606,1333,1273
10,Cáceres,206,Viandar de la Vera,300,146,154
10,Cáceres,207,Villa del Campo,612,302,310
10,Cáceres,208,Villa del Rey,147,76,71
10,Cáceres,209,Villamesías,342,165,177
10,Cáceres,210,Villamiel,650,370,280
10,Cáceres,211,Villanueva de la Sierra,619,302,317
10,Cáceres,212,Villanueva de la Vera,1950,1000,950
10,Cáceres,214,Villar de Plasencia,253,130,123
10,Cáceres,213,Villar del Pedroso,780,396,384
10,Cáceres,215,Villasbuenas de Gata,498,255,243
10,Cáceres,216,Zarza de Granadilla,1718,874,844
10,Cáceres,217,Zarza de Montánchez,605,302,303
10,Cáceres,218,Zarza la Mayor,1608,823,785
10,Cáceres,219,Zorita,1859,924,935
11,Cádiz,1,Alcalá de los Gazules,5491,2825,2666
11,Cádiz,2,Alcalá del Valle,5329,2745,2584
11,Cádiz,3,Algar,1640,877,763
11,Cádiz,4,Algeciras,108779,53902,54877
11,Cádiz,5,Algodonales,5621,2874,2747
11,Cádiz,6,Arcos de la Frontera,28735,14367,14368
11,Cádiz,7,Barbate,22264,11179,11085
11,Cádiz,8,Barrios (Los),18599,9373,9226
11,Cádiz,901,Benalup-Casas Viejas,6610,3339,3271
11,Cádiz,9,Benaocaz,672,350,322
11,Cádiz,10,Bornos,8064,3995,4069
11,Cádiz,11,Bosque (El),1977,1014,963
11,Cádiz,12,Cádiz,134989,64663,70326
11,Cádiz,13,Castellar de la Frontera,2677,1364,1313
11,Cádiz,14,Conil de la Frontera,18656,9495,9161
11,Cádiz,15,Chiclana de la Frontera,65694,33322,32372
11,Cádiz,16,Chipiona,17334,8761,8573
11,Cádiz,17,Espera,3885,1987,1898
11,Cádiz,18,Gastor (El),1957,1024,933
11,Cádiz,19,Grazalema,2200,1157,1043
11,Cádiz,20,Jerez de la Frontera,191002,93325,97677
11,Cádiz,21,Jimena de la Frontera,9343,4778,4565
11,Cádiz,22,Línea de la Concepción (La),61892,30557,31335
11,Cádiz,23,Medina-Sidonia,10811,5601,5210
11,Cádiz,24,Olvera,8584,4293,4291
11,Cádiz,25,Paterna de Rivera,5325,2767,2558
11,Cádiz,26,Prado del Rey,5873,2939,2934
11,Cádiz,27,Puerto de Santa María (El),79889,39795,40094
11,Cádiz,28,Puerto Real,37033,18705,18328
11,Cádiz,29,Puerto Serrano,6859,3530,3329
11,Cádiz,30,Rota,26431,13333,13098
11,Cádiz,31,San Fernando,88490,43683,44807
11,Cádiz,902,San José del Valle,4173,2158,2015
11,Cádiz,33,San Roque,25163,12741,12422
11,Cádiz,32,Sanlúcar de Barrameda,62308,31151,31157
11,Cádiz,34,Setenil de las Bodegas,3014,1546,1468
11,Cádiz,35,Tarifa,16392,8336,8056
11,Cádiz,36,Torre Alháquime,890,461,429
11,Cádiz,37,Trebujena,6887,3561,3326
11,Cádiz,38,Ubrique,17478,8649,8829
11,Cádiz,39,Vejer de la Frontera,12690,6396,6294
11,Cádiz,40,Villaluenga del Rosario,449,230,219
11,Cádiz,41,Villamartín,12069,6062,6007
11,Cádiz,42,Zahara,1506,782,724
12,Castellón/Castelló,2,Aín,154,79,75
12,Castellón/Castelló,3,Albocàsser,1378,680,698
12,Castellón/Castelló,4,Alcalà de Xivert,6324,3278,3046
12,Castellón/Castelló,5,Alcora (l'),9925,5048,4877
12,Castellón/Castelló,6,Alcudia de Veo,201,98,103
12,Castellón/Castelló,7,Alfondeguilla,883,440,443
12,Castellón/Castelló,8,Algimia de Almonacid,267,157,110
12,Castellón/Castelló,9,Almazora/Almassora,18385,9165,9220
12,Castellón/Castelló,10,Almedíjar,274,134,140
12,Castellón/Castelló,11,Almenara,5076,2514,2562
12,Castellón/Castelló,901,Alquerías del Niño Perdido,3695,1807,1888
12,Castellón/Castelló,12,Altura,3234,1629,1605
12,Castellón/Castelló,13,Arañuel,199,94,105
12,Castellón/Castelló,14,Ares del Maestre,229,118,111
12,Castellón/Castelló,15,Argelita,113,57,56
12,Castellón/Castelló,16,Artana,1848,919,929
12,Castellón/Castelló,1,Atzeneta del Maestrat,1417,716,701
12,Castellón/Castelló,17,Ayódar,220,123,97
12,Castellón/Castelló,18,Azuébar,337,170,167
12,Castellón/Castelló,20,Barracas,186,102,84
12,Castellón/Castelló,22,Bejís,371,210,161
12,Castellón/Castelló,24,Benafer,144,78,66
12,Castellón/Castelló,25,Benafigos,193,102,91
12,Castellón/Castelló,26,Benasal,1391,695,696
12,Castellón/Castelló,27,Benicarló,22063,11125,10938
12,Castellón/Castelló,28,Benicasim/Benicàssim,14607,7420,7187
12,Castellón/Castelló,29,Benlloch,883,451,432
12,Castellón/Castelló,21,Betxí,5467,2778,2689
12,Castellón/Castelló,31,Borriol,4073,2063,2010
12,Castellón/Castelló,32,Burriana,29250,14558,14692
12,Castellón/Castelló,33,Cabanes,2574,1303,1271
12,Castellón/Castelló,34,Càlig,1808,904,904
12,Castellón/Castelló,36,Canet lo Roig,922,448,474
12,Castellón/Castelló,37,Castell de Cabres,18,8,10
12,Castellón/Castelló,38,Castellfort,220,116,104
12,Castellón/Castelló,39,Castellnovo,1027,483,544
12,Castellón/Castelló,40,Castellón de la Plana/Castelló de la Plana,160714,79353,81361
12,Castellón/Castelló,41,Castillo de Villamalefa,105,52,53
12,Castellón/Castelló,42,Catí,862,445,417
12,Castellón/Castelló,43,Caudiel,709,349,360
12,Castellón/Castelló,44,Cervera del Maestre,660,308,352
12,Castellón/Castelló,45,Cinctorres,504,231,273
12,Castellón/Castelló,46,Cirat,255,137,118
12,Castellón/Castelló,48,Cortes de Arenoso,393,212,181
12,Castellón/Castelló,49,Costur,466,236,230
12,Castellón/Castelló,50,Coves de Vinromà (les),1865,960,905
12,Castellón/Castelló,51,Culla,723,371,352
12,Castellón/Castelló,52,Chert/Xert,903,441,462
12,Castellón/Castelló,53,Chilches/Xilxes,2484,1282,1202
12,Castellón/Castelló,55,Chodos/Xodos,142,77,65
12,Castellón/Castelló,56,Chóvar,351,178,173
12,Castellón/Castelló,57,Eslida,796,394,402
12,Castellón/Castelló,58,Espadilla,67,31,36
12,Castellón/Castelló,59,Fanzara,240,115,125
12,Castellón/Castelló,60,Figueroles,586,292,294
12,Castellón/Castelló,61,Forcall,557,266,291
12,Castellón/Castelló,63,Fuente la Reina,27,14,13
12,Castellón/Castelló,64,Fuentes de Ayódar,93,52,41
12,Castellón/Castelló,65,Gaibiel,185,99,86
12,Castellón/Castelló,67,Geldo,728,367,361
12,Castellón/Castelló,68,Herbés,88,47,41
12,Castellón/Castelló,69,Higueras,106,52,54
12,Castellón/Castelló,70,Jana (la),791,397,394
12,Castellón/Castelló,71,Jérica,1538,775,763
12,Castellón/Castelló,72,Lucena del Cid,1559,800,759
12,Castellón/Castelló,73,Ludiente,213,110,103
12,Castellón/Castelló,74,Llosa (la),912,452,460
12,Castellón/Castelló,75,Mata de Morella (la),174,90,84
12,Castellón/Castelló,76,Matet,127,66,61
12,Castellón/Castelló,77,Moncofa,4485,2321,2164
12,Castellón/Castelló,78,Montán,327,170,157
12,Castellón/Castelló,79,Montanejos,465,230,235
12,Castellón/Castelló,80,Morella,2766,1355,1411
12,Castellón/Castelló,81,Navajas,554,275,279
12,Castellón/Castelló,82,Nules,11899,5928,5971
12,Castellón/Castelló,83,Olocau del Rey,136,75,61
12,Castellón/Castelló,84,Onda,20909,10618,10291
12,Castellón/Castelló,85,Oropesa del Mar/Orpesa,5179,2733,2446
12,Castellón/Castelló,87,Palanques,25,16,9
12,Castellón/Castelló,88,Pavías,59,37,22
12,Castellón/Castelló,89,Peñíscola,5685,2939,2746
12,Castellón/Castelló,90,Pina de Montalgrao,158,85,73
12,Castellón/Castelló,93,Pobla de Benifassà (la),228,114,114
12,Castellón/Castelló,94,Pobla Tornesa (la),631,318,313
12,Castellón/Castelló,91,Portell de Morella,259,130,129
12,Castellón/Castelló,92,Puebla de Arenoso,161,86,75
12,Castellón/Castelló,95,Ribesalbes,1285,659,626
12,Castellón/Castelló,96,Rossell,1277,688,589
12,Castellón/Castelló,97,Sacañet,161,89,72
12,Castellón/Castelló,98,Salzadella (la),788,400,388
12,Castellón/Castelló,101,San Rafael del Río,451,236,215
12,Castellón/Castelló,902,Sant Joan de Moró,1915,1021,894
12,Castellón/Castelló,99,Sant Jordi/San Jorge,646,325,321
12,Castellón/Castelló,100,Sant Mateu,1930,984,946
12,Castellón/Castelló,102,Santa Magdalena de Pulpis,788,417,371
12,Castellón/Castelló,103,Sarratella,87,53,34
12,Castellón/Castelló,104,Segorbe,8229,3998,4231
12,Castellón/Castelló,105,Sierra Engarcerán,1079,559,520
12,Castellón/Castelló,106,Soneja,1349,683,666
12,Castellón/Castelló,107,Sot de Ferrer,475,240,235
12,Castellón/Castelló,108,Sueras/Suera,607,305,302
12,Castellón/Castelló,109,Tales,731,363,368
12,Castellón/Castelló,110,Teresa,321,164,157
12,Castellón/Castelló,111,Tírig,554,285,269
12,Castellón/Castelló,112,Todolella,135,81,54
12,Castellón/Castelló,113,Toga,77,40,37
12,Castellón/Castelló,114,Torás,249,129,120
12,Castellón/Castelló,115,Toro (El),289,152,137
12,Castellón/Castelló,116,Torralba del Pinar,77,34,43
12,Castellón/Castelló,119,Torre d'En Besora (la),184,96,88
12,Castellón/Castelló,120,Torre Endoménech,232,121,111
12,Castellón/Castelló,117,Torreblanca,5238,2740,2498
12,Castellón/Castelló,118,Torrechiva,97,59,38
12,Castellón/Castelló,121,Traiguera,1604,852,752
12,Castellón/Castelló,122,Useras/Useres (les),982,505,477
12,Castellón/Castelló,124,Vall d'Alba,2027,1026,1001
12,Castellón/Castelló,125,Vall de Almonacid,272,141,131
12,Castellón/Castelló,126,Vall d'Uixó (la),30423,15206,15217
12,Castellón/Castelló,123,Vallat,62,31,31
12,Castellón/Castelló,127,Vallibona,97,55,42
12,Castellón/Castelló,128,Vilafamés,1532,820,712
12,Castellón/Castelló,132,Vilanova d'Alcolea,627,323,304
12,Castellón/Castelló,134,Vilar de Canes,181,91,90
12,Castellón/Castelló,136,Vilavella (la),3369,1691,1678
12,Castellón/Castelló,129,Villafranca del Cid,2576,1273,1303
12,Castellón/Castelló,130,Villahermosa del Río,448,242,206
12,Castellón/Castelló,131,Villamalur,113,61,52
12,Castellón/Castelló,133,Villanueva de Viver,75,39,36
12,Castellón/Castelló,135,Villarreal/Vila-real,44685,22350,22335
12,Castellón/Castelló,137,Villores,62,31,31
12,Castellón/Castelló,138,Vinaròs,24507,12129,12378
12,Castellón/Castelló,139,Vistabella del Maestrazgo,423,211,212
12,Castellón/Castelló,140,Viver,1386,712,674
12,Castellón/Castelló,141,Zorita del Maestrazgo,128,62,66
12,Castellón/Castelló,142,Zucaina,204,114,90
13,Ciudad Real,1,Abenójar,1706,857,849
13,Ciudad Real,2,Agudo,1964,992,972
13,Ciudad Real,3,Alamillo,654,332,322
13,Ciudad Real,4,Albaladejo,1554,793,761
13,Ciudad Real,5,Alcázar de San Juan,27229,13323,13906
13,Ciudad Real,6,Alcoba,779,393,386
13,Ciudad Real,7,Alcolea de Calatrava,1602,815,787
13,Ciudad Real,8,Alcubillas,664,350,314
13,Ciudad Real,9,Aldea del Rey,2081,1014,1067
13,Ciudad Real,10,Alhambra,1203,615,588
13,Ciudad Real,11,Almadén,6659,3185,3474
13,Ciudad Real,12,Almadenejos,534,283,251
13,Ciudad Real,13,Almagro,8397,4099,4298
13,Ciudad Real,14,Almedina,706,354,352
13,Ciudad Real,15,Almodóvar del Campo,7164,3538,3626
13,Ciudad Real,16,Almuradiel,1024,486,538
13,Ciudad Real,17,Anchuras,397,229,168
13,Ciudad Real,903,Arenales de San Gregorio,682,355,327
13,Ciudad Real,18,Arenas de San Juan,1066,550,516
13,Ciudad Real,19,Argamasilla de Alba,6739,3347,3392
13,Ciudad Real,20,Argamasilla de Calatrava,5374,2738,2636
13,Ciudad Real,21,Arroba de los Montes,613,315,298
13,Ciudad Real,22,Ballesteros de Calatrava,569,280,289
13,Ciudad Real,23,Bolaños de Calatrava,11580,5907,5673
13,Ciudad Real,24,Brazatortas,1180,593,587
13,Ciudad Real,25,Cabezarados,367,189,178
13,Ciudad Real,26,Cabezarrubias del Puerto,618,317,301
13,Ciudad Real,27,Calzada de Calatrava,4554,2244,2310
13,Ciudad Real,28,Campo de Criptana,13193,6539,6654
13,Ciudad Real,29,Cañada de Calatrava,103,57,46
13,Ciudad Real,30,Caracuel de Calatrava,164,89,75
13,Ciudad Real,31,Carrión de Calatrava,2647,1316,1331
13,Ciudad Real,32,Carrizosa,1580,791,789
13,Ciudad Real,33,Castellar de Santiago,2207,1091,1116
13,Ciudad Real,34,Ciudad Real,65703,31139,34564
13,Ciudad Real,35,Corral de Calatrava,1260,642,618
13,Ciudad Real,36,Cortijos (Los),1004,498,506
13,Ciudad Real,37,Cózar,1278,636,642
13,Ciudad Real,38,Chillón,2228,1083,1145
13,Ciudad Real,39,Daimiel,17493,8638,8855
13,Ciudad Real,40,Fernán Caballero,1048,505,543
13,Ciudad Real,41,Fontanarejo,323,164,159
13,Ciudad Real,42,Fuencaliente,1255,655,600
13,Ciudad Real,43,Fuenllana,293,139,154
13,Ciudad Real,44,Fuente el Fresno,3501,1755,1746
13,Ciudad Real,45,Granátula de Calatrava,1028,510,518
13,Ciudad Real,46,Guadalmez,982,496,486
13,Ciudad Real,47,Herencia,7495,3865,3630
13,Ciudad Real,48,Hinojosas de Calatrava,695,328,367
13,Ciudad Real,49,Horcajo de los Montes,1093,553,540
13,Ciudad Real,50,Labores (Las),675,335,340
13,Ciudad Real,51,Luciana,435,218,217
13,Ciudad Real,904,Llanos del Caudillo,664,344,320
13,Ciudad Real,52,Malagón,8009,3951,4058
13,Ciudad Real,53,Manzanares,18157,9039,9118
13,Ciudad Real,54,Membrilla,6575,3290,3285
13,Ciudad Real,55,Mestanza,869,420,449
13,Ciudad Real,56,Miguelturra,10978,5520,5458
13,Ciudad Real,57,Montiel,1690,854,836
13,Ciudad Real,58,Moral de Calatrava,5241,2625,2616
13,Ciudad Real,59,Navalpino,283,138,145
13,Ciudad Real,60,Navas de Estena,397,214,183
13,Ciudad Real,61,Pedro Muñoz,7454,3795,3659
13,Ciudad Real,62,Picón,662,345,317
13,Ciudad Real,63,Piedrabuena,4759,2426,2333
13,Ciudad Real,64,Poblete,867,431,436
13,Ciudad Real,65,Porzuna,3868,1961,1907
13,Ciudad Real,66,Pozuelo de Calatrava,2603,1305,1298
13,Ciudad Real,67,Pozuelos de Calatrava (Los),491,249,242
13,Ciudad Real,68,Puebla de Don Rodrigo,1297,690,607
13,Ciudad Real,69,Puebla del Príncipe,1000,497,503
13,Ciudad Real,70,Puerto Lápice,1015,506,509
13,Ciudad Real,71,Puertollano,49804,24195,25609
13,Ciudad Real,72,Retuerta del Bullaque,1031,544,487
13,Ciudad Real,901,Robledo (El),1079,559,520
13,Ciudad Real,902,Ruidera,582,300,282
13,Ciudad Real,73,Saceruela,727,377,350
13,Ciudad Real,74,San Carlos del Valle,1223,611,612
13,Ciudad Real,75,San Lorenzo de Calatrava,279,144,135
13,Ciudad Real,76,Santa Cruz de los Cáñamos,638,315,323
13,Ciudad Real,77,Santa Cruz de Mudela,4772,2339,2433
13,Ciudad Real,78,Socuéllamos,11994,6024,5970
13,Ciudad Real,79,Solana (La),15392,7728,7664
13,Ciudad Real,80,Solana del Pino,474,235,239
13,Ciudad Real,81,Terrinches,1014,544,470
13,Ciudad Real,82,Tomelloso,31503,15628,15875
13,Ciudad Real,83,Torralba de Calatrava,2865,1413,1452
13,Ciudad Real,84,Torre de Juan Abad,1369,667,702
13,Ciudad Real,85,Torrenueva,3177,1621,1556
13,Ciudad Real,86,Valdemanco del Esteras,274,134,140
13,Ciudad Real,87,Valdepeñas,26880,13014,13866
13,Ciudad Real,88,Valenzuela de Calatrava,822,397,425
13,Ciudad Real,89,Villahermosa,2486,1178,1308
13,Ciudad Real,90,Villamanrique,1549,752,797
13,Ciudad Real,91,Villamayor de Calatrava,630,317,313
13,Ciudad Real,92,Villanueva de la Fuente,2607,1299,1308
13,Ciudad Real,93,Villanueva de los Infantes,5839,2853,2986
13,Ciudad Real,94,Villanueva de San Carlos,421,211,210
13,Ciudad Real,95,Villar del Pozo,112,59,53
13,Ciudad Real,96,Villarrubia de los Ojos,9931,4994,4937
13,Ciudad Real,97,Villarta de San Juan,3006,1538,1468
13,Ciudad Real,98,Viso del Marqués,2969,1478,1491
14,Córdoba,1,Adamuz,4423,2225,2198
14,Córdoba,2,Aguilar de la Frontera,13546,6716,6830
14,Córdoba,3,Alcaracejos,1428,700,728
14,Córdoba,4,Almedinilla,2565,1280,1285
14,Córdoba,5,Almodóvar del Río,7123,3516,3607
14,Córdoba,6,Añora,1551,763,788
14,Córdoba,7,Baena,19716,9792,9924
14,Córdoba,8,Belalcázar,3646,1767,1879
14,Córdoba,9,Belmez,3588,1728,1860
14,Córdoba,10,Benamejí,4854,2443,2411
14,Córdoba,11,Blázquez (Los),681,347,334
14,Córdoba,12,Bujalance,7995,3933,4062
14,Córdoba,13,Cabra,20724,10085,10639
14,Córdoba,14,Cañete de las Torres,3221,1618,1603
14,Córdoba,15,Carcabuey,2800,1409,1391
14,Córdoba,16,Cardeña,1755,889,866
14,Córdoba,17,Carlota (La),10944,5493,5451
14,Córdoba,18,Carpio (El),4463,2192,2271
14,Córdoba,19,Castro del Río,8083,3994,4089
14,Córdoba,20,Conquista,488,239,249
14,Córdoba,21,Córdoba,318628,153468,165160
14,Córdoba,22,Doña Mencía,4981,2472,2509
14,Córdoba,23,Dos Torres,2575,1259,1316
14,Córdoba,24,Encinas Reales,2364,1168,1196
14,Córdoba,25,Espejo,3840,1920,1920
14,Córdoba,26,Espiel,2434,1200,1234
14,Córdoba,27,Fernán-Núñez,9451,4726,4725
14,Córdoba,28,Fuente la Lancha,413,197,216
14,Córdoba,29,Fuente Obejuna,5615,2827,2788
14,Córdoba,30,Fuente Palmera,10042,5051,4991
14,Córdoba,31,Fuente-Tójar,800,381,419
14,Córdoba,32,Granjuela (La),502,261,241
14,Córdoba,33,Guadalcázar,1196,600,596
14,Córdoba,34,Guijo (El),405,204,201
14,Córdoba,35,Hinojosa del Duque,7744,3730,4014
14,Córdoba,36,Hornachuelos,4622,2333,2289
14,Córdoba,37,Iznájar,4895,2453,2442
14,Córdoba,38,Lucena,38598,19223,19375
14,Córdoba,39,Luque,3271,1620,1651
14,Córdoba,40,Montalbán de Córdoba,4520,2280,2240
14,Córdoba,41,Montemayor,3826,1915,1911
14,Córdoba,42,Montilla,23245,11507,11738
14,Córdoba,43,Montoro,9509,4673,4836
14,Córdoba,44,Monturque,1943,965,978
14,Córdoba,45,Moriles,3808,1904,1904
14,Córdoba,46,Nueva Carteya,5590,2817,2773
14,Córdoba,47,Obejo,1547,781,766
14,Córdoba,48,Palenciana,1567,779,788
14,Córdoba,49,Palma del Río,19693,9827,9866
14,Córdoba,50,Pedro Abad,2905,1447,1458
14,Córdoba,51,Pedroche,1760,870,890
14,Córdoba,52,Peñarroya-Pueblonuevo,12453,5961,6492
14,Córdoba,53,Posadas,7117,3523,3594
14,Córdoba,54,Pozoblanco,16612,8036,8576
14,Córdoba,55,Priego de Córdoba,22811,11245,11566
14,Córdoba,56,Puente Genil,28139,13922,14217
14,Córdoba,57,Rambla (La),7389,3673,3716
14,Córdoba,58,Rute,9970,4924,5046
14,Córdoba,59,San Sebastián de los Ballesteros,834,432,402
14,Córdoba,61,Santa Eufemia,1061,538,523
14,Córdoba,60,Santaella,5943,2986,2957
14,Córdoba,62,Torrecampo,1408,678,730
14,Córdoba,63,Valenzuela,1392,678,714
14,Córdoba,64,Valsequillo,427,205,222
14,Córdoba,65,Victoria (La),1749,877,872
14,Córdoba,66,Villa del Río,7296,3696,3600
14,Córdoba,67,Villafranca de Córdoba,3702,1901,1801
14,Córdoba,68,Villaharta,626,314,312
14,Córdoba,69,Villanueva de Córdoba,9263,4520,4743
14,Córdoba,70,Villanueva del Duque,1711,816,895
14,Córdoba,71,Villanueva del Rey,1242,633,609
14,Córdoba,72,Villaralto,1458,699,759
14,Córdoba,73,Villaviciosa de Córdoba,3679,1889,1790
14,Córdoba,74,Viso (El),2928,1423,1505
14,Córdoba,75,Zuheros,851,433,418
15,Coruña (A),1,Abegondo,5761,2883,2878
15,Coruña (A),2,Ames,20016,9718,10298
15,Coruña (A),3,Aranga,2307,1160,1147
15,Coruña (A),4,Ares,5188,2566,2622
15,Coruña (A),5,Arteixo,24668,12357,12311
15,Coruña (A),6,Arzúa,6676,3262,3414
15,Coruña (A),7,Baña (A),5036,2429,2607
15,Coruña (A),8,Bergondo,6391,3119,3272
15,Coruña (A),9,Betanzos,12822,6069,6753
15,Coruña (A),10,Boimorto,2500,1266,1234
15,Coruña (A),11,Boiro,18241,8863,9378
15,Coruña (A),12,Boqueixón,4263,2090,2173
15,Coruña (A),13,Brión,6576,3169,3407
15,Coruña (A),14,Cabana de Bergantiños,5447,2683,2764
15,Coruña (A),15,Cabanas,3330,1650,1680
15,Coruña (A),16,Camariñas,6597,3256,3341
15,Coruña (A),17,Cambre,20297,9994,10303
15,Coruña (A),18,Capela (A),1520,740,780
15,Coruña (A),19,Carballo,28949,14088,14861
15,Coruña (A),901,Cariño,4812,2347,2465
15,Coruña (A),20,Carnota,5421,2599,2822
15,Coruña (A),21,Carral,5373,2641,2732
15,Coruña (A),22,Cedeira,7498,3686,3812
15,Coruña (A),23,Cee,7308,3536,3772
15,Coruña (A),24,Cerceda,5471,2668,2803
15,Coruña (A),25,Cerdido,1589,771,818
15,Coruña (A),26,Cesuras,2509,1242,1267
15,Coruña (A),27,Coirós,1602,786,816
15,Coruña (A),28,Corcubión,1997,962,1035
15,Coruña (A),29,Coristanco,7860,3836,4024
15,Coruña (A),30,Coruña (A),243902,113858,130044
15,Coruña (A),31,Culleredo,23851,11638,12213
15,Coruña (A),32,Curtis,4438,2169,2269
15,Coruña (A),33,Dodro,3209,1562,1647
15,Coruña (A),34,Dumbría,4307,2085,2222
15,Coruña (A),35,Fene,14530,7072,7458
15,Coruña (A),36,Ferrol,78764,36794,41970
15,Coruña (A),37,Fisterra,5141,2600,2541
15,Coruña (A),38,Frades,2975,1474,1501
15,Coruña (A),39,Irixoa,1632,813,819
15,Coruña (A),41,Laracha (A),10782,5273,5509
15,Coruña (A),40,Laxe,3544,1771,1773
15,Coruña (A),42,Lousame,3957,1903,2054
15,Coruña (A),43,Malpica de Bergantiños,6944,3405,3539
15,Coruña (A),44,Mañón,1848,889,959
15,Coruña (A),45,Mazaricos,5787,2787,3000
15,Coruña (A),46,Melide,8345,4095,4250
15,Coruña (A),47,Mesía,3240,1620,1620
15,Coruña (A),48,Miño,5096,2423,2673
15,Coruña (A),49,Moeche,1478,682,796
15,Coruña (A),50,Monfero,2552,1298,1254
15,Coruña (A),51,Mugardos,5737,2762,2975
15,Coruña (A),53,Muros,10095,4860,5235
15,Coruña (A),52,Muxía,6029,2957,3072
15,Coruña (A),54,Narón,33825,16392,17433
15,Coruña (A),55,Neda,5913,2889,3024
15,Coruña (A),56,Negreira,6529,3118,3411
15,Coruña (A),57,Noia,14586,6977,7609
15,Coruña (A),58,Oleiros,28643,13898,14745
15,Coruña (A),59,Ordes,12266,5974,6292
15,Coruña (A),60,Oroso,5933,2946,2987
15,Coruña (A),61,Ortigueira,8022,3819,4203
15,Coruña (A),62,Outes,8243,3934,4309
15,Coruña (A),63,Oza dos Ríos,3125,1501,1624
15,Coruña (A),64,Paderne,2680,1291,1389
15,Coruña (A),65,Padrón,9136,4375,4761
15,Coruña (A),66,Pino (O),4948,2446,2502
15,Coruña (A),67,Pobra do Caramiñal (A),10010,4807,5203
15,Coruña (A),68,Ponteceso,6880,3436,3444
15,Coruña (A),69,Pontedeume,8746,4198,4548
15,Coruña (A),70,Pontes de García Rodríguez (As),12108,6077,6031
15,Coruña (A),71,Porto do Son,10134,4993,5141
15,Coruña (A),72,Rianxo,11629,5663,5966
15,Coruña (A),73,Ribeira,26589,13117,13472
15,Coruña (A),74,Rois,5137,2429,2708
15,Coruña (A),75,Sada,11963,5873,6090
15,Coruña (A),76,San Sadurniño,3272,1592,1680
15,Coruña (A),77,Santa Comba,10823,5295,5528
15,Coruña (A),78,Santiago de Compostela,92339,43261,49078
15,Coruña (A),79,Santiso,2249,1149,1100
15,Coruña (A),80,Sobrado,2400,1216,1184
15,Coruña (A),81,Somozas (As),1407,701,706
15,Coruña (A),82,Teo,16028,7864,8164
15,Coruña (A),83,Toques,1550,795,755
15,Coruña (A),84,Tordoia,4841,2302,2539
15,Coruña (A),85,Touro,4699,2318,2381
15,Coruña (A),86,Trazo,3728,1834,1894
15,Coruña (A),88,Val do Dubra,4720,2287,2433
15,Coruña (A),87,Valdoviño,6877,3375,3502
15,Coruña (A),89,Vedra,5037,2439,2598
15,Coruña (A),91,Vilarmaior,1350,688,662
15,Coruña (A),90,Vilasantar,1610,835,775
15,Coruña (A),92,Vimianzo,8653,4212,4441
15,Coruña (A),93,Zas,5978,2927,3051
16,Cuenca,1,Abia de la Obispalía,89,49,40
16,Cuenca,2,Acebrón (El),271,138,133
16,Cuenca,3,Alarcón,174,82,92
16,Cuenca,4,Albaladejo del Cuende,379,196,183
16,Cuenca,5,Albalate de las Nogueras,345,191,154
16,Cuenca,6,Albendea,174,90,84
16,Cuenca,7,Alberca de Záncara (La),1859,921,938
16,Cuenca,8,Alcalá de la Vega,169,88,81
16,Cuenca,9,Alcantud,109,61,48
16,Cuenca,10,Alcázar del Rey,228,111,117
16,Cuenca,11,Alcohujate,56,31,25
16,Cuenca,12,Alconchel de la Estrella,202,106,96
16,Cuenca,13,Algarra,35,19,16
16,Cuenca,14,Aliaguilla,830,430,400
16,Cuenca,15,Almarcha (La),583,305,278
16,Cuenca,16,Almendros,322,157,165
16,Cuenca,17,Almodóvar del Pinar,519,269,250
16,Cuenca,18,Almonacid del Marquesado,525,268,257
16,Cuenca,19,Altarejos,277,145,132
16,Cuenca,20,Arandilla del Arroyo,37,20,17
16,Cuenca,905,Arcas del Villar,842,427,415
16,Cuenca,22,Arcos de la Sierra,113,58,55
16,Cuenca,24,Arguisuelas,189,102,87
16,Cuenca,25,Arrancacepas,40,20,20
16,Cuenca,26,Atalaya del Cañavate,122,63,59
16,Cuenca,27,Barajas de Melo,781,399,382
16,Cuenca,29,Barchín del Hoyo,126,71,55
16,Cuenca,30,Bascuñana de San Pedro,36,21,15
16,Cuenca,31,Beamud,113,60,53
16,Cuenca,32,Belinchón,343,174,169
16,Cuenca,33,Belmonte,2329,1124,1205
16,Cuenca,34,Belmontejo,242,117,125
16,Cuenca,35,Beteta,425,209,216
16,Cuenca,36,Boniches,176,92,84
16,Cuenca,38,Buciegas,74,38,36
16,Cuenca,39,Buenache de Alarcón,625,324,301
16,Cuenca,40,Buenache de la Sierra,100,66,34
16,Cuenca,41,Buendía,523,257,266
16,Cuenca,42,Campillo de Altobuey,1718,870,848
16,Cuenca,43,Campillos-Paravientos,134,76,58
16,Cuenca,44,Campillos-Sierra,82,46,36
16,Cuenca,901,Campos del Paraíso,1022,479,543
16,Cuenca,45,Canalejas del Arroyo,380,197,183
16,Cuenca,46,Cañada del Hoyo,329,173,156
16,Cuenca,47,Cañada Juncosa,338,184,154
16,Cuenca,48,Cañamares,606,325,281
16,Cuenca,49,Cañavate (El),223,108,115
16,Cuenca,50,Cañaveras,386,194,192
16,Cuenca,51,Cañaveruelas,204,96,108
16,Cuenca,52,Cañete,887,441,446
16,Cuenca,53,Cañizares,610,311,299
16,Cuenca,55,Carboneras de Guadazaón,973,508,465
16,Cuenca,56,Cardenete,706,365,341
16,Cuenca,57,Carrascosa,111,66,45
16,Cuenca,58,Carrascosa de Haro,142,72,70
16,Cuenca,60,Casas de Benítez,1109,538,571
16,Cuenca,61,Casas de Fernando Alonso,1357,685,672
16,Cuenca,62,Casas de Garcimolina,33,20,13
16,Cuenca,63,Casas de Guijarro,132,65,67
16,Cuenca,64,Casas de Haro,878,465,413
16,Cuenca,65,Casas de los Pinos,532,252,280
16,Cuenca,66,Casasimarro,3038,1548,1490
16,Cuenca,67,Castejón,217,105,112
16,Cuenca,68,Castillejo de Iniesta,165,93,72
16,Cuenca,70,Castillejo-Sierra,49,25,24
16,Cuenca,72,Castillo de Garcimuñoz,196,102,94
16,Cuenca,71,Castillo-Albaráñez,29,15,14
16,Cuenca,73,Cervera del Llano,297,157,140
16,Cuenca,74,Cierva (La),53,29,24
16,Cuenca,78,Cuenca,47201,22676,24525
16,Cuenca,79,Cueva del Hierro,51,31,20
16,Cuenca,23,Chillarón de Cuenca,409,225,184
16,Cuenca,81,Chumillas,80,42,38
16,Cuenca,82,Enguídanos,497,252,245
16,Cuenca,83,Fresneda de Altarejos,86,46,40
16,Cuenca,84,Fresneda de la Sierra,73,35,38
16,Cuenca,85,Frontera (La),212,108,104
16,Cuenca,86,Fuente de Pedro Naharro,1231,638,593
16,Cuenca,87,Fuentelespino de Haro,319,164,155
16,Cuenca,88,Fuentelespino de Moya,175,93,82
16,Cuenca,904,Fuentenava de Jábaga,449,233,216
16,Cuenca,89,Fuentes,524,271,253
16,Cuenca,91,Fuertescusa,113,60,53
16,Cuenca,92,Gabaldón,197,118,79
16,Cuenca,93,Garaballa,146,78,68
16,Cuenca,94,Gascueña,152,66,86
16,Cuenca,95,Graja de Campalbo,128,69,59
16,Cuenca,96,Graja de Iniesta,348,180,168
16,Cuenca,97,Henarejos,252,126,126
16,Cuenca,98,Herrumblar (El),769,392,377
16,Cuenca,99,Hinojosa (La),304,151,153
16,Cuenca,100,Hinojosos (Los),1067,540,527
16,Cuenca,101,Hito (El),230,115,115
16,Cuenca,102,Honrubia,1649,813,836
16,Cuenca,103,Hontanaya,415,210,205
16,Cuenca,104,Hontecillas,96,45,51
16,Cuenca,106,Horcajo de Santiago,3585,1833,1752
16,Cuenca,107,Huélamo,128,68,60
16,Cuenca,108,Huelves,66,32,34
16,Cuenca,109,Huérguina,108,57,51
16,Cuenca,110,Huerta de la Obispalía,148,86,62
16,Cuenca,111,Huerta del Marquesado,228,129,99
16,Cuenca,112,Huete,2071,1040,1031
16,Cuenca,113,Iniesta,4204,2111,2093
16,Cuenca,115,Laguna del Marquesado,70,36,34
16,Cuenca,116,Lagunaseca,129,58,71
16,Cuenca,117,Landete,1413,708,705
16,Cuenca,118,Ledaña,1907,966,941
16,Cuenca,119,Leganiel,239,121,118
16,Cuenca,121,Majadas (Las),355,176,179
16,Cuenca,122,Mariana,306,147,159
16,Cuenca,123,Masegosa,123,67,56
16,Cuenca,124,Mesas (Las),2432,1248,1184
16,Cuenca,125,Minglanilla,2324,1198,1126
16,Cuenca,126,Mira,1180,611,569
16,Cuenca,128,Monreal del Llano,77,40,37
16,Cuenca,129,Montalbanejo,176,83,93
16,Cuenca,130,Montalbo,736,378,358
16,Cuenca,131,Monteagudo de las Salinas,131,77,54
16,Cuenca,132,Mota de Altarejos,55,33,22
16,Cuenca,133,Mota del Cuervo,5785,2911,2874
16,Cuenca,134,Motilla del Palancar,5390,2701,2689
16,Cuenca,135,Moya,279,147,132
16,Cuenca,137,Narboneta,141,73,68
16,Cuenca,139,Olivares de Júcar,513,264,249
16,Cuenca,140,Olmeda de la Cuesta,41,21,20
16,Cuenca,141,Olmeda del Rey,221,106,115
16,Cuenca,142,Olmedilla de Alarcón,148,84,64
16,Cuenca,143,Olmedilla de Eliz,27,14,13
16,Cuenca,145,Osa de la Vega,631,317,314
16,Cuenca,146,Pajarón,123,66,57
16,Cuenca,147,Pajaroncillo,91,47,44
16,Cuenca,148,Palomares del Campo,939,456,483
16,Cuenca,149,Palomera,187,90,97
16,Cuenca,150,Paracuellos,147,71,76
16,Cuenca,151,Paredes,90,46,44
16,Cuenca,152,Parra de las Vegas (La),50,26,24
16,Cuenca,153,Pedernoso (El),1305,656,649
16,Cuenca,154,Pedroñeras (Las),6925,3736,3189
16,Cuenca,155,Peral (El),719,372,347
16,Cuenca,156,Peraleja (La),147,74,73
16,Cuenca,157,Pesquera (La),273,140,133
16,Cuenca,158,Picazo (El),719,364,355
16,Cuenca,159,Pinarejo,373,181,192
16,Cuenca,160,Pineda de Gigüela,140,73,67
16,Cuenca,161,Piqueras del Castillo,80,43,37
16,Cuenca,162,Portalrubio de Guadamejud,69,35,34
16,Cuenca,163,Portilla,99,47,52
16,Cuenca,165,Poyatos,104,62,42
16,Cuenca,166,Pozoamargo,323,159,164
16,Cuenca,908,Pozorrubielos de la Mancha,262,130,132
16,Cuenca,167,Pozorrubio,448,217,231
16,Cuenca,169,Pozuelo (El),110,52,58
16,Cuenca,170,Priego,1054,541,513
16,Cuenca,171,Provencio (El),2610,1319,1291
16,Cuenca,172,Puebla de Almenara,504,255,249
16,Cuenca,173,Puebla de Don Francisco,320,166,154
16,Cuenca,174,Puebla del Salvador,271,143,128
16,Cuenca,175,Quintanar del Rey,6940,3652,3288
16,Cuenca,176,Rada de Haro,58,32,26
16,Cuenca,177,Reíllo,136,69,67
16,Cuenca,181,Rozalén del Monte,102,45,57
16,Cuenca,185,Saceda-Trasierra,118,69,49
16,Cuenca,186,Saelices,636,324,312
16,Cuenca,187,Salinas del Manzano,107,59,48
16,Cuenca,188,Salmeroncillos,181,92,89
16,Cuenca,189,Salvacañete,333,177,156
16,Cuenca,190,San Clemente,6679,3407,3272
16,Cuenca,191,San Lorenzo de la Parrilla,1373,691,682
16,Cuenca,192,San Martín de Boniches,98,45,53
16,Cuenca,193,San Pedro Palmiches,100,51,49
16,Cuenca,194,Santa Cruz de Moya,408,209,199
16,Cuenca,196,Santa María de los Llanos,819,424,395
16,Cuenca,195,Santa María del Campo Rus,745,374,371
16,Cuenca,197,Santa María del Val,110,62,48
16,Cuenca,198,Sisante,1825,921,904
16,Cuenca,199,Solera de Gabaldón,44,21,23
16,Cuenca,909,Sotorribas,968,478,490
16,Cuenca,202,Talayuelas,1171,608,563
16,Cuenca,203,Tarancón,12375,6128,6247
16,Cuenca,204,Tébar,361,192,169
16,Cuenca,205,Tejadillos,200,98,102
16,Cuenca,206,Tinajas,372,202,170
16,Cuenca,209,Torralba,193,103,90
16,Cuenca,211,Torrejoncillo del Rey,662,317,345
16,Cuenca,212,Torrubia del Campo,328,161,167
16,Cuenca,213,Torrubia del Castillo,37,20,17
16,Cuenca,215,Tragacete,391,209,182
16,Cuenca,216,Tresjuncos,448,227,221
16,Cuenca,217,Tribaldos,137,62,75
16,Cuenca,218,Uclés,303,141,162
16,Cuenca,219,Uña,138,75,63
16,Cuenca,906,Valdecolmenas (Los),116,67,49
16,Cuenca,224,Valdemeca,106,61,45
16,Cuenca,225,Valdemorillo de la Sierra,83,45,38
16,Cuenca,227,Valdemoro-Sierra,180,100,80
16,Cuenca,228,Valdeolivas,268,148,120
16,Cuenca,902,Valdetórtola,144,81,63
16,Cuenca,903,Valeras (Las),1403,722,681
16,Cuenca,231,Valhermoso de la Fuente,49,23,26
16,Cuenca,234,Valsalobre,70,37,33
16,Cuenca,236,Valverde de Júcar,1331,681,650
16,Cuenca,237,Valverdejo,133,64,69
16,Cuenca,238,Vara de Rey,637,326,311
16,Cuenca,239,Vega del Codorno,226,114,112
16,Cuenca,240,Vellisca,157,76,81
16,Cuenca,242,Villaconejos de Trabaque,478,241,237
16,Cuenca,243,Villaescusa de Haro,572,291,281
16,Cuenca,244,Villagarcía del Llano,936,479,457
16,Cuenca,245,Villalba de la Sierra,559,285,274
16,Cuenca,246,Villalba del Rey,663,339,324
16,Cuenca,247,Villalgordo del Marquesado,114,59,55
16,Cuenca,248,Villalpardo,1124,566,558
16,Cuenca,249,Villamayor de Santiago,2710,1366,1344
16,Cuenca,250,Villanueva de Guadamejud,114,60,54
16,Cuenca,251,Villanueva de la Jara,2287,1166,1121
16,Cuenca,253,Villar de Cañas,425,223,202
16,Cuenca,254,Villar de Domingo García,271,142,129
16,Cuenca,255,Villar de la Encina,223,110,113
16,Cuenca,263,Villar de Olalla,983,505,478
16,Cuenca,258,Villar del Humo,397,233,164
16,Cuenca,259,Villar del Infantado,45,27,18
16,Cuenca,910,Villar y Velasco,116,62,54
16,Cuenca,264,Villarejo de Fuentes,710,339,371
16,Cuenca,265,Villarejo de la Peñuela,27,11,16
16,Cuenca,266,Villarejo-Periesteban,505,257,248
16,Cuenca,269,Villares del Saz,649,329,320
16,Cuenca,270,Villarrubio,257,127,130
16,Cuenca,271,Villarta,806,416,390
16,Cuenca,272,Villas de la Ventosa,362,192,170
16,Cuenca,273,Villaverde y Pasaconsol,412,198,214
16,Cuenca,274,Víllora,243,103,140
16,Cuenca,275,Vindel,18,9,9
16,Cuenca,276,Yémeda,25,12,13
16,Cuenca,277,Zafra de Záncara,177,92,85
16,Cuenca,278,Zafrilla,118,55,63
16,Cuenca,279,Zarza de Tajo,250,124,126
16,Cuenca,280,Zarzuela,267,138,129
17,Girona,1,Agullana,723,369,354
17,Girona,2,Aiguaviva,587,295,292
17,Girona,3,Albanyà,116,62,54
17,Girona,4,Albons,607,322,285
17,Girona,6,Alp,1297,685,612
17,Girona,7,Amer,2189,1075,1114
17,Girona,8,Anglès,5049,2606,2443
17,Girona,9,Arbúcies,5599,2953,2646
17,Girona,10,Argelaguer,406,217,189
17,Girona,11,Armentera (L'),747,373,374
17,Girona,12,Avinyonet de Puigventós,955,481,474
17,Girona,15,Banyoles,16244,8077,8167
17,Girona,16,Bàscara,844,436,408
17,Girona,13,Begur,3748,1913,1835
17,Girona,18,Bellcaire d'Empordà,619,331,288
17,Girona,19,Besalú,2112,1029,1083
17,Girona,20,Bescanó,3525,1762,1763
17,Girona,21,Beuda,139,76,63
17,Girona,22,Bisbal d'Empordà (La),8651,4317,4334
17,Girona,234,Biure,232,116,116
17,Girona,23,Blanes,34477,17386,17091
17,Girona,29,Boadella d'Empordà,236,115,121
17,Girona,24,Bolvir,271,140,131
17,Girona,25,Bordils,1422,711,711
17,Girona,26,Borrassà,524,265,259
17,Girona,27,Breda,3543,1816,1727
17,Girona,28,Brunyola,362,184,178
17,Girona,31,Cabanelles,240,136,104
17,Girona,30,Cabanes,811,428,383
17,Girona,32,Cadaqués,2612,1271,1341
17,Girona,33,Caldes de Malavella,4602,2322,2280
17,Girona,34,Calonge,8282,4192,4090
17,Girona,35,Camós,661,344,317
17,Girona,36,Campdevànol,3374,1661,1713
17,Girona,37,Campelles,124,66,58
17,Girona,38,Campllong,338,173,165
17,Girona,39,Camprodon,2343,1154,1189
17,Girona,40,Canet d'Adri,519,271,248
17,Girona,41,Cantallops,265,126,139
17,Girona,42,Capmany,481,250,231
17,Girona,44,Cassà de la Selva,8150,4124,4026
17,Girona,46,Castellfollit de la Roca,984,500,484
17,Girona,47,Castelló d'Empúries,8165,4232,3933
17,Girona,48,Castell-Platja d'Aro,7905,4013,3892
17,Girona,49,Celrà,3072,1526,1546
17,Girona,189,Cellera de Ter (La),2064,1048,1016
17,Girona,50,Cervià de Ter,702,348,354
17,Girona,51,Cistella,232,117,115
17,Girona,54,Colera,613,307,306
17,Girona,55,Colomers,206,104,102
17,Girona,57,Corçà,1174,596,578
17,Girona,56,Cornellà del Terri,1918,967,951
17,Girona,58,Crespià,231,110,121
17,Girona,901,"Cruïlles, Monells i Sant Sadurní de l'Heura",1168,584,584
17,Girona,60,Darnius,519,269,250
17,Girona,61,Das,159,87,72
17,Girona,62,Escala (L'),6997,3545,3452
17,Girona,63,Espinelves,191,101,90
17,Girona,64,Espolla,374,185,189
17,Girona,65,Esponellà,422,209,213
17,Girona,5,Far d'Empordà (El),404,209,195
17,Girona,66,Figueres,36338,17713,18625
17,Girona,67,Flaçà,900,457,443
17,Girona,68,Foixà,303,149,154
17,Girona,69,Fontanals de Cerdanya,419,198,221
17,Girona,70,Fontanilles,165,95,70
17,Girona,71,Fontcoberta,1152,558,594
17,Girona,902,Forallac,1684,818,866
17,Girona,73,Fornells de la Selva,1691,819,872
17,Girona,74,Fortià,534,262,272
17,Girona,75,Garrigàs,313,173,140
17,Girona,76,Garrigoles,144,75,69
17,Girona,77,Garriguella,702,364,338
17,Girona,78,Ger,376,200,176
17,Girona,79,Girona,81220,39266,41954
17,Girona,80,Gombrèn,239,113,126
17,Girona,81,Gualta,321,181,140
17,Girona,82,Guils de Cerdanya,347,172,175
17,Girona,83,Hostalric,3019,1496,1523
17,Girona,84,Isòvol,205,115,90
17,Girona,85,Jafre,348,184,164
17,Girona,86,Jonquera (La),2849,1450,1399
17,Girona,87,Juià,262,128,134
17,Girona,88,Lladó,541,277,264
17,Girona,89,Llagostera,6293,3233,3060
17,Girona,90,Llambilles,504,257,247
17,Girona,91,Llanars,511,274,237
17,Girona,92,Llançà,4232,2105,2127
17,Girona,93,Llers,1068,536,532
17,Girona,94,Llívia,1160,617,543
17,Girona,95,Lloret de Mar,25457,13111,12346
17,Girona,96,Llosses (Les),262,142,120
17,Girona,102,Maçanet de Cabrenys,700,361,339
17,Girona,103,Maçanet de la Selva,4524,2308,2216
17,Girona,97,Madremanya,188,84,104
17,Girona,98,Maià de Montcal,346,182,164
17,Girona,100,Masarac,251,119,132
17,Girona,101,Massanes,567,304,263
17,Girona,99,Meranges,81,50,31
17,Girona,105,Mieres,347,181,166
17,Girona,106,Mollet de Peralada,172,90,82
17,Girona,107,Molló,333,167,166
17,Girona,109,Montagut i Oix,839,434,405
17,Girona,110,Mont-ras,1749,914,835
17,Girona,111,Navata,793,394,399
17,Girona,112,Ogassa,255,147,108
17,Girona,114,Olot,29546,14622,14924
17,Girona,115,Ordis,345,180,165
17,Girona,116,Osor,437,224,213
17,Girona,117,Palafrugell,19635,10041,9594
17,Girona,118,Palamós,15968,7943,8025
17,Girona,119,Palau de Santa Eulàlia,86,50,36
17,Girona,121,Palau-sator,287,147,140
17,Girona,120,Palau-saverdera,1068,538,530
17,Girona,123,Palol de Revardit,417,220,197
17,Girona,124,Pals,2143,1083,1060
17,Girona,125,Pardines,146,76,70
17,Girona,126,Parlavà,348,177,171
17,Girona,128,Pau,471,241,230
17,Girona,129,Pedret i Marzà,142,71,71
17,Girona,130,Pera (La),401,202,199
17,Girona,132,Peralada,1413,728,685
17,Girona,133,Planes d'Hostoles (Les),1728,866,862
17,Girona,134,Planoles,292,157,135
17,Girona,135,Pont de Molins,464,245,219
17,Girona,136,Pontós,215,118,97
17,Girona,137,Porqueres,3803,1882,1921
17,Girona,140,Port de la Selva (El),913,463,450
17,Girona,138,Portbou,1399,692,707
17,Girona,139,Preses (Les),1554,759,795
17,Girona,141,Puigcerdà,8034,4173,3861
17,Girona,142,Quart,2586,1301,1285
17,Girona,43,Queralbs,192,107,85
17,Girona,143,Rabós,154,78,76
17,Girona,144,Regencós,288,162,126
17,Girona,145,Ribes de Freser,2049,1011,1038
17,Girona,146,Riells i Viabrea,2541,1333,1208
17,Girona,147,Ripoll,10754,5245,5509
17,Girona,148,Riudarenes,1432,742,690
17,Girona,149,Riudaura,411,204,207
17,Girona,150,Riudellots de la Selva,1707,868,839
17,Girona,151,Riumors,174,86,88
17,Girona,152,Roses,14719,7441,7278
17,Girona,153,Rupià,179,96,83
17,Girona,154,Sales de Llierca,109,57,52
17,Girona,155,Salt,24513,12643,11870
17,Girona,157,Sant Andreu Salou,144,66,78
17,Girona,183,Sant Aniol de Finestres,292,154,138
17,Girona,158,Sant Climent Sescebes,423,215,208
17,Girona,159,Sant Feliu de Buixalleu,722,390,332
17,Girona,160,Sant Feliu de Guíxols,19456,9639,9817
17,Girona,161,Sant Feliu de Pallerols,1190,582,608
17,Girona,162,Sant Ferriol,209,116,93
17,Girona,163,Sant Gregori,2590,1335,1255
17,Girona,164,Sant Hilari Sacalm,5375,2807,2568
17,Girona,165,Sant Jaume de Llierca,764,392,372
17,Girona,167,Sant Joan de les Abadesses,3602,1785,1817
17,Girona,168,Sant Joan de Mollet,419,207,212
17,Girona,185,Sant Joan les Fonts,2718,1368,1350
17,Girona,166,Sant Jordi Desvalls,630,318,312
17,Girona,169,Sant Julià de Ramis,2240,1138,1102
17,Girona,903,Sant Julià del Llor i Bonmatí,1009,521,488
17,Girona,171,Sant Llorenç de la Muga,177,84,93
17,Girona,172,Sant Martí de Llémena,487,256,231
17,Girona,173,Sant Martí Vell,191,104,87
17,Girona,174,Sant Miquel de Campmajor,201,111,90
17,Girona,175,Sant Miquel de Fluvià,616,315,301
17,Girona,176,Sant Mori,160,77,83
17,Girona,177,Sant Pau de Segúries,656,333,323
17,Girona,178,Sant Pere Pescador,1604,898,706
17,Girona,180,Santa Coloma de Farners,9741,5006,4735
17,Girona,181,Santa Cristina d'Aro,3522,1819,1703
17,Girona,182,Santa Llogaia d'Àlguema,299,157,142
17,Girona,184,Santa Pau,1481,750,731
17,Girona,186,Sarrià de Ter,3858,1910,1948
17,Girona,187,Saus,708,353,355
17,Girona,188,Selva de Mar (La),202,104,98
17,Girona,190,Serinyà,901,471,430
17,Girona,191,Serra de Daró,176,97,79
17,Girona,192,Setcases,192,101,91
17,Girona,193,Sils,3512,1770,1742
17,Girona,52,Siurana,176,89,87
17,Girona,194,Susqueda,107,55,52
17,Girona,195,Tallada d'Empordà (La),332,180,152
17,Girona,196,Terrades,174,83,91
17,Girona,197,Torrent,168,92,76
17,Girona,198,Torroella de Fluvià,378,216,162
17,Girona,199,Torroella de Montgrí,9393,4778,4615
17,Girona,200,Tortellà,713,354,359
17,Girona,201,Toses,159,97,62
17,Girona,202,Tossa de Mar,4786,2425,2361
17,Girona,203,Ultramort,199,112,87
17,Girona,204,Ullà,893,498,395
17,Girona,205,Ullastret,230,117,113
17,Girona,206,Urús,203,107,96
17,Girona,14,Vajol (La),114,65,49
17,Girona,208,Vall de Bianya (La),1172,584,588
17,Girona,207,Vall d'en Bas (La),2565,1293,1272
17,Girona,170,Vallfogona de Ripollès,213,112,101
17,Girona,209,Vall-llobrega,549,249,300
17,Girona,210,Ventalló,668,347,321
17,Girona,211,Verges,1145,578,567
17,Girona,212,Vidrà,157,79,78
17,Girona,213,Vidreres,5559,2873,2686
17,Girona,214,Vilabertran,798,410,388
17,Girona,215,Vilablareix,2099,1056,1043
17,Girona,217,Viladamat,386,198,188
17,Girona,216,Viladasens,167,89,78
17,Girona,218,Vilademuls,770,403,367
17,Girona,220,Viladrau,906,469,437
17,Girona,221,Vilafant,4482,2238,2244
17,Girona,223,Vilajuïga,1013,503,510
17,Girona,224,Vilallonga de Ter,442,240,202
17,Girona,225,Vilamacolum,291,153,138
17,Girona,226,Vilamalla,868,463,405
17,Girona,227,Vilamaniscle,149,81,68
17,Girona,228,Vilanant,328,162,166
17,Girona,230,Vila-sacra,452,227,225
17,Girona,222,Vilaür,131,68,63
17,Girona,233,Vilobí d'Onyar,2430,1306,1124
17,Girona,232,Vilopriu,167,84,83
18,Granada,1,Agrón,344,180,164
18,Granada,2,Alamedilla,843,428,415
18,Granada,3,Albolote,14106,7116,6990
18,Granada,4,Albondón,967,491,476
18,Granada,5,Albuñán,446,221,225
18,Granada,6,Albuñol,5939,3034,2905
18,Granada,7,Albuñuelas,1149,585,564
18,Granada,10,Aldeire,753,380,373
18,Granada,11,Alfacar,4525,2321,2204
18,Granada,12,Algarinejo,4335,2212,2123
18,Granada,13,Alhama de Granada,6074,3129,2945
18,Granada,14,Alhendín,4506,2301,2205
18,Granada,15,Alicún de Ortega,609,326,283
18,Granada,16,Almegíjar,405,205,200
18,Granada,17,Almuñécar,23378,11564,11814
18,Granada,904,Alpujarra de la Sierra,1147,590,557
18,Granada,18,Alquife,840,421,419
18,Granada,20,Arenas del Rey,1976,1022,954
18,Granada,21,Armilla,16524,8188,8336
18,Granada,22,Atarfe,11680,5779,5901
18,Granada,23,Baza,21209,10507,10702
18,Granada,24,Beas de Granada,1061,563,498
18,Granada,25,Beas de Guadix,351,179,172
18,Granada,27,Benalúa,3239,1613,1626
18,Granada,28,Benalúa de las Villas,1366,680,686
18,Granada,29,Benamaurel,2346,1181,1165
18,Granada,30,Bérchules,769,411,358
18,Granada,32,Bubión,357,184,173
18,Granada,33,Busquístar,368,203,165
18,Granada,34,Cacín,753,383,370
18,Granada,35,Cádiar,1636,844,792
18,Granada,36,Cájar,3653,1767,1886
18,Granada,114,Calahorra (La),816,414,402
18,Granada,37,Calicasas,563,280,283
18,Granada,38,Campotéjar,1402,725,677
18,Granada,39,Caniles,4668,2308,2360
18,Granada,40,Cáñar,345,175,170
18,Granada,42,Capileira,570,282,288
18,Granada,43,Carataunas,202,104,98
18,Granada,44,Cástaras,262,136,126
18,Granada,45,Castilléjar,1617,785,832
18,Granada,46,Castril,2569,1307,1262
18,Granada,47,Cenes de la Vega,5882,3019,2863
18,Granada,48,Cijuela,1758,926,832
18,Granada,49,Cogollos de Guadix,711,373,338
18,Granada,50,Cogollos de la Vega,1957,1020,937
18,Granada,51,Colomera,1591,828,763
18,Granada,53,Cortes de Baza,2435,1239,1196
18,Granada,54,Cortes y Graena,1043,526,517
18,Granada,912,Cuevas del Campo,2050,1020,1030
18,Granada,56,Cúllar,4820,2410,2410
18,Granada,57,Cúllar Vega,4799,2450,2349
18,Granada,59,Chauchina,4251,2119,2132
18,Granada,61,Chimeneas,1493,758,735
18,Granada,62,Churriana de la Vega,7948,3912,4036
18,Granada,63,Darro,1463,726,737
18,Granada,64,Dehesas de Guadix,592,295,297
18,Granada,66,Deifontes,2338,1191,1147
18,Granada,67,Diezma,864,457,407
18,Granada,68,Dílar,1472,724,748
18,Granada,69,Dólar,591,294,297
18,Granada,70,Dúdar,310,163,147
18,Granada,71,Dúrcal,5158,2526,2632
18,Granada,72,Escúzar,781,387,394
18,Granada,74,Ferreira,327,167,160
18,Granada,76,Fonelas,1176,583,593
18,Granada,78,Freila,983,486,497
18,Granada,79,Fuente Vaqueros,3937,1961,1976
18,Granada,905,Gabias (Las),9773,5133,4640
18,Granada,82,Galera,1197,601,596
18,Granada,83,Gobernador,327,160,167
18,Granada,84,Gójar,3823,1968,1855
18,Granada,85,Gor,1084,552,532
18,Granada,86,Gorafe,541,269,272
18,Granada,87,Granada,237663,110417,127246
18,Granada,88,Guadahortuna,2179,1119,1060
18,Granada,89,Guadix,20163,9935,10228
18,Granada,906,Guajares (Los),1229,650,579
18,Granada,93,Gualchos,2694,1384,1310
18,Granada,94,Güejar Sierra,2576,1351,1225
18,Granada,95,Güevéjar,1756,883,873
18,Granada,96,Huélago,486,251,235
18,Granada,97,Huéneja,1201,606,595
18,Granada,98,Huéscar,8197,4120,4077
18,Granada,99,Huétor de Santillán,1698,881,817
18,Granada,100,Huétor Tájar,8759,4422,4337
18,Granada,101,Huétor Vega,10193,5145,5048
18,Granada,102,Illora,10130,5065,5065
18,Granada,103,Itrabo,983,490,493
18,Granada,105,Iznalloz,6885,3454,3431
18,Granada,107,Jayena,1296,673,623
18,Granada,108,Jerez del Marquesado,1066,535,531
18,Granada,109,Jete,758,368,390
18,Granada,111,Jun,1978,1010,968
18,Granada,112,Juviles,160,81,79
18,Granada,115,Láchar,2525,1280,1245
18,Granada,116,Lanjarón,3736,1825,1911
18,Granada,117,Lanteira,522,264,258
18,Granada,119,Lecrín,2274,1143,1131
18,Granada,120,Lentegí,329,160,169
18,Granada,121,Lobras,140,68,72
18,Granada,122,Loja,20576,10249,10327
18,Granada,123,Lugros,374,188,186
18,Granada,124,Lújar,514,278,236
18,Granada,126,Malahá (La),1597,814,783
18,Granada,127,Maracena,16587,8265,8322
18,Granada,128,Marchal,390,182,208
18,Granada,132,Moclín,4310,2158,2152
18,Granada,133,Molvízar,2802,1378,1424
18,Granada,134,Monachil,5684,2930,2754
18,Granada,135,Montefrío,6474,3224,3250
18,Granada,136,Montejícar,2728,1375,1353
18,Granada,137,Montillana,1336,680,656
18,Granada,138,Moraleda de Zafayona,2803,1435,1368
18,Granada,909,Morelábor,899,467,432
18,Granada,140,Motril,53597,26615,26982
18,Granada,141,Murtas,698,380,318
18,Granada,903,Nevada,1237,645,592
18,Granada,143,Nigüelas,979,486,493
18,Granada,144,Nívar,660,341,319
18,Granada,145,Ogíjares,10494,5404,5090
18,Granada,146,Orce,1390,704,686
18,Granada,147,Órgiva,5152,2580,2572
18,Granada,148,Otívar,1052,535,517
18,Granada,149,Otura,5090,2557,2533
18,Granada,150,Padul,7155,3603,3552
18,Granada,151,Pampaneira,337,177,160
18,Granada,152,Pedro Martínez,1320,653,667
18,Granada,153,Peligros,8500,4312,4188
18,Granada,154,Peza (La),1359,723,636
18,Granada,910,Pinar (El),1136,570,566
18,Granada,157,Pinos Genil,1237,645,592
18,Granada,158,Pinos Puente,13105,6661,6444
18,Granada,159,Píñar,1296,680,616
18,Granada,161,Polícar,256,128,128
18,Granada,162,Polopos,1398,784,614
18,Granada,163,Pórtugos,425,210,215
18,Granada,164,Puebla de Don Fadrique,2532,1299,1233
18,Granada,165,Pulianas,4683,2375,2308
18,Granada,167,Purullena,2356,1175,1181
18,Granada,168,Quéntar,1116,569,547
18,Granada,170,Rubite,478,247,231
18,Granada,171,Salar,2742,1382,1360
18,Granada,173,Salobreña,11134,5551,5583
18,Granada,174,Santa Cruz del Comercio,517,273,244
18,Granada,175,Santa Fe,13476,6674,6802
18,Granada,176,Soportújar,266,135,131
18,Granada,177,Sorvilán,621,332,289
18,Granada,901,Taha (La),784,396,388
18,Granada,178,Torre-Cardela,1170,571,599
18,Granada,179,Torvizcón,822,419,403
18,Granada,180,Trevélez,816,425,391
18,Granada,181,Turón,329,189,140
18,Granada,182,Ugíjar,2514,1278,1236
18,Granada,183,Válor,791,397,394
18,Granada,902,Valle (El),1170,568,602
18,Granada,907,Valle del Zalabí,2314,1142,1172
18,Granada,911,Vegas del Genil,3994,2040,1954
18,Granada,184,Vélez de Benaudalla,2508,1262,1246
18,Granada,185,Ventas de Huelma,670,334,336
18,Granada,908,Villamena,979,482,497
18,Granada,187,Villanueva de las Torres,829,434,395
18,Granada,188,Villanueva Mesía,2046,1039,1007
18,Granada,189,Víznar,753,402,351
18,Granada,192,Zafarraya,2225,1213,1012
18,Granada,913,Zagra,1089,538,551
18,Granada,193,Zubia (La),15017,7414,7603
18,Granada,194,Zújar,2700,1375,1325
19,Guadalajara,1,Abánades,107,61,46
19,Guadalajara,2,Ablanque,141,74,67
19,Guadalajara,3,Adobes,64,30,34
19,Guadalajara,4,Alaminos,82,41,41
19,Guadalajara,5,Alarilla,123,70,53
19,Guadalajara,6,Albalate de Zorita,859,463,396
19,Guadalajara,7,Albares,477,243,234
19,Guadalajara,8,Albendiego,40,27,13
19,Guadalajara,9,Alcocer,316,158,158
19,Guadalajara,10,Alcolea de las Peñas,26,14,12
19,Guadalajara,11,Alcolea del Pinar,386,192,194
19,Guadalajara,13,Alcoroches,167,92,75
19,Guadalajara,15,Aldeanueva de Guadalajara,115,55,60
19,Guadalajara,16,Algar de Mesa,78,42,36
19,Guadalajara,17,Algora,116,68,48
19,Guadalajara,18,Alhóndiga,248,136,112
19,Guadalajara,19,Alique,33,13,20
19,Guadalajara,20,Almadrones,103,58,45
19,Guadalajara,21,Almoguera,1221,642,579
19,Guadalajara,22,Almonacid de Zorita,834,397,437
19,Guadalajara,23,Alocén,178,85,93
19,Guadalajara,24,Alovera,4083,2123,1960
19,Guadalajara,27,Alustante,238,134,104
19,Guadalajara,31,Angón,35,20,15
19,Guadalajara,32,Anguita,246,129,117
19,Guadalajara,33,Anquela del Ducado,90,50,40
19,Guadalajara,34,Anquela del Pedregal,23,15,8
19,Guadalajara,36,Aranzueque,375,189,186
19,Guadalajara,37,Arbancón,197,109,88
19,Guadalajara,38,Arbeteta,59,29,30
19,Guadalajara,39,Argecilla,104,60,44
19,Guadalajara,40,Armallones,62,37,25
19,Guadalajara,41,Armuña de Tajuña,114,61,53
19,Guadalajara,42,Arroyo de las Fraguas,42,23,19
19,Guadalajara,43,Atanzón,110,68,42
19,Guadalajara,44,Atienza,433,228,205
19,Guadalajara,45,Auñón,255,134,121
19,Guadalajara,46,Azuqueca de Henares,22252,11361,10891
19,Guadalajara,47,Baides,68,33,35
19,Guadalajara,48,Baños de Tajo,28,20,8
19,Guadalajara,49,Bañuelos,27,15,12
19,Guadalajara,50,Barriopedro,31,14,17
19,Guadalajara,51,Berninches,131,75,56
19,Guadalajara,52,Bodera (La),48,29,19
19,Guadalajara,53,Brihuega,2802,1458,1344
19,Guadalajara,54,Budia,269,145,124
19,Guadalajara,55,Bujalaro,78,40,38
19,Guadalajara,57,Bustares,98,59,39
19,Guadalajara,58,Cabanillas del Campo,5664,2886,2778
19,Guadalajara,59,Campillo de Dueñas,115,65,50
19,Guadalajara,60,Campillo de Ranas,169,90,79
19,Guadalajara,61,Campisábalos,77,37,40
19,Guadalajara,64,Canredondo,107,54,53
19,Guadalajara,65,Cantalojas,146,79,67
19,Guadalajara,66,Cañizar,105,49,56
19,Guadalajara,67,Cardoso de la Sierra (El),79,55,24
19,Guadalajara,70,Casa de Uceda,106,56,50
19,Guadalajara,71,Casar (El),4826,2529,2297
19,Guadalajara,73,Casas de San Galindo,32,18,14
19,Guadalajara,74,Caspueñas,103,61,42
19,Guadalajara,75,Castejón de Henares,104,57,47
19,Guadalajara,76,Castellar de la Muela,45,24,21
19,Guadalajara,78,Castilforte,53,34,19
19,Guadalajara,79,Castilnuevo,7,4,3
19,Guadalajara,80,Cendejas de Enmedio,122,66,56
19,Guadalajara,81,Cendejas de la Torre,77,45,32
19,Guadalajara,82,Centenera,77,42,35
19,Guadalajara,86,Cifuentes,2006,1026,980
19,Guadalajara,87,Cincovillas,39,19,20
19,Guadalajara,88,Ciruelas,118,63,55
19,Guadalajara,89,Ciruelos del Pinar,52,28,24
19,Guadalajara,90,Cobeta,104,51,53
19,Guadalajara,91,Cogollor,41,21,20
19,Guadalajara,92,Cogolludo,614,352,262
19,Guadalajara,95,Condemios de Abajo,27,17,10
19,Guadalajara,96,Condemios de Arriba,176,87,89
19,Guadalajara,97,Congostrina,49,27,22
19,Guadalajara,98,Copernal,29,18,11
19,Guadalajara,99,Corduente,441,250,191
19,Guadalajara,102,Cubillo de Uceda (El),119,57,62
19,Guadalajara,103,Checa,385,214,171
19,Guadalajara,104,Chequilla,20,9,11
19,Guadalajara,105,Chiloeches,1573,815,758
19,Guadalajara,106,Chillarón del Rey,124,65,59
19,Guadalajara,107,Driebes,364,187,177
19,Guadalajara,108,Durón,162,85,77
19,Guadalajara,109,Embid,61,34,27
19,Guadalajara,110,Escamilla,107,44,63
19,Guadalajara,111,Escariche,211,113,98
19,Guadalajara,112,Escopete,61,26,35
19,Guadalajara,113,Espinosa de Henares,590,303,287
19,Guadalajara,114,Esplegares,57,33,24
19,Guadalajara,115,Establés,62,34,28
19,Guadalajara,116,Estriégana,24,15,9
19,Guadalajara,117,Fontanar,1120,585,535
19,Guadalajara,118,Fuembellida,17,9,8
19,Guadalajara,119,Fuencemillán,112,58,54
19,Guadalajara,120,Fuentelahiguera de Albatages,143,74,69
19,Guadalajara,121,Fuentelencina,216,114,102
19,Guadalajara,122,Fuentelsaz,119,55,64
19,Guadalajara,123,Fuentelviejo,71,35,36
19,Guadalajara,124,Fuentenovilla,300,166,134
19,Guadalajara,125,Gajanejos,74,42,32
19,Guadalajara,126,Galápagos,533,287,246
19,Guadalajara,127,Galve de Sorbe,132,65,67
19,Guadalajara,129,Gascueña de Bornova,54,33,21
19,Guadalajara,130,Guadalajara,70732,34622,36110
19,Guadalajara,132,Henche,115,61,54
19,Guadalajara,133,Heras de Ayuso,157,86,71
19,Guadalajara,134,Herrería,35,19,16
19,Guadalajara,135,Hiendelaencina,118,63,55
19,Guadalajara,136,Hijes,24,13,11
19,Guadalajara,138,Hita,300,165,135
19,Guadalajara,139,Hombrados,40,24,16
19,Guadalajara,142,Hontoba,213,111,102
19,Guadalajara,143,Horche,1691,880,811
19,Guadalajara,145,Hortezuela de Océn,80,42,38
19,Guadalajara,146,Huerce (La),44,28,16
19,Guadalajara,147,Huérmeces del Cerro,53,34,19
19,Guadalajara,148,Huertahernando,65,38,27
19,Guadalajara,150,Hueva,127,58,69
19,Guadalajara,151,Humanes,1230,612,618
19,Guadalajara,152,Illana,741,397,344
19,Guadalajara,153,Iniéstola,17,13,4
19,Guadalajara,154,Inviernas (Las),104,59,45
19,Guadalajara,155,Irueste,72,39,33
19,Guadalajara,156,Jadraque,1334,697,637
19,Guadalajara,157,Jirueque,80,50,30
19,Guadalajara,159,Ledanca,115,63,52
19,Guadalajara,160,Loranca de Tajuña,449,264,185
19,Guadalajara,161,Lupiana,235,123,112
19,Guadalajara,162,Luzaga,108,51,57
19,Guadalajara,163,Luzón,80,38,42
19,Guadalajara,165,Majaelrayo,70,44,26
19,Guadalajara,166,Málaga del Fresno,203,115,88
19,Guadalajara,167,Malaguilla,138,76,62
19,Guadalajara,168,Mandayona,421,208,213
19,Guadalajara,169,Mantiel,87,45,42
19,Guadalajara,170,Maranchón,250,139,111
19,Guadalajara,171,Marchamalo,4363,2242,2121
19,Guadalajara,172,Masegoso de Tajuña,100,51,49
19,Guadalajara,173,Matarrubia,44,29,15
19,Guadalajara,174,Matillas,161,81,80
19,Guadalajara,175,Mazarete,66,29,37
19,Guadalajara,176,Mazuecos,361,182,179
19,Guadalajara,177,Medranda,115,58,57
19,Guadalajara,178,Megina,63,29,34
19,Guadalajara,179,Membrillera,118,53,65
19,Guadalajara,181,Miedes de Atienza,104,56,48
19,Guadalajara,182,Mierla (La),27,18,9
19,Guadalajara,183,Milmarcos,140,79,61
19,Guadalajara,184,Millana,154,76,78
19,Guadalajara,185,Miñosa (La),56,34,22
19,Guadalajara,186,Mirabueno,117,66,51
19,Guadalajara,187,Miralrío,91,50,41
19,Guadalajara,188,Mochales,95,45,50
19,Guadalajara,189,Mohernando,146,78,68
19,Guadalajara,190,Molina de Aragón,3411,1756,1655
19,Guadalajara,191,Monasterio,20,10,10
19,Guadalajara,192,Mondéjar,2367,1220,1147
19,Guadalajara,193,Montarrón,48,26,22
19,Guadalajara,194,Moratilla de los Meleros,86,48,38
19,Guadalajara,195,Morenilla,51,29,22
19,Guadalajara,196,Muduex,108,53,55
19,Guadalajara,197,Navas de Jadraque (Las),35,20,15
19,Guadalajara,198,Negredo,19,10,9
19,Guadalajara,199,Ocentejo,49,25,24
19,Guadalajara,200,Olivar (El),192,105,87
19,Guadalajara,201,Olmeda de Cobeta,119,55,64
19,Guadalajara,202,Olmeda de Jadraque (La),21,11,10
19,Guadalajara,203,Ordial (El),53,24,29
19,Guadalajara,204,Orea,251,141,110
19,Guadalajara,208,Pálmaces de Jadraque,61,34,27
19,Guadalajara,209,Pardos,68,34,34
19,Guadalajara,210,Paredes de Sigüenza,45,25,20
19,Guadalajara,211,Pareja,538,285,253
19,Guadalajara,212,Pastrana,1057,524,533
19,Guadalajara,213,Pedregal (El),108,59,49
19,Guadalajara,214,Peñalén,128,73,55
19,Guadalajara,215,Peñalver,215,126,89
19,Guadalajara,216,Peralejos de las Truchas,172,92,80
19,Guadalajara,217,Peralveche,132,82,50
19,Guadalajara,218,Pinilla de Jadraque,87,44,43
19,Guadalajara,219,Pinilla de Molina,29,18,11
19,Guadalajara,220,Pioz,762,425,337
19,Guadalajara,221,Piqueras,58,35,23
19,Guadalajara,222,Pobo de Dueñas (El),153,84,69
19,Guadalajara,223,Poveda de la Sierra,186,103,83
19,Guadalajara,224,Pozo de Almoguera,158,85,73
19,Guadalajara,225,Pozo de Guadalajara,550,292,258
19,Guadalajara,226,Prádena de Atienza,52,31,21
19,Guadalajara,227,Prados Redondos,98,57,41
19,Guadalajara,228,Puebla de Beleña,49,29,20
19,Guadalajara,229,Puebla de Valles,77,43,34
19,Guadalajara,230,Quer,166,87,79
19,Guadalajara,231,Rebollosa de Jadraque,33,21,12
19,Guadalajara,232,Recuenco (El),94,50,44
19,Guadalajara,233,Renera,56,33,23
19,Guadalajara,234,Retiendas,54,26,28
19,Guadalajara,235,Riba de Saelices,156,87,69
19,Guadalajara,237,Rillo de Gallo,77,41,36
19,Guadalajara,238,Riofrío del Llano,53,30,23
19,Guadalajara,239,Robledillo de Mohernando,138,67,71
19,Guadalajara,240,Robledo de Corpes,110,55,55
19,Guadalajara,241,Romanillos de Atienza,49,31,18
19,Guadalajara,242,Romanones,123,66,57
19,Guadalajara,243,Rueda de la Sierra,63,35,28
19,Guadalajara,244,Sacecorbo,180,104,76
19,Guadalajara,245,Sacedón,1566,810,756
19,Guadalajara,246,Saelices de la Sal,69,35,34
19,Guadalajara,247,Salmerón,223,114,109
19,Guadalajara,248,San Andrés del Congosto,79,43,36
19,Guadalajara,249,San Andrés del Rey,46,17,29
19,Guadalajara,250,Santiuste,26,15,11
19,Guadalajara,251,Saúca,71,36,35
19,Guadalajara,252,Sayatón,126,73,53
19,Guadalajara,254,Selas,63,30,33
19,Guadalajara,901,Semillas,47,26,21
19,Guadalajara,255,Setiles,144,76,68
19,Guadalajara,256,Sienes,74,42,32
19,Guadalajara,257,Sigüenza,4796,2460,2336
19,Guadalajara,258,Solanillos del Extremo,126,64,62
19,Guadalajara,259,Somolinos,38,17,21
19,Guadalajara,260,Sotillo (El),46,26,20
19,Guadalajara,261,Sotodosos,60,26,34
19,Guadalajara,262,Tamajón,217,106,111
19,Guadalajara,263,Taragudo,37,23,14
19,Guadalajara,264,Taravilla,68,37,31
19,Guadalajara,265,Tartanedo,176,91,85
19,Guadalajara,266,Tendilla,311,166,145
19,Guadalajara,267,Terzaga,29,16,13
19,Guadalajara,268,Tierzo,55,31,24
19,Guadalajara,269,Toba (La),106,61,45
19,Guadalajara,270,Tordelrábano,10,3,7
19,Guadalajara,271,Tordellego,66,35,31
19,Guadalajara,272,Tordesilos,133,68,65
19,Guadalajara,274,Torija,532,257,275
19,Guadalajara,279,Torre del Burgo,124,71,53
19,Guadalajara,277,Torrecuadrada de Molina,21,11,10
19,Guadalajara,278,Torrecuadradilla,51,31,20
19,Guadalajara,280,Torrejón del Rey,1818,968,850
19,Guadalajara,281,Torremocha de Jadraque,16,12,4
19,Guadalajara,282,Torremocha del Campo,278,150,128
19,Guadalajara,283,Torremocha del Pinar,65,29,36
19,Guadalajara,284,Torremochuela,17,10,7
19,Guadalajara,285,Torrubia,38,19,19
19,Guadalajara,286,Tórtola de Henares,461,241,220
19,Guadalajara,287,Tortuera,235,127,108
19,Guadalajara,288,Tortuero,32,18,14
19,Guadalajara,289,Traíd,59,29,30
19,Guadalajara,290,Trijueque,776,416,360
19,Guadalajara,291,Trillo,1307,660,647
19,Guadalajara,293,Uceda,1410,736,674
19,Guadalajara,294,Ujados,29,16,13
19,Guadalajara,296,Utande,54,37,17
19,Guadalajara,297,Valdarachas,28,12,16
19,Guadalajara,298,Valdearenas,90,51,39
19,Guadalajara,299,Valdeavellano,102,59,43
19,Guadalajara,300,Valdeaveruelo,490,264,226
19,Guadalajara,301,Valdeconcha,47,24,23
19,Guadalajara,302,Valdegrudas,64,37,27
19,Guadalajara,303,Valdelcubo,55,31,24
19,Guadalajara,304,Valdenuño Fernández,183,100,83
19,Guadalajara,305,Valdepeñas de la Sierra,194,99,95
19,Guadalajara,306,Valderrebollo,38,19,19
19,Guadalajara,307,Valdesotos,31,15,16
19,Guadalajara,308,Valfermoso de Tajuña,103,58,45
19,Guadalajara,309,Valhermoso,49,28,21
19,Guadalajara,310,Valtablado del Río,16,9,7
19,Guadalajara,311,Valverde de los Arroyos,103,56,47
19,Guadalajara,314,Viana de Jadraque,48,28,20
19,Guadalajara,317,Villanueva de Alcorón,236,127,109
19,Guadalajara,318,Villanueva de Argecilla,49,28,21
19,Guadalajara,319,Villanueva de la Torre,3910,2043,1867
19,Guadalajara,321,Villares de Jadraque,60,36,24
19,Guadalajara,322,Villaseca de Henares,60,33,27
19,Guadalajara,323,Villaseca de Uceda,75,43,32
19,Guadalajara,324,Villel de Mesa,235,122,113
19,Guadalajara,325,Viñuelas,119,69,50
19,Guadalajara,326,Yebes,225,152,73
19,Guadalajara,327,Yebra,495,255,240
19,Guadalajara,329,Yélamos de Abajo,88,45,43
19,Guadalajara,330,Yélamos de Arriba,163,90,73
19,Guadalajara,331,Yunquera de Henares,2147,1079,1068
19,Guadalajara,332,Yunta (La),150,75,75
19,Guadalajara,333,Zaorejas,204,115,89
19,Guadalajara,334,Zarzuela de Jadraque,42,17,25
19,Guadalajara,335,Zorita de los Canes,97,52,45
20,Guipúzcoa,1,Abaltzisketa,281,163,118
20,Guipúzcoa,2,Aduna,341,185,156
20,Guipúzcoa,16,Aia,1652,912,740
20,Guipúzcoa,3,Aizarnazabal,552,300,252
20,Guipúzcoa,4,Albiztur,293,159,134
20,Guipúzcoa,5,Alegia,1612,829,783
20,Guipúzcoa,6,Alkiza,273,158,115
20,Guipúzcoa,906,Altzaga,133,67,66
20,Guipúzcoa,7,Altzo,320,166,154
20,Guipúzcoa,8,Amezketa,983,501,482
20,Guipúzcoa,9,Andoain,13886,6956,6930
20,Guipúzcoa,10,Anoeta,1778,901,877
20,Guipúzcoa,11,Antzuola,1911,973,938
20,Guipúzcoa,12,Arama,166,82,84
20,Guipúzcoa,13,Aretxabaleta,6245,3172,3073
20,Guipúzcoa,55,Arrasate/Mondragón,23085,11534,11551
20,Guipúzcoa,14,Asteasu,1317,696,621
20,Guipúzcoa,903,Astigarraga,3951,1995,1956
20,Guipúzcoa,15,Ataun,1514,788,726
20,Guipúzcoa,17,Azkoitia,10288,5113,5175
20,Guipúzcoa,18,Azpeitia,13858,6957,6901
20,Guipúzcoa,904,Baliarrain,97,50,47
20,Guipúzcoa,19,Beasain,12326,6171,6155
20,Guipúzcoa,20,Beizama,168,98,70
20,Guipúzcoa,21,Belauntza,294,162,132
20,Guipúzcoa,22,Berastegi,982,536,446
20,Guipúzcoa,74,Bergara,15044,7538,7506
20,Guipúzcoa,23,Berrobi,565,298,267
20,Guipúzcoa,24,Bidegoyan,432,236,196
20,Guipúzcoa,29,Deba,5275,2648,2627
20,Guipúzcoa,69,Donostia-San Sebastián,181811,85534,96277
20,Guipúzcoa,30,Eibar,28182,13841,14341
20,Guipúzcoa,31,Elduain,214,115,99
20,Guipúzcoa,33,Elgeta,975,496,479
20,Guipúzcoa,32,Elgoibar,10637,5323,5314
20,Guipúzcoa,67,Errenteria,38397,18854,19543
20,Guipúzcoa,66,Errezil,608,320,288
20,Guipúzcoa,34,Eskoriatza,3902,1998,1904
20,Guipúzcoa,35,Ezkio-Itsaso,561,295,266
20,Guipúzcoa,38,Gabiria,442,247,195
20,Guipúzcoa,37,Gaintza,129,78,51
20,Guipúzcoa,907,Gaztelu,150,86,64
20,Guipúzcoa,39,Getaria,2494,1244,1250
20,Guipúzcoa,40,Hernani,18747,9286,9461
20,Guipúzcoa,41,Hernialde,294,148,146
20,Guipúzcoa,36,Hondarribia,15493,7803,7690
20,Guipúzcoa,42,Ibarra,4374,2261,2113
20,Guipúzcoa,43,Idiazabal,2054,1043,1011
20,Guipúzcoa,44,Ikaztegieta,386,199,187
20,Guipúzcoa,45,Irun,58036,28423,29613
20,Guipúzcoa,46,Irura,1040,546,494
20,Guipúzcoa,47,Itsasondo,564,289,275
20,Guipúzcoa,48,Larraul,169,93,76
20,Guipúzcoa,902,Lasarte-Oria,17628,8808,8820
20,Guipúzcoa,49,Lazkao,5064,2609,2455
20,Guipúzcoa,50,Leaburu,375,205,170
20,Guipúzcoa,51,Legazpi,8730,4458,4272
20,Guipúzcoa,52,Legorreta,1371,704,667
20,Guipúzcoa,68,Leintz-Gatzaga,247,135,112
20,Guipúzcoa,53,Lezo,6013,2991,3022
20,Guipúzcoa,54,Lizartza,597,312,285
20,Guipúzcoa,901,Mendaro,1515,791,724
20,Guipúzcoa,57,Mutiloa,159,83,76
20,Guipúzcoa,56,Mutriku,4769,2384,2385
20,Guipúzcoa,63,Oiartzun,9407,4762,4645
20,Guipúzcoa,58,Olaberria,900,465,435
20,Guipúzcoa,59,Oñati,10750,5372,5378
20,Guipúzcoa,76,Ordizia,8962,4355,4607
20,Guipúzcoa,905,Orendain,161,90,71
20,Guipúzcoa,60,Orexa,83,48,35
20,Guipúzcoa,61,Orio,4605,2322,2283
20,Guipúzcoa,62,Ormaiztegi,1194,628,566
20,Guipúzcoa,64,Pasaia,16145,7839,8306
20,Guipúzcoa,70,Segura,1234,609,625
20,Guipúzcoa,65,Soraluze/Placencia de las Armas,4158,2059,2099
20,Guipúzcoa,71,Tolosa,17937,8681,9256
20,Guipúzcoa,72,Urnieta,5824,2981,2843
20,Guipúzcoa,77,Urretxu,6665,3376,3289
20,Guipúzcoa,73,Usurbil,5474,2827,2647
20,Guipúzcoa,75,Villabona,5630,2848,2782
20,Guipúzcoa,78,Zaldibia,1511,775,736
20,Guipúzcoa,79,Zarautz,21680,10744,10936
20,Guipúzcoa,25,Zegama,1300,669,631
20,Guipúzcoa,26,Zerain,252,128,124
20,Guipúzcoa,27,Zestoa,3081,1559,1522
20,Guipúzcoa,28,Zizurkil,2885,1477,1408
20,Guipúzcoa,81,Zumaia,8656,4337,4319
20,Guipúzcoa,80,Zumarraga,10173,5112,5061
21,Huelva,1,Alájar,769,404,365
21,Huelva,2,Aljaraque,13009,6529,6480
21,Huelva,3,Almendro (El),841,443,398
21,Huelva,4,Almonaster la Real,1879,929,950
21,Huelva,5,Almonte,18446,9351,9095
21,Huelva,6,Alosno,4514,2182,2332
21,Huelva,7,Aracena,6939,3404,3535
21,Huelva,8,Aroche,3396,1679,1717
21,Huelva,9,Arroyomolinos de León,1117,567,550
21,Huelva,10,Ayamonte,17402,8611,8791
21,Huelva,11,Beas,4036,2032,2004
21,Huelva,12,Berrocal,374,181,193
21,Huelva,13,Bollullos Par del Condado,13041,6513,6528
21,Huelva,14,Bonares,5295,2736,2559
21,Huelva,15,Cabezas Rubias,935,487,448
21,Huelva,16,Cala,1344,684,660
21,Huelva,17,Calañas,4553,2243,2310
21,Huelva,18,Campillo (El),2335,1119,1216
21,Huelva,19,Campofrío,845,418,427
21,Huelva,20,Cañaveral de León,464,224,240
21,Huelva,21,Cartaya,14106,7259,6847
21,Huelva,22,Castaño del Robledo,192,104,88
21,Huelva,23,Cerro de Andévalo (El),2700,1314,1386
21,Huelva,24,Corteconcepción,632,318,314
21,Huelva,25,Cortegana,5005,2490,2515
21,Huelva,26,Cortelazor,314,156,158
21,Huelva,27,Cumbres de Enmedio,50,27,23
21,Huelva,28,Cumbres de San Bartolomé,541,265,276
21,Huelva,29,Cumbres Mayores,2018,993,1025
21,Huelva,30,Chucena,2005,1017,988
21,Huelva,31,Encinasola,1710,849,861
21,Huelva,32,Escacena del Campo,2156,1076,1080
21,Huelva,33,Fuenteheridos,677,344,333
21,Huelva,34,Galaroza,1631,799,832
21,Huelva,35,Gibraleón,11022,5568,5454
21,Huelva,36,Granada de Río-Tinto (La),231,120,111
21,Huelva,37,Granado (El),639,351,288
21,Huelva,38,Higuera de la Sierra,1311,660,651
21,Huelva,39,Hinojales,400,203,197
21,Huelva,40,Hinojos,3591,1814,1777
21,Huelva,41,Huelva,144831,70126,74705
21,Huelva,42,Isla Cristina,19027,9532,9495
21,Huelva,43,Jabugo,2522,1256,1266
21,Huelva,44,Lepe,21223,10929,10294
21,Huelva,45,Linares de la Sierra,300,145,155
21,Huelva,46,Lucena del Puerto,2025,1037,988
21,Huelva,47,Manzanilla,2432,1216,1216
21,Huelva,48,Marines (Los),329,163,166
21,Huelva,49,Minas de Riotinto,4567,2185,2382
21,Huelva,50,Moguer,15980,8284,7696
21,Huelva,51,Nava (La),295,154,141
21,Huelva,52,Nerva,6101,2956,3145
21,Huelva,53,Niebla,3933,1993,1940
21,Huelva,54,Palma del Condado (La),9675,4759,4916
21,Huelva,55,Palos de la Frontera,7895,4137,3758
21,Huelva,56,Paterna del Campo,3777,1930,1847
21,Huelva,57,Paymogo,1262,629,633
21,Huelva,58,Puebla de Guzmán,3193,1632,1561
21,Huelva,59,Puerto Moral,259,136,123
21,Huelva,60,Punta Umbría,12925,6566,6359
21,Huelva,61,Rociana del Condado,6370,3296,3074
21,Huelva,62,Rosal de la Frontera,1792,869,923
21,Huelva,63,San Bartolomé de la Torre,2951,1502,1449
21,Huelva,64,San Juan del Puerto,6244,3126,3118
21,Huelva,66,San Silvestre de Guzmán,629,316,313
21,Huelva,65,Sanlúcar de Guadiana,379,189,190
21,Huelva,67,Santa Ana la Real,494,228,266
21,Huelva,68,Santa Bárbara de Casa,1255,627,628
21,Huelva,69,Santa Olalla del Cala,2173,1094,1079
21,Huelva,70,Trigueros,7194,3598,3596
21,Huelva,71,Valdelarco,256,123,133
21,Huelva,72,Valverde del Camino,12487,6055,6432
21,Huelva,73,Villablanca,2146,1136,1010
21,Huelva,74,Villalba del Alcor,3475,1730,1745
21,Huelva,75,Villanueva de las Cruces,400,189,211
21,Huelva,76,Villanueva de los Castillejos,2667,1326,1341
21,Huelva,77,Villarrasa,2074,1053,1021
21,Huelva,78,Zalamea la Real,3534,1741,1793
21,Huelva,79,Zufre,910,476,434
22,Huesca,1,Abiego,284,143,141
22,Huesca,2,Abizanda,132,62,70
22,Huesca,3,Adahuesca,155,79,76
22,Huesca,4,Agüero,174,91,83
22,Huesca,907,Aínsa-Sobrarbe,1730,912,818
22,Huesca,6,Aisa,411,227,184
22,Huesca,7,Albalate de Cinca,1286,725,561
22,Huesca,8,Albalatillo,243,122,121
22,Huesca,9,Albelda,911,460,451
22,Huesca,11,Albero Alto,108,59,49
22,Huesca,12,Albero Bajo,97,54,43
22,Huesca,13,Alberuela de Tubo,361,185,176
22,Huesca,14,Alcalá de Gurrea,284,140,144
22,Huesca,15,Alcalá del Obispo,355,184,171
22,Huesca,16,Alcampell,868,427,441
22,Huesca,17,Alcolea de Cinca,1230,651,579
22,Huesca,18,Alcubierre,448,236,212
22,Huesca,19,Alerre,220,110,110
22,Huesca,20,Alfántega,107,54,53
22,Huesca,21,Almudévar,2305,1191,1114
22,Huesca,22,Almunia de San Juan,671,344,327
22,Huesca,23,Almuniente,571,288,283
22,Huesca,24,Alquézar,315,169,146
22,Huesca,25,Altorricón,1464,779,685
22,Huesca,27,Angüés,427,234,193
22,Huesca,28,Ansó,529,257,272
22,Huesca,29,Antillón,156,79,77
22,Huesca,32,Aragüés del Puerto,142,82,60
22,Huesca,35,Arén,370,194,176
22,Huesca,36,Argavieso,131,71,60
22,Huesca,37,Arguis,61,33,28
22,Huesca,39,Ayerbe,1081,549,532
22,Huesca,40,Azanuy-Alins,173,80,93
22,Huesca,41,Azara,207,104,103
22,Huesca,42,Azlor,157,77,80
22,Huesca,43,Baélls,135,77,58
22,Huesca,44,Bailo,268,159,109
22,Huesca,45,Baldellou,132,74,58
22,Huesca,46,Ballobar,997,502,495
22,Huesca,47,Banastás,215,110,105
22,Huesca,48,Barbastro,15490,7576,7914
22,Huesca,49,Barbués,112,60,52
22,Huesca,50,Barbuñales,114,56,58
22,Huesca,51,Bárcabo,107,60,47
22,Huesca,52,Belver de Cinca,1372,750,622
22,Huesca,53,Benabarre,1112,582,530
22,Huesca,54,Benasque,1832,979,853
22,Huesca,55,Berbegal,463,235,228
22,Huesca,57,Bielsa,465,243,222
22,Huesca,58,Bierge,248,138,110
22,Huesca,59,Biescas,1312,701,611
22,Huesca,60,Binaced,1704,925,779
22,Huesca,61,Binéfar,8639,4422,4217
22,Huesca,62,Bisaurri,235,126,109
22,Huesca,63,Biscarrués,230,123,107
22,Huesca,64,Blecua y Torres,190,107,83
22,Huesca,66,Boltaña,838,429,409
22,Huesca,67,Bonansa,97,52,45
22,Huesca,68,Borau,76,43,33
22,Huesca,69,Broto,524,275,249
22,Huesca,72,Caldearenas,263,146,117
22,Huesca,74,Campo,304,142,162
22,Huesca,75,Camporrélls,241,126,115
22,Huesca,76,Canal de Berdún,402,222,180
22,Huesca,77,Candasnos,489,254,235
22,Huesca,78,Canfranc,532,292,240
22,Huesca,79,Capdesaso,166,75,91
22,Huesca,80,Capella,388,195,193
22,Huesca,81,Casbas de Huesca,295,158,137
22,Huesca,83,Castejón de Monegros,696,360,336
22,Huesca,84,Castejón de Sos,679,356,323
22,Huesca,82,Castejón del Puente,420,221,199
22,Huesca,85,Castelflorite,133,70,63
22,Huesca,86,Castiello de Jaca,180,98,82
22,Huesca,87,Castigaleu,114,65,49
22,Huesca,88,Castillazuelo,223,105,118
22,Huesca,89,Castillonroy,412,198,214
22,Huesca,90,Colungo,139,74,65
22,Huesca,94,Chalamera,148,83,65
22,Huesca,95,Chía,109,59,50
22,Huesca,96,Chimillas,246,128,118
22,Huesca,99,Esplús,731,357,374
22,Huesca,102,Estada,185,98,87
22,Huesca,103,Estadilla,886,444,442
22,Huesca,105,Estopiñán del Castillo,227,133,94
22,Huesca,106,Fago,33,21,12
22,Huesca,107,Fanlo,182,110,72
22,Huesca,109,Fiscal,251,143,108
22,Huesca,110,Fonz,1079,538,541
22,Huesca,111,Foradada del Toscar,220,108,112
22,Huesca,112,Fraga,12868,6667,6201
22,Huesca,113,Fueva (La),611,316,295
22,Huesca,114,Gistaín,165,92,73
22,Huesca,115,Grado (El),514,264,250
22,Huesca,116,Grañén,2009,1032,977
22,Huesca,117,Graus,3266,1646,1620
22,Huesca,119,Gurrea de Gállego,1740,902,838
22,Huesca,122,Hoz de Jaca,72,32,40
22,Huesca,908,Hoz y Costean,229,125,104
22,Huesca,124,Huerto,246,131,115
22,Huesca,125,Huesca,47609,22974,24635
22,Huesca,126,Ibieca,114,61,53
22,Huesca,127,Igriés,324,164,160
22,Huesca,128,Ilche,264,141,123
22,Huesca,129,Isábena,282,146,136
22,Huesca,130,Jaca,12063,5971,6092
22,Huesca,131,Jasa,115,67,48
22,Huesca,133,Labuerda,167,92,75
22,Huesca,135,Laluenga,250,132,118
22,Huesca,136,Lalueza,1152,603,549
22,Huesca,137,Lanaja,1496,775,721
22,Huesca,139,Laperdiguera,102,49,53
22,Huesca,141,Lascellas-Ponzano,158,80,78
22,Huesca,142,Lascuarre,149,79,70
22,Huesca,143,Laspaúles,284,158,126
22,Huesca,144,Laspuña,272,142,130
22,Huesca,149,Loarre,374,193,181
22,Huesca,150,Loporzano,511,273,238
22,Huesca,151,Loscorrales,112,64,48
22,Huesca,905,Lupiñén-Ortilla,348,188,160
22,Huesca,155,Monesma y Cajigar,101,53,48
22,Huesca,156,Monflorite-Lascasas,207,120,87
22,Huesca,157,Montanuy,292,165,127
22,Huesca,158,Monzón,15395,7835,7560
22,Huesca,160,Naval,295,143,152
22,Huesca,162,Novales,182,96,86
22,Huesca,163,Nueno,394,219,175
22,Huesca,164,Olvena,68,30,38
22,Huesca,165,Ontiñena,637,319,318
22,Huesca,167,Osso de Cinca,766,437,329
22,Huesca,168,Palo,47,29,18
22,Huesca,170,Panticosa,731,370,361
22,Huesca,172,Peñalba,764,383,381
22,Huesca,173,Peñas de Riglos (Las),272,159,113
22,Huesca,174,Peralta de Alcofea,675,331,344
22,Huesca,175,Peralta de Calasanz,277,156,121
22,Huesca,176,Peraltilla,180,97,83
22,Huesca,177,Perarrúa,124,60,64
22,Huesca,178,Pertusa,145,75,70
22,Huesca,181,Piracés,103,61,42
22,Huesca,182,Plan,319,166,153
22,Huesca,184,Poleñino,267,134,133
22,Huesca,186,Pozán de Vero,248,118,130
22,Huesca,187,Puebla de Castro (La),351,186,165
22,Huesca,188,Puente de Montañana,107,52,55
22,Huesca,902,Puente la Reina de Jaca,252,130,122
22,Huesca,189,Puértolas,223,124,99
22,Huesca,190,Pueyo de Araguás (El),143,85,58
22,Huesca,193,Pueyo de Santa Cruz,335,166,169
22,Huesca,195,Quicena,146,74,72
22,Huesca,197,Robres,657,347,310
22,Huesca,199,Sabiñánigo,8797,4423,4374
22,Huesca,200,Sahún,248,133,115
22,Huesca,201,Salas Altas,376,196,180
22,Huesca,202,Salas Bajas,149,73,76
22,Huesca,203,Salillas,118,58,60
22,Huesca,204,Sallent de Gállego,1172,585,587
22,Huesca,205,San Esteban de Litera,572,288,284
22,Huesca,207,San Juan de Plan,147,81,66
22,Huesca,903,San Miguel del Cinca,876,466,410
22,Huesca,206,Sangarrén,271,130,141
22,Huesca,208,Santa Cilia,200,109,91
22,Huesca,209,Santa Cruz de la Serós,164,95,69
22,Huesca,906,Santa María de Dulcis,219,109,110
22,Huesca,212,Santaliestra y San Quílez,107,57,50
22,Huesca,213,Sariñena,3987,2029,1958
22,Huesca,214,Secastilla,159,74,85
22,Huesca,215,Seira,195,100,95
22,Huesca,217,Sena,587,334,253
22,Huesca,218,Senés de Alcubierre,52,28,24
22,Huesca,220,Sesa,243,125,118
22,Huesca,221,Sesué,131,72,59
22,Huesca,222,Siétamo,460,254,206
22,Huesca,223,Sopeira,103,50,53
22,Huesca,904,Sotonera (La),1074,564,510
22,Huesca,225,Tamarite de Litera,3699,1861,1838
22,Huesca,226,Tardienta,1083,571,512
22,Huesca,227,Tella-Sin,264,137,127
22,Huesca,228,Tierz,174,84,90
22,Huesca,229,Tolva,182,95,87
22,Huesca,230,Torla,316,168,148
22,Huesca,232,Torralba de Aragón,118,59,59
22,Huesca,233,Torre la Ribera,119,64,55
22,Huesca,234,Torrente de Cinca,1001,502,499
22,Huesca,235,Torres de Alcanadre,128,75,53
22,Huesca,236,Torres de Barbués,336,163,173
22,Huesca,239,Tramaced,99,57,42
22,Huesca,242,Valfarta,98,56,42
22,Huesca,243,Valle de Bardají,54,29,25
22,Huesca,901,Valle de Hecho,994,513,481
22,Huesca,244,Valle de Lierp,51,27,24
22,Huesca,245,Velilla de Cinca,446,223,223
22,Huesca,909,Vencillón,466,247,219
22,Huesca,246,Veracruz,109,58,51
22,Huesca,247,Viacamp y Litera,28,18,10
22,Huesca,248,Vicién,120,65,55
22,Huesca,249,Villanova,134,66,68
22,Huesca,250,Villanúa,345,186,159
22,Huesca,251,Villanueva de Sigena,530,261,269
22,Huesca,252,Yebra de Basa,168,98,70
22,Huesca,253,Yésero,78,49,29
22,Huesca,254,Zaidín,1726,883,843
23,Jaén,1,Albanchez de Mágina,1405,723,682
23,Jaén,2,Alcalá la Real,21880,10819,11061
23,Jaén,3,Alcaudete,11151,5521,5630
23,Jaén,4,Aldeaquemada,549,282,267
23,Jaén,5,Andújar,37681,18555,19126
23,Jaén,6,Arjona,5641,2831,2810
23,Jaén,7,Arjonilla,3971,1985,1986
23,Jaén,8,Arquillos,1944,966,978
23,Jaén,905,Arroyo del Ojanco,2287,1165,1122
23,Jaén,9,Baeza,15072,7460,7612
23,Jaén,10,Bailén,17845,9094,8751
23,Jaén,11,Baños de la Encina,2716,1417,1299
23,Jaén,12,Beas de Segura,5647,2903,2744
23,Jaén,902,Bedmar y Garcíez,3237,1645,1592
23,Jaén,14,Begíjar,3118,1581,1537
23,Jaén,15,Bélmez de la Moraleda,1954,994,960
23,Jaén,16,Benatae,622,350,272
23,Jaén,17,Cabra del Santo Cristo,2238,1163,1075
23,Jaén,18,Cambil,2995,1577,1418
23,Jaén,19,Campillo de Arenas,2118,1069,1049
23,Jaén,20,Canena,2118,1036,1082
23,Jaén,21,Carboneros,673,343,330
23,Jaén,901,Cárcheles,1463,743,720
23,Jaén,24,Carolina (La),15198,7504,7694
23,Jaén,25,Castellar,3701,1898,1803
23,Jaén,26,Castillo de Locubín,4916,2403,2513
23,Jaén,27,Cazalilla,823,420,403
23,Jaén,28,Cazorla,8167,3987,4180
23,Jaén,29,Chiclana de Segura,1267,647,620
23,Jaén,30,Chilluévar,1719,848,871
23,Jaén,31,Escañuela,956,468,488
23,Jaén,32,Espelúy,792,400,392
23,Jaén,33,Frailes,1822,929,893
23,Jaén,34,Fuensanta de Martos,3278,1629,1649
23,Jaén,35,Fuerte del Rey,1204,595,609
23,Jaén,37,Génave,616,319,297
23,Jaén,38,Guardia de Jaén (La),2105,1087,1018
23,Jaén,39,Guarromán,2829,1398,1431
23,Jaén,41,Higuera de Calatrava,676,352,324
23,Jaén,42,Hinojares,454,222,232
23,Jaén,43,Hornos,690,341,349
23,Jaén,44,Huelma,6106,3121,2985
23,Jaén,45,Huesa,2756,1397,1359
23,Jaén,46,Ibros,3025,1519,1506
23,Jaén,47,Iruela (La),1860,933,927
23,Jaén,48,Iznatoraf,1235,657,578
23,Jaén,49,Jabalquinto,2454,1239,1215
23,Jaén,50,Jaén,115638,55892,59746
23,Jaén,51,Jamilena,3371,1703,1668
23,Jaén,52,Jimena,1501,722,779
23,Jaén,53,Jódar,11991,5966,6025
23,Jaén,40,Lahiguera,1884,942,942
23,Jaén,54,Larva,503,263,240
23,Jaén,55,Linares,58257,28491,29766
23,Jaén,56,Lopera,4020,1985,2035
23,Jaén,57,Lupión,1049,513,536
23,Jaén,58,Mancha Real,9562,4879,4683
23,Jaén,59,Marmolejo,7553,3796,3757
23,Jaén,60,Martos,22862,11096,11766
23,Jaén,61,Mengíbar,8929,4503,4426
23,Jaén,62,Montizón,2001,1032,969
23,Jaén,63,Navas de San Juan,5109,2544,2565
23,Jaén,64,Noalejo,2183,1102,1081
23,Jaén,65,Orcera,2160,1072,1088
23,Jaén,66,Peal de Becerro,5417,2695,2722
23,Jaén,67,Pegalajar,3084,1580,1504
23,Jaén,69,Porcuna,6899,3462,3437
23,Jaén,70,Pozo Alcón,5602,2827,2775
23,Jaén,71,Puente de Génave,2086,1045,1041
23,Jaén,72,Puerta de Segura (La),2612,1306,1306
23,Jaén,73,Quesada,5954,2927,3027
23,Jaén,74,Rus,3762,1898,1864
23,Jaén,75,Sabiote,4143,2113,2030
23,Jaén,76,Santa Elena,1012,532,480
23,Jaén,77,Santiago de Calatrava,929,467,462
23,Jaén,904,Santiago-Pontones,4230,2155,2075
23,Jaén,79,Santisteban del Puerto,4835,2467,2368
23,Jaén,80,Santo Tomé,2269,1138,1131
23,Jaén,81,Segura de la Sierra,1951,976,975
23,Jaén,82,Siles,2475,1242,1233
23,Jaén,84,Sorihuela del Guadalimar,1283,686,597
23,Jaén,86,Torre del Campo,13628,6851,6777
23,Jaén,85,Torreblascopedro,2916,1445,1471
23,Jaén,87,Torredonjimeno,13827,6811,7016
23,Jaén,88,Torreperogil,7118,3504,3614
23,Jaén,90,Torres,1792,932,860
23,Jaén,91,Torres de Albánchez,956,482,474
23,Jaén,92,Úbeda,33347,16337,17010
23,Jaén,93,Valdepeñas de Jaén,4411,2208,2203
23,Jaén,94,Vilches,4976,2495,2481
23,Jaén,95,Villacarrillo,11180,5632,5548
23,Jaén,96,Villanueva de la Reina,3300,1646,1654
23,Jaén,97,Villanueva del Arzobispo,8761,4483,4278
23,Jaén,98,Villardompardo,1203,603,600
23,Jaén,99,Villares (Los),5164,2583,2581
23,Jaén,101,Villarrodrigo,563,282,281
23,Jaén,903,Villatorres,4333,2243,2090
24,León,1,Acebedo,280,151,129
24,León,2,Algadefe,335,170,165
24,León,3,Alija del Infantado,935,463,472
24,León,4,Almanza,692,378,314
24,León,5,Antigua (La),587,311,276
24,León,6,Ardón,688,369,319
24,León,7,Arganza,913,464,449
24,León,8,Astorga,12289,5829,6460
24,León,9,Balboa,426,230,196
24,León,10,Bañeza (La),10182,4994,5188
24,León,11,Barjas,378,204,174
24,León,12,Barrios de Luna (Los),344,169,175
24,León,14,Bembibre,10217,5053,5164
24,León,15,Benavides,2979,1497,1482
24,León,16,Benuza,770,390,380
24,León,17,Bercianos del Páramo,800,403,397
24,León,18,Bercianos del Real Camino,204,103,101
24,León,19,Berlanga del Bierzo,406,186,220
24,León,20,Boca de Huérgano,579,317,262
24,León,21,Boñar,2415,1187,1228
24,León,22,Borrenes,484,237,247
24,León,23,Brazuelo,356,187,169
24,León,24,Burgo Ranero (El),892,470,422
24,León,25,Burón,388,210,178
24,León,26,Bustillo del Páramo,1710,868,842
24,León,27,Cabañas Raras,1262,647,615
24,León,28,Cabreros del Río,537,282,255
24,León,29,Cabrillanes,1038,521,517
24,León,30,Cacabelos,5001,2511,2490
24,León,31,Calzada del Coto,295,159,136
24,León,32,Campazas,151,80,71
24,León,33,Campo de Villavidel,307,158,149
24,León,34,Camponaraya,3290,1618,1672
24,León,36,Candín,425,233,192
24,León,37,Cármenes,421,220,201
24,León,38,Carracedelo,3556,1733,1823
24,León,39,Carrizo,2639,1320,1319
24,León,40,Carrocera,591,288,303
24,León,41,Carucedo,661,323,338
24,León,42,Castilfalé,98,50,48
24,León,43,Castrillo de Cabrera,178,89,89
24,León,44,Castrillo de la Valduerna,210,96,114
24,León,46,Castrocalbón,1288,663,625
24,León,47,Castrocontrigo,1082,529,553
24,León,49,Castropodame,1892,959,933
24,León,50,Castrotierra de Valmadrigal,147,73,74
24,León,51,Cea,650,338,312
24,León,52,Cebanico,230,126,104
24,León,53,Cebrones del Río,649,335,314
24,León,54,Cimanes de la Vega,637,319,318
24,León,55,Cimanes del Tejar,946,469,477
24,León,56,Cistierna,4059,1965,2094
24,León,57,Congosto,1732,820,912
24,León,58,Corbillos de los Oteros,262,134,128
24,León,59,Corullón,1177,592,585
24,León,60,Crémenes,912,443,469
24,León,61,Cuadros,1741,851,890
24,León,62,Cubillas de los Oteros,200,104,96
24,León,63,Cubillas de Rueda,610,315,295
24,León,64,Cubillos del Sil,1462,758,704
24,León,65,Chozas de Abajo,2010,1038,972
24,León,66,Destriana,763,360,403
24,León,67,Encinedo,987,504,483
24,León,68,Ercina (La),686,341,345
24,León,69,Escobar de Campos,80,48,32
24,León,70,Fabero,5504,2723,2781
24,León,71,Folgoso de la Ribera,1284,626,658
24,León,73,Fresno de la Vega,651,328,323
24,León,74,Fuentes de Carbajal,124,65,59
24,León,76,Garrafe de Torío,1223,614,609
24,León,77,Gordaliza del Pino,334,167,167
24,León,78,Gordoncillo,586,279,307
24,León,79,Gradefes,1255,619,636
24,León,80,Grajal de Campos,284,123,161
24,León,81,Gusendos de los Oteros,189,101,88
24,León,82,Hospital de Órbigo,1104,534,570
24,León,83,Igüeña,1788,931,857
24,León,84,Izagre,253,125,128
24,León,86,Joarilla de las Matas,417,216,201
24,León,87,Laguna Dalga,895,454,441
24,León,88,Laguna de Negrillos,1427,710,717
24,León,89,León,135634,63046,72588
24,León,90,Lucillo,484,244,240
24,León,91,Luyego,912,438,474
24,León,92,Llamas de la Ribera,1143,582,561
24,León,93,Magaz de Cepeda,491,240,251
24,León,94,Mansilla de las Mulas,1765,876,889
24,León,95,Mansilla Mayor,410,200,210
24,León,96,Maraña,177,90,87
24,León,97,Matadeón de los Oteros,290,150,140
24,León,98,Matallana de Torío,1591,787,804
24,León,99,Matanza,273,138,135
24,León,100,Molinaseca,769,403,366
24,León,101,Murias de Paredes,596,266,330
24,León,102,Noceda del Bierzo,878,439,439
24,León,103,Oencia,475,251,224
24,León,104,Omañas (Las),406,208,198
24,León,105,Onzonilla,1545,770,775
24,León,106,Oseja de Sajambre,317,173,144
24,León,107,Pajares de los Oteros,336,179,157
24,León,108,Palacios de la Valduerna,507,239,268
24,León,109,Palacios del Sil,1413,736,677
24,León,110,Páramo del Sil,1638,833,805
24,León,112,Peranzanes,327,185,142
24,León,113,Pobladura de Pelayo García,524,264,260
24,León,114,Pola de Gordón (La),4656,2265,2391
24,León,115,Ponferrada,64990,31549,33441
24,León,116,Posada de Valdeón,515,293,222
24,León,117,Pozuelo del Páramo,585,300,285
24,León,118,Prado de la Guzpeña,148,76,72
24,León,119,Priaranza del Bierzo,889,444,445
24,León,120,Prioro,441,229,212
24,León,121,Puebla de Lillo,727,371,356
24,León,122,Puente de Domingo Flórez,1873,978,895
24,León,123,Quintana del Castillo,1074,573,501
24,León,124,Quintana del Marco,531,269,262
24,León,125,Quintana y Congosto,736,376,360
24,León,127,Regueras de Arriba,379,198,181
24,León,129,Reyero,151,80,71
24,León,130,Riaño,569,317,252
24,León,131,Riego de la Vega,1037,506,531
24,León,132,Riello,902,467,435
24,León,133,Rioseco de Tapia,520,270,250
24,León,134,Robla (La),4845,2383,2462
24,León,136,Roperuelos del Páramo,748,374,374
24,León,137,Sabero,1688,814,874
24,León,139,Sahagún,2989,1453,1536
24,León,141,San Adrián del Valle,142,68,74
24,León,142,San Andrés del Rabanedo,26770,13071,13699
24,León,144,San Cristóbal de la Polantera,1006,489,517
24,León,145,San Emiliano,815,424,391
24,León,146,San Esteban de Nogales,350,168,182
24,León,148,San Justo de la Vega,2144,1083,1061
24,León,149,San Millán de los Caballeros,184,92,92
24,León,150,San Pedro Bercianos,357,182,175
24,León,143,Sancedo,554,278,276
24,León,151,Santa Colomba de Curueño,623,298,325
24,León,152,Santa Colomba de Somoza,486,247,239
24,León,153,Santa Cristina de Valmadrigal,353,186,167
24,León,154,Santa Elena de Jamuz,1337,678,659
24,León,155,Santa María de la Isla,657,342,315
24,León,158,Santa María de Ordás,380,189,191
24,León,156,Santa María del Monte de Cea,342,170,172
24,León,157,Santa María del Páramo,3185,1551,1634
24,León,159,Santa Marina del Rey,2429,1197,1232
24,León,160,Santas Martas,939,481,458
24,León,161,Santiago Millas,329,173,156
24,León,162,Santovenia de la Valdoncina,1771,892,879
24,León,163,Sariegos,3318,1676,1642
24,León,164,Sena de Luna,467,229,238
24,León,165,Sobrado,501,255,246
24,León,166,Soto de la Vega,1943,999,944
24,León,167,Soto y Amío,1047,508,539
24,León,168,Toral de los Guzmanes,665,335,330
24,León,169,Toreno,3942,1978,1964
24,León,170,Torre del Bierzo,2921,1477,1444
24,León,171,Trabadelo,502,260,242
24,León,172,Truchas,705,342,363
24,León,173,Turcia,1240,608,632
24,León,174,Urdiales del Páramo,634,329,305
24,León,185,Val de San Lorenzo,690,338,352
24,León,175,Valdefresno,1872,970,902
24,León,176,Valdefuentes del Páramo,395,209,186
24,León,177,Valdelugueros,454,264,190
24,León,178,Valdemora,109,45,64
24,León,179,Valdepiélago,414,212,202
24,León,180,Valdepolo,1508,788,720
24,León,181,Valderas,2064,1056,1008
24,León,182,Valderrey,592,287,305
24,León,183,Valderrueda,1189,614,575
24,León,184,Valdesamario,240,121,119
24,León,187,Valdevimbre,1127,581,546
24,León,188,Valencia de Don Juan,4132,2062,2070
24,León,189,Valverde de la Virgen,4417,2228,2189
24,León,190,Valverde-Enrique,207,107,100
24,León,191,Vallecillo,158,83,75
24,León,193,Vecilla (La),418,215,203
24,León,196,Vega de Espinareda,2771,1391,1380
24,León,197,Vega de Infanzones,869,438,431
24,León,198,Vega de Valcarce,802,405,397
24,León,194,Vegacervera,326,166,160
24,León,199,Vegaquemada,501,246,255
24,León,201,Vegas del Condado,1350,726,624
24,León,202,Villablino,12978,6508,6470
24,León,203,Villabraz,135,74,61
24,León,205,Villadangos del Páramo,992,501,491
24,León,206,Villadecanes,2225,1102,1123
24,León,207,Villademor de la Vega,441,234,207
24,León,209,Villafranca del Bierzo,3728,1837,1891
24,León,210,Villagatón,779,398,381
24,León,211,Villamandos,396,192,204
24,León,901,Villamanín,1198,587,611
24,León,212,Villamañán,1325,665,660
24,León,213,Villamartín de Don Sancho,177,96,81
24,León,214,Villamejil,929,467,462
24,León,215,Villamol,229,114,115
24,León,216,Villamontán de la Valduerna,1051,542,509
24,León,217,Villamoratiel de las Matas,194,112,82
24,León,218,Villanueva de las Manzanas,555,270,285
24,León,219,Villaobispo de Otero,683,340,343
24,León,902,Villaornate y Castro,495,266,229
24,León,221,Villaquejida,1065,554,511
24,León,222,Villaquilambre,10694,5302,5392
24,León,223,Villarejo de Órbigo,3282,1595,1687
24,León,224,Villares de Órbigo,875,440,435
24,León,225,Villasabariego,1238,624,614
24,León,226,Villaselán,281,157,124
24,León,227,Villaturiel,1790,936,854
24,León,228,Villazala,1008,510,498
24,León,229,Villazanzo de Valderaduey,672,360,312
24,León,230,Zotes del Páramo,617,327,290
25,Lleida,1,Abella de la Conca,183,99,84
25,Lleida,2,Àger,497,272,225
25,Lleida,3,Agramunt,5071,2637,2434
25,Lleida,38,Aitona,2218,1123,1095
25,Lleida,4,Alamús (Els),691,350,341
25,Lleida,5,Alàs i Cerc,396,215,181
25,Lleida,6,Albagés (L'),512,272,240
25,Lleida,7,Albatàrrec,1306,673,633
25,Lleida,8,Albesa,1523,768,755
25,Lleida,9,Albi (L'),826,426,400
25,Lleida,10,Alcanó,258,130,128
25,Lleida,11,Alcarràs,4903,2458,2445
25,Lleida,12,Alcoletge,1899,1000,899
25,Lleida,13,Alfarràs,2881,1421,1460
25,Lleida,14,Alfés,320,168,152
25,Lleida,15,Algerri,507,256,251
25,Lleida,16,Alguaire,2872,1468,1404
25,Lleida,17,Alins,270,136,134
25,Lleida,19,Almacelles,5702,2913,2789
25,Lleida,20,Almatret,461,239,222
25,Lleida,21,Almenar,3481,1793,1688
25,Lleida,22,Alòs de Balaguer,167,99,68
25,Lleida,23,Alpicat,4672,2335,2337
25,Lleida,24,Alt Àneu,414,235,179
25,Lleida,27,Anglesola,1273,650,623
25,Lleida,29,Arbeca,2295,1163,1132
25,Lleida,31,Arres,63,37,26
25,Lleida,32,Arsèguel,98,52,46
25,Lleida,33,Artesa de Lleida,1318,681,637
25,Lleida,34,Artesa de Segre,3413,1782,1631
25,Lleida,36,Aspa,269,134,135
25,Lleida,37,Avellanes i Santa Linya (Les),475,262,213
25,Lleida,39,Baix Pallars,360,203,157
25,Lleida,40,Balaguer,14068,6947,7121
25,Lleida,41,Barbens,795,404,391
25,Lleida,42,Baronia de Rialb (La),285,149,136
25,Lleida,44,Bassella,265,135,130
25,Lleida,45,Bausen,51,30,21
25,Lleida,46,Belianes,611,309,302
25,Lleida,170,Bellaguarda,351,175,176
25,Lleida,47,Bellcaire d'Urgell,1215,580,635
25,Lleida,48,Bell-lloc d'Urgell,2068,1028,1040
25,Lleida,49,Bellmunt d'Urgell,232,112,120
25,Lleida,50,Bellpuig,4224,2144,2080
25,Lleida,51,Bellver de Cerdanya,1689,897,792
25,Lleida,52,Bellvís,2137,1081,1056
25,Lleida,53,Benavent de Segrià,1077,559,518
25,Lleida,55,Biosca,241,125,116
25,Lleida,57,Bòrdes (Es),218,111,107
25,Lleida,58,Borges Blanques (Les),5365,2696,2669
25,Lleida,59,Bossòst,1011,520,491
25,Lleida,56,Bovera,378,187,191
25,Lleida,60,Cabanabona,96,45,51
25,Lleida,61,Cabó,115,63,52
25,Lleida,62,Camarasa,886,460,426
25,Lleida,63,Canejan,105,52,53
25,Lleida,904,Castell de Mur,156,83,73
25,Lleida,64,Castellar de la Ribera,162,80,82
25,Lleida,67,Castelldans,962,505,457
25,Lleida,68,Castellnou de Seana,697,362,335
25,Lleida,69,Castelló de Farfanya,570,285,285
25,Lleida,70,Castellserà,1123,565,558
25,Lleida,71,Cava,54,30,24
25,Lleida,72,Cervera,8424,4350,4074
25,Lleida,73,Cervià de les Garrigues,842,437,405
25,Lleida,74,Ciutadilla,233,122,111
25,Lleida,75,Clariana de Cardener,153,80,73
25,Lleida,76,Cogul (El),224,120,104
25,Lleida,77,Coll de Nargó,577,303,274
25,Lleida,163,Coma i la Pedra (La),242,148,94
25,Lleida,161,Conca de Dalt,426,217,209
25,Lleida,78,Corbins,1133,581,552
25,Lleida,79,Cubells,381,189,192
25,Lleida,81,Espluga Calba (L'),429,233,196
25,Lleida,82,Espot,339,181,158
25,Lleida,88,Estamariu,125,70,55
25,Lleida,85,Estaràs,193,106,87
25,Lleida,86,Esterri d'Àneu,705,349,356
25,Lleida,87,Esterri de Cardós,75,36,39
25,Lleida,89,Farrera,106,61,45
25,Lleida,908,Fígols i Alinyà,275,149,126
25,Lleida,92,Floresta (La),186,100,86
25,Lleida,93,Fondarella,721,364,357
25,Lleida,94,Foradada,209,119,90
25,Lleida,96,Fuliola (La),1227,620,607
25,Lleida,97,Fulleda,113,60,53
25,Lleida,98,Gavet de la Conca,303,147,156
25,Lleida,912,Gimenells i el Pla de la Font,1079,560,519
25,Lleida,99,Golmés,1433,719,714
25,Lleida,100,Gósol,225,119,106
25,Lleida,101,Granadella (La),777,398,379
25,Lleida,102,Granja d'Escarp (La),1059,566,493
25,Lleida,103,Granyanella,146,77,69
25,Lleida,105,Granyena de les Garrigues,165,92,73
25,Lleida,104,Granyena de Segarra,147,77,70
25,Lleida,109,Guimerà,346,174,172
25,Lleida,903,Guingueta d'Àneu (La),342,182,160
25,Lleida,110,Guissona,4138,2194,1944
25,Lleida,111,Guixers,165,98,67
25,Lleida,115,Isona i Conca Dellà,1197,648,549
25,Lleida,112,Ivars de Noguera,340,175,165
25,Lleida,113,Ivars d'Urgell,1781,914,867
25,Lleida,114,Ivorra,155,73,82
25,Lleida,910,Josa i Tuixén,181,100,81
25,Lleida,118,Juncosa,589,338,251
25,Lleida,119,Juneda,2992,1524,1468
25,Lleida,121,Les,676,336,340
25,Lleida,122,Linyola,2464,1242,1222
25,Lleida,123,Lladorre,215,111,104
25,Lleida,124,Lladurs,220,115,105
25,Lleida,125,Llardecans,595,311,284
25,Lleida,126,Llavorsí,295,148,147
25,Lleida,120,Lleida,118035,57736,60299
25,Lleida,127,Lles de Cerdanya,256,147,109
25,Lleida,128,Llimiana,158,84,74
25,Lleida,129,Llobera,223,119,104
25,Lleida,133,Maials,947,481,466
25,Lleida,130,Maldà,266,134,132
25,Lleida,131,Massalcoreig,607,301,306
25,Lleida,132,Massoteres,206,107,99
25,Lleida,134,Menàrguens,830,422,408
25,Lleida,135,Miralcamp,1248,617,631
25,Lleida,136,Molsosa (La),119,60,59
25,Lleida,137,Mollerussa,10625,5388,5237
25,Lleida,139,Montellà i Martinet,531,283,248
25,Lleida,140,Montferrer i Castellbò,766,416,350
25,Lleida,138,Montgai,819,413,406
25,Lleida,142,Montoliu de Lleida,456,226,230
25,Lleida,141,Montoliu de Segarra,188,104,84
25,Lleida,143,Montornès de Segarra,98,46,52
25,Lleida,145,Nalec,92,43,49
25,Lleida,25,Naut Aran,1543,805,738
25,Lleida,146,Navès,274,133,141
25,Lleida,148,Odèn,273,154,119
25,Lleida,149,Oliana,1872,949,923
25,Lleida,150,Oliola,283,155,128
25,Lleida,151,Olius,585,293,292
25,Lleida,152,Oluges (Les),180,94,86
25,Lleida,153,Omellons (Els),253,130,123
25,Lleida,154,Omells de na Gaia (Els),153,81,72
25,Lleida,155,Organyà,954,484,470
25,Lleida,156,Os de Balaguer,822,441,381
25,Lleida,157,Ossó de Sió,244,124,120
25,Lleida,158,Palau d'Anglesola (El),1741,871,870
25,Lleida,164,Penelles,538,294,244
25,Lleida,165,Peramola,385,206,179
25,Lleida,166,Pinell de Solsonès,204,109,95
25,Lleida,167,Pinós,303,165,138
25,Lleida,911,Plans de Sió (Els),573,294,279
25,Lleida,168,Poal (El),651,346,305
25,Lleida,169,Pobla de Cérvoles (La),233,126,107
25,Lleida,171,Pobla de Segur (La),2912,1419,1493
25,Lleida,30,Pont de Bar (El),153,84,69
25,Lleida,173,Pont de Suert (El),2165,1080,1085
25,Lleida,172,Ponts,2366,1191,1175
25,Lleida,174,Portella (La),643,353,290
25,Lleida,175,Prats i Sansor,211,121,90
25,Lleida,176,Preixana,427,209,218
25,Lleida,177,Preixens,522,252,270
25,Lleida,179,Prullans,215,114,101
25,Lleida,180,Puiggròs,259,133,126
25,Lleida,181,Puigverd d'Agramunt,265,140,125
25,Lleida,182,Puigverd de Lleida,1092,543,549
25,Lleida,183,Rialp,558,282,276
25,Lleida,905,Ribera d'Ondara,467,239,228
25,Lleida,185,Ribera d'Urgellet,829,428,401
25,Lleida,186,Riner,274,139,135
25,Lleida,913,Riu de Cerdanya,86,43,43
25,Lleida,189,Rosselló,1986,985,1001
25,Lleida,190,Salàs de Pallars,319,157,162
25,Lleida,191,Sanaüja,469,234,235
25,Lleida,196,Sant Esteve de la Sarga,106,65,41
25,Lleida,192,Sant Guim de Freixenet,1031,505,526
25,Lleida,197,Sant Guim de la Plana,176,93,83
25,Lleida,193,Sant Llorenç de Morunys,925,475,450
25,Lleida,902,Sant Martí de Riucorb,690,359,331
25,Lleida,194,Sant Ramon,564,291,273
25,Lleida,201,Sarroca de Bellera,154,84,70
25,Lleida,200,Sarroca de Lleida,444,221,223
25,Lleida,202,Senterada,100,48,52
25,Lleida,35,Sentiu de Sió (La),469,230,239
25,Lleida,204,Seròs,1754,945,809
25,Lleida,203,Seu d'Urgell (La),11726,5748,5978
25,Lleida,205,Sidamon,679,365,314
25,Lleida,206,Soleràs (El),428,234,194
25,Lleida,207,Solsona,7925,4008,3917
25,Lleida,208,Soriguera,330,172,158
25,Lleida,209,Sort,1924,975,949
25,Lleida,210,Soses,1552,825,727
25,Lleida,211,Sudanell,738,396,342
25,Lleida,212,Sunyer,289,145,144
25,Lleida,215,Talarn,346,173,173
25,Lleida,216,Talavera,281,148,133
25,Lleida,217,Tàrrega,13616,6789,6827
25,Lleida,218,Tarrés,115,58,57
25,Lleida,219,Tarroja de Segarra,160,77,83
25,Lleida,220,Térmens,1394,713,681
25,Lleida,221,Tírvia,128,65,63
25,Lleida,222,Tiurana,30,19,11
25,Lleida,223,Torà,1227,631,596
25,Lleida,224,Torms (Els),188,107,81
25,Lleida,225,Tornabous,833,435,398
25,Lleida,227,Torre de Cabdella (La),685,339,346
25,Lleida,226,Torrebesses,305,151,154
25,Lleida,228,Torrefarrera,2138,1102,1036
25,Lleida,907,Torrefeta i Florejacs,646,325,321
25,Lleida,230,Torregrossa,2213,1105,1108
25,Lleida,231,Torrelameu,578,319,259
25,Lleida,232,Torres de Segre,1879,969,910
25,Lleida,233,Torre-serona,347,183,164
25,Lleida,234,Tremp,5518,2733,2785
25,Lleida,43,Vall de Boí (La),952,524,428
25,Lleida,901,Vall de Cardós,335,174,161
25,Lleida,238,Vallbona de les Monges,268,133,135
25,Lleida,240,Vallfogona de Balaguer,1511,764,747
25,Lleida,906,Valls d'Aguilar (Les),332,180,152
25,Lleida,239,Valls de Valira (Les),803,430,373
25,Lleida,909,Vansa i Fórnols (La),200,101,99
25,Lleida,242,Verdú,1112,535,577
25,Lleida,243,Vielha e Mijaran,4547,2378,2169
25,Lleida,244,Vilagrassa,424,218,206
25,Lleida,245,Vilaller,570,293,277
25,Lleida,247,Vilamòs,159,88,71
25,Lleida,248,Vilanova de Bellpuig,1111,547,564
25,Lleida,254,Vilanova de la Barca,904,452,452
25,Lleida,249,Vilanova de l'Aguda,256,130,126
25,Lleida,250,Vilanova de Meià,423,221,202
25,Lleida,251,Vilanova de Segrià,782,396,386
25,Lleida,252,Vila-sana,570,273,297
25,Lleida,253,Vilosell (El),233,109,124
25,Lleida,255,Vinaixa,600,298,302
26,Rioja (La),1,Ábalos,269,152,117
26,Rioja (La),2,Agoncillo,947,498,449
26,Rioja (La),3,Aguilar del Río Alhama,705,356,349
26,Rioja (La),4,Ajamil,77,49,28
26,Rioja (La),5,Albelda de Iregua,2524,1270,1254
26,Rioja (La),6,Alberite,2187,1121,1066
26,Rioja (La),7,Alcanadre,758,390,368
26,Rioja (La),8,Aldeanueva de Ebro,2574,1338,1236
26,Rioja (La),9,Alesanco,452,233,219
26,Rioja (La),10,Alesón,131,67,64
26,Rioja (La),11,Alfaro,9331,4750,4581
26,Rioja (La),12,Almarza de Cameros,32,18,14
26,Rioja (La),13,Anguciana,323,175,148
26,Rioja (La),14,Anguiano,548,295,253
26,Rioja (La),15,Arenzana de Abajo,282,147,135
26,Rioja (La),16,Arenzana de Arriba,35,20,15
26,Rioja (La),17,Arnedillo,474,229,245
26,Rioja (La),18,Arnedo,13658,6820,6838
26,Rioja (La),19,Arrúbal,470,246,224
26,Rioja (La),20,Ausejo,798,446,352
26,Rioja (La),21,Autol,3822,2035,1787
26,Rioja (La),22,Azofra,315,169,146
26,Rioja (La),23,Badarán,708,371,337
26,Rioja (La),24,Bañares,375,189,186
26,Rioja (La),26,Baños de Río Tobía,1715,870,845
26,Rioja (La),25,Baños de Rioja,95,53,42
26,Rioja (La),27,Berceo,210,130,80
26,Rioja (La),28,Bergasa,149,82,67
26,Rioja (La),29,Bergasillas Bajera,31,17,14
26,Rioja (La),30,Bezares,22,14,8
26,Rioja (La),31,Bobadilla,138,76,62
26,Rioja (La),32,Brieva de Cameros,74,44,30
26,Rioja (La),33,Briñas,220,116,104
26,Rioja (La),34,Briones,828,442,386
26,Rioja (La),35,Cabezón de Cameros,22,18,4
26,Rioja (La),36,Calahorra,21354,10483,10871
26,Rioja (La),37,Camprovín,190,106,84
26,Rioja (La),38,Canales de la Sierra,91,55,36
26,Rioja (La),39,Canillas de Río Tuerto,52,27,25
26,Rioja (La),40,Cañas,121,65,56
26,Rioja (La),41,Cárdenas,217,104,113
26,Rioja (La),42,Casalarreina,1064,578,486
26,Rioja (La),43,Castañares de Rioja,427,206,221
26,Rioja (La),44,Castroviejo,55,33,22
26,Rioja (La),45,Cellorigo,21,11,10
26,Rioja (La),46,Cenicero,2001,1010,991
26,Rioja (La),47,Cervera del Río Alhama,2854,1499,1355
26,Rioja (La),48,Cidamón,39,21,18
26,Rioja (La),49,Cihuri,161,86,75
26,Rioja (La),50,Cirueña,113,65,48
26,Rioja (La),51,Clavijo,209,111,98
26,Rioja (La),52,Cordovín,225,123,102
26,Rioja (La),53,Corera,277,141,136
26,Rioja (La),54,Cornago,544,295,249
26,Rioja (La),55,Corporales,50,27,23
26,Rioja (La),56,Cuzcurrita de Río Tirón,449,240,209
26,Rioja (La),57,Daroca de Rioja,58,33,25
26,Rioja (La),58,Enciso,157,98,59
26,Rioja (La),59,Entrena,1171,625,546
26,Rioja (La),60,Estollo,122,70,52
26,Rioja (La),61,Ezcaray,1983,1078,905
26,Rioja (La),62,Foncea,107,56,51
26,Rioja (La),63,Fonzaleche,166,100,66
26,Rioja (La),64,Fuenmayor,2777,1423,1354
26,Rioja (La),65,Galbárruli,65,38,27
26,Rioja (La),66,Galilea,287,150,137
26,Rioja (La),67,Gallinero de Cameros,25,15,10
26,Rioja (La),68,Gimileo,144,86,58
26,Rioja (La),69,Grañón,383,210,173
26,Rioja (La),70,Grávalos,263,136,127
26,Rioja (La),71,Haro,9815,4847,4968
26,Rioja (La),72,Herce,383,200,183
26,Rioja (La),73,Herramélluri,134,70,64
26,Rioja (La),74,Hervías,142,73,69
26,Rioja (La),75,Hormilla,448,237,211
26,Rioja (La),76,Hormilleja,152,81,71
26,Rioja (La),77,Hornillos de Cameros,15,6,9
26,Rioja (La),78,Hornos de Moncalvillo,91,45,46
26,Rioja (La),79,Huércanos,898,477,421
26,Rioja (La),80,Igea,740,410,330
26,Rioja (La),81,Jalón de Cameros,48,29,19
26,Rioja (La),82,Laguna de Cameros,164,97,67
26,Rioja (La),83,Lagunilla del Jubera,290,157,133
26,Rioja (La),84,Lardero,5062,2603,2459
26,Rioja (La),86,Ledesma de la Cogolla,21,15,6
26,Rioja (La),87,Leiva,284,143,141
26,Rioja (La),88,Leza de Río Leza,31,20,11
26,Rioja (La),89,Logroño,139615,67819,71796
26,Rioja (La),91,Lumbreras,152,89,63
26,Rioja (La),92,Manjarrés,133,75,58
26,Rioja (La),93,Mansilla de la Sierra,52,33,19
26,Rioja (La),94,Manzanares de Rioja,105,60,45
26,Rioja (La),95,Matute,162,79,83
26,Rioja (La),96,Medrano,216,111,105
26,Rioja (La),98,Munilla,117,59,58
26,Rioja (La),99,Murillo de Río Leza,1307,656,651
26,Rioja (La),100,Muro de Aguas,60,34,26
26,Rioja (La),101,Muro en Cameros,36,21,15
26,Rioja (La),102,Nájera,7287,3644,3643
26,Rioja (La),103,Nalda,932,492,440
26,Rioja (La),104,Navajún,16,12,4
26,Rioja (La),105,Navarrete,2355,1219,1136
26,Rioja (La),106,Nestares,82,44,38
26,Rioja (La),107,Nieva de Cameros,95,52,43
26,Rioja (La),108,Ocón,299,175,124
26,Rioja (La),109,Ochánduri,90,48,42
26,Rioja (La),110,Ojacastro,222,128,94
26,Rioja (La),111,Ollauri,287,160,127
26,Rioja (La),112,Ortigosa de Cameros,303,171,132
26,Rioja (La),113,Pazuengos,48,30,18
26,Rioja (La),114,Pedroso,93,51,42
26,Rioja (La),115,Pinillos,22,11,11
26,Rioja (La),117,Pradejón,3562,1956,1606
26,Rioja (La),118,Pradillo,72,38,34
26,Rioja (La),119,Préjano,203,98,105
26,Rioja (La),120,Quel,1996,1053,943
26,Rioja (La),121,Rabanera,43,29,14
26,Rioja (La),122,Rasillo de Cameros (El),114,58,56
26,Rioja (La),123,Redal (El),208,109,99
26,Rioja (La),124,Ribafrecha,1002,548,454
26,Rioja (La),125,Rincón de Soto,3500,1831,1669
26,Rioja (La),126,Robres del Castillo,45,25,20
26,Rioja (La),127,Rodezno,310,174,136
26,Rioja (La),128,Sajazarra,124,66,58
26,Rioja (La),129,San Asensio,1242,663,579
26,Rioja (La),130,San Millán de la Cogolla,281,175,106
26,Rioja (La),131,San Millán de Yécora,70,49,21
26,Rioja (La),132,San Román de Cameros,170,96,74
26,Rioja (La),139,San Torcuato,116,74,42
26,Rioja (La),142,San Vicente de la Sonsierra,1167,644,523
26,Rioja (La),134,Santa Coloma,133,81,52
26,Rioja (La),135,Santa Engracia del Jubera,182,106,76
26,Rioja (La),136,Santa Eulalia Bajera,120,64,56
26,Rioja (La),138,Santo Domingo de la Calzada,5904,3004,2900
26,Rioja (La),140,Santurde de Rioja,304,156,148
26,Rioja (La),141,Santurdejo,180,103,77
26,Rioja (La),143,Sojuela,120,69,51
26,Rioja (La),144,Sorzano,237,127,110
26,Rioja (La),145,Sotés,252,135,117
26,Rioja (La),146,Soto en Cameros,202,103,99
26,Rioja (La),147,Terroba,28,15,13
26,Rioja (La),148,Tirgo,235,127,108
26,Rioja (La),149,Tobía,84,47,37
26,Rioja (La),150,Tormantos,196,109,87
26,Rioja (La),153,Torre en Cameros,15,12,3
26,Rioja (La),151,Torrecilla en Cameros,547,292,255
26,Rioja (La),152,Torrecilla sobre Alesanco,58,28,30
26,Rioja (La),154,Torremontalbo,16,8,8
26,Rioja (La),155,Treviana,233,123,110
26,Rioja (La),157,Tricio,387,191,196
26,Rioja (La),158,Tudelilla,402,213,189
26,Rioja (La),160,Uruñuela,777,400,377
26,Rioja (La),161,Valdemadera,12,8,4
26,Rioja (La),162,Valgañón,158,86,72
26,Rioja (La),163,Ventosa,133,74,59
26,Rioja (La),164,Ventrosa,90,50,40
26,Rioja (La),165,Viguera,378,222,156
26,Rioja (La),166,Villalba de Rioja,146,85,61
26,Rioja (La),167,Villalobar de Rioja,106,66,40
26,Rioja (La),168,Villamediana de Iregua,2850,1485,1365
26,Rioja (La),169,Villanueva de Cameros,114,67,47
26,Rioja (La),170,Villar de Arnedo (El),675,341,334
26,Rioja (La),171,Villar de Torre,280,151,129
26,Rioja (La),172,Villarejo,45,29,16
26,Rioja (La),173,Villarroya,9,4,5
26,Rioja (La),174,Villarta-Quintana,190,97,93
26,Rioja (La),175,Villavelayo,84,53,31
26,Rioja (La),176,Villaverde de Rioja,89,52,37
26,Rioja (La),177,Villoslada de Cameros,379,223,156
26,Rioja (La),178,Viniegra de Abajo,117,61,56
26,Rioja (La),179,Viniegra de Arriba,54,32,22
26,Rioja (La),180,Zarratón,246,132,114
26,Rioja (La),181,Zarzosa,15,11,4
26,Rioja (La),183,Zorraquín,58,34,24
27,Lugo,1,Abadín,3326,1594,1732
27,Lugo,2,Alfoz,2348,1127,1221
27,Lugo,3,Antas de Ulla,2676,1286,1390
27,Lugo,4,Baleira,1800,934,866
27,Lugo,901,Baralla,3242,1658,1584
27,Lugo,5,Barreiros,3323,1583,1740
27,Lugo,6,Becerreá,3442,1734,1708
27,Lugo,7,Begonte,3684,1824,1860
27,Lugo,8,Bóveda,1900,928,972
27,Lugo,902,Burela,8380,4172,4208
27,Lugo,9,Carballedo,3061,1510,1551
27,Lugo,10,Castro de Rei,5902,2929,2973
27,Lugo,11,Castroverde,3372,1741,1631
27,Lugo,12,Cervantes,2080,1137,943
27,Lugo,13,Cervo,5060,2516,2544
27,Lugo,14,Corgo (O),4183,2093,2090
27,Lugo,15,Cospeito,5609,2735,2874
27,Lugo,16,Chantada,9650,4717,4933
27,Lugo,17,Folgoso do Courel,1448,732,716
27,Lugo,18,Fonsagrada (A),4993,2629,2364
27,Lugo,19,Foz,9591,4587,5004
27,Lugo,20,Friol,4646,2307,2339
27,Lugo,22,Guitiriz,6131,3010,3121
27,Lugo,23,Guntín,3356,1693,1663
27,Lugo,24,Incio (O),2406,1166,1240
27,Lugo,26,Láncara,3146,1614,1532
27,Lugo,27,Lourenzá,2730,1325,1405
27,Lugo,28,Lugo,91158,42702,48456
27,Lugo,29,Meira,1806,875,931
27,Lugo,30,Mondoñedo,4909,2257,2652
27,Lugo,31,Monforte de Lemos,19710,9345,10365
27,Lugo,32,Monterroso,4229,2111,2118
27,Lugo,33,Muras,1020,507,513
27,Lugo,34,Navia de Suarna,1807,958,849
27,Lugo,35,Negueira de Muñiz,237,126,111
27,Lugo,37,Nogais (As),1520,785,735
27,Lugo,38,Ourol,1407,683,724
27,Lugo,39,Outeiro de Rei,4428,2264,2164
27,Lugo,40,Palas de Rei,4007,1971,2036
27,Lugo,41,Pantón,3249,1534,1715
27,Lugo,42,Paradela,2463,1230,1233
27,Lugo,43,Páramo (O),1873,942,931
27,Lugo,44,Pastoriza (A),3911,1948,1963
27,Lugo,45,Pedrafita do Cebreiro,1517,801,716
27,Lugo,47,Pobra do Brollón (A),2482,1224,1258
27,Lugo,46,Pol,2022,987,1035
27,Lugo,48,Pontenova (A),3199,1562,1637
27,Lugo,49,Portomarín,1996,987,1009
27,Lugo,50,Quiroga,4124,1986,2138
27,Lugo,56,Rábade,1626,813,813
27,Lugo,51,Ribadeo,9186,4322,4864
27,Lugo,52,Ribas de Sil,1410,688,722
27,Lugo,53,Ribeira de Piquín,827,416,411
27,Lugo,54,Riotorto,1762,862,900
27,Lugo,55,Samos,1999,1037,962
27,Lugo,57,Sarria,13142,6436,6706
27,Lugo,58,Saviñao (O),5014,2452,2562
27,Lugo,59,Sober,2985,1425,1560
27,Lugo,60,Taboada,3948,1895,2053
27,Lugo,61,Trabada,1579,768,811
27,Lugo,62,Triacastela,852,425,427
27,Lugo,63,Valadouro (O),2328,1159,1169
27,Lugo,64,Vicedo (O),2228,1094,1134
27,Lugo,65,Vilalba,15598,7630,7968
27,Lugo,66,Viveiro,15379,7408,7971
27,Lugo,21,Xermade,2516,1228,1288
27,Lugo,25,Xove,3574,1782,1792
28,Madrid,1,Acebeda (La),55,29,26
28,Madrid,2,Ajalvir,2755,1448,1307
28,Madrid,3,Alameda del Valle,195,117,78
28,Madrid,4,Álamo (El),5784,3129,2655
28,Madrid,5,Alcalá de Henares,188519,94460,94059
28,Madrid,6,Alcobendas,98417,48292,50125
28,Madrid,7,Alcorcón,154441,76428,78013
28,Madrid,8,Aldea del Fresno,1803,959,844
28,Madrid,9,Algete,16995,8520,8475
28,Madrid,10,Alpedrete,9627,4844,4783
28,Madrid,11,Ambite,323,163,160
28,Madrid,12,Anchuelo,574,314,260
28,Madrid,13,Aranjuez,41897,20381,21516
28,Madrid,14,Arganda del Rey,36250,18526,17724
28,Madrid,15,Arroyomolinos,6116,3108,3008
28,Madrid,16,Atazar (El),101,57,44
28,Madrid,17,Batres,1244,651,593
28,Madrid,18,Becerril de la Sierra,4090,2120,1970
28,Madrid,19,Belmonte de Tajo,1144,571,573
28,Madrid,21,Berrueco (El),463,245,218
28,Madrid,20,Berzosa del Lozoya,160,83,77
28,Madrid,22,Boadilla del Monte,30920,15424,15496
28,Madrid,23,Boalo (El),4283,2238,2045
28,Madrid,24,Braojos,190,108,82
28,Madrid,25,Brea de Tajo,467,235,232
28,Madrid,26,Brunete,6984,3490,3494
28,Madrid,27,Buitrago del Lozoya,1697,848,849
28,Madrid,28,Bustarviejo,1649,848,801
28,Madrid,29,Cabanillas de la Sierra,540,287,253
28,Madrid,30,Cabrera (La),2011,1017,994
28,Madrid,31,Cadalso de los Vidrios,2451,1253,1198
28,Madrid,32,Camarma de Esteruelas,3579,1836,1743
28,Madrid,33,Campo Real,3310,1691,1619
28,Madrid,34,Canencia,482,260,222
28,Madrid,35,Carabaña,1325,666,659
28,Madrid,36,Casarrubuelos,1460,765,695
28,Madrid,37,Cenicientos,1859,923,936
28,Madrid,38,Cercedilla,6297,3171,3126
28,Madrid,39,Cervera de Buitrago,129,73,56
28,Madrid,40,Ciempozuelos,16058,8199,7859
28,Madrid,41,Cobeña,3599,1792,1807
28,Madrid,43,Colmenar de Oreja,6257,3104,3153
28,Madrid,42,Colmenar del Arroyo,1029,509,520
28,Madrid,45,Colmenar Viejo,37239,18579,18660
28,Madrid,44,Colmenarejo,6235,3135,3100
28,Madrid,46,Collado Mediano,5317,2712,2605
28,Madrid,47,Collado Villalba,50634,25273,25361
28,Madrid,48,Corpa,461,236,225
28,Madrid,49,Coslada,82176,41108,41068
28,Madrid,50,Cubas de la Sagra,2421,1200,1221
28,Madrid,51,Chapinería,1620,820,800
28,Madrid,52,Chinchón,4576,2287,2289
28,Madrid,53,Daganzo de Arriba,5307,2686,2621
28,Madrid,54,Escorial (El),12669,6348,6321
28,Madrid,55,Estremera,1135,590,545
28,Madrid,56,Fresnedillas de la Oliva,1081,575,506
28,Madrid,57,Fresno de Torote,931,510,421
28,Madrid,58,Fuenlabrada,187963,94937,93026
28,Madrid,59,Fuente el Saz de Jarama,5260,2723,2537
28,Madrid,60,Fuentidueña de Tajo,1517,741,776
28,Madrid,61,Galapagar,26857,13614,13243
28,Madrid,62,Garganta de los Montes,348,182,166
28,Madrid,63,Gargantilla del Lozoya y Pinilla de Buitrago,303,177,126
28,Madrid,64,Gascones,138,75,63
28,Madrid,65,Getafe,156315,77940,78375
28,Madrid,66,Griñón,6594,3372,3222
28,Madrid,67,Guadalix de la Sierra,4109,2160,1949
28,Madrid,68,Guadarrama,11957,5998,5959
28,Madrid,69,Hiruela (La),99,55,44
28,Madrid,70,Horcajo de la Sierra,147,83,64
28,Madrid,71,Horcajuelo de la Sierra,115,51,64
28,Madrid,72,Hoyo de Manzanares,6725,3391,3334
28,Madrid,73,Humanes de Madrid,11738,6079,5659
28,Madrid,74,Leganés,176900,88183,88717
28,Madrid,75,Loeches,3729,1856,1873
28,Madrid,76,Lozoya,513,256,257
28,Madrid,901,Lozoyuela-Navas-Sieteiglesias,774,395,379
28,Madrid,78,Madarcos,33,20,13
28,Madrid,79,Madrid,3092759,1449343,1643416
28,Madrid,80,Majadahonda,56131,26883,29248
28,Madrid,82,Manzanares el Real,5182,2672,2510
28,Madrid,83,Meco,9217,4740,4477
28,Madrid,84,Mejorada del Campo,18438,9305,9133
28,Madrid,85,Miraflores de la Sierra,4365,2182,2183
28,Madrid,86,Molar (El),4607,2421,2186
28,Madrid,87,Molinos (Los),3821,1897,1924
28,Madrid,88,Montejo de la Sierra,319,152,167
28,Madrid,89,Moraleja de Enmedio,3629,1813,1816
28,Madrid,90,Moralzarzal,8163,4180,3983
28,Madrid,91,Morata de Tajuña,5916,2968,2948
28,Madrid,92,Móstoles,201789,100395,101394
28,Madrid,93,Navacerrada,2231,1118,1113
28,Madrid,94,Navalafuente,663,361,302
28,Madrid,95,Navalagamella,1514,813,701
28,Madrid,96,Navalcarnero,15768,7962,7806
28,Madrid,97,Navarredonda y San Mamés,126,67,59
28,Madrid,99,Navas del Rey,2050,1118,932
28,Madrid,100,Nuevo Baztán,4441,2254,2187
28,Madrid,101,Olmeda de las Fuentes,185,107,78
28,Madrid,102,Orusco de Tajuña,686,362,324
28,Madrid,104,Paracuellos de Jarama,7088,3648,3440
28,Madrid,106,Parla,82766,41983,40783
28,Madrid,107,Patones,374,194,180
28,Madrid,108,Pedrezuela,2033,1061,972
28,Madrid,109,Pelayos de la Presa,1842,960,882
28,Madrid,110,Perales de Tajuña,2245,1097,1148
28,Madrid,111,Pezuela de las Torres,503,260,243
28,Madrid,112,Pinilla del Valle,171,93,78
28,Madrid,113,Pinto,33445,16842,16603
28,Madrid,114,Piñuécar-Gandullas,183,88,95
28,Madrid,115,Pozuelo de Alarcón,72662,35132,37530
28,Madrid,116,Pozuelo del Rey,253,137,116
28,Madrid,117,Prádena del Rincón,105,57,48
28,Madrid,118,Puebla de la Sierra,104,55,49
28,Madrid,902,Puentes Viejas,417,234,183
28,Madrid,119,Quijorna,1565,820,745
28,Madrid,120,Rascafría,1643,867,776
28,Madrid,121,Redueña,218,119,99
28,Madrid,122,Ribatejada,400,223,177
28,Madrid,123,Rivas-Vaciamadrid,39630,19928,19702
28,Madrid,124,Robledillo de la Jara,107,52,55
28,Madrid,125,Robledo de Chavela,2768,1387,1381
28,Madrid,126,Robregordo,74,38,36
28,Madrid,127,Rozas de Madrid (Las),66809,32460,34349
28,Madrid,128,Rozas de Puerto Real,359,192,167
28,Madrid,129,San Agustín del Guadalix,7451,3698,3753
28,Madrid,130,San Fernando de Henares,38172,19215,18957
28,Madrid,131,San Lorenzo de El Escorial,14358,6965,7393
28,Madrid,132,San Martín de la Vega,13446,7024,6422
28,Madrid,133,San Martín de Valdeiglesias,6589,3279,3310
28,Madrid,134,San Sebastián de los Reyes,61583,30669,30914
28,Madrid,135,Santa María de la Alameda,856,452,404
28,Madrid,136,Santorcaz,616,315,301
28,Madrid,137,Santos de la Humosa (Los),1078,548,530
28,Madrid,138,Serna del Monte (La),122,62,60
28,Madrid,140,Serranillos del Valle,2206,1095,1111
28,Madrid,141,Sevilla la Nueva,5197,2715,2482
28,Madrid,143,Somosierra,111,62,49
28,Madrid,144,Soto del Real,6685,3359,3326
28,Madrid,145,Talamanca de Jarama,1761,882,879
28,Madrid,146,Tielmes,2262,1156,1106
28,Madrid,147,Titulcia,919,474,445
28,Madrid,148,Torrejón de Ardoz,104790,51257,53533
28,Madrid,149,Torrejón de la Calzada,5142,2565,2577
28,Madrid,150,Torrejón de Velasco,2643,1400,1243
28,Madrid,151,Torrelaguna,3413,1734,1679
28,Madrid,152,Torrelodones,17694,8593,9101
28,Madrid,153,Torremocha de Jarama,433,222,211
28,Madrid,154,Torres de la Alameda,5327,2704,2623
28,Madrid,903,Tres Cantos,38804,19190,19614
28,Madrid,155,Valdaracete,602,288,314
28,Madrid,156,Valdeavero,726,380,346
28,Madrid,157,Valdelaguna,647,344,303
28,Madrid,158,Valdemanco,632,336,296
28,Madrid,159,Valdemaqueda,680,341,339
28,Madrid,160,Valdemorillo,7860,4105,3755
28,Madrid,161,Valdemoro,37498,18826,18672
28,Madrid,162,Valdeolmos-Alalpardo,2010,1040,970
28,Madrid,163,Valdepiélagos,335,174,161
28,Madrid,164,Valdetorres de Jarama,2592,1333,1259
28,Madrid,165,Valdilecha,2147,1121,1026
28,Madrid,166,Valverde de Alcalá,332,170,162
28,Madrid,167,Velilla de San Antonio,8760,4460,4300
28,Madrid,168,Vellón (El),1215,636,579
28,Madrid,169,Venturada,1042,538,504
28,Madrid,171,Villa del Prado,4784,2525,2259
28,Madrid,170,Villaconejos,3039,1559,1480
28,Madrid,172,Villalbilla,5854,3004,2850
28,Madrid,173,Villamanrique de Tajo,639,326,313
28,Madrid,174,Villamanta,1785,916,869
28,Madrid,175,Villamantilla,416,219,197
28,Madrid,176,Villanueva de la Cañada,12525,6135,6390
28,Madrid,178,Villanueva de Perales,939,512,427
28,Madrid,177,Villanueva del Pardillo,7828,3941,3887
28,Madrid,179,Villar del Olmo,1665,861,804
28,Madrid,180,Villarejo de Salvanés,6022,3006,3016
28,Madrid,181,Villaviciosa de Odón,22094,10855,11239
28,Madrid,182,Villavieja del Lozoya,195,102,93
28,Madrid,183,Zarzalejo,1192,620,572
29,Málaga,1,Alameda,5066,2503,2563
29,Málaga,2,Alcaucín,1599,810,789
29,Málaga,3,Alfarnate,1401,726,675
29,Málaga,4,Alfarnatejo,387,205,182
29,Málaga,5,Algarrobo,4862,2417,2445
29,Málaga,6,Algatocín,954,496,458
29,Málaga,7,Alhaurín de la Torre,25401,12664,12737
29,Málaga,8,Alhaurín el Grande,18797,9428,9369
29,Málaga,9,Almáchar,1902,971,931
29,Málaga,10,Almargen,2096,1035,1061
29,Málaga,11,Almogía,4269,2179,2090
29,Málaga,12,Álora,12739,6410,6329
29,Málaga,13,Alozaina,2211,1149,1062
29,Málaga,14,Alpandeire,298,150,148
29,Málaga,15,Antequera,41953,20556,21397
29,Málaga,16,Árchez,355,181,174
29,Málaga,17,Archidona,8267,4088,4179
29,Málaga,18,Ardales,2650,1304,1346
29,Málaga,19,Arenas,1202,644,558
29,Málaga,20,Arriate,3586,1734,1852
29,Málaga,21,Atajate,175,92,83
29,Málaga,22,Benadalid,263,138,125
29,Málaga,23,Benahavís,2401,1196,1205
29,Málaga,24,Benalauría,481,247,234
29,Málaga,25,Benalmádena,40064,19710,20354
29,Málaga,26,Benamargosa,1528,775,753
29,Málaga,27,Benamocarra,2852,1445,1407
29,Málaga,28,Benaoján,1584,791,793
29,Málaga,29,Benarrabá,585,310,275
29,Málaga,30,Borge (El),988,510,478
29,Málaga,31,Burgo (El),2061,1036,1025
29,Málaga,32,Campillos,7813,3926,3887
29,Málaga,33,Canillas de Aceituno,2037,1033,1004
29,Málaga,34,Canillas de Albaida,755,394,361
29,Málaga,35,Cañete la Real,2090,1067,1023
29,Málaga,36,Carratraca,824,412,412
29,Málaga,37,Cartajima,237,123,114
29,Málaga,38,Cártama,14783,7493,7290
29,Málaga,39,Casabermeja,2942,1519,1423
29,Málaga,40,Casarabonela,2492,1271,1221
29,Málaga,41,Casares,3661,1908,1753
29,Málaga,42,Coín,19213,9915,9298
29,Málaga,43,Colmenar,3167,1552,1615
29,Málaga,44,Comares,1365,723,642
29,Málaga,45,Cómpeta,3195,1637,1558
29,Málaga,46,Cortes de la Frontera,3523,1782,1741
29,Málaga,47,Cuevas Bajas,1435,704,731
29,Málaga,49,Cuevas de San Marcos,3994,1976,2018
29,Málaga,48,Cuevas del Becerro,1886,945,941
29,Málaga,50,Cútar,637,325,312
29,Málaga,51,Estepona,47697,23674,24023
29,Málaga,52,Faraján,267,126,141
29,Málaga,53,Frigiliana,2328,1143,1185
29,Málaga,54,Fuengirola,57133,28229,28904
29,Málaga,55,Fuente de Piedra,2024,985,1039
29,Málaga,56,Gaucín,1793,936,857
29,Málaga,57,Genalguacil,528,279,249
29,Málaga,58,Guaro,2013,1024,989
29,Málaga,59,Humilladero,2745,1388,1357
29,Málaga,60,Igualeja,967,494,473
29,Málaga,61,Istán,1362,690,672
29,Málaga,62,Iznate,805,413,392
29,Málaga,63,Jimera de Líbar,386,186,200
29,Málaga,64,Jubrique,745,387,358
29,Málaga,65,Júzcar,211,118,93
29,Málaga,66,Macharaviaya,368,202,166
29,Málaga,67,Málaga,547105,262983,284122
29,Málaga,68,Manilva,7270,3734,3536
29,Málaga,69,Marbella,116234,57485,58749
29,Málaga,70,Mijas,52189,26163,26026
29,Málaga,71,Moclinejo,1123,575,548
29,Málaga,72,Mollina,3658,1809,1849
29,Málaga,73,Monda,1855,959,896
29,Málaga,74,Montejaque,1005,498,507
29,Málaga,75,Nerja,17637,8695,8942
29,Málaga,76,Ojén,2253,1177,1076
29,Málaga,77,Parauta,250,129,121
29,Málaga,79,Periana,3388,1765,1623
29,Málaga,80,Pizarra,6940,3420,3520
29,Málaga,81,Pujerra,324,180,144
29,Málaga,82,Rincón de la Victoria,28007,14021,13986
29,Málaga,83,Riogordo,2786,1430,1356
29,Málaga,84,Ronda,35137,17471,17666
29,Málaga,85,Salares,211,109,102
29,Málaga,86,Sayalonga,1289,645,644
29,Málaga,87,Sedella,487,262,225
29,Málaga,88,Sierra de Yeguas,3284,1644,1640
29,Málaga,89,Teba,4330,2213,2117
29,Málaga,90,Tolox,2221,1132,1089
29,Málaga,901,Torremolinos,50649,25204,25445
29,Málaga,91,Torrox,12391,6137,6254
29,Málaga,92,Totalán,624,326,298
29,Málaga,93,Valle de Abdalajís,2934,1432,1502
29,Málaga,94,Vélez-Málaga,60197,29875,30322
29,Málaga,95,Villanueva de Algaidas,4192,2096,2096
29,Málaga,98,Villanueva de Tapia,1658,845,813
29,Málaga,96,Villanueva del Rosario,3358,1649,1709
29,Málaga,97,Villanueva del Trabuco,4884,2472,2412
29,Málaga,99,Viñuela,1358,683,675
29,Málaga,100,Yunquera,3264,1703,1561
30,Murcia,1,Abanilla,6239,3151,3088
30,Murcia,2,Abarán,12786,6425,6361
30,Murcia,3,Águilas,29642,14822,14820
30,Murcia,4,Albudeite,1358,693,665
30,Murcia,5,Alcantarilla,35916,17845,18071
30,Murcia,902,Alcázares (Los),10396,5346,5050
30,Murcia,6,Aledo,1044,536,508
30,Murcia,7,Alguazas,7387,3713,3674
30,Murcia,8,Alhama de Murcia,17205,8729,8476
30,Murcia,9,Archena,15792,7998,7794
30,Murcia,10,Beniel,9151,4745,4406
30,Murcia,11,Blanca,5885,2934,2951
30,Murcia,12,Bullas,11252,5690,5562
30,Murcia,13,Calasparra,9405,4746,4659
30,Murcia,14,Campos del Río,2032,1000,1032
30,Murcia,15,Caravaca de la Cruz,23847,11914,11933
30,Murcia,16,Cartagena,194203,97497,96706
30,Murcia,17,Cehegín,14779,7393,7386
30,Murcia,18,Ceutí,8124,4145,3979
30,Murcia,19,Cieza,33701,16745,16956
30,Murcia,20,Fortuna,7446,3853,3593
30,Murcia,21,Fuente Álamo de Murcia,12503,6751,5752
30,Murcia,22,Jumilla,23666,12202,11464
30,Murcia,23,Librilla,4025,2026,1999
30,Murcia,24,Lorca,82511,42547,39964
30,Murcia,25,Lorquí,5922,3007,2915
30,Murcia,26,Mazarrón,24969,13543,11426
30,Murcia,27,Molina de Segura,50545,25350,25195
30,Murcia,28,Moratalla,8562,4378,4184
30,Murcia,29,Mula,15372,7839,7533
30,Murcia,30,Murcia,391146,192768,198378
30,Murcia,31,Ojós,609,300,309
30,Murcia,32,Pliego,3464,1803,1661
30,Murcia,33,Puerto Lumbreras,11794,5923,5871
30,Murcia,34,Ricote,1526,751,775
30,Murcia,35,San Javier,23481,12196,11285
30,Murcia,36,San Pedro del Pinatar,18279,9288,8991
30,Murcia,901,Santomera,12434,6294,6140
30,Murcia,37,Torre-Pacheco,27092,15025,12067
30,Murcia,38,Torres de Cotillas (Las),17141,8732,8409
30,Murcia,39,Totana,26361,13747,12614
30,Murcia,40,Ulea,999,507,492
30,Murcia,41,Unión (La),15172,7620,7552
30,Murcia,42,Villanueva del Río Segura,1599,776,823
30,Murcia,43,Yecla,32468,16502,15966
31,Navarra,1,Abáigar,92,52,40
31,Navarra,2,Abárzuza,522,263,259
31,Navarra,3,Abaurregaina/Abaurrea Alta,156,95,61
31,Navarra,4,Abaurrepea/Abaurrea Baja,44,32,12
31,Navarra,5,Aberin,344,189,155
31,Navarra,6,Ablitas,2402,1246,1156
31,Navarra,7,Adiós,147,76,71
31,Navarra,8,Aguilar de Codés,110,60,50
31,Navarra,9,Aibar/Oibar,928,479,449
31,Navarra,10,Altsasu/Alsasua,7355,3738,3617
31,Navarra,11,Allín,784,403,381
31,Navarra,12,Allo,1054,531,523
31,Navarra,13,Améscoa Baja,827,426,401
31,Navarra,14,Ancín,393,225,168
31,Navarra,15,Andosilla,2614,1316,1298
31,Navarra,16,Ansoáin,8854,4477,4377
31,Navarra,17,Anue,405,236,169
31,Navarra,18,Añorbe,490,267,223
31,Navarra,19,Aoiz/Agoitz,2001,1005,996
31,Navarra,20,Araitz,595,351,244
31,Navarra,25,Arakil,867,468,399
31,Navarra,21,Aranarache,89,46,43
31,Navarra,23,Aranguren,4665,2418,2247
31,Navarra,24,Arano,141,73,68
31,Navarra,22,Arantza,603,336,267
31,Navarra,26,Aras,225,119,106
31,Navarra,27,Arbizu,950,505,445
31,Navarra,28,Arce/Artzi,283,162,121
31,Navarra,29,Arcos (Los),1308,654,654
31,Navarra,30,Arellano,201,109,92
31,Navarra,31,Areso,295,158,137
31,Navarra,32,Arguedas,2345,1182,1163
31,Navarra,33,Aria,68,41,27
31,Navarra,34,Aribe,62,34,28
31,Navarra,35,Armañanzas,85,42,43
31,Navarra,36,Arróniz,1140,611,529
31,Navarra,37,Arruazu,106,58,48
31,Navarra,38,Artajona,1699,896,803
31,Navarra,39,Artazu,107,58,49
31,Navarra,40,Atez,230,139,91
31,Navarra,58,Auritz/Burguete,324,145,179
31,Navarra,41,Ayegui,1211,641,570
31,Navarra,42,Azagra,3792,1950,1842
31,Navarra,43,Azuelo,50,25,25
31,Navarra,44,Bakaiku,345,192,153
31,Navarra,901,Barañain,21540,10647,10893
31,Navarra,45,Barásoain,478,244,234
31,Navarra,46,Barbarin,97,44,53
31,Navarra,47,Bargota,373,184,189
31,Navarra,48,Barillas,198,103,95
31,Navarra,49,Basaburua,682,388,294
31,Navarra,50,Baztan,7746,3949,3797
31,Navarra,137,Beintza-Labaien,269,154,115
31,Navarra,51,Beire,299,148,151
31,Navarra,52,Belascoáin,116,57,59
31,Navarra,250,Bera/Vera de Bidasoa,3637,1845,1792
31,Navarra,53,Berbinzana,735,378,357
31,Navarra,905,Beriáin,2925,1463,1462
31,Navarra,902,Berrioplano,1469,764,705
31,Navarra,903,Berriozar,7577,3927,3650
31,Navarra,54,Bertizarana,684,347,337
31,Navarra,55,Betelu,331,174,157
31,Navarra,253,Bidaurreta,113,66,47
31,Navarra,56,Biurrun-Olcoz,204,118,86
31,Navarra,57,Buñuel,2421,1226,1195
31,Navarra,59,Burgui/Burgi,240,139,101
31,Navarra,60,Burlada/Burlata,17964,8853,9111
31,Navarra,61,Busto (El),92,50,42
31,Navarra,62,Cabanillas,1616,863,753
31,Navarra,63,Cabredo,115,59,56
31,Navarra,64,Cadreita,2117,1117,1000
31,Navarra,65,Caparroso,2440,1214,1226
31,Navarra,66,Cárcar,1191,595,596
31,Navarra,67,Carcastillo,2708,1406,1302
31,Navarra,68,Cascante,3853,1946,1907
31,Navarra,69,Cáseda,1060,524,536
31,Navarra,70,Castejón,3438,1781,1657
31,Navarra,71,Castillonuevo,19,11,8
31,Navarra,72,Cintruénigo,6349,3187,3162
31,Navarra,74,Cirauqui,445,250,195
31,Navarra,75,Ciriza,77,35,42
31,Navarra,76,Cizur,1703,869,834
31,Navarra,77,Corella,7432,3771,3661
31,Navarra,78,Cortes,3379,1792,1587
31,Navarra,79,Desojo,119,67,52
31,Navarra,80,Dicastillo,690,363,327
31,Navarra,81,Donamaria,408,203,205
31,Navarra,221,Doneztebe/Santesteban,1453,718,735
31,Navarra,83,Echarri,64,37,27
31,Navarra,86,Egüés,3985,2004,1981
31,Navarra,87,Elgorriaga,223,113,110
31,Navarra,89,Enériz,215,112,103
31,Navarra,90,Eratsun,174,114,60
31,Navarra,91,Ergoiena,448,251,197
31,Navarra,92,Erro,759,430,329
31,Navarra,94,Eslava,164,83,81
31,Navarra,95,Esparza de Salazar,102,52,50
31,Navarra,96,Espronceda,164,94,70
31,Navarra,97,Estella/Lizarra,13449,6543,6906
31,Navarra,98,Esteribar,1527,824,703
31,Navarra,99,Etayo,91,47,44
31,Navarra,82,Etxalar,801,418,383
31,Navarra,84,Etxarri-Aranatz,2417,1238,1179
31,Navarra,85,Etxauri,452,241,211
31,Navarra,100,Eulate,362,192,170
31,Navarra,101,Ezcabarte,1353,736,617
31,Navarra,93,Ezcároz/Ezkaroze,363,190,173
31,Navarra,102,Ezkurra,204,130,74
31,Navarra,103,Ezprogui,59,29,30
31,Navarra,104,Falces,2536,1249,1287
31,Navarra,105,Fitero,2234,1135,1099
31,Navarra,106,Fontellas,799,427,372
31,Navarra,107,Funes,2367,1267,1100
31,Navarra,108,Fustiñana,2427,1231,1196
31,Navarra,109,Galar,1306,676,630
31,Navarra,110,Gallipienzo,163,85,78
31,Navarra,111,Gallués/Galoze,118,72,46
31,Navarra,112,Garaioa,130,72,58
31,Navarra,113,Garde,186,105,81
31,Navarra,114,Garínoain,423,231,192
31,Navarra,115,Garralda,201,97,104
31,Navarra,116,Genevilla,112,63,49
31,Navarra,117,Goizueta,853,463,390
31,Navarra,118,Goñi,208,124,84
31,Navarra,119,Güesa/Gorza,68,39,29
31,Navarra,120,Guesálaz,472,272,200
31,Navarra,121,Guirguillano,92,48,44
31,Navarra,256,Hiriberri/Villanueva de Aezkoa,144,84,60
31,Navarra,122,Huarte/Uharte,3340,1699,1641
31,Navarra,124,Ibargoiti,233,134,99
31,Navarra,259,Igantzi,604,318,286
31,Navarra,125,Igúzquiza,341,166,175
31,Navarra,126,Imotz,411,225,186
31,Navarra,127,Irañeta,161,85,76
31,Navarra,904,Irurtzun,2277,1213,1064
31,Navarra,128,Isaba/Izaba,500,246,254
31,Navarra,129,Ituren,469,235,234
31,Navarra,130,Iturmendi,378,199,179
31,Navarra,131,Iza,786,413,373
31,Navarra,132,Izagaondoa,170,101,69
31,Navarra,133,Izalzu/Itzaltzu,45,27,18
31,Navarra,134,Jaurrieta,240,132,108
31,Navarra,135,Javier,89,38,51
31,Navarra,136,Juslapeña,492,270,222
31,Navarra,138,Lakuntza,1049,546,503
31,Navarra,139,Lana,213,126,87
31,Navarra,140,Lantz,121,76,45
31,Navarra,141,Lapoblación,178,105,73
31,Navarra,142,Larraga,1974,1098,876
31,Navarra,143,Larraona,145,71,74
31,Navarra,144,Larraun,1054,587,467
31,Navarra,145,Lazagurría,208,110,98
31,Navarra,146,Leache,48,28,20
31,Navarra,147,Legarda,96,52,44
31,Navarra,148,Legaria,122,55,67
31,Navarra,149,Leitza,2898,1512,1386
31,Navarra,908,Lekunberri,856,446,410
31,Navarra,150,Leoz,249,163,86
31,Navarra,151,Lerga,81,44,37
31,Navarra,152,Lerín,1867,951,916
31,Navarra,153,Lesaka,2692,1408,1284
31,Navarra,154,Lezáun,270,156,114
31,Navarra,155,Liédena,349,169,180
31,Navarra,156,Lizoáin,238,138,100
31,Navarra,157,Lodosa,4732,2433,2299
31,Navarra,158,Lónguida/Longida,310,162,148
31,Navarra,159,Lumbier,1413,741,672
31,Navarra,160,Luquin,132,73,59
31,Navarra,248,Luzaide/Valcarlos,448,219,229
31,Navarra,161,Mañeru,388,203,185
31,Navarra,162,Marañón,64,35,29
31,Navarra,163,Marcilla,2647,1375,1272
31,Navarra,164,Mélida,754,380,374
31,Navarra,165,Mendavia,3719,1903,1816
31,Navarra,166,Mendaza,352,170,182
31,Navarra,167,Mendigorría,981,501,480
31,Navarra,168,Metauten,302,169,133
31,Navarra,169,Milagro,2879,1460,1419
31,Navarra,170,Mirafuentes,56,28,28
31,Navarra,171,Miranda de Arga,1018,518,500
31,Navarra,172,Monreal,300,158,142
31,Navarra,173,Monteagudo,1161,580,581
31,Navarra,174,Morentin,155,78,77
31,Navarra,175,Mues,102,54,48
31,Navarra,176,Murchante,3255,1615,1640
31,Navarra,177,Murieta,274,159,115
31,Navarra,178,Murillo el Cuende,650,348,302
31,Navarra,179,Murillo el Fruto,749,384,365
31,Navarra,180,Muruzábal,282,135,147
31,Navarra,181,Navascués,203,127,76
31,Navarra,182,Nazar,55,34,21
31,Navarra,88,Noáin (Valle de Elorz)/Noain (Elortzibar),4169,2083,2086
31,Navarra,183,Obanos,856,422,434
31,Navarra,184,Oco,83,47,36
31,Navarra,185,Ochagavía,667,348,319
31,Navarra,186,Odieta,333,190,143
31,Navarra,187,Oitz,154,89,65
31,Navarra,188,Olaibar,178,89,89
31,Navarra,189,Olazti/Olazagutía,1697,875,822
31,Navarra,190,Olejua,53,24,29
31,Navarra,191,Olite,3265,1651,1614
31,Navarra,192,Olóriz,171,100,71
31,Navarra,193,Olza,1460,757,703
31,Navarra,194,Ollo,311,174,137
31,Navarra,195,Orbaitzeta,237,124,113
31,Navarra,196,Orbara,57,29,28
31,Navarra,906,Orcoyen,1683,875,808
31,Navarra,197,Orísoain,88,50,38
31,Navarra,198,Oronz,53,29,24
31,Navarra,199,Oroz-Betelu,206,106,100
31,Navarra,211,Orreaga/Roncesvalles,23,13,10
31,Navarra,200,Oteiza,941,492,449
31,Navarra,201,Pamplona/Iruña,190937,91443,99494
31,Navarra,202,Peralta,5668,2905,2763
31,Navarra,203,Petilla de Aragón,36,21,15
31,Navarra,204,Piedramillera,59,36,23
31,Navarra,205,Pitillas,608,306,302
31,Navarra,206,Puente la Reina/Gares,2520,1270,1250
31,Navarra,207,Pueyo,319,169,150
31,Navarra,208,Ribaforada,3440,1778,1662
31,Navarra,209,Romanzado,149,90,59
31,Navarra,210,Roncal/Erronkari,325,178,147
31,Navarra,212,Sada,223,120,103
31,Navarra,213,Saldías,133,79,54
31,Navarra,214,Salinas de Oro,105,59,46
31,Navarra,215,San Adrián,5793,2881,2912
31,Navarra,217,San Martín de Unx,440,239,201
31,Navarra,216,Sangüesa/Zangoza,4933,2550,2383
31,Navarra,219,Sansol,113,56,57
31,Navarra,220,Santacara,1028,521,507
31,Navarra,222,Sarriés/Sartze,78,47,31
31,Navarra,223,Sartaguda,1334,681,653
31,Navarra,224,Sesma,1418,713,705
31,Navarra,225,Sorlada,47,25,22
31,Navarra,226,Sunbilla,675,350,325
31,Navarra,227,Tafalla,10842,5343,5499
31,Navarra,228,Tiebas-Muruarte de Reta,564,299,265
31,Navarra,229,Tirapu,61,34,27
31,Navarra,230,Torralba del Río,143,76,67
31,Navarra,231,Torres del Río,165,83,82
31,Navarra,232,Tudela,31228,15680,15548
31,Navarra,233,Tulebras,110,38,72
31,Navarra,234,Ucar,129,68,61
31,Navarra,123,Uharte-Arakil,787,425,362
31,Navarra,235,Ujué,234,121,113
31,Navarra,236,Ultzama,1624,807,817
31,Navarra,237,Unciti,220,129,91
31,Navarra,238,Unzué,133,76,57
31,Navarra,239,Urdazubi/Urdax,387,193,194
31,Navarra,240,Urdiain,630,322,308
31,Navarra,241,Urraul Alto,168,101,67
31,Navarra,242,Urraul Bajo,287,134,153
31,Navarra,244,Urrotz,190,112,78
31,Navarra,243,Urroz,369,192,177
31,Navarra,245,Urzainqui,107,58,49
31,Navarra,246,Uterga,175,89,86
31,Navarra,247,Uztárroz/Uztarroze,225,110,115
31,Navarra,249,Valtierra,2430,1202,1228
31,Navarra,251,Viana,3589,1895,1694
31,Navarra,252,Vidángoz/Bidankoze,115,62,53
31,Navarra,254,Villafranca,2688,1370,1318
31,Navarra,255,Villamayor de Monjardín,123,61,62
31,Navarra,257,Villatuerta,908,462,446
31,Navarra,258,Villava/Atarrabia,10035,4986,5049
31,Navarra,260,Yerri,1562,831,731
31,Navarra,261,Yesa,262,141,121
31,Navarra,262,Zabalza,169,80,89
31,Navarra,73,Ziordia,365,172,193
31,Navarra,907,Zizur Mayor/Zizur Nagusia,12474,6195,6279
31,Navarra,263,Zubieta,293,171,122
31,Navarra,264,Zugarramurdi,230,117,113
31,Navarra,265,Zúñiga,173,102,71
32,Ourense,1,Allariz,5216,2518,2698
32,Ourense,2,Amoeiro,2276,1126,1150
32,Ourense,3,Arnoia (A),1233,580,653
32,Ourense,4,Avión,2881,1278,1603
32,Ourense,5,Baltar,1189,593,596
32,Ourense,6,Bande,2332,1068,1264
32,Ourense,7,Baños de Molgas,2088,1030,1058
32,Ourense,8,Barbadás,7193,3500,3693
32,Ourense,9,Barco de Valdeorras (O),13507,6744,6763
32,Ourense,10,Beade,576,284,292
32,Ourense,11,Beariz,1477,690,787
32,Ourense,12,Blancos (Os),1148,567,581
32,Ourense,13,Boborás,3286,1507,1779
32,Ourense,14,Bola (A),1540,728,812
32,Ourense,15,Bolo (O),1326,657,669
32,Ourense,16,Calvos de Randín,1242,625,617
32,Ourense,18,Carballeda de Avia,1596,762,834
32,Ourense,17,Carballeda de Valdeorras,2155,1076,1079
32,Ourense,19,Carballiño (O),13076,6196,6880
32,Ourense,20,Cartelle,3641,1753,1888
32,Ourense,22,Castrelo de Miño,2052,994,1058
32,Ourense,21,Castrelo do Val,1263,625,638
32,Ourense,23,Castro Caldelas,1863,940,923
32,Ourense,24,Celanova,6071,2865,3206
32,Ourense,25,Cenlle,1601,754,847
32,Ourense,26,Coles,3201,1590,1611
32,Ourense,27,Cortegada,1420,684,736
32,Ourense,28,Cualedro,2316,1161,1155
32,Ourense,29,Chandrexa de Queixa,854,460,394
32,Ourense,30,Entrimo,1386,638,748
32,Ourense,31,Esgos,1318,648,670
32,Ourense,33,Gomesende,1105,513,592
32,Ourense,34,Gudiña (A),1651,823,828
32,Ourense,35,Irixo (O),2092,985,1107
32,Ourense,38,Larouco,570,273,297
32,Ourense,39,Laza,1826,898,928
32,Ourense,40,Leiro,1967,936,1031
32,Ourense,41,Lobeira,1225,591,634
32,Ourense,42,Lobios,2584,1239,1345
32,Ourense,43,Maceda,3307,1622,1685
32,Ourense,44,Manzaneda,1156,594,562
32,Ourense,45,Maside,3157,1490,1667
32,Ourense,46,Melón,1530,691,839
32,Ourense,47,Merca (A),2373,1120,1253
32,Ourense,48,Mezquita (A),1468,761,707
32,Ourense,49,Montederramo,1188,605,583
32,Ourense,50,Monterrei,3246,1627,1619
32,Ourense,51,Muíños,2012,983,1029
32,Ourense,52,Nogueira de Ramuín,2565,1202,1363
32,Ourense,53,Oímbra,1991,1007,984
32,Ourense,54,Ourense,109475,51069,58406
32,Ourense,55,Paderne de Allariz,1643,778,865
32,Ourense,56,Padrenda,2530,1197,1333
32,Ourense,57,Parada de Sil,808,392,416
32,Ourense,58,Pereiro de Aguiar (O),5326,2678,2648
32,Ourense,59,Peroxa (A),2521,1184,1337
32,Ourense,60,Petín,1099,531,568
32,Ourense,61,Piñor,1527,750,777
32,Ourense,63,Pobra de Trives (A),2734,1355,1379
32,Ourense,64,Pontedeva,664,315,349
32,Ourense,62,Porqueira,1151,553,598
32,Ourense,65,Punxín,956,452,504
32,Ourense,66,Quintela de Leirado,851,397,454
32,Ourense,67,Rairiz de Veiga,1767,864,903
32,Ourense,68,Ramirás,2053,951,1102
32,Ourense,69,Ribadavia,5540,2677,2863
32,Ourense,71,Riós,2123,1056,1067
32,Ourense,72,Rúa (A),5027,2438,2589
32,Ourense,73,Rubiá,1716,843,873
32,Ourense,74,San Amaro,1385,676,709
32,Ourense,75,San Cibrao das Viñas,3840,1865,1975
32,Ourense,76,San Cristovo de Cea,3026,1470,1556
32,Ourense,70,San Xoán de Río,913,433,480
32,Ourense,77,Sandiás,1618,750,868
32,Ourense,78,Sarreaus,1845,911,934
32,Ourense,79,Taboadela,1701,839,862
32,Ourense,80,Teixeira (A),551,267,284
32,Ourense,81,Toén,2521,1260,1261
32,Ourense,82,Trasmiras,1828,895,933
32,Ourense,83,Veiga (A),1341,663,678
32,Ourense,84,Verea,1387,668,719
32,Ourense,85,Verín,13658,6659,6999
32,Ourense,86,Viana do Bolo,3743,1863,1880
32,Ourense,87,Vilamarín,2236,1097,1139
32,Ourense,88,Vilamartín de Valdeorras,2477,1180,1297
32,Ourense,89,Vilar de Barrio,1963,969,994
32,Ourense,90,Vilar de Santos,1001,485,516
32,Ourense,91,Vilardevós,2693,1346,1347
32,Ourense,92,Vilariño de Conso,771,427,344
32,Ourense,32,Xinzo de Limia,9821,4875,4946
32,Ourense,36,Xunqueira de Ambía,1997,989,1008
32,Ourense,37,Xunqueira de Espadanedo,1050,503,547
33,Asturias,1,Allande,2296,1191,1105
33,Asturias,2,Aller,14366,7047,7319
33,Asturias,3,Amieva,883,471,412
33,Asturias,4,Avilés,84182,40374,43808
33,Asturias,5,Belmonte de Miranda,2099,1088,1011
33,Asturias,6,Bimenes,2008,954,1054
33,Asturias,7,Boal,2332,1164,1168
33,Asturias,8,Cabrales,2328,1180,1148
33,Asturias,9,Cabranes,1139,569,570
33,Asturias,10,Candamo,2449,1183,1266
33,Asturias,12,Cangas de Onís,6358,3136,3222
33,Asturias,11,Cangas del Narcea,16340,8203,8137
33,Asturias,13,Caravia,575,287,288
33,Asturias,14,Carreño,10431,5131,5300
33,Asturias,15,Caso,1928,1034,894
33,Asturias,16,Castrillón,22603,10963,11640
33,Asturias,17,Castropol,4087,1923,2164
33,Asturias,18,Coaña,3584,1753,1831
33,Asturias,19,Colunga,4013,1969,2044
33,Asturias,20,Corvera de Asturias,15795,7737,8058
33,Asturias,21,Cudillero,5992,2928,3064
33,Asturias,22,Degaña,1452,757,695
33,Asturias,23,Franco (El),4168,2027,2141
33,Asturias,24,Gijón,270875,128672,142203
33,Asturias,25,Gozón,10791,5263,5528
33,Asturias,26,Grado,11405,5513,5892
33,Asturias,27,Grandas de Salime,1233,623,610
33,Asturias,28,Ibias,2024,1082,942
33,Asturias,29,Illano,596,315,281
33,Asturias,30,Illas,1082,574,508
33,Asturias,31,Langreo,47594,22724,24870
33,Asturias,32,Laviana,14443,7013,7430
33,Asturias,33,Lena,13609,6602,7007
33,Asturias,35,Llanera,12591,6223,6368
33,Asturias,36,Llanes,13032,6306,6726
33,Asturias,37,Mieres,47618,22802,24816
33,Asturias,38,Morcín,3102,1545,1557
33,Asturias,39,Muros de Nalón,2095,984,1111
33,Asturias,40,Nava,5499,2712,2787
33,Asturias,41,Navia,9097,4382,4715
33,Asturias,42,Noreña,4543,2197,2346
33,Asturias,43,Onís,847,432,415
33,Asturias,44,Oviedo,207699,96754,110945
33,Asturias,45,Parres,5656,2760,2896
33,Asturias,46,Peñamellera Alta,689,339,350
33,Asturias,47,Peñamellera Baja,1510,743,767
33,Asturias,48,Pesoz,228,108,120
33,Asturias,49,Piloña,8573,4164,4409
33,Asturias,50,Ponga,715,424,291
33,Asturias,51,Pravia,9208,4429,4779
33,Asturias,52,Proaza,849,447,402
33,Asturias,53,Quirós,1497,786,711
33,Asturias,54,Regueras (Las),2093,1026,1067
33,Asturias,55,Ribadedeva,1853,916,937
33,Asturias,56,Ribadesella,6171,2926,3245
33,Asturias,57,Ribera de Arriba,1968,966,1002
33,Asturias,58,Riosa,2491,1283,1208
33,Asturias,59,Salas,6544,3194,3350
33,Asturias,61,San Martín de Oscos,482,245,237
33,Asturias,60,San Martín del Rey Aurelio,19973,9624,10349
33,Asturias,63,San Tirso de Abres,615,298,317
33,Asturias,62,Santa Eulalia de Oscos,563,279,284
33,Asturias,64,Santo Adriano,294,143,151
33,Asturias,65,Sariego,1361,660,701
33,Asturias,66,Siero,48830,23671,25159
33,Asturias,67,Sobrescobio,852,457,395
33,Asturias,68,Somiedo,1541,829,712
33,Asturias,69,Soto del Barco,4121,1998,2123
33,Asturias,70,Tapia de Casariego,4333,2090,2243
33,Asturias,71,Taramundi,851,409,442
33,Asturias,72,Teverga,2065,1075,990
33,Asturias,73,Tineo,12422,6318,6104
33,Asturias,34,Valdés,14643,7168,7475
33,Asturias,74,Vegadeo,4501,2146,2355
33,Asturias,75,Villanueva de Oscos,422,217,205
33,Asturias,76,Villaviciosa,14232,6991,7241
33,Asturias,77,Villayón,1844,927,917
33,Asturias,78,Yernes y Tameza,208,102,106
34,Palencia,1,Abarca de Campos,48,27,21
34,Palencia,3,Abia de las Torres,192,98,94
34,Palencia,4,Aguilar de Campoo,7426,3624,3802
34,Palencia,5,Alar del Rey,1201,576,625
34,Palencia,6,Alba de Cerrato,100,52,48
34,Palencia,9,Amayuelas de Arriba,38,24,14
34,Palencia,10,Ampudia,677,355,322
34,Palencia,11,Amusco,522,283,239
34,Palencia,12,Antigüedad,408,219,189
34,Palencia,15,Arconada,54,30,24
34,Palencia,17,Astudillo,1227,642,585
34,Palencia,18,Autilla del Pino,247,129,118
34,Palencia,19,Autillo de Campos,183,85,98
34,Palencia,20,Ayuela,75,47,28
34,Palencia,22,Baltanás,1484,770,714
34,Palencia,24,Baquerín de Campos,26,14,12
34,Palencia,25,Bárcena de Campos,58,26,32
34,Palencia,27,Barruelo de Santullán,1608,761,847
34,Palencia,28,Báscones de Ojeda,193,101,92
34,Palencia,29,Becerril de Campos,1032,512,520
34,Palencia,31,Belmonte de Campos,35,15,20
34,Palencia,32,Berzosilla,64,29,35
34,Palencia,33,Boada de Campos,22,13,9
34,Palencia,35,Boadilla de Rioseco,163,83,80
34,Palencia,34,Boadilla del Camino,174,94,80
34,Palencia,36,Brañosera,309,165,144
34,Palencia,37,Buenavista de Valdavia,392,196,196
34,Palencia,38,Bustillo de la Vega,367,197,170
34,Palencia,39,Bustillo del Páramo de Carrión,85,47,38
34,Palencia,41,Calahorra de Boedo,128,68,60
34,Palencia,42,Calzada de los Molinos,382,213,169
34,Palencia,45,Capillas,104,52,52
34,Palencia,46,Cardeñosa de Volpejera,51,28,23
34,Palencia,47,Carrión de los Condes,2299,1093,1206
34,Palencia,48,Castil de Vela,99,48,51
34,Palencia,49,Castrejón de la Peña,595,315,280
34,Palencia,50,Castrillo de Don Juan,311,168,143
34,Palencia,51,Castrillo de Onielo,154,75,79
34,Palencia,52,Castrillo de Villavega,267,133,134
34,Palencia,53,Castromocho,256,139,117
34,Palencia,55,Cervatos de la Cueza,345,182,163
34,Palencia,56,Cervera de Pisuerga,2658,1326,1332
34,Palencia,57,Cevico de la Torre,619,303,316
34,Palencia,58,Cevico Navero,256,137,119
34,Palencia,59,Cisneros,558,282,276
34,Palencia,60,Cobos de Cerrato,228,113,115
34,Palencia,61,Collazos de Boedo,147,81,66
34,Palencia,62,Congosto de Valdavia,248,145,103
34,Palencia,63,Cordovilla la Real,119,66,53
34,Palencia,66,Cubillas de Cerrato,78,44,34
34,Palencia,67,Dehesa de Montejo,204,112,92
34,Palencia,68,Dehesa de Romanos,55,36,19
34,Palencia,69,Dueñas,2980,1538,1442
34,Palencia,70,Espinosa de Cerrato,249,131,118
34,Palencia,71,Espinosa de Villagonzalo,230,116,114
34,Palencia,72,Frechilla,247,123,124
34,Palencia,73,Fresno del Río,192,96,96
34,Palencia,74,Frómista,934,470,464
34,Palencia,76,Fuentes de Nava,780,401,379
34,Palencia,77,Fuentes de Valdepero,232,127,105
34,Palencia,79,Grijota,976,489,487
34,Palencia,80,Guardo,8187,4108,4079
34,Palencia,81,Guaza de Campos,65,33,32
34,Palencia,82,Hérmedes de Cerrato,120,59,61
34,Palencia,83,Herrera de Pisuerga,2471,1215,1256
34,Palencia,84,Herrera de Valdecañas,184,91,93
34,Palencia,86,Hontoria de Cerrato,110,58,52
34,Palencia,87,Hornillos de Cerrato,116,60,56
34,Palencia,88,Husillos,219,124,95
34,Palencia,89,Itero de la Vega,216,110,106
34,Palencia,91,Lagartos,162,86,76
34,Palencia,92,Lantadilla,475,233,242
34,Palencia,94,Ledigos,101,53,48
34,Palencia,903,Loma de Ucieza,300,163,137
34,Palencia,96,Lomas,59,26,33
34,Palencia,98,Magaz de Pisuerga,711,369,342
34,Palencia,99,Manquillos,64,34,30
34,Palencia,100,Mantinos,170,89,81
34,Palencia,101,Marcilla de Campos,64,27,37
34,Palencia,102,Mazariegos,264,143,121
34,Palencia,103,Mazuecos de Valdeginate,122,63,59
34,Palencia,104,Melgar de Yuso,357,200,157
34,Palencia,106,Meneses de Campos,142,72,70
34,Palencia,107,Micieces de Ojeda,107,61,46
34,Palencia,108,Monzón de Campos,706,369,337
34,Palencia,109,Moratinos,75,39,36
34,Palencia,110,Mudá,109,55,54
34,Palencia,112,Nogal de las Huertas,67,40,27
34,Palencia,113,Olea de Boedo,42,17,25
34,Palencia,114,Olmos de Ojeda,307,174,133
34,Palencia,116,Osornillo,97,50,47
34,Palencia,901,Osorno la Mayor,1605,848,757
34,Palencia,120,Palencia,81378,38665,42713
34,Palencia,121,Palenzuela,293,157,136
34,Palencia,122,Páramo de Boedo,103,53,50
34,Palencia,123,Paredes de Nava,2311,1148,1163
34,Palencia,124,Payo de Ojeda,88,52,36
34,Palencia,125,Pedraza de Campos,112,58,54
34,Palencia,126,Pedrosa de la Vega,372,197,175
34,Palencia,127,Perales,113,57,56
34,Palencia,904,Pernía (La),453,251,202
34,Palencia,129,Pino del Río,264,154,110
34,Palencia,130,Piña de Campos,275,142,133
34,Palencia,131,Población de Arroyo,89,49,40
34,Palencia,132,Población de Campos,187,101,86
34,Palencia,133,Población de Cerrato,126,68,58
34,Palencia,134,Polentinos,83,43,40
34,Palencia,135,Pomar de Valdivia,545,281,264
34,Palencia,136,Poza de la Vega,266,145,121
34,Palencia,137,Pozo de Urama,43,23,20
34,Palencia,139,Prádanos de Ojeda,238,126,112
34,Palencia,140,Puebla de Valdavia (La),149,74,75
34,Palencia,141,Quintana del Puente,251,130,121
34,Palencia,143,Quintanilla de Onsoña,219,120,99
34,Palencia,146,Reinoso de Cerrato,77,45,32
34,Palencia,147,Renedo de la Vega,256,146,110
34,Palencia,149,Requena de Campos,44,19,25
34,Palencia,151,Respenda de la Peña,239,132,107
34,Palencia,152,Revenga de Campos,179,93,86
34,Palencia,154,Revilla de Collazos,81,45,36
34,Palencia,155,Ribas de Campos,196,106,90
34,Palencia,156,Riberos de la Cueza,86,51,35
34,Palencia,157,Saldaña,3196,1608,1588
34,Palencia,158,Salinas de Pisuerga,325,165,160
34,Palencia,159,San Cebrián de Campos,491,281,210
34,Palencia,160,San Cebrián de Mudá,184,85,99
34,Palencia,161,San Cristóbal de Boedo,39,23,16
34,Palencia,163,San Mamés de Campos,91,40,51
34,Palencia,165,San Román de la Cuba,108,53,55
34,Palencia,167,Santa Cecilia del Alcor,155,88,67
34,Palencia,168,Santa Cruz de Boedo,56,32,24
34,Palencia,169,Santervás de la Vega,526,290,236
34,Palencia,170,Santibáñez de Ecla,94,42,52
34,Palencia,171,Santibáñez de la Peña,1424,702,722
34,Palencia,174,Santoyo,276,131,145
34,Palencia,175,Serna (La),121,72,49
34,Palencia,177,Soto de Cerrato,219,115,104
34,Palencia,176,Sotobañado y Priorato,184,98,86
34,Palencia,178,Tabanera de Cerrato,158,83,75
34,Palencia,179,Tabanera de Valdavia,48,22,26
34,Palencia,180,Támara de Campos,96,47,49
34,Palencia,181,Tariego de Cerrato,554,288,266
34,Palencia,182,Torquemada,1119,578,541
34,Palencia,184,Torremormojón,77,41,36
34,Palencia,185,Triollo,92,49,43
34,Palencia,186,Valbuena de Pisuerga,70,38,32
34,Palencia,189,Valdeolmillos,82,43,39
34,Palencia,190,Valderrábano,72,43,29
34,Palencia,192,Valde-Ucieza,120,68,52
34,Palencia,196,Valle de Cerrato,116,66,50
34,Palencia,902,Valle del Retortillo,198,98,100
34,Palencia,199,Velilla del Río Carrión,1684,856,828
34,Palencia,23,Venta de Baños,6027,2940,3087
34,Palencia,201,Vertavillo,218,120,98
34,Palencia,93,Vid de Ojeda (La),136,82,54
34,Palencia,202,Villabasta de Valdavia,40,18,22
34,Palencia,204,Villacidaler,70,30,40
34,Palencia,205,Villaconancio,87,50,37
34,Palencia,206,Villada,1244,622,622
34,Palencia,208,Villaeles de Valdavia,77,41,36
34,Palencia,210,Villahán,133,71,62
34,Palencia,211,Villaherreros,249,118,131
34,Palencia,213,Villalaco,73,30,43
34,Palencia,214,Villalba de Guardo,222,124,98
34,Palencia,215,Villalcázar de Sirga,224,106,118
34,Palencia,216,Villalcón,78,39,39
34,Palencia,217,Villalobón,479,244,235
34,Palencia,218,Villaluenga de la Vega,658,362,296
34,Palencia,220,Villamartín de Campos,139,73,66
34,Palencia,221,Villamediana,228,120,108
34,Palencia,222,Villameriel,145,83,62
34,Palencia,223,Villamoronta,313,179,134
34,Palencia,224,Villamuera de la Cueza,58,32,26
34,Palencia,225,Villamuriel de Cerrato,5158,2655,2503
34,Palencia,227,Villanueva del Rebollar,109,57,52
34,Palencia,228,Villanuño de Valdavia,124,71,53
34,Palencia,229,Villaprovedo,86,55,31
34,Palencia,230,Villarmentero de Campos,16,11,5
34,Palencia,231,Villarrabé,264,131,133
34,Palencia,232,Villarramiel,1037,531,506
34,Palencia,233,Villasarracino,232,126,106
34,Palencia,234,Villasila de Valdavia,92,54,38
34,Palencia,236,Villaturde,230,115,115
34,Palencia,237,Villaumbrales,836,439,397
34,Palencia,238,Villaviudas,444,214,230
34,Palencia,240,Villerías de Campos,118,66,52
34,Palencia,241,Villodre,39,26,13
34,Palencia,242,Villodrigo,104,54,50
34,Palencia,243,Villoldo,458,243,215
34,Palencia,245,Villota del Páramo,414,241,173
34,Palencia,246,Villovieco,112,57,55
35,Palmas (Las),1,Agaete,5635,2879,2756
35,Palmas (Las),2,Agüimes,23572,12178,11394
35,Palmas (Las),3,Antigua,6587,3740,2847
35,Palmas (Las),4,Arrecife,50785,25923,24862
35,Palmas (Las),5,Artenara,1357,702,655
35,Palmas (Las),6,Arucas,33449,16803,16646
35,Palmas (Las),7,Betancuria,721,361,360
35,Palmas (Las),8,Firgas,7023,3580,3443
35,Palmas (Las),9,Gáldar,22763,11425,11338
35,Palmas (Las),10,Haría,4741,2441,2300
35,Palmas (Las),11,Ingenio,26433,13444,12989
35,Palmas (Las),12,Mogán,15932,8498,7434
35,Palmas (Las),13,Moya,8307,4194,4113
35,Palmas (Las),14,Oliva (La),14042,7548,6494
35,Palmas (Las),15,Pájara,16279,9319,6960
35,Palmas (Las),16,Palmas de Gran Canaria (Las),377600,185188,192412
35,Palmas (Las),17,Puerto del Rosario,26093,13646,12447
35,Palmas (Las),18,San Bartolomé,16481,8533,7948
35,Palmas (Las),19,San Bartolomé de Tirajana,45559,23724,21835
35,Palmas (Las),20,San Nicolás de Tolentino,8089,4091,3998
35,Palmas (Las),21,Santa Brígida,18817,9412,9405
35,Palmas (Las),22,Santa Lucía de Tirajana,52684,27010,25674
35,Palmas (Las),23,Santa María de Guía de Gran Canaria,14255,7114,7141
35,Palmas (Las),24,Teguise,14214,7339,6875
35,Palmas (Las),25,Tejeda,2351,1229,1122
35,Palmas (Las),26,Telde,93942,47190,46752
35,Palmas (Las),27,Teror,12104,6126,5978
35,Palmas (Las),28,Tías,15636,8136,7500
35,Palmas (Las),29,Tinajo,5066,2667,2399
35,Palmas (Las),30,Tuineje,11261,5998,5263
35,Palmas (Las),31,Valsequillo de Gran Canaria,8381,4277,4104
35,Palmas (Las),32,Valleseco,4045,2121,1924
35,Palmas (Las),33,Vega de San Mateo,7610,3981,3629
35,Palmas (Las),34,Yaiza,7792,4426,3366
36,Pontevedra,20,Agolada,3875,1902,1973
36,Pontevedra,1,Arbo,4121,2023,2098
36,Pontevedra,3,Baiona,11153,5501,5652
36,Pontevedra,2,Barro,3418,1632,1786
36,Pontevedra,4,Bueu,12342,6070,6272
36,Pontevedra,5,Caldas de Reis,9532,4583,4949
36,Pontevedra,6,Cambados,13524,6557,6967
36,Pontevedra,7,Campo Lameiro,2213,1065,1148
36,Pontevedra,8,Cangas,24458,12131,12327
36,Pontevedra,9,Cañiza (A),6719,3216,3503
36,Pontevedra,10,Catoira,3501,1713,1788
36,Pontevedra,11,Cerdedo,2313,1040,1273
36,Pontevedra,12,Cotobade,4610,2116,2494
36,Pontevedra,13,Covelo,3751,1759,1992
36,Pontevedra,14,Crecente,2779,1288,1491
36,Pontevedra,15,Cuntis,5491,2556,2935
36,Pontevedra,16,Dozón,2059,995,1064
36,Pontevedra,17,Estrada (A),22362,10538,11824
36,Pontevedra,18,Forcarei,4704,2215,2489
36,Pontevedra,19,Fornelos de Montes,2137,987,1150
36,Pontevedra,21,Gondomar,11987,5896,6091
36,Pontevedra,22,Grove (O),11135,5501,5634
36,Pontevedra,23,Guarda (A),10131,4941,5190
36,Pontevedra,901,Illa de Arousa (A),4877,2425,2452
36,Pontevedra,24,Lalín,20648,9979,10669
36,Pontevedra,25,Lama (A),2957,1341,1616
36,Pontevedra,26,Marín,24825,12335,12490
36,Pontevedra,27,Meaño,5469,2615,2854
36,Pontevedra,28,Meis,5040,2381,2659
36,Pontevedra,29,Moaña,18165,8830,9335
36,Pontevedra,30,Mondariz,5373,2522,2851
36,Pontevedra,31,Mondariz-Balneario,693,335,358
36,Pontevedra,32,Moraña,4287,2029,2258
36,Pontevedra,33,Mos,14114,6916,7198
36,Pontevedra,34,Neves (As),4586,2228,2358
36,Pontevedra,35,Nigrán,16806,8227,8579
36,Pontevedra,36,Oia,2903,1458,1445
36,Pontevedra,37,Pazos de Borbén,3034,1413,1621
36,Pontevedra,41,Poio,14588,7126,7462
36,Pontevedra,43,Ponte Caldelas,6390,3055,3335
36,Pontevedra,42,Ponteareas,20432,9877,10555
36,Pontevedra,44,Pontecesures,3062,1514,1548
36,Pontevedra,38,Pontevedra,77993,37060,40933
36,Pontevedra,39,Porriño (O),16511,7978,8533
36,Pontevedra,40,Portas,3167,1477,1690
36,Pontevedra,45,Redondela,29415,14298,15117
36,Pontevedra,46,Ribadumia,4151,2018,2133
36,Pontevedra,47,Rodeiro,3734,1902,1832
36,Pontevedra,48,Rosal (O),5942,2891,3051
36,Pontevedra,49,Salceda de Caselas,6710,3345,3365
36,Pontevedra,50,Salvaterra de Miño,8117,3944,4173
36,Pontevedra,51,Sanxenxo,16312,8013,8299
36,Pontevedra,52,Silleda,9092,4358,4734
36,Pontevedra,53,Soutomaior,5603,2722,2881
36,Pontevedra,54,Tomiño,11487,5654,5833
36,Pontevedra,55,Tui,16326,7803,8523
36,Pontevedra,56,Valga,6174,3031,3143
36,Pontevedra,57,Vigo,292566,139556,153010
36,Pontevedra,59,Vila de Cruces,6953,3419,3534
36,Pontevedra,58,Vilaboa,5839,2892,2947
36,Pontevedra,60,Vilagarcía de Arousa,34469,16611,17858
36,Pontevedra,61,Vilanova de Arousa,10430,5036,5394
37,Salamanca,1,Abusejo,250,126,124
37,Salamanca,2,Agallas,189,99,90
37,Salamanca,3,Ahigal de los Aceiteros,177,89,88
37,Salamanca,4,Ahigal de Villarino,41,20,21
37,Salamanca,5,Alameda de Gardón (La),145,66,79
37,Salamanca,6,Alamedilla (La),209,107,102
37,Salamanca,7,Alaraz,621,317,304
37,Salamanca,8,Alba de Tormes,4785,2367,2418
37,Salamanca,9,Alba de Yeltes,249,126,123
37,Salamanca,10,Alberca (La),1105,573,532
37,Salamanca,11,Alberguería de Argañán (La),181,94,87
37,Salamanca,12,Alconada,211,111,100
37,Salamanca,15,Aldea del Obispo,377,199,178
37,Salamanca,13,Aldeacipreste,199,108,91
37,Salamanca,14,Aldeadávila de la Ribera,1556,782,774
37,Salamanca,16,Aldealengua,565,293,272
37,Salamanca,17,Aldeanueva de Figueroa,324,164,160
37,Salamanca,18,Aldeanueva de la Sierra,119,64,55
37,Salamanca,19,Aldearrodrigo,194,104,90
37,Salamanca,20,Aldearrubia,512,277,235
37,Salamanca,21,Aldeaseca de Alba,118,54,64
37,Salamanca,22,Aldeaseca de la Frontera,333,166,167
37,Salamanca,23,Aldeatejada,716,359,357
37,Salamanca,24,Aldeavieja de Tormes,131,66,65
37,Salamanca,25,Aldehuela de la Bóveda,344,170,174
37,Salamanca,26,Aldehuela de Yeltes,273,140,133
37,Salamanca,27,Almenara de Tormes,255,129,126
37,Salamanca,28,Almendra,200,101,99
37,Salamanca,29,Anaya de Alba,291,156,135
37,Salamanca,30,Añover de Tormes,102,58,44
37,Salamanca,31,Arabayona de Mógica,486,263,223
37,Salamanca,32,Arapiles,466,234,232
37,Salamanca,33,Arcediano,108,58,50
37,Salamanca,34,Arco (El),96,52,44
37,Salamanca,35,Armenteros,314,153,161
37,Salamanca,37,Atalaya (La),145,79,66
37,Salamanca,38,Babilafuente,1007,540,467
37,Salamanca,39,Bañobárez,382,199,183
37,Salamanca,40,Barbadillo,517,252,265
37,Salamanca,41,Barbalos,103,56,47
37,Salamanca,42,Barceo,58,29,29
37,Salamanca,44,Barruecopardo,551,281,270
37,Salamanca,45,Bastida (La),37,21,16
37,Salamanca,46,Béjar,15228,7179,8049
37,Salamanca,47,Beleña,153,79,74
37,Salamanca,49,Bermellar,203,104,99
37,Salamanca,50,Berrocal de Huebra,113,56,57
37,Salamanca,51,Berrocal de Salvatierra,125,62,63
37,Salamanca,52,Boada,384,194,190
37,Salamanca,54,Bodón (El),322,165,157
37,Salamanca,55,Bogajo,198,104,94
37,Salamanca,56,Bouza (La),72,37,35
37,Salamanca,57,Bóveda del Río Almar,299,160,139
37,Salamanca,58,Brincones,99,49,50
37,Salamanca,59,Buenamadre,170,94,76
37,Salamanca,60,Buenavista,142,74,68
37,Salamanca,61,Cabaco (El),289,146,143
37,Salamanca,63,Cabeza de Béjar (La),93,48,45
37,Salamanca,65,Cabeza del Caballo,467,243,224
37,Salamanca,62,Cabezabellosa de la Calzada,122,66,56
37,Salamanca,67,Cabrerizos,2598,1312,1286
37,Salamanca,68,Cabrillas,511,252,259
37,Salamanca,69,Calvarrasa de Abajo,1016,499,517
37,Salamanca,70,Calvarrasa de Arriba,680,353,327
37,Salamanca,71,Calzada de Béjar (La),91,49,42
37,Salamanca,72,Calzada de Don Diego,225,116,109
37,Salamanca,73,Calzada de Valdunciel,653,331,322
37,Salamanca,74,Campillo de Azaba,253,122,131
37,Salamanca,77,Campo de Peñaranda (El),360,189,171
37,Salamanca,78,Candelario,1014,498,516
37,Salamanca,79,Canillas de Abajo,103,61,42
37,Salamanca,80,Cantagallo,268,128,140
37,Salamanca,81,Cantalapiedra,1250,624,626
37,Salamanca,82,Cantalpino,1107,600,507
37,Salamanca,83,Cantaracillo,254,137,117
37,Salamanca,85,Carbajosa de la Sagrada,2716,1366,1350
37,Salamanca,86,Carpio de Azaba,101,56,45
37,Salamanca,87,Carrascal de Barregas,540,278,262
37,Salamanca,88,Carrascal del Obispo,244,121,123
37,Salamanca,89,Casafranca,90,42,48
37,Salamanca,90,Casas del Conde (Las),74,37,37
37,Salamanca,91,Casillas de Flores,251,119,132
37,Salamanca,92,Castellanos de Moriscos,406,192,214
37,Salamanca,185,Castellanos de Villiquera,580,303,277
37,Salamanca,96,Castillejo de Martín Viejo,309,162,147
37,Salamanca,97,Castraz,61,34,27
37,Salamanca,98,Cepeda,485,233,252
37,Salamanca,99,Cereceda de la Sierra,89,41,48
37,Salamanca,100,Cerezal de Peñahorcada,123,69,54
37,Salamanca,101,Cerralbo,242,124,118
37,Salamanca,102,Cerro (El),529,285,244
37,Salamanca,103,Cespedosa de Tormes,601,321,280
37,Salamanca,104,Cilleros de la Bastida,39,20,19
37,Salamanca,106,Cipérez,410,199,211
37,Salamanca,107,Ciudad Rodrigo,14250,6858,7392
37,Salamanca,108,Coca de Alba,144,66,78
37,Salamanca,109,Colmenar de Montemayor,258,145,113
37,Salamanca,110,Cordovilla,137,78,59
37,Salamanca,112,Cristóbal,235,120,115
37,Salamanca,113,Cubo de Don Sancho (El),563,297,266
37,Salamanca,114,Chagarcía Medianero,130,70,60
37,Salamanca,115,Dios le Guarde,175,93,82
37,Salamanca,116,Doñinos de Ledesma,108,55,53
37,Salamanca,117,Doñinos de Salamanca,778,406,372
37,Salamanca,118,Ejeme,182,95,87
37,Salamanca,119,Encina (La),172,93,79
37,Salamanca,120,Encina de San Silvestre,128,62,66
37,Salamanca,121,Encinas de Abajo,643,335,308
37,Salamanca,122,Encinas de Arriba,276,133,143
37,Salamanca,123,Encinasola de los Comendadores,280,140,140
37,Salamanca,124,Endrinal,291,166,125
37,Salamanca,125,Escurial de la Sierra,286,154,132
37,Salamanca,126,Espadaña,49,28,21
37,Salamanca,127,Espeja,281,147,134
37,Salamanca,128,Espino de la Orbada,326,164,162
37,Salamanca,129,Florida de Liébana,259,142,117
37,Salamanca,130,Forfoleda,240,123,117
37,Salamanca,131,Frades de la Sierra,258,136,122
37,Salamanca,132,Fregeneda (La),496,243,253
37,Salamanca,133,Fresnedoso,119,60,59
37,Salamanca,134,Fresno Alhándiga,291,151,140
37,Salamanca,135,Fuente de San Esteban (La),1496,754,742
37,Salamanca,136,Fuenteguinaldo,890,460,430
37,Salamanca,137,Fuenteliante,126,59,67
37,Salamanca,138,Fuenterroble de Salvatierra,264,132,132
37,Salamanca,139,Fuentes de Béjar,279,124,155
37,Salamanca,140,Fuentes de Oñoro,1436,706,730
37,Salamanca,141,Gajates,208,101,107
37,Salamanca,142,Galindo y Perahuy,447,248,199
37,Salamanca,143,Galinduste,553,273,280
37,Salamanca,144,Galisancho,532,298,234
37,Salamanca,145,Gallegos de Argañán,382,197,185
37,Salamanca,146,Gallegos de Solmirón,167,77,90
37,Salamanca,147,Garcibuey,258,147,111
37,Salamanca,148,Garcihernández,619,318,301
37,Salamanca,149,Garcirrey,108,56,52
37,Salamanca,150,Gejuelo del Barro,50,28,22
37,Salamanca,151,Golpejas,193,97,96
37,Salamanca,152,Gomecello,512,266,246
37,Salamanca,154,Guadramiro,205,117,88
37,Salamanca,155,Guijo de Ávila,104,61,43
37,Salamanca,156,Guijuelo,5189,2619,2570
37,Salamanca,157,Herguijuela de Ciudad Rodrigo,130,74,56
37,Salamanca,158,Herguijuela de la Sierra,303,154,149
37,Salamanca,159,Herguijuela del Campo,119,50,69
37,Salamanca,160,Hinojosa de Duero,796,399,397
37,Salamanca,161,Horcajo de Montemayor,193,98,95
37,Salamanca,162,Horcajo Medianero,329,167,162
37,Salamanca,163,Hoya (La),29,21,8
37,Salamanca,164,Huerta,285,156,129
37,Salamanca,165,Iruelos,54,20,34
37,Salamanca,166,Ituero de Azaba,274,152,122
37,Salamanca,167,Juzbado,184,94,90
37,Salamanca,168,Lagunilla,608,320,288
37,Salamanca,169,Larrodrigo,269,139,130
37,Salamanca,170,Ledesma,1882,944,938
37,Salamanca,171,Ledrada,587,292,295
37,Salamanca,172,Linares de Riofrío,1018,518,500
37,Salamanca,173,Lumbrales,2083,1018,1065
37,Salamanca,174,Macotera,1589,814,775
37,Salamanca,175,Machacón,506,256,250
37,Salamanca,176,Madroñal,172,93,79
37,Salamanca,177,Maíllo (El),403,212,191
37,Salamanca,178,Malpartida,137,74,63
37,Salamanca,179,Mancera de Abajo,332,172,160
37,Salamanca,180,Manzano (El),103,54,49
37,Salamanca,181,Martiago,375,189,186
37,Salamanca,183,Martín de Yeltes,519,266,253
37,Salamanca,182,Martinamor,69,35,34
37,Salamanca,184,Masueco,442,229,213
37,Salamanca,186,Mata de Ledesma (La),144,75,69
37,Salamanca,187,Matilla de los Caños del Río,705,358,347
37,Salamanca,188,Maya (La),262,144,118
37,Salamanca,189,Membribe de la Sierra,117,66,51
37,Salamanca,190,Mieza,344,171,173
37,Salamanca,191,Milano (El),170,95,75
37,Salamanca,192,Miranda de Azán,368,178,190
37,Salamanca,193,Miranda del Castañar,603,320,283
37,Salamanca,194,Mogarraz,318,155,163
37,Salamanca,195,Molinillo,75,37,38
37,Salamanca,196,Monforte de la Sierra,110,63,47
37,Salamanca,197,Monleón,121,67,54
37,Salamanca,198,Monleras,279,136,143
37,Salamanca,199,Monsagro,204,113,91
37,Salamanca,200,Montejo,241,128,113
37,Salamanca,201,Montemayor del Río,349,183,166
37,Salamanca,202,Monterrubio de Armuña,637,337,300
37,Salamanca,203,Monterrubio de la Sierra,157,86,71
37,Salamanca,204,Morasverdes,407,205,202
37,Salamanca,205,Morille,183,99,84
37,Salamanca,206,Moríñigo,128,68,60
37,Salamanca,207,Moriscos,126,60,66
37,Salamanca,208,Moronta,125,69,56
37,Salamanca,209,Mozárbez,409,221,188
37,Salamanca,211,Narros de Matalayegua,279,148,131
37,Salamanca,213,Nava de Béjar,116,60,56
37,Salamanca,214,Nava de Francia,157,80,77
37,Salamanca,215,Nava de Sotrobal,207,112,95
37,Salamanca,212,Navacarros,129,73,56
37,Salamanca,216,Navales,370,213,157
37,Salamanca,217,Navalmoral de Béjar,60,27,33
37,Salamanca,218,Navamorales,142,76,66
37,Salamanca,219,Navarredonda de la Rinconada,267,130,137
37,Salamanca,221,Navasfrías,668,342,326
37,Salamanca,222,Negrilla de Palencia,120,63,57
37,Salamanca,223,Olmedo de Camaces,151,74,77
37,Salamanca,224,Orbada (La),292,154,138
37,Salamanca,225,Pajares de la Laguna,149,75,74
37,Salamanca,226,Palacios del Arzobispo,209,110,99
37,Salamanca,228,Palaciosrubios,511,274,237
37,Salamanca,229,Palencia de Negrilla,174,92,82
37,Salamanca,230,Parada de Arriba,254,135,119
37,Salamanca,231,Parada de Rubiales,340,180,160
37,Salamanca,232,Paradinas de San Juan,602,327,275
37,Salamanca,233,Pastores,50,26,24
37,Salamanca,234,Payo (El),480,229,251
37,Salamanca,235,Pedraza de Alba,292,150,142
37,Salamanca,236,Pedrosillo de Alba,235,118,117
37,Salamanca,237,Pedrosillo de los Aires,425,235,190
37,Salamanca,238,Pedrosillo el Ralo,134,66,68
37,Salamanca,239,Pedroso de la Armuña (El),290,138,152
37,Salamanca,240,Pelabravo,826,431,395
37,Salamanca,241,Pelarrodríguez,193,112,81
37,Salamanca,242,Pelayos,79,41,38
37,Salamanca,243,Peña (La),143,65,78
37,Salamanca,244,Peñacaballera,198,99,99
37,Salamanca,245,Peñaparda,443,232,211
37,Salamanca,246,Peñaranda de Bracamonte,6320,3092,3228
37,Salamanca,247,Peñarandilla,257,129,128
37,Salamanca,248,Peralejos de Abajo,183,92,91
37,Salamanca,249,Peralejos de Arriba,65,37,28
37,Salamanca,250,Pereña de la Ribera,543,277,266
37,Salamanca,251,Peromingo,152,71,81
37,Salamanca,252,Pinedas,167,84,83
37,Salamanca,253,Pino de Tormes (El),178,92,86
37,Salamanca,254,Pitiegua,248,131,117
37,Salamanca,255,Pizarral,84,43,41
37,Salamanca,256,Poveda de las Cintas,325,179,146
37,Salamanca,257,Pozos de Hinojo,69,33,36
37,Salamanca,258,Puebla de Azaba,257,139,118
37,Salamanca,259,Puebla de San Medel,61,33,28
37,Salamanca,260,Puebla de Yeltes,225,119,106
37,Salamanca,261,Puente del Congosto,299,147,152
37,Salamanca,262,Puertas,102,60,42
37,Salamanca,263,Puerto de Béjar,460,217,243
37,Salamanca,264,Puerto Seguro,98,53,45
37,Salamanca,265,Rágama,281,146,135
37,Salamanca,266,Redonda (La),106,53,53
37,Salamanca,267,Retortillo,264,126,138
37,Salamanca,268,Rinconada de la Sierra (La),175,97,78
37,Salamanca,269,Robleda,568,294,274
37,Salamanca,270,Robliza de Cojos,227,118,109
37,Salamanca,271,Rollán,572,289,283
37,Salamanca,272,Saelices el Chico,163,87,76
37,Salamanca,273,Sagrada (La),175,92,83
37,Salamanca,303,Sahugo (El),254,129,125
37,Salamanca,274,Salamanca,157906,73800,84106
37,Salamanca,275,Saldeana,159,87,72
37,Salamanca,276,Salmoral,235,124,111
37,Salamanca,277,Salvatierra de Tormes,67,34,33
37,Salamanca,278,San Cristóbal de la Cuesta,477,261,216
37,Salamanca,284,San Esteban de la Sierra,434,220,214
37,Salamanca,285,San Felices de los Gallegos,598,307,291
37,Salamanca,286,San Martín del Castañar,280,144,136
37,Salamanca,287,San Miguel de Valero,410,214,196
37,Salamanca,36,San Miguel del Robledo,95,43,52
37,Salamanca,288,San Morales,240,137,103
37,Salamanca,289,San Muñoz,333,172,161
37,Salamanca,291,San Pedro de Rozados,358,177,181
37,Salamanca,290,San Pedro del Valle,131,66,65
37,Salamanca,292,San Pelayo de Guareña,110,56,54
37,Salamanca,279,Sancti-Spíritus,1058,547,511
37,Salamanca,280,Sanchón de la Ribera,111,58,53
37,Salamanca,281,Sanchón de la Sagrada,53,31,22
37,Salamanca,282,Sanchotello,286,146,140
37,Salamanca,283,Sando,152,82,70
37,Salamanca,293,Santa María de Sando,158,79,79
37,Salamanca,294,Santa Marta de Tormes,12496,6224,6272
37,Salamanca,296,Santiago de la Puebla,492,250,242
37,Salamanca,297,Santibáñez de Béjar,631,323,308
37,Salamanca,298,Santibáñez de la Sierra,249,134,115
37,Salamanca,299,Santiz,284,141,143
37,Salamanca,300,Santos (Los),659,340,319
37,Salamanca,301,Sardón de los Frailes,93,47,46
37,Salamanca,302,Saucelle,385,196,189
37,Salamanca,304,Sepulcro-Hilario,259,133,126
37,Salamanca,305,Sequeros,259,117,142
37,Salamanca,306,Serradilla del Arroyo,402,211,191
37,Salamanca,307,Serradilla del Llano,227,113,114
37,Salamanca,309,Sierpe (La),49,29,20
37,Salamanca,310,Sieteiglesias de Tormes,171,85,86
37,Salamanca,311,Sobradillo,345,168,177
37,Salamanca,312,Sorihuela,358,178,180
37,Salamanca,313,Sotoserrano,707,370,337
37,Salamanca,314,Tabera de Abajo,106,56,50
37,Salamanca,315,Tala (La),130,71,59
37,Salamanca,316,Tamames,1003,512,491
37,Salamanca,317,Tarazona de Guareña,412,222,190
37,Salamanca,318,Tardáguila,234,123,111
37,Salamanca,319,Tejado (El),163,80,83
37,Salamanca,320,Tejeda y Segoyuela,119,60,59
37,Salamanca,321,Tenebrón,220,111,109
37,Salamanca,322,Terradillos,3165,1624,1541
37,Salamanca,323,Topas,711,369,342
37,Salamanca,324,Tordillos,538,279,259
37,Salamanca,325,Tornadizo (El),133,68,65
37,Salamanca,327,Torresmenudas,206,100,106
37,Salamanca,328,Trabanca,256,133,123
37,Salamanca,329,Tremedal de Tormes,38,19,19
37,Salamanca,330,Valdecarros,426,214,212
37,Salamanca,331,Valdefuentes de Sangusín,306,157,149
37,Salamanca,332,Valdehijaderos,105,58,47
37,Salamanca,333,Valdelacasa,325,178,147
37,Salamanca,334,Valdelageve,119,62,57
37,Salamanca,335,Valdelosa,509,241,268
37,Salamanca,336,Valdemierque,59,29,30
37,Salamanca,337,Valderrodrigo,180,87,93
37,Salamanca,338,Valdunciel,104,53,51
37,Salamanca,339,Valero,419,206,213
37,Salamanca,340,Valsalabroso,200,107,93
37,Salamanca,341,Valverde de Valdelacasa,68,36,32
37,Salamanca,342,Valverdón,288,145,143
37,Salamanca,343,Vallejera de Riofrío,65,34,31
37,Salamanca,344,Vecinos,315,152,163
37,Salamanca,345,Vega de Tirados,204,104,100
37,Salamanca,346,Veguillas (Las),310,155,155
37,Salamanca,347,Vellés (La),390,205,185
37,Salamanca,348,Ventosa del Río Almar,143,70,73
37,Salamanca,349,Vídola (La),160,78,82
37,Salamanca,350,Vilvestre,561,273,288
37,Salamanca,351,Villaflores,416,213,203
37,Salamanca,352,Villagonzalo de Tormes,226,114,112
37,Salamanca,353,Villalba de los Llanos,179,101,78
37,Salamanca,354,Villamayor,3874,2019,1855
37,Salamanca,355,Villanueva del Conde,251,130,121
37,Salamanca,356,Villar de Argañán,112,57,55
37,Salamanca,357,Villar de Ciervo,373,192,181
37,Salamanca,358,Villar de Gallimazo,204,98,106
37,Salamanca,359,Villar de la Yegua,274,131,143
37,Salamanca,360,Villar de Peralonso,330,156,174
37,Salamanca,361,Villar de Samaniego,119,63,56
37,Salamanca,362,Villares de la Reina,3467,1751,1716
37,Salamanca,363,Villares de Yeltes,166,80,86
37,Salamanca,364,Villarino de los Aires,1111,559,552
37,Salamanca,365,Villarmayor,219,114,105
37,Salamanca,366,Villarmuerto,53,32,21
37,Salamanca,367,Villasbuenas,286,150,136
37,Salamanca,368,Villasdardo,18,7,11
37,Salamanca,369,Villaseco de los Gamitos,212,112,100
37,Salamanca,370,Villaseco de los Reyes,432,233,199
37,Salamanca,371,Villasrubias,313,171,142
37,Salamanca,372,Villaverde de Guareña,195,96,99
37,Salamanca,373,Villavieja de Yeltes,1029,514,515
37,Salamanca,374,Villoria,1408,707,701
37,Salamanca,375,Villoruela,973,481,492
37,Salamanca,376,Vitigudino,3016,1498,1518
37,Salamanca,377,Yecla de Yeltes,339,171,168
37,Salamanca,378,Zamarra,145,77,68
37,Salamanca,379,Zamayón,202,113,89
37,Salamanca,380,Zarapicos,79,44,35
37,Salamanca,381,Zarza de Pumareda (La),172,94,78
37,Salamanca,382,Zorita de la Frontera,269,135,134
38,Santa Cruz de Tenerife,1,Adeje,27640,14524,13116
38,Santa Cruz de Tenerife,2,Agulo,1189,579,610
38,Santa Cruz de Tenerife,3,Alajeró,1726,915,811
38,Santa Cruz de Tenerife,4,Arafo,5122,2486,2636
38,Santa Cruz de Tenerife,5,Arico,6928,3590,3338
38,Santa Cruz de Tenerife,6,Arona,57445,29830,27615
38,Santa Cruz de Tenerife,7,Barlovento,2367,1212,1155
38,Santa Cruz de Tenerife,8,Breña Alta,6665,3286,3379
38,Santa Cruz de Tenerife,9,Breña Baja,4187,2136,2051
38,Santa Cruz de Tenerife,10,Buenavista del Norte,5453,2802,2651
38,Santa Cruz de Tenerife,11,Candelaria,17398,8704,8694
38,Santa Cruz de Tenerife,12,Fasnia,2641,1360,1281
38,Santa Cruz de Tenerife,13,Frontera,5435,2758,2677
38,Santa Cruz de Tenerife,14,Fuencaliente de la Palma,1857,966,891
38,Santa Cruz de Tenerife,15,Garachico,5756,2827,2929
38,Santa Cruz de Tenerife,16,Garafía,1998,1038,960
38,Santa Cruz de Tenerife,17,Granadilla de Abona,28927,14968,13959
38,Santa Cruz de Tenerife,18,Guancha (La),5318,2610,2708
38,Santa Cruz de Tenerife,19,Guía de Isora,17163,8618,8545
38,Santa Cruz de Tenerife,20,Güímar,16251,8062,8189
38,Santa Cruz de Tenerife,21,Hermigua,2167,1097,1070
38,Santa Cruz de Tenerife,22,Icod de los Vinos,22958,11386,11572
38,Santa Cruz de Tenerife,24,Llanos de Aridane (Los),20001,9896,10105
38,Santa Cruz de Tenerife,25,Matanza de Acentejo (La),7490,3795,3695
38,Santa Cruz de Tenerife,26,Orotava (La),39876,19762,20114
38,Santa Cruz de Tenerife,27,Paso (El),7544,3839,3705
38,Santa Cruz de Tenerife,28,Puerto de la Cruz,31830,15360,16470
38,Santa Cruz de Tenerife,29,Puntagorda,1789,891,898
38,Santa Cruz de Tenerife,30,Puntallana,2364,1169,1195
38,Santa Cruz de Tenerife,31,Realejos (Los),35799,17747,18052
38,Santa Cruz de Tenerife,32,Rosario (El),14862,7824,7038
38,Santa Cruz de Tenerife,33,San Andrés y Sauces,5102,2598,2504
38,Santa Cruz de Tenerife,23,San Cristóbal de La Laguna,134744,66313,68431
38,Santa Cruz de Tenerife,34,San Juan de la Rambla,5027,2508,2519
38,Santa Cruz de Tenerife,35,San Miguel de Abona,9988,5110,4878
38,Santa Cruz de Tenerife,36,San Sebastián de la Gomera,6902,3507,3395
38,Santa Cruz de Tenerife,37,Santa Cruz de la Palma,18201,8953,9248
38,Santa Cruz de Tenerife,38,Santa Cruz de Tenerife,220022,106075,113947
38,Santa Cruz de Tenerife,39,Santa Úrsula,11959,6011,5948
38,Santa Cruz de Tenerife,40,Santiago del Teide,10523,5316,5207
38,Santa Cruz de Tenerife,41,Sauzal (El),8267,4121,4146
38,Santa Cruz de Tenerife,42,Silos (Los),5545,2760,2785
38,Santa Cruz de Tenerife,43,Tacoronte,21778,10923,10855
38,Santa Cruz de Tenerife,44,Tanque (El),3198,1610,1588
38,Santa Cruz de Tenerife,45,Tazacorte,6107,3091,3016
38,Santa Cruz de Tenerife,46,Tegueste,9948,4941,5007
38,Santa Cruz de Tenerife,47,Tijarafe,2687,1362,1325
38,Santa Cruz de Tenerife,48,Valverde,4727,2402,2325
38,Santa Cruz de Tenerife,49,Valle Gran Rey,4487,2281,2206
38,Santa Cruz de Tenerife,50,Vallehermoso,3109,1572,1537
38,Santa Cruz de Tenerife,51,Victoria de Acentejo (La),8235,4099,4136
38,Santa Cruz de Tenerife,52,Vilaflor,1798,918,880
38,Santa Cruz de Tenerife,53,Villa de Mazo,4762,2408,2354
39,Cantabria,1,Alfoz de Lloredo,2583,1322,1261
39,Cantabria,2,Ampuero,3620,1851,1769
39,Cantabria,3,Anievas,388,195,193
39,Cantabria,4,Arenas de Iguña,1927,980,947
39,Cantabria,5,Argoños,1132,592,540
39,Cantabria,6,Arnuero,1906,964,942
39,Cantabria,7,Arredondo,561,314,247
39,Cantabria,8,Astillero (El),14641,7096,7545
39,Cantabria,9,Bárcena de Cicero,2546,1275,1271
39,Cantabria,10,Bárcena de Pie de Concha,825,408,417
39,Cantabria,11,Bareyo,1702,868,834
39,Cantabria,12,Cabezón de la Sal,7781,3842,3939
39,Cantabria,13,Cabezón de Liébana,708,393,315
39,Cantabria,14,Cabuérniga,1109,568,541
39,Cantabria,15,Camaleño,1096,582,514
39,Cantabria,16,Camargo,25676,12671,13005
39,Cantabria,27,Campoo de Enmedio,3996,2048,1948
39,Cantabria,17,Campoo de Yuso,740,378,362
39,Cantabria,18,Cartes,3735,1910,1825
39,Cantabria,19,Castañeda,1621,810,811
39,Cantabria,20,Castro-Urdiales,23734,11977,11757
39,Cantabria,21,Cieza,679,333,346
39,Cantabria,22,Cillorigo de Liébana,1144,617,527
39,Cantabria,23,Colindres,6945,3468,3477
39,Cantabria,24,Comillas,2311,1091,1220
39,Cantabria,25,Corrales de Buelna (Los),10872,5433,5439
39,Cantabria,26,Corvera de Toranzo,2183,1095,1088
39,Cantabria,28,Entrambasaguas,2491,1243,1248
39,Cantabria,29,Escalante,749,393,356
39,Cantabria,30,Guriezo,1827,940,887
39,Cantabria,31,Hazas de Cesto,1268,635,633
39,Cantabria,32,Hermandad de Campoo de Suso,1923,1050,873
39,Cantabria,33,Herrerías,731,415,316
39,Cantabria,34,Lamasón,360,212,148
39,Cantabria,35,Laredo,12847,6206,6641
39,Cantabria,36,Liendo,908,478,430
39,Cantabria,37,Liérganes,2260,1144,1116
39,Cantabria,38,Limpias,1428,725,703
39,Cantabria,39,Luena,857,449,408
39,Cantabria,40,Marina de Cudeyo,5120,2597,2523
39,Cantabria,41,Mazcuerras,1906,994,912
39,Cantabria,42,Medio Cudeyo,6481,3170,3311
39,Cantabria,43,Meruelo,1232,618,614
39,Cantabria,44,Miengo,3815,1920,1895
39,Cantabria,45,Miera,486,245,241
39,Cantabria,46,Molledo,1856,905,951
39,Cantabria,47,Noja,2182,1088,1094
39,Cantabria,48,Penagos,1710,857,853
39,Cantabria,49,Peñarrubia,356,180,176
39,Cantabria,50,Pesaguero,373,203,170
39,Cantabria,51,Pesquera,78,42,36
39,Cantabria,52,Piélagos,14224,7107,7117
39,Cantabria,53,Polaciones,267,172,95
39,Cantabria,54,Polanco,3769,1844,1925
39,Cantabria,55,Potes,1597,774,823
39,Cantabria,56,Puente Viesgo,2453,1240,1213
39,Cantabria,57,Ramales de la Victoria,2242,1145,1097
39,Cantabria,58,Rasines,943,497,446
39,Cantabria,59,Reinosa,10783,5142,5641
39,Cantabria,60,Reocín,7157,3550,3607
39,Cantabria,61,Ribamontán al Mar,3880,1980,1900
39,Cantabria,62,Ribamontán al Monte,1997,1032,965
39,Cantabria,63,Rionansa,1317,744,573
39,Cantabria,64,Riotuerto,1546,742,804
39,Cantabria,65,Rozas de Valdearroyo (Las),306,173,133
39,Cantabria,66,Ruente,977,524,453
39,Cantabria,67,Ruesga,1151,605,546
39,Cantabria,68,Ruiloba,758,391,367
39,Cantabria,69,San Felices de Buelna,2230,1096,1134
39,Cantabria,70,San Miguel de Aguayo,155,83,72
39,Cantabria,71,San Pedro del Romeral,596,314,282
39,Cantabria,72,San Roque de Riomiera,466,265,201
39,Cantabria,80,San Vicente de la Barquera,4453,2262,2191
39,Cantabria,73,Santa Cruz de Bezana,9562,4698,4864
39,Cantabria,74,Santa María de Cayón,6505,3255,3250
39,Cantabria,75,Santander,184778,86496,98282
39,Cantabria,76,Santillana del Mar,3956,1924,2032
39,Cantabria,77,Santiurde de Reinosa,344,183,161
39,Cantabria,78,Santiurde de Toranzo,1461,733,728
39,Cantabria,79,Santoña,11646,5828,5818
39,Cantabria,81,Saro,525,269,256
39,Cantabria,82,Selaya,1974,1006,968
39,Cantabria,83,Soba,1529,801,728
39,Cantabria,84,Solórzano,1028,539,489
39,Cantabria,85,Suances,6838,3381,3457
39,Cantabria,86,Tojos (Los),424,244,180
39,Cantabria,87,Torrelavega,56638,27249,29389
39,Cantabria,88,Tresviso,62,34,28
39,Cantabria,89,Tudanca,225,142,83
39,Cantabria,90,Udías,825,422,403
39,Cantabria,95,Val de San Vicente,2615,1338,1277
39,Cantabria,91,Valdáliga,2451,1276,1175
39,Cantabria,92,Valdeolea,1372,692,680
39,Cantabria,93,Valdeprado del Río,334,187,147
39,Cantabria,94,Valderredible,1160,622,538
39,Cantabria,96,Vega de Liébana,946,497,449
39,Cantabria,97,Vega de Pas,969,512,457
39,Cantabria,98,Villacarriedo,1736,913,823
39,Cantabria,99,Villaescusa,3347,1649,1698
39,Cantabria,100,Villafufre,1132,589,543
39,Cantabria,101,Villaverde de Trucíos,368,188,180
39,Cantabria,102,Voto,2268,1170,1098
40,Segovia,1,Abades,861,435,426
40,Segovia,2,Adrada de Pirón,53,29,24
40,Segovia,3,Adrados,193,98,95
40,Segovia,4,Aguilafuente,802,397,405
40,Segovia,5,Alconada de Maderuelo,46,28,18
40,Segovia,12,Aldea Real,380,205,175
40,Segovia,6,Aldealcorvo,22,10,12
40,Segovia,7,Aldealengua de Pedraza,84,45,39
40,Segovia,8,Aldealengua de Santa María,76,42,34
40,Segovia,9,Aldeanueva de la Serrezuela,34,21,13
40,Segovia,10,Aldeanueva del Codonal,199,106,93
40,Segovia,13,Aldeasoña,88,41,47
40,Segovia,14,Aldehorno,67,37,30
40,Segovia,15,Aldehuela del Codonal,48,26,22
40,Segovia,16,Aldeonte,95,50,45
40,Segovia,17,Anaya,135,70,65
40,Segovia,18,Añe,129,69,60
40,Segovia,19,Arahuetes,49,26,23
40,Segovia,20,Arcones,255,134,121
40,Segovia,21,Arevalillo de Cega,43,21,22
40,Segovia,22,Armuña,249,136,113
40,Segovia,24,Ayllón,1254,624,630
40,Segovia,25,Barbolla,199,108,91
40,Segovia,26,Basardilla,122,59,63
40,Segovia,28,Bercial,123,61,62
40,Segovia,29,Bercimuel,82,41,41
40,Segovia,30,Bernardos,683,361,322
40,Segovia,31,Bernuy de Porreros,375,197,178
40,Segovia,32,Boceguillas,616,308,308
40,Segovia,33,Brieva,79,47,32
40,Segovia,34,Caballar,98,49,49
40,Segovia,35,Cabañas de Polendos,119,63,56
40,Segovia,36,Cabezuela,714,380,334
40,Segovia,37,Calabazas de Fuentidueña,64,32,32
40,Segovia,39,Campo de San Pedro,359,209,150
40,Segovia,40,Cantalejo,3542,1805,1737
40,Segovia,41,Cantimpalos,1295,663,632
40,Segovia,43,Carbonero el Mayor,2440,1236,1204
40,Segovia,44,Carrascal del Río,200,102,98
40,Segovia,45,Casla,159,84,75
40,Segovia,46,Castillejo de Mesleón,137,73,64
40,Segovia,47,Castro de Fuentidueña,78,44,34
40,Segovia,48,Castrojimeno,37,22,15
40,Segovia,49,Castroserna de Abajo,53,27,26
40,Segovia,51,Castroserracín,47,28,19
40,Segovia,52,Cedillo de la Torre,110,55,55
40,Segovia,53,Cerezo de Abajo,168,83,85
40,Segovia,54,Cerezo de Arriba,180,97,83
40,Segovia,55,Cilleruelo de San Mamés,47,22,25
40,Segovia,56,Cobos de Fuentidueña,55,24,31
40,Segovia,57,Coca,1960,965,995
40,Segovia,58,Codorniz,447,217,230
40,Segovia,59,Collado Hermoso,157,80,77
40,Segovia,60,Condado de Castilnovo,129,65,64
40,Segovia,61,Corral de Ayllón,98,52,46
40,Segovia,902,Cozuelos de Fuentidueña,176,97,79
40,Segovia,62,Cubillo,59,33,26
40,Segovia,63,Cuéllar,9386,4789,4597
40,Segovia,905,Cuevas de Provanco,184,98,86
40,Segovia,65,Chañe,705,379,326
40,Segovia,68,Domingo García,53,26,27
40,Segovia,69,Donhierro,99,52,47
40,Segovia,70,Duruelo,130,72,58
40,Segovia,71,Encinas,67,33,34
40,Segovia,72,Encinillas,76,44,32
40,Segovia,73,Escalona del Prado,594,317,277
40,Segovia,74,Escarabajosa de Cabezas,369,204,165
40,Segovia,75,Escobar de Polendos,244,128,116
40,Segovia,76,Espinar (El),6887,3513,3374
40,Segovia,77,Espirdo,320,178,142
40,Segovia,78,Fresneda de Cuéllar,229,123,106
40,Segovia,79,Fresno de Cantespino,300,161,139
40,Segovia,80,Fresno de la Fuente,76,40,36
40,Segovia,81,Frumales,183,93,90
40,Segovia,82,Fuente de Santa Cruz,179,86,93
40,Segovia,83,Fuente el Olmo de Fuentidueña,133,72,61
40,Segovia,84,Fuente el Olmo de Íscar,95,53,42
40,Segovia,86,Fuentepelayo,970,494,476
40,Segovia,87,Fuentepiñel,159,81,78
40,Segovia,88,Fuenterrebollo,398,202,196
40,Segovia,89,Fuentesaúco de Fuentidueña,309,161,148
40,Segovia,91,Fuentesoto,159,84,75
40,Segovia,92,Fuentidueña,160,89,71
40,Segovia,93,Gallegos,106,52,54
40,Segovia,94,Garcillán,358,191,167
40,Segovia,95,Gomezserracín,726,370,356
40,Segovia,97,Grajera,97,52,45
40,Segovia,99,Honrubia de la Cuesta,62,27,35
40,Segovia,100,Hontalbilla,404,209,195
40,Segovia,101,Hontanares de Eresma,209,115,94
40,Segovia,103,Huertos (Los),146,74,72
40,Segovia,104,Ituero y Lama,98,56,42
40,Segovia,105,Juarros de Riomoros,70,40,30
40,Segovia,106,Juarros de Voltoya,275,139,136
40,Segovia,107,Labajos,143,78,65
40,Segovia,108,Laguna de Contreras,148,80,68
40,Segovia,109,Languilla,123,66,57
40,Segovia,110,Lastras de Cuéllar,509,270,239
40,Segovia,111,Lastras del Pozo,76,38,38
40,Segovia,112,Lastrilla (La),2133,1070,1063
40,Segovia,113,Losa (La),418,223,195
40,Segovia,115,Maderuelo,161,83,78
40,Segovia,903,Marazoleja,145,83,62
40,Segovia,118,Marazuela,65,35,30
40,Segovia,119,Martín Miguel,188,96,92
40,Segovia,120,Martín Muñoz de la Dehesa,190,102,88
40,Segovia,121,Martín Muñoz de las Posadas,468,227,241
40,Segovia,122,Marugán,436,244,192
40,Segovia,124,Mata de Cuéllar,305,162,143
40,Segovia,123,Matabuena,226,120,106
40,Segovia,125,Matilla (La),114,59,55
40,Segovia,126,Melque de Cercos,108,52,56
40,Segovia,127,Membibre de la Hoz,63,31,32
40,Segovia,128,Migueláñez,161,72,89
40,Segovia,129,Montejo de Arévalo,268,148,120
40,Segovia,130,Montejo de la Vega de la Serrezuela,195,104,91
40,Segovia,131,Monterrubio,71,41,30
40,Segovia,132,Moral de Hornuez,97,54,43
40,Segovia,134,Mozoncillo,1033,531,502
40,Segovia,135,Muñopedro,382,200,182
40,Segovia,136,Muñoveros,196,108,88
40,Segovia,138,Nava de la Asunción,2620,1325,1295
40,Segovia,139,Navafría,353,186,167
40,Segovia,140,Navalilla,129,68,61
40,Segovia,141,Navalmanzano,1126,578,548
40,Segovia,142,Navares de Ayuso,74,41,33
40,Segovia,143,Navares de Enmedio,142,81,61
40,Segovia,144,Navares de las Cuevas,34,20,14
40,Segovia,145,Navas de Oro,1437,729,708
40,Segovia,904,Navas de Riofrío,314,149,165
40,Segovia,146,Navas de San Antonio,297,155,142
40,Segovia,148,Nieva,340,182,158
40,Segovia,149,Olombrada,771,420,351
40,Segovia,150,Orejana,97,58,39
40,Segovia,151,Ortigosa de Pestaño,106,58,48
40,Segovia,901,Ortigosa del Monte,400,200,200
40,Segovia,152,Otero de Herreros,859,424,435
40,Segovia,154,Pajarejos,41,20,21
40,Segovia,155,Palazuelos de Eresma,2033,1056,977
40,Segovia,156,Pedraza,479,263,216
40,Segovia,157,Pelayos del Arroyo,61,32,29
40,Segovia,158,Perosillo,27,18,9
40,Segovia,159,Pinarejos,179,103,76
40,Segovia,160,Pinarnegrillo,167,92,75
40,Segovia,161,Pradales,72,33,39
40,Segovia,162,Prádena,540,296,244
40,Segovia,163,Puebla de Pedraza,94,52,42
40,Segovia,164,Rapariegos,245,119,126
40,Segovia,165,Rebollo,121,67,54
40,Segovia,166,Remondo,335,159,176
40,Segovia,168,Riaguas de San Bartolomé,84,45,39
40,Segovia,170,Riaza,1988,1096,892
40,Segovia,171,Ribota,40,26,14
40,Segovia,172,Riofrío de Riaza,56,28,28
40,Segovia,173,Roda de Eresma,93,47,46
40,Segovia,174,Sacramenia,540,275,265
40,Segovia,176,Samboal,577,301,276
40,Segovia,177,San Cristóbal de Cuéllar,205,106,99
40,Segovia,178,San Cristóbal de la Vega,149,75,74
40,Segovia,906,San Cristóbal de Segovia,2245,1142,1103
40,Segovia,181,San Ildefonso,5180,2552,2628
40,Segovia,182,San Martín y Mudrián,261,131,130
40,Segovia,183,San Miguel de Bernuy,187,94,93
40,Segovia,184,San Pedro de Gaíllos,334,174,160
40,Segovia,179,Sanchonuño,808,396,412
40,Segovia,180,Sangarcía,455,233,222
40,Segovia,185,Santa María la Real de Nieva,1335,691,644
40,Segovia,186,Santa Marta del Cerro,53,27,26
40,Segovia,188,Santiuste de Pedraza,116,60,56
40,Segovia,189,Santiuste de San Juan Bautista,740,384,356
40,Segovia,190,Santo Domingo de Pirón,63,32,31
40,Segovia,191,Santo Tomé del Puerto,329,178,151
40,Segovia,192,Sauquillo de Cabezas,237,129,108
40,Segovia,193,Sebúlcor,262,140,122
40,Segovia,194,Segovia,55640,26663,28977
40,Segovia,195,Sepúlveda,1304,664,640
40,Segovia,196,Sequera de Fresno,43,25,18
40,Segovia,198,Sotillo,38,19,19
40,Segovia,199,Sotosalbos,119,68,51
40,Segovia,200,Tabanera la Luenga,67,35,32
40,Segovia,201,Tolocirio,58,27,31
40,Segovia,206,Torre Val de San Pedro,181,101,80
40,Segovia,202,Torreadrada,112,50,62
40,Segovia,203,Torrecaballeros,662,341,321
40,Segovia,204,Torrecilla del Pinar,281,143,138
40,Segovia,205,Torreiglesias,384,200,184
40,Segovia,207,Trescasas,351,185,166
40,Segovia,208,Turégano,1074,547,527
40,Segovia,210,Urueñas,110,61,49
40,Segovia,211,Valdeprados,63,29,34
40,Segovia,212,Valdevacas de Montejo,30,18,12
40,Segovia,213,Valdevacas y Guijar,146,75,71
40,Segovia,214,Valseca,269,141,128
40,Segovia,215,Valtiendas,165,93,72
40,Segovia,216,Valverde del Majano,530,280,250
40,Segovia,218,Valle de Tabladillo,162,85,77
40,Segovia,219,Vallelado,836,434,402
40,Segovia,220,Valleruela de Pedraza,70,38,32
40,Segovia,221,Valleruela de Sepúlveda,70,33,37
40,Segovia,222,Veganzones,306,161,145
40,Segovia,223,Vegas de Matute,243,137,106
40,Segovia,224,Ventosilla y Tejadilla,50,31,19
40,Segovia,225,Villacastín,1504,775,729
40,Segovia,228,Villaverde de Íscar,706,362,344
40,Segovia,229,Villaverde de Montejo,62,35,27
40,Segovia,230,Villeguillo,124,70,54
40,Segovia,231,Yanguas de Eresma,187,92,95
40,Segovia,233,Zarzuela del Monte,542,277,265
40,Segovia,234,Zarzuela del Pinar,576,302,274
41,Sevilla,1,Aguadulce,1970,992,978
41,Sevilla,2,Alanís,1984,1000,984
41,Sevilla,3,Albaida del Aljarafe,2029,1028,1001
41,Sevilla,4,Alcalá de Guadaira,59807,29754,30053
41,Sevilla,5,Alcalá del Río,9142,4647,4495
41,Sevilla,6,Alcolea del Río,3328,1633,1695
41,Sevilla,7,Algaba (La),13304,6657,6647
41,Sevilla,8,Algámitas,1360,707,653
41,Sevilla,9,Almadén de la Plata,1686,857,829
41,Sevilla,10,Almensilla,3545,1814,1731
41,Sevilla,11,Arahal,18568,9209,9359
41,Sevilla,12,Aznalcázar,3581,1799,1782
41,Sevilla,13,Aznalcóllar,5845,3010,2835
41,Sevilla,14,Badolatosa,3167,1623,1544
41,Sevilla,15,Benacazón,5463,2786,2677
41,Sevilla,16,Bollullos de la Mitación,5567,2794,2773
41,Sevilla,17,Bormujos,12641,6328,6313
41,Sevilla,18,Brenes,10929,5480,5449
41,Sevilla,19,Burguillos,3737,1885,1852
41,Sevilla,20,Cabezas de San Juan (Las),15867,8147,7720
41,Sevilla,21,Camas,25502,12490,13012
41,Sevilla,22,Campana (La),5138,2573,2565
41,Sevilla,23,Cantillana,9138,4592,4546
41,Sevilla,901,Cañada Rosal,3044,1505,1539
41,Sevilla,24,Carmona,26297,13239,13058
41,Sevilla,25,Carrión de los Céspedes,2296,1089,1207
41,Sevilla,26,Casariche,5289,2666,2623
41,Sevilla,27,Castilblanco de los Arroyos,4660,2310,2350
41,Sevilla,28,Castilleja de Guzmán,2145,1097,1048
41,Sevilla,29,Castilleja de la Cuesta,16735,8255,8480
41,Sevilla,30,Castilleja del Campo,616,311,305
41,Sevilla,31,Castillo de las Guardas (El),1638,831,807
41,Sevilla,32,Cazalla de la Sierra,5177,2580,2597
41,Sevilla,33,Constantina,6889,3370,3519
41,Sevilla,34,Coria del Río,24735,12387,12348
41,Sevilla,35,Coripe,1435,737,698
41,Sevilla,36,Coronil (El),5085,2569,2516
41,Sevilla,37,Corrales (Los),4086,2087,1999
41,Sevilla,903,Cuervo de Sevilla (El),7801,3961,3840
41,Sevilla,38,Dos Hermanas,107258,53162,54096
41,Sevilla,39,Écija,38083,18760,19323
41,Sevilla,40,Espartinas,6546,3326,3220
41,Sevilla,41,Estepa,12030,5962,6068
41,Sevilla,42,Fuentes de Andalucía,7398,3667,3731
41,Sevilla,43,Garrobo (El),765,386,379
41,Sevilla,44,Gelves,7224,3596,3628
41,Sevilla,45,Gerena,5720,2854,2866
41,Sevilla,46,Gilena,3829,1927,1902
41,Sevilla,47,Gines,11430,5628,5802
41,Sevilla,48,Guadalcanal,2946,1473,1473
41,Sevilla,49,Guillena,8615,4364,4251
41,Sevilla,50,Herrera,6123,3026,3097
41,Sevilla,51,Huévar del Aljarafe,2332,1215,1117
41,Sevilla,902,Isla Mayor,5937,2968,2969
41,Sevilla,52,Lantejuela (La),3685,1895,1790
41,Sevilla,53,Lebrija,24544,12414,12130
41,Sevilla,54,Lora de Estepa,788,395,393
41,Sevilla,55,Lora del Río,18663,9240,9423
41,Sevilla,56,Luisiana (La),4386,2224,2162
41,Sevilla,57,Madroño (El),369,190,179
41,Sevilla,58,Mairena del Alcor,17315,8638,8677
41,Sevilla,59,Mairena del Aljarafe,37464,18904,18560
41,Sevilla,60,Marchena,18434,9154,9280
41,Sevilla,61,Marinaleda,2645,1327,1318
41,Sevilla,62,Martín de la Jara,2726,1418,1308
41,Sevilla,63,Molares (Los),2759,1405,1354
41,Sevilla,64,Montellano,6877,3463,3414
41,Sevilla,65,Morón de la Frontera,27944,13883,14061
41,Sevilla,66,Navas de la Concepción (Las),1863,930,933
41,Sevilla,67,Olivares,8370,4197,4173
41,Sevilla,68,Osuna,17285,8531,8754
41,Sevilla,69,Palacios y Villafranca (Los),33711,17038,16673
41,Sevilla,70,Palomares del Río,4086,2053,2033
41,Sevilla,71,Paradas,7067,3529,3538
41,Sevilla,72,Pedrera,5001,2461,2540
41,Sevilla,73,Pedroso (El),2308,1136,1172
41,Sevilla,74,Peñaflor,3703,1873,1830
41,Sevilla,75,Pilas,11654,5795,5859
41,Sevilla,76,Pruna,3067,1577,1490
41,Sevilla,77,Puebla de Cazalla (La),10600,5293,5307
41,Sevilla,78,Puebla de los Infantes (La),3271,1656,1615
41,Sevilla,79,Puebla del Río (La),10832,5380,5452
41,Sevilla,80,Real de la Jara (El),1623,778,845
41,Sevilla,81,Rinconada (La),30761,15494,15267
41,Sevilla,82,Roda de Andalucía (La),4214,2090,2124
41,Sevilla,83,Ronquillo (El),1360,688,672
41,Sevilla,84,Rubio (El),3622,1803,1819
41,Sevilla,85,Salteras,3611,1789,1822
41,Sevilla,86,San Juan de Aznalfarache,20001,9724,10277
41,Sevilla,88,San Nicolás del Puerto,689,353,336
41,Sevilla,87,Sanlúcar la Mayor,11328,5628,5700
41,Sevilla,89,Santiponce,7278,3641,3637
41,Sevilla,90,Saucejo (El),4268,2136,2132
41,Sevilla,91,Sevilla,709975,339259,370716
41,Sevilla,92,Tocina,8932,4432,4500
41,Sevilla,93,Tomares,18992,9453,9539
41,Sevilla,94,Umbrete,5206,2593,2613
41,Sevilla,95,Utrera,46086,23083,23003
41,Sevilla,96,Valencina de la Concepción,7220,3616,3604
41,Sevilla,97,Villamanrique de la Condesa,3757,1844,1913
41,Sevilla,100,Villanueva de San Juan,1438,712,726
41,Sevilla,98,Villanueva del Ariscal,5206,2525,2681
41,Sevilla,99,Villanueva del Río y Minas,5264,2551,2713
41,Sevilla,101,Villaverde del Río,6555,3320,3235
41,Sevilla,102,Viso del Alcor (El),16597,8389,8208
42,Soria,1,Abejar,395,207,188
42,Soria,3,Adradas,87,48,39
42,Soria,4,Ágreda,3192,1584,1608
42,Soria,6,Alconaba,164,94,70
42,Soria,7,Alcubilla de Avellaneda,203,100,103
42,Soria,8,Alcubilla de las Peñas,89,46,43
42,Soria,9,Aldealafuente,138,72,66
42,Soria,10,Aldealices,25,13,12
42,Soria,11,Aldealpozo,31,14,17
42,Soria,12,Aldealseñor,44,28,16
42,Soria,13,Aldehuela de Periáñez,50,26,24
42,Soria,14,Aldehuelas (Las),103,57,46
42,Soria,15,Alentisque,38,17,21
42,Soria,16,Aliud,31,17,14
42,Soria,17,Almajano,227,123,104
42,Soria,18,Almaluez,270,143,127
42,Soria,19,Almarza,592,323,269
42,Soria,20,Almazán,5751,2849,2902
42,Soria,21,Almazul,148,77,71
42,Soria,22,Almenar de Soria,344,186,158
42,Soria,23,Alpanseque,96,51,45
42,Soria,24,Arancón,110,61,49
42,Soria,25,Arcos de Jalón,1833,930,903
42,Soria,26,Arenillas,35,22,13
42,Soria,27,Arévalo de la Sierra,93,53,40
42,Soria,28,Ausejo de la Sierra,60,30,30
42,Soria,29,Baraona,217,117,100
42,Soria,30,Barca,121,70,51
42,Soria,31,Barcones,43,26,17
42,Soria,32,Bayubas de Abajo,268,144,124
42,Soria,33,Bayubas de Arriba,66,34,32
42,Soria,34,Beratón,32,24,8
42,Soria,35,Berlanga de Duero,1109,559,550
42,Soria,36,Blacos,62,36,26
42,Soria,37,Bliecos,45,27,18
42,Soria,38,Borjabad,56,32,24
42,Soria,39,Borobia,355,181,174
42,Soria,41,Buberos,45,24,21
42,Soria,42,Buitrago,54,25,29
42,Soria,43,Burgo de Osma-Ciudad de Osma,5016,2474,2542
42,Soria,44,Cabrejas del Campo,80,44,36
42,Soria,45,Cabrejas del Pinar,451,241,210
42,Soria,46,Calatañazor,62,37,25
42,Soria,48,Caltojar,113,61,52
42,Soria,49,Candilichera,211,106,105
42,Soria,50,Cañamaque,40,24,16
42,Soria,51,Carabantes,35,16,19
42,Soria,52,Caracena,22,15,7
42,Soria,53,Carrascosa de Abajo,35,19,16
42,Soria,54,Carrascosa de la Sierra,12,7,5
42,Soria,55,Casarejos,260,137,123
42,Soria,56,Castilfrío de la Sierra,29,18,11
42,Soria,57,Castilruiz,299,150,149
42,Soria,58,Castillejo de Robledo,180,97,83
42,Soria,59,Centenera de Andaluz,28,10,18
42,Soria,60,Cerbón,48,25,23
42,Soria,61,Cidones,349,197,152
42,Soria,62,Cigudosa,61,36,25
42,Soria,63,Cihuela,83,40,43
42,Soria,64,Ciria,107,51,56
42,Soria,65,Cirujales del Río,38,20,18
42,Soria,68,Coscurita,125,72,53
42,Soria,69,Covaleda,2016,1014,1002
42,Soria,70,Cubilla,61,33,28
42,Soria,71,Cubo de la Solana,233,124,109
42,Soria,73,Cueva de Ágreda,86,45,41
42,Soria,75,Dévanos,118,64,54
42,Soria,76,Deza,346,169,177
42,Soria,78,Duruelo de la Sierra,1436,716,720
42,Soria,79,Escobosa de Almazán,41,22,19
42,Soria,80,Espeja de San Marcelino,237,132,105
42,Soria,81,Espejón,219,114,105
42,Soria,82,Estepa de San Juan,14,7,7
42,Soria,83,Frechilla de Almazán,41,20,21
42,Soria,84,Fresno de Caracena,45,25,20
42,Soria,85,Fuentearmegil,302,159,143
42,Soria,86,Fuentecambrón,63,34,29
42,Soria,87,Fuentecantos,54,28,26
42,Soria,88,Fuentelmonge,120,64,56
42,Soria,89,Fuentelsaz de Soria,57,21,36
42,Soria,90,Fuentepinilla,141,82,59
42,Soria,92,Fuentes de Magaña,90,47,43
42,Soria,93,Fuentestrún,68,43,25
42,Soria,94,Garray,489,271,218
42,Soria,95,Golmayo,1061,575,486
42,Soria,96,Gómara,437,230,207
42,Soria,97,Gormaz,19,7,12
42,Soria,98,Herrera de Soria,23,16,7
42,Soria,100,Hinojosa del Campo,42,28,14
42,Soria,103,Langa de Duero,853,473,380
42,Soria,105,Liceras,63,32,31
42,Soria,106,Losilla (La),18,11,7
42,Soria,107,Magaña,113,60,53
42,Soria,108,Maján,17,9,8
42,Soria,110,Matalebreras,121,64,57
42,Soria,111,Matamala de Almazán,397,202,195
42,Soria,113,Medinaceli,727,363,364
42,Soria,115,Miño de Medinaceli,102,50,52
42,Soria,116,Miño de San Esteban,86,47,39
42,Soria,117,Molinos de Duero,184,101,83
42,Soria,118,Momblona,38,21,17
42,Soria,119,Monteagudo de las Vicarías,277,142,135
42,Soria,120,Montejo de Tiermes,241,136,105
42,Soria,121,Montenegro de Cameros,101,60,41
42,Soria,123,Morón de Almazán,246,116,130
42,Soria,124,Muriel de la Fuente,83,48,35
42,Soria,125,Muriel Viejo,72,33,39
42,Soria,127,Nafría de Ucero,81,43,38
42,Soria,128,Narros,47,23,24
42,Soria,129,Navaleno,996,494,502
42,Soria,130,Nepas,79,47,32
42,Soria,131,Nolay,88,46,42
42,Soria,132,Noviercas,227,112,115
42,Soria,134,Ólvega,3259,1678,1581
42,Soria,135,Oncala,101,57,44
42,Soria,139,Pinilla del Campo,21,12,9
42,Soria,140,Portillo de Soria,19,11,8
42,Soria,141,Póveda de Soria (La),121,64,57
42,Soria,142,Pozalmuro,102,52,50
42,Soria,144,Quintana Redonda,572,300,272
42,Soria,145,Quintanas de Gormaz,186,101,85
42,Soria,148,Quiñonería,15,5,10
42,Soria,149,Rábanos (Los),428,255,173
42,Soria,151,Rebollar,51,27,24
42,Soria,152,Recuerda,111,59,52
42,Soria,153,Rello,34,18,16
42,Soria,154,Renieblas,121,65,56
42,Soria,155,Retortillo de Soria,228,125,103
42,Soria,156,Reznos,44,28,16
42,Soria,157,Riba de Escalote (La),25,14,11
42,Soria,158,Rioseco de Soria,139,71,68
42,Soria,159,Rollamienta,50,29,21
42,Soria,160,Royo (El),322,168,154
42,Soria,161,Salduero,189,99,90
42,Soria,162,San Esteban de Gormaz,3341,1711,1630
42,Soria,163,San Felices,85,42,43
42,Soria,164,San Leonardo de Yagüe,2181,1113,1068
42,Soria,165,San Pedro Manrique,538,285,253
42,Soria,166,Santa Cruz de Yanguas,65,40,25
42,Soria,167,Santa María de Huerta,436,235,201
42,Soria,168,Santa María de las Hoyas,190,101,89
42,Soria,171,Serón de Nágima,227,118,109
42,Soria,172,Soliedra,35,20,15
42,Soria,173,Soria,35178,16876,18302
42,Soria,174,Sotillo del Rincón,218,109,109
42,Soria,175,Suellacabras,34,20,14
42,Soria,176,Tajahuerce,36,16,20
42,Soria,177,Tajueco,113,58,55
42,Soria,178,Talveila,189,100,89
42,Soria,181,Tardelcuende,617,307,310
42,Soria,182,Taroda,76,39,37
42,Soria,183,Tejado,185,92,93
42,Soria,184,Torlengua,102,53,49
42,Soria,185,Torreblacos,34,18,16
42,Soria,187,Torrubia de Soria,89,50,39
42,Soria,188,Trévago,81,33,48
42,Soria,189,Ucero,99,50,49
42,Soria,190,Vadillo,138,70,68
42,Soria,191,Valdeavellano de Tera,239,120,119
42,Soria,192,Valdegeña,51,32,19
42,Soria,193,Valdelagua del Cerro,20,10,10
42,Soria,194,Valdemaluque,259,129,130
42,Soria,195,Valdenebro,143,72,71
42,Soria,196,Valdeprado,22,10,12
42,Soria,197,Valderrodilla,110,56,54
42,Soria,198,Valtajeros,26,16,10
42,Soria,200,Velamazán,130,74,56
42,Soria,201,Velilla de la Sierra,24,13,11
42,Soria,202,Velilla de los Ajos,42,25,17
42,Soria,204,Viana de Duero,73,45,28
42,Soria,205,Villaciervos,124,73,51
42,Soria,206,Villanueva de Gormaz,26,15,11
42,Soria,207,Villar del Ala,61,29,32
42,Soria,208,Villar del Campo,34,19,15
42,Soria,209,Villar del Río,167,94,73
42,Soria,211,Villares de Soria (Los),114,58,56
42,Soria,212,Villasayas,98,60,38
42,Soria,213,Villaseca de Arciel,41,24,17
42,Soria,215,Vinuesa,1041,552,489
42,Soria,216,Vizmanos,38,25,13
42,Soria,217,Vozmediano,45,26,19
42,Soria,218,Yanguas,127,62,65
42,Soria,219,Yelo,52,28,24
43,Tarragona,1,Aiguamúrcia,672,355,317
43,Tarragona,2,Albinyana,1780,913,867
43,Tarragona,3,Albiol (L'),230,121,109
43,Tarragona,4,Alcanar,8738,4441,4297
43,Tarragona,5,Alcover,4197,2145,2052
43,Tarragona,904,Aldea (L'),3590,1857,1733
43,Tarragona,6,Aldover,814,387,427
43,Tarragona,7,Aleixar (L'),750,381,369
43,Tarragona,8,Alfara de Carles,377,198,179
43,Tarragona,9,Alforja,1393,717,676
43,Tarragona,10,Alió,376,185,191
43,Tarragona,11,Almoster,1017,521,496
43,Tarragona,12,Altafulla,3710,1896,1814
43,Tarragona,13,Ametlla de Mar (L'),5835,3013,2822
43,Tarragona,906,Ampolla (L'),2133,1071,1062
43,Tarragona,14,Amposta,17759,8912,8847
43,Tarragona,16,Arboç (L'),3977,2080,1897
43,Tarragona,15,Arbolí,122,65,57
43,Tarragona,17,Argentera (L'),154,87,67
43,Tarragona,18,Arnes,501,258,243
43,Tarragona,19,Ascó,1635,828,807
43,Tarragona,20,Banyeres del Penedès,1862,1003,859
43,Tarragona,21,Barberà de la Conca,434,221,213
43,Tarragona,22,Batea,2063,1046,1017
43,Tarragona,23,Bellmunt del Priorat,304,152,152
43,Tarragona,24,Bellvei,1532,812,720
43,Tarragona,25,Benifallet,843,417,426
43,Tarragona,26,Benissanet,1124,601,523
43,Tarragona,27,Bisbal de Falset (La),250,129,121
43,Tarragona,28,Bisbal del Penedès (La),2349,1251,1098
43,Tarragona,29,Blancafort,412,221,191
43,Tarragona,30,Bonastre,424,225,199
43,Tarragona,31,Borges del Camp (Les),1686,846,840
43,Tarragona,32,Bot,793,402,391
43,Tarragona,33,Botarell,831,437,394
43,Tarragona,34,Bràfim,600,296,304
43,Tarragona,35,Cabacés,345,182,163
43,Tarragona,36,Cabra del Camp,709,373,336
43,Tarragona,37,Calafell,15883,8013,7870
43,Tarragona,903,Camarles,3060,1546,1514
43,Tarragona,38,Cambrils,23555,11797,11758
43,Tarragona,39,Capafonts,119,63,56
43,Tarragona,40,Capçanes,401,188,213
43,Tarragona,41,Caseres,323,157,166
43,Tarragona,42,Castellvell del Camp,1722,855,867
43,Tarragona,43,Catllar (El),2847,1470,1377
43,Tarragona,45,Colldejou,192,103,89
43,Tarragona,46,Conesa,123,68,55
43,Tarragona,47,Constantí,5314,2804,2510
43,Tarragona,48,Corbera d'Ebre,1040,548,492
43,Tarragona,49,Cornudella de Montsant,863,444,419
43,Tarragona,50,Creixell,2326,1191,1135
43,Tarragona,51,Cunit,7339,3817,3522
43,Tarragona,901,Deltebre,10697,5394,5303
43,Tarragona,53,Duesaigües,187,112,75
43,Tarragona,54,Espluga de Francolí (L'),3687,1844,1843
43,Tarragona,55,Falset,2595,1319,1276
43,Tarragona,56,Fatarella (La),1184,597,587
43,Tarragona,57,Febró (La),60,40,20
43,Tarragona,58,Figuera (La),140,74,66
43,Tarragona,59,Figuerola del Camp,292,138,154
43,Tarragona,60,Flix,4051,2045,2006
43,Tarragona,61,Forès,60,31,29
43,Tarragona,62,Freginals,391,202,189
43,Tarragona,63,Galera (La),754,378,376
43,Tarragona,64,Gandesa,2805,1440,1365
43,Tarragona,65,Garcia,505,262,243
43,Tarragona,66,Garidells (Els),173,90,83
43,Tarragona,67,Ginestar,893,458,435
43,Tarragona,68,Godall,728,378,350
43,Tarragona,69,Gratallops,223,122,101
43,Tarragona,70,Guiamets (Els),311,163,148
43,Tarragona,71,Horta de Sant Joan,1189,630,559
43,Tarragona,72,Lloar (El),114,58,56
43,Tarragona,73,Llorac,128,59,69
43,Tarragona,74,Llorenç del Penedès,1821,891,930
43,Tarragona,76,Marçà,596,298,298
43,Tarragona,75,Margalef,124,65,59
43,Tarragona,77,Mas de Barberans,687,348,339
43,Tarragona,78,Masdenverge,1005,531,474
43,Tarragona,79,Masllorenç,453,228,225
43,Tarragona,80,Masó (La),287,143,144
43,Tarragona,81,Maspujols,496,257,239
43,Tarragona,82,Masroig (El),519,249,270
43,Tarragona,83,Milà (El),160,74,86
43,Tarragona,84,Miravet,781,414,367
43,Tarragona,85,Molar (El),293,155,138
43,Tarragona,86,Montblanc,6388,3184,3204
43,Tarragona,88,Montbrió del Camp,1535,778,757
43,Tarragona,89,Montferri,163,91,72
43,Tarragona,90,Montmell (El),784,434,350
43,Tarragona,91,Mont-ral,166,93,73
43,Tarragona,92,Mont-roig del Camp,7897,4070,3827
43,Tarragona,93,Móra d'Ebre,4847,2390,2457
43,Tarragona,94,Móra la Nova,3084,1590,1494
43,Tarragona,95,Morell (El),2420,1240,1180
43,Tarragona,96,Morera de Montsant (La),176,95,81
43,Tarragona,97,Nou de Gaià (La),404,210,194
43,Tarragona,98,Nulles,379,181,198
43,Tarragona,99,Palma d'Ebre (La),406,193,213
43,Tarragona,100,Pallaresos (Els),2811,1455,1356
43,Tarragona,101,Passanant,217,120,97
43,Tarragona,102,Paüls,625,313,312
43,Tarragona,103,Perafort,710,365,345
43,Tarragona,104,Perelló (El),2246,1193,1053
43,Tarragona,105,Piles (Les),180,101,79
43,Tarragona,106,Pinell de Brai (El),1075,550,525
43,Tarragona,107,Pira,440,215,225
43,Tarragona,108,Pla de Santa Maria (El),1727,902,825
43,Tarragona,109,Pobla de Mafumet (La),1270,637,633
43,Tarragona,110,Pobla de Massaluca (La),426,222,204
43,Tarragona,111,Pobla de Montornès (La),1682,907,775
43,Tarragona,112,Poboleda,325,167,158
43,Tarragona,113,Pont d'Armentera (El),551,284,267
43,Tarragona,141,Pontils,130,67,63
43,Tarragona,114,Porrera,465,251,214
43,Tarragona,115,Pradell de la Teixeta,196,101,95
43,Tarragona,116,Prades,579,297,282
43,Tarragona,117,Prat de Comte,187,92,95
43,Tarragona,118,Pratdip,646,334,312
43,Tarragona,119,Puigpelat,706,364,342
43,Tarragona,120,Querol,320,175,145
43,Tarragona,121,Rasquera,807,408,399
43,Tarragona,122,Renau,81,40,41
43,Tarragona,123,Reus,94407,46551,47856
43,Tarragona,124,Riba (La),681,366,315
43,Tarragona,125,Riba-roja d'Ebre,1339,689,650
43,Tarragona,126,Riera de Gaià (La),1135,577,558
43,Tarragona,127,Riudecanyes,746,377,369
43,Tarragona,128,Riudecols,1033,548,485
43,Tarragona,129,Riudoms,5462,2773,2689
43,Tarragona,130,Rocafort de Queralt,277,146,131
43,Tarragona,131,Roda de Barà,4127,2211,1916
43,Tarragona,132,Rodonyà,434,228,206
43,Tarragona,133,Roquetes,6839,3518,3321
43,Tarragona,134,Rourell (El),309,156,153
43,Tarragona,135,Salomó,363,185,178
43,Tarragona,905,Salou,16952,8854,8098
43,Tarragona,136,Sant Carles de la Ràpita,12095,6071,6024
43,Tarragona,137,Sant Jaume dels Domenys,1637,851,786
43,Tarragona,902,Sant Jaume d'Enveja,3296,1684,1612
43,Tarragona,138,Santa Bàrbara,3541,1804,1737
43,Tarragona,139,Santa Coloma de Queralt,2880,1439,1441
43,Tarragona,140,Santa Oliva,2422,1226,1196
43,Tarragona,142,Sarral,1481,774,707
43,Tarragona,143,Savallà del Comtat,72,36,36
43,Tarragona,144,Secuita (La),1150,592,558
43,Tarragona,145,Selva del Camp (La),4507,2265,2242
43,Tarragona,146,Senan,35,24,11
43,Tarragona,44,Sénia (La),5737,2999,2738
43,Tarragona,147,Solivella,574,281,293
43,Tarragona,148,Tarragona,121076,59283,61793
43,Tarragona,149,Tivenys,910,458,452
43,Tarragona,150,Tivissa,1790,894,896
43,Tarragona,151,Torre de Fontaubella (La),140,72,68
43,Tarragona,152,Torre de l'Espanyol (La),724,378,346
43,Tarragona,153,Torredembarra,12113,6076,6037
43,Tarragona,154,Torroja del Priorat,147,89,58
43,Tarragona,155,Tortosa,31164,15471,15693
43,Tarragona,156,Ulldecona,5997,3092,2905
43,Tarragona,157,Ulldemolins,501,263,238
43,Tarragona,158,Vallclara,113,64,49
43,Tarragona,159,Vallfogona de Riucorb,172,87,85
43,Tarragona,160,Vallmoll,1337,705,632
43,Tarragona,161,Valls,21649,10755,10894
43,Tarragona,162,Vandellòs i l'Hospitalet de l'Infant,4642,2353,2289
43,Tarragona,163,Vendrell (El),26820,13529,13291
43,Tarragona,164,Vespella de Gaià,236,139,97
43,Tarragona,165,Vilabella,795,407,388
43,Tarragona,175,Vilalba dels Arcs,736,381,355
43,Tarragona,166,Vilallonga del Camp,1283,639,644
43,Tarragona,168,Vilanova de Prades,145,74,71
43,Tarragona,167,Vilanova d'Escornalbou,447,227,220
43,Tarragona,169,Vilaplana,528,274,254
43,Tarragona,170,Vila-rodona,1061,582,479
43,Tarragona,171,Vila-seca,14377,7232,7145
43,Tarragona,172,Vilaverd,399,203,196
43,Tarragona,173,Vilella Alta (La),110,60,50
43,Tarragona,174,Vilella Baixa (La),197,104,93
43,Tarragona,176,Vimbodí,1054,575,479
43,Tarragona,177,Vinebre,478,245,233
43,Tarragona,178,Vinyols i els Arcs,1369,724,645
43,Tarragona,52,Xerta,1240,626,614
44,Teruel,1,Ababuj,85,49,36
44,Teruel,2,Abejuela,59,32,27
44,Teruel,3,Aguatón,26,11,15
44,Teruel,4,Aguaviva,675,338,337
44,Teruel,5,Aguilar del Alfambra,82,43,39
44,Teruel,6,Alacón,422,212,210
44,Teruel,7,Alba,250,127,123
44,Teruel,8,Albalate del Arzobispo,2201,1107,1094
44,Teruel,9,Albarracín,1045,533,512
44,Teruel,10,Albentosa,311,167,144
44,Teruel,11,Alcaine,69,41,28
44,Teruel,12,Alcalá de la Selva,527,281,246
44,Teruel,13,Alcañiz,14383,7212,7171
44,Teruel,14,Alcorisa,3416,1725,1691
44,Teruel,16,Alfambra,629,324,305
44,Teruel,17,Aliaga,389,215,174
44,Teruel,18,Almohaja,31,18,13
44,Teruel,19,Alobras,84,46,38
44,Teruel,20,Alpeñés,28,18,10
44,Teruel,21,Allepuz,137,67,70
44,Teruel,22,Alloza,703,349,354
44,Teruel,23,Allueva,14,10,4
44,Teruel,24,Anadón,19,12,7
44,Teruel,25,Andorra,7869,4088,3781
44,Teruel,26,Arcos de las Salinas,137,66,71
44,Teruel,27,Arens de Lledó,228,106,122
44,Teruel,28,Argente,263,136,127
44,Teruel,29,Ariño,897,465,432
44,Teruel,31,Azaila,167,98,69
44,Teruel,32,Bádenas,17,11,6
44,Teruel,33,Báguena,441,226,215
44,Teruel,34,Bañón,167,92,75
44,Teruel,35,Barrachina,156,83,73
44,Teruel,36,Bea,36,20,16
44,Teruel,37,Beceite,608,314,294
44,Teruel,38,Belmonte de San José,145,79,66
44,Teruel,39,Bello,355,166,189
44,Teruel,40,Berge,244,123,121
44,Teruel,41,Bezas,74,43,31
44,Teruel,42,Blancas,178,103,75
44,Teruel,43,Blesa,139,85,54
44,Teruel,44,Bordón,134,72,62
44,Teruel,45,Bronchales,479,253,226
44,Teruel,46,Bueña,87,46,41
44,Teruel,47,Burbáguena,297,139,158
44,Teruel,48,Cabra de Mora,111,63,48
44,Teruel,49,Calaceite,1158,601,557
44,Teruel,50,Calamocha,4198,2107,2091
44,Teruel,51,Calanda,3565,1835,1730
44,Teruel,52,Calomarde,73,42,31
44,Teruel,53,Camañas,148,94,54
44,Teruel,54,Camarena de la Sierra,166,89,77
44,Teruel,55,Camarillas,103,59,44
44,Teruel,56,Caminreal,761,387,374
44,Teruel,59,Cantavieja,722,385,337
44,Teruel,60,Cañada de Benatanduz,60,36,24
44,Teruel,61,Cañada de Verich (La),106,59,47
44,Teruel,62,Cañada Vellida,52,36,16
44,Teruel,63,Cañizar del Olivar,117,59,58
44,Teruel,64,Cascante del Río,114,65,49
44,Teruel,65,Castejón de Tornos,91,54,37
44,Teruel,66,Castel de Cabra,157,81,76
44,Teruel,67,Castelnou,107,57,50
44,Teruel,68,Castelserás,831,443,388
44,Teruel,70,Castellar (El),87,50,37
44,Teruel,71,Castellote,805,424,381
44,Teruel,74,Cedrillas,517,261,256
44,Teruel,75,Celadas,420,230,190
44,Teruel,76,Cella,2805,1457,1348
44,Teruel,77,Cerollera (La),116,65,51
44,Teruel,80,Codoñera (La),336,178,158
44,Teruel,82,Corbalán,92,51,41
44,Teruel,84,Cortes de Aragón,116,59,57
44,Teruel,85,Cosa,96,51,45
44,Teruel,86,Cretas,619,317,302
44,Teruel,87,Crivillén,116,61,55
44,Teruel,88,Cuba (La),55,28,27
44,Teruel,89,Cubla,45,27,18
44,Teruel,90,Cucalón,86,49,37
44,Teruel,92,Cuervo (El),114,60,54
44,Teruel,93,Cuevas de Almudén,105,57,48
44,Teruel,94,Cuevas Labradas,151,78,73
44,Teruel,96,Ejulve,222,114,108
44,Teruel,97,Escorihuela,198,102,96
44,Teruel,99,Escucha,1101,609,492
44,Teruel,100,Estercuel,316,164,152
44,Teruel,101,Ferreruela de Huerva,78,43,35
44,Teruel,102,Fonfría,29,17,12
44,Teruel,103,Formiche Alto,197,102,95
44,Teruel,105,Fórnoles,101,46,55
44,Teruel,106,Fortanete,186,98,88
44,Teruel,107,Foz-Calanda,263,143,120
44,Teruel,108,Fresneda (La),451,249,202
44,Teruel,109,Frías de Albarracín,156,83,73
44,Teruel,110,Fuenferrada,46,24,22
44,Teruel,111,Fuentes Calientes,127,70,57
44,Teruel,112,Fuentes Claras,589,291,298
44,Teruel,113,Fuentes de Rubielos,108,63,45
44,Teruel,114,Fuentespalda,353,176,177
44,Teruel,115,Galve,147,82,65
44,Teruel,116,Gargallo,117,59,58
44,Teruel,117,Gea de Albarracín,443,228,215
44,Teruel,118,Ginebrosa (La),246,141,105
44,Teruel,119,Griegos,132,83,49
44,Teruel,120,Guadalaviar,272,139,133
44,Teruel,121,Gúdar,81,47,34
44,Teruel,122,Híjar,1883,955,928
44,Teruel,123,Hinojosa de Jarque,166,90,76
44,Teruel,124,Hoz de la Vieja (La),109,52,57
44,Teruel,125,Huesa del Común,128,80,48
44,Teruel,126,Iglesuela del Cid (La),484,266,218
44,Teruel,127,Jabaloyas,75,37,38
44,Teruel,128,Jarque de la Val,99,54,45
44,Teruel,129,Jatiel,53,29,24
44,Teruel,130,Jorcas,40,26,14
44,Teruel,131,Josa,33,20,13
44,Teruel,132,Lagueruela,58,28,30
44,Teruel,133,Lanzuela,35,23,12
44,Teruel,135,Libros,153,79,74
44,Teruel,136,Lidón,70,32,38
44,Teruel,137,Linares de Mora,323,184,139
44,Teruel,138,Loscos,191,104,87
44,Teruel,141,Lledó,200,110,90
44,Teruel,142,Maicas,39,19,20
44,Teruel,143,Manzanera,489,270,219
44,Teruel,144,Martín del Río,475,244,231
44,Teruel,145,Mas de las Matas,1452,744,708
44,Teruel,146,Mata de los Olmos (La),274,134,140
44,Teruel,147,Mazaleón,599,305,294
44,Teruel,148,Mezquita de Jarque,129,69,60
44,Teruel,149,Mirambel,144,80,64
44,Teruel,150,Miravete de la Sierra,42,25,17
44,Teruel,151,Molinos,306,163,143
44,Teruel,152,Monforte de Moyuela,73,47,26
44,Teruel,153,Monreal del Campo,2408,1203,1205
44,Teruel,154,Monroyo,330,179,151
44,Teruel,155,Montalbán,1530,784,746
44,Teruel,156,Monteagudo del Castillo,67,41,26
44,Teruel,157,Monterde de Albarracín,58,28,30
44,Teruel,158,Mora de Rubielos,1391,716,675
44,Teruel,159,Moscardón,54,31,23
44,Teruel,160,Mosqueruela,722,403,319
44,Teruel,161,Muniesa,704,370,334
44,Teruel,163,Noguera de Albarracín,161,85,76
44,Teruel,164,Nogueras,19,14,5
44,Teruel,165,Nogueruelas,224,121,103
44,Teruel,167,Obón,83,45,38
44,Teruel,168,Odón,261,129,132
44,Teruel,169,Ojos Negros,535,282,253
44,Teruel,171,Olba,216,110,106
44,Teruel,172,Oliete,476,245,231
44,Teruel,173,Olmos (Los),144,76,68
44,Teruel,174,Orihuela del Tremedal,628,317,311
44,Teruel,175,Orrios,182,92,90
44,Teruel,176,Palomar de Arroyos,238,136,102
44,Teruel,177,Pancrudo,145,79,66
44,Teruel,178,Parras de Castellote (Las),82,44,38
44,Teruel,179,Peñarroya de Tastavins,532,285,247
44,Teruel,180,Peracense,107,61,46
44,Teruel,181,Peralejos,82,41,41
44,Teruel,182,Perales del Alfambra,281,150,131
44,Teruel,183,Pitarque,104,47,57
44,Teruel,184,Plou,48,22,26
44,Teruel,185,Pobo (El),138,79,59
44,Teruel,187,Portellada (La),284,150,134
44,Teruel,189,Pozondón,95,48,47
44,Teruel,190,Pozuel del Campo,108,59,49
44,Teruel,191,Puebla de Híjar (La),1035,506,529
44,Teruel,192,Puebla de Valverde (La),504,278,226
44,Teruel,193,Puertomingalvo,165,93,72
44,Teruel,194,Ráfales,187,96,91
44,Teruel,195,Rillo,130,72,58
44,Teruel,196,Riodeva,186,86,100
44,Teruel,197,Ródenas,85,44,41
44,Teruel,198,Royuela,229,131,98
44,Teruel,199,Rubiales,55,31,24
44,Teruel,200,Rubielos de la Cérida,57,28,29
44,Teruel,201,Rubielos de Mora,643,329,314
44,Teruel,203,Salcedillo,8,4,4
44,Teruel,204,Saldón,31,17,14
44,Teruel,205,Samper de Calanda,982,479,503
44,Teruel,206,San Agustín,131,71,60
44,Teruel,207,San Martín del Río,264,131,133
44,Teruel,208,Santa Cruz de Nogueras,36,21,15
44,Teruel,209,Santa Eulalia,1148,565,583
44,Teruel,210,Sarrión,1033,541,492
44,Teruel,211,Segura de los Baños,43,22,21
44,Teruel,212,Seno,52,28,24
44,Teruel,213,Singra,90,44,46
44,Teruel,215,Terriente,174,101,73
44,Teruel,216,Teruel,32304,15620,16684
44,Teruel,217,Toril y Masegoso,26,15,11
44,Teruel,218,Tormón,37,20,17
44,Teruel,219,Tornos,241,126,115
44,Teruel,220,Torralba de los Sisones,231,123,108
44,Teruel,223,Torre de Arcas,103,50,53
44,Teruel,224,Torre de las Arcas,32,19,13
44,Teruel,225,Torre del Compte,173,85,88
44,Teruel,227,Torre los Negros,90,45,45
44,Teruel,221,Torrecilla de Alcañiz,447,242,205
44,Teruel,222,Torrecilla del Rebollar,186,92,94
44,Teruel,226,Torrelacárcel,265,138,127
44,Teruel,228,Torremocha de Jiloca,154,79,75
44,Teruel,229,Torres de Albarracín,155,85,70
44,Teruel,230,Torrevelilla,207,101,106
44,Teruel,231,Torrijas,94,45,49
44,Teruel,232,Torrijo del Campo,568,288,280
44,Teruel,234,Tramacastiel,112,60,52
44,Teruel,235,Tramacastilla,128,63,65
44,Teruel,236,Tronchón,106,58,48
44,Teruel,237,Urrea de Gaén,580,288,292
44,Teruel,238,Utrillas,3192,1658,1534
44,Teruel,239,Valacloche,20,12,8
44,Teruel,240,Valbona,202,105,97
44,Teruel,241,Valdealgorfa,721,354,367
44,Teruel,243,Valdecuenca,38,21,17
44,Teruel,244,Valdelinares,132,74,58
44,Teruel,245,Valdeltormo,367,195,172
44,Teruel,246,Valderrobres,2018,1074,944
44,Teruel,247,Valjunquera,428,219,209
44,Teruel,249,Vallecillo (El),55,32,23
44,Teruel,250,Veguillas de la Sierra,27,17,10
44,Teruel,251,Villafranca del Campo,371,193,178
44,Teruel,252,Villahermosa del Campo,87,45,42
44,Teruel,256,Villanueva del Rebollar de la Sierra,51,28,23
44,Teruel,257,Villar del Cobo,218,112,106
44,Teruel,258,Villar del Salz,108,61,47
44,Teruel,260,Villarluengo,213,125,88
44,Teruel,261,Villarquemado,928,479,449
44,Teruel,262,Villarroya de los Pinares,193,103,90
44,Teruel,263,Villastar,338,175,163
44,Teruel,264,Villel,347,191,156
44,Teruel,265,Vinaceite,282,143,139
44,Teruel,266,Visiedo,189,87,102
44,Teruel,267,Vivel del Río Martín,84,44,40
44,Teruel,268,Zoma (La),28,14,14
45,Toledo,1,Ajofrín,2150,1112,1038
45,Toledo,2,Alameda de la Sagra,2918,1538,1380
45,Toledo,3,Albarreal de Tajo,641,319,322
45,Toledo,4,Alcabón,652,330,322
45,Toledo,5,Alcañizo,312,162,150
45,Toledo,6,Alcaudete de la Jara,1914,921,993
45,Toledo,7,Alcolea de Tajo,809,407,402
45,Toledo,8,Aldea en Cabo,158,82,76
45,Toledo,9,Aldeanueva de Barbarroya,754,384,370
45,Toledo,10,Aldeanueva de San Bartolomé,539,267,272
45,Toledo,11,Almendral de la Cañada,392,203,189
45,Toledo,12,Almonacid de Toledo,793,410,383
45,Toledo,13,Almorox,2200,1158,1042
45,Toledo,14,Añover de Tajo,4898,2513,2385
45,Toledo,15,Arcicóllar,576,284,292
45,Toledo,16,Argés,2988,1505,1483
45,Toledo,17,Azután,335,168,167
45,Toledo,18,Barcience,110,59,51
45,Toledo,19,Bargas,7333,3676,3657
45,Toledo,20,Belvís de la Jara,1681,844,837
45,Toledo,21,Borox,2393,1214,1179
45,Toledo,22,Buenaventura,532,262,270
45,Toledo,23,Burguillos de Toledo,1280,647,633
45,Toledo,24,Burujón,1326,683,643
45,Toledo,25,Cabañas de la Sagra,1489,774,715
45,Toledo,26,Cabañas de Yepes,255,129,126
45,Toledo,27,Cabezamesada,476,254,222
45,Toledo,28,Calera y Chozas,3817,1939,1878
45,Toledo,29,Caleruela,296,145,151
45,Toledo,30,Calzada de Oropesa,576,292,284
45,Toledo,31,Camarena,2586,1333,1253
45,Toledo,32,Camarenilla,521,262,259
45,Toledo,33,Campillo de la Jara (El),486,255,231
45,Toledo,34,Camuñas,1759,902,857
45,Toledo,35,Cardiel de los Montes,167,96,71
45,Toledo,36,Carmena,834,432,402
45,Toledo,37,Carpio de Tajo (El),2174,1064,1110
45,Toledo,38,Carranque,2064,1043,1021
45,Toledo,39,Carriches,296,149,147
45,Toledo,40,Casar de Escalona (El),1051,522,529
45,Toledo,41,Casarrubios del Monte,3769,1987,1782
45,Toledo,42,Casasbuenas,232,113,119
45,Toledo,43,Castillo de Bayuela,1037,529,508
45,Toledo,45,Cazalegas,1204,613,591
45,Toledo,46,Cebolla,3077,1562,1515
45,Toledo,47,Cedillo del Condado,1810,927,883
45,Toledo,48,Cerralbos (Los),451,234,217
45,Toledo,49,Cervera de los Montes,364,190,174
45,Toledo,50,Ciruelos,379,208,171
45,Toledo,51,Cobeja,1929,985,944
45,Toledo,52,Cobisa,2457,1268,1189
45,Toledo,53,Consuegra,10269,5141,5128
45,Toledo,54,Corral de Almaguer,5631,2868,2763
45,Toledo,55,Cuerva,1353,684,669
45,Toledo,56,Chozas de Canales,1310,672,638
45,Toledo,57,Chueca,238,125,113
45,Toledo,58,Domingo Pérez,471,237,234
45,Toledo,59,Dosbarrios,2098,1053,1045
45,Toledo,60,Erustes,199,99,100
45,Toledo,61,Escalona,2374,1204,1170
45,Toledo,62,Escalonilla,1424,715,709
45,Toledo,63,Espinoso del Rey,612,312,300
45,Toledo,64,Esquivias,4084,2057,2027
45,Toledo,65,Estrella (La),382,198,184
45,Toledo,66,Fuensalida,8206,4130,4076
45,Toledo,67,Gálvez,3198,1611,1587
45,Toledo,68,Garciotum,166,78,88
45,Toledo,69,Gerindote,1985,1021,964
45,Toledo,70,Guadamur,1666,841,825
45,Toledo,71,Guardia (La),2320,1158,1162
45,Toledo,72,Herencias (Las),718,380,338
45,Toledo,73,Herreruela de Oropesa,420,213,207
45,Toledo,74,Hinojosa de San Vicente,499,272,227
45,Toledo,75,Hontanar,120,66,54
45,Toledo,76,Hormigos,443,234,209
45,Toledo,77,Huecas,511,272,239
45,Toledo,78,Huerta de Valdecarábanos,1719,855,864
45,Toledo,79,Iglesuela (La),415,206,209
45,Toledo,80,Illán de Vacas,8,5,3
45,Toledo,81,Illescas,12704,6439,6265
45,Toledo,82,Lagartera,1701,849,852
45,Toledo,83,Layos,327,159,168
45,Toledo,84,Lillo,2816,1430,1386
45,Toledo,85,Lominchar,1342,695,647
45,Toledo,86,Lucillos,477,235,242
45,Toledo,87,Madridejos,10754,5379,5375
45,Toledo,88,Magán,1317,674,643
45,Toledo,89,Malpica de Tajo,1950,993,957
45,Toledo,90,Manzaneque,501,255,246
45,Toledo,91,Maqueda,506,256,250
45,Toledo,92,Marjaliza,305,150,155
45,Toledo,93,Marrupe,157,85,72
45,Toledo,94,Mascaraque,444,222,222
45,Toledo,95,Mata (La),948,477,471
45,Toledo,96,Mazarambroz,1272,643,629
45,Toledo,97,Mejorada,1216,612,604
45,Toledo,98,Menasalbas,2996,1567,1429
45,Toledo,99,Méntrida,2562,1337,1225
45,Toledo,100,Mesegar de Tajo,232,113,119
45,Toledo,101,Miguel Esteban,4957,2501,2456
45,Toledo,102,Mocejón,4277,2199,2078
45,Toledo,103,Mohedas de la Jara,556,293,263
45,Toledo,104,Montearagón,456,240,216
45,Toledo,105,Montesclaros,417,217,200
45,Toledo,106,Mora,9722,4868,4854
45,Toledo,107,Nambroca,2818,1433,1385
45,Toledo,108,Nava de Ricomalillo (La),700,352,348
45,Toledo,109,Navahermosa,4180,2181,1999
45,Toledo,110,Navalcán,2116,1090,1026
45,Toledo,111,Navalmoralejo,66,31,35
45,Toledo,112,Navalmorales (Los),2669,1366,1303
45,Toledo,113,Navalucillos (Los),2669,1341,1328
45,Toledo,114,Navamorcuende,717,372,345
45,Toledo,115,Noblejas,3149,1625,1524
45,Toledo,116,Noez,798,394,404
45,Toledo,117,Nombela,906,469,437
45,Toledo,118,Novés,1657,839,818
45,Toledo,119,Numancia de la Sagra,3211,1701,1510
45,Toledo,120,Nuño Gómez,244,122,122
45,Toledo,121,Ocaña,6679,3374,3305
45,Toledo,122,Olías del Rey,4939,2550,2389
45,Toledo,123,Ontígola,1620,876,744
45,Toledo,124,Orgaz,2720,1364,1356
45,Toledo,125,Oropesa,2846,1381,1465
45,Toledo,126,Otero,200,95,105
45,Toledo,127,Palomeque,432,225,207
45,Toledo,128,Pantoja,2789,1405,1384
45,Toledo,129,Paredes de Escalona,120,53,67
45,Toledo,130,Parrillas,414,210,204
45,Toledo,131,Pelahustán,360,191,169
45,Toledo,132,Pepino,1311,691,620
45,Toledo,133,Polán,3533,1784,1749
45,Toledo,134,Portillo de Toledo,2137,1120,1017
45,Toledo,135,Puebla de Almoradiel (La),5548,2798,2750
45,Toledo,136,Puebla de Montalbán (La),7540,3838,3702
45,Toledo,137,Pueblanueva (La),2119,1073,1046
45,Toledo,138,Puente del Arzobispo (El),1441,689,752
45,Toledo,139,Puerto de San Vicente,284,148,136
45,Toledo,140,Pulgar,1327,687,640
45,Toledo,141,Quero,1252,630,622
45,Toledo,142,Quintanar de la Orden,10193,5110,5083
45,Toledo,143,Quismondo,1332,672,660
45,Toledo,144,Real de San Vicente (El),1022,532,490
45,Toledo,145,Recas,3023,1687,1336
45,Toledo,146,Retamoso,141,76,65
45,Toledo,147,Rielves,545,272,273
45,Toledo,148,Robledo del Mazo,463,246,217
45,Toledo,149,Romeral (El),836,411,425
45,Toledo,150,San Bartolomé de las Abiertas,457,237,220
45,Toledo,151,San Martín de Montalbán,718,351,367
45,Toledo,152,San Martín de Pusa,774,394,380
45,Toledo,153,San Pablo de los Montes,2092,1065,1027
45,Toledo,154,San Román de los Montes,858,459,399
45,Toledo,155,Santa Ana de Pusa,383,203,180
45,Toledo,156,Santa Cruz de la Zarza,4594,2348,2246
45,Toledo,157,Santa Cruz del Retamar,1955,988,967
45,Toledo,158,Santa Olalla,2659,1376,1283
45,Toledo,901,Santo Domingo-Caudilla,769,382,387
45,Toledo,159,Sartajada,118,71,47
45,Toledo,160,Segurilla,988,496,492
45,Toledo,161,Seseña,6424,3331,3093
45,Toledo,162,Sevilleja de la Jara,1015,540,475
45,Toledo,163,Sonseca,10136,5166,4970
45,Toledo,164,Sotillo de las Palomas,220,108,112
45,Toledo,165,Talavera de la Reina,79916,38921,40995
45,Toledo,166,Tembleque,2174,1098,1076
45,Toledo,167,Toboso (El),2050,1033,1017
45,Toledo,168,Toledo,72549,34738,37811
45,Toledo,169,Torralba de Oropesa,255,121,134
45,Toledo,171,Torre de Esteban Hambrán (La),1571,815,756
45,Toledo,170,Torrecilla de la Jara,370,194,176
45,Toledo,172,Torrico,867,455,412
45,Toledo,173,Torrijos,10530,5188,5342
45,Toledo,174,Totanés,369,186,183
45,Toledo,175,Turleque,913,446,467
45,Toledo,176,Ugena,2288,1218,1070
45,Toledo,177,Urda,3092,1561,1531
45,Toledo,179,Valdeverdeja,741,335,406
45,Toledo,180,Valmojado,2624,1339,1285
45,Toledo,181,Velada,2436,1260,1176
45,Toledo,182,Ventas con Peña Aguilera (Las),1441,746,695
45,Toledo,183,Ventas de Retamosa (Las),1056,560,496
45,Toledo,184,Ventas de San Julián (Las),285,124,161
45,Toledo,186,Villa de Don Fadrique (La),4096,2052,2044
45,Toledo,185,Villacañas,9739,4832,4907
45,Toledo,187,Villafranca de los Caballeros,5241,2598,2643
45,Toledo,188,Villaluenga de la Sagra,2792,1385,1407
45,Toledo,189,Villamiel de Toledo,513,257,256
45,Toledo,190,Villaminaya,599,306,293
45,Toledo,191,Villamuelas,743,372,371
45,Toledo,192,Villanueva de Alcardete,3503,1815,1688
45,Toledo,193,Villanueva de Bogas,819,414,405
45,Toledo,194,Villarejo de Montalbán,80,41,39
45,Toledo,195,Villarrubia de Santiago,2851,1430,1421
45,Toledo,196,Villaseca de la Sagra,1579,783,796
45,Toledo,197,Villasequilla,2335,1204,1131
45,Toledo,198,Villatobas,2368,1211,1157
45,Toledo,199,Viso de San Juan (El),1507,823,684
45,Toledo,200,Yébenes (Los),6154,3117,3037
45,Toledo,201,Yeles,2201,1192,1009
45,Toledo,202,Yepes,4490,2283,2207
45,Toledo,203,Yuncler,2287,1160,1127
45,Toledo,204,Yunclillos,682,354,328
45,Toledo,205,Yuncos,4776,2517,2259
46,Valencia/València,1,Ademuz,1117,585,532
46,Valencia/València,2,Ador,1273,648,625
46,Valencia/València,4,Agullent,2290,1118,1172
46,Valencia/València,42,Aielo de Malferit,4283,2123,2160
46,Valencia/València,43,Aielo de Rugat,209,111,98
46,Valencia/València,5,Alaquàs,28804,14434,14370
46,Valencia/València,6,Albaida,6168,3068,3100
46,Valencia/València,7,Albal,13009,6543,6466
46,Valencia/València,8,Albalat de la Ribera,3426,1702,1724
46,Valencia/València,9,Albalat dels Sorells,3486,1710,1776
46,Valencia/València,10,Albalat dels Tarongers,768,399,369
46,Valencia/València,11,Alberic,9556,4743,4813
46,Valencia/València,12,Alborache,925,470,455
46,Valencia/València,13,Alboraya,19351,9661,9690
46,Valencia/València,14,Albuixech,3293,1639,1654
46,Valencia/València,16,Alcàntera de Xúquer,1341,662,679
46,Valencia/València,15,Alcàsser,7763,3932,3831
46,Valencia/València,18,Alcublas,793,399,394
46,Valencia/València,19,Alcúdia (l'),10691,5288,5403
46,Valencia/València,20,Alcúdia de Crespins (l'),4676,2357,2319
46,Valencia/València,21,Aldaia,25643,12824,12819
46,Valencia/València,22,Alfafar,19554,9749,9805
46,Valencia/València,24,Alfara de Algimia,484,233,251
46,Valencia/València,25,Alfara del Patriarca,2671,1329,1342
46,Valencia/València,26,Alfarp,1309,651,658
46,Valencia/València,27,Alfarrasí,1274,621,653
46,Valencia/València,23,Alfauir,361,185,176
46,Valencia/València,28,Algar de Palancia,441,225,216
46,Valencia/València,29,Algemesí,25596,12678,12918
46,Valencia/València,30,Algimia de Alfara,933,477,456
46,Valencia/València,31,Alginet,11687,5873,5814
46,Valencia/València,32,Almàssera,6227,2994,3233
46,Valencia/València,33,Almiserà,253,116,137
46,Valencia/València,34,Almoines,1673,827,846
46,Valencia/València,35,Almussafes,7423,3714,3709
46,Valencia/València,36,Alpuente,894,473,421
46,Valencia/València,37,Alqueria de la Comtessa (l'),1429,690,739
46,Valencia/València,17,Alzira,41758,20527,21231
46,Valencia/València,38,Andilla,356,204,152
46,Valencia/València,39,Anna,2750,1404,1346
46,Valencia/València,40,Antella,1519,752,767
46,Valencia/València,41,Aras de los Olmos,364,210,154
46,Valencia/València,3,Atzeneta d'Albaida,1313,683,630
46,Valencia/València,44,Ayora,5494,2804,2690
46,Valencia/València,46,Barx,1312,643,669
46,Valencia/València,45,Barxeta,1619,836,783
46,Valencia/València,47,Bèlgida,729,354,375
46,Valencia/València,48,Bellreguard,3826,1916,1910
46,Valencia/València,49,Bellús,388,191,197
46,Valencia/València,50,Benagéber,171,83,88
46,Valencia/València,51,Benaguasil,9559,4851,4708
46,Valencia/València,52,Benavites,623,309,314
46,Valencia/València,53,Beneixida,607,287,320
46,Valencia/València,54,Benetússer,13803,6845,6958
46,Valencia/València,55,Beniarjó,1313,649,664
46,Valencia/València,56,Beniatjar,236,117,119
46,Valencia/València,57,Benicolet,514,263,251
46,Valencia/València,60,Benifaió,12314,6153,6161
46,Valencia/València,59,Benifairó de la Valldigna,1713,869,844
46,Valencia/València,58,Benifairó de les Valls,1904,935,969
46,Valencia/València,61,Beniflá,227,116,111
46,Valencia/València,62,Benigánim,5638,2858,2780
46,Valencia/València,63,Benimodo,1957,1005,952
46,Valencia/València,64,Benimuslem,576,290,286
46,Valencia/València,65,Beniparrell,1717,884,833
46,Valencia/València,66,Benirredrà,1417,667,750
46,Valencia/València,67,Benisanó,1886,962,924
46,Valencia/València,68,Benissoda,316,172,144
46,Valencia/València,69,Benisuera,193,98,95
46,Valencia/València,70,Bétera,16499,8251,8248
46,Valencia/València,71,Bicorp,663,331,332
46,Valencia/València,72,Bocairent,4491,2203,2288
46,Valencia/València,73,Bolbaite,1474,770,704
46,Valencia/València,74,Bonrepòs i Mirambell,2172,1068,1104
46,Valencia/València,75,Bufali,200,103,97
46,Valencia/València,76,Bugarra,824,414,410
46,Valencia/València,77,Buñol,9224,4612,4612
46,Valencia/València,78,Burjassot,37213,18164,19049
46,Valencia/València,79,Calles,390,214,176
46,Valencia/València,80,Camporrobles,1394,693,701
46,Valencia/València,81,Canals,13669,6858,6811
46,Valencia/València,82,Canet d'En Berenguer,3543,1775,1768
46,Valencia/València,83,Carcaixent,21051,10413,10638
46,Valencia/València,84,Càrcer,2009,965,1044
46,Valencia/València,85,Carlet,14398,7181,7217
46,Valencia/València,86,Carrícola,83,40,43
46,Valencia/València,87,Casas Altas,156,81,75
46,Valencia/València,88,Casas Bajas,260,141,119
46,Valencia/València,89,Casinos,2313,1185,1128
46,Valencia/València,90,Castelló de Rugat,2254,1177,1077
46,Valencia/València,91,Castellonet de la Conquesta,144,78,66
46,Valencia/València,92,Castielfabib,294,160,134
46,Valencia/València,93,Catadau,2469,1254,1215
46,Valencia/València,94,Catarroja,22353,11131,11222
46,Valencia/València,95,Caudete de las Fuentes,794,407,387
46,Valencia/València,96,Cerdà,279,141,138
46,Valencia/València,97,Cofrentes,950,473,477
46,Valencia/València,98,Corbera,3066,1492,1574
46,Valencia/València,99,Cortes de Pallás,918,473,445
46,Valencia/València,100,Cotes,373,169,204
46,Valencia/València,105,Cullera,21372,10692,10680
46,Valencia/València,106,Chelva,2010,1034,976
46,Valencia/València,107,Chella,2592,1291,1301
46,Valencia/València,108,Chera,553,285,268
46,Valencia/València,109,Cheste,7116,3659,3457
46,Valencia/València,111,Chiva,10847,5498,5349
46,Valencia/València,112,Chulilla,766,387,379
46,Valencia/València,113,Daimús,2101,1071,1030
46,Valencia/València,114,Domeño,512,272,240
46,Valencia/València,115,Dos Aguas,468,253,215
46,Valencia/València,116,Eliana (l'),14543,7245,7298
46,Valencia/València,117,Emperador,237,119,118
46,Valencia/València,118,Enguera,5412,2861,2551
46,Valencia/València,119,Ènova (l'),1011,509,502
46,Valencia/València,120,Estivella,1146,549,597
46,Valencia/València,121,Estubeny,153,79,74
46,Valencia/València,122,Faura,2759,1391,1368
46,Valencia/València,123,Favara,1799,876,923
46,Valencia/València,126,Foios,5906,2902,3004
46,Valencia/València,128,Font de la Figuera (la),2105,1070,1035
46,Valencia/València,127,Font d'En Carròs (la),3351,1666,1685
46,Valencia/València,124,Fontanars dels Alforins,986,505,481
46,Valencia/València,125,Fortaleny,983,494,489
46,Valencia/València,129,Fuenterrobles,715,381,334
46,Valencia/València,131,Gandia,63201,31325,31876
46,Valencia/València,902,Gátova,467,218,249
46,Valencia/València,130,Gavarda,1184,576,608
46,Valencia/València,132,Genovés,2519,1244,1275
46,Valencia/València,133,Gestalgar,678,341,337
46,Valencia/València,134,Gilet,1980,1012,968
46,Valencia/València,135,Godella,11729,5803,5926
46,Valencia/València,136,Godelleta,2426,1226,1200
46,Valencia/València,137,Granja de la Costera (la),366,178,188
46,Valencia/València,138,Guadasequies,385,198,187
46,Valencia/València,139,Guadassuar,5483,2729,2754
46,Valencia/València,140,Guardamar de la Safor,132,69,63
46,Valencia/València,141,Higueruelas,524,266,258
46,Valencia/València,142,Jalance,971,489,482
46,Valencia/València,144,Jarafuel,853,439,414
46,Valencia/València,148,Loriguilla,1100,563,537
46,Valencia/València,149,Losa del Obispo,455,230,225
46,Valencia/València,152,Lugar Nuevo de la Corona,99,46,53
46,Valencia/València,154,Llanera de Ranes,1111,619,492
46,Valencia/València,155,Llaurí,1315,655,660
46,Valencia/València,147,Llíria,18431,9315,9116
46,Valencia/València,153,Llocnou de Sant Jeroni,568,281,287
46,Valencia/València,151,Llocnou d'En Fenollet,795,399,396
46,Valencia/València,156,Llombai,2282,1158,1124
46,Valencia/València,157,Llosa de Ranes (la),3753,1943,1810
46,Valencia/València,150,Llutxent,2499,1278,1221
46,Valencia/València,158,Macastre,1105,560,545
46,Valencia/València,159,Manises,26655,13232,13423
46,Valencia/València,160,Manuel,2428,1185,1243
46,Valencia/València,161,Marines,1443,740,703
46,Valencia/València,162,Masalavés,1581,825,756
46,Valencia/València,163,Massalfassar,1346,655,691
46,Valencia/València,164,Massamagrell,13463,6723,6740
46,Valencia/València,165,Massanassa,7360,3604,3756
46,Valencia/València,166,Meliana,9278,4585,4693
46,Valencia/València,167,Millares,578,277,301
46,Valencia/València,168,Miramar,1530,761,769
46,Valencia/València,169,Mislata,41971,20611,21360
46,Valencia/València,170,Mogente/Moixent,4410,2254,2156
46,Valencia/València,171,Moncada,19661,9751,9910
46,Valencia/València,172,Monserrat,3225,1669,1556
46,Valencia/València,173,Montaverner,1705,855,850
46,Valencia/València,174,Montesa,1413,725,688
46,Valencia/València,175,Montichelvo,638,333,305
46,Valencia/València,176,Montroy,1625,837,788
46,Valencia/València,177,Museros,4350,2173,2177
46,Valencia/València,178,Náquera,3445,1796,1649
46,Valencia/València,179,Navarrés,2900,1514,1386
46,Valencia/València,180,Novelé/Novetlè,638,307,331
46,Valencia/València,181,Oliva,22768,11358,11410
46,Valencia/València,182,Olocau,1037,544,493
46,Valencia/València,183,Olleria (l'),7517,3864,3653
46,Valencia/València,184,Ontinyent,34516,17242,17274
46,Valencia/València,185,Otos,505,259,246
46,Valencia/València,186,Paiporta,20032,10098,9934
46,Valencia/València,187,Palma de Gandía,1588,799,789
46,Valencia/València,188,Palmera,608,306,302
46,Valencia/València,189,Palomar (el),525,255,270
46,Valencia/València,190,Paterna,49683,24622,25061
46,Valencia/València,191,Pedralba,2366,1275,1091
46,Valencia/València,192,Petrés,860,431,429
46,Valencia/València,193,Picanya,9417,4695,4722
46,Valencia/València,194,Picassent,16769,8497,8272
46,Valencia/València,195,Piles,2303,1148,1155
46,Valencia/València,196,Pinet,193,101,92
46,Valencia/València,199,Pobla de Farnals (la),5917,3000,2917
46,Valencia/València,202,Pobla de Vallbona (la),14333,7344,6989
46,Valencia/València,200,Pobla del Duc (la),2580,1266,1314
46,Valencia/València,203,Pobla Llarga (la),4413,2189,2224
46,Valencia/València,197,Polinyà de Xúquer,2986,1465,1521
46,Valencia/València,198,Potríes,916,446,470
46,Valencia/València,205,Puçol,15524,7664,7860
46,Valencia/València,201,Puebla de San Miguel,77,44,33
46,Valencia/València,204,Puig,7815,3897,3918
46,Valencia/València,101,Quart de les Valls,1091,515,576
46,Valencia/València,102,Quart de Poblet,25780,12762,13018
46,Valencia/València,103,Quartell,1385,675,710
46,Valencia/València,104,Quatretonda,2531,1293,1238
46,Valencia/València,206,Quesa,760,396,364
46,Valencia/València,207,Rafelbuñol/Rafelbunyol,6107,3017,3090
46,Valencia/València,208,Rafelcofer,1376,663,713
46,Valencia/València,209,Rafelguaraf,2389,1174,1215
46,Valencia/València,210,Ráfol de Salem,369,174,195
46,Valencia/València,211,Real de Gandía,1859,914,945
46,Valencia/València,212,Real de Montroi,1854,968,886
46,Valencia/València,213,Requena,19740,9938,9802
46,Valencia/València,214,Riba-roja de Túria,14999,7569,7430
46,Valencia/València,215,Riola,1684,842,842
46,Valencia/València,216,Rocafort,5858,2878,2980
46,Valencia/València,217,Rotglà i Corberà,993,484,509
46,Valencia/València,218,Rótova,1251,637,614
46,Valencia/València,219,Rugat,197,95,102
46,Valencia/València,220,Sagunto/Sagunt,58287,28600,29687
46,Valencia/València,221,Salem,478,245,233
46,Valencia/València,903,San Antonio de Benagéber,3508,1769,1739
46,Valencia/València,222,San Juan de Énova,375,174,201
46,Valencia/València,223,Sedaví,8641,4275,4366
46,Valencia/València,224,Segart,175,79,96
46,Valencia/València,225,Sellent,469,244,225
46,Valencia/València,226,Sempere,35,16,19
46,Valencia/València,227,Senyera,1008,489,519
46,Valencia/València,228,Serra,2101,1094,1007
46,Valencia/València,229,Siete Aguas,1218,635,583
46,Valencia/València,230,Silla,16022,8125,7897
46,Valencia/València,231,Simat de la Valldigna,3204,1643,1561
46,Valencia/València,232,Sinarcas,1220,622,598
46,Valencia/València,233,Sollana,4490,2205,2285
46,Valencia/València,234,Sot de Chera,375,189,186
46,Valencia/València,235,Sueca,26361,13006,13355
46,Valencia/València,236,Sumacàrcer,1320,671,649
46,Valencia/València,237,Tavernes Blanques,8935,4422,4513
46,Valencia/València,238,Tavernes de la Valldigna,17106,8605,8501
46,Valencia/València,239,Teresa de Cofrentes,677,351,326
46,Valencia/València,240,Terrateig,350,172,178
46,Valencia/València,241,Titaguas,553,294,259
46,Valencia/València,242,Torrebaja,444,231,213
46,Valencia/València,243,Torrella,161,85,76
46,Valencia/València,244,Torrent,69620,34693,34927
46,Valencia/València,245,Torres Torres,483,251,232
46,Valencia/València,246,Tous,1100,533,567
46,Valencia/València,247,Tuéjar,1186,623,563
46,Valencia/València,248,Turís,5100,2646,2454
46,Valencia/València,249,Utiel,11845,5913,5932
46,Valencia/València,250,Valencia,780653,373613,407040
46,Valencia/València,251,Vallada,3275,1674,1601
46,Valencia/València,252,Vallanca,229,114,115
46,Valencia/València,253,Vallés,98,56,42
46,Valencia/València,254,Venta del Moro,1526,786,740
46,Valencia/València,256,Vilamarxant,6516,3383,3133
46,Valencia/València,255,Villalonga,3843,1925,1918
46,Valencia/València,257,Villanueva de Castellón,7286,3603,3683
46,Valencia/València,258,Villar del Arzobispo,3470,1754,1716
46,Valencia/València,259,Villargordo del Cabriel,699,361,338
46,Valencia/València,260,Vinalesa,2511,1207,1304
46,Valencia/València,145,Xàtiva,27300,13469,13831
46,Valencia/València,143,Xeraco,5356,2710,2646
46,Valencia/València,146,Xeresa,1942,979,963
46,Valencia/València,110,Xirivella,28044,13920,14124
46,Valencia/València,261,Yátova,1961,1024,937
46,Valencia/València,262,Yesa (La),254,130,124
46,Valencia/València,263,Zarra,413,224,189
47,Valladolid,1,Adalia,74,39,35
47,Valladolid,2,Aguasal,25,13,12
47,Valladolid,3,Aguilar de Campos,349,188,161
47,Valladolid,4,Alaejos,1551,809,742
47,Valladolid,5,Alcazarén,689,370,319
47,Valladolid,6,Aldea de San Miguel,211,106,105
47,Valladolid,7,Aldeamayor de San Martín,1718,855,863
47,Valladolid,8,Almenara de Adaja,34,20,14
47,Valladolid,9,Amusquillo,159,86,73
47,Valladolid,10,Arroyo de la Encomienda,5087,2616,2471
47,Valladolid,11,Ataquines,821,435,386
47,Valladolid,12,Bahabón,193,95,98
47,Valladolid,13,Barcial de la Loma,149,77,72
47,Valladolid,14,Barruelo del Valle,73,42,31
47,Valladolid,15,Becilla de Valderaduey,363,195,168
47,Valladolid,16,Benafarces,104,52,52
47,Valladolid,17,Bercero,252,133,119
47,Valladolid,18,Berceruelo,41,24,17
47,Valladolid,19,Berrueces,110,63,47
47,Valladolid,20,Bobadilla del Campo,392,212,180
47,Valladolid,21,Bocigas,132,64,68
47,Valladolid,22,Bocos de Duero,77,34,43
47,Valladolid,23,Boecillo,2062,1049,1013
47,Valladolid,24,Bolaños de Campos,386,199,187
47,Valladolid,25,Brahojos de Medina,164,87,77
47,Valladolid,26,Bustillo de Chaves,113,58,55
47,Valladolid,27,Cabezón de Pisuerga,2131,1092,1039
47,Valladolid,28,Cabezón de Valderaduey,53,31,22
47,Valladolid,29,Cabreros del Monte,83,44,39
47,Valladolid,30,Campaspero,1393,730,663
47,Valladolid,31,Campillo (El),239,137,102
47,Valladolid,32,Camporredondo,202,116,86
47,Valladolid,33,Canalejas de Peñafiel,275,140,135
47,Valladolid,34,Canillas de Esgueva,126,68,58
47,Valladolid,35,Carpio,1113,593,520
47,Valladolid,36,Casasola de Arión,326,184,142
47,Valladolid,37,Castrejón de Trabancos,250,132,118
47,Valladolid,38,Castrillo de Duero,173,85,88
47,Valladolid,39,Castrillo-Tejeriego,231,123,108
47,Valladolid,40,Castrobol,102,46,56
47,Valladolid,41,Castrodeza,226,120,106
47,Valladolid,42,Castromembibre,81,44,37
47,Valladolid,43,Castromonte,400,204,196
47,Valladolid,44,Castronuevo de Esgueva,326,173,153
47,Valladolid,45,Castronuño,1029,514,515
47,Valladolid,46,Castroponce,172,92,80
47,Valladolid,47,Castroverde de Cerrato,264,153,111
47,Valladolid,48,Ceinos de Campos,286,148,138
47,Valladolid,49,Cervillego de la Cruz,141,70,71
47,Valladolid,50,Cigales,3169,1570,1599
47,Valladolid,51,Ciguñuela,357,190,167
47,Valladolid,52,Cistérniga,4641,2410,2231
47,Valladolid,53,Cogeces de Íscar,148,80,68
47,Valladolid,54,Cogeces del Monte,868,487,381
47,Valladolid,55,Corcos,249,134,115
47,Valladolid,56,Corrales de Duero,123,74,49
47,Valladolid,57,Cubillas de Santa Marta,294,160,134
47,Valladolid,58,Cuenca de Campos,261,129,132
47,Valladolid,59,Curiel de Duero,103,58,45
47,Valladolid,60,Encinas de Esgueva,335,181,154
47,Valladolid,61,Esguevillas de Esgueva,360,186,174
47,Valladolid,62,Fombellida,242,128,114
47,Valladolid,63,Fompedraza,148,82,66
47,Valladolid,64,Fontihoyuelo,38,25,13
47,Valladolid,65,Fresno el Viejo,1196,611,585
47,Valladolid,66,Fuensaldaña,1116,556,560
47,Valladolid,67,Fuente el Sol,273,141,132
47,Valladolid,68,Fuente-Olmedo,56,29,27
47,Valladolid,69,Gallegos de Hornija,149,74,75
47,Valladolid,70,Gatón de Campos,36,23,13
47,Valladolid,71,Geria,472,259,213
47,Valladolid,73,Herrín de Campos,200,93,107
47,Valladolid,74,Hornillos de Eresma,190,101,89
47,Valladolid,75,Íscar,6446,3276,3170
47,Valladolid,76,Laguna de Duero,20045,10167,9878
47,Valladolid,77,Langayo,403,225,178
47,Valladolid,78,Lomoviejo,243,121,122
47,Valladolid,79,Llano de Olmedo,85,47,38
47,Valladolid,80,Manzanillo,50,26,24
47,Valladolid,81,Marzales,65,33,32
47,Valladolid,82,Matapozuelos,1019,516,503
47,Valladolid,83,Matilla de los Caños,108,64,44
47,Valladolid,84,Mayorga,1934,974,960
47,Valladolid,86,Medina de Rioseco,5009,2456,2553
47,Valladolid,85,Medina del Campo,20046,9809,10237
47,Valladolid,87,Megeces,460,232,228
47,Valladolid,88,Melgar de Abajo,175,92,83
47,Valladolid,89,Melgar de Arriba,286,149,137
47,Valladolid,90,Mojados,2858,1430,1428
47,Valladolid,91,Monasterio de Vega,104,55,49
47,Valladolid,92,Montealegre de Campos,139,80,59
47,Valladolid,93,Montemayor de Pililla,1025,536,489
47,Valladolid,94,Moral de la Reina,218,111,107
47,Valladolid,95,Moraleja de las Panaderas,34,24,10
47,Valladolid,96,Morales de Campos,189,94,95
47,Valladolid,97,Mota del Marqués,442,220,222
47,Valladolid,98,Mucientes,625,322,303
47,Valladolid,99,Mudarra (La),237,128,109
47,Valladolid,100,Muriel,214,109,105
47,Valladolid,101,Nava del Rey,2144,1087,1057
47,Valladolid,102,Nueva Villa de las Torres,400,224,176
47,Valladolid,103,Olivares de Duero,336,185,151
47,Valladolid,104,Olmedo,3478,1678,1800
47,Valladolid,105,Olmos de Esgueva,222,126,96
47,Valladolid,106,Olmos de Peñafiel,81,40,41
47,Valladolid,109,Palazuelo de Vedija,250,132,118
47,Valladolid,110,Parrilla (La),622,301,321
47,Valladolid,111,Pedraja de Portillo (La),1111,568,543
47,Valladolid,112,Pedrajas de San Esteban,3275,1674,1601
47,Valladolid,113,Pedrosa del Rey,215,116,99
47,Valladolid,114,Peñafiel,5433,2711,2722
47,Valladolid,115,Peñaflor de Hornija,423,227,196
47,Valladolid,116,Pesquera de Duero,541,279,262
47,Valladolid,117,Piña de Esgueva,370,186,184
47,Valladolid,118,Piñel de Abajo,201,105,96
47,Valladolid,119,Piñel de Arriba,139,66,73
47,Valladolid,121,Pollos,779,406,373
47,Valladolid,122,Portillo,2566,1315,1251
47,Valladolid,123,Pozal de Gallinas,491,266,225
47,Valladolid,124,Pozaldez,496,247,249
47,Valladolid,125,Pozuelo de la Orden,71,40,31
47,Valladolid,126,Puras,64,30,34
47,Valladolid,127,Quintanilla de Arriba,223,117,106
47,Valladolid,129,Quintanilla de Onésimo,1135,583,552
47,Valladolid,130,Quintanilla de Trigueros,115,59,56
47,Valladolid,128,Quintanilla del Molar,78,34,44
47,Valladolid,131,Rábano,249,125,124
47,Valladolid,132,Ramiro,73,42,31
47,Valladolid,133,Renedo de Esgueva,1233,645,588
47,Valladolid,134,Roales de Campos,248,124,124
47,Valladolid,135,Robladillo,110,52,58
47,Valladolid,137,Roturas,33,18,15
47,Valladolid,138,Rubí de Bracamonte,303,158,145
47,Valladolid,139,Rueda,1415,720,695
47,Valladolid,140,Saelices de Mayorga,187,101,86
47,Valladolid,141,Salvador de Zapardiel,191,105,86
47,Valladolid,142,San Cebrián de Mazote,211,114,97
47,Valladolid,143,San Llorente,188,105,83
47,Valladolid,144,San Martín de Valvení,101,54,47
47,Valladolid,145,San Miguel del Arroyo,775,399,376
47,Valladolid,146,San Miguel del Pino,223,117,106
47,Valladolid,147,San Pablo de la Moraleja,168,90,78
47,Valladolid,148,San Pedro de Latarce,617,328,289
47,Valladolid,149,San Pelayo,45,26,19
47,Valladolid,150,San Román de Hornija,416,198,218
47,Valladolid,151,San Salvador,44,24,20
47,Valladolid,156,San Vicente del Palacio,230,121,109
47,Valladolid,152,Santa Eufemia del Arroyo,154,74,80
47,Valladolid,153,Santervás de Campos,152,84,68
47,Valladolid,154,Santibáñez de Valcorba,197,95,102
47,Valladolid,155,Santovenia de Pisuerga,2719,1372,1347
47,Valladolid,157,Sardón de Duero,667,333,334
47,Valladolid,158,Seca (La),1033,541,492
47,Valladolid,159,Serrada,1073,554,519
47,Valladolid,160,Siete Iglesias de Trabancos,575,302,273
47,Valladolid,161,Simancas,4204,2149,2055
47,Valladolid,162,Tamariz de Campos,107,55,52
47,Valladolid,163,Tiedra,404,199,205
47,Valladolid,164,Tordehumos,523,263,260
47,Valladolid,165,Tordesillas,8150,4126,4024
47,Valladolid,169,Torre de Esgueva,99,49,50
47,Valladolid,170,Torre de Peñafiel,50,27,23
47,Valladolid,166,Torrecilla de la Abadesa,333,170,163
47,Valladolid,167,Torrecilla de la Orden,338,168,170
47,Valladolid,168,Torrecilla de la Torre,33,21,12
47,Valladolid,171,Torrelobatón,557,277,280
47,Valladolid,172,Torrescárcela,161,84,77
47,Valladolid,173,Traspinedo,854,455,399
47,Valladolid,174,Trigueros del Valle,328,175,153
47,Valladolid,175,Tudela de Duero,6733,3472,3261
47,Valladolid,176,Unión de Campos (La),303,152,151
47,Valladolid,177,Urones de Castroponce,148,81,67
47,Valladolid,178,Urueña,216,115,101
47,Valladolid,179,Valbuena de Duero,509,267,242
47,Valladolid,180,Valdearcos de la Vega,120,65,55
47,Valladolid,181,Valdenebro de los Valles,230,117,113
47,Valladolid,182,Valdestillas,1611,821,790
47,Valladolid,183,Valdunquillo,217,101,116
47,Valladolid,184,Valoria la Buena,659,349,310
47,Valladolid,185,Valverde de Campos,108,62,46
47,Valladolid,186,Valladolid,321143,154222,166921
47,Valladolid,187,Vega de Ruiponce,123,63,60
47,Valladolid,188,Vega de Valdetronco,163,88,75
47,Valladolid,189,Velascálvaro,189,104,85
47,Valladolid,190,Velilla,148,72,76
47,Valladolid,191,Velliza,162,100,62
47,Valladolid,192,Ventosa de la Cuesta,142,76,66
47,Valladolid,193,Viana de Cega,1619,829,790
47,Valladolid,194,Viloria,388,215,173
47,Valladolid,195,Villabáñez,476,261,215
47,Valladolid,196,Villabaruz de Campos,42,21,21
47,Valladolid,197,Villabrágima,1162,612,550
47,Valladolid,198,Villacarralón,93,50,43
47,Valladolid,199,Villacid de Campos,104,58,46
47,Valladolid,200,Villaco,127,77,50
47,Valladolid,203,Villafrades de Campos,99,44,55
47,Valladolid,204,Villafranca de Duero,347,177,170
47,Valladolid,205,Villafrechós,509,267,242
47,Valladolid,206,Villafuerte,145,75,70
47,Valladolid,207,Villagarcía de Campos,421,223,198
47,Valladolid,208,Villagómez la Nueva,90,47,43
47,Valladolid,209,Villalán de Campos,53,28,25
47,Valladolid,210,Villalar de los Comuneros,464,223,241
47,Valladolid,211,Villalba de la Loma,47,25,22
47,Valladolid,212,Villalba de los Alcores,548,288,260
47,Valladolid,213,Villalbarba,160,80,80
47,Valladolid,214,Villalón de Campos,2019,1000,1019
47,Valladolid,215,Villamuriel de Campos,78,36,42
47,Valladolid,216,Villán de Tordesillas,178,90,88
47,Valladolid,217,Villanubla,1237,648,589
47,Valladolid,218,Villanueva de Duero,1024,521,503
47,Valladolid,219,Villanueva de la Condesa,43,27,16
47,Valladolid,220,Villanueva de los Caballeros,248,123,125
47,Valladolid,221,Villanueva de los Infantes,141,78,63
47,Valladolid,222,Villanueva de San Mancio,126,66,60
47,Valladolid,223,Villardefrades,226,119,107
47,Valladolid,224,Villarmentero de Esgueva,117,58,59
47,Valladolid,225,Villasexmir,114,58,56
47,Valladolid,226,Villavaquerín,200,101,99
47,Valladolid,227,Villavellid,70,39,31
47,Valladolid,228,Villaverde de Medina,572,303,269
47,Valladolid,229,Villavicencio de los Caballeros,292,132,160
47,Valladolid,230,Wamba,375,200,175
47,Valladolid,231,Zaratán,1812,936,876
47,Valladolid,232,Zarza (La),148,74,74
48,Vizcaya,1,Abadiño,6996,3509,3487
48,Vizcaya,2,Abanto y Ciérvana-Abanto Zierbena,9190,4550,4640
48,Vizcaya,911,Ajangiz,430,217,213
48,Vizcaya,912,Alonsotegi,2658,1294,1364
48,Vizcaya,3,Amorebieta-Etxano,16398,8162,8236
48,Vizcaya,4,Amoroto,378,197,181
48,Vizcaya,5,Arakaldo,94,56,38
48,Vizcaya,6,Arantzazu,285,138,147
48,Vizcaya,93,Areatza,1027,469,558
48,Vizcaya,9,Arrankudiaga,775,380,395
48,Vizcaya,914,Arratzu,363,182,181
48,Vizcaya,10,Arrieta,505,262,243
48,Vizcaya,11,Arrigorriaga,11515,5705,5810
48,Vizcaya,23,Artea,657,325,332
48,Vizcaya,8,Artzentales,666,368,298
48,Vizcaya,91,Atxondo,1451,739,712
48,Vizcaya,70,Aulesti,654,335,319
48,Vizcaya,12,Bakio,1832,922,910
48,Vizcaya,90,Balmaseda,7043,3421,3622
48,Vizcaya,13,Barakaldo,94727,46242,48485
48,Vizcaya,14,Barrika,1239,629,610
48,Vizcaya,15,Basauri,44935,22233,22702
48,Vizcaya,92,Bedia,985,493,492
48,Vizcaya,16,Berango,5612,2793,2819
48,Vizcaya,17,Bermeo,16906,8316,8590
48,Vizcaya,18,Berriatua,1023,534,489
48,Vizcaya,19,Berriz,4445,2271,2174
48,Vizcaya,20,Bilbao,353567,167520,186047
48,Vizcaya,21,Busturia,1665,834,831
48,Vizcaya,901,Derio,4935,2469,2466
48,Vizcaya,26,Dima,1079,560,519
48,Vizcaya,27,Durango,25735,12551,13184
48,Vizcaya,28,Ea,796,397,399
48,Vizcaya,31,Elantxobe,460,205,255
48,Vizcaya,32,Elorrio,7170,3575,3595
48,Vizcaya,902,Erandio,22876,11291,11585
48,Vizcaya,33,Ereño,251,125,126
48,Vizcaya,34,Ermua,16735,8516,8219
48,Vizcaya,79,Errigoiti,499,285,214
48,Vizcaya,29,"Etxebarri, Anteiglesia de San Esteban-Etxebarri Doneztebeko Elizatea",7390,3785,3605
48,Vizcaya,30,Etxebarria,790,411,379
48,Vizcaya,906,Forua,1002,508,494
48,Vizcaya,35,Fruiz,357,175,182
48,Vizcaya,36,Galdakao,29765,14734,15031
48,Vizcaya,37,Galdames,802,415,387
48,Vizcaya,38,Gamiz-Fika,1227,631,596
48,Vizcaya,39,Garay,275,137,138
48,Vizcaya,40,Gatika,1295,660,635
48,Vizcaya,41,Gautegiz Arteaga,867,444,423
48,Vizcaya,46,Gernika-Lumo,15454,7506,7948
48,Vizcaya,44,Getxo,83624,39817,43807
48,Vizcaya,47,Gizaburuaga,140,73,67
48,Vizcaya,42,Gordexola,1533,769,764
48,Vizcaya,43,Gorliz,4652,2325,2327
48,Vizcaya,45,Güeñes,5960,2912,3048
48,Vizcaya,48,Ibarrangelu,540,259,281
48,Vizcaya,94,Igorre,3995,2000,1995
48,Vizcaya,49,Ispaster,613,319,294
48,Vizcaya,910,Iurreta,4146,2061,2085
48,Vizcaya,50,Izurtza,263,135,128
48,Vizcaya,22,Karrantza Harana/Valle de Carranza,2909,1523,1386
48,Vizcaya,907,Kortezubi,371,190,181
48,Vizcaya,51,Lanestosa,286,143,143
48,Vizcaya,52,Larrabetzu,1607,793,814
48,Vizcaya,53,Laukiz,994,501,493
48,Vizcaya,54,Leioa,28893,14211,14682
48,Vizcaya,57,Lekeitio,7354,3643,3711
48,Vizcaya,55,Lemoa,2767,1381,1386
48,Vizcaya,56,Lemoiz,888,465,423
48,Vizcaya,81,Lezama,2182,1104,1078
48,Vizcaya,903,Loiu,2129,1101,1028
48,Vizcaya,58,Mallabia,1119,594,525
48,Vizcaya,59,Mañaria,453,231,222
48,Vizcaya,60,Markina-Xemein,4713,2382,2331
48,Vizcaya,61,Maruri-Jatabe,732,365,367
48,Vizcaya,62,Mendata,342,179,163
48,Vizcaya,63,Mendexa,348,186,162
48,Vizcaya,64,Meñaka,535,268,267
48,Vizcaya,66,Morga,422,233,189
48,Vizcaya,68,Mundaka,1837,899,938
48,Vizcaya,69,Mungia,14285,6989,7296
48,Vizcaya,7,Munitibar-Arbatzegi Gerrikaitz,382,203,179
48,Vizcaya,908,Murueta,264,136,128
48,Vizcaya,71,Muskiz,6573,3221,3352
48,Vizcaya,67,Muxika,1302,671,631
48,Vizcaya,909,Nabarniz,226,112,114
48,Vizcaya,73,Ondarroa,9761,4960,4801
48,Vizcaya,75,Orozko,2204,1109,1095
48,Vizcaya,83,Ortuella,8763,4264,4499
48,Vizcaya,72,Otxandio,1025,539,486
48,Vizcaya,77,Plentzia,3763,1828,1935
48,Vizcaya,78,Portugalete,50927,24804,26123
48,Vizcaya,82,Santurtzi,47160,23000,24160
48,Vizcaya,84,Sestao,31527,15387,16140
48,Vizcaya,904,Sondika,4142,2013,2129
48,Vizcaya,85,Sopelana,10894,5374,5520
48,Vizcaya,86,Sopuerta,2225,1130,1095
48,Vizcaya,76,Sukarrieta,330,173,157
48,Vizcaya,87,Trucios-Turtzioz,521,255,266
48,Vizcaya,88,Ubide,171,89,82
48,Vizcaya,65,Ugao-Miraballes,4099,2074,2025
48,Vizcaya,89,Urduliz,3161,1591,1570
48,Vizcaya,74,Urduña-Orduña,3991,2058,1933
48,Vizcaya,80,Valle de Trápaga-Trapagaran,12686,6279,6407
48,Vizcaya,95,Zaldibar,2874,1406,1468
48,Vizcaya,96,Zalla,7888,3887,4001
48,Vizcaya,905,Zamudio,3101,1551,1550
48,Vizcaya,97,Zaratamo,1651,826,825
48,Vizcaya,24,Zeanuri,1144,594,550
48,Vizcaya,25,Zeberio,1016,533,483
48,Vizcaya,913,Zierbena,1244,672,572
49,Zamora,2,Abezames,95,49,46
49,Zamora,3,Alcañices,1140,566,574
49,Zamora,4,Alcubilla de Nogales,187,93,94
49,Zamora,5,Alfaraz de Sayago,200,110,90
49,Zamora,6,Algodre,179,90,89
49,Zamora,7,Almaraz de Duero,457,230,227
49,Zamora,8,Almeida de Sayago,629,315,314
49,Zamora,9,Andavías,472,232,240
49,Zamora,10,Arcenillas,310,156,154
49,Zamora,11,Arcos de la Polvorosa,289,152,137
49,Zamora,12,Argañín,93,45,48
49,Zamora,13,Argujillo,367,193,174
49,Zamora,14,Arquillinos,170,89,81
49,Zamora,15,Arrabalde,383,181,202
49,Zamora,16,Aspariegos,336,167,169
49,Zamora,17,Asturianos,312,160,152
49,Zamora,18,Ayoó de Vidriales,428,217,211
49,Zamora,19,Barcial del Barco,309,174,135
49,Zamora,20,Belver de los Montes,431,232,199
49,Zamora,21,Benavente,17483,8560,8923
49,Zamora,22,Benegiles,397,208,189
49,Zamora,23,Bermillo de Sayago,1348,711,637
49,Zamora,24,Bóveda de Toro (La),925,467,458
49,Zamora,25,Bretó,235,119,116
49,Zamora,26,Bretocino,314,164,150
49,Zamora,27,Brime de Sog,230,107,123
49,Zamora,28,Brime de Urz,163,85,78
49,Zamora,29,Burganes de Valverde,878,461,417
49,Zamora,30,Bustillo del Oro,144,71,73
49,Zamora,31,Cabañas de Sayago,198,98,100
49,Zamora,32,Calzadilla de Tera,476,228,248
49,Zamora,33,Camarzana de Tera,1023,487,536
49,Zamora,34,Cañizal,588,310,278
49,Zamora,35,Cañizo,314,167,147
49,Zamora,36,Carbajales de Alba,694,354,340
49,Zamora,37,Carbellino,256,128,128
49,Zamora,38,Casaseca de Campeán,140,78,62
49,Zamora,39,Casaseca de las Chanas,348,179,169
49,Zamora,40,Castrillo de la Guareña,158,79,79
49,Zamora,41,Castrogonzalo,541,293,248
49,Zamora,42,Castronuevo,349,173,176
49,Zamora,43,Castroverde de Campos,406,208,198
49,Zamora,44,Cazurra,91,49,42
49,Zamora,46,Cerecinos de Campos,403,205,198
49,Zamora,47,Cerecinos del Carrizal,152,85,67
49,Zamora,48,Cernadilla,187,92,95
49,Zamora,50,Cobreros,702,353,349
49,Zamora,52,Coomonte,306,153,153
49,Zamora,53,Coreses,1166,594,572
49,Zamora,54,Corrales,1086,518,568
49,Zamora,55,Cotanes del Monte,149,80,69
49,Zamora,56,Cubillos,391,198,193
49,Zamora,57,Cubo de Benavente,166,87,79
49,Zamora,58,Cubo de Tierra del Vino (El),451,236,215
49,Zamora,59,Cuelgamures,134,78,56
49,Zamora,61,Entrala,181,91,90
49,Zamora,62,Espadañedo,191,92,99
49,Zamora,63,Faramontanos de Tábara,487,246,241
49,Zamora,64,Fariza,684,340,344
49,Zamora,65,Fermoselle,1560,795,765
49,Zamora,66,Ferreras de Abajo,662,326,336
49,Zamora,67,Ferreras de Arriba,517,259,258
49,Zamora,68,Ferreruela,614,314,300
49,Zamora,69,Figueruela de Arriba,530,249,281
49,Zamora,71,Fonfría,1124,575,549
49,Zamora,75,Fresno de la Polvorosa,201,97,104
49,Zamora,76,Fresno de la Ribera,426,232,194
49,Zamora,77,Fresno de Sayago,245,122,123
49,Zamora,78,Friera de Valverde,258,132,126
49,Zamora,79,Fuente Encalada,135,71,64
49,Zamora,80,Fuentelapeña,956,492,464
49,Zamora,82,Fuentes de Ropel,569,299,270
49,Zamora,81,Fuentesaúco,1848,939,909
49,Zamora,83,Fuentesecas,92,42,50
49,Zamora,84,Fuentespreadas,380,205,175
49,Zamora,85,Galende,1402,711,691
49,Zamora,86,Gallegos del Pan,156,80,76
49,Zamora,87,Gallegos del Río,782,412,370
49,Zamora,88,Gamones,89,50,39
49,Zamora,90,Gema,249,120,129
49,Zamora,91,Granja de Moreruela,345,174,171
49,Zamora,92,Granucillo,253,133,120
49,Zamora,93,Guarrate,379,197,182
49,Zamora,94,Hermisende,404,217,187
49,Zamora,95,Hiniesta (La),373,177,196
49,Zamora,96,Jambrina,231,115,116
49,Zamora,97,Justel,154,85,69
49,Zamora,98,Losacino,326,173,153
49,Zamora,99,Losacio,139,73,66
49,Zamora,100,Lubián,353,172,181
49,Zamora,101,Luelmo,236,119,117
49,Zamora,102,Maderal (El),281,150,131
49,Zamora,103,Madridanos,539,266,273
49,Zamora,104,Mahide,514,270,244
49,Zamora,105,Maire de Castroponce,233,119,114
49,Zamora,107,Malva,211,111,100
49,Zamora,108,Manganeses de la Lampreana,716,354,362
49,Zamora,109,Manganeses de la Polvorosa,827,401,426
49,Zamora,110,Manzanal de Arriba,450,235,215
49,Zamora,112,Manzanal de los Infantes,187,100,87
49,Zamora,111,Manzanal del Barco,194,101,93
49,Zamora,113,Matilla de Arzón,249,135,114
49,Zamora,114,Matilla la Seca,69,34,35
49,Zamora,115,Mayalde,244,123,121
49,Zamora,116,Melgar de Tera,548,272,276
49,Zamora,117,Micereces de Tera,627,327,300
49,Zamora,118,Milles de la Polvorosa,268,136,132
49,Zamora,119,Molacillos,280,147,133
49,Zamora,120,Molezuelas de la Carballeda,95,47,48
49,Zamora,121,Mombuey,459,229,230
49,Zamora,122,Monfarracinos,703,370,333
49,Zamora,123,Montamarta,645,325,320
49,Zamora,124,Moral de Sayago,350,192,158
49,Zamora,126,Moraleja de Sayago,309,162,147
49,Zamora,125,Moraleja del Vino,1301,693,608
49,Zamora,128,Morales de Rey,728,354,374
49,Zamora,129,Morales de Toro,1049,526,523
49,Zamora,130,Morales de Valverde,277,134,143
49,Zamora,127,Morales del Vino,1888,972,916
49,Zamora,131,Moralina,349,173,176
49,Zamora,132,Moreruela de los Infanzones,439,226,213
49,Zamora,133,Moreruela de Tábara,493,263,230
49,Zamora,134,Muelas de los Caballeros,245,141,104
49,Zamora,135,Muelas del Pan,851,426,425
49,Zamora,136,Muga de Sayago,486,235,251
49,Zamora,137,Navianos de Valverde,251,134,117
49,Zamora,138,Olmillos de Castro,389,204,185
49,Zamora,139,Otero de Bodas,241,129,112
49,Zamora,141,Pajares de la Lampreana,496,245,251
49,Zamora,143,Palacios de Sanabria,324,155,169
49,Zamora,142,Palacios del Pan,248,111,137
49,Zamora,145,Pedralba de la Pradería,292,139,153
49,Zamora,146,Pego (El),421,216,205
49,Zamora,147,Peleagonzalo,405,205,200
49,Zamora,148,Peleas de Abajo,291,129,162
49,Zamora,149,Peñausende,519,256,263
49,Zamora,150,Peque,194,94,100
49,Zamora,151,Perdigón (El),779,402,377
49,Zamora,152,Pereruela,686,351,335
49,Zamora,153,Perilla de Castro,244,121,123
49,Zamora,154,Pías,208,105,103
49,Zamora,155,Piedrahita de Castro,143,80,63
49,Zamora,156,Pinilla de Toro,355,176,179
49,Zamora,157,Pino del Oro,233,125,108
49,Zamora,158,Piñero (El),286,149,137
49,Zamora,160,Pobladura de Valderaduey,72,35,37
49,Zamora,159,Pobladura del Valle,338,170,168
49,Zamora,162,Porto,308,163,145
49,Zamora,163,Pozoantiguo,321,165,156
49,Zamora,164,Pozuelo de Tábara,214,108,106
49,Zamora,165,Prado,100,52,48
49,Zamora,166,Puebla de Sanabria,1617,780,837
49,Zamora,167,Pueblica de Valverde,295,150,145
49,Zamora,170,Quintanilla de Urz,157,78,79
49,Zamora,168,Quintanilla del Monte,131,63,68
49,Zamora,169,Quintanilla del Olmo,54,25,29
49,Zamora,171,Quiruelas de Vidriales,943,447,496
49,Zamora,172,Rabanales,780,406,374
49,Zamora,173,Rábano de Aliste,456,233,223
49,Zamora,174,Requejo,171,84,87
49,Zamora,175,Revellinos,320,177,143
49,Zamora,176,Riofrío de Aliste,1034,542,492
49,Zamora,177,Rionegro del Puente,391,197,194
49,Zamora,178,Roales,506,261,245
49,Zamora,179,Robleda-Cervantes,482,240,242
49,Zamora,180,Roelos de Sayago,158,83,75
49,Zamora,181,Rosinos de la Requejada,516,253,263
49,Zamora,183,Salce,126,68,58
49,Zamora,184,Samir de los Caños,229,119,110
49,Zamora,185,San Agustín del Pozo,195,106,89
49,Zamora,186,San Cebrián de Castro,349,165,184
49,Zamora,187,San Cristóbal de Entreviñas,1647,846,801
49,Zamora,188,San Esteban del Molar,167,85,82
49,Zamora,189,San Justo,350,173,177
49,Zamora,190,San Martín de Valderaduey,89,44,45
49,Zamora,191,San Miguel de la Ribera,376,190,186
49,Zamora,192,San Miguel del Valle,216,103,113
49,Zamora,193,San Pedro de Ceque,668,332,336
49,Zamora,194,San Pedro de la Nave-Almendra,482,239,243
49,Zamora,208,San Vicente de la Cabeza,578,302,276
49,Zamora,209,San Vitero,685,368,317
49,Zamora,197,Santa Clara de Avedillo,249,122,127
49,Zamora,199,Santa Colomba de las Monjas,318,163,155
49,Zamora,200,Santa Cristina de la Polvorosa,1264,639,625
49,Zamora,201,Santa Croya de Tera,452,224,228
49,Zamora,202,Santa Eufemia del Barco,284,158,126
49,Zamora,203,Santa María de la Vega,470,247,223
49,Zamora,204,Santa María de Valverde,98,48,50
49,Zamora,205,Santibáñez de Tera,620,306,314
49,Zamora,206,Santibáñez de Vidriales,1334,663,671
49,Zamora,207,Santovenia,382,184,198
49,Zamora,210,Sanzoles,655,336,319
49,Zamora,214,Tábara,978,498,480
49,Zamora,216,Tapioles,229,123,106
49,Zamora,219,Toro,9166,4486,4680
49,Zamora,220,Torre del Valle (La),186,102,84
49,Zamora,221,Torregamones,329,167,162
49,Zamora,222,Torres del Carrizal,502,256,246
49,Zamora,223,Trabazos,933,475,458
49,Zamora,224,Trefacio,246,125,121
49,Zamora,225,Uña de Quintana,230,111,119
49,Zamora,226,Vadillo de la Guareña,357,186,171
49,Zamora,227,Valcabado,341,173,168
49,Zamora,228,Valdefinjas,96,53,43
49,Zamora,229,Valdescorriel,205,104,101
49,Zamora,230,Vallesa de la Guareña,165,91,74
49,Zamora,231,Vega de Tera,485,236,249
49,Zamora,232,Vega de Villalobos,155,71,84
49,Zamora,233,Vegalatrave,132,70,62
49,Zamora,234,Venialbo,508,271,237
49,Zamora,235,Vezdemarbán,649,320,329
49,Zamora,236,Vidayanes,105,49,56
49,Zamora,237,Videmala,207,98,109
49,Zamora,238,Villabrázaro,318,155,163
49,Zamora,239,Villabuena del Puente,927,496,431
49,Zamora,240,Villadepera,277,138,139
49,Zamora,241,Villaescusa,349,178,171
49,Zamora,242,Villafáfila,623,315,308
49,Zamora,243,Villaferrueña,151,77,74
49,Zamora,244,Villageriz,63,33,30
49,Zamora,245,Villalazán,383,189,194
49,Zamora,246,Villalba de la Lampreana,302,157,145
49,Zamora,247,Villalcampo,641,327,314
49,Zamora,248,Villalobos,302,148,154
49,Zamora,249,Villalonso,122,63,59
49,Zamora,250,Villalpando,1635,801,834
49,Zamora,251,Villalube,271,139,132
49,Zamora,252,Villamayor de Campos,511,260,251
49,Zamora,255,Villamor de los Escuderos,563,282,281
49,Zamora,256,Villanázar,375,180,195
49,Zamora,257,Villanueva de Azoague,322,166,156
49,Zamora,258,Villanueva de Campeán,167,83,84
49,Zamora,259,Villanueva de las Peras,174,87,87
49,Zamora,260,Villanueva del Campo,1054,526,528
49,Zamora,263,Villar de Fallaves,98,52,46
49,Zamora,264,Villar del Buey,812,436,376
49,Zamora,261,Villaralbo,1666,838,828
49,Zamora,262,Villardeciervos,513,243,270
49,Zamora,265,Villardiegua de la Ribera,169,83,86
49,Zamora,266,Villárdiga,104,53,51
49,Zamora,267,Villardondiego,124,69,55
49,Zamora,268,Villarrín de Campos,609,320,289
49,Zamora,269,Villaseco del Pan,283,136,147
49,Zamora,270,Villavendimio,208,116,92
49,Zamora,272,Villaveza de Valverde,128,66,62
49,Zamora,271,Villaveza del Agua,271,138,133
49,Zamora,273,Viñas,264,136,128
49,Zamora,275,Zamora,65639,31076,34563
50,Zaragoza,1,Abanto,158,86,72
50,Zaragoza,2,Acered,245,129,116
50,Zaragoza,3,Agón,197,105,92
50,Zaragoza,4,Aguarón,751,376,375
50,Zaragoza,5,Aguilón,293,143,150
50,Zaragoza,6,Ainzón,1211,635,576
50,Zaragoza,7,Aladrén,76,44,32
50,Zaragoza,8,Alagón,5907,2973,2934
50,Zaragoza,9,Alarba,145,82,63
50,Zaragoza,10,Alberite de San Juan,101,59,42
50,Zaragoza,11,Albeta,139,67,72
50,Zaragoza,12,Alborge,133,72,61
50,Zaragoza,13,Alcalá de Ebro,292,138,154
50,Zaragoza,14,Alcalá de Moncayo,135,72,63
50,Zaragoza,15,Alconchel de Ariza,135,75,60
50,Zaragoza,16,Aldehuela de Liestos,37,19,18
50,Zaragoza,17,Alfajarín,1611,818,793
50,Zaragoza,18,Alfamén,1498,860,638
50,Zaragoza,19,Alforque,85,47,38
50,Zaragoza,20,Alhama de Aragón,1150,576,574
50,Zaragoza,21,Almochuel,49,26,23
50,Zaragoza,22,Almolda (La),653,330,323
50,Zaragoza,23,Almonacid de la Cuba,312,158,154
50,Zaragoza,24,Almonacid de la Sierra,881,471,410
50,Zaragoza,25,Almunia de Doña Godina (La),6353,3325,3028
50,Zaragoza,26,Alpartir,600,315,285
50,Zaragoza,27,Ambel,336,150,186
50,Zaragoza,28,Anento,213,134,79
50,Zaragoza,29,Aniñón,848,457,391
50,Zaragoza,30,Añón de Moncayo,284,163,121
50,Zaragoza,31,Aranda de Moncayo,228,124,104
50,Zaragoza,32,Arándiga,459,234,225
50,Zaragoza,33,Ardisa,80,44,36
50,Zaragoza,34,Ariza,1337,696,641
50,Zaragoza,35,Artieda,104,62,42
50,Zaragoza,36,Asín,110,52,58
50,Zaragoza,37,Atea,191,109,82
50,Zaragoza,38,Ateca,2029,1010,1019
50,Zaragoza,39,Azuara,652,348,304
50,Zaragoza,40,Badules,110,58,52
50,Zaragoza,41,Bagüés,45,25,20
50,Zaragoza,42,Balconchán,23,10,13
50,Zaragoza,43,Bárboles,327,175,152
50,Zaragoza,44,Bardallur,278,132,146
50,Zaragoza,45,Belchite,1570,809,761
50,Zaragoza,46,Belmonte de Gracián,262,144,118
50,Zaragoza,47,Berdejo,65,39,26
50,Zaragoza,48,Berrueco,45,25,20
50,Zaragoza,901,Biel,213,120,93
50,Zaragoza,50,Bijuesca,123,73,50
50,Zaragoza,51,Biota,1179,604,575
50,Zaragoza,52,Bisimbre,122,53,69
50,Zaragoza,53,Boquiñeni,995,505,490
50,Zaragoza,54,Bordalba,94,55,39
50,Zaragoza,55,Borja,4313,2137,2176
50,Zaragoza,56,Botorrita,465,245,220
50,Zaragoza,57,Brea de Aragón,1999,1026,973
50,Zaragoza,58,Bubierca,93,48,45
50,Zaragoza,59,Bujaraloz,1006,530,476
50,Zaragoza,60,Bulbuente,243,133,110
50,Zaragoza,61,Bureta,310,161,149
50,Zaragoza,62,Burgo de Ebro (El),1695,873,822
50,Zaragoza,63,Buste (El),101,50,51
50,Zaragoza,64,Cabañas de Ebro,517,270,247
50,Zaragoza,65,Cabolafuente,70,39,31
50,Zaragoza,66,Cadrete,1916,1026,890
50,Zaragoza,67,Calatayud,19279,9553,9726
50,Zaragoza,68,Calatorao,2986,1630,1356
50,Zaragoza,69,Calcena,71,37,34
50,Zaragoza,70,Calmarza,88,46,42
50,Zaragoza,71,Campillo de Aragón,177,98,79
50,Zaragoza,72,Carenas,236,114,122
50,Zaragoza,73,Cariñena,3411,1847,1564
50,Zaragoza,74,Caspe,7587,3757,3830
50,Zaragoza,75,Castejón de Alarba,101,55,46
50,Zaragoza,76,Castejón de las Armas,105,53,52
50,Zaragoza,77,Castejón de Valdejasa,317,164,153
50,Zaragoza,78,Castiliscar,384,200,184
50,Zaragoza,79,Cervera de la Cañada,330,166,164
50,Zaragoza,80,Cerveruela,25,19,6
50,Zaragoza,81,Cetina,690,335,355
50,Zaragoza,82,Cimballa,156,76,80
50,Zaragoza,83,Cinco Olivas,123,60,63
50,Zaragoza,84,Clarés de Ribota,102,54,48
50,Zaragoza,85,Codo,234,117,117
50,Zaragoza,86,Codos,283,176,107
50,Zaragoza,87,Contamina,54,33,21
50,Zaragoza,88,Cosuenda,396,208,188
50,Zaragoza,89,Cuarte de Huerva,2249,1178,1071
50,Zaragoza,90,Cubel,207,100,107
50,Zaragoza,91,Cuerlas (Las),100,51,49
50,Zaragoza,92,Chiprana,383,194,189
50,Zaragoza,93,Chodes,117,55,62
50,Zaragoza,94,Daroca,2099,1057,1042
50,Zaragoza,95,Ejea de los Caballeros,16249,8507,7742
50,Zaragoza,96,Embid de Ariza,103,61,42
50,Zaragoza,98,Encinacorba,311,161,150
50,Zaragoza,99,Épila,4050,2130,1920
50,Zaragoza,100,Erla,445,219,226
50,Zaragoza,101,Escatrón,1189,576,613
50,Zaragoza,102,Fabara,1198,642,556
50,Zaragoza,104,Farlete,451,221,230
50,Zaragoza,105,Fayón,381,200,181
50,Zaragoza,106,Fayos (Los),179,89,90
50,Zaragoza,107,Figueruelas,1083,541,542
50,Zaragoza,108,Fombuena,15,12,3
50,Zaragoza,109,Frago (El),124,75,49
50,Zaragoza,110,Frasno (El),535,285,250
50,Zaragoza,111,Fréscano,223,111,112
50,Zaragoza,113,Fuendejalón,794,406,388
50,Zaragoza,114,Fuendetodos,178,95,83
50,Zaragoza,115,Fuentes de Ebro,4015,2120,1895
50,Zaragoza,116,Fuentes de Jiloca,317,164,153
50,Zaragoza,117,Gallocanta,175,93,82
50,Zaragoza,118,Gallur,2960,1522,1438
50,Zaragoza,119,Gelsa,1210,610,600
50,Zaragoza,120,Godojos,66,33,33
50,Zaragoza,121,Gotor,399,210,189
50,Zaragoza,122,Grisel,63,37,26
50,Zaragoza,123,Grisén,480,249,231
50,Zaragoza,124,Herrera de los Navarros,621,331,290
50,Zaragoza,125,Ibdes,530,280,250
50,Zaragoza,126,Illueca,3444,1695,1749
50,Zaragoza,128,Isuerre,56,37,19
50,Zaragoza,129,Jaraba,323,171,152
50,Zaragoza,130,Jarque,555,298,257
50,Zaragoza,131,Jaulín,287,150,137
50,Zaragoza,132,Joyosa (La),506,263,243
50,Zaragoza,133,Lagata,141,79,62
50,Zaragoza,134,Langa del Castillo,171,81,90
50,Zaragoza,135,Layana,125,63,62
50,Zaragoza,136,Lécera,786,392,394
50,Zaragoza,137,Leciñena,1296,655,641
50,Zaragoza,138,Lechón,59,36,23
50,Zaragoza,139,Letux,456,236,220
50,Zaragoza,140,Litago,203,113,90
50,Zaragoza,141,Lituénigo,122,60,62
50,Zaragoza,142,Lobera de Onsella,58,36,22
50,Zaragoza,143,Longares,999,583,416
50,Zaragoza,144,Longás,49,29,20
50,Zaragoza,146,Lucena de Jalón,245,125,120
50,Zaragoza,147,Luceni,1053,527,526
50,Zaragoza,148,Luesia,400,218,182
50,Zaragoza,149,Luesma,40,19,21
50,Zaragoza,150,Lumpiaque,943,495,448
50,Zaragoza,151,Luna,872,461,411
50,Zaragoza,152,Maella,2064,1084,980
50,Zaragoza,153,Magallón,1194,635,559
50,Zaragoza,154,Mainar,157,85,72
50,Zaragoza,155,Malanquilla,132,68,64
50,Zaragoza,156,Maleján,302,152,150
50,Zaragoza,157,Malón,432,226,206
50,Zaragoza,159,Maluenda,1026,504,522
50,Zaragoza,160,Mallén,3323,1797,1526
50,Zaragoza,161,Manchones,151,79,72
50,Zaragoza,162,Mara,208,101,107
50,Zaragoza,163,María de Huerva,1675,878,797
50,Zaragoza,902,Marracos,119,61,58
50,Zaragoza,164,Mediana de Aragón,510,251,259
50,Zaragoza,165,Mequinenza,2511,1250,1261
50,Zaragoza,166,Mesones de Isuela,344,166,178
50,Zaragoza,167,Mezalocha,281,157,124
50,Zaragoza,168,Mianos,44,24,20
50,Zaragoza,169,Miedes de Aragón,508,266,242
50,Zaragoza,170,Monegrillo,517,282,235
50,Zaragoza,171,Moneva,132,70,62
50,Zaragoza,172,Monreal de Ariza,265,140,125
50,Zaragoza,173,Monterde,228,122,106
50,Zaragoza,174,Montón,131,71,60
50,Zaragoza,175,Morata de Jalón,1422,696,726
50,Zaragoza,176,Morata de Jiloca,325,173,152
50,Zaragoza,177,Morés,438,234,204
50,Zaragoza,178,Moros,495,248,247
50,Zaragoza,179,Moyuela,320,170,150
50,Zaragoza,180,Mozota,121,59,62
50,Zaragoza,181,Muel,1135,583,552
50,Zaragoza,182,Muela (La),2310,1200,1110
50,Zaragoza,183,Munébrega,438,236,202
50,Zaragoza,184,Murero,138,78,60
50,Zaragoza,185,Murillo de Gállego,177,102,75
50,Zaragoza,186,Navardún,54,30,24
50,Zaragoza,187,Nigüella,105,59,46
50,Zaragoza,188,Nombrevilla,55,31,24
50,Zaragoza,189,Nonaspe,1045,539,506
50,Zaragoza,190,Novallas,815,406,409
50,Zaragoza,191,Novillas,669,345,324
50,Zaragoza,192,Nuévalos,393,208,185
50,Zaragoza,193,Nuez de Ebro,619,320,299
50,Zaragoza,194,Olvés,145,75,70
50,Zaragoza,195,Orcajo,42,22,20
50,Zaragoza,196,Orera,132,67,65
50,Zaragoza,197,Orés,113,63,50
50,Zaragoza,198,Oseja,47,27,20
50,Zaragoza,199,Osera de Ebro,383,189,194
50,Zaragoza,200,Paniza,734,386,348
50,Zaragoza,201,Paracuellos de Jiloca,497,241,256
50,Zaragoza,202,Paracuellos de la Ribera,249,120,129
50,Zaragoza,203,Pastriz,1160,567,593
50,Zaragoza,204,Pedrola,2862,1487,1375
50,Zaragoza,205,Pedrosas (Las),100,50,50
50,Zaragoza,206,Perdiguera,569,295,274
50,Zaragoza,207,Piedratajada,173,85,88
50,Zaragoza,208,Pina de Ebro,2335,1195,1140
50,Zaragoza,209,Pinseque,2019,1018,1001
50,Zaragoza,210,Pintanos (Los),102,55,47
50,Zaragoza,211,Plasencia de Jalón,370,205,165
50,Zaragoza,212,Pleitas,62,35,27
50,Zaragoza,213,Plenas,133,66,67
50,Zaragoza,214,Pomer,35,21,14
50,Zaragoza,215,Pozuel de Ariza,23,15,8
50,Zaragoza,216,Pozuelo de Aragón,347,191,156
50,Zaragoza,217,Pradilla de Ebro,630,326,304
50,Zaragoza,218,Puebla de Albortón,137,80,57
50,Zaragoza,219,Puebla de Alfindén (La),2567,1312,1255
50,Zaragoza,220,Puendeluna,63,39,24
50,Zaragoza,221,Purujosa,60,42,18
50,Zaragoza,222,Quinto,2075,1029,1046
50,Zaragoza,223,Remolinos,1237,627,610
50,Zaragoza,224,Retascón,95,52,43
50,Zaragoza,225,Ricla,2750,1573,1177
50,Zaragoza,227,Romanos,140,81,59
50,Zaragoza,228,Rueda de Jalón,365,187,178
50,Zaragoza,229,Ruesca,87,44,43
50,Zaragoza,241,Sabiñán,845,414,431
50,Zaragoza,230,Sádaba,1764,890,874
50,Zaragoza,231,Salillas de Jalón,346,184,162
50,Zaragoza,232,Salvatierra de Esca,271,134,137
50,Zaragoza,233,Samper del Salz,135,69,66
50,Zaragoza,234,San Martín de la Virgen de Moncayo,291,159,132
50,Zaragoza,235,San Mateo de Gállego,2290,1195,1095
50,Zaragoza,236,Santa Cruz de Grío,216,114,102
50,Zaragoza,237,Santa Cruz de Moncayo,127,60,67
50,Zaragoza,238,Santa Eulalia de Gállego,135,68,67
50,Zaragoza,239,Santed,76,37,39
50,Zaragoza,240,Sástago,1325,672,653
50,Zaragoza,242,Sediles,100,52,48
50,Zaragoza,243,Sestrica,452,234,218
50,Zaragoza,244,Sierra de Luna,250,130,120
50,Zaragoza,245,Sigüés,174,90,84
50,Zaragoza,246,Sisamón,65,40,25
50,Zaragoza,247,Sobradiel,755,380,375
50,Zaragoza,248,Sos del Rey Católico,743,379,364
50,Zaragoza,249,Tabuenca,461,259,202
50,Zaragoza,250,Talamantes,59,35,24
50,Zaragoza,251,Tarazona,10671,5180,5491
50,Zaragoza,252,Tauste,7247,3643,3604
50,Zaragoza,253,Terrer,568,278,290
50,Zaragoza,254,Tierga,227,128,99
50,Zaragoza,255,Tobed,251,127,124
50,Zaragoza,256,Torralba de los Frailes,91,45,46
50,Zaragoza,257,Torralba de Ribota,196,107,89
50,Zaragoza,258,Torralbilla,72,37,35
50,Zaragoza,259,Torrehermosa,107,56,51
50,Zaragoza,260,Torrelapaja,37,20,17
50,Zaragoza,261,Torrellas,307,163,144
50,Zaragoza,262,Torres de Berrellén,1429,730,699
50,Zaragoza,263,Torrijo de la Cañada,334,182,152
50,Zaragoza,264,Tosos,210,110,100
50,Zaragoza,265,Trasmoz,65,34,31
50,Zaragoza,266,Trasobares,193,106,87
50,Zaragoza,267,Uncastillo,875,434,441
50,Zaragoza,268,Undués de Lerda,57,34,23
50,Zaragoza,269,Urrea de Jalón,347,179,168
50,Zaragoza,270,Urriés,64,39,25
50,Zaragoza,271,Used,340,187,153
50,Zaragoza,272,Utebo,12600,6393,6207
50,Zaragoza,274,Val de San Martín,85,42,43
50,Zaragoza,273,Valdehorna,53,27,26
50,Zaragoza,275,Valmadrid,101,63,38
50,Zaragoza,276,Valpalmas,169,84,85
50,Zaragoza,277,Valtorres,101,47,54
50,Zaragoza,278,Velilla de Ebro,249,121,128
50,Zaragoza,279,Velilla de Jiloca,117,59,58
50,Zaragoza,280,Vera de Moncayo,448,233,215
50,Zaragoza,281,Vierlas,103,51,52
50,Zaragoza,282,Vilueña (La),111,48,63
50,Zaragoza,283,Villadoz,79,44,35
50,Zaragoza,284,Villafeliche,235,121,114
50,Zaragoza,285,Villafranca de Ebro,672,331,341
50,Zaragoza,286,Villalba de Perejil,115,61,54
50,Zaragoza,287,Villalengua,402,208,194
50,Zaragoza,288,Villanueva de Gállego,3488,1758,1730
50,Zaragoza,290,Villanueva de Huerva,585,308,277
50,Zaragoza,289,Villanueva de Jiloca,93,50,43
50,Zaragoza,291,Villar de los Navarros,140,66,74
50,Zaragoza,292,Villarreal de Huerva,189,107,82
50,Zaragoza,293,Villarroya de la Sierra,632,327,305
50,Zaragoza,294,Villarroya del Campo,78,39,39
50,Zaragoza,295,Vistabella,35,20,15
50,Zaragoza,296,Zaida (La),568,284,284
50,Zaragoza,297,Zaragoza,626081,302059,324022
50,Zaragoza,298,Zuera,5835,3005,2830
51,Ceuta,1,Ceuta,74931,38395,36536
52,Melilla,1,Melilla,68463,34737,33726
