CPRO,PROVINCIA,CMUN,NOMBRE,TOTAL,VARONES,MUJERES
1,Álava,1,Alegría-Dulantzi,1919,980,939
1,Álava,2,Amurrio,9512,4730,4782
1,Álava,49,Añana,185,98,87
1,Álava,3,Aramaio,1487,789,698
1,Álava,6,Armiñón,162,83,79
1,Álava,37,Arraia-Maeztu,736,408,328
1,Álava,8,Arrazua-Ubarrundia,795,436,359
1,Álava,4,Artziniega,1451,717,734
1,Álava,9,Asparrena,1581,787,794
1,Álava,10,Ayala/Aiara,2415,1216,1199
1,Álava,11,Baños de Ebro/Mañueta,336,186,150
1,Álava,13,Barrundia,755,418,337
1,Álava,14,Berantevilla,458,234,224
1,Álava,16,Bernedo,538,315,223
1,Álava,17,Campezo/Kanpezu,1085,580,505
1,Álava,21,Elburgo/Burgelu,453,237,216
1,Álava,22,Elciego,926,467,459
1,Álava,23,Elvillar/Bilar,373,199,174
1,Álava,56,Harana/Valle de Arana,329,190,139
1,Álava,901,Iruña Oka/Iruña de Oca,2093,1108,985
1,Álava,27,Iruraiz-Gauna,465,248,217
1,Álava,19,Kripan,190,104,86
1,Álava,20,Kuartango,364,205,159
1,Álava,28,Labastida,1334,719,615
1,Álava,30,Lagrán,195,107,88
1,Álava,31,Laguardia,1480,774,706
1,Álava,32,Lanciego/Lantziego,643,332,311
1,Álava,902,Lantarón,935,513,422
1,Álava,33,Lapuebla de Labarca,848,439,409
1,Álava,58,Legutiano,1459,772,687
1,Álava,34,Leza,220,118,102
1,Álava,36,Llodio,18721,9344,9377
1,Álava,39,Moreda de Álava,276,142,134
1,Álava,41,Navaridas,208,107,101
1,Álava,42,Okondo,1004,530,474
1,Álava,43,Oyón-Oion,2678,1365,1313
1,Álava,44,Peñacerrada-Urizaharra,263,145,118
1,Álava,46,Ribera Alta,580,332,248
1,Álava,47,Ribera Baja/Erribera Beitia,966,535,431
1,Álava,51,Salvatierra/Agurain,4096,2044,2052
1,Álava,52,Samaniego,319,163,156
1,Álava,53,San Millán/Donemiliaga,706,401,305
1,Álava,54,Urkabustaiz,958,516,442
1,Álava,55,Valdegovía,1046,576,470
1,Álava,57,Villabuena de Álava/Eskuernaga,321,163,158
1,Álava,59,Vitoria-Gasteiz,223702,110337,113365
1,Álava,60,Yécora/Iekora,266,130,136
1,Álava,61,Zalduondo,162,84,78
1,Álava,62,Zambrana,361,200,161
1,Álava,18,Zigoitia,1331,731,600
1,Álava,63,Zuia,2219,1121,1098
2,Albacete,1,Abengibre,977,483,494
2,Albacete,2,Alatoz,603,315,288
2,Albacete,3,Albacete,156466,76861,79605
2,Albacete,4,Albatana,854,415,439
2,Albacete,5,Alborea,793,403,390
2,Albacete,6,Alcadozo,772,405,367
2,Albacete,7,Alcalá del Júcar,1410,735,675
2,Albacete,8,Alcaraz,1735,847,888
2,Albacete,9,Almansa,24689,12188,12501
2,Albacete,10,Alpera,2335,1218,1117
2,Albacete,11,Ayna,943,486,457
2,Albacete,12,Balazote,2571,1417,1154
2,Albacete,14,Ballestero (El),528,268,260
2,Albacete,13,Balsa de Ves,234,127,107
2,Albacete,15,Barrax,1986,992,994
2,Albacete,16,Bienservida,814,414,400
2,Albacete,17,Bogarra,1164,603,561
2,Albacete,18,Bonete,1242,643,599
2,Albacete,19,Bonillo (El),3193,1639,1554
2,Albacete,20,Carcelén,656,353,303
2,Albacete,21,Casas de Juan Núñez,1304,678,626
2,Albacete,22,Casas de Lázaro,422,227,195
2,Albacete,23,Casas de Ves,812,428,384
2,Albacete,24,Casas-Ibáñez,4331,2194,2137
2,Albacete,25,Caudete,9429,4784,4645
2,Albacete,26,Cenizate,1174,609,565
2,Albacete,29,Chinchilla de Monte-Aragón,3285,1743,1542
2,Albacete,27,Corral-Rubio,450,234,216
2,Albacete,28,Cotillas,169,83,86
2,Albacete,30,Elche de la Sierra,3879,1918,1961
2,Albacete,31,Férez,807,404,403
2,Albacete,32,Fuensanta,336,180,156
2,Albacete,33,Fuente-Álamo,2707,1426,1281
2,Albacete,34,Fuentealbilla,1915,984,931
2,Albacete,35,Gineta (La),2114,1057,1057
2,Albacete,36,Golosalvo,112,53,59
2,Albacete,37,Hellín,29303,14678,14625
2,Albacete,38,Herrera (La),355,185,170
2,Albacete,39,Higueruela,1338,674,664
2,Albacete,40,Hoya-Gonzalo,871,441,430
2,Albacete,41,Jorquera,520,269,251
2,Albacete,42,Letur,1229,605,624
2,Albacete,43,Lezuza,1704,890,814
2,Albacete,44,Liétor,1577,820,757
2,Albacete,45,Madrigueras,4581,2335,2246
2,Albacete,46,Mahora,1361,671,690
2,Albacete,47,Masegoso,134,75,59
2,Albacete,48,Minaya,1704,896,808
2,Albacete,49,Molinicos,1173,609,564
2,Albacete,50,Montalvos,147,76,71
2,Albacete,51,Montealegre del Castillo,2309,1170,1139
2,Albacete,52,Motilleja,535,269,266
2,Albacete,53,Munera,3997,2025,1972
2,Albacete,54,Navas de Jorquera,524,265,259
2,Albacete,55,Nerpio,1663,903,760
2,Albacete,56,Ontur,2418,1189,1229
2,Albacete,57,Ossa de Montiel,2795,1395,1400
2,Albacete,58,Paterna del Madera,490,251,239
2,Albacete,60,Peñas de San Pedro,1225,654,571
2,Albacete,59,Peñascosa,392,199,193
2,Albacete,61,Pétrola,875,446,429
2,Albacete,62,Povedilla,645,342,303
2,Albacete,901,Pozo Cañada,2675,1319,1356
2,Albacete,63,Pozohondo,1837,943,894
2,Albacete,64,Pozo-Lorente,585,293,292
2,Albacete,65,Pozuelo,668,358,310
2,Albacete,66,Recueja (La),323,156,167
2,Albacete,67,Riópar,1495,765,730
2,Albacete,68,Robledo,424,222,202
2,Albacete,69,Roda (La),14550,7355,7195
2,Albacete,70,Salobre,611,310,301
2,Albacete,71,San Pedro,1288,662,626
2,Albacete,72,Socovos,1935,999,936
2,Albacete,73,Tarazona de la Mancha,6454,3296,3158
2,Albacete,74,Tobarra,7814,3966,3848
2,Albacete,75,Valdeganga,1884,940,944
2,Albacete,76,Vianos,457,224,233
2,Albacete,77,Villa de Ves,74,35,39
2,Albacete,78,Villalgordo del Júcar,1248,618,630
2,Albacete,79,Villamalea,3873,1970,1903
2,Albacete,80,Villapalacios,760,373,387
2,Albacete,81,Villarrobledo,24373,12199,12174
2,Albacete,82,Villatoya,187,98,89
2,Albacete,83,Villavaliente,273,144,129
2,Albacete,84,Villaverde de Guadalimar,432,229,203
2,Albacete,85,Viveros,485,260,225
2,Albacete,86,Yeste,3667,1863,1804
3,Alicante/Alacant,1,Adsubia,635,339,296
3,Alicante/Alacant,2,Agost,4517,2280,2237
3,Alicante/Alacant,3,Agres,671,364,307
3,Alicante/Alacant,4,Aigües,737,378,359
3,Alicante/Alacant,5,Albatera,10001,5120,4881
3,Alicante/Alacant,6,Alcalalí,1216,636,580
3,Alicante/Alacant,7,Alcocer de Planes,177,81,96
3,Alicante/Alacant,8,Alcoleja,241,123,118
3,Alicante/Alacant,9,Alcoy/Alcoi,60532,29344,31188
3,Alicante/Alacant,10,Alfafara,426,206,220
3,Alicante/Alacant,11,Alfàs del Pi (l'),14656,7356,7300
3,Alicante/Alacant,12,Algorfa,1956,990,966
3,Alicante/Alacant,13,Algueña,1452,706,746
3,Alicante/Alacant,14,Alicante/Alacant,310330,150405,159925
3,Alicante/Alacant,15,Almoradí,15450,7924,7526
3,Alicante/Alacant,16,Almudaina,111,62,49
3,Alicante/Alacant,17,Alqueria d'Asnar (l'),410,209,201
3,Alicante/Alacant,18,Altea,19514,9716,9798
3,Alicante/Alacant,19,Aspe,17833,8976,8857
3,Alicante/Alacant,20,Balones,171,80,91
3,Alicante/Alacant,21,Banyeres de Mariola,7314,3655,3659
3,Alicante/Alacant,22,Benasau,237,118,119
3,Alicante/Alacant,23,Beneixama,1939,970,969
3,Alicante/Alacant,24,Benejúzar,5216,2607,2609
3,Alicante/Alacant,25,Benferri,1351,695,656
3,Alicante/Alacant,26,Beniarbeig,1455,725,730
3,Alicante/Alacant,27,Beniardá,199,102,97
3,Alicante/Alacant,28,Beniarrés,1363,680,683
3,Alicante/Alacant,30,Benidoleig,995,487,508
3,Alicante/Alacant,31,Benidorm,64956,32561,32395
3,Alicante/Alacant,32,Benifallim,132,60,72
3,Alicante/Alacant,33,Benifato,173,89,84
3,Alicante/Alacant,29,Benigembla,531,270,261
3,Alicante/Alacant,34,Benijófar,3138,1536,1602
3,Alicante/Alacant,35,Benilloba,891,447,444
3,Alicante/Alacant,36,Benillup,93,45,48
3,Alicante/Alacant,37,Benimantell,447,217,230
3,Alicante/Alacant,38,Benimarfull,455,224,231
3,Alicante/Alacant,39,Benimassot,137,76,61
3,Alicante/Alacant,40,Benimeli,355,179,176
3,Alicante/Alacant,41,Benissa,11405,5728,5677
3,Alicante/Alacant,42,Benitachell/Poble Nou de Benitatxell (el),3425,1755,1670
3,Alicante/Alacant,43,Biar,3574,1762,1812
3,Alicante/Alacant,44,Bigastro,5601,2856,2745
3,Alicante/Alacant,45,Bolulla,364,185,179
3,Alicante/Alacant,46,Busot,2127,1063,1064
3,Alicante/Alacant,49,Callosa de Segura,16471,8357,8114
3,Alicante/Alacant,48,Callosa d'En Sarrià,7957,4206,3751
3,Alicante/Alacant,47,Calpe/Calp,23653,12111,11542
3,Alicante/Alacant,50,Campello (el),22380,11027,11353
3,Alicante/Alacant,51,Campo de Mirra/Camp de Mirra (el),428,210,218
3,Alicante/Alacant,52,Cañada,1176,562,614
3,Alicante/Alacant,53,Castalla,8532,4306,4226
3,Alicante/Alacant,54,Castell de Castells,475,227,248
3,Alicante/Alacant,75,Castell de Guadalest (el),204,104,100
3,Alicante/Alacant,55,Catral,5884,2994,2890
3,Alicante/Alacant,56,Cocentaina,10907,5407,5500
3,Alicante/Alacant,57,Confrides,301,165,136
3,Alicante/Alacant,58,Cox,6377,3276,3101
3,Alicante/Alacant,59,Crevillent,26632,13553,13079
3,Alicante/Alacant,61,Daya Nueva,1390,722,668
3,Alicante/Alacant,62,Daya Vieja,261,133,128
3,Alicante/Alacant,63,Dénia,38584,19124,19460
3,Alicante/Alacant,64,Dolores,6863,3511,3352
3,Alicante/Alacant,65,Elche/Elx,209439,104148,105291
3,Alicante/Alacant,66,Elda,55576,27209,28367
3,Alicante/Alacant,67,Facheca,103,53,50
3,Alicante/Alacant,68,Famorca,65,30,35
3,Alicante/Alacant,69,Finestrat,3377,1712,1665
3,Alicante/Alacant,70,Formentera del Segura,2588,1303,1285
3,Alicante/Alacant,72,Gaianes,344,164,180
3,Alicante/Alacant,71,Gata de Gorgos,5212,2658,2554
3,Alicante/Alacant,73,Gorga,261,138,123
3,Alicante/Alacant,74,Granja de Rocamora,2066,1065,1001
3,Alicante/Alacant,76,Guardamar del Segura,12215,6189,6026
3,Alicante/Alacant,77,Hondón de las Nieves,1936,964,972
3,Alicante/Alacant,78,Hondón de los Frailes,883,455,428
3,Alicante/Alacant,79,Ibi,22967,11437,11530
3,Alicante/Alacant,80,Jacarilla,1686,838,848
3,Alicante/Alacant,81,Jalón/Xaló,2400,1214,1186
3,Alicante/Alacant,82,Jávea/Xàbia,26649,13450,13199
3,Alicante/Alacant,83,Jijona/Xixona,7400,3522,3878
3,Alicante/Alacant,85,Llíber,837,423,414
3,Alicante/Alacant,84,Lorcha/Orxa (l'),735,364,371
3,Alicante/Alacant,86,Millena,175,83,92
3,Alicante/Alacant,88,Monforte del Cid,5864,3067,2797
3,Alicante/Alacant,89,Monóvar/Monòver,12624,6255,6369
3,Alicante/Alacant,903,Montesinos (Los),3081,1556,1525
3,Alicante/Alacant,91,Murla,482,230,252
3,Alicante/Alacant,92,Muro de Alcoy,7830,3889,3941
3,Alicante/Alacant,90,Mutxamel,17599,8784,8815
3,Alicante/Alacant,93,Novelda,25653,12809,12844
3,Alicante/Alacant,94,Nucia (la),10672,5412,5260
3,Alicante/Alacant,95,Ondara,5749,2920,2829
3,Alicante/Alacant,96,Onil,7317,3643,3674
3,Alicante/Alacant,97,Orba,1968,956,1012
3,Alicante/Alacant,99,Orihuela,68778,34831,33947
3,Alicante/Alacant,98,Orxeta,675,336,339
3,Alicante/Alacant,100,Parcent,907,448,459
3,Alicante/Alacant,101,Pedreguer,6489,3248,3241
3,Alicante/Alacant,102,Pego,10749,5552,5197
3,Alicante/Alacant,103,Penàguila,344,174,170
3,Alicante/Alacant,104,Petrer,31919,15944,15975
3,Alicante/Alacant,902,Pilar de la Horadada,16050,8537,7513
3,Alicante/Alacant,105,Pinoso,6878,3466,3412
3,Alicante/Alacant,106,Planes,794,396,398
3,Alicante/Alacant,901,Poblets (els),2242,1076,1166
3,Alicante/Alacant,107,Polop,2934,1508,1426
3,Alicante/Alacant,60,Quatretondeta,150,76,74
3,Alicante/Alacant,109,Rafal,3586,1838,1748
3,Alicante/Alacant,110,"Ràfol d'Almúnia, el",536,265,271
3,Alicante/Alacant,111,Redován,6257,3203,3054
3,Alicante/Alacant,112,Relleu,925,467,458
3,Alicante/Alacant,113,Rojales,11657,5949,5708
3,Alicante/Alacant,114,Romana (la),2235,1149,1086
3,Alicante/Alacant,115,Sagra,422,203,219
3,Alicante/Alacant,116,Salinas,1402,723,679
3,Alicante/Alacant,118,San Fulgencio,6685,3412,3273
3,Alicante/Alacant,904,San Isidro,1332,688,644
3,Alicante/Alacant,120,San Miguel de Salinas,5781,2955,2826
3,Alicante/Alacant,122,San Vicente del Raspeig/Sant Vicent del Raspeig,44226,22057,22169
3,Alicante/Alacant,117,Sanet y Negrals,623,292,331
3,Alicante/Alacant,119,Sant Joan d'Alacant,19027,9305,9722
3,Alicante/Alacant,121,Santa Pola,23220,11623,11597
3,Alicante/Alacant,123,Sax,9222,4637,4585
3,Alicante/Alacant,124,Sella,620,317,303
3,Alicante/Alacant,125,Senija,566,299,267
3,Alicante/Alacant,127,Tárbena,721,364,357
3,Alicante/Alacant,128,Teulada,11060,5590,5470
3,Alicante/Alacant,129,Tibi,1416,733,683
3,Alicante/Alacant,130,Tollos,34,20,14
3,Alicante/Alacant,131,Tormos,305,148,157
3,Alicante/Alacant,132,Torremanzanas/Torre de les Maçanes (la),717,374,343
3,Alicante/Alacant,133,Torrevieja,75530,38709,36821
3,Alicante/Alacant,134,Vall d'Alcalà (la),167,82,85
3,Alicante/Alacant,135,Vall de Ebo,336,166,170
3,Alicante/Alacant,136,Vall de Gallinera,590,311,279
3,Alicante/Alacant,137,Vall de Laguar (la),894,419,475
3,Alicante/Alacant,138,Verger (el),4221,2158,2063
3,Alicante/Alacant,139,Villajoyosa/Vila Joiosa (la),26792,13411,13381
3,Alicante/Alacant,140,Villena,33889,16787,17102
4,Almería,1,Abla,1482,738,744
4,Almería,2,Abrucena,1386,692,694
4,Almería,3,Adra,22257,11188,11069
4,Almería,4,Albánchez,697,355,342
4,Almería,5,Alboloduy,764,367,397
4,Almería,6,Albox,10680,5661,5019
4,Almería,7,Alcolea,1009,518,491
4,Almería,8,Alcóntar,650,344,306
4,Almería,9,Alcudia de Monteagud,166,84,82
4,Almería,10,Alhabia,679,333,346
4,Almería,11,Alhama de Almería,3319,1656,1663
4,Almería,12,Alicún,247,125,122
4,Almería,13,Almería,177681,86339,91342
4,Almería,14,Almócita,165,88,77
4,Almería,15,Alsodux,119,62,57
4,Almería,16,Antas,3101,1563,1538
4,Almería,17,Arboleas,2310,1191,1119
4,Almería,18,Armuña de Almanzora,310,156,154
4,Almería,19,Bacares,296,154,142
4,Almería,20,Bayárcal,305,160,145
4,Almería,21,Bayarque,246,125,121
4,Almería,22,Bédar,732,370,362
4,Almería,23,Beires,121,59,62
4,Almería,24,Benahadux,3058,1475,1583
4,Almería,26,Benitagla,66,37,29
4,Almería,27,Benizalón,302,152,150
4,Almería,28,Bentarique,278,146,132
4,Almería,29,Berja,13924,6924,7000
4,Almería,30,Canjáyar,1575,821,754
4,Almería,31,Cantoria,3382,1723,1659
4,Almería,32,Carboneras,7100,3633,3467
4,Almería,33,Castro de Filabres,162,81,81
4,Almería,36,Chercos,286,150,136
4,Almería,37,Chirivel,1800,891,909
4,Almería,34,Cóbdar,242,124,118
4,Almería,35,Cuevas del Almanzora,11001,5647,5354
4,Almería,38,Dalías,3675,1806,1869
4,Almería,902,Ejido (El),63914,34693,29221
4,Almería,41,Enix,315,175,140
4,Almería,43,Felix,564,288,276
4,Almería,44,Fines,1930,1016,914
4,Almería,45,Fiñana,2432,1210,1222
4,Almería,46,Fondón,946,491,455
4,Almería,47,Gádor,2874,1474,1400
4,Almería,48,Gallardos (Los),2583,1340,1243
4,Almería,49,Garrucha,6525,3311,3214
4,Almería,50,Gérgal,1068,534,534
4,Almería,51,Huécija,551,276,275
4,Almería,52,Huércal de Almería,10242,5260,4982
4,Almería,53,Huércal-Overa,15540,7682,7858
4,Almería,54,Illar,423,208,215
4,Almería,55,Instinción,527,260,267
4,Almería,56,Laroya,123,65,58
4,Almería,57,Láujar de Andarax,1819,897,922
4,Almería,58,Líjar,504,255,249
4,Almería,59,Lubrín,1667,794,873
4,Almería,60,Lucainena de las Torres,610,328,282
4,Almería,61,Lúcar,798,393,405
4,Almería,62,Macael,6002,3088,2914
4,Almería,63,María,1575,789,786
4,Almería,64,Mojácar,5375,2700,2675
4,Almería,903,Mojonera (La),7746,4244,3502
4,Almería,65,Nacimiento,465,243,222
4,Almería,66,Níjar,21306,11650,9656
4,Almería,67,Ohanes,822,420,402
4,Almería,68,Olula de Castro,155,83,72
4,Almería,69,Olula del Río,6272,3159,3113
4,Almería,70,Oria,2350,1197,1153
4,Almería,71,Padules,455,224,231
4,Almería,72,Partaloa,529,255,274
4,Almería,73,Paterna del Río,415,226,189
4,Almería,74,Pechina,3114,1582,1532
4,Almería,75,Pulpí,7368,3898,3470
4,Almería,76,Purchena,1629,814,815
4,Almería,77,Rágol,382,183,199
4,Almería,78,Rioja,1278,636,642
4,Almería,79,Roquetas de Mar,58519,30036,28483
4,Almería,80,Santa Cruz de Marchena,204,95,109
4,Almería,81,Santa Fe de Mondújar,433,213,220
4,Almería,82,Senés,314,162,152
4,Almería,83,Serón,2427,1187,1240
4,Almería,84,Sierro,452,220,232
4,Almería,85,Somontín,530,265,265
4,Almería,86,Sorbas,2707,1440,1267
4,Almería,87,Suflí,234,125,109
4,Almería,88,Tabernas,3180,1652,1528
4,Almería,89,Taberno,1081,553,528
4,Almería,90,Tahal,385,198,187
4,Almería,91,Terque,457,240,217
4,Almería,92,Tíjola,3755,1862,1893
4,Almería,901,Tres Villas (Las),632,327,305
4,Almería,93,Turre,2656,1345,1311
4,Almería,94,Turrillas,240,136,104
4,Almería,95,Uleila del Campo,972,491,481
4,Almería,96,Urrácal,350,169,181
4,Almería,97,Velefique,263,139,124
4,Almería,98,Vélez-Blanco,2051,1066,985
4,Almería,99,Vélez-Rubio,6905,3374,3531
4,Almería,100,Vera,9504,4793,4711
4,Almería,101,Viator,3872,1953,1919
4,Almería,102,Vícar,16935,8745,8190
4,Almería,103,Zurgena,2253,1121,1132
5,Ávila,1,Adanero,322,172,150
5,Ávila,2,Adrada (La),2155,1104,1051
5,Ávila,5,Albornos,218,123,95
5,Ávila,7,Aldeanueva de Santa Cruz,172,93,79
5,Ávila,8,Aldeaseca,313,155,158
5,Ávila,10,Aldehuela (La),237,117,120
5,Ávila,12,Amavida,190,96,94
5,Ávila,13,Arenal (El),1039,510,529
5,Ávila,14,Arenas de San Pedro,6549,3218,3331
5,Ávila,15,Arevalillo,120,60,60
5,Ávila,16,Arévalo,7653,3693,3960
5,Ávila,17,Aveinte,111,58,53
5,Ávila,18,Avellaneda,40,19,21
5,Ávila,19,Ávila,52417,25064,27353
5,Ávila,21,Barco de Ávila (El),2425,1175,1250
5,Ávila,22,Barraco (El),2090,1054,1036
5,Ávila,23,Barromán,226,126,100
5,Ávila,24,Becedas,355,190,165
5,Ávila,25,Becedillas,154,83,71
5,Ávila,26,Bercial de Zapardiel,286,137,149
5,Ávila,27,Berlanas (Las),346,187,159
5,Ávila,29,Bernuy-Zapardiel,192,110,82
5,Ávila,30,Berrocalejo de Aragona,52,29,23
5,Ávila,33,Blascomillán,261,121,140
5,Ávila,34,Blasconuño de Matacabras,18,10,8
5,Ávila,35,Blascosancho,136,70,66
5,Ávila,36,Bohodón (El),163,84,79
5,Ávila,37,Bohoyo,412,212,200
5,Ávila,38,Bonilla de la Sierra,167,94,73
5,Ávila,39,Brabos,70,40,30
5,Ávila,40,Bularros,101,56,45
5,Ávila,41,Burgohondo,1184,610,574
5,Ávila,42,Cabezas de Alambre,199,101,98
5,Ávila,43,Cabezas del Pozo,129,66,63
5,Ávila,44,Cabezas del Villar,423,227,196
5,Ávila,45,Cabizuela,127,64,63
5,Ávila,46,Canales,56,30,26
5,Ávila,47,Candeleda,5046,2608,2438
5,Ávila,48,Cantiveros,182,95,87
5,Ávila,49,Cardeñosa,530,279,251
5,Ávila,51,Carrera (La),245,122,123
5,Ávila,52,Casas del Puerto,110,57,53
5,Ávila,53,Casasola,131,72,59
5,Ávila,54,Casavieja,1482,775,707
5,Ávila,55,Casillas,823,436,387
5,Ávila,56,Castellanos de Zapardiel,135,77,58
5,Ávila,57,Cebreros,3223,1629,1594
5,Ávila,58,Cepeda la Mora,113,61,52
5,Ávila,67,Chamartín,100,59,41
5,Ávila,59,Cillán,134,76,58
5,Ávila,60,Cisla,180,89,91
5,Ávila,61,Colilla (La),250,122,128
5,Ávila,62,Collado de Contreras,253,138,115
5,Ávila,63,Collado del Mirón,66,36,30
5,Ávila,64,Constanzana,168,92,76
5,Ávila,65,Crespos,646,334,312
5,Ávila,66,Cuevas del Valle,580,312,268
5,Ávila,903,Diego del Carpio,256,139,117
5,Ávila,69,Donjimeno,130,71,59
5,Ávila,70,Donvidas,70,36,34
5,Ávila,72,Espinosa de los Caballeros,110,63,47
5,Ávila,73,Flores de Ávila,401,211,190
5,Ávila,74,Fontiveros,948,486,462
5,Ávila,75,Fresnedilla,98,41,57
5,Ávila,76,Fresno (El),494,257,237
5,Ávila,77,Fuente el Saúz,264,143,121
5,Ávila,78,Fuentes de Año,171,96,75
5,Ávila,79,Gallegos de Altamiros,101,60,41
5,Ávila,80,Gallegos de Sobrinos,94,46,48
5,Ávila,81,Garganta del Villar,58,33,25
5,Ávila,82,Gavilanes,693,386,307
5,Ávila,83,Gemuño,192,92,100
5,Ávila,85,Gil García,52,22,30
5,Ávila,84,Gilbuena,99,54,45
5,Ávila,86,Gimialcón,105,62,43
5,Ávila,87,Gotarrendura,180,65,115
5,Ávila,88,Grandes y San Martín,45,23,22
5,Ávila,89,Guisando,636,333,303
5,Ávila,90,Gutierre-Muñoz,123,60,63
5,Ávila,92,Hernansancho,220,116,104
5,Ávila,93,Herradón de Pinares,521,274,247
5,Ávila,94,Herreros de Suso,198,100,98
5,Ávila,95,Higuera de las Dueñas,305,174,131
5,Ávila,96,Hija de Dios (La),94,53,41
5,Ávila,97,Horcajada (La),701,339,362
5,Ávila,99,Horcajo de las Torres,720,398,322
5,Ávila,100,Hornillo (El),395,201,194
5,Ávila,102,Hoyo de Pinares (El),2367,1232,1135
5,Ávila,101,Hoyocasero,373,188,185
5,Ávila,103,Hoyorredondo,110,59,51
5,Ávila,106,Hoyos de Miguel Muñoz,49,26,23
5,Ávila,104,Hoyos del Collado,40,24,16
5,Ávila,105,Hoyos del Espino,451,254,197
5,Ávila,107,Hurtumpascual,105,61,44
5,Ávila,108,Junciana,87,47,40
5,Ávila,109,Langa,561,290,271
5,Ávila,110,Lanzahíta,966,515,451
5,Ávila,113,Llanos de Tormes (Los),111,56,55
5,Ávila,112,Losar del Barco (El),125,64,61
5,Ávila,114,Madrigal de las Altas Torres,1844,942,902
5,Ávila,115,Maello,672,346,326
5,Ávila,116,Malpartida de Corneja,181,90,91
5,Ávila,117,Mamblas,261,151,110
5,Ávila,118,Mancera de Arriba,120,62,58
5,Ávila,119,Manjabálago,56,27,29
5,Ávila,120,Marlín,41,25,16
5,Ávila,121,Martiherrero,195,104,91
5,Ávila,122,Martínez,199,107,92
5,Ávila,123,Mediana de Voltoya,109,56,53
5,Ávila,124,Medinilla,170,78,92
5,Ávila,125,Mengamuñoz,68,32,36
5,Ávila,126,Mesegar de Corneja,100,51,49
5,Ávila,127,Mijares,904,463,441
5,Ávila,128,Mingorría,466,245,221
5,Ávila,129,Mirón (El),214,126,88
5,Ávila,130,Mironcillo,137,74,63
5,Ávila,131,Mirueña de los Infanzones,157,81,76
5,Ávila,132,Mombeltrán,1142,593,549
5,Ávila,133,Monsalupe,73,34,39
5,Ávila,134,Moraleja de Matacabras,66,36,30
5,Ávila,135,Muñana,535,268,267
5,Ávila,136,Muñico,129,65,64
5,Ávila,138,Muñogalindo,435,240,195
5,Ávila,139,Muñogrande,95,49,46
5,Ávila,140,Muñomer del Peco,123,63,60
5,Ávila,141,Muñopepe,104,59,45
5,Ávila,142,Muñosancho,143,66,77
5,Ávila,143,Muñotello,107,56,51
5,Ávila,144,Narrillos del Álamo,137,73,64
5,Ávila,145,Narrillos del Rebollar,65,35,30
5,Ávila,149,Narros de Saldueña,148,84,64
5,Ávila,147,Narros del Castillo,213,117,96
5,Ávila,148,Narros del Puerto,44,26,18
5,Ávila,152,Nava de Arévalo,945,495,450
5,Ávila,153,Nava del Barco,143,70,73
5,Ávila,151,Navacepedilla de Corneja,158,86,72
5,Ávila,154,Navadijos,57,35,22
5,Ávila,155,Navaescurial,74,42,32
5,Ávila,156,Navahondilla,193,110,83
5,Ávila,157,Navalacruz,270,131,139
5,Ávila,158,Navalmoral,500,261,239
5,Ávila,159,Navalonguilla,408,211,197
5,Ávila,160,Navalosa,427,224,203
5,Ávila,161,Navalperal de Pinares,960,496,464
5,Ávila,162,Navalperal de Tormes,129,69,60
5,Ávila,163,Navaluenga,2088,1057,1031
5,Ávila,164,Navaquesera,47,19,28
5,Ávila,165,Navarredonda de Gredos,469,240,229
5,Ávila,166,Navarredondilla,251,121,130
5,Ávila,167,Navarrevisca,398,196,202
5,Ávila,168,Navas del Marqués (Las),4834,2504,2330
5,Ávila,169,Navatalgordo,305,159,146
5,Ávila,170,Navatejares,79,36,43
5,Ávila,171,Neila de San Miguel,103,57,46
5,Ávila,172,Niharra,183,94,89
5,Ávila,173,Ojos-Albos,58,36,22
5,Ávila,174,Orbita,101,47,54
5,Ávila,175,Oso (El),220,120,100
5,Ávila,176,Padiernos,226,123,103
5,Ávila,177,Pajares de Adaja,183,96,87
5,Ávila,178,Palacios de Goda,455,224,231
5,Ávila,179,Papatrigo,299,158,141
5,Ávila,180,Parral (El),123,66,57
5,Ávila,181,Pascualcobo,46,26,20
5,Ávila,182,Pedro Bernardo,1204,622,582
5,Ávila,183,Pedro-Rodríguez,223,106,117
5,Ávila,184,Peguerinos,328,176,152
5,Ávila,185,Peñalba de Ávila,129,71,58
5,Ávila,186,Piedrahíta,2024,997,1027
5,Ávila,187,Piedralaves,2120,1071,1049
5,Ávila,188,Poveda,81,48,33
5,Ávila,189,Poyales del Hoyo,631,310,321
5,Ávila,190,Pozanco,54,33,21
5,Ávila,191,Pradosegar,201,107,94
5,Ávila,192,Puerto Castilla,146,84,62
5,Ávila,193,Rasueros,297,156,141
5,Ávila,194,Riocabado,191,106,85
5,Ávila,195,Riofrío,325,181,144
5,Ávila,196,Rivilla de Barajas,92,46,46
5,Ávila,197,Salobral,120,65,55
5,Ávila,198,Salvadiós,110,55,55
5,Ávila,199,San Bartolomé de Béjar,57,28,29
5,Ávila,200,San Bartolomé de Corneja,79,41,38
5,Ávila,201,San Bartolomé de Pinares,701,372,329
5,Ávila,206,San Esteban de los Patos,39,20,19
5,Ávila,208,San Esteban de Zapardiel,61,36,25
5,Ávila,207,San Esteban del Valle,862,442,420
5,Ávila,209,San García de Ingelmos,140,76,64
5,Ávila,901,San Juan de Gredos,401,213,188
5,Ávila,210,San Juan de la Encinilla,123,58,65
5,Ávila,211,San Juan de la Nava,635,330,305
5,Ávila,212,San Juan del Molinillo,322,185,137
5,Ávila,213,San Juan del Olmo,156,89,67
5,Ávila,214,San Lorenzo de Tormes,54,27,27
5,Ávila,215,San Martín de la Vega del Alberche,253,144,109
5,Ávila,216,San Martín del Pimpollar,282,155,127
5,Ávila,217,San Miguel de Corneja,102,49,53
5,Ávila,218,San Miguel de Serrezuela,183,99,84
5,Ávila,219,San Pascual,49,32,17
5,Ávila,220,San Pedro del Arroyo,494,248,246
5,Ávila,231,San Vicente de Arévalo,225,114,111
5,Ávila,204,Sanchidrián,762,381,381
5,Ávila,205,Sanchorreja,138,65,73
5,Ávila,222,Santa Cruz de Pinares,200,109,91
5,Ávila,221,Santa Cruz del Valle,511,266,245
5,Ávila,226,Santa María de los Caballeros,117,62,55
5,Ávila,224,Santa María del Arroyo,118,64,54
5,Ávila,225,Santa María del Berrocal,521,250,271
5,Ávila,902,Santa María del Cubillo,388,219,169
5,Ávila,227,Santa María del Tiétar,425,225,200
5,Ávila,228,Santiago del Collado,260,163,97
5,Ávila,904,Santiago del Tormes,202,101,101
5,Ávila,229,Santo Domingo de las Posadas,95,48,47
5,Ávila,230,Santo Tomé de Zabarcos,104,57,47
5,Ávila,232,Serrada (La),137,70,67
5,Ávila,233,Serranillos,366,192,174
5,Ávila,234,Sigeres,76,36,40
5,Ávila,235,Sinlabajos,188,104,84
5,Ávila,236,Solana de Ávila,194,104,90
5,Ávila,237,Solana de Rioalmar,263,140,123
5,Ávila,238,Solosancho,1032,540,492
5,Ávila,239,Sotalbo,270,142,128
5,Ávila,240,Sotillo de la Adrada,4009,1973,2036
5,Ávila,241,Tiemblo (El),3753,1891,1862
5,Ávila,242,Tiñosillos,787,411,376
5,Ávila,243,Tolbaños,111,53,58
5,Ávila,244,Tormellas,93,50,43
5,Ávila,245,Tornadizos de Ávila,370,184,186
5,Ávila,247,Torre (La),357,200,157
5,Ávila,246,Tórtoles,99,54,45
5,Ávila,249,Umbrías,152,80,72
5,Ávila,251,Vadillo de la Sierra,123,64,59
5,Ávila,252,Valdecasa,93,51,42
5,Ávila,253,Vega de Santa María,131,75,56
5,Ávila,254,Velayos,262,132,130
5,Ávila,256,Villaflor,148,75,73
5,Ávila,257,Villafranca de la Sierra,176,89,87
5,Ávila,905,Villanueva de Ávila,322,163,159
5,Ávila,258,Villanueva de Gómez,143,70,73
5,Ávila,259,Villanueva del Aceral,167,79,88
5,Ávila,260,Villanueva del Campillo,175,94,81
5,Ávila,261,Villar de Corneja,73,39,34
5,Ávila,262,Villarejo del Valle,485,249,236
5,Ávila,263,Villatoro,240,133,107
5,Ávila,264,Viñegra de Moraña,85,46,39
5,Ávila,265,Vita,101,64,37
5,Ávila,266,Zapardiel de la Cañada,158,75,83
5,Ávila,267,Zapardiel de la Ribera,125,59,66
6,Badajoz,1,Acedera,870,454,416
6,Badajoz,2,Aceuchal,5368,2664,2704
6,Badajoz,3,Ahillones,1113,549,564
6,Badajoz,4,Alange,2020,1040,980
6,Badajoz,5,Albuera (La),1797,919,878
6,Badajoz,6,Alburquerque,5616,2837,2779
6,Badajoz,7,Alconchel,1984,1010,974
6,Badajoz,8,Alconera,749,370,379
6,Badajoz,9,Aljucén,243,129,114
6,Badajoz,10,Almendral,1352,664,688
6,Badajoz,11,Almendralejo,29132,14446,14686
6,Badajoz,12,Arroyo de San Serván,3995,2059,1936
6,Badajoz,13,Atalaya,344,163,181
6,Badajoz,14,Azuaga,8320,4216,4104
6,Badajoz,15,Badajoz,139135,67557,71578
6,Badajoz,16,Barcarrota,3660,1861,1799
6,Badajoz,17,Baterno,366,190,176
6,Badajoz,18,Benquerencia de la Serena,969,481,488
6,Badajoz,19,Berlanga,2612,1270,1342
6,Badajoz,20,Bienvenida,2365,1217,1148
6,Badajoz,21,Bodonal de la Sierra,1183,604,579
6,Badajoz,22,Burguillos del Cerro,3183,1517,1666
6,Badajoz,23,Cabeza del Buey,5691,2794,2897
6,Badajoz,24,Cabeza la Vaca,1575,792,783
6,Badajoz,25,Calamonte,6115,3050,3065
6,Badajoz,26,Calera de León,1062,534,528
6,Badajoz,27,Calzadilla de los Barros,860,423,437
6,Badajoz,28,Campanario,5592,2738,2854
6,Badajoz,29,Campillo de Llerena,1655,820,835
6,Badajoz,30,Capilla,197,94,103
6,Badajoz,31,Carmonita,632,324,308
6,Badajoz,32,Carrascalejo (El),72,36,36
6,Badajoz,33,Casas de Don Pedro,1679,842,837
6,Badajoz,34,Casas de Reina,201,93,108
6,Badajoz,35,Castilblanco,1200,577,623
6,Badajoz,36,Castuera,6826,3398,3428
6,Badajoz,42,Cheles,1312,660,652
6,Badajoz,37,Codosera (La),2220,1166,1054
6,Badajoz,38,Cordobilla de Lácara,1048,526,522
6,Badajoz,39,Coronada (La),2340,1166,1174
6,Badajoz,40,Corte de Peleas,1257,623,634
6,Badajoz,41,Cristina,558,296,262
6,Badajoz,43,Don Álvaro,638,316,322
6,Badajoz,44,Don Benito,32783,16174,16609
6,Badajoz,45,Entrín Bajo,606,302,304
6,Badajoz,46,Esparragalejo,1521,740,781
6,Badajoz,47,Esparragosa de la Serena,1121,561,560
6,Badajoz,48,Esparragosa de Lares,1068,529,539
6,Badajoz,49,Feria,1400,694,706
6,Badajoz,50,Fregenal de la Sierra,5234,2518,2716
6,Badajoz,51,Fuenlabrada de los Montes,1953,970,983
6,Badajoz,52,Fuente de Cantos,4982,2477,2505
6,Badajoz,53,Fuente del Arco,740,374,366
6,Badajoz,54,Fuente del Maestre,6772,3367,3405
6,Badajoz,55,Fuentes de León,2669,1317,1352
6,Badajoz,56,Garbayuela,546,293,253
6,Badajoz,57,Garlitos,736,379,357
6,Badajoz,58,Garrovilla (La),2542,1287,1255
6,Badajoz,59,Granja de Torrehermosa,2478,1215,1263
6,Badajoz,60,Guareña,7330,3684,3646
6,Badajoz,61,Haba (La),1451,730,721
6,Badajoz,62,Helechosa de los Montes,774,432,342
6,Badajoz,63,Herrera del Duque,3670,1865,1805
6,Badajoz,64,Higuera de la Serena,1134,590,544
6,Badajoz,65,Higuera de Llerena,406,198,208
6,Badajoz,66,Higuera de Vargas,2167,1086,1081
6,Badajoz,67,Higuera la Real,2507,1276,1231
6,Badajoz,68,Hinojosa del Valle,572,289,283
6,Badajoz,69,Hornachos,3810,1952,1858
6,Badajoz,70,Jerez de los Caballeros,9723,4831,4892
6,Badajoz,71,Lapa (La),310,157,153
6,Badajoz,73,Llera,948,489,459
6,Badajoz,74,Llerena,5659,2784,2875
6,Badajoz,72,Lobón,2620,1362,1258
6,Badajoz,75,Magacela,661,343,318
6,Badajoz,76,Maguilla,1113,552,561
6,Badajoz,77,Malcocinado,501,268,233
6,Badajoz,78,Malpartida de la Serena,736,383,353
6,Badajoz,79,Manchita,751,379,372
6,Badajoz,80,Medellín,2361,1197,1164
6,Badajoz,81,Medina de las Torres,1420,699,721
6,Badajoz,82,Mengabril,455,234,221
6,Badajoz,83,Mérida,52200,25342,26858
6,Badajoz,84,Mirandilla,1355,690,665
6,Badajoz,85,Monesterio,4389,2226,2163
6,Badajoz,86,Montemolín,1603,826,777
6,Badajoz,87,Monterrubio de la Serena,2792,1335,1457
6,Badajoz,88,Montijo,15512,7683,7829
6,Badajoz,89,Morera (La),777,388,389
6,Badajoz,90,Nava de Santiago (La),1140,569,571
6,Badajoz,91,Navalvillar de Pela,4767,2405,2362
6,Badajoz,92,Nogales,710,351,359
6,Badajoz,93,Oliva de la Frontera,5751,2844,2907
6,Badajoz,94,Oliva de Mérida,1898,940,958
6,Badajoz,95,Olivenza,11196,5568,5628
6,Badajoz,96,Orellana de la Sierra,313,163,150
6,Badajoz,97,Orellana la Vieja,3207,1619,1588
6,Badajoz,98,Palomas,728,374,354
6,Badajoz,99,Parra (La),1427,707,720
6,Badajoz,100,Peñalsordo,1396,685,711
6,Badajoz,101,Peraleda del Zaucejo,600,308,292
6,Badajoz,102,Puebla de Alcocer,1314,646,668
6,Badajoz,103,Puebla de la Calzada,5580,2748,2832
6,Badajoz,104,Puebla de la Reina,919,475,444
6,Badajoz,107,Puebla de Obando,2026,1027,999
6,Badajoz,108,Puebla de Sancho Pérez,2868,1442,1426
6,Badajoz,105,Puebla del Maestre,833,408,425
6,Badajoz,106,Puebla del Prior,555,274,281
6,Badajoz,902,Pueblonuevo del Guadiana,1999,1022,977
6,Badajoz,109,Quintana de la Serena,5223,2655,2568
6,Badajoz,110,Reina,198,101,97
6,Badajoz,111,Rena,645,318,327
6,Badajoz,112,Retamal de Llerena,521,278,243
6,Badajoz,113,Ribera del Fresno,3328,1637,1691
6,Badajoz,114,Risco,204,98,106
6,Badajoz,115,Roca de la Sierra (La),1562,773,789
6,Badajoz,116,Salvaleón,2177,1092,1085
6,Badajoz,117,Salvatierra de los Barros,1889,961,928
6,Badajoz,119,San Pedro de Mérida,804,408,396
6,Badajoz,123,San Vicente de Alcántara,5831,2880,2951
6,Badajoz,118,Sancti-Spíritus,250,121,129
6,Badajoz,120,Santa Amalia,4373,2185,2188
6,Badajoz,121,Santa Marta,4157,2077,2080
6,Badajoz,122,Santos de Maimona (Los),7911,3956,3955
6,Badajoz,124,Segura de León,2214,1107,1107
6,Badajoz,125,Siruela,2269,1133,1136
6,Badajoz,126,Solana de los Barros,2657,1329,1328
6,Badajoz,127,Talarrubias,3601,1789,1812
6,Badajoz,128,Talavera la Real,5210,2628,2582
6,Badajoz,129,Táliga,712,360,352
6,Badajoz,130,Tamurejo,268,136,132
6,Badajoz,131,Torre de Miguel Sesmero,1220,608,612
6,Badajoz,132,Torremayor,1004,476,528
6,Badajoz,133,Torremejía,2127,1093,1034
6,Badajoz,134,Trasierra,703,370,333
6,Badajoz,135,Trujillanos,1337,701,636
6,Badajoz,136,Usagre,2011,1016,995
6,Badajoz,137,Valdecaballeros,1288,647,641
6,Badajoz,901,Valdelacalzada,2591,1338,1253
6,Badajoz,138,Valdetorres,1326,664,662
6,Badajoz,139,Valencia de las Torres,734,374,360
6,Badajoz,140,Valencia del Mombuey,803,402,401
6,Badajoz,141,Valencia del Ventoso,2256,1122,1134
6,Badajoz,146,Valle de la Serena,1490,717,773
6,Badajoz,147,Valle de Matamoros,459,225,234
6,Badajoz,148,Valle de Santa Ana,1211,613,598
6,Badajoz,142,Valverde de Burguillos,338,169,169
6,Badajoz,143,Valverde de Leganés,3837,1933,1904
6,Badajoz,144,Valverde de Llerena,779,367,412
6,Badajoz,145,Valverde de Mérida,1128,563,565
6,Badajoz,149,Villafranca de los Barros,12618,6256,6362
6,Badajoz,150,Villagarcía de la Torre,1012,511,501
6,Badajoz,151,Villagonzalo,1357,667,690
6,Badajoz,152,Villalba de los Barros,1682,863,819
6,Badajoz,153,Villanueva de la Serena,24491,12028,12463
6,Badajoz,154,Villanueva del Fresno,3548,1754,1794
6,Badajoz,156,Villar de Rena,1557,814,743
6,Badajoz,155,Villar del Rey,2290,1187,1103
6,Badajoz,157,Villarta de los Montes,611,301,310
6,Badajoz,158,Zafra,15542,7492,8050
6,Badajoz,159,Zahínos,2961,1494,1467
6,Badajoz,160,Zalamea de la Serena,4345,2154,2191
6,Badajoz,162,Zarza (La),3585,1813,1772
6,Badajoz,161,Zarza-Capilla,460,238,222
7,Balears (Illes),2,Alaior,8308,4182,4126
7,Balears (Illes),1,Alaró,4607,2267,2340
7,Balears (Illes),3,Alcúdia,15057,7717,7340
7,Balears (Illes),4,Algaida,4149,2134,2015
7,Balears (Illes),5,Andratx,9404,4697,4707
7,Balears (Illes),901,Ariany,771,400,371
7,Balears (Illes),6,Artà,6524,3284,3240
7,Balears (Illes),7,Banyalbufar,570,314,256
7,Balears (Illes),8,Binissalem,6051,3029,3022
7,Balears (Illes),9,Búger,993,509,484
7,Balears (Illes),10,Bunyola,5291,2650,2641
7,Balears (Illes),11,Calvià,42614,21557,21057
7,Balears (Illes),12,Campanet,2420,1189,1231
7,Balears (Illes),13,Campos,7898,3989,3909
7,Balears (Illes),14,Capdepera,9297,4684,4613
7,Balears (Illes),64,Castell (Es),7066,3588,3478
7,Balears (Illes),15,Ciutadella de Menorca,26073,13037,13036
7,Balears (Illes),16,Consell,2727,1382,1345
7,Balears (Illes),17,Costitx,986,481,505
7,Balears (Illes),18,Deyá,689,358,331
7,Balears (Illes),26,Eivissa,40991,20823,20168
7,Balears (Illes),19,Escorca,295,166,129
7,Balears (Illes),20,Esporles,4363,2154,2209
7,Balears (Illes),21,Estellencs,374,202,172
7,Balears (Illes),22,Felanitx,16153,8238,7915
7,Balears (Illes),23,Ferreries,4338,2243,2095
7,Balears (Illes),24,Formentera,7131,3695,3436
7,Balears (Illes),25,Fornalutx,679,341,338
7,Balears (Illes),27,Inca,25900,13091,12809
7,Balears (Illes),28,Lloret de Vistalegre,1107,568,539
7,Balears (Illes),29,Lloseta,5180,2646,2534
7,Balears (Illes),30,Llubí,1967,975,992
7,Balears (Illes),31,Llucmajor,28591,14495,14096
7,Balears (Illes),32,Mahón,26536,13115,13421
7,Balears (Illes),33,Manacor,35512,17903,17609
7,Balears (Illes),34,Mancor de la Vall,947,462,485
7,Balears (Illes),35,Maria de la Salut,2043,1040,1003
7,Balears (Illes),36,Marratxí,27145,13733,13412
7,Balears (Illes),37,Mercadal (Es),3844,1992,1852
7,Balears (Illes),902,Migjorn Gran (Es),1300,660,640
7,Balears (Illes),38,Montuïri,2510,1261,1249
7,Balears (Illes),39,Muro,6487,3309,3178
7,Balears (Illes),40,Palma de Mallorca,368974,180814,188160
7,Balears (Illes),41,Petra,2643,1322,1321
7,Balears (Illes),44,Pobla (Sa),11442,5944,5498
7,Balears (Illes),42,Pollença,15513,7790,7723
7,Balears (Illes),43,Porreres,4519,2353,2166
7,Balears (Illes),45,Puigpunyent,1446,753,693
7,Balears (Illes),59,Salines (Ses),4151,2116,2035
7,Balears (Illes),46,Sant Antoni de Portmany,17407,8952,8455
7,Balears (Illes),49,Sant Joan,1821,923,898
7,Balears (Illes),50,Sant Joan de Labritja,4611,2391,2220
7,Balears (Illes),48,Sant Josep de sa Talaia,17385,9099,8286
7,Balears (Illes),51,Sant Llorenç des Cardassar,7280,3721,3559
7,Balears (Illes),52,Sant Lluís,5407,2728,2679
7,Balears (Illes),53,Santa Eugènia,1384,726,658
7,Balears (Illes),54,Santa Eulalia del Río,25826,13347,12479
7,Balears (Illes),55,Santa Margalida,9266,4710,4556
7,Balears (Illes),56,Santa María del Camí,5103,2559,2544
7,Balears (Illes),57,Santanyí,10337,5260,5077
7,Balears (Illes),58,Selva,3112,1531,1581
7,Balears (Illes),47,Sencelles,2559,1305,1254
7,Balears (Illes),60,Sineu,2927,1458,1469
7,Balears (Illes),61,Sóller,12140,6103,6037
7,Balears (Illes),62,Son Servera,10519,5381,5138
7,Balears (Illes),63,Valldemossa,1822,917,905
7,Balears (Illes),65,Vilafranca de Bonany,2563,1283,1280
8,Barcelona,1,Abrera,9422,4890,4532
8,Barcelona,2,Aguilar de Segarra,230,122,108
8,Barcelona,14,Aiguafreda,2241,1078,1163
8,Barcelona,3,Alella,8831,4371,4460
8,Barcelona,4,Alpens,290,156,134
8,Barcelona,5,Ametlla del Vallès (L'),7111,3558,3553
8,Barcelona,6,Arenys de Mar,13428,6544,6884
8,Barcelona,7,Arenys de Munt,7190,3622,3568
8,Barcelona,8,Argençola,209,118,91
8,Barcelona,9,Argentona,10403,5143,5260
8,Barcelona,10,Artés,4830,2435,2395
8,Barcelona,11,Avià,1956,982,974
8,Barcelona,12,Avinyó,2073,1037,1036
8,Barcelona,13,Avinyonet del Penedès,1414,760,654
8,Barcelona,15,Badalona,214874,107327,107547
8,Barcelona,904,Badia del Vallès,14313,7124,7189
8,Barcelona,16,Bagà,2122,1032,1090
8,Barcelona,17,Balenyà,3413,1700,1713
8,Barcelona,18,Balsareny,3241,1607,1634
8,Barcelona,252,Barberà del Vallès,27202,13624,13578
8,Barcelona,19,Barcelona,1578546,746045,832501
8,Barcelona,20,Begues,5284,2644,2640
8,Barcelona,21,Bellprat,90,49,41
8,Barcelona,22,Berga,15753,7742,8011
8,Barcelona,23,Bigues i Riells,6636,3459,3177
8,Barcelona,24,Borredà,508,258,250
8,Barcelona,25,Bruc (El),1454,771,683
8,Barcelona,26,Brull (El),201,110,91
8,Barcelona,27,Cabanyes (Les),647,326,321
8,Barcelona,29,Cabrera de Mar,3991,2046,1945
8,Barcelona,28,Cabrera d'Igualada,818,442,376
8,Barcelona,30,Cabrils,6003,2933,3070
8,Barcelona,31,Calaf,3214,1671,1543
8,Barcelona,34,Calders,803,407,396
8,Barcelona,33,Caldes de Montbui,15096,7575,7521
8,Barcelona,32,Caldes d'Estrac,2448,1208,1240
8,Barcelona,35,Calella,16008,7896,8112
8,Barcelona,37,Calldetenes,2143,1113,1030
8,Barcelona,38,Callús,1427,705,722
8,Barcelona,36,Calonge de Segarra,200,104,96
8,Barcelona,39,Campins,334,171,163
8,Barcelona,40,Canet de Mar,12047,5943,6104
8,Barcelona,41,Canovelles,14001,7210,6791
8,Barcelona,42,Cànoves i Samalús,2297,1197,1100
8,Barcelona,43,Canyelles,2808,1488,1320
8,Barcelona,44,Capellades,5143,2513,2630
8,Barcelona,45,Capolat,80,42,38
8,Barcelona,46,Cardedeu,14514,7232,7282
8,Barcelona,47,Cardona,5272,2563,2709
8,Barcelona,48,Carme,721,373,348
8,Barcelona,49,Casserres,1524,734,790
8,Barcelona,57,Castell de l'Areny,65,37,28
8,Barcelona,52,Castellar de n'Hug,191,104,87
8,Barcelona,50,Castellar del Riu,136,79,57
8,Barcelona,51,Castellar del Vallès,19475,9743,9732
8,Barcelona,53,Castellbell i el Vilar,3171,1621,1550
8,Barcelona,54,Castellbisbal,10352,5329,5023
8,Barcelona,55,Castellcir,500,265,235
8,Barcelona,56,Castelldefels,53964,26909,27055
8,Barcelona,58,Castellet i la Gornal,1684,854,830
8,Barcelona,60,Castellfollit de Riubregós,219,112,107
8,Barcelona,59,Castellfollit del Boix,405,201,204
8,Barcelona,61,Castellgalí,1145,599,546
8,Barcelona,62,Castellnou de Bages,742,394,348
8,Barcelona,63,Castellolí,452,221,231
8,Barcelona,64,Castellterçol,2178,1068,1110
8,Barcelona,65,Castellví de la Marca,1522,774,748
8,Barcelona,66,Castellví de Rosanes,1297,660,637
8,Barcelona,67,Centelles,6304,3093,3211
8,Barcelona,268,Cercs,1338,688,650
8,Barcelona,266,Cerdanyola del Vallès,56065,27997,28068
8,Barcelona,68,Cervelló,6980,3571,3409
8,Barcelona,69,Collbató,3024,1593,1431
8,Barcelona,70,Collsuspina,296,157,139
8,Barcelona,71,Copons,282,137,145
8,Barcelona,72,Corbera de Llobregat,11278,5787,5491
8,Barcelona,73,Cornellà de Llobregat,83327,41341,41986
8,Barcelona,74,Cubelles,9549,4944,4605
8,Barcelona,75,Dosrius,3762,1895,1867
8,Barcelona,76,Esparreguera,20163,10314,9849
8,Barcelona,77,Esplugues de Llobregat,45915,22598,23317
8,Barcelona,78,Espunyola (L'),273,138,135
8,Barcelona,79,Estany (L'),405,189,216
8,Barcelona,134,Figaró-Montmany,993,507,486
8,Barcelona,80,Fígols,47,26,21
8,Barcelona,82,Fogars de la Selva,1045,545,500
8,Barcelona,81,Fogars de Montclús,395,213,182
8,Barcelona,83,Folgueroles,1833,911,922
8,Barcelona,84,Fonollosa,1173,601,572
8,Barcelona,85,Font-rubí,1340,708,632
8,Barcelona,86,Franqueses del Vallès (Les),14754,7519,7235
8,Barcelona,90,Gaià,154,77,77
8,Barcelona,87,Gallifa,209,106,103
8,Barcelona,88,Garriga (La),12923,6295,6628
8,Barcelona,89,Gavà,43242,21610,21632
8,Barcelona,91,Gelida,5358,2741,2617
8,Barcelona,92,Gironella,4884,2377,2507
8,Barcelona,93,Gisclareny,33,18,15
8,Barcelona,94,Granada (La),1525,763,762
8,Barcelona,95,Granera,78,54,24
8,Barcelona,96,Granollers,56456,27988,28468
8,Barcelona,97,Gualba,950,498,452
8,Barcelona,99,Guardiola de Berguedà,945,489,456
8,Barcelona,100,Gurb,2126,1078,1048
8,Barcelona,101,Hospitalet de Llobregat (L'),250536,122898,127638
8,Barcelona,162,Hostalets de Pierola (Els),1716,896,820
8,Barcelona,102,Igualada,35195,17347,17848
8,Barcelona,103,Jorba,636,300,336
8,Barcelona,104,Llacuna (La),875,467,408
8,Barcelona,105,Llagosta (La),12944,6501,6443
8,Barcelona,107,Lliçà d'Amunt,12009,6166,5843
8,Barcelona,108,Lliçà de Vall,5696,2969,2727
8,Barcelona,106,Llinars del Vallès,7834,3917,3917
8,Barcelona,109,Lluçà,261,141,120
8,Barcelona,110,Malgrat de Mar,16162,8136,8026
8,Barcelona,111,Malla,262,122,140
8,Barcelona,112,Manlleu,18748,9479,9269
8,Barcelona,113,Manresa,68505,33548,34957
8,Barcelona,242,Marganell,243,108,135
8,Barcelona,114,Martorell,25010,12880,12130
8,Barcelona,115,Martorelles,4912,2472,2440
8,Barcelona,116,Masies de Roda (Les),703,349,354
8,Barcelona,117,Masies de Voltregà (Les),3006,1468,1538
8,Barcelona,118,Masnou (El),21196,10274,10922
8,Barcelona,119,Masquefa,6680,3424,3256
8,Barcelona,120,Matadepera,7711,3875,3836
8,Barcelona,121,Mataró,114114,56921,57193
8,Barcelona,122,Mediona,1757,919,838
8,Barcelona,138,Moià,4872,2442,2430
8,Barcelona,123,Molins de Rei,22496,11079,11417
8,Barcelona,124,Mollet del Vallès,50691,25696,24995
8,Barcelona,128,Monistrol de Calders,657,326,331
8,Barcelona,127,Monistrol de Montserrat,2654,1377,1277
8,Barcelona,125,Montcada i Reixac,30953,15337,15616
8,Barcelona,130,Montclar,126,62,64
8,Barcelona,131,Montesquiu,863,439,424
8,Barcelona,126,Montgat,8844,4384,4460
8,Barcelona,132,Montmajor,459,239,220
8,Barcelona,133,Montmaneu,196,105,91
8,Barcelona,135,Montmeló,8724,4387,4337
8,Barcelona,136,Montornès del Vallès,14065,7189,6876
8,Barcelona,137,Montseny,313,167,146
8,Barcelona,129,Muntanyola,397,217,180
8,Barcelona,139,Mura,212,111,101
8,Barcelona,140,Navarcles,5498,2731,2767
8,Barcelona,141,Navàs,5658,2814,2844
8,Barcelona,142,Nou de Berguedà (La),157,81,76
8,Barcelona,143,Òdena,2832,1415,1417
8,Barcelona,145,Olèrdola,2632,1363,1269
8,Barcelona,146,Olesa de Bonesvalls,1287,671,616
8,Barcelona,147,Olesa de Montserrat,20294,10273,10021
8,Barcelona,148,Olivella,2011,1072,939
8,Barcelona,149,Olost,1187,588,599
8,Barcelona,144,Olvan,895,438,457
8,Barcelona,150,Orís,252,126,126
8,Barcelona,151,Oristà,603,291,312
8,Barcelona,152,Orpí,175,93,82
8,Barcelona,153,Òrrius,330,171,159
8,Barcelona,154,Pacs del Penedès,739,377,362
8,Barcelona,155,Palafolls,6631,3345,3286
8,Barcelona,156,Palau-solità i Plegamans,12499,6347,6152
8,Barcelona,157,Pallejà,9746,4941,4805
8,Barcelona,905,Palma de Cervelló (La),2881,1441,1440
8,Barcelona,158,Papiol (El),3628,1839,1789
8,Barcelona,159,Parets del Vallès,15912,8078,7834
8,Barcelona,160,Perafita,371,180,191
8,Barcelona,161,Piera,11452,5900,5552
8,Barcelona,163,Pineda de Mar,23539,11936,11603
8,Barcelona,164,Pla del Penedès (El),891,459,432
8,Barcelona,165,Pobla de Claramunt (La),1942,1018,924
8,Barcelona,166,Pobla de Lillet (La),1357,655,702
8,Barcelona,167,Polinyà,5855,2992,2863
8,Barcelona,182,Pont de Vilomara i Rocafort (El),2992,1534,1458
8,Barcelona,168,Pontons,467,256,211
8,Barcelona,169,Prat de Llobregat (El),63148,31708,31440
8,Barcelona,171,Prats de Lluçanès,2700,1350,1350
8,Barcelona,170,Prats de Rei (Els),540,273,267
8,Barcelona,230,Premià de Dalt,9703,4850,4853
8,Barcelona,172,Premià de Mar,27464,13739,13725
8,Barcelona,174,Puigdàlber,389,184,205
8,Barcelona,175,Puig-reig,4171,2026,2145
8,Barcelona,176,Pujalt,194,101,93
8,Barcelona,177,Quar (La),73,42,31
8,Barcelona,178,Rajadell,455,239,216
8,Barcelona,179,Rellinars,572,290,282
8,Barcelona,180,Ripollet,33605,16943,16662
8,Barcelona,181,Roca del Vallès (La),8685,4392,4293
8,Barcelona,183,Roda de Ter,5365,2609,2756
8,Barcelona,184,Rubí,66425,33499,32926
8,Barcelona,185,Rubió,134,76,58
8,Barcelona,901,Rupit i Pruit,344,173,171
8,Barcelona,187,Sabadell,193338,94421,98917
8,Barcelona,188,Sagàs,140,71,69
8,Barcelona,190,Saldes,338,190,148
8,Barcelona,191,Sallent,7103,3439,3664
8,Barcelona,194,Sant Adrià de Besòs,32921,16267,16654
8,Barcelona,195,Sant Agustí de Lluçanès,103,54,49
8,Barcelona,196,Sant Andreu de la Barca,23675,12149,11526
8,Barcelona,197,Sant Andreu de Llavaneres,8707,4389,4318
8,Barcelona,198,Sant Antoni de Vilamajor,4437,2242,2195
8,Barcelona,199,Sant Bartomeu del Grau,1084,568,516
8,Barcelona,200,Sant Boi de Llobregat,80636,40096,40540
8,Barcelona,201,Sant Boi de Lluçanès,572,291,281
8,Barcelona,203,Sant Cebrià de Vallalta,2343,1280,1063
8,Barcelona,202,Sant Celoni,14278,7136,7142
8,Barcelona,204,Sant Climent de Llobregat,3366,1706,1660
8,Barcelona,205,Sant Cugat del Vallès,65061,32063,32998
8,Barcelona,206,Sant Cugat Sesgarrigues,843,444,399
8,Barcelona,207,Sant Esteve de Palautordera,1798,874,924
8,Barcelona,208,Sant Esteve Sesrovires,5978,3083,2895
8,Barcelona,210,Sant Feliu de Codines,5027,2590,2437
8,Barcelona,211,Sant Feliu de Llobregat,41954,20674,21280
8,Barcelona,212,Sant Feliu Sasserra,653,326,327
8,Barcelona,209,Sant Fost de Campsentelles,7039,3589,3450
8,Barcelona,213,Sant Fruitós de Bages,6696,3392,3304
8,Barcelona,215,Sant Hipòlit de Voltregà,3150,1568,1582
8,Barcelona,193,Sant Iscle de Vallalta,1016,532,484
8,Barcelona,216,Sant Jaume de Frontanyà,27,14,13
8,Barcelona,218,Sant Joan de Vilatorrada,9854,4943,4911
8,Barcelona,217,Sant Joan Despí,30242,14917,15325
8,Barcelona,903,Sant Julià de Cerdanyola,260,141,119
8,Barcelona,220,Sant Julià de Vilatorta,2622,1280,1342
8,Barcelona,221,Sant Just Desvern,14910,7119,7791
8,Barcelona,222,Sant Llorenç d'Hortons,1939,969,970
8,Barcelona,223,Sant Llorenç Savall,2210,1112,1098
8,Barcelona,225,Sant Martí d'Albars,122,63,59
8,Barcelona,224,Sant Martí de Centelles,851,436,415
8,Barcelona,226,Sant Martí de Tous,1053,535,518
8,Barcelona,227,Sant Martí Sarroca,2650,1335,1315
8,Barcelona,228,Sant Martí Sesgueioles,341,175,166
8,Barcelona,229,Sant Mateu de Bages,664,327,337
8,Barcelona,231,Sant Pere de Ribes,25280,12755,12525
8,Barcelona,232,Sant Pere de Riudebitlles,2112,1049,1063
8,Barcelona,233,Sant Pere de Torelló,2244,1126,1118
8,Barcelona,234,Sant Pere de Vilamajor,3270,1687,1583
8,Barcelona,189,Sant Pere Sallavinera,156,79,77
8,Barcelona,235,Sant Pol de Mar,4464,2283,2181
8,Barcelona,236,Sant Quintí de Mediona,1970,1040,930
8,Barcelona,237,Sant Quirze de Besora,1985,976,1009
8,Barcelona,238,Sant Quirze del Vallès,15729,7804,7925
8,Barcelona,239,Sant Quirze Safaja,529,282,247
8,Barcelona,240,Sant Sadurní d'Anoia,11034,5505,5529
8,Barcelona,241,Sant Sadurní d'Osormort,91,48,43
8,Barcelona,98,Sant Salvador de Guardiola,2622,1362,1260
8,Barcelona,262,Sant Vicenç de Castellet,7532,3641,3891
8,Barcelona,264,Sant Vicenç de Montalt,4549,2309,2240
8,Barcelona,265,Sant Vicenç de Torelló,1877,910,967
8,Barcelona,263,Sant Vicenç dels Horts,26477,13373,13104
8,Barcelona,243,Santa Cecília de Voltregà,203,110,93
8,Barcelona,244,Santa Coloma de Cervelló,6652,3324,3328
8,Barcelona,245,Santa Coloma de Gramenet,116503,58522,57981
8,Barcelona,246,Santa Eugènia de Berga,2016,1048,968
8,Barcelona,247,Santa Eulàlia de Riuprimer,864,443,421
8,Barcelona,248,Santa Eulàlia de Ronçana,5468,2780,2688
8,Barcelona,249,Santa Fe del Penedès,336,165,171
8,Barcelona,250,Santa Margarida de Montbui,9298,4676,4622
8,Barcelona,251,Santa Margarida i els Monjos,5701,2995,2706
8,Barcelona,253,Santa Maria de Besora,175,90,85
8,Barcelona,254,Santa Maria de Corcó,2199,1086,1113
8,Barcelona,256,Santa Maria de Martorelles,736,378,358
8,Barcelona,255,Santa Maria de Merlès,153,80,73
8,Barcelona,257,Santa Maria de Miralles,115,56,59
8,Barcelona,259,Santa Maria de Palautordera,7499,3879,3620
8,Barcelona,258,Santa Maria d'Oló,1047,532,515
8,Barcelona,260,Santa Perpètua de Mogoda,20844,10547,10297
8,Barcelona,261,Santa Susanna,2681,1368,1313
8,Barcelona,192,Santpedor,5828,2907,2921
8,Barcelona,267,Sentmenat,6628,3317,3311
8,Barcelona,269,Seva,2846,1457,1389
8,Barcelona,270,Sitges,23172,11401,11771
8,Barcelona,271,Sobremunt,87,40,47
8,Barcelona,272,Sora,205,105,100
8,Barcelona,273,Subirats,2736,1363,1373
8,Barcelona,274,Súria,6193,3044,3149
8,Barcelona,276,Tagamanent,247,128,119
8,Barcelona,277,Talamanca,114,59,55
8,Barcelona,278,Taradell,5519,2820,2699
8,Barcelona,275,Tavèrnoles,285,148,137
8,Barcelona,280,Tavertet,149,81,68
8,Barcelona,281,Teià,5751,2881,2870
8,Barcelona,279,Terrassa,189212,93865,95347
8,Barcelona,282,Tiana,6789,3346,3443
8,Barcelona,283,Tona,6725,3413,3312
8,Barcelona,284,Tordera,11719,5970,5749
8,Barcelona,285,Torelló,12768,6314,6454
8,Barcelona,286,Torre de Claramunt (La),2936,1506,1430
8,Barcelona,287,Torrelavit,1148,609,539
8,Barcelona,288,Torrelles de Foix,1944,1041,903
8,Barcelona,289,Torrelles de Llobregat,4324,2182,2142
8,Barcelona,290,Ullastrell,1405,716,689
8,Barcelona,291,Vacarisses,3931,2064,1867
8,Barcelona,292,Vallbona d'Anoia,1190,605,585
8,Barcelona,293,Vallcebre,281,146,135
8,Barcelona,294,Vallgorguina,1713,885,828
8,Barcelona,295,Vallirana,11678,5883,5795
8,Barcelona,296,Vallromanes,1807,928,879
8,Barcelona,297,Veciana,169,89,80
8,Barcelona,298,Vic,36571,18443,18128
8,Barcelona,299,Vilada,514,258,256
8,Barcelona,301,Viladecans,60033,30282,29751
8,Barcelona,300,Viladecavalls,6838,3440,3398
8,Barcelona,305,Vilafranca del Penedès,34409,17094,17315
8,Barcelona,306,Vilalba Sasserra,544,285,259
8,Barcelona,303,Vilanova de Sau,339,157,182
8,Barcelona,302,Vilanova del Camí,11121,5634,5487
8,Barcelona,902,Vilanova del Vallès,2932,1496,1436
8,Barcelona,307,Vilanova i la Geltrú,59409,29328,30081
8,Barcelona,214,Vilassar de Dalt,7902,3949,3953
8,Barcelona,219,Vilassar de Mar,18558,9069,9489
8,Barcelona,304,Vilobí del Penedès,970,500,470
8,Barcelona,308,Viver i Serrateix,195,101,94
9,Burgos,1,Abajas,41,22,19
9,Burgos,3,Adrada de Haza,260,142,118
9,Burgos,6,Aguas Cándidas,97,55,42
9,Burgos,7,Aguilar de Bureba,75,39,36
9,Burgos,9,Albillos,197,112,85
9,Burgos,10,Alcocero de Mola,53,33,20
9,Burgos,11,Alfoz de Bricia,119,64,55
9,Burgos,907,Alfoz de Quintanadueñas,1300,706,594
9,Burgos,12,Alfoz de Santa Gadea,132,68,64
9,Burgos,13,Altable,61,37,24
9,Burgos,14,Altos (Los),210,122,88
9,Burgos,16,Ameyugo,95,51,44
9,Burgos,17,Anguix,142,74,68
9,Burgos,18,Aranda de Duero,30875,15417,15458
9,Burgos,19,Arandilla,191,111,80
9,Burgos,20,Arauzo de Miel,363,203,160
9,Burgos,21,Arauzo de Salce,73,41,32
9,Burgos,22,Arauzo de Torre,106,58,48
9,Burgos,23,Arcos,502,267,235
9,Burgos,24,Arenillas de Riopisuerga,221,123,98
9,Burgos,25,Arija,202,101,101
9,Burgos,26,Arlanzón,411,234,177
9,Burgos,27,Arraya de Oca,53,26,27
9,Burgos,29,Atapuerca,200,101,99
9,Burgos,30,Ausines (Los),136,77,59
9,Burgos,32,Avellanosa de Muñó,145,77,68
9,Burgos,33,Bahabón de Esgueva,124,73,51
9,Burgos,34,Balbases (Los),348,187,161
9,Burgos,35,Baños de Valdearados,424,242,182
9,Burgos,36,Bañuelos de Bureba,41,25,16
9,Burgos,37,Barbadillo de Herreros,148,89,59
9,Burgos,38,Barbadillo del Mercado,169,91,78
9,Burgos,39,Barbadillo del Pez,93,55,38
9,Burgos,41,Barrio de Muñó,32,19,13
9,Burgos,43,Barrios de Bureba (Los),243,135,108
9,Burgos,44,Barrios de Colina,76,41,35
9,Burgos,45,Basconcillos del Tozo,371,205,166
9,Burgos,46,Bascuñana,61,33,28
9,Burgos,47,Belbimbre,80,44,36
9,Burgos,48,Belorado,2109,1073,1036
9,Burgos,50,Berberana,81,44,37
9,Burgos,51,Berlangas de Roa,226,118,108
9,Burgos,52,Berzosa de Bureba,48,30,18
9,Burgos,54,Bozoó,110,57,53
9,Burgos,55,Brazacorta,88,46,42
9,Burgos,56,Briviesca,6741,3376,3365
9,Burgos,57,Bugedo,150,104,46
9,Burgos,58,Buniel,231,125,106
9,Burgos,59,Burgos,169682,81672,88010
9,Burgos,60,Busto de Bureba,216,117,99
9,Burgos,61,Cabañes de Esgueva,243,127,116
9,Burgos,62,Cabezón de la Sierra,67,28,39
9,Burgos,64,Caleruega,460,232,228
9,Burgos,65,Campillo de Aranda,186,97,89
9,Burgos,66,Campolara,95,56,39
9,Burgos,67,Canicosa de la Sierra,575,301,274
9,Burgos,68,Cantabrana,39,24,15
9,Burgos,70,Carazo,46,28,18
9,Burgos,71,Carcedo de Bureba,46,23,23
9,Burgos,72,Carcedo de Burgos,221,132,89
9,Burgos,73,Cardeñadijo,668,360,308
9,Burgos,74,Cardeñajimeno,612,333,279
9,Burgos,75,Cardeñuela Riopico,106,61,45
9,Burgos,76,Carrias,42,28,14
9,Burgos,77,Cascajares de Bureba,54,30,24
9,Burgos,78,Cascajares de la Sierra,29,14,15
9,Burgos,79,Castellanos de Castro,63,37,26
9,Burgos,83,Castil de Peones,28,15,13
9,Burgos,82,Castildelgado,70,36,34
9,Burgos,84,Castrillo de la Reina,254,157,97
9,Burgos,85,Castrillo de la Vega,605,332,273
9,Burgos,88,Castrillo de Riopisuerga,87,50,37
9,Burgos,86,Castrillo del Val,515,302,213
9,Burgos,90,Castrillo Matajudíos,71,34,37
9,Burgos,91,Castrojeriz,954,487,467
9,Burgos,63,Cavia,255,140,115
9,Burgos,93,Cayuela,130,73,57
9,Burgos,94,Cebrecos,67,38,29
9,Burgos,95,Celada del Camino,99,48,51
9,Burgos,98,Cerezo de Río Tirón,728,392,336
9,Burgos,100,Cerratón de Juarros,62,38,24
9,Burgos,101,Ciadoncha,99,59,40
9,Burgos,102,Cillaperlata,44,29,15
9,Burgos,103,Cilleruelo de Abajo,298,166,132
9,Burgos,104,Cilleruelo de Arriba,72,37,35
9,Burgos,105,Ciruelos de Cervera,144,82,62
9,Burgos,108,Cogollos,348,190,158
9,Burgos,109,Condado de Treviño,1282,723,559
9,Burgos,110,Contreras,103,64,39
9,Burgos,112,Coruña del Conde,163,93,70
9,Burgos,113,Covarrubias,632,330,302
9,Burgos,114,Cubillo del Campo,76,39,37
9,Burgos,115,Cubo de Bureba,114,63,51
9,Burgos,117,Cueva de Roa (La),109,59,50
9,Burgos,119,Cuevas de San Clemente,59,29,30
9,Burgos,120,Encío,53,30,23
9,Burgos,122,Espinosa de Cervera,99,57,42
9,Burgos,124,Espinosa de los Monteros,2007,1028,979
9,Burgos,123,Espinosa del Camino,36,21,15
9,Burgos,125,Estépar,797,441,356
9,Burgos,127,Fontioso,67,37,30
9,Burgos,128,Frandovínez,92,52,40
9,Burgos,129,Fresneda de la Sierra Tirón,115,66,49
9,Burgos,130,Fresneña,105,58,47
9,Burgos,131,Fresnillo de las Dueñas,349,188,161
9,Burgos,132,Fresno de Río Tirón,221,127,94
9,Burgos,133,Fresno de Rodilla,46,29,17
9,Burgos,134,Frías,314,164,150
9,Burgos,135,Fuentebureba,71,38,33
9,Burgos,136,Fuentecén,285,153,132
9,Burgos,137,Fuentelcésped,194,98,96
9,Burgos,138,Fuentelisendo,111,63,48
9,Burgos,139,Fuentemolinos,115,66,49
9,Burgos,140,Fuentenebro,171,96,75
9,Burgos,141,Fuentespina,663,356,307
9,Burgos,143,Galbarros,31,21,10
9,Burgos,144,Gallega (La),85,48,37
9,Burgos,148,Grijalba,123,61,62
9,Burgos,149,Grisaleña,46,30,16
9,Burgos,151,Gumiel de Izán,665,373,292
9,Burgos,152,Gumiel de Mercado,386,227,159
9,Burgos,154,Hacinas,189,104,85
9,Burgos,155,Haza,37,21,16
9,Burgos,159,Hontanas,70,41,29
9,Burgos,160,Hontangas,134,86,48
9,Burgos,162,Hontoria de la Cantera,137,69,68
9,Burgos,164,Hontoria de Valdearados,236,144,92
9,Burgos,163,Hontoria del Pinar,787,422,365
9,Burgos,166,Hormazas (Las),134,72,62
9,Burgos,167,Hornillos del Camino,70,38,32
9,Burgos,168,Horra (La),417,222,195
9,Burgos,169,Hortigüela,126,75,51
9,Burgos,170,Hoyales de Roa,269,132,137
9,Burgos,172,Huérmeces,131,69,62
9,Burgos,173,Huerta de Arriba,170,94,76
9,Burgos,174,Huerta de Rey,1208,627,581
9,Burgos,175,Humada,177,108,69
9,Burgos,176,Hurones,70,44,26
9,Burgos,177,Ibeas de Juarros,1192,641,551
9,Burgos,178,Ibrillos,92,53,39
9,Burgos,179,Iglesiarrubia,58,33,25
9,Burgos,180,Iglesias,163,93,70
9,Burgos,181,Isar,385,173,212
9,Burgos,182,Itero del Castillo,110,56,54
9,Burgos,183,Jaramillo de la Fuente,41,23,18
9,Burgos,184,Jaramillo Quemado,15,9,6
9,Burgos,189,Junta de Traslaloma,200,107,93
9,Burgos,190,Junta de Villalba de Losa,115,54,61
9,Burgos,191,Jurisdicción de Lara,59,35,24
9,Burgos,192,Jurisdicción de San Zadornil,110,50,60
9,Burgos,194,Lerma,2619,1273,1346
9,Burgos,195,Llano de Bureba,70,40,30
9,Burgos,196,Madrigal del Monte,209,115,94
9,Burgos,197,Madrigalejo del Monte,211,124,87
9,Burgos,198,Mahamud,159,82,77
9,Burgos,199,Mambrilla de Castrejón,138,72,66
9,Burgos,200,Mambrillas de Lara,69,35,34
9,Burgos,201,Mamolar,62,35,27
9,Burgos,202,Manciles,35,20,15
9,Burgos,206,Mazuela,76,45,31
9,Burgos,208,Mecerreyes,287,150,137
9,Burgos,209,Medina de Pomar,5282,2725,2557
9,Burgos,211,Melgar de Fernamental,1956,1032,924
9,Burgos,213,Merindad de Cuesta-Urria,500,273,227
9,Burgos,214,Merindad de Montija,868,483,385
9,Burgos,906,Merindad de Río Ubierna,1389,730,659
9,Burgos,215,Merindad de Sotoscueva,516,290,226
9,Burgos,216,Merindad de Valdeporres,487,249,238
9,Burgos,217,Merindad de Valdivielso,492,268,224
9,Burgos,218,Milagros,474,262,212
9,Burgos,219,Miranda de Ebro,37020,18335,18685
9,Burgos,220,Miraveche,106,63,43
9,Burgos,221,Modúbar de la Emparedada,367,200,167
9,Burgos,223,Monasterio de la Sierra,43,28,15
9,Burgos,224,Monasterio de Rodilla,224,126,98
9,Burgos,225,Moncalvillo,105,66,39
9,Burgos,226,Monterrubio de la Demanda,100,51,49
9,Burgos,227,Montorio,175,92,83
9,Burgos,228,Moradillo de Roa,209,116,93
9,Burgos,229,Nava de Roa,246,129,117
9,Burgos,230,Navas de Bureba,46,21,25
9,Burgos,231,Nebreda,95,59,36
9,Burgos,232,Neila,235,127,108
9,Burgos,235,Olmedillo de Roa,194,101,93
9,Burgos,236,Olmillos de Muñó,41,24,17
9,Burgos,238,Oña,1485,760,725
9,Burgos,239,Oquillas,74,40,34
9,Burgos,241,Orbaneja Riopico,177,103,74
9,Burgos,242,Padilla de Abajo,101,62,39
9,Burgos,243,Padilla de Arriba,110,62,48
9,Burgos,244,Padrones de Bureba,59,35,24
9,Burgos,246,Palacios de la Sierra,870,448,422
9,Burgos,247,Palacios de Riopisuerga,30,16,14
9,Burgos,248,Palazuelos de la Sierra,73,42,31
9,Burgos,249,Palazuelos de Muñó,65,39,26
9,Burgos,250,Pampliega,403,214,189
9,Burgos,251,Pancorbo,464,242,222
9,Burgos,253,Pardilla,126,66,60
9,Burgos,255,Partido de la Sierra en Tobalina,68,46,22
9,Burgos,256,Pedrosa de Duero,501,269,232
9,Burgos,259,Pedrosa de Río Úrbel,269,162,107
9,Burgos,257,Pedrosa del Páramo,103,56,47
9,Burgos,258,Pedrosa del Príncipe,217,110,107
9,Burgos,261,Peñaranda de Duero,583,310,273
9,Burgos,262,Peral de Arlanza,223,116,107
9,Burgos,265,Piérnigas,38,26,12
9,Burgos,266,Pineda de la Sierra,127,70,57
9,Burgos,267,Pineda Trasmonte,161,90,71
9,Burgos,268,Pinilla de los Barruecos,133,73,60
9,Burgos,269,Pinilla de los Moros,44,29,15
9,Burgos,270,Pinilla Trasmonte,214,118,96
9,Burgos,272,Poza de la Sal,387,192,195
9,Burgos,273,Prádanos de Bureba,59,37,22
9,Burgos,274,Pradoluengo,1651,836,815
9,Burgos,275,Presencio,238,124,114
9,Burgos,276,Puebla de Arganzón (La),465,254,211
9,Burgos,277,Puentedura,119,72,47
9,Burgos,279,Quemada,254,148,106
9,Burgos,281,Quintana del Pidio,180,96,84
9,Burgos,280,Quintanabureba,39,23,16
9,Burgos,283,Quintanaélez,85,39,46
9,Burgos,287,Quintanaortuño,163,89,74
9,Burgos,288,Quintanapalla,116,64,52
9,Burgos,289,Quintanar de la Sierra,1896,978,918
9,Burgos,292,Quintanavides,118,59,59
9,Burgos,294,Quintanilla de la Mata,157,84,73
9,Burgos,901,Quintanilla del Agua y Tordueles,582,318,264
9,Burgos,295,Quintanilla del Coco,106,58,48
9,Burgos,298,Quintanilla San García,98,51,47
9,Burgos,301,Quintanilla Vivar,581,300,281
9,Burgos,297,Quintanillas (Las),372,204,168
9,Burgos,302,Rabanera del Pinar,141,74,67
9,Burgos,303,Rábanos,120,69,51
9,Burgos,304,Rabé de las Calzadas,154,81,73
9,Burgos,306,Rebolledo de la Torre,167,93,74
9,Burgos,307,Redecilla del Camino,148,80,68
9,Burgos,308,Redecilla del Campo,79,44,35
9,Burgos,309,Regumiel de la Sierra,458,222,236
9,Burgos,310,Reinoso,22,14,8
9,Burgos,311,Retuerta,65,35,30
9,Burgos,314,Revilla del Campo,132,72,60
9,Burgos,316,Revilla Vallejera,119,70,49
9,Burgos,312,Revilla y Ahedo (La),125,75,50
9,Burgos,315,Revillarruz,178,86,92
9,Burgos,317,Rezmondo,25,11,14
9,Burgos,318,Riocavado de la Sierra,71,42,29
9,Burgos,321,Roa,2272,1182,1090
9,Burgos,323,Rojas,84,52,32
9,Burgos,325,Royuela de Río Franco,289,164,125
9,Burgos,326,Rubena,176,94,82
9,Burgos,327,Rublacedo de Abajo,40,22,18
9,Burgos,328,Rucandio,85,44,41
9,Burgos,329,Salas de Bureba,143,82,61
9,Burgos,330,Salas de los Infantes,2085,1072,1013
9,Burgos,332,Saldaña de Burgos,132,73,59
9,Burgos,334,Salinillas de Bureba,52,31,21
9,Burgos,335,San Adrián de Juarros,52,32,20
9,Burgos,337,San Juan del Monte,167,86,81
9,Burgos,338,San Mamés de Burgos,258,144,114
9,Burgos,339,San Martín de Rubiales,217,119,98
9,Burgos,340,San Millán de Lara,82,56,26
9,Burgos,360,San Vicente del Valle,52,31,21
9,Burgos,343,Santa Cecilia,118,68,50
9,Burgos,345,Santa Cruz de la Salceda,178,99,79
9,Burgos,346,Santa Cruz del Valle Urbión,114,66,48
9,Burgos,347,Santa Gadea del Cid,174,95,79
9,Burgos,348,Santa Inés,185,102,83
9,Burgos,350,Santa María del Campo,693,369,324
9,Burgos,351,Santa María del Invierno,69,46,23
9,Burgos,352,Santa María del Mercadillo,167,97,70
9,Burgos,353,Santa María Rivarredonda,120,62,58
9,Burgos,354,Santa Olalla de Bureba,33,15,18
9,Burgos,355,Santibáñez de Esgueva,148,72,76
9,Burgos,356,Santibáñez del Val,70,44,26
9,Burgos,358,Santo Domingo de Silos,292,181,111
9,Burgos,361,Sargentes de la Lora,196,107,89
9,Burgos,362,Sarracín,285,155,130
9,Burgos,363,Sasamón,1346,743,603
9,Burgos,365,Sequera de Haza (La),53,32,21
9,Burgos,366,Solarana,104,61,43
9,Burgos,368,Sordillos,31,18,13
9,Burgos,369,Sotillo de la Ribera,603,336,267
9,Burgos,372,Sotragero,197,101,96
9,Burgos,373,Sotresgudo,645,359,286
9,Burgos,374,Susinos del Páramo,115,55,60
9,Burgos,375,Tamarón,46,29,17
9,Burgos,377,Tardajos,622,337,285
9,Burgos,378,Tejada,44,27,17
9,Burgos,380,Terradillos de Esgueva,127,61,66
9,Burgos,381,Tinieblas de la Sierra,46,23,23
9,Burgos,382,Tobar,43,25,18
9,Burgos,384,Tordómar,351,203,148
9,Burgos,386,Torrecilla del Monte,88,48,40
9,Burgos,387,Torregalindo,126,68,58
9,Burgos,388,Torrelara,26,14,12
9,Burgos,389,Torrepadre,95,60,35
9,Burgos,390,Torresandino,808,432,376
9,Burgos,391,Tórtoles de Esgueva,529,294,235
9,Burgos,392,Tosantos,60,32,28
9,Burgos,394,Trespaderne,1049,549,500
9,Burgos,395,Tubilla del Agua,209,133,76
9,Burgos,396,Tubilla del Lago,170,98,72
9,Burgos,398,Úrbel del Castillo,100,64,36
9,Burgos,400,Vadocondes,419,221,198
9,Burgos,403,Valdeande,128,79,49
9,Burgos,405,Valdezate,179,91,88
9,Burgos,406,Valdorros,168,95,73
9,Burgos,408,Vallarta de Bureba,61,37,24
9,Burgos,904,Valle de las Navas,620,343,277
9,Burgos,908,Valle de Losa,621,355,266
9,Burgos,409,Valle de Manzanedo,136,75,61
9,Burgos,410,Valle de Mena,3414,1743,1671
9,Burgos,411,Valle de Oca,226,122,104
9,Burgos,902,Valle de Santibáñez,572,297,275
9,Burgos,905,Valle de Sedano,541,301,240
9,Burgos,412,Valle de Tobalina,1069,568,501
9,Burgos,413,Valle de Valdebezana,677,373,304
9,Burgos,414,Valle de Valdelaguna,215,126,89
9,Burgos,415,Valle de Valdelucio,350,188,162
9,Burgos,416,Valle de Zamanzas,78,42,36
9,Burgos,417,Vallejera,55,33,22
9,Burgos,418,Valles de Palenzuela,103,54,49
9,Burgos,419,Valluércanes,105,59,46
9,Burgos,407,Valmala,34,17,17
9,Burgos,422,Vid de Bureba (La),30,13,17
9,Burgos,421,Vid y Barrios (La),322,184,138
9,Burgos,423,Vileña,31,21,10
9,Burgos,427,Villadiego,1903,1030,873
9,Burgos,428,Villaescusa de Roa,169,93,76
9,Burgos,429,Villaescusa la Sombría,62,39,23
9,Burgos,430,Villaespasa,23,12,11
9,Burgos,431,Villafranca Montes de Oca,174,92,82
9,Burgos,432,Villafruela,255,150,105
9,Burgos,433,Villagalijo,80,50,30
9,Burgos,434,Villagonzalo Pedernales,1043,539,504
9,Burgos,437,Villahoz,359,188,171
9,Burgos,438,Villalba de Duero,617,328,289
9,Burgos,439,Villalbilla de Burgos,819,454,365
9,Burgos,440,Villalbilla de Gumiel,121,74,47
9,Burgos,441,Villaldemiro,70,40,30
9,Burgos,442,Villalmanzo,475,255,220
9,Burgos,443,Villamayor de los Montes,224,109,115
9,Burgos,444,Villamayor de Treviño,99,55,44
9,Burgos,445,Villambistia,65,35,30
9,Burgos,446,Villamedianilla,24,12,12
9,Burgos,447,Villamiel de la Sierra,38,21,17
9,Burgos,448,Villangómez,315,182,133
9,Burgos,449,Villanueva de Argaño,126,72,54
9,Burgos,450,Villanueva de Carazo,25,16,9
9,Burgos,451,Villanueva de Gumiel,288,150,138
9,Burgos,454,Villanueva de Teba,57,34,23
9,Burgos,455,Villaquirán de la Puebla,57,31,26
9,Burgos,456,Villaquirán de los Infantes,187,97,90
9,Burgos,903,Villarcayo de Merindad de Castilla la Vieja,4031,2059,1972
9,Burgos,458,Villariezo,370,204,166
9,Burgos,460,Villasandino,238,131,107
9,Burgos,463,Villasur de Herreros,318,174,144
9,Burgos,464,Villatuelda,62,36,26
9,Burgos,466,Villaverde del Monte,170,93,77
9,Burgos,467,Villaverde-Mogina,109,67,42
9,Burgos,471,Villayerno Morquillas,191,95,96
9,Burgos,472,Villazopeque,78,47,31
9,Burgos,473,Villegas,116,65,51
9,Burgos,476,Villoruebo,64,40,24
9,Burgos,424,Viloria de Rioja,62,35,27
9,Burgos,425,Vilviestre del Pinar,751,391,360
9,Burgos,478,Vizcaínos,57,33,24
9,Burgos,480,Zael,129,69,60
9,Burgos,482,Zarzosa de Río Pisuerga,52,28,24
9,Burgos,483,Zazuar,267,141,126
9,Burgos,485,Zuñeda,68,36,32
10,Cáceres,1,Abadía,288,162,126
10,Cáceres,2,Abertura,506,263,243
10,Cáceres,3,Acebo,724,382,342
10,Cáceres,4,Acehúche,883,438,445
10,Cáceres,5,Aceituna,645,339,306
10,Cáceres,6,Ahigal,1605,830,775
10,Cáceres,7,Albalá,878,439,439
10,Cáceres,8,Alcántara,1725,856,869
10,Cáceres,9,Alcollarín,310,154,156
10,Cáceres,10,Alcuéscar,3033,1585,1448
10,Cáceres,12,Aldea del Cano,742,358,384
10,Cáceres,13,Aldea del Obispo (La),384,201,183
10,Cáceres,11,Aldeacentenera,889,460,429
10,Cáceres,14,Aldeanueva de la Vera,2385,1168,1217
10,Cáceres,15,Aldeanueva del Camino,858,420,438
10,Cáceres,16,Aldehuela de Jerte,352,199,153
10,Cáceres,17,Alía,1210,617,593
10,Cáceres,18,Aliseda,1963,988,975
10,Cáceres,19,Almaraz,1354,702,652
10,Cáceres,20,Almoharín,2062,1034,1028
10,Cáceres,21,Arroyo de la Luz,6635,3295,3340
10,Cáceres,23,Arroyomolinos,946,488,458
10,Cáceres,22,Arroyomolinos de la Vera,558,279,279
10,Cáceres,24,Baños de Montemayor,672,313,359
10,Cáceres,25,Barrado,517,263,254
10,Cáceres,26,Belvís de Monroy,616,307,309
10,Cáceres,27,Benquerencia,103,56,47
10,Cáceres,28,Berrocalejo,119,55,64
10,Cáceres,29,Berzocana,525,265,260
10,Cáceres,30,Bohonal de Ibor,548,286,262
10,Cáceres,31,Botija,153,68,85
10,Cáceres,32,Brozas,2183,1078,1105
10,Cáceres,33,Cabañas del Castillo,521,268,253
10,Cáceres,34,Cabezabellosa,453,222,231
10,Cáceres,35,Cabezuela del Valle,2210,1149,1061
10,Cáceres,36,Cabrero,377,203,174
10,Cáceres,37,Cáceres,88245,42433,45812
10,Cáceres,38,Cachorrilla,92,42,50
10,Cáceres,39,Cadalso,564,295,269
10,Cáceres,40,Calzadilla,494,253,241
10,Cáceres,41,Caminomorisco,1269,658,611
10,Cáceres,42,Campillo de Deleitosa,119,52,67
10,Cáceres,43,Campo Lugar,1149,576,573
10,Cáceres,44,Cañamero,1685,866,819
10,Cáceres,45,Cañaveral,1309,629,680
10,Cáceres,46,Carbajo,251,130,121
10,Cáceres,47,Carcaboso,1041,587,454
10,Cáceres,48,Carrascalejo,397,207,190
10,Cáceres,49,Casar de Cáceres,4718,2354,2364
10,Cáceres,50,Casar de Palomero,1277,647,630
10,Cáceres,51,Casares de las Hurdes,619,304,315
10,Cáceres,52,Casas de Don Antonio,216,102,114
10,Cáceres,53,Casas de Don Gómez,348,181,167
10,Cáceres,56,Casas de Millán,723,366,357
10,Cáceres,57,Casas de Miravete,194,107,87
10,Cáceres,54,Casas del Castañar,666,336,330
10,Cáceres,55,Casas del Monte,890,463,427
10,Cáceres,58,Casatejada,1324,683,641
10,Cáceres,59,Casillas de Coria,498,235,263
10,Cáceres,60,Castañar de Ibor,1205,616,589
10,Cáceres,61,Ceclavín,2109,1050,1059
10,Cáceres,62,Cedillo,563,290,273
10,Cáceres,63,Cerezo,203,96,107
10,Cáceres,64,Cilleros,2000,1024,976
10,Cáceres,65,Collado,237,123,114
10,Cáceres,66,Conquista de la Sierra,226,121,105
10,Cáceres,67,Coria,12832,6480,6352
10,Cáceres,68,Cuacos de Yuste,961,508,453
10,Cáceres,69,Cumbre (La),1049,527,522
10,Cáceres,70,Deleitosa,842,433,409
10,Cáceres,71,Descargamaría,277,160,117
10,Cáceres,72,Eljas,1142,579,563
10,Cáceres,73,Escurial,897,458,439
10,Cáceres,75,Fresnedoso de Ibor,350,171,179
10,Cáceres,76,Galisteo,1992,1005,987
10,Cáceres,77,Garciaz,926,474,452
10,Cáceres,78,Garganta (La),574,312,262
10,Cáceres,79,Garganta la Olla,1153,607,546
10,Cáceres,80,Gargantilla,456,237,219
10,Cáceres,81,Gargüera,167,87,80
10,Cáceres,82,Garrovillas de Alconétar,2411,1171,1240
10,Cáceres,83,Garvín,108,59,49
10,Cáceres,84,Gata,1796,911,885
10,Cáceres,85,Gordo (El),296,140,156
10,Cáceres,86,Granja (La),354,197,157
10,Cáceres,87,Guadalupe,2232,1117,1115
10,Cáceres,88,Guijo de Coria,259,137,122
10,Cáceres,89,Guijo de Galisteo,1552,847,705
10,Cáceres,90,Guijo de Granadilla,683,341,342
10,Cáceres,91,Guijo de Santa Bárbara,442,228,214
10,Cáceres,92,Herguijuela,372,194,178
10,Cáceres,93,Hernán-Pérez,504,261,243
10,Cáceres,94,Herrera de Alcántara,295,150,145
10,Cáceres,95,Herreruela,408,210,198
10,Cáceres,96,Hervás,3834,1886,1948
10,Cáceres,97,Higuera,100,54,46
10,Cáceres,98,Hinojal,444,223,221
10,Cáceres,99,Holguera,785,392,393
10,Cáceres,100,Hoyos,981,499,482
10,Cáceres,101,Huélaga,192,92,100
10,Cáceres,102,Ibahernando,608,295,313
10,Cáceres,103,Jaraicejo,634,310,324
10,Cáceres,104,Jaraíz de la Vera,6748,3426,3322
10,Cáceres,105,Jarandilla de la Vera,3136,1574,1562
10,Cáceres,106,Jarilla,148,74,74
10,Cáceres,107,Jerte,1320,675,645
10,Cáceres,108,Ladrillar,275,150,125
10,Cáceres,109,Logrosán,2239,1154,1085
10,Cáceres,110,Losar de la Vera,3154,1657,1497
10,Cáceres,111,Madrigal de la Vera,1733,906,827
10,Cáceres,112,Madrigalejo,2102,1056,1046
10,Cáceres,113,Madroñera,2998,1492,1506
10,Cáceres,114,Majadas,1311,683,628
10,Cáceres,115,Malpartida de Cáceres,4368,2240,2128
10,Cáceres,116,Malpartida de Plasencia,4279,2129,2150
10,Cáceres,117,Marchagaz,294,148,146
10,Cáceres,118,Mata de Alcántara,330,164,166
10,Cáceres,119,Membrío,890,427,463
10,Cáceres,120,Mesas de Ibor,206,110,96
10,Cáceres,121,Miajadas,9786,4886,4900
10,Cáceres,122,Millanes,192,104,88
10,Cáceres,123,Mirabel,751,383,368
10,Cáceres,124,Mohedas de Granadilla,1071,541,530
10,Cáceres,125,Monroy,994,513,481
10,Cáceres,126,Montánchez,2046,1022,1024
10,Cáceres,127,Montehermoso,5654,2878,2776
10,Cáceres,128,Moraleja,7916,3972,3944
10,Cáceres,129,Morcillo,435,215,220
10,Cáceres,130,Navaconcejo,2105,1057,1048
10,Cáceres,131,Navalmoral de la Mata,16856,8499,8357
10,Cáceres,132,Navalvillar de Ibor,452,240,212
10,Cáceres,133,Navas del Madroño,1497,745,752
10,Cáceres,134,Navezuelas,729,390,339
10,Cáceres,135,Nuñomoral,1581,839,742
10,Cáceres,136,Oliva de Plasencia,265,144,121
10,Cáceres,137,Palomero,513,265,248
10,Cáceres,138,Pasarón de la Vera,698,341,357
10,Cáceres,139,Pedroso de Acim,119,62,57
10,Cáceres,140,Peraleda de la Mata,1515,779,736
10,Cáceres,141,Peraleda de San Román,361,180,181
10,Cáceres,142,Perales del Puerto,992,495,497
10,Cáceres,143,Pescueza,176,83,93
10,Cáceres,144,Pesga (La),1168,614,554
10,Cáceres,145,Piedras Albas,162,80,82
10,Cáceres,146,Pinofranqueado,1638,885,753
10,Cáceres,147,Piornal,1535,756,779
10,Cáceres,148,Plasencia,38815,18999,19816
10,Cáceres,149,Plasenzuela,556,268,288
10,Cáceres,150,Portaje,388,195,193
10,Cáceres,151,Portezuelo,304,148,156
10,Cáceres,152,Pozuelo de Zarzón,599,290,309
10,Cáceres,153,Puerto de Santa Cruz,410,212,198
10,Cáceres,154,Rebollar,227,115,112
10,Cáceres,155,Riolobos,1372,725,647
10,Cáceres,156,Robledillo de Gata,154,83,71
10,Cáceres,157,Robledillo de la Vera,324,159,165
10,Cáceres,158,Robledillo de Trujillo,467,242,225
10,Cáceres,159,Robledollano,390,215,175
10,Cáceres,160,Romangordo,165,81,84
10,Cáceres,901,Rosalejo,1472,800,672
10,Cáceres,161,Ruanes,84,45,39
10,Cáceres,162,Salorino,777,387,390
10,Cáceres,163,Salvatierra de Santiago,386,185,201
10,Cáceres,164,San Martín de Trevejo,949,456,493
10,Cáceres,165,Santa Ana,335,172,163
10,Cáceres,166,Santa Cruz de la Sierra,323,168,155
10,Cáceres,167,Santa Cruz de Paniagua,390,211,179
10,Cáceres,168,Santa Marta de Magasca,261,125,136
10,Cáceres,169,Santiago de Alcántara,705,356,349
10,Cáceres,170,Santiago del Campo,318,161,157
10,Cáceres,171,Santibáñez el Alto,501,251,250
10,Cáceres,172,Santibáñez el Bajo,922,469,453
10,Cáceres,173,Saucedilla,702,369,333
10,Cáceres,174,Segura de Toro,193,94,99
10,Cáceres,175,Serradilla,1832,942,890
10,Cáceres,176,Serrejón,482,247,235
10,Cáceres,177,Sierra de Fuentes,1871,973,898
10,Cáceres,178,Talaván,928,468,460
10,Cáceres,179,Talaveruela de la Vera,413,196,217
10,Cáceres,180,Talayuela,10082,5944,4138
10,Cáceres,181,Tejeda de Tiétar,987,519,468
10,Cáceres,182,Toril,222,136,86
10,Cáceres,183,Tornavacas,1285,683,602
10,Cáceres,184,Torno (El),939,490,449
10,Cáceres,187,Torre de Don Miguel,619,321,298
10,Cáceres,188,Torre de Santa María,669,339,330
10,Cáceres,185,Torrecilla de los Ángeles,723,369,354
10,Cáceres,186,Torrecillas de la Tiesa,1156,581,575
10,Cáceres,190,Torrejón el Rubio,602,313,289
10,Cáceres,189,Torrejoncillo,3371,1656,1715
10,Cáceres,191,Torremenga,617,322,295
10,Cáceres,192,Torremocha,1141,572,569
10,Cáceres,193,Torreorgaz,1672,826,846
10,Cáceres,194,Torrequemada,605,286,319
10,Cáceres,195,Trujillo,9406,4621,4785
10,Cáceres,196,Valdastillas,332,169,163
10,Cáceres,197,Valdecañas de Tajo,200,108,92
10,Cáceres,198,Valdefuentes,1552,791,761
10,Cáceres,199,Valdehúncar,207,106,101
10,Cáceres,200,Valdelacasa de Tajo,534,257,277
10,Cáceres,201,Valdemorales,248,121,127
10,Cáceres,202,Valdeobispo,786,387,399
10,Cáceres,203,Valencia de Alcántara,6106,2996,3110
10,Cáceres,204,Valverde de la Vera,614,308,306
10,Cáceres,205,Valverde del Fresno,2578,1318,1260
10,Cáceres,206,Viandar de la Vera,303,148,155
10,Cáceres,207,Villa del Campo,615,296,319
10,Cáceres,208,Villa del Rey,143,74,69
10,Cáceres,209,Villamesías,348,173,175
10,Cáceres,210,Villamiel,633,356,277
10,Cáceres,211,Villanueva de la Sierra,588,292,296
10,Cáceres,212,Villanueva de la Vera,2075,1057,1018
10,Cáceres,214,Villar de Plasencia,248,125,123
10,Cáceres,213,Villar del Pedroso,765,386,379
10,Cáceres,215,Villasbuenas de Gata,495,257,238
10,Cáceres,216,Zarza de Granadilla,1740,883,857
10,Cáceres,217,Zarza de Montánchez,608,300,308
10,Cáceres,218,Zarza la Mayor,1536,791,745
10,Cáceres,219,Zorita,1816,900,916
11,Cádiz,1,Alcalá de los Gazules,5590,2883,2707
11,Cádiz,2,Alcalá del Valle,5325,2746,2579
11,Cádiz,3,Algar,1643,875,768
11,Cádiz,4,Algeciras,109665,55037,54628
11,Cádiz,5,Algodonales,5650,2884,2766
11,Cádiz,6,Arcos de la Frontera,29079,14550,14529
11,Cádiz,7,Barbate,22444,11269,11175
11,Cádiz,8,Barrios (Los),19260,9687,9573
11,Cádiz,901,Benalup-Casas Viejas,6706,3404,3302
11,Cádiz,9,Benaocaz,702,363,339
11,Cádiz,10,Bornos,8082,3995,4087
11,Cádiz,11,Bosque (El),1978,1008,970
11,Cádiz,12,Cádiz,133242,63695,69547
11,Cádiz,13,Castellar de la Frontera,2813,1424,1389
11,Cádiz,15,Chiclana de la Frontera,68156,34559,33597
11,Cádiz,16,Chipiona,17603,8882,8721
11,Cádiz,14,Conil de la Frontera,18979,9666,9313
11,Cádiz,17,Espera,3846,1964,1882
11,Cádiz,18,Gastor (El),1948,1017,931
11,Cádiz,19,Grazalema,2178,1147,1031
11,Cádiz,20,Jerez de la Frontera,192648,94146,98502
11,Cádiz,21,Jimena de la Frontera,9355,4814,4541
11,Cádiz,22,Línea de la Concepción (La),61875,30593,31282
11,Cádiz,23,Medina-Sidonia,10802,5609,5193
11,Cádiz,24,Olvera,8549,4257,4292
11,Cádiz,25,Paterna de Rivera,5313,2772,2541
11,Cádiz,26,Prado del Rey,5858,2922,2936
11,Cádiz,27,Puerto de Santa María (El),80658,40160,40498
11,Cádiz,28,Puerto Real,37481,18915,18566
11,Cádiz,29,Puerto Serrano,6828,3507,3321
11,Cádiz,30,Rota,26691,13440,13251
11,Cádiz,31,San Fernando,90178,44557,45621
11,Cádiz,902,San José del Valle,4203,2163,2040
11,Cádiz,33,San Roque,24757,12516,12241
11,Cádiz,32,Sanlúcar de Barrameda,62662,31352,31310
11,Cádiz,34,Setenil de las Bodegas,3015,1553,1462
11,Cádiz,35,Tarifa,16743,8514,8229
11,Cádiz,36,Torre Alháquime,883,463,420
11,Cádiz,37,Trebujena,6843,3537,3306
11,Cádiz,38,Ubrique,17404,8603,8801
11,Cádiz,39,Vejer de la Frontera,12685,6403,6282
11,Cádiz,40,Villaluenga del Rosario,473,245,228
11,Cádiz,41,Villamartín,12038,6039,5999
11,Cádiz,42,Zahara,1543,804,739
12,Castellón/Castelló,2,Aín,153,78,75
12,Castellón/Castelló,3,Albocàsser,1385,680,705
12,Castellón/Castelló,4,Alcalà de Xivert,6449,3294,3155
12,Castellón/Castelló,5,Alcora (l'),10084,5147,4937
12,Castellón/Castelló,6,Alcudia de Veo,204,100,104
12,Castellón/Castelló,7,Alfondeguilla,871,437,434
12,Castellón/Castelló,8,Algimia de Almonacid,269,159,110
12,Castellón/Castelló,9,Almazora/Almassora,18961,9456,9505
12,Castellón/Castelló,10,Almedíjar,270,134,136
12,Castellón/Castelló,11,Almenara,5045,2490,2555
12,Castellón/Castelló,901,Alquerías del Niño Perdido,3746,1839,1907
12,Castellón/Castelló,12,Altura,3234,1632,1602
12,Castellón/Castelló,13,Arañuel,191,88,103
12,Castellón/Castelló,14,Ares del Maestre,228,119,109
12,Castellón/Castelló,15,Argelita,117,60,57
12,Castellón/Castelló,16,Artana,1851,927,924
12,Castellón/Castelló,1,Atzeneta del Maestrat,1442,741,701
12,Castellón/Castelló,17,Ayódar,225,125,100
12,Castellón/Castelló,18,Azuébar,348,176,172
12,Castellón/Castelló,20,Barracas,183,101,82
12,Castellón/Castelló,22,Bejís,381,216,165
12,Castellón/Castelló,24,Benafer,145,76,69
12,Castellón/Castelló,25,Benafigos,186,99,87
12,Castellón/Castelló,26,Benasal,1355,680,675
12,Castellón/Castelló,27,Benicarló,22653,11357,11296
12,Castellón/Castelló,28,Benicasim/Benicàssim,15151,7669,7482
12,Castellón/Castelló,29,Benlloch,860,439,421
12,Castellón/Castelló,21,Betxí,5528,2796,2732
12,Castellón/Castelló,31,Borriol,4195,2136,2059
12,Castellón/Castelló,32,Burriana,30059,14961,15098
12,Castellón/Castelló,33,Cabanes,2589,1320,1269
12,Castellón/Castelló,34,Càlig,1721,862,859
12,Castellón/Castelló,36,Canet lo Roig,909,442,467
12,Castellón/Castelló,37,Castell de Cabres,19,9,10
12,Castellón/Castelló,38,Castellfort,218,114,104
12,Castellón/Castelló,39,Castellnovo,1011,485,526
12,Castellón/Castelló,40,Castellón de la Plana/Castelló de la Plana,163088,80576,82512
12,Castellón/Castelló,41,Castillo de Villamalefa,108,53,55
12,Castellón/Castelló,42,Catí,853,442,411
12,Castellón/Castelló,43,Caudiel,704,352,352
12,Castellón/Castelló,44,Cervera del Maestre,640,300,340
12,Castellón/Castelló,52,Chert/Xert,896,439,457
12,Castellón/Castelló,53,Chilches/Xilxes,2550,1320,1230
12,Castellón/Castelló,55,Chodos/Xodos,131,68,63
12,Castellón/Castelló,56,Chóvar,345,176,169
12,Castellón/Castelló,45,Cinctorres,509,229,280
12,Castellón/Castelló,46,Cirat,281,149,132
12,Castellón/Castelló,48,Cortes de Arenoso,392,220,172
12,Castellón/Castelló,49,Costur,471,240,231
12,Castellón/Castelló,50,Coves de Vinromà (les),1877,949,928
12,Castellón/Castelló,51,Culla,697,360,337
12,Castellón/Castelló,57,Eslida,828,416,412
12,Castellón/Castelló,58,Espadilla,62,28,34
12,Castellón/Castelló,59,Fanzara,259,125,134
12,Castellón/Castelló,60,Figueroles,562,285,277
12,Castellón/Castelló,61,Forcall,543,260,283
12,Castellón/Castelló,63,Fuente la Reina,35,19,16
12,Castellón/Castelló,64,Fuentes de Ayódar,95,54,41
12,Castellón/Castelló,65,Gaibiel,197,106,91
12,Castellón/Castelló,67,Geldo,733,370,363
12,Castellón/Castelló,68,Herbés,84,48,36
12,Castellón/Castelló,69,Higueras,92,45,47
12,Castellón/Castelló,70,Jana (la),820,410,410
12,Castellón/Castelló,71,Jérica,1542,782,760
12,Castellón/Castelló,74,Llosa (la),915,460,455
12,Castellón/Castelló,72,Lucena del Cid,1550,792,758
12,Castellón/Castelló,73,Ludiente,206,108,98
12,Castellón/Castelló,75,Mata de Morella (la),171,91,80
12,Castellón/Castelló,76,Matet,130,66,64
12,Castellón/Castelló,77,Moncofa,4705,2427,2278
12,Castellón/Castelló,78,Montán,330,171,159
12,Castellón/Castelló,79,Montanejos,481,240,241
12,Castellón/Castelló,80,Morella,2782,1364,1418
12,Castellón/Castelló,81,Navajas,602,303,299
12,Castellón/Castelló,82,Nules,12065,6025,6040
12,Castellón/Castelló,83,Olocau del Rey,134,75,59
12,Castellón/Castelló,84,Onda,21566,10927,10639
12,Castellón/Castelló,85,Oropesa del Mar/Orpesa,6153,3305,2848
12,Castellón/Castelló,87,Palanques,27,16,11
12,Castellón/Castelló,88,Pavías,58,36,22
12,Castellón/Castelló,89,Peñíscola,5809,2988,2821
12,Castellón/Castelló,90,Pina de Montalgrao,151,79,72
12,Castellón/Castelló,93,Pobla de Benifassà (la),256,129,127
12,Castellón/Castelló,94,Pobla Tornesa (la),670,341,329
12,Castellón/Castelló,91,Portell de Morella,252,122,130
12,Castellón/Castelló,92,Puebla de Arenoso,158,80,78
12,Castellón/Castelló,95,Ribesalbes,1302,670,632
12,Castellón/Castelló,96,Rossell,1291,685,606
12,Castellón/Castelló,97,Sacañet,147,90,57
12,Castellón/Castelló,98,Salzadella (la),801,415,386
12,Castellón/Castelló,101,San Rafael del Río,481,253,228
12,Castellón/Castelló,902,Sant Joan de Moró,1930,1040,890
12,Castellón/Castelló,99,Sant Jordi/San Jorge,637,315,322
12,Castellón/Castelló,100,Sant Mateu,1956,1004,952
12,Castellón/Castelló,102,Santa Magdalena de Pulpis,812,427,385
12,Castellón/Castelló,103,Sarratella,91,54,37
12,Castellón/Castelló,104,Segorbe,8299,4044,4255
12,Castellón/Castelló,105,Sierra Engarcerán,1073,555,518
12,Castellón/Castelló,106,Soneja,1350,677,673
12,Castellón/Castelló,107,Sot de Ferrer,487,248,239
12,Castellón/Castelló,108,Sueras/Suera,573,286,287
12,Castellón/Castelló,109,Tales,753,375,378
12,Castellón/Castelló,110,Teresa,328,165,163
12,Castellón/Castelló,111,Tírig,573,300,273
12,Castellón/Castelló,112,Todolella,134,82,52
12,Castellón/Castelló,113,Toga,85,42,43
12,Castellón/Castelló,114,Torás,266,132,134
12,Castellón/Castelló,115,Toro (El),292,155,137
12,Castellón/Castelló,116,Torralba del Pinar,68,32,36
12,Castellón/Castelló,119,Torre d'En Besora (la),190,103,87
12,Castellón/Castelló,120,Torre Endoménech,238,126,112
12,Castellón/Castelló,117,Torreblanca,5430,2808,2622
12,Castellón/Castelló,118,Torrechiva,98,61,37
12,Castellón/Castelló,121,Traiguera,1561,826,735
12,Castellón/Castelló,122,Useras/Useres (les),988,513,475
12,Castellón/Castelló,124,Vall d'Alba,2045,1039,1006
12,Castellón/Castelló,125,Vall de Almonacid,266,136,130
12,Castellón/Castelló,126,Vall d'Uixó (la),30610,15306,15304
12,Castellón/Castelló,123,Vallat,62,31,31
12,Castellón/Castelló,127,Vallibona,89,49,40
12,Castellón/Castelló,128,Vilafamés,1603,862,741
12,Castellón/Castelló,132,Vilanova d'Alcolea,637,331,306
12,Castellón/Castelló,134,Vilar de Canes,185,93,92
12,Castellón/Castelló,136,Vilavella (la),3360,1691,1669
12,Castellón/Castelló,129,Villafranca del Cid,2569,1256,1313
12,Castellón/Castelló,130,Villahermosa del Río,439,237,202
12,Castellón/Castelló,131,Villamalur,108,58,50
12,Castellón/Castelló,133,Villanueva de Viver,71,38,33
12,Castellón/Castelló,135,Villarreal/Vila-real,45582,22814,22768
12,Castellón/Castelló,137,Villores,56,30,26
12,Castellón/Castelló,138,Vinaròs,24467,12112,12355
12,Castellón/Castelló,139,Vistabella del Maestrazgo,418,213,205
12,Castellón/Castelló,140,Viver,1413,734,679
12,Castellón/Castelló,141,Zorita del Maestrazgo,131,64,67
12,Castellón/Castelló,142,Zucaina,199,112,87
13,Ciudad Real,1,Abenójar,1693,846,847
13,Ciudad Real,2,Agudo,1945,982,963
13,Ciudad Real,3,Alamillo,631,321,310
13,Ciudad Real,4,Albaladejo,1563,798,765
13,Ciudad Real,5,Alcázar de San Juan,28199,13861,14338
13,Ciudad Real,6,Alcoba,757,378,379
13,Ciudad Real,7,Alcolea de Calatrava,1621,824,797
13,Ciudad Real,8,Alcubillas,678,362,316
13,Ciudad Real,9,Aldea del Rey,2051,1009,1042
13,Ciudad Real,10,Alhambra,1190,601,589
13,Ciudad Real,11,Almadén,6543,3136,3407
13,Ciudad Real,12,Almadenejos,520,273,247
13,Ciudad Real,13,Almagro,8492,4158,4334
13,Ciudad Real,14,Almedina,703,357,346
13,Ciudad Real,15,Almodóvar del Campo,7011,3459,3552
13,Ciudad Real,16,Almuradiel,991,474,517
13,Ciudad Real,17,Anchuras,444,264,180
13,Ciudad Real,903,Arenales de San Gregorio,686,354,332
13,Ciudad Real,18,Arenas de San Juan,1075,554,521
13,Ciudad Real,19,Argamasilla de Alba,6832,3391,3441
13,Ciudad Real,20,Argamasilla de Calatrava,5374,2720,2654
13,Ciudad Real,21,Arroba de los Montes,584,308,276
13,Ciudad Real,22,Ballesteros de Calatrava,614,310,304
13,Ciudad Real,23,Bolaños de Calatrava,11831,6064,5767
13,Ciudad Real,24,Brazatortas,1143,582,561
13,Ciudad Real,25,Cabezarados,371,188,183
13,Ciudad Real,26,Cabezarrubias del Puerto,608,311,297
13,Ciudad Real,27,Calzada de Calatrava,4603,2285,2318
13,Ciudad Real,28,Campo de Criptana,13258,6596,6662
13,Ciudad Real,29,Cañada de Calatrava,103,59,44
13,Ciudad Real,30,Caracuel de Calatrava,166,87,79
13,Ciudad Real,31,Carrión de Calatrava,2660,1324,1336
13,Ciudad Real,32,Carrizosa,1568,792,776
13,Ciudad Real,33,Castellar de Santiago,2190,1081,1109
13,Ciudad Real,38,Chillón,2201,1069,1132
13,Ciudad Real,34,Ciudad Real,67401,31972,35429
13,Ciudad Real,35,Corral de Calatrava,1262,640,622
13,Ciudad Real,36,Cortijos (Los),1005,501,504
13,Ciudad Real,37,Cózar,1293,654,639
13,Ciudad Real,39,Daimiel,17542,8656,8886
13,Ciudad Real,40,Fernán Caballero,1094,533,561
13,Ciudad Real,41,Fontanarejo,305,158,147
13,Ciudad Real,42,Fuencaliente,1246,652,594
13,Ciudad Real,43,Fuenllana,283,133,150
13,Ciudad Real,44,Fuente el Fresno,3474,1749,1725
13,Ciudad Real,45,Granátula de Calatrava,1011,500,511
13,Ciudad Real,46,Guadalmez,971,494,477
13,Ciudad Real,47,Herencia,7693,3980,3713
13,Ciudad Real,48,Hinojosas de Calatrava,706,335,371
13,Ciudad Real,49,Horcajo de los Montes,1057,531,526
13,Ciudad Real,50,Labores (Las),678,342,336
13,Ciudad Real,904,Llanos del Caudillo,651,337,314
13,Ciudad Real,51,Luciana,438,224,214
13,Ciudad Real,52,Malagón,7964,3938,4026
13,Ciudad Real,53,Manzanares,18344,9133,9211
13,Ciudad Real,54,Membrilla,6516,3255,3261
13,Ciudad Real,55,Mestanza,830,403,427
13,Ciudad Real,56,Miguelturra,11344,5705,5639
13,Ciudad Real,57,Montiel,1689,858,831
13,Ciudad Real,58,Moral de Calatrava,5239,2616,2623
13,Ciudad Real,59,Navalpino,273,138,135
13,Ciudad Real,60,Navas de Estena,395,212,183
13,Ciudad Real,61,Pedro Muñoz,7637,3921,3716
13,Ciudad Real,62,Picón,661,343,318
13,Ciudad Real,63,Piedrabuena,4816,2444,2372
13,Ciudad Real,64,Poblete,919,461,458
13,Ciudad Real,65,Porzuna,3932,1977,1955
13,Ciudad Real,66,Pozuelo de Calatrava,2691,1341,1350
13,Ciudad Real,67,Pozuelos de Calatrava (Los),485,244,241
13,Ciudad Real,68,Puebla de Don Rodrigo,1267,674,593
13,Ciudad Real,69,Puebla del Príncipe,975,494,481
13,Ciudad Real,70,Puerto Lápice,1008,511,497
13,Ciudad Real,71,Puertollano,49775,24199,25576
13,Ciudad Real,72,Retuerta del Bullaque,1040,552,488
13,Ciudad Real,901,Robledo (El),1078,556,522
13,Ciudad Real,902,Ruidera,593,302,291
13,Ciudad Real,73,Saceruela,703,365,338
13,Ciudad Real,74,San Carlos del Valle,1220,612,608
13,Ciudad Real,75,San Lorenzo de Calatrava,279,143,136
13,Ciudad Real,76,Santa Cruz de los Cáñamos,638,316,322
13,Ciudad Real,77,Santa Cruz de Mudela,4801,2364,2437
13,Ciudad Real,78,Socuéllamos,12600,6412,6188
13,Ciudad Real,79,Solana (La),15432,7756,7676
13,Ciudad Real,80,Solana del Pino,442,219,223
13,Ciudad Real,81,Terrinches,1019,553,466
13,Ciudad Real,82,Tomelloso,32002,15918,16084
13,Ciudad Real,83,Torralba de Calatrava,2940,1463,1477
13,Ciudad Real,84,Torre de Juan Abad,1349,665,684
13,Ciudad Real,85,Torrenueva,3120,1592,1528
13,Ciudad Real,86,Valdemanco del Esteras,263,128,135
13,Ciudad Real,87,Valdepeñas,27274,13239,14035
13,Ciudad Real,88,Valenzuela de Calatrava,803,382,421
13,Ciudad Real,89,Villahermosa,2453,1166,1287
13,Ciudad Real,90,Villamanrique,1528,745,783
13,Ciudad Real,91,Villamayor de Calatrava,623,315,308
13,Ciudad Real,92,Villanueva de la Fuente,2607,1305,1302
13,Ciudad Real,93,Villanueva de los Infantes,5834,2861,2973
13,Ciudad Real,94,Villanueva de San Carlos,418,212,206
13,Ciudad Real,95,Villar del Pozo,117,60,57
13,Ciudad Real,96,Villarrubia de los Ojos,9968,5016,4952
13,Ciudad Real,97,Villarta de San Juan,3043,1564,1479
13,Ciudad Real,98,Viso del Marqués,2958,1481,1477
14,Córdoba,1,Adamuz,4397,2214,2183
14,Córdoba,2,Aguilar de la Frontera,13522,6721,6801
14,Córdoba,3,Alcaracejos,1446,704,742
14,Córdoba,4,Almedinilla,2563,1293,1270
14,Córdoba,5,Almodóvar del Río,7324,3622,3702
14,Córdoba,6,Añora,1536,758,778
14,Córdoba,7,Baena,20071,10073,9998
14,Córdoba,8,Belalcázar,3602,1733,1869
14,Córdoba,9,Belmez,3527,1698,1829
14,Córdoba,10,Benamejí,4897,2464,2433
14,Córdoba,11,Blázquez (Los),693,348,345
14,Córdoba,12,Bujalance,7915,3897,4018
14,Córdoba,13,Cabra,20837,10141,10696
14,Córdoba,14,Cañete de las Torres,3209,1605,1604
14,Córdoba,15,Carcabuey,2834,1427,1407
14,Córdoba,16,Cardeña,1776,897,879
14,Córdoba,17,Carlota (La),11203,5642,5561
14,Córdoba,18,Carpio (El),4473,2201,2272
14,Córdoba,19,Castro del Río,8076,3999,4077
14,Córdoba,20,Conquista,492,240,252
14,Córdoba,21,Córdoba,319692,153991,165701
14,Córdoba,22,Doña Mencía,5002,2484,2518
14,Córdoba,23,Dos Torres,2609,1281,1328
14,Córdoba,24,Encinas Reales,2408,1189,1219
14,Córdoba,25,Espejo,3821,1906,1915
14,Córdoba,26,Espiel,2379,1187,1192
14,Córdoba,27,Fernán-Núñez,9407,4708,4699
14,Córdoba,28,Fuente la Lancha,427,205,222
14,Córdoba,29,Fuente Obejuna,5530,2794,2736
14,Córdoba,30,Fuente Palmera,10146,5097,5049
14,Córdoba,31,Fuente-Tójar,805,381,424
14,Córdoba,32,Granjuela (La),498,255,243
14,Córdoba,33,Guadalcázar,1215,613,602
14,Córdoba,34,Guijo (El),392,199,193
14,Córdoba,35,Hinojosa del Duque,7643,3689,3954
14,Córdoba,36,Hornachuelos,4654,2342,2312
14,Córdoba,37,Iznájar,4907,2450,2457
14,Córdoba,38,Lucena,39259,19518,19741
14,Córdoba,39,Luque,3265,1616,1649
14,Córdoba,40,Montalbán de Córdoba,4609,2333,2276
14,Córdoba,41,Montemayor,3894,1949,1945
14,Córdoba,42,Montilla,23223,11471,11752
14,Córdoba,43,Montoro,9491,4681,4810
14,Córdoba,44,Monturque,1995,1002,993
14,Córdoba,45,Moriles,3835,1913,1922
14,Córdoba,46,Nueva Carteya,5578,2811,2767
14,Córdoba,47,Obejo,1500,748,752
14,Córdoba,48,Palenciana,1565,783,782
14,Córdoba,49,Palma del Río,20030,9999,10031
14,Córdoba,50,Pedro Abad,2914,1458,1456
14,Córdoba,51,Pedroche,1732,857,875
14,Córdoba,52,Peñarroya-Pueblonuevo,12351,5928,6423
14,Córdoba,53,Posadas,7257,3590,3667
14,Córdoba,54,Pozoblanco,16759,8125,8634
14,Córdoba,55,Priego de Córdoba,22906,11285,11621
14,Córdoba,56,Puente Genil,28396,14100,14296
14,Córdoba,57,Rambla (La),7376,3672,3704
14,Córdoba,58,Rute,9960,4934,5026
14,Córdoba,59,San Sebastián de los Ballesteros,854,444,410
14,Córdoba,61,Santa Eufemia,1036,530,506
14,Córdoba,60,Santaella,5938,2971,2967
14,Córdoba,62,Torrecampo,1396,674,722
14,Córdoba,63,Valenzuela,1391,680,711
14,Córdoba,64,Valsequillo,423,202,221
14,Córdoba,65,Victoria (La),1802,910,892
14,Córdoba,66,Villa del Río,7358,3726,3632
14,Córdoba,67,Villafranca de Córdoba,3758,1925,1833
14,Córdoba,68,Villaharta,615,311,304
14,Córdoba,69,Villanueva de Córdoba,9740,4784,4956
14,Córdoba,70,Villanueva del Duque,1689,808,881
14,Córdoba,71,Villanueva del Rey,1232,628,604
14,Córdoba,72,Villaralto,1425,693,732
14,Córdoba,73,Villaviciosa de Córdoba,3667,1867,1800
14,Córdoba,74,Viso (El),2885,1414,1471
14,Córdoba,75,Zuheros,838,425,413
15,Coruña (A),1,Abegondo,5732,2850,2882
15,Coruña (A),2,Ames,20840,10131,10709
15,Coruña (A),3,Aranga,2274,1144,1130
15,Coruña (A),4,Ares,5265,2604,2661
15,Coruña (A),5,Arteixo,25295,12648,12647
15,Coruña (A),6,Arzúa,6632,3253,3379
15,Coruña (A),7,Baña (A),4888,2366,2522
15,Coruña (A),8,Bergondo,6413,3128,3285
15,Coruña (A),9,Betanzos,12990,6128,6862
15,Coruña (A),10,Boimorto,2486,1258,1228
15,Coruña (A),11,Boiro,18302,8874,9428
15,Coruña (A),12,Boqueixón,4337,2134,2203
15,Coruña (A),13,Brión,6684,3222,3462
15,Coruña (A),14,Cabana de Bergantiños,5354,2643,2711
15,Coruña (A),15,Cabanas,3368,1673,1695
15,Coruña (A),16,Camariñas,6502,3199,3303
15,Coruña (A),17,Cambre,20919,10330,10589
15,Coruña (A),18,Capela (A),1526,751,775
15,Coruña (A),19,Carballo,29521,14393,15128
15,Coruña (A),901,Cariño,4798,2352,2446
15,Coruña (A),20,Carnota,5285,2546,2739
15,Coruña (A),21,Carral,5453,2657,2796
15,Coruña (A),22,Cedeira,7477,3699,3778
15,Coruña (A),23,Cee,7344,3551,3793
15,Coruña (A),24,Cerceda,5499,2684,2815
15,Coruña (A),25,Cerdido,1558,755,803
15,Coruña (A),26,Cesuras,2463,1214,1249
15,Coruña (A),27,Coirós,1650,812,838
15,Coruña (A),28,Corcubión,1964,956,1008
15,Coruña (A),29,Coristanco,7765,3788,3977
15,Coruña (A),30,Coruña (A),242846,113306,129540
15,Coruña (A),31,Culleredo,24640,12028,12612
15,Coruña (A),32,Curtis,4421,2168,2253
15,Coruña (A),33,Dodro,3162,1541,1621
15,Coruña (A),34,Dumbría,4166,2028,2138
15,Coruña (A),35,Fene,14485,7037,7448
15,Coruña (A),36,Ferrol,77859,36358,41501
15,Coruña (A),37,Fisterra,5093,2585,2508
15,Coruña (A),38,Frades,2920,1456,1464
15,Coruña (A),39,Irixoa,1619,806,813
15,Coruña (A),41,Laracha (A),10800,5266,5534
15,Coruña (A),40,Laxe,3558,1788,1770
15,Coruña (A),42,Lousame,3912,1866,2046
15,Coruña (A),43,Malpica de Bergantiños,6890,3378,3512
15,Coruña (A),44,Mañón,1830,882,948
15,Coruña (A),45,Mazaricos,5639,2709,2930
15,Coruña (A),46,Melide,7809,3817,3992
15,Coruña (A),47,Mesía,3216,1615,1601
15,Coruña (A),48,Miño,5089,2433,2656
15,Coruña (A),49,Moeche,1461,674,787
15,Coruña (A),50,Monfero,2490,1269,1221
15,Coruña (A),51,Mugardos,5612,2703,2909
15,Coruña (A),53,Muros,10050,4860,5190
15,Coruña (A),52,Muxía,5899,2900,2999
15,Coruña (A),54,Narón,34404,16660,17744
15,Coruña (A),55,Neda,5804,2846,2958
15,Coruña (A),56,Negreira,6497,3092,3405
15,Coruña (A),57,Noia,14481,6914,7567
15,Coruña (A),58,Oleiros,29671,14408,15263
15,Coruña (A),59,Ordes,12287,5982,6305
15,Coruña (A),60,Oroso,6155,3053,3102
15,Coruña (A),61,Ortigueira,7830,3739,4091
15,Coruña (A),62,Outes,8050,3837,4213
15,Coruña (A),63,Oza dos Ríos,3154,1527,1627
15,Coruña (A),64,Paderne,2689,1310,1379
15,Coruña (A),65,Padrón,9070,4339,4731
15,Coruña (A),66,Pino (O),4940,2440,2500
15,Coruña (A),67,Pobra do Caramiñal (A),9992,4798,5194
15,Coruña (A),68,Ponteceso,6810,3400,3410
15,Coruña (A),69,Pontedeume,8694,4175,4519
15,Coruña (A),70,Pontes de García Rodríguez (As),11911,5964,5947
15,Coruña (A),71,Porto do Son,10039,4956,5083
15,Coruña (A),72,Rianxo,11582,5652,5930
15,Coruña (A),73,Ribeira,26623,13137,13486
15,Coruña (A),74,Rois,5122,2431,2691
15,Coruña (A),75,Sada,12453,6147,6306
15,Coruña (A),76,San Sadurniño,3229,1574,1655
15,Coruña (A),77,Santa Comba,10704,5189,5515
15,Coruña (A),78,Santiago de Compostela,92298,43237,49061
15,Coruña (A),79,Santiso,2212,1125,1087
15,Coruña (A),80,Sobrado,2360,1187,1173
15,Coruña (A),81,Somozas (As),1403,693,710
15,Coruña (A),82,Teo,16428,8058,8370
15,Coruña (A),83,Toques,1530,790,740
15,Coruña (A),84,Tordoia,4713,2242,2471
15,Coruña (A),85,Touro,4634,2287,2347
15,Coruña (A),86,Trazo,3652,1798,1854
15,Coruña (A),88,Val do Dubra,4642,2251,2391
15,Coruña (A),87,Valdoviño,6854,3360,3494
15,Coruña (A),89,Vedra,5057,2429,2628
15,Coruña (A),91,Vilarmaior,1362,695,667
15,Coruña (A),90,Vilasantar,1574,820,754
15,Coruña (A),92,Vimianzo,8517,4133,4384
15,Coruña (A),93,Zas,5867,2873,2994
16,Cuenca,1,Abia de la Obispalía,88,48,40
16,Cuenca,2,Acebrón (El),269,138,131
16,Cuenca,3,Alarcón,182,83,99
16,Cuenca,4,Albaladejo del Cuende,378,198,180
16,Cuenca,5,Albalate de las Nogueras,365,199,166
16,Cuenca,6,Albendea,166,85,81
16,Cuenca,7,Alberca de Záncara (La),1829,927,902
16,Cuenca,8,Alcalá de la Vega,160,84,76
16,Cuenca,9,Alcantud,103,57,46
16,Cuenca,10,Alcázar del Rey,220,110,110
16,Cuenca,11,Alcohujate,70,42,28
16,Cuenca,12,Alconchel de la Estrella,183,95,88
16,Cuenca,13,Algarra,36,19,17
16,Cuenca,14,Aliaguilla,830,427,403
16,Cuenca,15,Almarcha (La),579,305,274
16,Cuenca,16,Almendros,302,151,151
16,Cuenca,17,Almodóvar del Pinar,514,270,244
16,Cuenca,18,Almonacid del Marquesado,525,273,252
16,Cuenca,19,Altarejos,314,163,151
16,Cuenca,20,Arandilla del Arroyo,36,20,16
16,Cuenca,905,Arcas del Villar,882,455,427
16,Cuenca,22,Arcos de la Sierra,111,56,55
16,Cuenca,24,Arguisuelas,173,98,75
16,Cuenca,25,Arrancacepas,39,20,19
16,Cuenca,26,Atalaya del Cañavate,119,61,58
16,Cuenca,27,Barajas de Melo,790,405,385
16,Cuenca,29,Barchín del Hoyo,122,70,52
16,Cuenca,30,Bascuñana de San Pedro,36,21,15
16,Cuenca,31,Beamud,101,54,47
16,Cuenca,32,Belinchón,351,177,174
16,Cuenca,33,Belmonte,2352,1142,1210
16,Cuenca,34,Belmontejo,218,107,111
16,Cuenca,35,Beteta,412,202,210
16,Cuenca,36,Boniches,172,82,90
16,Cuenca,38,Buciegas,67,34,33
16,Cuenca,39,Buenache de Alarcón,630,329,301
16,Cuenca,40,Buenache de la Sierra,109,69,40
16,Cuenca,41,Buendía,493,251,242
16,Cuenca,42,Campillo de Altobuey,1707,867,840
16,Cuenca,43,Campillos-Paravientos,133,75,58
16,Cuenca,44,Campillos-Sierra,79,43,36
16,Cuenca,901,Campos del Paraíso,1001,468,533
16,Cuenca,45,Canalejas del Arroyo,388,202,186
16,Cuenca,46,Cañada del Hoyo,325,168,157
16,Cuenca,47,Cañada Juncosa,334,182,152
16,Cuenca,48,Cañamares,616,334,282
16,Cuenca,49,Cañavate (El),214,102,112
16,Cuenca,50,Cañaveras,392,199,193
16,Cuenca,51,Cañaveruelas,201,98,103
16,Cuenca,52,Cañete,878,438,440
16,Cuenca,53,Cañizares,602,309,293
16,Cuenca,55,Carboneras de Guadazaón,940,489,451
16,Cuenca,56,Cardenete,722,380,342
16,Cuenca,57,Carrascosa,112,66,46
16,Cuenca,58,Carrascosa de Haro,142,69,73
16,Cuenca,60,Casas de Benítez,1079,525,554
16,Cuenca,61,Casas de Fernando Alonso,1333,679,654
16,Cuenca,62,Casas de Garcimolina,34,22,12
16,Cuenca,63,Casas de Guijarro,131,65,66
16,Cuenca,64,Casas de Haro,855,447,408
16,Cuenca,65,Casas de los Pinos,530,254,276
16,Cuenca,66,Casasimarro,3045,1551,1494
16,Cuenca,67,Castejón,216,102,114
16,Cuenca,68,Castillejo de Iniesta,183,103,80
16,Cuenca,70,Castillejo-Sierra,46,23,23
16,Cuenca,72,Castillo de Garcimuñoz,192,100,92
16,Cuenca,71,Castillo-Albaráñez,25,12,13
16,Cuenca,73,Cervera del Llano,296,155,141
16,Cuenca,23,Chillarón de Cuenca,446,239,207
16,Cuenca,81,Chumillas,70,38,32
16,Cuenca,74,Cierva (La),51,29,22
16,Cuenca,78,Cuenca,47862,22950,24912
16,Cuenca,79,Cueva del Hierro,50,29,21
16,Cuenca,82,Enguídanos,472,239,233
16,Cuenca,83,Fresneda de Altarejos,85,46,39
16,Cuenca,84,Fresneda de la Sierra,73,36,37
16,Cuenca,85,Frontera (La),207,104,103
16,Cuenca,86,Fuente de Pedro Naharro,1258,656,602
16,Cuenca,87,Fuentelespino de Haro,314,163,151
16,Cuenca,88,Fuentelespino de Moya,166,90,76
16,Cuenca,904,Fuentenava de Jábaga,467,238,229
16,Cuenca,89,Fuentes,512,265,247
16,Cuenca,91,Fuertescusa,120,67,53
16,Cuenca,92,Gabaldón,198,114,84
16,Cuenca,93,Garaballa,130,70,60
16,Cuenca,94,Gascueña,151,66,85
16,Cuenca,95,Graja de Campalbo,129,71,58
16,Cuenca,96,Graja de Iniesta,401,230,171
16,Cuenca,97,Henarejos,248,123,125
16,Cuenca,98,Herrumblar (El),763,391,372
16,Cuenca,99,Hinojosa (La),294,149,145
16,Cuenca,100,Hinojosos (Los),1084,544,540
16,Cuenca,101,Hito (El),227,116,111
16,Cuenca,102,Honrubia,1650,817,833
16,Cuenca,103,Hontanaya,421,215,206
16,Cuenca,104,Hontecillas,97,45,52
16,Cuenca,106,Horcajo de Santiago,3679,1876,1803
16,Cuenca,107,Huélamo,127,63,64
16,Cuenca,108,Huelves,60,27,33
16,Cuenca,109,Huérguina,100,54,46
16,Cuenca,110,Huerta de la Obispalía,155,86,69
16,Cuenca,111,Huerta del Marquesado,234,130,104
16,Cuenca,112,Huete,2079,1054,1025
16,Cuenca,113,Iniesta,4284,2143,2141
16,Cuenca,115,Laguna del Marquesado,72,36,36
16,Cuenca,116,Lagunaseca,129,56,73
16,Cuenca,117,Landete,1407,712,695
16,Cuenca,118,Ledaña,1911,958,953
16,Cuenca,119,Leganiel,243,122,121
16,Cuenca,121,Majadas (Las),364,180,184
16,Cuenca,122,Mariana,306,151,155
16,Cuenca,123,Masegosa,119,64,55
16,Cuenca,124,Mesas (Las),2498,1295,1203
16,Cuenca,125,Minglanilla,2309,1189,1120
16,Cuenca,126,Mira,1194,621,573
16,Cuenca,128,Monreal del Llano,76,39,37
16,Cuenca,129,Montalbanejo,177,85,92
16,Cuenca,130,Montalbo,713,368,345
16,Cuenca,131,Monteagudo de las Salinas,147,85,62
16,Cuenca,132,Mota de Altarejos,56,35,21
16,Cuenca,133,Mota del Cuervo,5912,2970,2942
16,Cuenca,134,Motilla del Palancar,5497,2753,2744
16,Cuenca,135,Moya,257,137,120
16,Cuenca,137,Narboneta,113,59,54
16,Cuenca,139,Olivares de Júcar,511,265,246
16,Cuenca,140,Olmeda de la Cuesta,42,22,20
16,Cuenca,141,Olmeda del Rey,218,108,110
16,Cuenca,142,Olmedilla de Alarcón,147,83,64
16,Cuenca,143,Olmedilla de Eliz,29,15,14
16,Cuenca,145,Osa de la Vega,660,332,328
16,Cuenca,146,Pajarón,117,64,53
16,Cuenca,147,Pajaroncillo,94,49,45
16,Cuenca,148,Palomares del Campo,928,452,476
16,Cuenca,149,Palomera,189,92,97
16,Cuenca,150,Paracuellos,153,71,82
16,Cuenca,151,Paredes,84,46,38
16,Cuenca,152,Parra de las Vegas (La),46,25,21
16,Cuenca,153,Pedernoso (El),1296,653,643
16,Cuenca,154,Pedroñeras (Las),6951,3723,3228
16,Cuenca,155,Peral (El),730,386,344
16,Cuenca,156,Peraleja (La),139,69,70
16,Cuenca,157,Pesquera (La),268,138,130
16,Cuenca,158,Picazo (El),731,371,360
16,Cuenca,159,Pinarejo,361,173,188
16,Cuenca,160,Pineda de Gigüela,137,72,65
16,Cuenca,161,Piqueras del Castillo,82,45,37
16,Cuenca,162,Portalrubio de Guadamejud,67,35,32
16,Cuenca,163,Portilla,100,49,51
16,Cuenca,165,Poyatos,105,62,43
16,Cuenca,166,Pozoamargo,338,171,167
16,Cuenca,908,Pozorrubielos de la Mancha,276,131,145
16,Cuenca,167,Pozorrubio,446,215,231
16,Cuenca,169,Pozuelo (El),113,55,58
16,Cuenca,170,Priego,1052,541,511
16,Cuenca,171,Provencio (El),2641,1327,1314
16,Cuenca,172,Puebla de Almenara,487,246,241
16,Cuenca,173,Puebla de Don Francisco,323,169,154
16,Cuenca,174,Puebla del Salvador,273,144,129
16,Cuenca,175,Quintanar del Rey,7254,3868,3386
16,Cuenca,176,Rada de Haro,62,34,28
16,Cuenca,177,Reíllo,126,67,59
16,Cuenca,181,Rozalén del Monte,98,41,57
16,Cuenca,185,Saceda-Trasierra,106,61,45
16,Cuenca,186,Saelices,649,327,322
16,Cuenca,187,Salinas del Manzano,107,59,48
16,Cuenca,188,Salmeroncillos,176,93,83
16,Cuenca,189,Salvacañete,335,179,156
16,Cuenca,190,San Clemente,6711,3421,3290
16,Cuenca,191,San Lorenzo de la Parrilla,1339,671,668
16,Cuenca,192,San Martín de Boniches,92,44,48
16,Cuenca,193,San Pedro Palmiches,96,50,46
16,Cuenca,194,Santa Cruz de Moya,393,204,189
16,Cuenca,196,Santa María de los Llanos,798,414,384
16,Cuenca,195,Santa María del Campo Rus,762,386,376
16,Cuenca,197,Santa María del Val,102,58,44
16,Cuenca,198,Sisante,1795,901,894
16,Cuenca,199,Solera de Gabaldón,38,16,22
16,Cuenca,909,Sotorribas,936,468,468
16,Cuenca,202,Talayuelas,1144,588,556
16,Cuenca,203,Tarancón,12696,6294,6402
16,Cuenca,204,Tébar,387,203,184
16,Cuenca,205,Tejadillos,184,92,92
16,Cuenca,206,Tinajas,370,200,170
16,Cuenca,209,Torralba,186,102,84
16,Cuenca,211,Torrejoncillo del Rey,652,319,333
16,Cuenca,212,Torrubia del Campo,334,162,172
16,Cuenca,213,Torrubia del Castillo,38,20,18
16,Cuenca,215,Tragacete,356,194,162
16,Cuenca,216,Tresjuncos,445,224,221
16,Cuenca,217,Tribaldos,129,59,70
16,Cuenca,218,Uclés,287,138,149
16,Cuenca,219,Uña,138,75,63
16,Cuenca,906,Valdecolmenas (Los),111,62,49
16,Cuenca,224,Valdemeca,100,55,45
16,Cuenca,225,Valdemorillo de la Sierra,81,45,36
16,Cuenca,227,Valdemoro-Sierra,173,97,76
16,Cuenca,228,Valdeolivas,269,148,121
16,Cuenca,902,Valdetórtola,146,81,65
16,Cuenca,903,Valeras (Las),1399,721,678
16,Cuenca,231,Valhermoso de la Fuente,46,22,24
16,Cuenca,234,Valsalobre,67,35,32
16,Cuenca,236,Valverde de Júcar,1355,699,656
16,Cuenca,237,Valverdejo,129,64,65
16,Cuenca,238,Vara de Rey,637,327,310
16,Cuenca,239,Vega del Codorno,214,105,109
16,Cuenca,240,Vellisca,161,78,83
16,Cuenca,242,Villaconejos de Trabaque,484,243,241
16,Cuenca,243,Villaescusa de Haro,585,297,288
16,Cuenca,244,Villagarcía del Llano,939,484,455
16,Cuenca,245,Villalba de la Sierra,616,309,307
16,Cuenca,246,Villalba del Rey,662,340,322
16,Cuenca,247,Villalgordo del Marquesado,114,62,52
16,Cuenca,248,Villalpardo,1141,580,561
16,Cuenca,249,Villamayor de Santiago,2741,1378,1363
16,Cuenca,250,Villanueva de Guadamejud,112,60,52
16,Cuenca,251,Villanueva de la Jara,2232,1138,1094
16,Cuenca,253,Villar de Cañas,457,238,219
16,Cuenca,254,Villar de Domingo García,271,143,128
16,Cuenca,255,Villar de la Encina,220,110,110
16,Cuenca,263,Villar de Olalla,1006,517,489
16,Cuenca,258,Villar del Humo,372,218,154
16,Cuenca,259,Villar del Infantado,48,27,21
16,Cuenca,910,Villar y Velasco,114,61,53
16,Cuenca,264,Villarejo de Fuentes,727,349,378
16,Cuenca,265,Villarejo de la Peñuela,31,15,16
16,Cuenca,266,Villarejo-Periesteban,510,259,251
16,Cuenca,269,Villares del Saz,639,327,312
16,Cuenca,270,Villarrubio,254,126,128
16,Cuenca,271,Villarta,820,422,398
16,Cuenca,272,Villas de la Ventosa,356,192,164
16,Cuenca,273,Villaverde y Pasaconsol,413,198,215
16,Cuenca,274,Víllora,227,98,129
16,Cuenca,275,Vindel,24,11,13
16,Cuenca,276,Yémeda,26,13,13
16,Cuenca,277,Zafra de Záncara,173,92,81
16,Cuenca,278,Zafrilla,123,61,62
16,Cuenca,279,Zarza de Tajo,260,129,131
16,Cuenca,280,Zarzuela,265,138,127
17,Girona,1,Agullana,746,382,364
17,Girona,2,Aiguaviva,593,301,292
17,Girona,3,Albanyà,135,71,64
17,Girona,4,Albons,574,304,270
17,Girona,6,Alp,1315,691,624
17,Girona,7,Amer,2184,1077,1107
17,Girona,8,Anglès,5096,2625,2471
17,Girona,9,Arbúcies,5775,3056,2719
17,Girona,10,Argelaguer,385,204,181
17,Girona,11,Armentera (L'),738,364,374
17,Girona,12,Avinyonet de Puigventós,983,495,488
17,Girona,15,Banyoles,16423,8175,8248
17,Girona,16,Bàscara,870,454,416
17,Girona,13,Begur,3861,1986,1875
17,Girona,18,Bellcaire d'Empordà,645,338,307
17,Girona,19,Besalú,2165,1057,1108
17,Girona,20,Bescanó,3648,1827,1821
17,Girona,21,Beuda,146,78,68
17,Girona,22,Bisbal d'Empordà (La),8885,4426,4459
17,Girona,234,Biure,234,120,114
17,Girona,23,Blanes,35577,17940,17637
17,Girona,29,Boadella d'Empordà,234,113,121
17,Girona,24,Bolvir,276,141,135
17,Girona,25,Bordils,1425,723,702
17,Girona,26,Borrassà,557,292,265
17,Girona,27,Breda,3566,1821,1745
17,Girona,28,Brunyola,348,173,175
17,Girona,31,Cabanelles,244,141,103
17,Girona,30,Cabanes,852,447,405
17,Girona,32,Cadaqués,2730,1322,1408
17,Girona,33,Caldes de Malavella,4925,2469,2456
17,Girona,34,Calonge,8757,4440,4317
17,Girona,35,Camós,659,339,320
17,Girona,36,Campdevànol,3361,1668,1693
17,Girona,37,Campelles,122,67,55
17,Girona,38,Campllong,352,180,172
17,Girona,39,Camprodon,2390,1175,1215
17,Girona,40,Canet d'Adri,538,280,258
17,Girona,41,Cantallops,267,131,136
17,Girona,42,Capmany,485,254,231
17,Girona,44,Cassà de la Selva,8325,4226,4099
17,Girona,46,Castellfollit de la Roca,979,498,481
17,Girona,47,Castelló d'Empúries,7777,4031,3746
17,Girona,48,Castell-Platja d'Aro,8470,4328,4142
17,Girona,189,Cellera de Ter (La),2038,1035,1003
17,Girona,49,Celrà,3218,1606,1612
17,Girona,50,Cervià de Ter,730,359,371
17,Girona,51,Cistella,233,118,115
17,Girona,54,Colera,655,331,324
17,Girona,55,Colomers,202,101,101
17,Girona,57,Corçà,1201,606,595
17,Girona,56,Cornellà del Terri,1992,1004,988
17,Girona,58,Crespià,227,112,115
17,Girona,901,"Cruïlles, Monells i Sant Sadurní de l'Heura",1201,594,607
17,Girona,60,Darnius,516,260,256
17,Girona,61,Das,165,89,76
17,Girona,62,Escala (L'),7455,3785,3670
17,Girona,63,Espinelves,189,100,89
17,Girona,64,Espolla,380,189,191
17,Girona,65,Esponellà,426,207,219
17,Girona,5,Far d'Empordà (El),440,226,214
17,Girona,66,Figueres,37032,18034,18998
17,Girona,67,Flaçà,932,478,454
17,Girona,68,Foixà,321,158,163
17,Girona,69,Fontanals de Cerdanya,428,208,220
17,Girona,70,Fontanilles,159,91,68
17,Girona,71,Fontcoberta,1145,556,589
17,Girona,902,Forallac,1746,857,889
17,Girona,73,Fornells de la Selva,1760,854,906
17,Girona,74,Fortià,547,267,280
17,Girona,75,Garrigàs,321,174,147
17,Girona,76,Garrigoles,141,77,64
17,Girona,77,Garriguella,717,376,341
17,Girona,78,Ger,409,207,202
17,Girona,79,Girona,83531,40340,43191
17,Girona,80,Gombrèn,236,111,125
17,Girona,81,Gualta,330,183,147
17,Girona,82,Guils de Cerdanya,368,186,182
17,Girona,83,Hostalric,3247,1622,1625
17,Girona,84,Isòvol,202,114,88
17,Girona,85,Jafre,359,194,165
17,Girona,86,Jonquera (La),2920,1487,1433
17,Girona,87,Juià,287,150,137
17,Girona,88,Lladó,561,282,279
17,Girona,89,Llagostera,6461,3319,3142
17,Girona,90,Llambilles,522,264,258
17,Girona,91,Llanars,527,278,249
17,Girona,92,Llançà,4205,2097,2108
17,Girona,93,Llers,1097,554,543
17,Girona,94,Llívia,1173,619,554
17,Girona,95,Lloret de Mar,26557,13703,12854
17,Girona,96,Llosses (Les),262,145,117
17,Girona,102,Maçanet de Cabrenys,721,372,349
17,Girona,103,Maçanet de la Selva,4913,2532,2381
17,Girona,97,Madremanya,208,92,116
17,Girona,98,Maià de Montcal,365,193,172
17,Girona,100,Masarac,258,122,136
17,Girona,101,Massanes,588,315,273
17,Girona,99,Meranges,85,54,31
17,Girona,105,Mieres,356,184,172
17,Girona,106,Mollet de Peralada,174,90,84
17,Girona,107,Molló,343,174,169
17,Girona,109,Montagut i Oix,858,445,413
17,Girona,110,Mont-ras,1761,913,848
17,Girona,111,Navata,826,409,417
17,Girona,112,Ogassa,260,148,112
17,Girona,114,Olot,30306,15049,15257
17,Girona,115,Ordis,335,179,156
17,Girona,116,Osor,429,220,209
17,Girona,117,Palafrugell,19813,10094,9719
17,Girona,118,Palamós,16231,8047,8184
17,Girona,119,Palau de Santa Eulàlia,84,50,34
17,Girona,121,Palau-sator,284,147,137
17,Girona,120,Palau-saverdera,1031,514,517
17,Girona,123,Palol de Revardit,420,222,198
17,Girona,124,Pals,2261,1152,1109
17,Girona,125,Pardines,154,81,73
17,Girona,126,Parlavà,349,183,166
17,Girona,128,Pau,454,230,224
17,Girona,129,Pedret i Marzà,144,74,70
17,Girona,130,Pera (La),424,213,211
17,Girona,132,Peralada,1491,768,723
17,Girona,133,Planes d'Hostoles (Les),1720,860,860
17,Girona,134,Planoles,304,164,140
17,Girona,135,Pont de Molins,450,236,214
17,Girona,136,Pontós,212,115,97
17,Girona,137,Porqueres,3919,1928,1991
17,Girona,140,Port de la Selva (El),922,464,458
17,Girona,138,Portbou,1365,676,689
17,Girona,139,Preses (Les),1644,798,846
17,Girona,141,Puigcerdà,8370,4374,3996
17,Girona,142,Quart,2609,1322,1287
17,Girona,43,Queralbs,198,113,85
17,Girona,143,Rabós,167,83,84
17,Girona,144,Regencós,303,165,138
17,Girona,145,Ribes de Freser,2040,1012,1028
17,Girona,146,Riells i Viabrea,2818,1481,1337
17,Girona,147,Ripoll,10717,5259,5458
17,Girona,148,Riudarenes,1581,814,767
17,Girona,149,Riudaura,406,207,199
17,Girona,150,Riudellots de la Selva,1735,886,849
17,Girona,151,Riumors,163,81,82
17,Girona,152,Roses,14687,7376,7311
17,Girona,153,Rupià,196,104,92
17,Girona,154,Sales de Llierca,108,56,52
17,Girona,155,Salt,25912,13559,12353
17,Girona,157,Sant Andreu Salou,152,71,81
17,Girona,183,Sant Aniol de Finestres,291,157,134
17,Girona,158,Sant Climent Sescebes,453,229,224
17,Girona,159,Sant Feliu de Buixalleu,752,405,347
17,Girona,160,Sant Feliu de Guíxols,19693,9739,9954
17,Girona,161,Sant Feliu de Pallerols,1202,595,607
17,Girona,162,Sant Ferriol,198,107,91
17,Girona,163,Sant Gregori,2705,1390,1315
17,Girona,164,Sant Hilari Sacalm,5466,2855,2611
17,Girona,165,Sant Jaume de Llierca,778,398,380
17,Girona,167,Sant Joan de les Abadesses,3597,1794,1803
17,Girona,168,Sant Joan de Mollet,437,211,226
17,Girona,185,Sant Joan les Fonts,2660,1328,1332
17,Girona,166,Sant Jordi Desvalls,647,326,321
17,Girona,169,Sant Julià de Ramis,2340,1191,1149
17,Girona,903,Sant Julià del Llor i Bonmatí,991,507,484
17,Girona,171,Sant Llorenç de la Muga,192,92,100
17,Girona,172,Sant Martí de Llémena,509,267,242
17,Girona,173,Sant Martí Vell,185,103,82
17,Girona,174,Sant Miquel de Campmajor,199,110,89
17,Girona,175,Sant Miquel de Fluvià,654,340,314
17,Girona,176,Sant Mori,160,79,81
17,Girona,177,Sant Pau de Segúries,656,328,328
17,Girona,178,Sant Pere Pescador,1618,882,736
17,Girona,180,Santa Coloma de Farners,10036,5143,4893
17,Girona,181,Santa Cristina d'Aro,3735,1949,1786
17,Girona,182,Santa Llogaia d'Àlguema,294,156,138
17,Girona,184,Santa Pau,1516,772,744
17,Girona,186,Sarrià de Ter,3930,1956,1974
17,Girona,187,Saus,713,348,365
17,Girona,188,Selva de Mar (La),207,106,101
17,Girona,190,Serinyà,962,502,460
17,Girona,191,Serra de Daró,178,97,81
17,Girona,192,Setcases,185,95,90
17,Girona,193,Sils,3693,1856,1837
17,Girona,52,Siurana,180,92,88
17,Girona,194,Susqueda,111,62,49
17,Girona,195,Tallada d'Empordà (La),338,183,155
17,Girona,196,Terrades,167,81,86
17,Girona,197,Torrent,173,93,80
17,Girona,198,Torroella de Fluvià,418,239,179
17,Girona,199,Torroella de Montgrí,9714,4953,4761
17,Girona,200,Tortellà,728,364,364
17,Girona,201,Toses,161,98,63
17,Girona,202,Tossa de Mar,5001,2531,2470
17,Girona,204,Ullà,917,494,423
17,Girona,205,Ullastret,221,109,112
17,Girona,203,Ultramort,196,112,84
17,Girona,206,Urús,206,107,99
17,Girona,14,Vajol (La),103,59,44
17,Girona,208,Vall de Bianya (La),1214,602,612
17,Girona,207,Vall d'en Bas (La),2591,1314,1277
17,Girona,170,Vallfogona de Ripollès,224,118,106
17,Girona,209,Vall-llobrega,597,274,323
17,Girona,210,Ventalló,669,344,325
17,Girona,211,Verges,1155,568,587
17,Girona,212,Vidrà,162,81,81
17,Girona,213,Vidreres,5762,3017,2745
17,Girona,214,Vilabertran,822,420,402
17,Girona,215,Vilablareix,2146,1080,1066
17,Girona,217,Viladamat,404,207,197
17,Girona,216,Viladasens,172,89,83
17,Girona,218,Vilademuls,769,398,371
17,Girona,220,Viladrau,959,499,460
17,Girona,221,Vilafant,4657,2324,2333
17,Girona,223,Vilajuïga,1035,512,523
17,Girona,224,Vilallonga de Ter,425,229,196
17,Girona,225,Vilamacolum,294,152,142
17,Girona,226,Vilamalla,878,463,415
17,Girona,227,Vilamaniscle,160,89,71
17,Girona,228,Vilanant,327,164,163
17,Girona,230,Vila-sacra,483,244,239
17,Girona,222,Vilaür,136,67,69
17,Girona,233,Vilobí d'Onyar,2504,1359,1145
17,Girona,232,Vilopriu,175,87,88
18,Granada,1,Agrón,320,169,151
18,Granada,2,Alamedilla,830,419,411
18,Granada,3,Albolote,14862,7504,7358
18,Granada,4,Albondón,941,486,455
18,Granada,5,Albuñán,458,228,230
18,Granada,6,Albuñol,6054,3102,2952
18,Granada,7,Albuñuelas,1100,564,536
18,Granada,10,Aldeire,747,377,370
18,Granada,11,Alfacar,4766,2431,2335
18,Granada,12,Algarinejo,4268,2183,2085
18,Granada,13,Alhama de Granada,6076,3132,2944
18,Granada,14,Alhendín,4729,2419,2310
18,Granada,15,Alicún de Ortega,586,310,276
18,Granada,16,Almegíjar,445,224,221
18,Granada,17,Almuñécar,23073,11397,11676
18,Granada,904,Alpujarra de la Sierra,1175,609,566
18,Granada,18,Alquife,828,412,416
18,Granada,20,Arenas del Rey,1979,1036,943
18,Granada,21,Armilla,16938,8450,8488
18,Granada,22,Atarfe,12355,6117,6238
18,Granada,23,Baza,21600,10711,10889
18,Granada,24,Beas de Granada,1065,569,496
18,Granada,25,Beas de Guadix,367,185,182
18,Granada,27,Benalúa,3222,1609,1613
18,Granada,28,Benalúa de las Villas,1377,691,686
18,Granada,29,Benamaurel,2319,1179,1140
18,Granada,30,Bérchules,788,415,373
18,Granada,32,Bubión,347,181,166
18,Granada,33,Busquístar,352,191,161
18,Granada,34,Cacín,712,354,358
18,Granada,35,Cádiar,1567,802,765
18,Granada,36,Cájar,3838,1861,1977
18,Granada,114,Calahorra (La),813,415,398
18,Granada,37,Calicasas,558,282,276
18,Granada,38,Campotéjar,1408,737,671
18,Granada,39,Caniles,4782,2380,2402
18,Granada,40,Cáñar,339,177,162
18,Granada,42,Capileira,578,287,291
18,Granada,43,Carataunas,204,103,101
18,Granada,44,Cástaras,249,131,118
18,Granada,45,Castilléjar,1608,781,827
18,Granada,46,Castril,2561,1311,1250
18,Granada,47,Cenes de la Vega,6095,3137,2958
18,Granada,59,Chauchina,4315,2166,2149
18,Granada,61,Chimeneas,1481,751,730
18,Granada,62,Churriana de la Vega,8230,4065,4165
18,Granada,48,Cijuela,1855,972,883
18,Granada,49,Cogollos de Guadix,721,381,340
18,Granada,50,Cogollos de la Vega,1935,1006,929
18,Granada,51,Colomera,1567,815,752
18,Granada,53,Cortes de Baza,2388,1213,1175
18,Granada,54,Cortes y Graena,1091,551,540
18,Granada,912,Cuevas del Campo,2048,1022,1026
18,Granada,56,Cúllar,4836,2417,2419
18,Granada,57,Cúllar Vega,5173,2642,2531
18,Granada,63,Darro,1490,740,750
18,Granada,64,Dehesas de Guadix,574,281,293
18,Granada,66,Deifontes,2395,1233,1162
18,Granada,67,Diezma,836,438,398
18,Granada,68,Dílar,1581,779,802
18,Granada,69,Dólar,586,295,291
18,Granada,70,Dúdar,297,160,137
18,Granada,71,Dúrcal,6151,3112,3039
18,Granada,72,Escúzar,764,375,389
18,Granada,74,Ferreira,333,174,159
18,Granada,76,Fonelas,1165,581,584
18,Granada,78,Freila,1019,499,520
18,Granada,79,Fuente Vaqueros,3953,1969,1984
18,Granada,905,Gabias (Las),10400,5461,4939
18,Granada,82,Galera,1152,573,579
18,Granada,83,Gobernador,320,154,166
18,Granada,84,Gójar,4454,2303,2151
18,Granada,85,Gor,1048,539,509
18,Granada,86,Gorafe,538,272,266
18,Granada,87,Granada,238292,110593,127699
18,Granada,88,Guadahortuna,2083,1068,1015
18,Granada,89,Guadix,20035,9841,10194
18,Granada,906,Guajares (Los),1203,636,567
18,Granada,93,Gualchos,2621,1348,1273
18,Granada,94,Güejar Sierra,2828,1500,1328
18,Granada,95,Güevéjar,1859,946,913
18,Granada,96,Huélago,471,247,224
18,Granada,97,Huéneja,1222,628,594
18,Granada,98,Huéscar,8186,4122,4064
18,Granada,99,Huétor de Santillán,1706,895,811
18,Granada,100,Huétor Tájar,8947,4499,4448
18,Granada,101,Huétor Vega,10362,5218,5144
18,Granada,102,Illora,10072,5038,5034
18,Granada,103,Itrabo,1031,513,518
18,Granada,105,Iznalloz,6948,3511,3437
18,Granada,107,Jayena,1271,670,601
18,Granada,108,Jerez del Marquesado,1068,542,526
18,Granada,109,Jete,768,378,390
18,Granada,111,Jun,2053,1052,1001
18,Granada,112,Juviles,178,90,88
18,Granada,115,Láchar,2657,1340,1317
18,Granada,116,Lanjarón,3757,1846,1911
18,Granada,117,Lanteira,507,260,247
18,Granada,119,Lecrín,2269,1150,1119
18,Granada,120,Lentegí,330,165,165
18,Granada,121,Lobras,132,65,67
18,Granada,122,Loja,20707,10315,10392
18,Granada,123,Lugros,370,190,180
18,Granada,124,Lújar,506,275,231
18,Granada,126,Malahá (La),1656,855,801
18,Granada,127,Maracena,17232,8580,8652
18,Granada,128,Marchal,384,181,203
18,Granada,132,Moclín,4243,2129,2114
18,Granada,133,Molvízar,2745,1352,1393
18,Granada,134,Monachil,5765,2962,2803
18,Granada,135,Montefrío,6568,3279,3289
18,Granada,136,Montejícar,2686,1347,1339
18,Granada,137,Montillana,1316,675,641
18,Granada,138,Moraleda de Zafayona,2769,1420,1349
18,Granada,909,Morelábor,852,440,412
18,Granada,140,Motril,55078,27322,27756
18,Granada,141,Murtas,713,395,318
18,Granada,903,Nevada,1228,642,586
18,Granada,143,Nigüelas,955,469,486
18,Granada,144,Nívar,662,342,320
18,Granada,145,Ogíjares,11324,5812,5512
18,Granada,146,Orce,1360,687,673
18,Granada,147,Órgiva,5175,2591,2584
18,Granada,148,Otívar,1056,540,516
18,Granada,149,Otura,5222,2643,2579
18,Granada,150,Padul,7217,3618,3599
18,Granada,151,Pampaneira,327,171,156
18,Granada,152,Pedro Martínez,1267,633,634
18,Granada,153,Peligros,9573,4890,4683
18,Granada,154,Peza (La),1330,717,613
18,Granada,910,Pinar (El),1119,562,557
18,Granada,157,Pinos Genil,1240,651,589
18,Granada,158,Pinos Puente,13303,6785,6518
18,Granada,159,Píñar,1249,661,588
18,Granada,161,Polícar,241,121,120
18,Granada,162,Polopos,1493,840,653
18,Granada,163,Pórtugos,415,203,212
18,Granada,164,Puebla de Don Fadrique,2637,1354,1283
18,Granada,165,Pulianas,4761,2402,2359
18,Granada,167,Purullena,2286,1143,1143
18,Granada,168,Quéntar,1062,545,517
18,Granada,170,Rubite,492,257,235
18,Granada,171,Salar,2760,1393,1367
18,Granada,173,Salobreña,11420,5697,5723
18,Granada,174,Santa Cruz del Comercio,514,280,234
18,Granada,175,Santa Fe,13803,6837,6966
18,Granada,176,Soportújar,269,143,126
18,Granada,177,Sorvilán,694,368,326
18,Granada,901,Taha (La),793,403,390
18,Granada,178,Torre-Cardela,1134,549,585
18,Granada,179,Torvizcón,807,414,393
18,Granada,180,Trevélez,827,434,393
18,Granada,181,Turón,335,194,141
18,Granada,182,Ugíjar,2541,1298,1243
18,Granada,902,Valle (El),1151,547,604
18,Granada,907,Valle del Zalabí,2352,1158,1194
18,Granada,183,Válor,768,386,382
18,Granada,911,Vegas del Genil,4922,2535,2387
18,Granada,184,Vélez de Benaudalla,2575,1307,1268
18,Granada,185,Ventas de Huelma,663,332,331
18,Granada,908,Villamena,988,484,504
18,Granada,187,Villanueva de las Torres,786,411,375
18,Granada,188,Villanueva Mesía,2091,1070,1021
18,Granada,189,Víznar,768,409,359
18,Granada,192,Zafarraya,2202,1208,994
18,Granada,913,Zagra,1094,537,557
18,Granada,193,Zubia (La),15312,7540,7772
18,Granada,194,Zújar,2703,1384,1319
19,Guadalajara,1,Abánades,107,61,46
19,Guadalajara,2,Ablanque,140,72,68
19,Guadalajara,3,Adobes,68,31,37
19,Guadalajara,4,Alaminos,83,42,41
19,Guadalajara,5,Alarilla,122,73,49
19,Guadalajara,6,Albalate de Zorita,813,438,375
19,Guadalajara,7,Albares,508,258,250
19,Guadalajara,8,Albendiego,38,27,11
19,Guadalajara,9,Alcocer,313,154,159
19,Guadalajara,10,Alcolea de las Peñas,24,12,12
19,Guadalajara,11,Alcolea del Pinar,406,210,196
19,Guadalajara,13,Alcoroches,167,91,76
19,Guadalajara,15,Aldeanueva de Guadalajara,115,55,60
19,Guadalajara,16,Algar de Mesa,75,40,35
19,Guadalajara,17,Algora,112,64,48
19,Guadalajara,18,Alhóndiga,244,134,110
19,Guadalajara,19,Alique,36,15,21
19,Guadalajara,20,Almadrones,109,63,46
19,Guadalajara,21,Almoguera,1418,762,656
19,Guadalajara,22,Almonacid de Zorita,826,402,424
19,Guadalajara,23,Alocén,179,85,94
19,Guadalajara,24,Alovera,5636,2940,2696
19,Guadalajara,27,Alustante,261,156,105
19,Guadalajara,31,Angón,35,20,15
19,Guadalajara,32,Anguita,253,133,120
19,Guadalajara,33,Anquela del Ducado,88,44,44
19,Guadalajara,34,Anquela del Pedregal,22,15,7
19,Guadalajara,36,Aranzueque,385,194,191
19,Guadalajara,37,Arbancón,197,110,87
19,Guadalajara,38,Arbeteta,59,30,29
19,Guadalajara,39,Argecilla,100,56,44
19,Guadalajara,40,Armallones,61,38,23
19,Guadalajara,41,Armuña de Tajuña,122,67,55
19,Guadalajara,42,Arroyo de las Fraguas,42,22,20
19,Guadalajara,43,Atanzón,105,65,40
19,Guadalajara,44,Atienza,435,232,203
19,Guadalajara,45,Auñón,254,137,117
19,Guadalajara,46,Azuqueca de Henares,23101,11785,11316
19,Guadalajara,47,Baides,63,31,32
19,Guadalajara,48,Baños de Tajo,29,21,8
19,Guadalajara,49,Bañuelos,23,13,10
19,Guadalajara,50,Barriopedro,32,14,18
19,Guadalajara,51,Berninches,126,70,56
19,Guadalajara,52,Bodera (La),45,27,18
19,Guadalajara,53,Brihuega,2788,1453,1335
19,Guadalajara,54,Budia,270,146,124
19,Guadalajara,55,Bujalaro,79,40,39
19,Guadalajara,57,Bustares,98,61,37
19,Guadalajara,58,Cabanillas del Campo,6450,3266,3184
19,Guadalajara,59,Campillo de Dueñas,111,61,50
19,Guadalajara,60,Campillo de Ranas,184,98,86
19,Guadalajara,61,Campisábalos,71,35,36
19,Guadalajara,64,Canredondo,113,61,52
19,Guadalajara,65,Cantalojas,144,80,64
19,Guadalajara,66,Cañizar,104,51,53
19,Guadalajara,67,Cardoso de la Sierra (El),75,52,23
19,Guadalajara,70,Casa de Uceda,110,58,52
19,Guadalajara,71,Casar (El),5588,2933,2655
19,Guadalajara,73,Casas de San Galindo,32,17,15
19,Guadalajara,74,Caspueñas,98,57,41
19,Guadalajara,75,Castejón de Henares,106,60,46
19,Guadalajara,76,Castellar de la Muela,42,22,20
19,Guadalajara,78,Castilforte,52,32,20
19,Guadalajara,79,Castilnuevo,9,5,4
19,Guadalajara,80,Cendejas de Enmedio,125,68,57
19,Guadalajara,81,Cendejas de la Torre,69,43,26
19,Guadalajara,82,Centenera,88,46,42
19,Guadalajara,103,Checa,364,200,164
19,Guadalajara,104,Chequilla,19,9,10
19,Guadalajara,106,Chillarón del Rey,121,65,56
19,Guadalajara,105,Chiloeches,1684,884,800
19,Guadalajara,86,Cifuentes,2019,1040,979
19,Guadalajara,87,Cincovillas,39,19,20
19,Guadalajara,88,Ciruelas,105,55,50
19,Guadalajara,89,Ciruelos del Pinar,49,27,22
19,Guadalajara,90,Cobeta,108,51,57
19,Guadalajara,91,Cogollor,40,21,19
19,Guadalajara,92,Cogolludo,623,359,264
19,Guadalajara,95,Condemios de Abajo,29,18,11
19,Guadalajara,96,Condemios de Arriba,181,93,88
19,Guadalajara,97,Congostrina,48,25,23
19,Guadalajara,98,Copernal,24,15,9
19,Guadalajara,99,Corduente,430,248,182
19,Guadalajara,102,Cubillo de Uceda (El),119,57,62
19,Guadalajara,107,Driebes,361,184,177
19,Guadalajara,108,Durón,173,88,85
19,Guadalajara,109,Embid,60,33,27
19,Guadalajara,110,Escamilla,105,43,62
19,Guadalajara,111,Escariche,217,116,101
19,Guadalajara,112,Escopete,67,34,33
19,Guadalajara,113,Espinosa de Henares,631,330,301
19,Guadalajara,114,Esplegares,54,32,22
19,Guadalajara,115,Establés,55,31,24
19,Guadalajara,116,Estriégana,24,15,9
19,Guadalajara,117,Fontanar,1263,655,608
19,Guadalajara,118,Fuembellida,15,9,6
19,Guadalajara,119,Fuencemillán,108,53,55
19,Guadalajara,120,Fuentelahiguera de Albatages,156,85,71
19,Guadalajara,121,Fuentelencina,227,122,105
19,Guadalajara,122,Fuentelsaz,118,56,62
19,Guadalajara,123,Fuentelviejo,60,29,31
19,Guadalajara,124,Fuentenovilla,342,193,149
19,Guadalajara,125,Gajanejos,68,40,28
19,Guadalajara,126,Galápagos,678,379,299
19,Guadalajara,127,Galve de Sorbe,133,68,65
19,Guadalajara,129,Gascueña de Bornova,54,34,20
19,Guadalajara,130,Guadalajara,71815,35073,36742
19,Guadalajara,132,Henche,116,62,54
19,Guadalajara,133,Heras de Ayuso,150,82,68
19,Guadalajara,134,Herrería,34,20,14
19,Guadalajara,135,Hiendelaencina,131,70,61
19,Guadalajara,136,Hijes,22,12,10
19,Guadalajara,138,Hita,299,165,134
19,Guadalajara,139,Hombrados,44,26,18
19,Guadalajara,142,Hontoba,220,117,103
19,Guadalajara,143,Horche,1775,934,841
19,Guadalajara,145,Hortezuela de Océn,78,41,37
19,Guadalajara,146,Huerce (La),45,28,17
19,Guadalajara,147,Huérmeces del Cerro,53,34,19
19,Guadalajara,148,Huertahernando,66,38,28
19,Guadalajara,150,Hueva,138,68,70
19,Guadalajara,151,Humanes,1272,647,625
19,Guadalajara,152,Illana,747,395,352
19,Guadalajara,153,Iniéstola,17,13,4
19,Guadalajara,154,Inviernas (Las),102,59,43
19,Guadalajara,155,Irueste,65,35,30
19,Guadalajara,156,Jadraque,1354,705,649
19,Guadalajara,157,Jirueque,84,52,32
19,Guadalajara,159,Ledanca,120,65,55
19,Guadalajara,160,Loranca de Tajuña,575,329,246
19,Guadalajara,161,Lupiana,227,121,106
19,Guadalajara,162,Luzaga,106,50,56
19,Guadalajara,163,Luzón,80,39,41
19,Guadalajara,165,Majaelrayo,72,48,24
19,Guadalajara,166,Málaga del Fresno,198,115,83
19,Guadalajara,167,Malaguilla,137,73,64
19,Guadalajara,168,Mandayona,405,200,205
19,Guadalajara,169,Mantiel,79,44,35
19,Guadalajara,170,Maranchón,244,137,107
19,Guadalajara,171,Marchamalo,4548,2357,2191
19,Guadalajara,172,Masegoso de Tajuña,97,52,45
19,Guadalajara,173,Matarrubia,51,32,19
19,Guadalajara,174,Matillas,171,89,82
19,Guadalajara,175,Mazarete,66,29,37
19,Guadalajara,176,Mazuecos,359,182,177
19,Guadalajara,177,Medranda,109,56,53
19,Guadalajara,178,Megina,57,27,30
19,Guadalajara,179,Membrillera,113,53,60
19,Guadalajara,181,Miedes de Atienza,103,57,46
19,Guadalajara,182,Mierla (La),27,18,9
19,Guadalajara,184,Millana,158,80,78
19,Guadalajara,183,Milmarcos,125,71,54
19,Guadalajara,185,Miñosa (La),57,33,24
19,Guadalajara,186,Mirabueno,111,65,46
19,Guadalajara,187,Miralrío,76,41,35
19,Guadalajara,188,Mochales,90,44,46
19,Guadalajara,189,Mohernando,151,81,70
19,Guadalajara,190,Molina de Aragón,3478,1780,1698
19,Guadalajara,191,Monasterio,24,11,13
19,Guadalajara,192,Mondéjar,2500,1293,1207
19,Guadalajara,193,Montarrón,44,24,20
19,Guadalajara,194,Moratilla de los Meleros,95,52,43
19,Guadalajara,195,Morenilla,51,28,23
19,Guadalajara,196,Muduex,120,63,57
19,Guadalajara,197,Navas de Jadraque (Las),33,17,16
19,Guadalajara,198,Negredo,20,10,10
19,Guadalajara,199,Ocentejo,41,20,21
19,Guadalajara,200,Olivar (El),161,92,69
19,Guadalajara,201,Olmeda de Cobeta,112,54,58
19,Guadalajara,202,Olmeda de Jadraque (La),23,13,10
19,Guadalajara,203,Ordial (El),48,22,26
19,Guadalajara,204,Orea,258,148,110
19,Guadalajara,208,Pálmaces de Jadraque,65,38,27
19,Guadalajara,209,Pardos,67,34,33
19,Guadalajara,210,Paredes de Sigüenza,43,24,19
19,Guadalajara,211,Pareja,502,262,240
19,Guadalajara,212,Pastrana,1071,538,533
19,Guadalajara,213,Pedregal (El),106,57,49
19,Guadalajara,214,Peñalén,126,73,53
19,Guadalajara,215,Peñalver,209,120,89
19,Guadalajara,216,Peralejos de las Truchas,169,89,80
19,Guadalajara,217,Peralveche,112,72,40
19,Guadalajara,218,Pinilla de Jadraque,83,41,42
19,Guadalajara,219,Pinilla de Molina,27,18,9
19,Guadalajara,220,Pioz,864,486,378
19,Guadalajara,221,Piqueras,61,37,24
19,Guadalajara,222,Pobo de Dueñas (El),150,83,67
19,Guadalajara,223,Poveda de la Sierra,179,102,77
19,Guadalajara,224,Pozo de Almoguera,154,81,73
19,Guadalajara,225,Pozo de Guadalajara,646,338,308
19,Guadalajara,226,Prádena de Atienza,50,31,19
19,Guadalajara,227,Prados Redondos,124,71,53
19,Guadalajara,228,Puebla de Beleña,52,31,21
19,Guadalajara,229,Puebla de Valles,84,46,38
19,Guadalajara,230,Quer,449,248,201
19,Guadalajara,231,Rebollosa de Jadraque,32,20,12
19,Guadalajara,232,Recuenco (El),92,47,45
19,Guadalajara,233,Renera,61,33,28
19,Guadalajara,234,Retiendas,50,23,27
19,Guadalajara,235,Riba de Saelices,168,93,75
19,Guadalajara,237,Rillo de Gallo,74,42,32
19,Guadalajara,238,Riofrío del Llano,57,33,24
19,Guadalajara,239,Robledillo de Mohernando,129,67,62
19,Guadalajara,240,Robledo de Corpes,108,56,52
19,Guadalajara,241,Romanillos de Atienza,55,33,22
19,Guadalajara,242,Romanones,127,66,61
19,Guadalajara,243,Rueda de la Sierra,58,32,26
19,Guadalajara,244,Sacecorbo,163,99,64
19,Guadalajara,245,Sacedón,1626,842,784
19,Guadalajara,246,Saelices de la Sal,69,34,35
19,Guadalajara,247,Salmerón,220,115,105
19,Guadalajara,248,San Andrés del Congosto,79,43,36
19,Guadalajara,249,San Andrés del Rey,46,17,29
19,Guadalajara,250,Santiuste,24,16,8
19,Guadalajara,251,Saúca,70,36,34
19,Guadalajara,252,Sayatón,129,72,57
19,Guadalajara,254,Selas,63,30,33
19,Guadalajara,901,Semillas,50,30,20
19,Guadalajara,255,Setiles,147,80,67
19,Guadalajara,256,Sienes,75,42,33
19,Guadalajara,257,Sigüenza,4806,2456,2350
19,Guadalajara,258,Solanillos del Extremo,122,65,57
19,Guadalajara,259,Somolinos,37,17,20
19,Guadalajara,260,Sotillo (El),48,28,20
19,Guadalajara,261,Sotodosos,64,28,36
19,Guadalajara,262,Tamajón,216,111,105
19,Guadalajara,263,Taragudo,38,21,17
19,Guadalajara,264,Taravilla,65,37,28
19,Guadalajara,265,Tartanedo,174,92,82
19,Guadalajara,266,Tendilla,330,177,153
19,Guadalajara,267,Terzaga,28,16,12
19,Guadalajara,268,Tierzo,52,30,22
19,Guadalajara,269,Toba (La),114,64,50
19,Guadalajara,271,Tordellego,62,33,29
19,Guadalajara,270,Tordelrábano,11,3,8
19,Guadalajara,272,Tordesilos,146,77,69
19,Guadalajara,274,Torija,576,274,302
19,Guadalajara,279,Torre del Burgo,122,69,53
19,Guadalajara,277,Torrecuadrada de Molina,23,12,11
19,Guadalajara,278,Torrecuadradilla,51,30,21
19,Guadalajara,280,Torrejón del Rey,2341,1247,1094
19,Guadalajara,281,Torremocha de Jadraque,19,13,6
19,Guadalajara,282,Torremocha del Campo,261,139,122
19,Guadalajara,283,Torremocha del Pinar,60,26,34
19,Guadalajara,284,Torremochuela,18,11,7
19,Guadalajara,285,Torrubia,39,21,18
19,Guadalajara,286,Tórtola de Henares,475,260,215
19,Guadalajara,287,Tortuera,226,121,105
19,Guadalajara,288,Tortuero,35,19,16
19,Guadalajara,289,Traíd,62,30,32
19,Guadalajara,290,Trijueque,909,501,408
19,Guadalajara,291,Trillo,1336,676,660
19,Guadalajara,293,Uceda,1575,824,751
19,Guadalajara,294,Ujados,31,16,15
19,Guadalajara,296,Utande,53,36,17
19,Guadalajara,297,Valdarachas,28,12,16
19,Guadalajara,298,Valdearenas,88,54,34
19,Guadalajara,299,Valdeavellano,103,62,41
19,Guadalajara,300,Valdeaveruelo,530,281,249
19,Guadalajara,301,Valdeconcha,49,27,22
19,Guadalajara,302,Valdegrudas,63,37,26
19,Guadalajara,303,Valdelcubo,68,39,29
19,Guadalajara,304,Valdenuño Fernández,209,113,96
19,Guadalajara,305,Valdepeñas de la Sierra,191,99,92
19,Guadalajara,306,Valderrebollo,42,22,20
19,Guadalajara,307,Valdesotos,26,13,13
19,Guadalajara,308,Valfermoso de Tajuña,97,53,44
19,Guadalajara,309,Valhermoso,45,25,20
19,Guadalajara,310,Valtablado del Río,18,11,7
19,Guadalajara,311,Valverde de los Arroyos,102,54,48
19,Guadalajara,314,Viana de Jadraque,45,28,17
19,Guadalajara,317,Villanueva de Alcorón,269,142,127
19,Guadalajara,318,Villanueva de Argecilla,48,25,23
19,Guadalajara,319,Villanueva de la Torre,4425,2286,2139
19,Guadalajara,321,Villares de Jadraque,55,33,22
19,Guadalajara,322,Villaseca de Henares,58,32,26
19,Guadalajara,323,Villaseca de Uceda,76,45,31
19,Guadalajara,324,Villel de Mesa,227,120,107
19,Guadalajara,325,Viñuelas,118,70,48
19,Guadalajara,326,Yebes,235,160,75
19,Guadalajara,327,Yebra,508,265,243
19,Guadalajara,329,Yélamos de Abajo,84,41,43
19,Guadalajara,330,Yélamos de Arriba,136,73,63
19,Guadalajara,331,Yunquera de Henares,2294,1168,1126
19,Guadalajara,332,Yunta (La),144,74,70
19,Guadalajara,333,Zaorejas,197,112,85
19,Guadalajara,334,Zarzuela de Jadraque,46,22,24
19,Guadalajara,335,Zorita de los Canes,98,52,46
20,Guipúzcoa,1,Abaltzisketa,280,161,119
20,Guipúzcoa,2,Aduna,342,188,154
20,Guipúzcoa,16,Aia,1707,952,755
20,Guipúzcoa,3,Aizarnazabal,579,320,259
20,Guipúzcoa,4,Albiztur,296,162,134
20,Guipúzcoa,5,Alegia,1659,848,811
20,Guipúzcoa,6,Alkiza,290,166,124
20,Guipúzcoa,906,Altzaga,148,74,74
20,Guipúzcoa,7,Altzo,349,181,168
20,Guipúzcoa,8,Amezketa,980,499,481
20,Guipúzcoa,9,Andoain,13803,6887,6916
20,Guipúzcoa,10,Anoeta,1776,904,872
20,Guipúzcoa,11,Antzuola,1946,993,953
20,Guipúzcoa,12,Arama,163,81,82
20,Guipúzcoa,13,Aretxabaleta,6281,3191,3090
20,Guipúzcoa,55,Arrasate/Mondragón,22872,11451,11421
20,Guipúzcoa,14,Asteasu,1346,720,626
20,Guipúzcoa,903,Astigarraga,4109,2084,2025
20,Guipúzcoa,15,Ataun,1514,792,722
20,Guipúzcoa,17,Azkoitia,10345,5147,5198
20,Guipúzcoa,18,Azpeitia,13857,6978,6879
20,Guipúzcoa,904,Baliarrain,101,51,50
20,Guipúzcoa,19,Beasain,12442,6225,6217
20,Guipúzcoa,20,Beizama,166,96,70
20,Guipúzcoa,21,Belauntza,296,163,133
20,Guipúzcoa,22,Berastegi,994,540,454
20,Guipúzcoa,74,Bergara,14918,7473,7445
20,Guipúzcoa,23,Berrobi,571,299,272
20,Guipúzcoa,24,Bidegoian,439,238,201
20,Guipúzcoa,29,Deba,5259,2658,2601
20,Guipúzcoa,69,Donostia-San Sebastián,182644,85981,96663
20,Guipúzcoa,30,Eibar,28006,13705,14301
20,Guipúzcoa,31,Elduain,216,116,100
20,Guipúzcoa,33,Elgeta,1002,511,491
20,Guipúzcoa,32,Elgoibar,10524,5260,5264
20,Guipúzcoa,67,Errenteria,38141,18736,19405
20,Guipúzcoa,66,Errezil,607,321,286
20,Guipúzcoa,34,Eskoriatza,3890,1987,1903
20,Guipúzcoa,35,Ezkio-Itsaso,570,299,271
20,Guipúzcoa,38,Gabiria,419,230,189
20,Guipúzcoa,37,Gaintza,125,74,51
20,Guipúzcoa,907,Gaztelu,151,87,64
20,Guipúzcoa,39,Getaria,2510,1255,1255
20,Guipúzcoa,40,Hernani,18792,9299,9493
20,Guipúzcoa,41,Hernialde,305,151,154
20,Guipúzcoa,36,Hondarribia,15727,7954,7773
20,Guipúzcoa,42,Ibarra,4372,2260,2112
20,Guipúzcoa,43,Idiazabal,2124,1071,1053
20,Guipúzcoa,44,Ikaztegieta,387,198,189
20,Guipúzcoa,45,Irun,58899,28907,29992
20,Guipúzcoa,46,Irura,1079,568,511
20,Guipúzcoa,47,Itsasondo,554,286,268
20,Guipúzcoa,48,Larraul,176,98,78
20,Guipúzcoa,902,Lasarte-Oria,17734,8863,8871
20,Guipúzcoa,49,Lazkao,5064,2603,2461
20,Guipúzcoa,50,Leaburu,369,201,168
20,Guipúzcoa,51,Legazpi,8673,4421,4252
20,Guipúzcoa,52,Legorreta,1363,697,666
20,Guipúzcoa,68,Leintz-Gatzaga,248,136,112
20,Guipúzcoa,53,Lezo,5920,2957,2963
20,Guipúzcoa,54,Lizartza,601,313,288
20,Guipúzcoa,901,Mendaro,1587,831,756
20,Guipúzcoa,57,Mutiloa,156,82,74
20,Guipúzcoa,56,Mutriku,4752,2378,2374
20,Guipúzcoa,63,Oiartzun,9633,4857,4776
20,Guipúzcoa,58,Olaberria,918,467,451
20,Guipúzcoa,59,Oñati,10729,5353,5376
20,Guipúzcoa,76,Ordizia,8926,4349,4577
20,Guipúzcoa,905,Orendain,162,88,74
20,Guipúzcoa,60,Orexa,85,49,36
20,Guipúzcoa,61,Orio,4585,2311,2274
20,Guipúzcoa,62,Ormaiztegi,1242,659,583
20,Guipúzcoa,64,Pasaia,16078,7804,8274
20,Guipúzcoa,70,Segura,1234,612,622
20,Guipúzcoa,65,Soraluze/Placencia de las Armas,4158,2058,2100
20,Guipúzcoa,71,Tolosa,17798,8619,9179
20,Guipúzcoa,72,Urnieta,5807,2954,2853
20,Guipúzcoa,77,Urretxu,6667,3382,3285
20,Guipúzcoa,73,Usurbil,5512,2827,2685
20,Guipúzcoa,75,Villabona,5742,2913,2829
20,Guipúzcoa,78,Zaldibia,1481,764,717
20,Guipúzcoa,79,Zarautz,21906,10840,11066
20,Guipúzcoa,25,Zegama,1307,675,632
20,Guipúzcoa,26,Zerain,249,128,121
20,Guipúzcoa,27,Zestoa,3104,1577,1527
20,Guipúzcoa,28,Zizurkil,2855,1467,1388
20,Guipúzcoa,81,Zumaia,8705,4355,4350
20,Guipúzcoa,80,Zumarraga,10115,5086,5029
21,Huelva,1,Alájar,750,392,358
21,Huelva,2,Aljaraque,14060,7073,6987
21,Huelva,3,Almendro (El),834,436,398
21,Huelva,4,Almonaster la Real,1858,923,935
21,Huelva,5,Almonte,19191,9732,9459
21,Huelva,6,Alosno,4419,2152,2267
21,Huelva,7,Aracena,6979,3414,3565
21,Huelva,8,Aroche,3360,1656,1704
21,Huelva,9,Arroyomolinos de León,1105,563,542
21,Huelva,10,Ayamonte,17623,8693,8930
21,Huelva,11,Beas,4139,2082,2057
21,Huelva,12,Berrocal,371,182,189
21,Huelva,13,Bollullos Par del Condado,13143,6555,6588
21,Huelva,14,Bonares,5267,2703,2564
21,Huelva,15,Cabezas Rubias,899,470,429
21,Huelva,16,Cala,1315,667,648
21,Huelva,17,Calañas,4534,2237,2297
21,Huelva,18,Campillo (El),2293,1101,1192
21,Huelva,19,Campofrío,832,411,421
21,Huelva,20,Cañaveral de León,434,207,227
21,Huelva,21,Cartaya,14767,7648,7119
21,Huelva,22,Castaño del Robledo,201,106,95
21,Huelva,23,Cerro de Andévalo (El),2668,1299,1369
21,Huelva,30,Chucena,1996,1004,992
21,Huelva,24,Corteconcepción,633,320,313
21,Huelva,25,Cortegana,4988,2474,2514
21,Huelva,26,Cortelazor,301,149,152
21,Huelva,27,Cumbres de Enmedio,48,27,21
21,Huelva,28,Cumbres de San Bartolomé,523,253,270
21,Huelva,29,Cumbres Mayores,2001,990,1011
21,Huelva,31,Encinasola,1673,822,851
21,Huelva,32,Escacena del Campo,2162,1075,1087
21,Huelva,33,Fuenteheridos,654,336,318
21,Huelva,34,Galaroza,1651,812,839
21,Huelva,35,Gibraleón,11123,5597,5526
21,Huelva,36,Granada de Río-Tinto (La),231,121,110
21,Huelva,37,Granado (El),624,345,279
21,Huelva,38,Higuera de la Sierra,1344,675,669
21,Huelva,39,Hinojales,392,201,191
21,Huelva,40,Hinojos,3683,1864,1819
21,Huelva,41,Huelva,144369,69884,74485
21,Huelva,42,Isla Cristina,19227,9652,9575
21,Huelva,43,Jabugo,2509,1249,1260
21,Huelva,44,Lepe,21952,11312,10640
21,Huelva,45,Linares de la Sierra,303,144,159
21,Huelva,46,Lucena del Puerto,2310,1207,1103
21,Huelva,47,Manzanilla,2421,1208,1213
21,Huelva,48,Marines (Los),327,164,163
21,Huelva,49,Minas de Riotinto,4509,2171,2338
21,Huelva,50,Moguer,16349,8495,7854
21,Huelva,51,Nava (La),288,151,137
21,Huelva,52,Nerva,6051,2919,3132
21,Huelva,53,Niebla,3947,1992,1955
21,Huelva,54,Palma del Condado (La),9790,4840,4950
21,Huelva,55,Palos de la Frontera,7897,4129,3768
21,Huelva,56,Paterna del Campo,3695,1877,1818
21,Huelva,57,Paymogo,1293,648,645
21,Huelva,58,Puebla de Guzmán,3131,1601,1530
21,Huelva,59,Puerto Moral,258,137,121
21,Huelva,60,Punta Umbría,13089,6661,6428
21,Huelva,61,Rociana del Condado,6408,3306,3102
21,Huelva,62,Rosal de la Frontera,1807,876,931
21,Huelva,63,San Bartolomé de la Torre,2972,1511,1461
21,Huelva,64,San Juan del Puerto,6560,3281,3279
21,Huelva,66,San Silvestre de Guzmán,627,322,305
21,Huelva,65,Sanlúcar de Guadiana,370,187,183
21,Huelva,67,Santa Ana la Real,495,232,263
21,Huelva,68,Santa Bárbara de Casa,1237,616,621
21,Huelva,69,Santa Olalla del Cala,2176,1102,1074
21,Huelva,70,Trigueros,7212,3604,3608
21,Huelva,71,Valdelarco,250,120,130
21,Huelva,72,Valverde del Camino,12497,6072,6425
21,Huelva,73,Villablanca,2222,1172,1050
21,Huelva,74,Villalba del Alcor,3439,1707,1732
21,Huelva,75,Villanueva de las Cruces,410,196,214
21,Huelva,76,Villanueva de los Castillejos,2691,1347,1344
21,Huelva,77,Villarrasa,2114,1072,1042
21,Huelva,78,Zalamea la Real,3523,1735,1788
21,Huelva,79,Zufre,913,480,433
22,Huesca,1,Abiego,288,149,139
22,Huesca,2,Abizanda,131,60,71
22,Huesca,3,Adahuesca,163,86,77
22,Huesca,4,Agüero,162,84,78
22,Huesca,907,Aínsa-Sobrarbe,1766,932,834
22,Huesca,6,Aisa,415,232,183
22,Huesca,7,Albalate de Cinca,1222,667,555
22,Huesca,8,Albalatillo,253,128,125
22,Huesca,9,Albelda,877,449,428
22,Huesca,11,Albero Alto,114,60,54
22,Huesca,12,Albero Bajo,93,51,42
22,Huesca,13,Alberuela de Tubo,370,187,183
22,Huesca,14,Alcalá de Gurrea,292,149,143
22,Huesca,15,Alcalá del Obispo,363,189,174
22,Huesca,16,Alcampell,849,420,429
22,Huesca,17,Alcolea de Cinca,1245,657,588
22,Huesca,18,Alcubierre,439,237,202
22,Huesca,19,Alerre,227,113,114
22,Huesca,20,Alfántega,113,60,53
22,Huesca,21,Almudévar,2377,1236,1141
22,Huesca,22,Almunia de San Juan,660,338,322
22,Huesca,23,Almuniente,571,289,282
22,Huesca,24,Alquézar,309,162,147
22,Huesca,25,Altorricón,1447,760,687
22,Huesca,27,Angüés,423,230,193
22,Huesca,28,Ansó,523,257,266
22,Huesca,29,Antillón,163,82,81
22,Huesca,32,Aragüés del Puerto,143,82,61
22,Huesca,35,Arén,364,185,179
22,Huesca,36,Argavieso,127,70,57
22,Huesca,37,Arguis,61,33,28
22,Huesca,39,Ayerbe,1092,564,528
22,Huesca,40,Azanuy-Alins,179,87,92
22,Huesca,41,Azara,200,101,99
22,Huesca,42,Azlor,154,77,77
22,Huesca,43,Baélls,134,78,56
22,Huesca,44,Bailo,256,150,106
22,Huesca,45,Baldellou,129,73,56
22,Huesca,46,Ballobar,1012,512,500
22,Huesca,47,Banastás,238,124,114
22,Huesca,48,Barbastro,15592,7649,7943
22,Huesca,49,Barbués,108,56,52
22,Huesca,50,Barbuñales,116,59,57
22,Huesca,51,Bárcabo,103,59,44
22,Huesca,52,Belver de Cinca,1375,743,632
22,Huesca,53,Benabarre,1112,587,525
22,Huesca,54,Benasque,2025,1097,928
22,Huesca,55,Berbegal,459,234,225
22,Huesca,57,Bielsa,463,243,220
22,Huesca,58,Bierge,246,137,109
22,Huesca,59,Biescas,1362,736,626
22,Huesca,60,Binaced,1645,889,756
22,Huesca,61,Binéfar,8786,4520,4266
22,Huesca,62,Bisaurri,248,131,117
22,Huesca,63,Biscarrués,232,119,113
22,Huesca,64,Blecua y Torres,189,106,83
22,Huesca,66,Boltaña,870,452,418
22,Huesca,67,Bonansa,101,52,49
22,Huesca,68,Borau,75,42,33
22,Huesca,69,Broto,516,270,246
22,Huesca,72,Caldearenas,270,154,116
22,Huesca,74,Campo,295,139,156
22,Huesca,75,Camporrélls,231,122,109
22,Huesca,76,Canal de Berdún,401,216,185
22,Huesca,77,Candasnos,470,249,221
22,Huesca,78,Canfranc,564,318,246
22,Huesca,79,Capdesaso,160,74,86
22,Huesca,80,Capella,387,196,191
22,Huesca,81,Casbas de Huesca,296,157,139
22,Huesca,83,Castejón de Monegros,683,350,333
22,Huesca,84,Castejón de Sos,731,383,348
22,Huesca,82,Castejón del Puente,435,228,207
22,Huesca,85,Castelflorite,128,68,60
22,Huesca,86,Castiello de Jaca,198,108,90
22,Huesca,87,Castigaleu,115,68,47
22,Huesca,88,Castillazuelo,230,109,121
22,Huesca,89,Castillonroy,410,196,214
22,Huesca,94,Chalamera,153,86,67
22,Huesca,95,Chía,112,58,54
22,Huesca,96,Chimillas,279,144,135
22,Huesca,90,Colungo,135,71,64
22,Huesca,99,Esplús,733,365,368
22,Huesca,102,Estada,192,104,88
22,Huesca,103,Estadilla,856,428,428
22,Huesca,105,Estopiñán del Castillo,217,121,96
22,Huesca,106,Fago,33,20,13
22,Huesca,107,Fanlo,172,100,72
22,Huesca,109,Fiscal,282,160,122
22,Huesca,110,Fonz,1064,534,530
22,Huesca,111,Foradada del Toscar,213,106,107
22,Huesca,112,Fraga,13035,6743,6292
22,Huesca,113,Fueva (La),599,305,294
22,Huesca,114,Gistaín,161,89,72
22,Huesca,115,Grado (El),511,271,240
22,Huesca,116,Grañén,1999,1031,968
22,Huesca,117,Graus,3356,1712,1644
22,Huesca,119,Gurrea de Gállego,1744,904,840
22,Huesca,122,Hoz de Jaca,74,34,40
22,Huesca,908,Hoz y Costean,230,128,102
22,Huesca,124,Huerto,253,134,119
22,Huesca,125,Huesca,47923,23162,24761
22,Huesca,126,Ibieca,117,60,57
22,Huesca,127,Igriés,362,185,177
22,Huesca,128,Ilche,261,140,121
22,Huesca,129,Isábena,278,149,129
22,Huesca,130,Jaca,12322,6113,6209
22,Huesca,131,Jasa,128,76,52
22,Huesca,133,Labuerda,166,94,72
22,Huesca,135,Laluenga,248,133,115
22,Huesca,136,Lalueza,1140,594,546
22,Huesca,137,Lanaja,1481,774,707
22,Huesca,139,Laperdiguera,103,52,51
22,Huesca,141,Lascellas-Ponzano,157,82,75
22,Huesca,142,Lascuarre,146,74,72
22,Huesca,143,Laspaúles,277,156,121
22,Huesca,144,Laspuña,271,140,131
22,Huesca,149,Loarre,397,207,190
22,Huesca,150,Loporzano,520,285,235
22,Huesca,151,Loscorrales,113,65,48
22,Huesca,905,Lupiñén-Ortilla,346,188,158
22,Huesca,155,Monesma y Cajigar,104,53,51
22,Huesca,156,Monflorite-Lascasas,217,123,94
22,Huesca,157,Montanuy,308,179,129
22,Huesca,158,Monzón,15457,7852,7605
22,Huesca,160,Naval,296,144,152
22,Huesca,162,Novales,191,100,91
22,Huesca,163,Nueno,423,239,184
22,Huesca,164,Olvena,79,38,41
22,Huesca,165,Ontiñena,623,313,310
22,Huesca,167,Osso de Cinca,746,419,327
22,Huesca,168,Palo,35,24,11
22,Huesca,170,Panticosa,718,362,356
22,Huesca,172,Peñalba,742,374,368
22,Huesca,173,Peñas de Riglos (Las),282,167,115
22,Huesca,174,Peralta de Alcofea,670,330,340
22,Huesca,175,Peralta de Calasanz,274,155,119
22,Huesca,176,Peraltilla,181,99,82
22,Huesca,177,Perarrúa,123,59,64
22,Huesca,178,Pertusa,135,74,61
22,Huesca,181,Piracés,103,62,41
22,Huesca,182,Plan,314,163,151
22,Huesca,184,Poleñino,256,130,126
22,Huesca,186,Pozán de Vero,244,119,125
22,Huesca,187,Puebla de Castro (La),372,195,177
22,Huesca,188,Puente de Montañana,102,50,52
22,Huesca,902,Puente la Reina de Jaca,246,129,117
22,Huesca,189,Puértolas,224,126,98
22,Huesca,190,Pueyo de Araguás (El),151,90,61
22,Huesca,193,Pueyo de Santa Cruz,330,167,163
22,Huesca,195,Quicena,207,105,102
22,Huesca,197,Robres,661,345,316
22,Huesca,199,Sabiñánigo,8855,4443,4412
22,Huesca,200,Sahún,241,130,111
22,Huesca,201,Salas Altas,366,192,174
22,Huesca,202,Salas Bajas,156,73,83
22,Huesca,203,Salillas,115,56,59
22,Huesca,204,Sallent de Gállego,1227,609,618
22,Huesca,205,San Esteban de Litera,562,284,278
22,Huesca,207,San Juan de Plan,147,82,65
22,Huesca,903,San Miguel del Cinca,873,459,414
22,Huesca,206,Sangarrén,274,134,140
22,Huesca,208,Santa Cilia,199,108,91
22,Huesca,209,Santa Cruz de la Serós,161,93,68
22,Huesca,906,Santa María de Dulcis,213,109,104
22,Huesca,212,Santaliestra y San Quílez,102,55,47
22,Huesca,213,Sariñena,4026,2062,1964
22,Huesca,214,Secastilla,147,65,82
22,Huesca,215,Seira,179,91,88
22,Huesca,217,Sena,556,313,243
22,Huesca,218,Senés de Alcubierre,50,25,25
22,Huesca,220,Sesa,241,127,114
22,Huesca,221,Sesué,130,75,55
22,Huesca,222,Siétamo,491,272,219
22,Huesca,223,Sopeira,100,49,51
22,Huesca,904,Sotonera (La),1073,558,515
22,Huesca,225,Tamarite de Litera,3673,1837,1836
22,Huesca,226,Tardienta,1072,564,508
22,Huesca,227,Tella-Sin,267,137,130
22,Huesca,228,Tierz,243,116,127
22,Huesca,229,Tolva,180,94,86
22,Huesca,230,Torla,315,168,147
22,Huesca,232,Torralba de Aragón,115,62,53
22,Huesca,233,Torre la Ribera,117,65,52
22,Huesca,234,Torrente de Cinca,1002,505,497
22,Huesca,235,Torres de Alcanadre,125,70,55
22,Huesca,236,Torres de Barbués,335,162,173
22,Huesca,239,Tramaced,108,62,46
22,Huesca,242,Valfarta,91,52,39
22,Huesca,243,Valle de Bardají,54,29,25
22,Huesca,901,Valle de Hecho,984,508,476
22,Huesca,244,Valle de Lierp,49,26,23
22,Huesca,245,Velilla de Cinca,441,222,219
22,Huesca,909,Vencillón,446,237,209
22,Huesca,246,Veracruz,105,57,48
22,Huesca,247,Viacamp y Litera,26,17,9
22,Huesca,248,Vicién,115,61,54
22,Huesca,249,Villanova,133,63,70
22,Huesca,250,Villanúa,381,214,167
22,Huesca,251,Villanueva de Sigena,532,261,271
22,Huesca,252,Yebra de Basa,166,97,69
22,Huesca,253,Yésero,77,48,29
22,Huesca,254,Zaidín,1721,885,836
23,Jaén,1,Albanchez de Mágina,1397,720,677
23,Jaén,2,Alcalá la Real,21806,10795,11011
23,Jaén,3,Alcaudete,11101,5500,5601
23,Jaén,4,Aldeaquemada,539,279,260
23,Jaén,5,Andújar,38241,18835,19406
23,Jaén,6,Arjona,5648,2825,2823
23,Jaén,7,Arjonilla,3935,1962,1973
23,Jaén,8,Arquillos,1962,977,985
23,Jaén,905,Arroyo del Ojanco,2468,1268,1200
23,Jaén,9,Baeza,15177,7517,7660
23,Jaén,10,Bailén,17966,9168,8798
23,Jaén,11,Baños de la Encina,2734,1439,1295
23,Jaén,12,Beas de Segura,5477,2809,2668
23,Jaén,902,Bedmar y Garcíez,3227,1641,1586
23,Jaén,14,Begíjar,3109,1580,1529
23,Jaén,15,Bélmez de la Moraleda,1897,971,926
23,Jaén,16,Benatae,600,339,261
23,Jaén,17,Cabra del Santo Cristo,2240,1181,1059
23,Jaén,18,Cambil,3034,1582,1452
23,Jaén,19,Campillo de Arenas,2098,1064,1034
23,Jaén,20,Canena,2103,1023,1080
23,Jaén,21,Carboneros,691,360,331
23,Jaén,901,Cárcheles,1436,731,705
23,Jaén,24,Carolina (La),15573,7667,7906
23,Jaén,25,Castellar,3737,1931,1806
23,Jaén,26,Castillo de Locubín,5002,2472,2530
23,Jaén,27,Cazalilla,819,422,397
23,Jaén,28,Cazorla,8096,3935,4161
23,Jaén,29,Chiclana de Segura,1249,630,619
23,Jaén,30,Chilluévar,1707,837,870
23,Jaén,31,Escañuela,942,460,482
23,Jaén,32,Espelúy,779,393,386
23,Jaén,33,Frailes,1804,922,882
23,Jaén,34,Fuensanta de Martos,3252,1612,1640
23,Jaén,35,Fuerte del Rey,1214,605,609
23,Jaén,37,Génave,605,315,290
23,Jaén,38,Guardia de Jaén (La),2216,1148,1068
23,Jaén,39,Guarromán,2896,1428,1468
23,Jaén,41,Higuera de Calatrava,695,361,334
23,Jaén,42,Hinojares,478,237,241
23,Jaén,43,Hornos,649,323,326
23,Jaén,44,Huelma,6136,3149,2987
23,Jaén,45,Huesa,2743,1389,1354
23,Jaén,46,Ibros,3021,1525,1496
23,Jaén,47,Iruela (La),1843,927,916
23,Jaén,48,Iznatoraf,1205,635,570
23,Jaén,49,Jabalquinto,2420,1220,1200
23,Jaén,50,Jaén,115917,55997,59920
23,Jaén,51,Jamilena,3379,1709,1670
23,Jaén,52,Jimena,1500,722,778
23,Jaén,53,Jódar,12135,6054,6081
23,Jaén,40,Lahiguera,1887,937,950
23,Jaén,54,Larva,497,257,240
23,Jaén,55,Linares,59096,28942,30154
23,Jaén,56,Lopera,4001,1981,2020
23,Jaén,57,Lupión,1026,504,522
23,Jaén,58,Mancha Real,9674,4941,4733
23,Jaén,59,Marmolejo,7602,3826,3776
23,Jaén,60,Martos,23719,11617,12102
23,Jaén,61,Mengíbar,8963,4539,4424
23,Jaén,62,Montizón,1999,1030,969
23,Jaén,63,Navas de San Juan,5086,2527,2559
23,Jaén,64,Noalejo,2173,1093,1080
23,Jaén,65,Orcera,2137,1069,1068
23,Jaén,66,Peal de Becerro,5458,2720,2738
23,Jaén,67,Pegalajar,3093,1583,1510
23,Jaén,69,Porcuna,6935,3469,3466
23,Jaén,70,Pozo Alcón,5497,2791,2706
23,Jaén,71,Puente de Génave,2072,1037,1035
23,Jaén,72,Puerta de Segura (La),2640,1332,1308
23,Jaén,73,Quesada,5979,2952,3027
23,Jaén,74,Rus,3743,1885,1858
23,Jaén,75,Sabiote,4141,2112,2029
23,Jaén,76,Santa Elena,1004,533,471
23,Jaén,77,Santiago de Calatrava,898,452,446
23,Jaén,904,Santiago-Pontones,4172,2140,2032
23,Jaén,79,Santisteban del Puerto,4787,2449,2338
23,Jaén,80,Santo Tomé,2275,1146,1129
23,Jaén,81,Segura de la Sierra,1860,930,930
23,Jaén,82,Siles,2473,1254,1219
23,Jaén,84,Sorihuela del Guadalimar,1256,676,580
23,Jaén,86,Torre del Campo,13798,6956,6842
23,Jaén,85,Torreblascopedro,2803,1396,1407
23,Jaén,87,Torredonjimeno,13927,6860,7067
23,Jaén,88,Torreperogil,6948,3419,3529
23,Jaén,90,Torres,1769,921,848
23,Jaén,91,Torres de Albánchez,940,476,464
23,Jaén,92,Úbeda,33511,16434,17077
23,Jaén,93,Valdepeñas de Jaén,4365,2179,2186
23,Jaén,94,Vilches,4946,2490,2456
23,Jaén,95,Villacarrillo,11081,5597,5484
23,Jaén,96,Villanueva de la Reina,3344,1660,1684
23,Jaén,97,Villanueva del Arzobispo,8728,4469,4259
23,Jaén,98,Villardompardo,1176,593,583
23,Jaén,99,Villares (Los),5207,2596,2611
23,Jaén,101,Villarrodrigo,535,265,270
23,Jaén,903,Villatorres,4339,2251,2088
24,León,1,Acebedo,277,153,124
24,León,2,Algadefe,337,166,171
24,León,3,Alija del Infantado,905,453,452
24,León,4,Almanza,666,369,297
24,León,5,Antigua (La),557,301,256
24,León,6,Ardón,659,356,303
24,León,7,Arganza,883,449,434
24,León,8,Astorga,12207,5780,6427
24,León,9,Balboa,409,219,190
24,León,10,Bañeza (La),10117,4932,5185
24,León,11,Barjas,365,195,170
24,León,12,Barrios de Luna (Los),329,164,165
24,León,14,Bembibre,9989,4941,5048
24,León,15,Benavides,2929,1470,1459
24,León,16,Benuza,738,381,357
24,León,17,Bercianos del Páramo,769,389,380
24,León,18,Bercianos del Real Camino,205,101,104
24,León,19,Berlanga del Bierzo,409,192,217
24,León,20,Boca de Huérgano,571,322,249
24,León,21,Boñar,2351,1150,1201
24,León,22,Borrenes,465,232,233
24,León,23,Brazuelo,340,177,163
24,León,24,Burgo Ranero (El),894,471,423
24,León,25,Burón,379,203,176
24,León,26,Bustillo del Páramo,1668,851,817
24,León,27,Cabañas Raras,1213,626,587
24,León,28,Cabreros del Río,523,279,244
24,León,29,Cabrillanes,1000,507,493
24,León,30,Cacabelos,5064,2532,2532
24,León,31,Calzada del Coto,289,156,133
24,León,32,Campazas,152,81,71
24,León,33,Campo de Villavidel,289,149,140
24,León,34,Camponaraya,3411,1680,1731
24,León,36,Candín,407,223,184
24,León,37,Cármenes,425,223,202
24,León,38,Carracedelo,3518,1707,1811
24,León,39,Carrizo,2613,1309,1304
24,León,40,Carrocera,574,276,298
24,León,41,Carucedo,649,318,331
24,León,42,Castilfalé,91,47,44
24,León,43,Castrillo de Cabrera,165,80,85
24,León,44,Castrillo de la Valduerna,198,89,109
24,León,46,Castrocalbón,1254,650,604
24,León,47,Castrocontrigo,1075,528,547
24,León,49,Castropodame,1854,946,908
24,León,50,Castrotierra de Valmadrigal,142,71,71
24,León,51,Cea,634,331,303
24,León,52,Cebanico,225,120,105
24,León,53,Cebrones del Río,642,333,309
24,León,65,Chozas de Abajo,2001,1024,977
24,León,54,Cimanes de la Vega,625,317,308
24,León,55,Cimanes del Tejar,904,446,458
24,León,56,Cistierna,3972,1909,2063
24,León,57,Congosto,1691,808,883
24,León,58,Corbillos de los Oteros,259,133,126
24,León,59,Corullón,1151,584,567
24,León,60,Crémenes,882,425,457
24,León,61,Cuadros,1780,874,906
24,León,62,Cubillas de los Oteros,192,102,90
24,León,63,Cubillas de Rueda,594,306,288
24,León,64,Cubillos del Sil,1445,755,690
24,León,66,Destriana,736,346,390
24,León,67,Encinedo,967,498,469
24,León,68,Ercina (La),681,335,346
24,León,69,Escobar de Campos,74,45,29
24,León,70,Fabero,5312,2625,2687
24,León,71,Folgoso de la Ribera,1285,624,661
24,León,73,Fresno de la Vega,645,330,315
24,León,74,Fuentes de Carbajal,124,66,58
24,León,76,Garrafe de Torío,1150,581,569
24,León,77,Gordaliza del Pino,315,158,157
24,León,78,Gordoncillo,616,293,323
24,León,79,Gradefes,1211,600,611
24,León,80,Grajal de Campos,279,121,158
24,León,81,Gusendos de los Oteros,180,96,84
24,León,82,Hospital de Órbigo,1080,518,562
24,León,83,Igüeña,1702,886,816
24,León,84,Izagre,226,114,112
24,León,86,Joarilla de las Matas,410,213,197
24,León,87,Laguna Dalga,867,444,423
24,León,88,Laguna de Negrillos,1379,691,688
24,León,89,León,135789,62973,72816
24,León,92,Llamas de la Ribera,1111,564,547
24,León,90,Lucillo,477,241,236
24,León,91,Luyego,887,427,460
24,León,93,Magaz de Cepeda,467,226,241
24,León,94,Mansilla de las Mulas,1811,894,917
24,León,95,Mansilla Mayor,393,196,197
24,León,96,Maraña,169,89,80
24,León,97,Matadeón de los Oteros,283,149,134
24,León,98,Matallana de Torío,1538,772,766
24,León,99,Matanza,258,134,124
24,León,100,Molinaseca,750,390,360
24,León,101,Murias de Paredes,580,267,313
24,León,102,Noceda del Bierzo,855,422,433
24,León,103,Oencia,531,278,253
24,León,104,Omañas (Las),382,197,185
24,León,105,Onzonilla,1555,786,769
24,León,106,Oseja de Sajambre,323,177,146
24,León,107,Pajares de los Oteros,376,207,169
24,León,108,Palacios de la Valduerna,497,235,262
24,León,109,Palacios del Sil,1373,711,662
24,León,110,Páramo del Sil,1580,809,771
24,León,112,Peranzanes,329,190,139
24,León,113,Pobladura de Pelayo García,530,269,261
24,León,114,Pola de Gordón (La),4422,2161,2261
24,León,115,Ponferrada,65111,31564,33547
24,León,116,Posada de Valdeón,507,289,218
24,León,117,Pozuelo del Páramo,559,286,273
24,León,118,Prado de la Guzpeña,138,73,65
24,León,119,Priaranza del Bierzo,865,429,436
24,León,120,Prioro,437,228,209
24,León,121,Puebla de Lillo,696,364,332
24,León,122,Puente de Domingo Flórez,1852,963,889
24,León,123,Quintana del Castillo,1043,551,492
24,León,124,Quintana del Marco,516,264,252
24,León,125,Quintana y Congosto,702,363,339
24,León,127,Regueras de Arriba,368,187,181
24,León,129,Reyero,146,76,70
24,León,130,Riaño,547,316,231
24,León,131,Riego de la Vega,1014,501,513
24,León,132,Riello,864,451,413
24,León,133,Rioseco de Tapia,504,262,242
24,León,134,Robla (La),4739,2324,2415
24,León,136,Roperuelos del Páramo,737,370,367
24,León,137,Sabero,1615,780,835
24,León,139,Sahagún,2908,1426,1482
24,León,141,San Adrián del Valle,135,62,73
24,León,142,San Andrés del Rabanedo,26968,13154,13814
24,León,144,San Cristóbal de la Polantera,970,475,495
24,León,145,San Emiliano,786,408,378
24,León,146,San Esteban de Nogales,350,174,176
24,León,148,San Justo de la Vega,2112,1074,1038
24,León,149,San Millán de los Caballeros,179,89,90
24,León,150,San Pedro Bercianos,346,175,171
24,León,143,Sancedo,554,278,276
24,León,151,Santa Colomba de Curueño,601,287,314
24,León,152,Santa Colomba de Somoza,498,252,246
24,León,153,Santa Cristina de Valmadrigal,339,182,157
24,León,154,Santa Elena de Jamuz,1315,670,645
24,León,155,Santa María de la Isla,639,330,309
24,León,158,Santa María de Ordás,372,184,188
24,León,156,Santa María del Monte de Cea,331,167,164
24,León,157,Santa María del Páramo,3147,1544,1603
24,León,159,Santa Marina del Rey,2350,1164,1186
24,León,160,Santas Martas,952,479,473
24,León,161,Santiago Millas,335,175,160
24,León,162,Santovenia de la Valdoncina,1774,893,881
24,León,163,Sariegos,3451,1759,1692
24,León,164,Sena de Luna,450,218,232
24,León,165,Sobrado,494,249,245
24,León,166,Soto de la Vega,1933,990,943
24,León,167,Soto y Amío,1011,493,518
24,León,168,Toral de los Guzmanes,655,341,314
24,León,169,Toreno,3792,1889,1903
24,León,170,Torre del Bierzo,2736,1381,1355
24,León,171,Trabadelo,523,276,247
24,León,172,Truchas,673,328,345
24,León,173,Turcia,1216,592,624
24,León,174,Urdiales del Páramo,614,318,296
24,León,185,Val de San Lorenzo,674,333,341
24,León,175,Valdefresno,1893,984,909
24,León,176,Valdefuentes del Páramo,388,208,180
24,León,177,Valdelugueros,467,267,200
24,León,178,Valdemora,102,44,58
24,León,179,Valdepiélago,422,219,203
24,León,180,Valdepolo,1481,775,706
24,León,181,Valderas,2049,1044,1005
24,León,182,Valderrey,580,283,297
24,León,183,Valderrueda,1138,585,553
24,León,184,Valdesamario,224,114,110
24,León,187,Valdevimbre,1110,571,539
24,León,188,Valencia de Don Juan,4165,2064,2101
24,León,191,Vallecillo,150,80,70
24,León,189,Valverde de la Virgen,4592,2294,2298
24,León,190,Valverde-Enrique,208,107,101
24,León,193,Vecilla (La),421,217,204
24,León,196,Vega de Espinareda,2705,1349,1356
24,León,197,Vega de Infanzones,856,427,429
24,León,198,Vega de Valcarce,805,408,397
24,León,194,Vegacervera,334,175,159
24,León,199,Vegaquemada,488,245,243
24,León,201,Vegas del Condado,1361,721,640
24,León,202,Villablino,12212,6098,6114
24,León,203,Villabraz,139,78,61
24,León,205,Villadangos del Páramo,1018,520,498
24,León,206,Villadecanes,2169,1071,1098
24,León,207,Villademor de la Vega,451,237,214
24,León,209,Villafranca del Bierzo,3729,1832,1897
24,León,210,Villagatón,734,371,363
24,León,211,Villamandos,374,182,192
24,León,901,Villamanín,1161,573,588
24,León,212,Villamañán,1285,633,652
24,León,213,Villamartín de Don Sancho,180,95,85
24,León,214,Villamejil,894,448,446
24,León,215,Villamol,222,112,110
24,León,216,Villamontán de la Valduerna,1001,515,486
24,León,217,Villamoratiel de las Matas,181,106,75
24,León,218,Villanueva de las Manzanas,558,274,284
24,León,219,Villaobispo de Otero,665,331,334
24,León,902,Villaornate y Castro,472,253,219
24,León,221,Villaquejida,1040,541,499
24,León,222,Villaquilambre,11741,5851,5890
24,León,223,Villarejo de Órbigo,3290,1609,1681
24,León,224,Villares de Órbigo,858,439,419
24,León,225,Villasabariego,1182,596,586
24,León,226,Villaselán,270,152,118
24,León,227,Villaturiel,1767,924,843
24,León,228,Villazala,962,492,470
24,León,229,Villazanzo de Valderaduey,665,356,309
24,León,230,Zotes del Páramo,592,313,279
25,Lleida,1,Abella de la Conca,187,104,83
25,Lleida,2,Àger,502,269,233
25,Lleida,3,Agramunt,5212,2715,2497
25,Lleida,38,Aitona,2248,1155,1093
25,Lleida,4,Alamús (Els),724,374,350
25,Lleida,5,Alàs i Cerc,403,221,182
25,Lleida,6,Albagés (L'),502,264,238
25,Lleida,7,Albatàrrec,1393,731,662
25,Lleida,8,Albesa,1531,776,755
25,Lleida,9,Albi (L'),836,431,405
25,Lleida,10,Alcanó,254,128,126
25,Lleida,11,Alcarràs,5027,2515,2512
25,Lleida,12,Alcoletge,1973,1043,930
25,Lleida,13,Alfarràs,3137,1598,1539
25,Lleida,14,Alfés,317,168,149
25,Lleida,15,Algerri,495,249,246
25,Lleida,16,Alguaire,2928,1514,1414
25,Lleida,17,Alins,256,130,126
25,Lleida,19,Almacelles,5819,2980,2839
25,Lleida,20,Almatret,452,233,219
25,Lleida,21,Almenar,3515,1821,1694
25,Lleida,22,Alòs de Balaguer,166,98,68
25,Lleida,23,Alpicat,4852,2445,2407
25,Lleida,24,Alt Àneu,427,245,182
25,Lleida,27,Anglesola,1293,653,640
25,Lleida,29,Arbeca,2159,1074,1085
25,Lleida,31,Arres,67,40,27
25,Lleida,32,Arsèguel,89,45,44
25,Lleida,33,Artesa de Lleida,1379,715,664
25,Lleida,34,Artesa de Segre,3540,1852,1688
25,Lleida,36,Aspa,271,133,138
25,Lleida,37,Avellanes i Santa Linya (Les),476,266,210
25,Lleida,39,Baix Pallars,372,213,159
25,Lleida,40,Balaguer,14540,7223,7317
25,Lleida,41,Barbens,818,432,386
25,Lleida,42,Baronia de Rialb (La),279,149,130
25,Lleida,44,Bassella,263,137,126
25,Lleida,45,Bausen,51,31,20
25,Lleida,46,Belianes,608,309,299
25,Lleida,170,Bellaguarda,348,176,172
25,Lleida,47,Bellcaire d'Urgell,1218,580,638
25,Lleida,48,Bell-lloc d'Urgell,2126,1045,1081
25,Lleida,49,Bellmunt d'Urgell,226,107,119
25,Lleida,50,Bellpuig,4243,2149,2094
25,Lleida,51,Bellver de Cerdanya,1738,915,823
25,Lleida,52,Bellvís,2207,1127,1080
25,Lleida,53,Benavent de Segrià,1178,607,571
25,Lleida,55,Biosca,238,124,114
25,Lleida,57,Bòrdes (Es),217,109,108
25,Lleida,58,Borges Blanques (Les),5425,2731,2694
25,Lleida,59,Bossòst,1015,525,490
25,Lleida,56,Bovera,383,193,190
25,Lleida,60,Cabanabona,116,54,62
25,Lleida,61,Cabó,114,63,51
25,Lleida,62,Camarasa,903,460,443
25,Lleida,63,Canejan,108,55,53
25,Lleida,904,Castell de Mur,167,86,81
25,Lleida,64,Castellar de la Ribera,155,77,78
25,Lleida,67,Castelldans,955,503,452
25,Lleida,68,Castellnou de Seana,710,372,338
25,Lleida,69,Castelló de Farfanya,588,299,289
25,Lleida,70,Castellserà,1117,569,548
25,Lleida,71,Cava,58,35,23
25,Lleida,72,Cervera,8564,4425,4139
25,Lleida,73,Cervià de les Garrigues,844,440,404
25,Lleida,74,Ciutadilla,245,129,116
25,Lleida,75,Clariana de Cardener,153,80,73
25,Lleida,76,Cogul (El),218,115,103
25,Lleida,77,Coll de Nargó,591,303,288
25,Lleida,163,Coma i la Pedra (La),254,152,102
25,Lleida,161,Conca de Dalt,437,224,213
25,Lleida,78,Corbins,1149,594,555
25,Lleida,79,Cubells,384,197,187
25,Lleida,81,Espluga Calba (L'),425,228,197
25,Lleida,82,Espot,364,201,163
25,Lleida,88,Estamariu,122,68,54
25,Lleida,85,Estaràs,186,103,83
25,Lleida,86,Esterri d'Àneu,754,379,375
25,Lleida,87,Esterri de Cardós,72,34,38
25,Lleida,89,Farrera,105,61,44
25,Lleida,908,Fígols i Alinyà,271,147,124
25,Lleida,92,Floresta (La),180,99,81
25,Lleida,93,Fondarella,741,374,367
25,Lleida,94,Foradada,231,132,99
25,Lleida,96,Fuliola (La),1234,620,614
25,Lleida,97,Fulleda,114,61,53
25,Lleida,98,Gavet de la Conca,311,148,163
25,Lleida,912,Gimenells i el Pla de la Font,1093,563,530
25,Lleida,99,Golmés,1443,713,730
25,Lleida,100,Gósol,223,118,105
25,Lleida,101,Granadella (La),786,397,389
25,Lleida,102,Granja d'Escarp (La),1045,557,488
25,Lleida,103,Granyanella,140,75,65
25,Lleida,105,Granyena de les Garrigues,169,94,75
25,Lleida,104,Granyena de Segarra,144,76,68
25,Lleida,109,Guimerà,361,184,177
25,Lleida,903,Guingueta d'Àneu (La),347,183,164
25,Lleida,110,Guissona,4439,2389,2050
25,Lleida,111,Guixers,145,88,57
25,Lleida,115,Isona i Conca Dellà,1189,648,541
25,Lleida,112,Ivars de Noguera,345,177,168
25,Lleida,113,Ivars d'Urgell,1806,941,865
25,Lleida,114,Ivorra,151,72,79
25,Lleida,910,Josa i Tuixén,176,94,82
25,Lleida,118,Juncosa,558,310,248
25,Lleida,119,Juneda,3023,1545,1478
25,Lleida,121,Les,721,358,363
25,Lleida,122,Linyola,2529,1289,1240
25,Lleida,123,Lladorre,212,112,100
25,Lleida,124,Lladurs,221,114,107
25,Lleida,125,Llardecans,583,303,280
25,Lleida,126,Llavorsí,330,164,166
25,Lleida,120,Lleida,119935,58757,61178
25,Lleida,127,Lles de Cerdanya,246,143,103
25,Lleida,128,Llimiana,168,88,80
25,Lleida,129,Llobera,223,118,105
25,Lleida,133,Maials,950,478,472
25,Lleida,130,Maldà,283,151,132
25,Lleida,131,Massalcoreig,610,307,303
25,Lleida,132,Massoteres,200,106,94
25,Lleida,134,Menàrguens,834,435,399
25,Lleida,135,Miralcamp,1280,641,639
25,Lleida,137,Mollerussa,11087,5655,5432
25,Lleida,136,Molsosa (La),130,63,67
25,Lleida,139,Montellà i Martinet,535,285,250
25,Lleida,140,Montferrer i Castellbò,817,441,376
25,Lleida,138,Montgai,793,401,392
25,Lleida,142,Montoliu de Lleida,477,243,234
25,Lleida,141,Montoliu de Segarra,190,106,84
25,Lleida,143,Montornès de Segarra,100,46,54
25,Lleida,145,Nalec,92,46,46
25,Lleida,25,Naut Aran,1649,878,771
25,Lleida,146,Navès,272,133,139
25,Lleida,148,Odèn,272,155,117
25,Lleida,149,Oliana,1870,956,914
25,Lleida,150,Oliola,270,148,122
25,Lleida,151,Olius,610,304,306
25,Lleida,152,Oluges (Les),181,95,86
25,Lleida,153,Omellons (Els),253,129,124
25,Lleida,154,Omells de na Gaia (Els),156,87,69
25,Lleida,155,Organyà,935,471,464
25,Lleida,156,Os de Balaguer,800,426,374
25,Lleida,157,Ossó de Sió,230,117,113
25,Lleida,158,Palau d'Anglesola (El),1775,894,881
25,Lleida,164,Penelles,523,282,241
25,Lleida,165,Peramola,382,206,176
25,Lleida,166,Pinell de Solsonès,215,117,98
25,Lleida,167,Pinós,311,169,142
25,Lleida,911,Plans de Sió (Els),563,291,272
25,Lleida,168,Poal (El),645,342,303
25,Lleida,169,Pobla de Cérvoles (La),238,127,111
25,Lleida,171,Pobla de Segur (La),2961,1464,1497
25,Lleida,30,Pont de Bar (El),153,83,70
25,Lleida,173,Pont de Suert (El),2212,1114,1098
25,Lleida,172,Ponts,2365,1173,1192
25,Lleida,174,Portella (La),713,400,313
25,Lleida,175,Prats i Sansor,217,126,91
25,Lleida,176,Preixana,413,208,205
25,Lleida,177,Preixens,509,253,256
25,Lleida,179,Prullans,233,121,112
25,Lleida,180,Puiggròs,254,129,125
25,Lleida,181,Puigverd d'Agramunt,244,131,113
25,Lleida,182,Puigverd de Lleida,1141,574,567
25,Lleida,183,Rialp,612,312,300
25,Lleida,905,Ribera d'Ondara,462,240,222
25,Lleida,185,Ribera d'Urgellet,857,449,408
25,Lleida,186,Riner,273,138,135
25,Lleida,913,Riu de Cerdanya,99,51,48
25,Lleida,189,Rosselló,2086,1041,1045
25,Lleida,190,Salàs de Pallars,332,169,163
25,Lleida,191,Sanaüja,476,243,233
25,Lleida,196,Sant Esteve de la Sarga,114,72,42
25,Lleida,192,Sant Guim de Freixenet,1071,540,531
25,Lleida,197,Sant Guim de la Plana,185,95,90
25,Lleida,193,Sant Llorenç de Morunys,936,482,454
25,Lleida,902,Sant Martí de Riucorb,697,366,331
25,Lleida,194,Sant Ramon,560,290,270
25,Lleida,201,Sarroca de Bellera,147,81,66
25,Lleida,200,Sarroca de Lleida,437,217,220
25,Lleida,202,Senterada,93,45,48
25,Lleida,35,Sentiu de Sió (La),466,227,239
25,Lleida,204,Seròs,1827,1011,816
25,Lleida,203,Seu d'Urgell (La),11921,5851,6070
25,Lleida,205,Sidamon,642,329,313
25,Lleida,206,Soleràs (El),407,220,187
25,Lleida,207,Solsona,8127,4117,4010
25,Lleida,208,Soriguera,327,178,149
25,Lleida,209,Sort,2003,1013,990
25,Lleida,210,Soses,1565,830,735
25,Lleida,211,Sudanell,774,418,356
25,Lleida,212,Sunyer,287,146,141
25,Lleida,215,Talarn,338,169,169
25,Lleida,216,Talavera,286,153,133
25,Lleida,217,Tàrrega,13999,7008,6991
25,Lleida,218,Tarrés,121,59,62
25,Lleida,219,Tarroja de Segarra,164,82,82
25,Lleida,220,Térmens,1467,755,712
25,Lleida,221,Tírvia,131,66,65
25,Lleida,222,Tiurana,37,23,14
25,Lleida,223,Torà,1231,635,596
25,Lleida,224,Torms (Els),184,104,80
25,Lleida,225,Tornabous,824,433,391
25,Lleida,227,Torre de Cabdella (La),698,346,352
25,Lleida,226,Torrebesses,298,152,146
25,Lleida,228,Torrefarrera,2203,1165,1038
25,Lleida,907,Torrefeta i Florejacs,635,316,319
25,Lleida,230,Torregrossa,2285,1152,1133
25,Lleida,231,Torrelameu,583,321,262
25,Lleida,232,Torres de Segre,1935,998,937
25,Lleida,233,Torre-serona,339,176,163
25,Lleida,234,Tremp,5570,2753,2817
25,Lleida,43,Vall de Boí (La),1007,549,458
25,Lleida,901,Vall de Cardós,354,184,170
25,Lleida,238,Vallbona de les Monges,264,130,134
25,Lleida,240,Vallfogona de Balaguer,1526,765,761
25,Lleida,906,Valls d'Aguilar (Les),321,177,144
25,Lleida,239,Valls de Valira (Les),780,409,371
25,Lleida,909,Vansa i Fórnols (La),192,101,91
25,Lleida,242,Verdú,1074,504,570
25,Lleida,243,Vielha e Mijaran,4838,2525,2313
25,Lleida,244,Vilagrassa,449,231,218
25,Lleida,245,Vilaller,577,306,271
25,Lleida,247,Vilamòs,166,91,75
25,Lleida,248,Vilanova de Bellpuig,1116,549,567
25,Lleida,254,Vilanova de la Barca,939,472,467
25,Lleida,249,Vilanova de l'Aguda,248,124,124
25,Lleida,250,Vilanova de Meià,433,226,207
25,Lleida,251,Vilanova de Segrià,765,388,377
25,Lleida,252,Vila-sana,547,267,280
25,Lleida,253,Vilosell (El),242,120,122
25,Lleida,255,Vinaixa,586,292,294
26,Rioja (La),1,Ábalos,289,164,125
26,Rioja (La),2,Agoncillo,955,504,451
26,Rioja (La),3,Aguilar del Río Alhama,703,359,344
26,Rioja (La),4,Ajamil,80,54,26
26,Rioja (La),5,Albelda de Iregua,2599,1320,1279
26,Rioja (La),6,Alberite,2239,1141,1098
26,Rioja (La),7,Alcanadre,758,395,363
26,Rioja (La),8,Aldeanueva de Ebro,2553,1327,1226
26,Rioja (La),9,Alesanco,437,227,210
26,Rioja (La),10,Alesón,124,65,59
26,Rioja (La),11,Alfaro,9461,4822,4639
26,Rioja (La),12,Almarza de Cameros,29,17,12
26,Rioja (La),13,Anguciana,330,181,149
26,Rioja (La),14,Anguiano,540,295,245
26,Rioja (La),15,Arenzana de Abajo,265,135,130
26,Rioja (La),16,Arenzana de Arriba,33,19,14
26,Rioja (La),17,Arnedillo,477,230,247
26,Rioja (La),18,Arnedo,13965,6999,6966
26,Rioja (La),19,Arrúbal,484,252,232
26,Rioja (La),20,Ausejo,839,481,358
26,Rioja (La),21,Autol,3915,2082,1833
26,Rioja (La),22,Azofra,295,156,139
26,Rioja (La),23,Badarán,700,366,334
26,Rioja (La),24,Bañares,363,182,181
26,Rioja (La),26,Baños de Río Tobía,1708,858,850
26,Rioja (La),25,Baños de Rioja,94,55,39
26,Rioja (La),27,Berceo,208,128,80
26,Rioja (La),28,Bergasa,150,83,67
26,Rioja (La),29,Bergasillas Bajera,31,17,14
26,Rioja (La),30,Bezares,21,13,8
26,Rioja (La),31,Bobadilla,138,76,62
26,Rioja (La),32,Brieva de Cameros,73,44,29
26,Rioja (La),33,Briñas,226,119,107
26,Rioja (La),34,Briones,838,446,392
26,Rioja (La),35,Cabezón de Cameros,25,19,6
26,Rioja (La),36,Calahorra,22378,11048,11330
26,Rioja (La),37,Camprovín,197,109,88
26,Rioja (La),38,Canales de la Sierra,90,55,35
26,Rioja (La),39,Canillas de Río Tuerto,49,24,25
26,Rioja (La),40,Cañas,133,76,57
26,Rioja (La),41,Cárdenas,199,92,107
26,Rioja (La),42,Casalarreina,1206,659,547
26,Rioja (La),43,Castañares de Rioja,418,205,213
26,Rioja (La),44,Castroviejo,52,30,22
26,Rioja (La),45,Cellorigo,22,11,11
26,Rioja (La),46,Cenicero,2012,1021,991
26,Rioja (La),47,Cervera del Río Alhama,2998,1566,1432
26,Rioja (La),48,Cidamón,35,19,16
26,Rioja (La),49,Cihuri,166,87,79
26,Rioja (La),50,Cirueña,115,65,50
26,Rioja (La),51,Clavijo,239,129,110
26,Rioja (La),52,Cordovín,220,120,100
26,Rioja (La),53,Corera,266,140,126
26,Rioja (La),54,Cornago,540,294,246
26,Rioja (La),55,Corporales,49,27,22
26,Rioja (La),56,Cuzcurrita de Río Tirón,420,225,195
26,Rioja (La),57,Daroca de Rioja,52,29,23
26,Rioja (La),58,Enciso,154,97,57
26,Rioja (La),59,Entrena,1213,649,564
26,Rioja (La),60,Estollo,126,72,54
26,Rioja (La),61,Ezcaray,2050,1120,930
26,Rioja (La),62,Foncea,105,55,50
26,Rioja (La),63,Fonzaleche,164,100,64
26,Rioja (La),64,Fuenmayor,2792,1430,1362
26,Rioja (La),65,Galbárruli,67,39,28
26,Rioja (La),66,Galilea,298,149,149
26,Rioja (La),67,Gallinero de Cameros,24,15,9
26,Rioja (La),68,Gimileo,137,87,50
26,Rioja (La),69,Grañón,371,202,169
26,Rioja (La),70,Grávalos,248,130,118
26,Rioja (La),71,Haro,10165,5054,5111
26,Rioja (La),72,Herce,368,193,175
26,Rioja (La),73,Herramélluri,132,70,62
26,Rioja (La),74,Hervías,136,70,66
26,Rioja (La),75,Hormilla,441,234,207
26,Rioja (La),76,Hormilleja,168,88,80
26,Rioja (La),77,Hornillos de Cameros,15,6,9
26,Rioja (La),78,Hornos de Moncalvillo,93,48,45
26,Rioja (La),79,Huércanos,895,476,419
26,Rioja (La),80,Igea,732,405,327
26,Rioja (La),81,Jalón de Cameros,47,28,19
26,Rioja (La),82,Laguna de Cameros,164,98,66
26,Rioja (La),83,Lagunilla del Jubera,428,235,193
26,Rioja (La),84,Lardero,5628,2866,2762
26,Rioja (La),86,Ledesma de la Cogolla,23,16,7
26,Rioja (La),87,Leiva,276,139,137
26,Rioja (La),88,Leza de Río Leza,49,27,22
26,Rioja (La),89,Logroño,141568,68643,72925
26,Rioja (La),91,Lumbreras,140,82,58
26,Rioja (La),92,Manjarrés,130,74,56
26,Rioja (La),93,Mansilla de la Sierra,52,33,19
26,Rioja (La),94,Manzanares de Rioja,102,58,44
26,Rioja (La),95,Matute,164,83,81
26,Rioja (La),96,Medrano,207,105,102
26,Rioja (La),98,Munilla,121,62,59
26,Rioja (La),99,Murillo de Río Leza,1267,638,629
26,Rioja (La),100,Muro de Aguas,60,34,26
26,Rioja (La),101,Muro en Cameros,35,21,14
26,Rioja (La),102,Nájera,7560,3790,3770
26,Rioja (La),103,Nalda,946,507,439
26,Rioja (La),104,Navajún,17,13,4
26,Rioja (La),105,Navarrete,2466,1287,1179
26,Rioja (La),106,Nestares,87,51,36
26,Rioja (La),107,Nieva de Cameros,126,73,53
26,Rioja (La),109,Ochánduri,82,46,36
26,Rioja (La),108,Ocón,357,217,140
26,Rioja (La),110,Ojacastro,220,128,92
26,Rioja (La),111,Ollauri,294,163,131
26,Rioja (La),112,Ortigosa de Cameros,306,170,136
26,Rioja (La),113,Pazuengos,44,28,16
26,Rioja (La),114,Pedroso,97,53,44
26,Rioja (La),115,Pinillos,22,11,11
26,Rioja (La),117,Pradejón,3541,1931,1610
26,Rioja (La),118,Pradillo,67,35,32
26,Rioja (La),119,Préjano,196,93,103
26,Rioja (La),120,Quel,2007,1062,945
26,Rioja (La),121,Rabanera,40,29,11
26,Rioja (La),122,Rasillo de Cameros (El),132,62,70
26,Rioja (La),123,Redal (El),196,105,91
26,Rioja (La),124,Ribafrecha,997,540,457
26,Rioja (La),125,Rincón de Soto,3525,1855,1670
26,Rioja (La),126,Robres del Castillo,41,23,18
26,Rioja (La),127,Rodezno,325,188,137
26,Rioja (La),128,Sajazarra,123,65,58
26,Rioja (La),129,San Asensio,1266,670,596
26,Rioja (La),130,San Millán de la Cogolla,293,178,115
26,Rioja (La),131,San Millán de Yécora,71,47,24
26,Rioja (La),132,San Román de Cameros,161,91,70
26,Rioja (La),139,San Torcuato,118,75,43
26,Rioja (La),142,San Vicente de la Sonsierra,1191,666,525
26,Rioja (La),134,Santa Coloma,126,79,47
26,Rioja (La),135,Santa Engracia del Jubera,185,106,79
26,Rioja (La),136,Santa Eulalia Bajera,126,67,59
26,Rioja (La),138,Santo Domingo de la Calzada,6069,3111,2958
26,Rioja (La),140,Santurde de Rioja,310,161,149
26,Rioja (La),141,Santurdejo,178,100,78
26,Rioja (La),143,Sojuela,114,65,49
26,Rioja (La),144,Sorzano,244,129,115
26,Rioja (La),145,Sotés,262,147,115
26,Rioja (La),146,Soto en Cameros,182,96,86
26,Rioja (La),147,Terroba,29,17,12
26,Rioja (La),148,Tirgo,260,146,114
26,Rioja (La),149,Tobía,81,45,36
26,Rioja (La),150,Tormantos,197,112,85
26,Rioja (La),153,Torre en Cameros,15,12,3
26,Rioja (La),151,Torrecilla en Cameros,574,300,274
26,Rioja (La),152,Torrecilla sobre Alesanco,55,27,28
26,Rioja (La),154,Torremontalbo,19,8,11
26,Rioja (La),155,Treviana,231,125,106
26,Rioja (La),157,Tricio,380,189,191
26,Rioja (La),158,Tudelilla,389,210,179
26,Rioja (La),160,Uruñuela,778,397,381
26,Rioja (La),161,Valdemadera,11,8,3
26,Rioja (La),162,Valgañón,156,86,70
26,Rioja (La),163,Ventosa,135,75,60
26,Rioja (La),164,Ventrosa,82,44,38
26,Rioja (La),165,Viguera,397,230,167
26,Rioja (La),166,Villalba de Rioja,162,94,68
26,Rioja (La),167,Villalobar de Rioja,98,60,38
26,Rioja (La),168,Villamediana de Iregua,3335,1749,1586
26,Rioja (La),169,Villanueva de Cameros,109,63,46
26,Rioja (La),170,Villar de Arnedo (El),656,338,318
26,Rioja (La),171,Villar de Torre,268,142,126
26,Rioja (La),172,Villarejo,43,28,15
26,Rioja (La),173,Villarroya,9,4,5
26,Rioja (La),174,Villarta-Quintana,184,95,89
26,Rioja (La),175,Villavelayo,82,48,34
26,Rioja (La),176,Villaverde de Rioja,83,49,34
26,Rioja (La),177,Villoslada de Cameros,390,238,152
26,Rioja (La),178,Viniegra de Abajo,113,59,54
26,Rioja (La),179,Viniegra de Arriba,49,32,17
26,Rioja (La),180,Zarratón,248,136,112
26,Rioja (La),181,Zarzosa,14,10,4
26,Rioja (La),183,Zorraquín,55,32,23
27,Lugo,1,Abadín,3256,1565,1691
27,Lugo,2,Alfoz,2312,1122,1190
27,Lugo,3,Antas de Ulla,2640,1260,1380
27,Lugo,4,Baleira,1778,921,857
27,Lugo,901,Baralla,3193,1631,1562
27,Lugo,5,Barreiros,3278,1562,1716
27,Lugo,6,Becerreá,3424,1716,1708
27,Lugo,7,Begonte,3682,1814,1868
27,Lugo,8,Bóveda,1866,918,948
27,Lugo,902,Burela,8348,4154,4194
27,Lugo,9,Carballedo,3055,1512,1543
27,Lugo,10,Castro de Rei,5856,2907,2949
27,Lugo,11,Castroverde,3286,1690,1596
27,Lugo,12,Cervantes,2031,1118,913
27,Lugo,13,Cervo,4978,2468,2510
27,Lugo,16,Chantada,9463,4617,4846
27,Lugo,14,Corgo (O),4264,2111,2153
27,Lugo,15,Cospeito,5548,2712,2836
27,Lugo,17,Folgoso do Courel,1397,714,683
27,Lugo,18,Fonsagrada (A),5007,2630,2377
27,Lugo,19,Foz,9619,4606,5013
27,Lugo,20,Friol,4580,2272,2308
27,Lugo,22,Guitiriz,6086,2988,3098
27,Lugo,23,Guntín,3329,1680,1649
27,Lugo,24,Incio (O),2358,1136,1222
27,Lugo,26,Láncara,3136,1588,1548
27,Lugo,27,Lourenzá,2700,1312,1388
27,Lugo,28,Lugo,91426,42792,48634
27,Lugo,29,Meira,1789,869,920
27,Lugo,30,Mondoñedo,4904,2252,2652
27,Lugo,31,Monforte de Lemos,19445,9230,10215
27,Lugo,32,Monterroso,4237,2121,2116
27,Lugo,33,Muras,978,485,493
27,Lugo,34,Navia de Suarna,1732,923,809
27,Lugo,35,Negueira de Muñiz,235,123,112
27,Lugo,37,Nogais (As),1501,780,721
27,Lugo,38,Ourol,1365,661,704
27,Lugo,39,Outeiro de Rei,4528,2316,2212
27,Lugo,40,Palas de Rei,3909,1911,1998
27,Lugo,41,Pantón,3209,1514,1695
27,Lugo,42,Paradela,2408,1214,1194
27,Lugo,43,Páramo (O),1887,952,935
27,Lugo,44,Pastoriza (A),3856,1936,1920
27,Lugo,45,Pedrafita do Cebreiro,1486,795,691
27,Lugo,47,Pobra do Brollón (A),2425,1187,1238
27,Lugo,46,Pol,1999,974,1025
27,Lugo,48,Pontenova (A),3125,1521,1604
27,Lugo,49,Portomarín,1991,979,1012
27,Lugo,50,Quiroga,4129,1990,2139
27,Lugo,56,Rábade,1630,817,813
27,Lugo,51,Ribadeo,9270,4355,4915
27,Lugo,52,Ribas de Sil,1335,642,693
27,Lugo,53,Ribeira de Piquín,810,406,404
27,Lugo,54,Riotorto,1726,839,887
27,Lugo,55,Samos,1923,1005,918
27,Lugo,57,Sarria,13132,6458,6674
27,Lugo,58,Saviñao (O),4915,2407,2508
27,Lugo,59,Sober,2988,1414,1574
27,Lugo,60,Taboada,3872,1849,2023
27,Lugo,61,Trabada,1552,759,793
27,Lugo,62,Triacastela,839,420,419
27,Lugo,63,Valadouro (O),2305,1148,1157
27,Lugo,64,Vicedo (O),2181,1067,1114
27,Lugo,65,Vilalba,15484,7564,7920
27,Lugo,66,Viveiro,15389,7413,7976
27,Lugo,21,Xermade,2464,1201,1263
27,Lugo,25,Xove,3603,1799,1804
28,Madrid,1,Acebeda (La),55,29,26
28,Madrid,2,Ajalvir,2925,1538,1387
28,Madrid,3,Alameda del Valle,206,126,80
28,Madrid,4,Álamo (El),6259,3389,2870
28,Madrid,5,Alcalá de Henares,191545,96028,95517
28,Madrid,6,Alcobendas,100307,49139,51168
28,Madrid,7,Alcorcón,156592,77491,79101
28,Madrid,8,Aldea del Fresno,1889,1005,884
28,Madrid,9,Algete,17626,8789,8837
28,Madrid,10,Alpedrete,10235,5139,5096
28,Madrid,11,Ambite,354,181,173
28,Madrid,12,Anchuelo,556,302,254
28,Madrid,13,Aranjuez,42481,20674,21807
28,Madrid,14,Arganda del Rey,38269,19658,18611
28,Madrid,15,Arroyomolinos,7099,3646,3453
28,Madrid,16,Atazar (El),105,57,48
28,Madrid,17,Batres,1316,685,631
28,Madrid,18,Becerril de la Sierra,4353,2270,2083
28,Madrid,19,Belmonte de Tajo,1176,588,588
28,Madrid,21,Berrueco (El),479,254,225
28,Madrid,20,Berzosa del Lozoya,172,88,84
28,Madrid,22,Boadilla del Monte,32813,16372,16441
28,Madrid,23,Boalo (El),4687,2457,2230
28,Madrid,24,Braojos,191,107,84
28,Madrid,25,Brea de Tajo,475,239,236
28,Madrid,26,Brunete,7368,3701,3667
28,Madrid,27,Buitrago del Lozoya,1755,889,866
28,Madrid,28,Bustarviejo,1687,877,810
28,Madrid,29,Cabanillas de la Sierra,582,309,273
28,Madrid,30,Cabrera (La),2139,1093,1046
28,Madrid,31,Cadalso de los Vidrios,2550,1309,1241
28,Madrid,32,Camarma de Esteruelas,4310,2216,2094
28,Madrid,33,Campo Real,3544,1800,1744
28,Madrid,34,Canencia,457,247,210
28,Madrid,35,Carabaña,1407,714,693
28,Madrid,36,Casarrubuelos,1805,924,881
28,Madrid,37,Cenicientos,1893,947,946
28,Madrid,38,Cercedilla,6499,3259,3240
28,Madrid,39,Cervera de Buitrago,128,73,55
28,Madrid,51,Chapinería,1726,889,837
28,Madrid,52,Chinchón,4738,2381,2357
28,Madrid,40,Ciempozuelos,16680,8498,8182
28,Madrid,41,Cobeña,3764,1868,1896
28,Madrid,46,Collado Mediano,5638,2878,2760
28,Madrid,47,Collado Villalba,50695,25248,25447
28,Madrid,43,Colmenar de Oreja,6637,3310,3327
28,Madrid,42,Colmenar del Arroyo,1107,552,555
28,Madrid,45,Colmenar Viejo,38866,19412,19454
28,Madrid,44,Colmenarejo,6693,3359,3334
28,Madrid,48,Corpa,507,256,251
28,Madrid,49,Coslada,82418,41136,41282
28,Madrid,50,Cubas de la Sagra,2637,1307,1330
28,Madrid,53,Daganzo de Arriba,6311,3194,3117
28,Madrid,54,Escorial (El),12975,6493,6482
28,Madrid,55,Estremera,1156,602,554
28,Madrid,56,Fresnedillas de la Oliva,1097,581,516
28,Madrid,57,Fresno de Torote,1324,724,600
28,Madrid,58,Fuenlabrada,192458,97372,95086
28,Madrid,59,Fuente el Saz de Jarama,5376,2779,2597
28,Madrid,60,Fuentidueña de Tajo,1602,807,795
28,Madrid,61,Galapagar,28255,14232,14023
28,Madrid,62,Garganta de los Montes,356,190,166
28,Madrid,63,Gargantilla del Lozoya y Pinilla de Buitrago,321,188,133
28,Madrid,64,Gascones,158,86,72
28,Madrid,65,Getafe,155997,77684,78313
28,Madrid,66,Griñón,7039,3603,3436
28,Madrid,67,Guadalix de la Sierra,4540,2388,2152
28,Madrid,68,Guadarrama,12457,6224,6233
28,Madrid,69,Hiruela (La),90,50,40
28,Madrid,70,Horcajo de la Sierra,156,84,72
28,Madrid,71,Horcajuelo de la Sierra,117,53,64
28,Madrid,72,Hoyo de Manzanares,6892,3461,3431
28,Madrid,73,Humanes de Madrid,12923,6724,6199
28,Madrid,74,Leganés,178630,88915,89715
28,Madrid,75,Loeches,4275,2127,2148
28,Madrid,76,Lozoya,539,280,259
28,Madrid,901,Lozoyuela-Navas-Sieteiglesias,847,437,410
28,Madrid,78,Madarcos,31,18,13
28,Madrid,79,Madrid,3099834,1453486,1646348
28,Madrid,80,Majadahonda,58377,27842,30535
28,Madrid,82,Manzanares el Real,5713,2937,2776
28,Madrid,83,Meco,9986,5136,4850
28,Madrid,84,Mejorada del Campo,19178,9683,9495
28,Madrid,85,Miraflores de la Sierra,4741,2379,2362
28,Madrid,86,Molar (El),4824,2548,2276
28,Madrid,87,Molinos (Los),4161,2099,2062
28,Madrid,88,Montejo de la Sierra,319,156,163
28,Madrid,89,Moraleja de Enmedio,3874,1952,1922
28,Madrid,90,Moralzarzal,9003,4582,4421
28,Madrid,91,Morata de Tajuña,6048,3008,3040
28,Madrid,92,Móstoles,202496,100898,101598
28,Madrid,93,Navacerrada,2309,1151,1158
28,Madrid,94,Navalafuente,714,388,326
28,Madrid,95,Navalagamella,1600,848,752
28,Madrid,96,Navalcarnero,16416,8324,8092
28,Madrid,97,Navarredonda y San Mamés,137,73,64
28,Madrid,99,Navas del Rey,2196,1206,990
28,Madrid,100,Nuevo Baztán,5015,2551,2464
28,Madrid,101,Olmeda de las Fuentes,193,111,82
28,Madrid,102,Orusco de Tajuña,703,374,329
28,Madrid,104,Paracuellos de Jarama,7233,3725,3508
28,Madrid,106,Parla,86912,44146,42766
28,Madrid,107,Patones,375,196,179
28,Madrid,108,Pedrezuela,2299,1202,1097
28,Madrid,109,Pelayos de la Presa,2017,1056,961
28,Madrid,110,Perales de Tajuña,2358,1174,1184
28,Madrid,111,Pezuela de las Torres,492,260,232
28,Madrid,112,Pinilla del Valle,165,92,73
28,Madrid,113,Pinto,35199,17678,17521
28,Madrid,114,Piñuécar-Gandullas,186,89,97
28,Madrid,115,Pozuelo de Alarcón,75079,36239,38840
28,Madrid,116,Pozuelo del Rey,291,155,136
28,Madrid,117,Prádena del Rincón,110,61,49
28,Madrid,118,Puebla de la Sierra,104,57,47
28,Madrid,902,Puentes Viejas,427,238,189
28,Madrid,119,Quijorna,1847,952,895
28,Madrid,120,Rascafría,1606,848,758
28,Madrid,121,Redueña,221,120,101
28,Madrid,122,Ribatejada,419,237,182
28,Madrid,123,Rivas-Vaciamadrid,45099,22699,22400
28,Madrid,124,Robledillo de la Jara,103,49,54
28,Madrid,125,Robledo de Chavela,3008,1513,1495
28,Madrid,126,Robregordo,71,36,35
28,Madrid,127,Rozas de Madrid (Las),68061,33052,35009
28,Madrid,128,Rozas de Puerto Real,354,193,161
28,Madrid,129,San Agustín del Guadalix,7806,3883,3923
28,Madrid,130,San Fernando de Henares,39175,19751,19424
28,Madrid,131,San Lorenzo de El Escorial,14971,7272,7699
28,Madrid,132,San Martín de la Vega,14011,7304,6707
28,Madrid,133,San Martín de Valdeiglesias,6781,3392,3389
28,Madrid,134,San Sebastián de los Reyes,62242,30996,31246
28,Madrid,135,Santa María de la Alameda,929,492,437
28,Madrid,136,Santorcaz,677,352,325
28,Madrid,137,Santos de la Humosa (Los),1273,651,622
28,Madrid,138,Serna del Monte (La),113,62,51
28,Madrid,140,Serranillos del Valle,2457,1215,1242
28,Madrid,141,Sevilla la Nueva,5832,3024,2808
28,Madrid,143,Somosierra,122,65,57
28,Madrid,144,Soto del Real,7137,3572,3565
28,Madrid,145,Talamanca de Jarama,1877,947,930
28,Madrid,146,Tielmes,2311,1178,1133
28,Madrid,147,Titulcia,935,477,458
28,Madrid,148,Torrejón de Ardoz,106740,52546,54194
28,Madrid,149,Torrejón de la Calzada,5224,2613,2611
28,Madrid,150,Torrejón de Velasco,2928,1540,1388
28,Madrid,151,Torrelaguna,3711,1911,1800
28,Madrid,152,Torrelodones,18228,8824,9404
28,Madrid,153,Torremocha de Jarama,489,252,237
28,Madrid,154,Torres de la Alameda,5560,2825,2735
28,Madrid,903,Tres Cantos,38882,19180,19702
28,Madrid,155,Valdaracete,621,306,315
28,Madrid,156,Valdeavero,760,401,359
28,Madrid,157,Valdelaguna,673,355,318
28,Madrid,158,Valdemanco,736,400,336
28,Madrid,159,Valdemaqueda,728,371,357
28,Madrid,160,Valdemorillo,8594,4481,4113
28,Madrid,161,Valdemoro,40839,20570,20269
28,Madrid,162,Valdeolmos-Alalpardo,2112,1092,1020
28,Madrid,163,Valdepiélagos,377,201,176
28,Madrid,164,Valdetorres de Jarama,2870,1476,1394
28,Madrid,165,Valdilecha,2251,1168,1083
28,Madrid,166,Valverde de Alcalá,339,176,163
28,Madrid,167,Velilla de San Antonio,9062,4609,4453
28,Madrid,168,Vellón (El),1252,648,604
28,Madrid,169,Venturada,1118,575,543
28,Madrid,171,Villa del Prado,5079,2668,2411
28,Madrid,170,Villaconejos,3018,1554,1464
28,Madrid,172,Villalbilla,7037,3597,3440
28,Madrid,173,Villamanrique de Tajo,650,331,319
28,Madrid,174,Villamanta,1852,951,901
28,Madrid,175,Villamantilla,493,252,241
28,Madrid,176,Villanueva de la Cañada,13198,6459,6739
28,Madrid,178,Villanueva de Perales,939,513,426
28,Madrid,177,Villanueva del Pardillo,9013,4521,4492
28,Madrid,179,Villar del Olmo,1752,907,845
28,Madrid,180,Villarejo de Salvanés,6231,3140,3091
28,Madrid,181,Villaviciosa de Odón,23173,11358,11815
28,Madrid,182,Villavieja del Lozoya,196,99,97
28,Madrid,183,Zarzalejo,1265,661,604
29,Málaga,1,Alameda,5161,2565,2596
29,Málaga,2,Alcaucín,1651,837,814
29,Málaga,3,Alfarnate,1413,737,676
29,Málaga,4,Alfarnatejo,394,206,188
29,Málaga,5,Algarrobo,4979,2491,2488
29,Málaga,6,Algatocín,944,494,450
29,Málaga,7,Alhaurín de la Torre,26764,13352,13412
29,Málaga,8,Alhaurín el Grande,19324,9718,9606
29,Málaga,9,Almáchar,1908,979,929
29,Málaga,10,Almargen,2074,1023,1051
29,Málaga,11,Almogía,4244,2163,2081
29,Málaga,12,Álora,12838,6454,6384
29,Málaga,13,Alozaina,2236,1159,1077
29,Málaga,14,Alpandeire,291,146,145
29,Málaga,15,Antequera,42378,20819,21559
29,Málaga,16,Árchez,397,196,201
29,Málaga,17,Archidona,8403,4162,4241
29,Málaga,18,Ardales,2642,1306,1336
29,Málaga,19,Arenas,1202,642,560
29,Málaga,20,Arriate,3716,1813,1903
29,Málaga,21,Atajate,172,90,82
29,Málaga,22,Benadalid,258,133,125
29,Málaga,23,Benahavís,2265,1151,1114
29,Málaga,24,Benalauría,476,248,228
29,Málaga,25,Benalmádena,42437,20886,21551
29,Málaga,26,Benamargosa,1539,782,757
29,Málaga,27,Benamocarra,2881,1458,1423
29,Málaga,28,Benaoján,1628,812,816
29,Málaga,29,Benarrabá,561,296,265
29,Málaga,30,Borge (El),966,496,470
29,Málaga,31,Burgo (El),2069,1034,1035
29,Málaga,32,Campillos,7923,3964,3959
29,Málaga,33,Canillas de Aceituno,2157,1088,1069
29,Málaga,34,Canillas de Albaida,777,407,370
29,Málaga,35,Cañete la Real,2084,1069,1015
29,Málaga,36,Carratraca,839,415,424
29,Málaga,37,Cartajima,250,128,122
29,Málaga,38,Cártama,15524,7881,7643
29,Málaga,39,Casabermeja,3127,1614,1513
29,Málaga,40,Casarabonela,2491,1268,1223
29,Málaga,41,Casares,3846,2011,1835
29,Málaga,42,Coín,19295,9973,9322
29,Málaga,43,Colmenar,3197,1581,1616
29,Málaga,44,Comares,1419,751,668
29,Málaga,45,Cómpeta,3364,1745,1619
29,Málaga,46,Cortes de la Frontera,3558,1811,1747
29,Málaga,47,Cuevas Bajas,1460,727,733
29,Málaga,49,Cuevas de San Marcos,3973,1967,2006
29,Málaga,48,Cuevas del Becerro,1871,935,936
29,Málaga,50,Cútar,637,314,323
29,Málaga,51,Estepona,50488,25132,25356
29,Málaga,52,Faraján,253,117,136
29,Málaga,53,Frigiliana,2451,1214,1237
29,Málaga,54,Fuengirola,58957,29106,29851
29,Málaga,55,Fuente de Piedra,2067,1012,1055
29,Málaga,56,Gaucín,1818,952,866
29,Málaga,57,Genalguacil,543,282,261
29,Málaga,58,Guaro,2046,1039,1007
29,Málaga,59,Humilladero,2797,1399,1398
29,Málaga,60,Igualeja,1011,514,497
29,Málaga,61,Istán,1417,717,700
29,Málaga,62,Iznate,816,415,401
29,Málaga,63,Jimera de Líbar,410,201,209
29,Málaga,64,Jubrique,737,382,355
29,Málaga,65,Júzcar,201,112,89
29,Málaga,66,Macharaviaya,367,202,165
29,Málaga,67,Málaga,547731,263776,283955
29,Málaga,68,Manilva,8245,4260,3985
29,Málaga,69,Marbella,117353,57957,59396
29,Málaga,70,Mijas,52573,26391,26182
29,Málaga,71,Moclinejo,1147,587,560
29,Málaga,72,Mollina,3883,1929,1954
29,Málaga,73,Monda,1974,1017,957
29,Málaga,74,Montejaque,994,495,499
29,Málaga,75,Nerja,18509,9155,9354
29,Málaga,76,Ojén,2294,1186,1108
29,Málaga,77,Parauta,245,123,122
29,Málaga,79,Periana,3396,1754,1642
29,Málaga,80,Pizarra,7165,3534,3631
29,Málaga,81,Pujerra,320,177,143
29,Málaga,82,Rincón de la Victoria,30169,15086,15083
29,Málaga,83,Riogordo,2873,1470,1403
29,Málaga,84,Ronda,34948,17399,17549
29,Málaga,85,Salares,214,114,100
29,Málaga,86,Sayalonga,1331,669,662
29,Málaga,87,Sedella,523,278,245
29,Málaga,88,Sierra de Yeguas,3299,1650,1649
29,Málaga,89,Teba,4315,2196,2119
29,Málaga,90,Tolox,2246,1137,1109
29,Málaga,901,Torremolinos,52354,26230,26124
29,Málaga,91,Torrox,12901,6412,6489
29,Málaga,92,Totalán,679,351,328
29,Málaga,93,Valle de Abdalajís,2954,1443,1511
29,Málaga,94,Vélez-Málaga,61797,30721,31076
29,Málaga,95,Villanueva de Algaidas,4321,2174,2147
29,Málaga,98,Villanueva de Tapia,1679,855,824
29,Málaga,96,Villanueva del Rosario,3361,1659,1702
29,Málaga,97,Villanueva del Trabuco,4985,2524,2461
29,Málaga,99,Viñuela,1481,742,739
29,Málaga,100,Yunquera,3284,1698,1586
30,Murcia,1,Abanilla,6145,3084,3061
30,Murcia,2,Abarán,12804,6412,6392
30,Murcia,3,Águilas,30263,15101,15162
30,Murcia,4,Albudeite,1439,739,700
30,Murcia,5,Alcantarilla,36496,18139,18357
30,Murcia,902,Alcázares (Los),11306,5786,5520
30,Murcia,6,Aledo,1062,543,519
30,Murcia,7,Alguazas,7561,3798,3763
30,Murcia,8,Alhama de Murcia,17717,9042,8675
30,Murcia,9,Archena,15856,8057,7799
30,Murcia,10,Beniel,9420,4875,4545
30,Murcia,11,Blanca,5977,2982,2995
30,Murcia,12,Bullas,11435,5791,5644
30,Murcia,13,Calasparra,9674,4885,4789
30,Murcia,14,Campos del Río,2052,1014,1038
30,Murcia,15,Caravaca de la Cruz,24179,12081,12098
30,Murcia,16,Cartagena,197665,99404,98261
30,Murcia,17,Cehegín,14804,7396,7408
30,Murcia,18,Ceutí,8343,4268,4075
30,Murcia,19,Cieza,33825,16858,16967
30,Murcia,20,Fortuna,7707,3992,3715
30,Murcia,21,Fuente Álamo de Murcia,13210,7024,6186
30,Murcia,22,Jumilla,23958,12280,11678
30,Murcia,23,Librilla,4088,2055,2033
30,Murcia,24,Lorca,84245,43484,40761
30,Murcia,25,Lorquí,6115,3119,2996
30,Murcia,26,Mazarrón,26122,14003,12119
30,Murcia,27,Molina de Segura,52588,26371,26217
30,Murcia,28,Moratalla,8549,4368,4181
30,Murcia,29,Mula,15592,7959,7633
30,Murcia,30,Murcia,398815,196770,202045
30,Murcia,31,Ojós,601,302,299
30,Murcia,32,Pliego,3507,1816,1691
30,Murcia,33,Puerto Lumbreras,12037,6040,5997
30,Murcia,34,Ricote,1509,748,761
30,Murcia,35,San Javier,24686,12766,11920
30,Murcia,36,San Pedro del Pinatar,18746,9470,9276
30,Murcia,901,Santomera,12777,6460,6317
30,Murcia,37,Torre-Pacheco,26806,14439,12367
30,Murcia,38,Torres de Cotillas (Las),17565,8955,8610
30,Murcia,39,Totana,26435,13627,12808
30,Murcia,40,Ulea,989,503,486
30,Murcia,41,Unión (La),15287,7671,7616
30,Murcia,42,Villanueva del Río Segura,1749,838,911
30,Murcia,43,Yecla,32988,16742,16246
31,Navarra,1,Abáigar,97,54,43
31,Navarra,2,Abárzuza,514,264,250
31,Navarra,3,Abaurregaina/Abaurrea Alta,157,96,61
31,Navarra,4,Abaurrepea/Abaurrea Baja,42,30,12
31,Navarra,5,Aberin,327,175,152
31,Navarra,6,Ablitas,2417,1245,1172
31,Navarra,7,Adiós,154,83,71
31,Navarra,8,Aguilar de Codés,111,59,52
31,Navarra,9,Aibar/Oibar,927,482,445
31,Navarra,11,Allín,795,410,385
31,Navarra,12,Allo,1072,545,527
31,Navarra,10,Altsasu/Alsasua,7377,3780,3597
31,Navarra,13,Améscoa Baja,823,429,394
31,Navarra,14,Ancín,393,221,172
31,Navarra,15,Andosilla,2733,1390,1343
31,Navarra,16,Ansoáin,9526,4789,4737
31,Navarra,17,Anue,411,241,170
31,Navarra,18,Añorbe,510,275,235
31,Navarra,19,Aoiz/Agoitz,2099,1047,1052
31,Navarra,20,Araitz,581,341,240
31,Navarra,25,Arakil,867,471,396
31,Navarra,21,Aranarache,85,46,39
31,Navarra,23,Aranguren,5263,2702,2561
31,Navarra,24,Arano,141,72,69
31,Navarra,22,Arantza,584,325,259
31,Navarra,26,Aras,222,117,105
31,Navarra,27,Arbizu,963,505,458
31,Navarra,28,Arce/Artzi,275,160,115
31,Navarra,29,Arcos (Los),1300,651,649
31,Navarra,30,Arellano,192,105,87
31,Navarra,31,Areso,296,163,133
31,Navarra,32,Arguedas,2362,1196,1166
31,Navarra,33,Aria,68,40,28
31,Navarra,34,Aribe,62,34,28
31,Navarra,35,Armañanzas,81,41,40
31,Navarra,36,Arróniz,1156,616,540
31,Navarra,37,Arruazu,104,57,47
31,Navarra,38,Artajona,1666,876,790
31,Navarra,39,Artazu,103,57,46
31,Navarra,40,Atez,230,139,91
31,Navarra,58,Auritz/Burguete,323,152,171
31,Navarra,41,Ayegui,1260,667,593
31,Navarra,42,Azagra,3767,1923,1844
31,Navarra,43,Azuelo,46,25,21
31,Navarra,44,Bakaiku,333,184,149
31,Navarra,901,Barañain,22071,10897,11174
31,Navarra,45,Barásoain,531,268,263
31,Navarra,46,Barbarin,94,43,51
31,Navarra,47,Bargota,375,186,189
31,Navarra,48,Barillas,206,108,98
31,Navarra,49,Basaburua,683,388,295
31,Navarra,50,Baztan,7707,3934,3773
31,Navarra,137,Beintza-Labaien,264,155,109
31,Navarra,51,Beire,310,153,157
31,Navarra,52,Belascoáin,119,59,60
31,Navarra,250,Bera/Vera de Bidasoa,3659,1848,1811
31,Navarra,53,Berbinzana,730,375,355
31,Navarra,905,Beriáin,3042,1512,1530
31,Navarra,902,Berrioplano,1641,847,794
31,Navarra,903,Berriozar,7865,4037,3828
31,Navarra,54,Bertizarana,689,350,339
31,Navarra,55,Betelu,335,180,155
31,Navarra,253,Bidaurreta,114,67,47
31,Navarra,56,Biurrun-Olcoz,194,115,79
31,Navarra,57,Buñuel,2408,1208,1200
31,Navarra,59,Burgui/Burgi,236,137,99
31,Navarra,60,Burlada/Burlata,18040,8916,9124
31,Navarra,61,Busto (El),87,48,39
31,Navarra,62,Cabanillas,1608,860,748
31,Navarra,63,Cabredo,110,56,54
31,Navarra,64,Cadreita,2150,1133,1017
31,Navarra,65,Caparroso,2489,1228,1261
31,Navarra,66,Cárcar,1118,550,568
31,Navarra,67,Carcastillo,2675,1393,1282
31,Navarra,68,Cascante,3906,1968,1938
31,Navarra,69,Cáseda,1042,520,522
31,Navarra,70,Castejón,3529,1816,1713
31,Navarra,71,Castillonuevo,20,12,8
31,Navarra,72,Cintruénigo,6527,3294,3233
31,Navarra,74,Cirauqui,462,259,203
31,Navarra,75,Ciriza,72,31,41
31,Navarra,76,Cizur,1744,907,837
31,Navarra,77,Corella,7493,3805,3688
31,Navarra,78,Cortes,3339,1758,1581
31,Navarra,79,Desojo,122,67,55
31,Navarra,80,Dicastillo,696,366,330
31,Navarra,81,Donamaria,414,203,211
31,Navarra,221,Doneztebe/Santesteban,1479,740,739
31,Navarra,83,Echarri,67,39,28
31,Navarra,86,Egüés,4472,2258,2214
31,Navarra,87,Elgorriaga,225,117,108
31,Navarra,89,Enériz,217,112,105
31,Navarra,90,Eratsun,174,113,61
31,Navarra,91,Ergoiena,450,250,200
31,Navarra,92,Erro,751,427,324
31,Navarra,94,Eslava,158,80,78
31,Navarra,95,Esparza de Salazar,102,50,52
31,Navarra,96,Espronceda,162,93,69
31,Navarra,97,Estella/Lizarra,13439,6564,6875
31,Navarra,98,Esteribar,1547,831,716
31,Navarra,99,Etayo,93,49,44
31,Navarra,82,Etxalar,803,427,376
31,Navarra,84,Etxarri-Aranatz,2428,1248,1180
31,Navarra,85,Etxauri,460,248,212
31,Navarra,100,Eulate,349,185,164
31,Navarra,101,Ezcabarte,1403,760,643
31,Navarra,93,Ezcároz/Ezkaroze,363,190,173
31,Navarra,102,Ezkurra,200,126,74
31,Navarra,103,Ezprogui,62,32,30
31,Navarra,104,Falces,2575,1287,1288
31,Navarra,105,Fitero,2213,1121,1092
31,Navarra,106,Fontellas,804,420,384
31,Navarra,107,Funes,2388,1266,1122
31,Navarra,108,Fustiñana,2495,1256,1239
31,Navarra,109,Galar,1342,695,647
31,Navarra,110,Gallipienzo,158,80,78
31,Navarra,111,Gallués/Galoze,120,75,45
31,Navarra,112,Garaioa,126,69,57
31,Navarra,113,Garde,180,104,76
31,Navarra,114,Garínoain,443,245,198
31,Navarra,115,Garralda,195,97,98
31,Navarra,116,Genevilla,105,59,46
31,Navarra,117,Goizueta,814,448,366
31,Navarra,118,Goñi,204,123,81
31,Navarra,119,Güesa/Gorza,66,38,28
31,Navarra,120,Guesálaz,453,267,186
31,Navarra,121,Guirguillano,94,48,46
31,Navarra,256,Hiriberri/Villanueva de Aezkoa,144,84,60
31,Navarra,122,Huarte/Uharte,3623,1846,1777
31,Navarra,124,Ibargoiti,230,137,93
31,Navarra,259,Igantzi,615,321,294
31,Navarra,125,Igúzquiza,357,172,185
31,Navarra,126,Imotz,406,223,183
31,Navarra,127,Irañeta,165,88,77
31,Navarra,904,Irurtzun,2234,1178,1056
31,Navarra,128,Isaba/Izaba,487,240,247
31,Navarra,129,Ituren,472,237,235
31,Navarra,130,Iturmendi,381,199,182
31,Navarra,131,Iza,754,396,358
31,Navarra,132,Izagaondoa,172,102,70
31,Navarra,133,Izalzu/Itzaltzu,47,28,19
31,Navarra,134,Jaurrieta,235,128,107
31,Navarra,135,Javier,77,34,43
31,Navarra,136,Juslapeña,491,269,222
31,Navarra,138,Lakuntza,1091,563,528
31,Navarra,139,Lana,215,127,88
31,Navarra,140,Lantz,124,78,46
31,Navarra,141,Lapoblación,174,106,68
31,Navarra,142,Larraga,1963,1111,852
31,Navarra,143,Larraona,142,70,72
31,Navarra,144,Larraun,1074,604,470
31,Navarra,145,Lazagurría,207,107,100
31,Navarra,146,Leache,48,28,20
31,Navarra,147,Legarda,111,61,50
31,Navarra,148,Legaria,123,56,67
31,Navarra,149,Leitza,2901,1534,1367
31,Navarra,908,Lekunberri,951,482,469
31,Navarra,150,Leoz,267,170,97
31,Navarra,151,Lerga,78,44,34
31,Navarra,152,Lerín,1833,932,901
31,Navarra,153,Lesaka,2663,1381,1282
31,Navarra,154,Lezáun,263,156,107
31,Navarra,155,Liédena,344,167,177
31,Navarra,156,Lizoáin,271,161,110
31,Navarra,157,Lodosa,4719,2416,2303
31,Navarra,158,Lónguida/Longida,307,164,143
31,Navarra,159,Lumbier,1426,754,672
31,Navarra,160,Luquin,137,76,61
31,Navarra,248,Luzaide/Valcarlos,443,214,229
31,Navarra,161,Mañeru,382,197,185
31,Navarra,162,Marañón,63,32,31
31,Navarra,163,Marcilla,2636,1352,1284
31,Navarra,164,Mélida,762,378,384
31,Navarra,165,Mendavia,3722,1907,1815
31,Navarra,166,Mendaza,347,166,181
31,Navarra,167,Mendigorría,1013,520,493
31,Navarra,168,Metauten,299,169,130
31,Navarra,169,Milagro,2945,1510,1435
31,Navarra,170,Mirafuentes,58,30,28
31,Navarra,171,Miranda de Arga,1003,515,488
31,Navarra,172,Monreal,337,177,160
31,Navarra,173,Monteagudo,1154,573,581
31,Navarra,174,Morentin,164,84,80
31,Navarra,175,Mues,108,60,48
31,Navarra,176,Murchante,3289,1639,1650
31,Navarra,177,Murieta,273,156,117
31,Navarra,178,Murillo el Cuende,657,346,311
31,Navarra,179,Murillo el Fruto,748,386,362
31,Navarra,180,Muruzábal,293,138,155
31,Navarra,181,Navascués,200,125,75
31,Navarra,182,Nazar,56,35,21
31,Navarra,88,Noáin (Valle de Elorz)/Noain (Elortzibar),4254,2130,2124
31,Navarra,183,Obanos,875,426,449
31,Navarra,185,Ochagavía,655,342,313
31,Navarra,184,Oco,76,45,31
31,Navarra,186,Odieta,333,187,146
31,Navarra,187,Oitz,151,88,63
31,Navarra,188,Olaibar,185,93,92
31,Navarra,189,Olazti/Olazagutía,1704,879,825
31,Navarra,190,Olejua,54,24,30
31,Navarra,191,Olite,3356,1700,1656
31,Navarra,194,Ollo,305,169,136
31,Navarra,192,Olóriz,193,115,78
31,Navarra,193,Olza,1379,710,669
31,Navarra,195,Orbaitzeta,227,119,108
31,Navarra,196,Orbara,57,29,28
31,Navarra,906,Orcoyen,1885,992,893
31,Navarra,197,Orísoain,85,47,38
31,Navarra,198,Oronz,55,31,24
31,Navarra,199,Oroz-Betelu,199,103,96
31,Navarra,211,Orreaga/Roncesvalles,26,14,12
31,Navarra,200,Oteiza,924,482,442
31,Navarra,201,Pamplona/Iruña,191865,91776,100089
31,Navarra,202,Peralta,5681,2886,2795
31,Navarra,203,Petilla de Aragón,34,20,14
31,Navarra,204,Piedramillera,60,38,22
31,Navarra,205,Pitillas,620,312,308
31,Navarra,206,Puente la Reina/Gares,2546,1282,1264
31,Navarra,207,Pueyo,320,171,149
31,Navarra,208,Ribaforada,3416,1758,1658
31,Navarra,209,Romanzado,154,89,65
31,Navarra,210,Roncal/Erronkari,308,171,137
31,Navarra,212,Sada,216,115,101
31,Navarra,213,Saldías,126,75,51
31,Navarra,214,Salinas de Oro,109,60,49
31,Navarra,215,San Adrián,5940,2933,3007
31,Navarra,217,San Martín de Unx,436,231,205
31,Navarra,216,Sangüesa/Zangoza,4971,2551,2420
31,Navarra,219,Sansol,110,53,57
31,Navarra,220,Santacara,1023,519,504
31,Navarra,222,Sarriés/Sartze,79,48,31
31,Navarra,223,Sartaguda,1349,692,657
31,Navarra,224,Sesma,1387,694,693
31,Navarra,225,Sorlada,42,21,21
31,Navarra,226,Sunbilla,660,344,316
31,Navarra,227,Tafalla,10782,5331,5451
31,Navarra,228,Tiebas-Muruarte de Reta,545,288,257
31,Navarra,229,Tirapu,57,33,24
31,Navarra,230,Torralba del Río,135,70,65
31,Navarra,231,Torres del Río,169,83,86
31,Navarra,232,Tudela,31659,15884,15775
31,Navarra,233,Tulebras,107,38,69
31,Navarra,234,Ucar,145,79,66
31,Navarra,123,Uharte-Arakil,776,419,357
31,Navarra,235,Ujué,237,121,116
31,Navarra,236,Ultzama,1608,794,814
31,Navarra,237,Unciti,226,131,95
31,Navarra,238,Unzué,139,80,59
31,Navarra,239,Urdazubi/Urdax,376,184,192
31,Navarra,240,Urdiain,620,316,304
31,Navarra,241,Urraul Alto,178,107,71
31,Navarra,242,Urraul Bajo,289,130,159
31,Navarra,244,Urrotz,187,111,76
31,Navarra,243,Urroz,384,199,185
31,Navarra,245,Urzainqui,109,59,50
31,Navarra,246,Uterga,171,90,81
31,Navarra,247,Uztárroz/Uztarroze,223,105,118
31,Navarra,249,Valtierra,2433,1198,1235
31,Navarra,251,Viana,3580,1868,1712
31,Navarra,252,Vidángoz/Bidankoze,115,61,54
31,Navarra,254,Villafranca,2733,1399,1334
31,Navarra,255,Villamayor de Monjardín,135,68,67
31,Navarra,257,Villatuerta,970,490,480
31,Navarra,258,Villava/Atarrabia,10179,5067,5112
31,Navarra,260,Yerri,1516,805,711
31,Navarra,261,Yesa,260,141,119
31,Navarra,262,Zabalza,171,80,91
31,Navarra,73,Ziordia,369,173,196
31,Navarra,907,Zizur Mayor/Zizur Nagusia,12833,6390,6443
31,Navarra,263,Zubieta,292,165,127
31,Navarra,264,Zugarramurdi,229,117,112
31,Navarra,265,Zúñiga,183,108,75
32,Ourense,1,Allariz,5313,2570,2743
32,Ourense,2,Amoeiro,2322,1152,1170
32,Ourense,3,Arnoia (A),1247,591,656
32,Ourense,4,Avión,2804,1243,1561
32,Ourense,5,Baltar,1180,593,587
32,Ourense,6,Bande,2326,1073,1253
32,Ourense,7,Baños de Molgas,2038,1004,1034
32,Ourense,8,Barbadás,7597,3698,3899
32,Ourense,9,Barco de Valdeorras (O),13518,6738,6780
32,Ourense,10,Beade,578,288,290
32,Ourense,11,Beariz,1404,648,756
32,Ourense,12,Blancos (Os),1138,565,573
32,Ourense,13,Boborás,3214,1471,1743
32,Ourense,14,Bola (A),1549,736,813
32,Ourense,15,Bolo (O),1286,636,650
32,Ourense,16,Calvos de Randín,1212,606,606
32,Ourense,18,Carballeda de Avia,1601,766,835
32,Ourense,17,Carballeda de Valdeorras,2080,1033,1047
32,Ourense,19,Carballiño (O),13226,6257,6969
32,Ourense,20,Cartelle,3565,1708,1857
32,Ourense,22,Castrelo de Miño,2044,1000,1044
32,Ourense,21,Castrelo do Val,1239,610,629
32,Ourense,23,Castro Caldelas,1833,922,911
32,Ourense,24,Celanova,6079,2875,3204
32,Ourense,25,Cenlle,1575,747,828
32,Ourense,29,Chandrexa de Queixa,830,446,384
32,Ourense,26,Coles,3252,1607,1645
32,Ourense,27,Cortegada,1407,676,731
32,Ourense,28,Cualedro,2286,1145,1141
32,Ourense,30,Entrimo,1370,631,739
32,Ourense,31,Esgos,1304,641,663
32,Ourense,33,Gomesende,1118,535,583
32,Ourense,34,Gudiña (A),1625,813,812
32,Ourense,35,Irixo (O),2033,955,1078
32,Ourense,38,Larouco,570,273,297
32,Ourense,39,Laza,1800,882,918
32,Ourense,40,Leiro,1940,924,1016
32,Ourense,41,Lobeira,1188,575,613
32,Ourense,42,Lobios,2547,1225,1322
32,Ourense,43,Maceda,3262,1595,1667
32,Ourense,44,Manzaneda,1150,586,564
32,Ourense,45,Maside,3121,1468,1653
32,Ourense,46,Melón,1552,702,850
32,Ourense,47,Merca (A),2341,1104,1237
32,Ourense,48,Mezquita (A),1406,723,683
32,Ourense,49,Montederramo,1130,574,556
32,Ourense,50,Monterrei,3187,1590,1597
32,Ourense,51,Muíños,1985,970,1015
32,Ourense,52,Nogueira de Ramuín,2561,1218,1343
32,Ourense,53,Oímbra,1984,995,989
32,Ourense,54,Ourense,108600,50703,57897
32,Ourense,55,Paderne de Allariz,1630,775,855
32,Ourense,56,Padrenda,2479,1182,1297
32,Ourense,57,Parada de Sil,788,380,408
32,Ourense,58,Pereiro de Aguiar (O),5391,2724,2667
32,Ourense,59,Peroxa (A),2502,1170,1332
32,Ourense,60,Petín,1095,534,561
32,Ourense,61,Piñor,1505,744,761
32,Ourense,63,Pobra de Trives (A),2721,1354,1367
32,Ourense,64,Pontedeva,647,307,340
32,Ourense,62,Porqueira,1130,554,576
32,Ourense,65,Punxín,945,437,508
32,Ourense,66,Quintela de Leirado,831,385,446
32,Ourense,67,Rairiz de Veiga,1788,869,919
32,Ourense,68,Ramirás,2046,951,1095
32,Ourense,69,Ribadavia,5510,2652,2858
32,Ourense,71,Riós,2097,1037,1060
32,Ourense,72,Rúa (A),5000,2432,2568
32,Ourense,73,Rubiá,1685,829,856
32,Ourense,74,San Amaro,1371,672,699
32,Ourense,75,San Cibrao das Viñas,3867,1883,1984
32,Ourense,76,San Cristovo de Cea,2994,1450,1544
32,Ourense,70,San Xoán de Río,864,415,449
32,Ourense,77,Sandiás,1585,737,848
32,Ourense,78,Sarreaus,1800,885,915
32,Ourense,79,Taboadela,1691,835,856
32,Ourense,80,Teixeira (A),547,267,280
32,Ourense,81,Toén,2573,1294,1279
32,Ourense,82,Trasmiras,1786,866,920
32,Ourense,83,Veiga (A),1318,657,661
32,Ourense,84,Verea,1398,672,726
32,Ourense,85,Verín,13585,6622,6963
32,Ourense,86,Viana do Bolo,3663,1825,1838
32,Ourense,87,Vilamarín,2301,1135,1166
32,Ourense,88,Vilamartín de Valdeorras,2472,1169,1303
32,Ourense,89,Vilar de Barrio,1914,938,976
32,Ourense,90,Vilar de Santos,1004,483,521
32,Ourense,91,Vilardevós,2633,1316,1317
32,Ourense,92,Vilariño de Conso,749,415,334
32,Ourense,32,Xinzo de Limia,9869,4904,4965
32,Ourense,36,Xunqueira de Ambía,1934,964,970
32,Ourense,37,Xunqueira de Espadanedo,1033,493,540
33,Asturias,1,Allande,2261,1158,1103
33,Asturias,2,Aller,14036,6884,7152
33,Asturias,3,Amieva,877,469,408
33,Asturias,4,Avilés,83899,40216,43683
33,Asturias,5,Belmonte de Miranda,2054,1052,1002
33,Asturias,6,Bimenes,1977,928,1049
33,Asturias,7,Boal,2239,1106,1133
33,Asturias,8,Cabrales,2291,1163,1128
33,Asturias,9,Cabranes,1097,554,543
33,Asturias,10,Candamo,2407,1170,1237
33,Asturias,12,Cangas de Onís,6494,3202,3292
33,Asturias,11,Cangas del Narcea,16011,8031,7980
33,Asturias,13,Caravia,565,279,286
33,Asturias,14,Carreño,10435,5115,5320
33,Asturias,15,Caso,2011,1074,937
33,Asturias,16,Castrillón,22889,11150,11739
33,Asturias,17,Castropol,4052,1903,2149
33,Asturias,18,Coaña,3507,1708,1799
33,Asturias,19,Colunga,3947,1952,1995
33,Asturias,20,Corvera de Asturias,15924,7811,8113
33,Asturias,21,Cudillero,5998,2921,3077
33,Asturias,22,Degaña,1407,732,675
33,Asturias,23,Franco (El),4112,2006,2106
33,Asturias,24,Gijón,271039,128762,142277
33,Asturias,25,Gozón,10744,5228,5516
33,Asturias,26,Grado,11237,5436,5801
33,Asturias,27,Grandas de Salime,1219,620,599
33,Asturias,28,Ibias,1972,1061,911
33,Asturias,29,Illano,580,306,274
33,Asturias,30,Illas,1045,555,490
33,Asturias,31,Langreo,46964,22404,24560
33,Asturias,32,Laviana,14440,6971,7469
33,Asturias,33,Lena,13425,6491,6934
33,Asturias,35,Llanera,13045,6483,6562
33,Asturias,36,Llanes,12982,6261,6721
33,Asturias,37,Mieres,46561,22222,24339
33,Asturias,38,Morcín,3084,1541,1543
33,Asturias,39,Muros de Nalón,2076,971,1105
33,Asturias,40,Nava,5473,2695,2778
33,Asturias,41,Navia,9047,4344,4703
33,Asturias,42,Noreña,4600,2227,2373
33,Asturias,43,Onís,842,432,410
33,Asturias,44,Oviedo,209495,97549,111946
33,Asturias,45,Parres,5705,2808,2897
33,Asturias,46,Peñamellera Alta,667,332,335
33,Asturias,47,Peñamellera Baja,1515,749,766
33,Asturias,48,Pesoz,221,102,119
33,Asturias,49,Piloña,8475,4136,4339
33,Asturias,50,Ponga,701,419,282
33,Asturias,51,Pravia,9087,4388,4699
33,Asturias,52,Proaza,815,427,388
33,Asturias,53,Quirós,1488,794,694
33,Asturias,54,Regueras (Las),2091,1037,1054
33,Asturias,55,Ribadedeva,1890,925,965
33,Asturias,56,Ribadesella,6220,2957,3263
33,Asturias,57,Ribera de Arriba,2005,999,1006
33,Asturias,58,Riosa,2411,1237,1174
33,Asturias,59,Salas,6447,3148,3299
33,Asturias,61,San Martín de Oscos,477,242,235
33,Asturias,60,San Martín del Rey Aurelio,19938,9610,10328
33,Asturias,63,San Tirso de Abres,612,301,311
33,Asturias,62,Santa Eulalia de Oscos,564,287,277
33,Asturias,64,Santo Adriano,284,139,145
33,Asturias,65,Sariego,1366,666,700
33,Asturias,66,Siero,48909,23743,25166
33,Asturias,67,Sobrescobio,873,469,404
33,Asturias,68,Somiedo,1527,831,696
33,Asturias,69,Soto del Barco,4119,2000,2119
33,Asturias,70,Tapia de Casariego,4325,2091,2234
33,Asturias,71,Taramundi,840,408,432
33,Asturias,72,Teverga,2049,1067,982
33,Asturias,73,Tineo,12312,6258,6054
33,Asturias,34,Valdés,14395,7035,7360
33,Asturias,74,Vegadeo,4465,2125,2340
33,Asturias,75,Villanueva de Oscos,416,213,203
33,Asturias,76,Villaviciosa,14166,6946,7220
33,Asturias,77,Villayón,1820,911,909
33,Asturias,78,Yernes y Tameza,206,104,102
34,Palencia,1,Abarca de Campos,47,28,19
34,Palencia,3,Abia de las Torres,186,96,90
34,Palencia,4,Aguilar de Campoo,7346,3575,3771
34,Palencia,5,Alar del Rey,1185,578,607
34,Palencia,6,Alba de Cerrato,99,51,48
34,Palencia,9,Amayuelas de Arriba,38,24,14
34,Palencia,10,Ampudia,677,353,324
34,Palencia,11,Amusco,507,276,231
34,Palencia,12,Antigüedad,405,215,190
34,Palencia,15,Arconada,52,29,23
34,Palencia,17,Astudillo,1205,627,578
34,Palencia,18,Autilla del Pino,243,132,111
34,Palencia,19,Autillo de Campos,191,89,102
34,Palencia,20,Ayuela,69,43,26
34,Palencia,22,Baltanás,1452,756,696
34,Palencia,24,Baquerín de Campos,24,13,11
34,Palencia,25,Bárcena de Campos,59,27,32
34,Palencia,27,Barruelo de Santullán,1592,760,832
34,Palencia,28,Báscones de Ojeda,195,104,91
34,Palencia,29,Becerril de Campos,1028,509,519
34,Palencia,31,Belmonte de Campos,34,15,19
34,Palencia,32,Berzosilla,63,27,36
34,Palencia,33,Boada de Campos,22,12,10
34,Palencia,35,Boadilla de Rioseco,158,82,76
34,Palencia,34,Boadilla del Camino,166,89,77
34,Palencia,36,Brañosera,284,148,136
34,Palencia,37,Buenavista de Valdavia,416,206,210
34,Palencia,38,Bustillo de la Vega,363,192,171
34,Palencia,39,Bustillo del Páramo de Carrión,82,47,35
34,Palencia,41,Calahorra de Boedo,125,65,60
34,Palencia,42,Calzada de los Molinos,378,207,171
34,Palencia,45,Capillas,102,51,51
34,Palencia,46,Cardeñosa de Volpejera,51,26,25
34,Palencia,47,Carrión de los Condes,2334,1115,1219
34,Palencia,48,Castil de Vela,91,43,48
34,Palencia,49,Castrejón de la Peña,578,300,278
34,Palencia,50,Castrillo de Don Juan,305,165,140
34,Palencia,51,Castrillo de Onielo,154,77,77
34,Palencia,52,Castrillo de Villavega,255,130,125
34,Palencia,53,Castromocho,258,138,120
34,Palencia,55,Cervatos de la Cueza,340,182,158
34,Palencia,56,Cervera de Pisuerga,2679,1339,1340
34,Palencia,57,Cevico de la Torre,588,288,300
34,Palencia,58,Cevico Navero,253,134,119
34,Palencia,59,Cisneros,551,277,274
34,Palencia,60,Cobos de Cerrato,220,113,107
34,Palencia,61,Collazos de Boedo,153,84,69
34,Palencia,62,Congosto de Valdavia,239,136,103
34,Palencia,63,Cordovilla la Real,117,62,55
34,Palencia,66,Cubillas de Cerrato,77,42,35
34,Palencia,67,Dehesa de Montejo,195,106,89
34,Palencia,68,Dehesa de Romanos,47,29,18
34,Palencia,69,Dueñas,3029,1592,1437
34,Palencia,70,Espinosa de Cerrato,225,120,105
34,Palencia,71,Espinosa de Villagonzalo,226,115,111
34,Palencia,72,Frechilla,249,121,128
34,Palencia,73,Fresno del Río,190,98,92
34,Palencia,74,Frómista,928,469,459
34,Palencia,76,Fuentes de Nava,774,402,372
34,Palencia,77,Fuentes de Valdepero,232,129,103
34,Palencia,79,Grijota,1011,503,508
34,Palencia,80,Guardo,8041,4022,4019
34,Palencia,81,Guaza de Campos,68,34,34
34,Palencia,82,Hérmedes de Cerrato,122,60,62
34,Palencia,83,Herrera de Pisuerga,2457,1200,1257
34,Palencia,84,Herrera de Valdecañas,180,93,87
34,Palencia,86,Hontoria de Cerrato,111,57,54
34,Palencia,87,Hornillos de Cerrato,118,60,58
34,Palencia,88,Husillos,208,117,91
34,Palencia,89,Itero de la Vega,215,114,101
34,Palencia,91,Lagartos,147,80,67
34,Palencia,92,Lantadilla,456,224,232
34,Palencia,94,Ledigos,96,51,45
34,Palencia,903,Loma de Ucieza,298,161,137
34,Palencia,96,Lomas,56,24,32
34,Palencia,98,Magaz de Pisuerga,755,395,360
34,Palencia,99,Manquillos,63,33,30
34,Palencia,100,Mantinos,170,87,83
34,Palencia,101,Marcilla de Campos,63,27,36
34,Palencia,102,Mazariegos,267,147,120
34,Palencia,103,Mazuecos de Valdeginate,121,61,60
34,Palencia,104,Melgar de Yuso,351,197,154
34,Palencia,106,Meneses de Campos,142,72,70
34,Palencia,107,Micieces de Ojeda,104,59,45
34,Palencia,108,Monzón de Campos,696,367,329
34,Palencia,109,Moratinos,76,40,36
34,Palencia,110,Mudá,105,52,53
34,Palencia,112,Nogal de las Huertas,62,35,27
34,Palencia,113,Olea de Boedo,42,18,24
34,Palencia,114,Olmos de Ojeda,296,169,127
34,Palencia,116,Osornillo,88,45,43
34,Palencia,901,Osorno la Mayor,1592,827,765
34,Palencia,120,Palencia,81207,38519,42688
34,Palencia,121,Palenzuela,278,147,131
34,Palencia,122,Páramo de Boedo,107,57,50
34,Palencia,123,Paredes de Nava,2293,1142,1151
34,Palencia,124,Payo de Ojeda,86,51,35
34,Palencia,125,Pedraza de Campos,115,60,55
34,Palencia,126,Pedrosa de la Vega,366,197,169
34,Palencia,127,Perales,107,55,52
34,Palencia,904,Pernía (La),440,244,196
34,Palencia,129,Pino del Río,265,155,110
34,Palencia,130,Piña de Campos,279,146,133
34,Palencia,131,Población de Arroyo,88,48,40
34,Palencia,132,Población de Campos,179,98,81
34,Palencia,133,Población de Cerrato,133,70,63
34,Palencia,134,Polentinos,78,41,37
34,Palencia,135,Pomar de Valdivia,531,278,253
34,Palencia,136,Poza de la Vega,267,147,120
34,Palencia,137,Pozo de Urama,44,24,20
34,Palencia,139,Prádanos de Ojeda,218,117,101
34,Palencia,140,Puebla de Valdavia (La),148,75,73
34,Palencia,141,Quintana del Puente,247,128,119
34,Palencia,143,Quintanilla de Onsoña,220,120,100
34,Palencia,146,Reinoso de Cerrato,69,39,30
34,Palencia,147,Renedo de la Vega,256,144,112
34,Palencia,149,Requena de Campos,41,18,23
34,Palencia,151,Respenda de la Peña,228,125,103
34,Palencia,152,Revenga de Campos,179,91,88
34,Palencia,154,Revilla de Collazos,79,44,35
34,Palencia,155,Ribas de Campos,185,96,89
34,Palencia,156,Riberos de la Cueza,87,51,36
34,Palencia,157,Saldaña,3077,1550,1527
34,Palencia,158,Salinas de Pisuerga,337,163,174
34,Palencia,159,San Cebrián de Campos,471,270,201
34,Palencia,160,San Cebrián de Mudá,185,90,95
34,Palencia,161,San Cristóbal de Boedo,38,22,16
34,Palencia,163,San Mamés de Campos,90,39,51
34,Palencia,165,San Román de la Cuba,108,53,55
34,Palencia,167,Santa Cecilia del Alcor,152,85,67
34,Palencia,168,Santa Cruz de Boedo,52,31,21
34,Palencia,169,Santervás de la Vega,516,280,236
34,Palencia,170,Santibáñez de Ecla,87,39,48
34,Palencia,171,Santibáñez de la Peña,1392,688,704
34,Palencia,174,Santoyo,267,128,139
34,Palencia,175,Serna (La),116,69,47
34,Palencia,177,Soto de Cerrato,212,112,100
34,Palencia,176,Sotobañado y Priorato,179,98,81
34,Palencia,178,Tabanera de Cerrato,148,80,68
34,Palencia,179,Tabanera de Valdavia,48,21,27
34,Palencia,180,Támara de Campos,93,45,48
34,Palencia,181,Tariego de Cerrato,547,280,267
34,Palencia,182,Torquemada,1091,570,521
34,Palencia,184,Torremormojón,78,43,35
34,Palencia,185,Triollo,86,48,38
34,Palencia,186,Valbuena de Pisuerga,68,37,31
34,Palencia,189,Valdeolmillos,83,44,39
34,Palencia,190,Valderrábano,65,37,28
34,Palencia,192,Valde-Ucieza,117,65,52
34,Palencia,196,Valle de Cerrato,114,63,51
34,Palencia,902,Valle del Retortillo,189,94,95
34,Palencia,199,Velilla del Río Carrión,1632,824,808
34,Palencia,23,Venta de Baños,5967,2905,3062
34,Palencia,201,Vertavillo,216,116,100
34,Palencia,93,Vid de Ojeda (La),130,78,52
34,Palencia,202,Villabasta de Valdavia,38,16,22
34,Palencia,204,Villacidaler,71,33,38
34,Palencia,205,Villaconancio,85,50,35
34,Palencia,206,Villada,1200,599,601
34,Palencia,208,Villaeles de Valdavia,74,40,34
34,Palencia,210,Villahán,124,65,59
34,Palencia,211,Villaherreros,252,124,128
34,Palencia,213,Villalaco,74,30,44
34,Palencia,214,Villalba de Guardo,228,125,103
34,Palencia,215,Villalcázar de Sirga,216,103,113
34,Palencia,216,Villalcón,82,40,42
34,Palencia,217,Villalobón,608,306,302
34,Palencia,218,Villaluenga de la Vega,667,375,292
34,Palencia,220,Villamartín de Campos,134,71,63
34,Palencia,221,Villamediana,229,120,109
34,Palencia,222,Villameriel,141,80,61
34,Palencia,223,Villamoronta,314,180,134
34,Palencia,224,Villamuera de la Cueza,60,33,27
34,Palencia,225,Villamuriel de Cerrato,5304,2726,2578
34,Palencia,227,Villanueva del Rebollar,106,57,49
34,Palencia,228,Villanuño de Valdavia,115,62,53
34,Palencia,229,Villaprovedo,84,54,30
34,Palencia,230,Villarmentero de Campos,16,11,5
34,Palencia,231,Villarrabé,251,128,123
34,Palencia,232,Villarramiel,1012,522,490
34,Palencia,233,Villasarracino,225,123,102
34,Palencia,234,Villasila de Valdavia,92,58,34
34,Palencia,236,Villaturde,225,112,113
34,Palencia,237,Villaumbrales,814,427,387
34,Palencia,238,Villaviudas,423,203,220
34,Palencia,240,Villerías de Campos,122,68,54
34,Palencia,241,Villodre,36,24,12
34,Palencia,242,Villodrigo,128,58,70
34,Palencia,243,Villoldo,444,230,214
34,Palencia,245,Villota del Páramo,409,238,171
34,Palencia,246,Villovieco,108,55,53
35,Palmas (Las),1,Agaete,5511,2816,2695
35,Palmas (Las),2,Agüimes,24460,12621,11839
35,Palmas (Las),3,Antigua,6853,3883,2970
35,Palmas (Las),4,Arrecife,51633,26403,25230
35,Palmas (Las),5,Artenara,1469,771,698
35,Palmas (Las),6,Arucas,33701,16958,16743
35,Palmas (Las),7,Betancuria,749,378,371
35,Palmas (Las),8,Firgas,7060,3603,3457
35,Palmas (Las),9,Gáldar,22992,11536,11456
35,Palmas (Las),10,Haría,4747,2447,2300
35,Palmas (Las),11,Ingenio,26857,13647,13210
35,Palmas (Las),12,Mogán,15176,8109,7067
35,Palmas (Las),13,Moya,7825,3973,3852
35,Palmas (Las),14,Oliva (La),15583,8452,7131
35,Palmas (Las),15,Pájara,16821,9490,7331
35,Palmas (Las),16,Palmas de Gran Canaria (Las),376953,184619,192334
35,Palmas (Las),17,Puerto del Rosario,28357,14849,13508
35,Palmas (Las),18,San Bartolomé,16884,8689,8195
35,Palmas (Las),19,San Bartolomé de Tirajana,44155,23091,21064
35,Palmas (Las),20,San Nicolás de Tolentino,7988,4036,3952
35,Palmas (Las),21,Santa Brígida,18599,9292,9307
35,Palmas (Las),22,Santa Lucía de Tirajana,53820,27497,26323
35,Palmas (Las),23,Santa María de Guía de Gran Canaria,14107,7043,7064
35,Palmas (Las),24,Teguise,14477,7462,7015
35,Palmas (Las),25,Tejeda,2347,1220,1127
35,Palmas (Las),26,Telde,94862,47665,47197
35,Palmas (Las),27,Teror,12281,6196,6085
35,Palmas (Las),28,Tías,15788,8216,7572
35,Palmas (Las),29,Tinajo,5123,2702,2421
35,Palmas (Las),30,Tuineje,11623,6173,5450
35,Palmas (Las),32,Valleseco,4082,2140,1942
35,Palmas (Las),31,Valsequillo de Gran Canaria,8498,4348,4150
35,Palmas (Las),33,Vega de San Mateo,7617,3956,3661
35,Palmas (Las),34,Yaiza,8130,4584,3546
36,Pontevedra,20,Agolada,3678,1807,1871
36,Pontevedra,1,Arbo,4018,1996,2022
36,Pontevedra,3,Baiona,11337,5597,5740
36,Pontevedra,2,Barro,3380,1629,1751
36,Pontevedra,4,Bueu,12483,6136,6347
36,Pontevedra,5,Caldas de Reis,9522,4591,4931
36,Pontevedra,6,Cambados,13564,6582,6982
36,Pontevedra,7,Campo Lameiro,2178,1042,1136
36,Pontevedra,8,Cangas,24643,12237,12406
36,Pontevedra,9,Cañiza (A),6782,3252,3530
36,Pontevedra,10,Catoira,3510,1716,1794
36,Pontevedra,11,Cerdedo,2308,1041,1267
36,Pontevedra,12,Cotobade,4644,2140,2504
36,Pontevedra,13,Covelo,3730,1760,1970
36,Pontevedra,14,Crecente,2756,1268,1488
36,Pontevedra,15,Cuntis,5443,2545,2898
36,Pontevedra,16,Dozón,2030,987,1043
36,Pontevedra,17,Estrada (A),22217,10503,11714
36,Pontevedra,18,Forcarei,4616,2175,2441
36,Pontevedra,19,Fornelos de Montes,2092,965,1127
36,Pontevedra,21,Gondomar,12121,5977,6144
36,Pontevedra,22,Grove (O),11147,5512,5635
36,Pontevedra,23,Guarda (A),10162,4951,5211
36,Pontevedra,901,Illa de Arousa (A),4874,2424,2450
36,Pontevedra,24,Lalín,20698,9994,10704
36,Pontevedra,25,Lama (A),2905,1324,1581
36,Pontevedra,26,Marín,25706,12858,12848
36,Pontevedra,27,Meaño,5489,2647,2842
36,Pontevedra,28,Meis,5004,2376,2628
36,Pontevedra,29,Moaña,18396,8958,9438
36,Pontevedra,30,Mondariz,5320,2509,2811
36,Pontevedra,31,Mondariz-Balneario,704,342,362
36,Pontevedra,32,Moraña,4281,2024,2257
36,Pontevedra,33,Mos,14214,6978,7236
36,Pontevedra,34,Neves (As),4440,2156,2284
36,Pontevedra,35,Nigrán,16894,8340,8554
36,Pontevedra,36,Oia,2912,1473,1439
36,Pontevedra,37,Pazos de Borbén,3161,1479,1682
36,Pontevedra,41,Poio,14651,7185,7466
36,Pontevedra,43,Ponte Caldelas,6393,3074,3319
36,Pontevedra,42,Ponteareas,21049,10214,10835
36,Pontevedra,44,Pontecesures,3028,1493,1535
36,Pontevedra,38,Pontevedra,78715,37390,41325
36,Pontevedra,39,Porriño (O),16527,7978,8549
36,Pontevedra,40,Portas,3176,1490,1686
36,Pontevedra,45,Redondela,29732,14455,15277
36,Pontevedra,46,Ribadumia,4238,2042,2196
36,Pontevedra,47,Rodeiro,3553,1806,1747
36,Pontevedra,48,Rosal (O),5992,2921,3071
36,Pontevedra,49,Salceda de Caselas,6835,3414,3421
36,Pontevedra,50,Salvaterra de Miño,8019,3913,4106
36,Pontevedra,51,Sanxenxo,16424,8055,8369
36,Pontevedra,52,Silleda,9055,4337,4718
36,Pontevedra,53,Soutomaior,5781,2834,2947
36,Pontevedra,54,Tomiño,11776,5812,5964
36,Pontevedra,55,Tui,16303,7774,8529
36,Pontevedra,56,Valga,6160,3030,3130
36,Pontevedra,57,Vigo,292059,139405,152654
36,Pontevedra,59,Vila de Cruces,6779,3372,3407
36,Pontevedra,58,Vilaboa,5853,2875,2978
36,Pontevedra,60,Vilagarcía de Arousa,35053,16912,18141
36,Pontevedra,61,Vilanova de Arousa,10421,5040,5381
37,Salamanca,1,Abusejo,249,126,123
37,Salamanca,2,Agallas,184,96,88
37,Salamanca,3,Ahigal de los Aceiteros,170,86,84
37,Salamanca,4,Ahigal de Villarino,42,21,21
37,Salamanca,5,Alameda de Gardón (La),138,65,73
37,Salamanca,6,Alamedilla (La),204,105,99
37,Salamanca,7,Alaraz,616,316,300
37,Salamanca,8,Alba de Tormes,4844,2401,2443
37,Salamanca,9,Alba de Yeltes,253,127,126
37,Salamanca,10,Alberca (La),1095,565,530
37,Salamanca,11,Alberguería de Argañán (La),184,98,86
37,Salamanca,12,Alconada,207,111,96
37,Salamanca,15,Aldea del Obispo,372,199,173
37,Salamanca,13,Aldeacipreste,192,104,88
37,Salamanca,14,Aldeadávila de la Ribera,1518,764,754
37,Salamanca,16,Aldealengua,562,291,271
37,Salamanca,17,Aldeanueva de Figueroa,312,156,156
37,Salamanca,18,Aldeanueva de la Sierra,117,61,56
37,Salamanca,19,Aldearrodrigo,188,101,87
37,Salamanca,20,Aldearrubia,511,277,234
37,Salamanca,21,Aldeaseca de Alba,110,51,59
37,Salamanca,22,Aldeaseca de la Frontera,331,166,165
37,Salamanca,23,Aldeatejada,800,402,398
37,Salamanca,24,Aldeavieja de Tormes,131,68,63
37,Salamanca,25,Aldehuela de la Bóveda,341,168,173
37,Salamanca,26,Aldehuela de Yeltes,256,134,122
37,Salamanca,27,Almenara de Tormes,257,128,129
37,Salamanca,28,Almendra,215,107,108
37,Salamanca,29,Anaya de Alba,283,153,130
37,Salamanca,30,Añover de Tormes,101,55,46
37,Salamanca,31,Arabayona de Mógica,481,262,219
37,Salamanca,32,Arapiles,491,245,246
37,Salamanca,33,Arcediano,106,57,49
37,Salamanca,34,Arco (El),133,72,61
37,Salamanca,35,Armenteros,309,157,152
37,Salamanca,37,Atalaya (La),141,77,64
37,Salamanca,38,Babilafuente,1000,536,464
37,Salamanca,39,Bañobárez,370,194,176
37,Salamanca,40,Barbadillo,507,246,261
37,Salamanca,41,Barbalos,101,55,46
37,Salamanca,42,Barceo,55,27,28
37,Salamanca,44,Barruecopardo,534,274,260
37,Salamanca,45,Bastida (La),35,20,15
37,Salamanca,46,Béjar,15102,7136,7966
37,Salamanca,47,Beleña,166,82,84
37,Salamanca,49,Bermellar,196,99,97
37,Salamanca,50,Berrocal de Huebra,109,55,54
37,Salamanca,51,Berrocal de Salvatierra,122,60,62
37,Salamanca,52,Boada,370,188,182
37,Salamanca,54,Bodón (El),319,163,156
37,Salamanca,55,Bogajo,196,103,93
37,Salamanca,56,Bouza (La),68,36,32
37,Salamanca,57,Bóveda del Río Almar,294,155,139
37,Salamanca,58,Brincones,92,43,49
37,Salamanca,59,Buenamadre,160,90,70
37,Salamanca,60,Buenavista,149,76,73
37,Salamanca,61,Cabaco (El),304,159,145
37,Salamanca,63,Cabeza de Béjar (La),89,46,43
37,Salamanca,65,Cabeza del Caballo,453,234,219
37,Salamanca,62,Cabezabellosa de la Calzada,123,67,56
37,Salamanca,67,Cabrerizos,2768,1402,1366
37,Salamanca,68,Cabrillas,492,246,246
37,Salamanca,69,Calvarrasa de Abajo,1010,496,514
37,Salamanca,70,Calvarrasa de Arriba,674,353,321
37,Salamanca,71,Calzada de Béjar (La),91,46,45
37,Salamanca,72,Calzada de Don Diego,224,116,108
37,Salamanca,73,Calzada de Valdunciel,669,340,329
37,Salamanca,74,Campillo de Azaba,249,124,125
37,Salamanca,77,Campo de Peñaranda (El),356,187,169
37,Salamanca,78,Candelario,1023,514,509
37,Salamanca,79,Canillas de Abajo,102,60,42
37,Salamanca,80,Cantagallo,257,123,134
37,Salamanca,81,Cantalapiedra,1239,620,619
37,Salamanca,82,Cantalpino,1078,594,484
37,Salamanca,83,Cantaracillo,249,133,116
37,Salamanca,85,Carbajosa de la Sagrada,3111,1575,1536
37,Salamanca,86,Carpio de Azaba,100,55,45
37,Salamanca,87,Carrascal de Barregas,554,280,274
37,Salamanca,88,Carrascal del Obispo,236,121,115
37,Salamanca,89,Casafranca,84,41,43
37,Salamanca,90,Casas del Conde (Las),76,39,37
37,Salamanca,91,Casillas de Flores,234,115,119
37,Salamanca,92,Castellanos de Moriscos,427,199,228
37,Salamanca,185,Castellanos de Villiquera,577,306,271
37,Salamanca,96,Castillejo de Martín Viejo,313,168,145
37,Salamanca,97,Castraz,58,32,26
37,Salamanca,98,Cepeda,478,230,248
37,Salamanca,99,Cereceda de la Sierra,94,43,51
37,Salamanca,100,Cerezal de Peñahorcada,125,70,55
37,Salamanca,101,Cerralbo,236,120,116
37,Salamanca,102,Cerro (El),527,282,245
37,Salamanca,103,Cespedosa de Tormes,589,315,274
37,Salamanca,114,Chagarcía Medianero,120,65,55
37,Salamanca,104,Cilleros de la Bastida,37,20,17
37,Salamanca,106,Cipérez,391,191,200
37,Salamanca,107,Ciudad Rodrigo,14169,6850,7319
37,Salamanca,108,Coca de Alba,132,60,72
37,Salamanca,109,Colmenar de Montemayor,247,139,108
37,Salamanca,110,Cordovilla,135,78,57
37,Salamanca,112,Cristóbal,221,114,107
37,Salamanca,113,Cubo de Don Sancho (El),545,284,261
37,Salamanca,115,Dios le Guarde,174,95,79
37,Salamanca,116,Doñinos de Ledesma,102,53,49
37,Salamanca,117,Doñinos de Salamanca,808,418,390
37,Salamanca,118,Ejeme,168,88,80
37,Salamanca,119,Encina (La),160,88,72
37,Salamanca,120,Encina de San Silvestre,124,61,63
37,Salamanca,121,Encinas de Abajo,647,335,312
37,Salamanca,122,Encinas de Arriba,276,131,145
37,Salamanca,123,Encinasola de los Comendadores,265,136,129
37,Salamanca,124,Endrinal,291,165,126
37,Salamanca,125,Escurial de la Sierra,292,157,135
37,Salamanca,126,Espadaña,47,27,20
37,Salamanca,127,Espeja,277,141,136
37,Salamanca,128,Espino de la Orbada,318,160,158
37,Salamanca,129,Florida de Liébana,275,146,129
37,Salamanca,130,Forfoleda,237,123,114
37,Salamanca,131,Frades de la Sierra,257,135,122
37,Salamanca,132,Fregeneda (La),476,235,241
37,Salamanca,133,Fresnedoso,125,65,60
37,Salamanca,134,Fresno Alhándiga,282,150,132
37,Salamanca,135,Fuente de San Esteban (La),1475,742,733
37,Salamanca,136,Fuenteguinaldo,872,447,425
37,Salamanca,137,Fuenteliante,120,56,64
37,Salamanca,138,Fuenterroble de Salvatierra,263,131,132
37,Salamanca,139,Fuentes de Béjar,284,128,156
37,Salamanca,140,Fuentes de Oñoro,1499,766,733
37,Salamanca,141,Gajates,196,94,102
37,Salamanca,142,Galindo y Perahuy,494,277,217
37,Salamanca,143,Galinduste,540,266,274
37,Salamanca,144,Galisancho,487,273,214
37,Salamanca,145,Gallegos de Argañán,370,189,181
37,Salamanca,146,Gallegos de Solmirón,163,77,86
37,Salamanca,147,Garcibuey,242,136,106
37,Salamanca,148,Garcihernández,596,306,290
37,Salamanca,149,Garcirrey,101,54,47
37,Salamanca,150,Gejuelo del Barro,50,28,22
37,Salamanca,151,Golpejas,187,93,94
37,Salamanca,152,Gomecello,511,267,244
37,Salamanca,154,Guadramiro,197,113,84
37,Salamanca,155,Guijo de Ávila,106,65,41
37,Salamanca,156,Guijuelo,5207,2640,2567
37,Salamanca,157,Herguijuela de Ciudad Rodrigo,143,77,66
37,Salamanca,158,Herguijuela de la Sierra,299,155,144
37,Salamanca,159,Herguijuela del Campo,118,51,67
37,Salamanca,160,Hinojosa de Duero,788,391,397
37,Salamanca,161,Horcajo de Montemayor,195,98,97
37,Salamanca,162,Horcajo Medianero,340,171,169
37,Salamanca,163,Hoya (La),30,21,9
37,Salamanca,164,Huerta,278,154,124
37,Salamanca,165,Iruelos,54,21,33
37,Salamanca,166,Ituero de Azaba,276,152,124
37,Salamanca,167,Juzbado,186,93,93
37,Salamanca,168,Lagunilla,579,308,271
37,Salamanca,169,Larrodrigo,274,144,130
37,Salamanca,170,Ledesma,1869,941,928
37,Salamanca,171,Ledrada,577,287,290
37,Salamanca,172,Linares de Riofrío,1014,514,500
37,Salamanca,173,Lumbrales,2049,999,1050
37,Salamanca,175,Machacón,514,259,255
37,Salamanca,174,Macotera,1555,798,757
37,Salamanca,176,Madroñal,165,89,76
37,Salamanca,177,Maíllo (El),392,206,186
37,Salamanca,178,Malpartida,139,74,65
37,Salamanca,179,Mancera de Abajo,324,168,156
37,Salamanca,180,Manzano (El),105,55,50
37,Salamanca,181,Martiago,367,185,182
37,Salamanca,183,Martín de Yeltes,517,267,250
37,Salamanca,182,Martinamor,69,35,34
37,Salamanca,184,Masueco,426,221,205
37,Salamanca,186,Mata de Ledesma (La),137,75,62
37,Salamanca,187,Matilla de los Caños del Río,691,352,339
37,Salamanca,188,Maya (La),259,144,115
37,Salamanca,189,Membribe de la Sierra,111,67,44
37,Salamanca,190,Mieza,334,167,167
37,Salamanca,191,Milano (El),161,90,71
37,Salamanca,192,Miranda de Azán,375,186,189
37,Salamanca,193,Miranda del Castañar,576,302,274
37,Salamanca,194,Mogarraz,335,170,165
37,Salamanca,195,Molinillo,70,35,35
37,Salamanca,196,Monforte de la Sierra,99,56,43
37,Salamanca,197,Monleón,120,67,53
37,Salamanca,198,Monleras,272,130,142
37,Salamanca,199,Monsagro,196,107,89
37,Salamanca,200,Montejo,229,122,107
37,Salamanca,201,Montemayor del Río,341,178,163
37,Salamanca,202,Monterrubio de Armuña,656,355,301
37,Salamanca,203,Monterrubio de la Sierra,154,84,70
37,Salamanca,204,Morasverdes,392,196,196
37,Salamanca,205,Morille,213,112,101
37,Salamanca,206,Moríñigo,131,67,64
37,Salamanca,207,Moriscos,121,58,63
37,Salamanca,208,Moronta,119,62,57
37,Salamanca,209,Mozárbez,404,217,187
37,Salamanca,211,Narros de Matalayegua,268,142,126
37,Salamanca,213,Nava de Béjar,113,58,55
37,Salamanca,214,Nava de Francia,152,77,75
37,Salamanca,215,Nava de Sotrobal,202,111,91
37,Salamanca,212,Navacarros,136,77,59
37,Salamanca,216,Navales,364,208,156
37,Salamanca,217,Navalmoral de Béjar,62,28,34
37,Salamanca,218,Navamorales,134,76,58
37,Salamanca,219,Navarredonda de la Rinconada,268,132,136
37,Salamanca,221,Navasfrías,643,324,319
37,Salamanca,222,Negrilla de Palencia,118,63,55
37,Salamanca,223,Olmedo de Camaces,144,71,73
37,Salamanca,224,Orbada (La),284,148,136
37,Salamanca,225,Pajares de la Laguna,147,73,74
37,Salamanca,226,Palacios del Arzobispo,200,102,98
37,Salamanca,228,Palaciosrubios,500,267,233
37,Salamanca,229,Palencia de Negrilla,181,98,83
37,Salamanca,230,Parada de Arriba,243,126,117
37,Salamanca,231,Parada de Rubiales,324,168,156
37,Salamanca,232,Paradinas de San Juan,585,320,265
37,Salamanca,233,Pastores,48,25,23
37,Salamanca,234,Payo (El),452,221,231
37,Salamanca,235,Pedraza de Alba,285,143,142
37,Salamanca,236,Pedrosillo de Alba,224,114,110
37,Salamanca,237,Pedrosillo de los Aires,412,227,185
37,Salamanca,238,Pedrosillo el Ralo,129,64,65
37,Salamanca,239,Pedroso de la Armuña (El),278,133,145
37,Salamanca,240,Pelabravo,877,445,432
37,Salamanca,241,Pelarrodríguez,194,113,81
37,Salamanca,242,Pelayos,106,55,51
37,Salamanca,243,Peña (La),141,63,78
37,Salamanca,244,Peñacaballera,190,96,94
37,Salamanca,245,Peñaparda,442,234,208
37,Salamanca,246,Peñaranda de Bracamonte,6285,3064,3221
37,Salamanca,247,Peñarandilla,257,129,128
37,Salamanca,248,Peralejos de Abajo,185,94,91
37,Salamanca,249,Peralejos de Arriba,62,36,26
37,Salamanca,250,Pereña de la Ribera,513,268,245
37,Salamanca,251,Peromingo,148,70,78
37,Salamanca,252,Pinedas,173,90,83
37,Salamanca,253,Pino de Tormes (El),181,95,86
37,Salamanca,254,Pitiegua,240,128,112
37,Salamanca,255,Pizarral,81,44,37
37,Salamanca,256,Poveda de las Cintas,313,174,139
37,Salamanca,257,Pozos de Hinojo,65,32,33
37,Salamanca,258,Puebla de Azaba,255,135,120
37,Salamanca,259,Puebla de San Medel,56,31,25
37,Salamanca,260,Puebla de Yeltes,221,117,104
37,Salamanca,261,Puente del Congosto,283,140,143
37,Salamanca,262,Puertas,91,54,37
37,Salamanca,263,Puerto de Béjar,441,205,236
37,Salamanca,264,Puerto Seguro,99,51,48
37,Salamanca,265,Rágama,275,143,132
37,Salamanca,266,Redonda (La),100,52,48
37,Salamanca,267,Retortillo,264,127,137
37,Salamanca,268,Rinconada de la Sierra (La),172,95,77
37,Salamanca,269,Robleda,549,285,264
37,Salamanca,270,Robliza de Cojos,223,116,107
37,Salamanca,271,Rollán,553,279,274
37,Salamanca,272,Saelices el Chico,157,81,76
37,Salamanca,273,Sagrada (La),165,84,81
37,Salamanca,303,Sahugo (El),270,137,133
37,Salamanca,274,Salamanca,160415,74756,85659
37,Salamanca,275,Saldeana,156,86,70
37,Salamanca,276,Salmoral,249,131,118
37,Salamanca,277,Salvatierra de Tormes,67,34,33
37,Salamanca,278,San Cristóbal de la Cuesta,521,281,240
37,Salamanca,284,San Esteban de la Sierra,423,216,207
37,Salamanca,285,San Felices de los Gallegos,588,301,287
37,Salamanca,286,San Martín del Castañar,276,142,134
37,Salamanca,287,San Miguel de Valero,394,208,186
37,Salamanca,36,San Miguel del Robledo,105,46,59
37,Salamanca,288,San Morales,238,133,105
37,Salamanca,289,San Muñoz,324,169,155
37,Salamanca,291,San Pedro de Rozados,350,177,173
37,Salamanca,290,San Pedro del Valle,127,65,62
37,Salamanca,292,San Pelayo de Guareña,130,66,64
37,Salamanca,280,Sanchón de la Ribera,111,59,52
37,Salamanca,281,Sanchón de la Sagrada,51,30,21
37,Salamanca,282,Sanchotello,285,149,136
37,Salamanca,279,Sancti-Spíritus,1001,513,488
37,Salamanca,283,Sando,199,109,90
37,Salamanca,293,Santa María de Sando,159,81,78
37,Salamanca,294,Santa Marta de Tormes,12749,6373,6376
37,Salamanca,296,Santiago de la Puebla,482,239,243
37,Salamanca,297,Santibáñez de Béjar,618,314,304
37,Salamanca,298,Santibáñez de la Sierra,245,131,114
37,Salamanca,299,Santiz,288,143,145
37,Salamanca,300,Santos (Los),725,371,354
37,Salamanca,301,Sardón de los Frailes,88,46,42
37,Salamanca,302,Saucelle,386,195,191
37,Salamanca,304,Sepulcro-Hilario,253,132,121
37,Salamanca,305,Sequeros,244,111,133
37,Salamanca,306,Serradilla del Arroyo,394,204,190
37,Salamanca,307,Serradilla del Llano,222,106,116
37,Salamanca,309,Sierpe (La),49,30,19
37,Salamanca,310,Sieteiglesias de Tormes,166,84,82
37,Salamanca,311,Sobradillo,333,168,165
37,Salamanca,312,Sorihuela,359,181,178
37,Salamanca,313,Sotoserrano,712,373,339
37,Salamanca,314,Tabera de Abajo,105,55,50
37,Salamanca,315,Tala (La),122,65,57
37,Salamanca,316,Tamames,992,507,485
37,Salamanca,317,Tarazona de Guareña,404,217,187
37,Salamanca,318,Tardáguila,232,121,111
37,Salamanca,319,Tejado (El),151,77,74
37,Salamanca,320,Tejeda y Segoyuela,116,57,59
37,Salamanca,321,Tenebrón,213,109,104
37,Salamanca,322,Terradillos,3192,1633,1559
37,Salamanca,323,Topas,695,356,339
37,Salamanca,324,Tordillos,525,274,251
37,Salamanca,325,Tornadizo (El),124,67,57
37,Salamanca,327,Torresmenudas,207,104,103
37,Salamanca,328,Trabanca,262,141,121
37,Salamanca,329,Tremedal de Tormes,37,19,18
37,Salamanca,330,Valdecarros,410,206,204
37,Salamanca,331,Valdefuentes de Sangusín,301,156,145
37,Salamanca,332,Valdehijaderos,107,57,50
37,Salamanca,333,Valdelacasa,320,174,146
37,Salamanca,334,Valdelageve,112,60,52
37,Salamanca,335,Valdelosa,530,254,276
37,Salamanca,336,Valdemierque,52,27,25
37,Salamanca,337,Valderrodrigo,176,84,92
37,Salamanca,338,Valdunciel,103,51,52
37,Salamanca,339,Valero,437,222,215
37,Salamanca,343,Vallejera de Riofrío,67,36,31
37,Salamanca,340,Valsalabroso,194,105,89
37,Salamanca,341,Valverde de Valdelacasa,66,36,30
37,Salamanca,342,Valverdón,291,148,143
37,Salamanca,344,Vecinos,308,151,157
37,Salamanca,345,Vega de Tirados,247,122,125
37,Salamanca,346,Veguillas (Las),305,151,154
37,Salamanca,347,Vellés (La),424,226,198
37,Salamanca,348,Ventosa del Río Almar,134,67,67
37,Salamanca,349,Vídola (La),156,74,82
37,Salamanca,351,Villaflores,402,206,196
37,Salamanca,352,Villagonzalo de Tormes,229,119,110
37,Salamanca,353,Villalba de los Llanos,182,105,77
37,Salamanca,354,Villamayor,4221,2181,2040
37,Salamanca,355,Villanueva del Conde,234,121,113
37,Salamanca,356,Villar de Argañán,105,51,54
37,Salamanca,357,Villar de Ciervo,360,185,175
37,Salamanca,358,Villar de Gallimazo,193,95,98
37,Salamanca,359,Villar de la Yegua,272,129,143
37,Salamanca,360,Villar de Peralonso,324,150,174
37,Salamanca,361,Villar de Samaniego,116,61,55
37,Salamanca,362,Villares de la Reina,3784,1891,1893
37,Salamanca,363,Villares de Yeltes,164,79,85
37,Salamanca,364,Villarino de los Aires,1091,547,544
37,Salamanca,365,Villarmayor,215,114,101
37,Salamanca,366,Villarmuerto,52,31,21
37,Salamanca,367,Villasbuenas,277,148,129
37,Salamanca,368,Villasdardo,18,7,11
37,Salamanca,369,Villaseco de los Gamitos,206,116,90
37,Salamanca,370,Villaseco de los Reyes,422,234,188
37,Salamanca,371,Villasrubias,297,163,134
37,Salamanca,372,Villaverde de Guareña,199,99,100
37,Salamanca,373,Villavieja de Yeltes,1041,518,523
37,Salamanca,374,Villoria,1398,704,694
37,Salamanca,375,Villoruela,980,486,494
37,Salamanca,350,Vilvestre,544,268,276
37,Salamanca,376,Vitigudino,2987,1477,1510
37,Salamanca,377,Yecla de Yeltes,335,173,162
37,Salamanca,378,Zamarra,140,74,66
37,Salamanca,379,Zamayón,195,110,85
37,Salamanca,380,Zarapicos,95,52,43
37,Salamanca,381,Zarza de Pumareda (La),168,94,74
37,Salamanca,382,Zorita de la Frontera,262,132,130
38,Santa Cruz de Tenerife,1,Adeje,30304,15875,14429
38,Santa Cruz de Tenerife,2,Agulo,1221,599,622
38,Santa Cruz de Tenerife,3,Alajeró,1894,1014,880
38,Santa Cruz de Tenerife,4,Arafo,5256,2555,2701
38,Santa Cruz de Tenerife,5,Arico,7005,3645,3360
38,Santa Cruz de Tenerife,6,Arona,59395,30875,28520
38,Santa Cruz de Tenerife,7,Barlovento,2350,1194,1156
38,Santa Cruz de Tenerife,8,Breña Alta,6847,3383,3464
38,Santa Cruz de Tenerife,9,Breña Baja,4186,2107,2079
38,Santa Cruz de Tenerife,10,Buenavista del Norte,5301,2735,2566
38,Santa Cruz de Tenerife,11,Candelaria,19197,9596,9601
38,Santa Cruz de Tenerife,12,Fasnia,2704,1393,1311
38,Santa Cruz de Tenerife,13,Frontera,5231,2651,2580
38,Santa Cruz de Tenerife,14,Fuencaliente de la Palma,1877,968,909
38,Santa Cruz de Tenerife,15,Garachico,5671,2806,2865
38,Santa Cruz de Tenerife,16,Garafía,1948,1009,939
38,Santa Cruz de Tenerife,17,Granadilla de Abona,30769,15961,14808
38,Santa Cruz de Tenerife,18,Guancha (La),5372,2634,2738
38,Santa Cruz de Tenerife,19,Guía de Isora,17816,8986,8830
38,Santa Cruz de Tenerife,20,Güímar,16334,8113,8221
38,Santa Cruz de Tenerife,21,Hermigua,2176,1102,1074
38,Santa Cruz de Tenerife,22,Icod de los Vinos,24023,11919,12104
38,Santa Cruz de Tenerife,24,Llanos de Aridane (Los),19659,9723,9936
38,Santa Cruz de Tenerife,25,Matanza de Acentejo (La),7587,3830,3757
38,Santa Cruz de Tenerife,26,Orotava (La),39909,19759,20150
38,Santa Cruz de Tenerife,27,Paso (El),7218,3667,3551
38,Santa Cruz de Tenerife,28,Puerto de la Cruz,30088,14581,15507
38,Santa Cruz de Tenerife,29,Puntagorda,1708,852,856
38,Santa Cruz de Tenerife,30,Puntallana,2380,1179,1201
38,Santa Cruz de Tenerife,31,Realejos (Los),35756,17732,18024
38,Santa Cruz de Tenerife,32,Rosario (El),15542,8121,7421
38,Santa Cruz de Tenerife,33,San Andrés y Sauces,5012,2563,2449
38,Santa Cruz de Tenerife,23,San Cristóbal de La Laguna,137314,67659,69655
38,Santa Cruz de Tenerife,34,San Juan de la Rambla,5002,2489,2513
38,Santa Cruz de Tenerife,35,San Miguel de Abona,10802,5535,5267
38,Santa Cruz de Tenerife,36,San Sebastián de la Gomera,7984,4046,3938
38,Santa Cruz de Tenerife,37,Santa Cruz de la Palma,17857,8780,9077
38,Santa Cruz de Tenerife,38,Santa Cruz de Tenerife,219446,105797,113649
38,Santa Cruz de Tenerife,39,Santa Úrsula,12237,6139,6098
38,Santa Cruz de Tenerife,40,Santiago del Teide,10777,5426,5351
38,Santa Cruz de Tenerife,41,Sauzal (El),8178,4074,4104
38,Santa Cruz de Tenerife,42,Silos (Los),5547,2773,2774
38,Santa Cruz de Tenerife,43,Tacoronte,21986,11049,10937
38,Santa Cruz de Tenerife,44,Tanque (El),3111,1558,1553
38,Santa Cruz de Tenerife,45,Tazacorte,5797,2921,2876
38,Santa Cruz de Tenerife,46,Tegueste,10165,5033,5132
38,Santa Cruz de Tenerife,47,Tijarafe,2666,1351,1315
38,Santa Cruz de Tenerife,49,Valle Gran Rey,4745,2414,2331
38,Santa Cruz de Tenerife,50,Vallehermoso,3200,1621,1579
38,Santa Cruz de Tenerife,48,Valverde,4840,2447,2393
38,Santa Cruz de Tenerife,51,Victoria de Acentejo (La),8350,4158,4192
38,Santa Cruz de Tenerife,52,Vilaflor,1895,978,917
38,Santa Cruz de Tenerife,53,Villa de Mazo,4777,2418,2359
39,Cantabria,1,Alfoz de Lloredo,2590,1321,1269
39,Cantabria,2,Ampuero,3671,1857,1814
39,Cantabria,3,Anievas,394,197,197
39,Cantabria,4,Arenas de Iguña,1918,978,940
39,Cantabria,5,Argoños,1260,656,604
39,Cantabria,6,Arnuero,1937,977,960
39,Cantabria,7,Arredondo,569,318,251
39,Cantabria,8,Astillero (El),15424,7528,7896
39,Cantabria,9,Bárcena de Cicero,2793,1430,1363
39,Cantabria,10,Bárcena de Pie de Concha,811,396,415
39,Cantabria,11,Bareyo,1810,928,882
39,Cantabria,12,Cabezón de la Sal,7921,3919,4002
39,Cantabria,13,Cabezón de Liébana,705,389,316
39,Cantabria,14,Cabuérniga,1134,588,546
39,Cantabria,15,Camaleño,1127,590,537
39,Cantabria,16,Camargo,26955,13327,13628
39,Cantabria,27,Campoo de Enmedio,3959,2029,1930
39,Cantabria,17,Campoo de Yuso,737,376,361
39,Cantabria,18,Cartes,3752,1912,1840
39,Cantabria,19,Castañeda,1696,843,853
39,Cantabria,20,Castro-Urdiales,25388,12819,12569
39,Cantabria,21,Cieza,664,326,338
39,Cantabria,22,Cillorigo de Liébana,1195,633,562
39,Cantabria,23,Colindres,7075,3526,3549
39,Cantabria,24,Comillas,2373,1115,1258
39,Cantabria,25,Corrales de Buelna (Los),10825,5390,5435
39,Cantabria,26,Corvera de Toranzo,2184,1096,1088
39,Cantabria,28,Entrambasaguas,2520,1253,1267
39,Cantabria,29,Escalante,757,398,359
39,Cantabria,30,Guriezo,1953,1014,939
39,Cantabria,31,Hazas de Cesto,1275,642,633
39,Cantabria,32,Hermandad de Campoo de Suso,1921,1059,862
39,Cantabria,33,Herrerías,720,414,306
39,Cantabria,34,Lamasón,363,216,147
39,Cantabria,35,Laredo,12825,6168,6657
39,Cantabria,36,Liendo,935,486,449
39,Cantabria,37,Liérganes,2328,1173,1155
39,Cantabria,38,Limpias,1457,727,730
39,Cantabria,39,Luena,843,443,400
39,Cantabria,40,Marina de Cudeyo,5059,2564,2495
39,Cantabria,41,Mazcuerras,1946,1018,928
39,Cantabria,42,Medio Cudeyo,6677,3283,3394
39,Cantabria,43,Meruelo,1321,660,661
39,Cantabria,44,Miengo,3860,1936,1924
39,Cantabria,45,Miera,479,244,235
39,Cantabria,46,Molledo,1858,906,952
39,Cantabria,47,Noja,2218,1122,1096
39,Cantabria,48,Penagos,1707,850,857
39,Cantabria,49,Peñarrubia,375,191,184
39,Cantabria,50,Pesaguero,384,211,173
39,Cantabria,51,Pesquera,82,46,36
39,Cantabria,52,Piélagos,14849,7437,7412
39,Cantabria,53,Polaciones,285,191,94
39,Cantabria,54,Polanco,3857,1898,1959
39,Cantabria,55,Potes,1588,778,810
39,Cantabria,56,Puente Viesgo,2506,1277,1229
39,Cantabria,57,Ramales de la Victoria,2273,1162,1111
39,Cantabria,58,Rasines,944,505,439
39,Cantabria,59,Reinosa,10577,5022,5555
39,Cantabria,60,Reocín,7191,3543,3648
39,Cantabria,61,Ribamontán al Mar,3939,2002,1937
39,Cantabria,62,Ribamontán al Monte,2007,1037,970
39,Cantabria,63,Rionansa,1289,734,555
39,Cantabria,64,Riotuerto,1511,729,782
39,Cantabria,65,Rozas de Valdearroyo (Las),319,175,144
39,Cantabria,66,Ruente,985,525,460
39,Cantabria,67,Ruesga,1136,594,542
39,Cantabria,68,Ruiloba,767,395,372
39,Cantabria,69,San Felices de Buelna,2233,1105,1128
39,Cantabria,70,San Miguel de Aguayo,151,83,68
39,Cantabria,71,San Pedro del Romeral,588,309,279
39,Cantabria,72,San Roque de Riomiera,461,264,197
39,Cantabria,80,San Vicente de la Barquera,4464,2262,2202
39,Cantabria,73,Santa Cruz de Bezana,9799,4830,4969
39,Cantabria,74,Santa María de Cayón,6614,3327,3287
39,Cantabria,75,Santander,183799,85877,97922
39,Cantabria,76,Santillana del Mar,4006,1950,2056
39,Cantabria,77,Santiurde de Reinosa,355,188,167
39,Cantabria,78,Santiurde de Toranzo,1406,706,700
39,Cantabria,79,Santoña,11521,5739,5782
39,Cantabria,81,Saro,522,269,253
39,Cantabria,82,Selaya,1983,1010,973
39,Cantabria,83,Soba,1530,808,722
39,Cantabria,84,Solórzano,1056,562,494
39,Cantabria,85,Suances,6906,3401,3505
39,Cantabria,86,Tojos (Los),415,239,176
39,Cantabria,87,Torrelavega,56407,27192,29215
39,Cantabria,88,Tresviso,63,34,29
39,Cantabria,89,Tudanca,212,128,84
39,Cantabria,90,Udías,828,428,400
39,Cantabria,95,Val de San Vicente,2601,1340,1261
39,Cantabria,91,Valdáliga,2410,1257,1153
39,Cantabria,92,Valdeolea,1347,687,660
39,Cantabria,93,Valdeprado del Río,335,186,149
39,Cantabria,94,Valderredible,1213,648,565
39,Cantabria,96,Vega de Liébana,949,510,439
39,Cantabria,97,Vega de Pas,959,509,450
39,Cantabria,98,Villacarriedo,1724,912,812
39,Cantabria,99,Villaescusa,3395,1694,1701
39,Cantabria,100,Villafufre,1120,580,540
39,Cantabria,101,Villaverde de Trucíos,380,199,181
39,Cantabria,102,Voto,2279,1182,1097
40,Segovia,1,Abades,888,454,434
40,Segovia,2,Adrada de Pirón,47,24,23
40,Segovia,3,Adrados,183,95,88
40,Segovia,4,Aguilafuente,773,382,391
40,Segovia,5,Alconada de Maderuelo,52,32,20
40,Segovia,12,Aldea Real,383,204,179
40,Segovia,6,Aldealcorvo,21,10,11
40,Segovia,7,Aldealengua de Pedraza,89,50,39
40,Segovia,8,Aldealengua de Santa María,78,43,35
40,Segovia,9,Aldeanueva de la Serrezuela,54,33,21
40,Segovia,10,Aldeanueva del Codonal,194,104,90
40,Segovia,13,Aldeasoña,82,39,43
40,Segovia,14,Aldehorno,62,32,30
40,Segovia,15,Aldehuela del Codonal,45,24,21
40,Segovia,16,Aldeonte,94,47,47
40,Segovia,17,Anaya,136,71,65
40,Segovia,18,Añe,126,69,57
40,Segovia,19,Arahuetes,54,30,24
40,Segovia,20,Arcones,260,137,123
40,Segovia,21,Arevalillo de Cega,42,20,22
40,Segovia,22,Armuña,247,134,113
40,Segovia,24,Ayllón,1238,628,610
40,Segovia,25,Barbolla,226,119,107
40,Segovia,26,Basardilla,149,73,76
40,Segovia,28,Bercial,119,58,61
40,Segovia,29,Bercimuel,84,41,43
40,Segovia,30,Bernardos,670,353,317
40,Segovia,31,Bernuy de Porreros,400,214,186
40,Segovia,32,Boceguillas,649,327,322
40,Segovia,33,Brieva,71,45,26
40,Segovia,34,Caballar,104,51,53
40,Segovia,35,Cabañas de Polendos,121,63,58
40,Segovia,36,Cabezuela,719,376,343
40,Segovia,37,Calabazas de Fuentidueña,61,30,31
40,Segovia,39,Campo de San Pedro,354,202,152
40,Segovia,40,Cantalejo,3622,1834,1788
40,Segovia,41,Cantimpalos,1296,670,626
40,Segovia,43,Carbonero el Mayor,2469,1255,1214
40,Segovia,44,Carrascal del Río,201,107,94
40,Segovia,45,Casla,167,85,82
40,Segovia,46,Castillejo de Mesleón,146,77,69
40,Segovia,47,Castro de Fuentidueña,73,41,32
40,Segovia,48,Castrojimeno,38,22,16
40,Segovia,49,Castroserna de Abajo,49,24,25
40,Segovia,51,Castroserracín,50,32,18
40,Segovia,52,Cedillo de la Torre,108,52,56
40,Segovia,53,Cerezo de Abajo,186,93,93
40,Segovia,54,Cerezo de Arriba,185,107,78
40,Segovia,65,Chañe,710,380,330
40,Segovia,55,Cilleruelo de San Mamés,46,23,23
40,Segovia,56,Cobos de Fuentidueña,56,25,31
40,Segovia,57,Coca,2005,992,1013
40,Segovia,58,Codorniz,453,219,234
40,Segovia,59,Collado Hermoso,154,76,78
40,Segovia,60,Condado de Castilnovo,128,68,60
40,Segovia,61,Corral de Ayllón,97,52,45
40,Segovia,902,Cozuelos de Fuentidueña,168,92,76
40,Segovia,62,Cubillo,58,34,24
40,Segovia,63,Cuéllar,9495,4828,4667
40,Segovia,905,Cuevas de Provanco,179,93,86
40,Segovia,68,Domingo García,50,26,24
40,Segovia,69,Donhierro,96,52,44
40,Segovia,70,Duruelo,136,74,62
40,Segovia,71,Encinas,68,33,35
40,Segovia,72,Encinillas,83,48,35
40,Segovia,73,Escalona del Prado,612,318,294
40,Segovia,74,Escarabajosa de Cabezas,363,203,160
40,Segovia,75,Escobar de Polendos,245,127,118
40,Segovia,76,Espinar (El),7251,3706,3545
40,Segovia,77,Espirdo,372,201,171
40,Segovia,78,Fresneda de Cuéllar,222,117,105
40,Segovia,79,Fresno de Cantespino,290,161,129
40,Segovia,80,Fresno de la Fuente,80,41,39
40,Segovia,81,Frumales,177,88,89
40,Segovia,82,Fuente de Santa Cruz,168,83,85
40,Segovia,83,Fuente el Olmo de Fuentidueña,124,63,61
40,Segovia,84,Fuente el Olmo de Íscar,95,52,43
40,Segovia,86,Fuentepelayo,975,501,474
40,Segovia,87,Fuentepiñel,150,75,75
40,Segovia,88,Fuenterrebollo,394,202,192
40,Segovia,89,Fuentesaúco de Fuentidueña,310,165,145
40,Segovia,91,Fuentesoto,163,88,75
40,Segovia,92,Fuentidueña,158,85,73
40,Segovia,93,Gallegos,102,51,51
40,Segovia,94,Garcillán,372,198,174
40,Segovia,95,Gomezserracín,726,377,349
40,Segovia,97,Grajera,103,56,47
40,Segovia,99,Honrubia de la Cuesta,91,48,43
40,Segovia,100,Hontalbilla,391,205,186
40,Segovia,101,Hontanares de Eresma,249,140,109
40,Segovia,103,Huertos (Los),152,76,76
40,Segovia,104,Ituero y Lama,105,61,44
40,Segovia,105,Juarros de Riomoros,73,44,29
40,Segovia,106,Juarros de Voltoya,272,135,137
40,Segovia,107,Labajos,146,83,63
40,Segovia,108,Laguna de Contreras,152,84,68
40,Segovia,109,Languilla,119,63,56
40,Segovia,110,Lastras de Cuéllar,487,258,229
40,Segovia,111,Lastras del Pozo,83,41,42
40,Segovia,112,Lastrilla (La),2249,1135,1114
40,Segovia,113,Losa (La),445,231,214
40,Segovia,115,Maderuelo,149,76,73
40,Segovia,903,Marazoleja,132,76,56
40,Segovia,118,Marazuela,61,32,29
40,Segovia,119,Martín Miguel,183,97,86
40,Segovia,120,Martín Muñoz de la Dehesa,188,101,87
40,Segovia,121,Martín Muñoz de las Posadas,439,210,229
40,Segovia,122,Marugán,475,267,208
40,Segovia,124,Mata de Cuéllar,301,160,141
40,Segovia,123,Matabuena,224,115,109
40,Segovia,125,Matilla (La),114,62,52
40,Segovia,126,Melque de Cercos,111,55,56
40,Segovia,127,Membibre de la Hoz,60,30,30
40,Segovia,128,Migueláñez,167,73,94
40,Segovia,129,Montejo de Arévalo,262,143,119
40,Segovia,130,Montejo de la Vega de la Serrezuela,188,102,86
40,Segovia,131,Monterrubio,80,44,36
40,Segovia,132,Moral de Hornuez,93,50,43
40,Segovia,134,Mozoncillo,1014,519,495
40,Segovia,135,Muñopedro,382,201,181
40,Segovia,136,Muñoveros,197,108,89
40,Segovia,138,Nava de la Asunción,2645,1332,1313
40,Segovia,139,Navafría,349,182,167
40,Segovia,140,Navalilla,134,70,64
40,Segovia,141,Navalmanzano,1157,603,554
40,Segovia,142,Navares de Ayuso,73,41,32
40,Segovia,143,Navares de Enmedio,136,77,59
40,Segovia,144,Navares de las Cuevas,31,20,11
40,Segovia,145,Navas de Oro,1438,735,703
40,Segovia,904,Navas de Riofrío,343,158,185
40,Segovia,146,Navas de San Antonio,327,167,160
40,Segovia,148,Nieva,346,187,159
40,Segovia,149,Olombrada,778,421,357
40,Segovia,150,Orejana,96,57,39
40,Segovia,151,Ortigosa de Pestaño,104,56,48
40,Segovia,901,Ortigosa del Monte,430,218,212
40,Segovia,152,Otero de Herreros,873,436,437
40,Segovia,154,Pajarejos,39,20,19
40,Segovia,155,Palazuelos de Eresma,2393,1244,1149
40,Segovia,156,Pedraza,488,265,223
40,Segovia,157,Pelayos del Arroyo,60,32,28
40,Segovia,158,Perosillo,26,17,9
40,Segovia,159,Pinarejos,173,101,72
40,Segovia,160,Pinarnegrillo,162,89,73
40,Segovia,161,Pradales,64,32,32
40,Segovia,162,Prádena,542,297,245
40,Segovia,163,Puebla de Pedraza,91,50,41
40,Segovia,164,Rapariegos,246,124,122
40,Segovia,165,Rebollo,126,69,57
40,Segovia,166,Remondo,332,161,171
40,Segovia,168,Riaguas de San Bartolomé,81,43,38
40,Segovia,170,Riaza,2020,1107,913
40,Segovia,171,Ribota,45,26,19
40,Segovia,172,Riofrío de Riaza,55,26,29
40,Segovia,173,Roda de Eresma,112,65,47
40,Segovia,174,Sacramenia,540,278,262
40,Segovia,176,Samboal,560,294,266
40,Segovia,177,San Cristóbal de Cuéllar,203,105,98
40,Segovia,178,San Cristóbal de la Vega,144,70,74
40,Segovia,906,San Cristóbal de Segovia,2324,1194,1130
40,Segovia,181,San Ildefonso,5315,2612,2703
40,Segovia,182,San Martín y Mudrián,266,134,132
40,Segovia,183,San Miguel de Bernuy,199,99,100
40,Segovia,184,San Pedro de Gaíllos,353,178,175
40,Segovia,179,Sanchonuño,824,406,418
40,Segovia,180,Sangarcía,450,231,219
40,Segovia,185,Santa María la Real de Nieva,1322,692,630
40,Segovia,186,Santa Marta del Cerro,53,28,25
40,Segovia,188,Santiuste de Pedraza,119,63,56
40,Segovia,189,Santiuste de San Juan Bautista,742,385,357
40,Segovia,190,Santo Domingo de Pirón,64,31,33
40,Segovia,191,Santo Tomé del Puerto,349,192,157
40,Segovia,192,Sauquillo de Cabezas,231,123,108
40,Segovia,193,Sebúlcor,283,153,130
40,Segovia,194,Segovia,55586,26674,28912
40,Segovia,195,Sepúlveda,1336,683,653
40,Segovia,196,Sequera de Fresno,43,25,18
40,Segovia,198,Sotillo,38,19,19
40,Segovia,199,Sotosalbos,119,68,51
40,Segovia,200,Tabanera la Luenga,72,37,35
40,Segovia,201,Tolocirio,58,28,30
40,Segovia,206,Torre Val de San Pedro,191,107,84
40,Segovia,202,Torreadrada,113,49,64
40,Segovia,203,Torrecaballeros,754,381,373
40,Segovia,204,Torrecilla del Pinar,284,143,141
40,Segovia,205,Torreiglesias,384,198,186
40,Segovia,207,Trescasas,328,176,152
40,Segovia,208,Turégano,1119,569,550
40,Segovia,210,Urueñas,118,62,56
40,Segovia,211,Valdeprados,63,30,33
40,Segovia,212,Valdevacas de Montejo,29,18,11
40,Segovia,213,Valdevacas y Guijar,139,73,66
40,Segovia,218,Valle de Tabladillo,151,80,71
40,Segovia,219,Vallelado,831,436,395
40,Segovia,220,Valleruela de Pedraza,67,34,33
40,Segovia,221,Valleruela de Sepúlveda,70,32,38
40,Segovia,214,Valseca,301,159,142
40,Segovia,215,Valtiendas,161,91,70
40,Segovia,216,Valverde del Majano,561,287,274
40,Segovia,222,Veganzones,300,155,145
40,Segovia,223,Vegas de Matute,252,145,107
40,Segovia,224,Ventosilla y Tejadilla,51,32,19
40,Segovia,225,Villacastín,1572,807,765
40,Segovia,228,Villaverde de Íscar,687,350,337
40,Segovia,229,Villaverde de Montejo,58,35,23
40,Segovia,230,Villeguillo,132,69,63
40,Segovia,231,Yanguas de Eresma,196,99,97
40,Segovia,233,Zarzuela del Monte,524,269,255
40,Segovia,234,Zarzuela del Pinar,563,297,266
41,Sevilla,1,Aguadulce,1982,1001,981
41,Sevilla,2,Alanís,1974,983,991
41,Sevilla,3,Albaida del Aljarafe,2157,1095,1062
41,Sevilla,4,Alcalá de Guadaíra,61063,30414,30649
41,Sevilla,5,Alcalá del Río,9211,4681,4530
41,Sevilla,6,Alcolea del Río,3336,1646,1690
41,Sevilla,7,Algaba (La),13463,6726,6737
41,Sevilla,8,Algámitas,1347,698,649
41,Sevilla,9,Almadén de la Plata,1705,861,844
41,Sevilla,10,Almensilla,4244,2157,2087
41,Sevilla,11,Arahal,18588,9214,9374
41,Sevilla,12,Aznalcázar,3613,1820,1793
41,Sevilla,13,Aznalcóllar,5841,3012,2829
41,Sevilla,14,Badolatosa,3178,1628,1550
41,Sevilla,15,Benacazón,5578,2854,2724
41,Sevilla,16,Bollullos de la Mitación,6062,3036,3026
41,Sevilla,17,Bormujos,13492,6737,6755
41,Sevilla,18,Brenes,11156,5584,5572
41,Sevilla,19,Burguillos,3945,1991,1954
41,Sevilla,20,Cabezas de San Juan (Las),15937,8158,7779
41,Sevilla,21,Camas,25393,12460,12933
41,Sevilla,22,Campana (La),5166,2589,2577
41,Sevilla,23,Cantillana,9289,4710,4579
41,Sevilla,901,Cañada Rosal,3059,1507,1552
41,Sevilla,24,Carmona,26558,13371,13187
41,Sevilla,25,Carrión de los Céspedes,2292,1101,1191
41,Sevilla,26,Casariche,5344,2697,2647
41,Sevilla,27,Castilblanco de los Arroyos,4682,2336,2346
41,Sevilla,28,Castilleja de Guzmán,2272,1162,1110
41,Sevilla,29,Castilleja de la Cuesta,16791,8274,8517
41,Sevilla,30,Castilleja del Campo,629,318,311
41,Sevilla,31,Castillo de las Guardas (El),1635,832,803
41,Sevilla,32,Cazalla de la Sierra,5204,2593,2611
41,Sevilla,33,Constantina,6818,3341,3477
41,Sevilla,34,Coria del Río,25029,12548,12481
41,Sevilla,35,Coripe,1424,729,695
41,Sevilla,36,Coronil (El),5044,2551,2493
41,Sevilla,37,Corrales (Los),4084,2075,2009
41,Sevilla,903,Cuervo de Sevilla (El),7918,4019,3899
41,Sevilla,38,Dos Hermanas,109595,54387,55208
41,Sevilla,39,Écija,38472,18948,19524
41,Sevilla,40,Espartinas,7226,3633,3593
41,Sevilla,41,Estepa,12101,5980,6121
41,Sevilla,42,Fuentes de Andalucía,7369,3668,3701
41,Sevilla,43,Garrobo (El),778,395,383
41,Sevilla,44,Gelves,7566,3793,3773
41,Sevilla,45,Gerena,5762,2880,2882
41,Sevilla,46,Gilena,3821,1916,1905
41,Sevilla,47,Gines,11756,5809,5947
41,Sevilla,48,Guadalcanal,2918,1460,1458
41,Sevilla,49,Guillena,8760,4444,4316
41,Sevilla,50,Herrera,6184,3068,3116
41,Sevilla,51,Huévar del Aljarafe,2412,1257,1155
41,Sevilla,902,Isla Mayor,5899,2962,2937
41,Sevilla,52,Lantejuela (La),3740,1917,1823
41,Sevilla,53,Lebrija,24677,12458,12219
41,Sevilla,54,Lora de Estepa,803,403,400
41,Sevilla,55,Lora del Río,18739,9297,9442
41,Sevilla,56,Luisiana (La),4413,2242,2171
41,Sevilla,57,Madroño (El),366,187,179
41,Sevilla,58,Mairena del Alcor,17623,8804,8819
41,Sevilla,59,Mairena del Aljarafe,37941,19124,18817
41,Sevilla,60,Marchena,18550,9222,9328
41,Sevilla,61,Marinaleda,2676,1357,1319
41,Sevilla,62,Martín de la Jara,2760,1437,1323
41,Sevilla,63,Molares (Los),2800,1430,1370
41,Sevilla,64,Montellano,6854,3454,3400
41,Sevilla,65,Morón de la Frontera,27942,13903,14039
41,Sevilla,66,Navas de la Concepción (Las),1848,916,932
41,Sevilla,67,Olivares,8573,4304,4269
41,Sevilla,68,Osuna,17345,8553,8792
41,Sevilla,69,Palacios y Villafranca (Los),34105,17256,16849
41,Sevilla,70,Palomares del Río,4444,2242,2202
41,Sevilla,71,Paradas,7078,3538,3540
41,Sevilla,72,Pedrera,5027,2481,2546
41,Sevilla,73,Pedroso (El),2300,1125,1175
41,Sevilla,74,Peñaflor,3698,1871,1827
41,Sevilla,75,Pilas,11730,5857,5873
41,Sevilla,76,Pruna,3057,1572,1485
41,Sevilla,77,Puebla de Cazalla (La),10664,5311,5353
41,Sevilla,78,Puebla de los Infantes (La),3291,1656,1635
41,Sevilla,79,Puebla del Río (La),11032,5486,5546
41,Sevilla,80,Real de la Jara (El),1599,760,839
41,Sevilla,81,Rinconada (La),31683,15975,15708
41,Sevilla,82,Roda de Andalucía (La),4260,2121,2139
41,Sevilla,83,Ronquillo (El),1370,697,673
41,Sevilla,84,Rubio (El),3586,1790,1796
41,Sevilla,85,Salteras,3708,1836,1872
41,Sevilla,86,San Juan de Aznalfarache,20001,9745,10256
41,Sevilla,88,San Nicolás del Puerto,691,344,347
41,Sevilla,87,Sanlúcar la Mayor,11516,5725,5791
41,Sevilla,89,Santiponce,7428,3735,3693
41,Sevilla,90,Saucejo (El),4298,2145,2153
41,Sevilla,91,Sevilla,704203,336304,367899
41,Sevilla,92,Tocina,9005,4459,4546
41,Sevilla,93,Tomares,19238,9603,9635
41,Sevilla,94,Umbrete,5372,2680,2692
41,Sevilla,95,Utrera,46774,23522,23252
41,Sevilla,96,Valencina de la Concepción,7269,3630,3639
41,Sevilla,97,Villamanrique de la Condesa,3762,1838,1924
41,Sevilla,100,Villanueva de San Juan,1447,713,734
41,Sevilla,98,Villanueva del Ariscal,5340,2602,2738
41,Sevilla,99,Villanueva del Río y Minas,5236,2542,2694
41,Sevilla,101,Villaverde del Río,6631,3362,3269
41,Sevilla,102,Viso del Alcor (El),16805,8493,8312
42,Soria,1,Abejar,399,208,191
42,Soria,3,Adradas,86,48,38
42,Soria,4,Ágreda,3215,1612,1603
42,Soria,6,Alconaba,175,102,73
42,Soria,7,Alcubilla de Avellaneda,195,97,98
42,Soria,8,Alcubilla de las Peñas,82,40,42
42,Soria,9,Aldealafuente,129,69,60
42,Soria,10,Aldealices,24,12,12
42,Soria,11,Aldealpozo,28,13,15
42,Soria,12,Aldealseñor,46,27,19
42,Soria,13,Aldehuela de Periáñez,53,29,24
42,Soria,14,Aldehuelas (Las),104,57,47
42,Soria,15,Alentisque,43,19,24
42,Soria,16,Aliud,31,17,14
42,Soria,17,Almajano,200,111,89
42,Soria,18,Almaluez,254,136,118
42,Soria,19,Almarza,609,343,266
42,Soria,20,Almazán,5755,2868,2887
42,Soria,21,Almazul,142,74,68
42,Soria,22,Almenar de Soria,342,181,161
42,Soria,23,Alpanseque,98,51,47
42,Soria,24,Arancón,109,60,49
42,Soria,25,Arcos de Jalón,1852,942,910
42,Soria,26,Arenillas,32,20,12
42,Soria,27,Arévalo de la Sierra,94,54,40
42,Soria,28,Ausejo de la Sierra,63,32,31
42,Soria,29,Baraona,211,112,99
42,Soria,30,Barca,118,71,47
42,Soria,31,Barcones,42,25,17
42,Soria,32,Bayubas de Abajo,250,134,116
42,Soria,33,Bayubas de Arriba,68,35,33
42,Soria,34,Beratón,40,26,14
42,Soria,35,Berlanga de Duero,1099,549,550
42,Soria,36,Blacos,59,33,26
42,Soria,37,Bliecos,43,26,17
42,Soria,38,Borjabad,56,32,24
42,Soria,39,Borobia,347,179,168
42,Soria,41,Buberos,44,23,21
42,Soria,42,Buitrago,55,26,29
42,Soria,43,Burgo de Osma-Ciudad de Osma,5032,2491,2541
42,Soria,44,Cabrejas del Campo,79,42,37
42,Soria,45,Cabrejas del Pinar,485,258,227
42,Soria,46,Calatañazor,61,36,25
42,Soria,48,Caltojar,111,61,50
42,Soria,49,Candilichera,204,104,100
42,Soria,50,Cañamaque,42,25,17
42,Soria,51,Carabantes,33,16,17
42,Soria,52,Caracena,19,14,5
42,Soria,53,Carrascosa de Abajo,33,19,14
42,Soria,54,Carrascosa de la Sierra,13,7,6
42,Soria,55,Casarejos,256,136,120
42,Soria,56,Castilfrío de la Sierra,27,16,11
42,Soria,58,Castillejo de Robledo,161,92,69
42,Soria,57,Castilruiz,285,143,142
42,Soria,59,Centenera de Andaluz,25,9,16
42,Soria,60,Cerbón,46,24,22
42,Soria,61,Cidones,357,200,157
42,Soria,62,Cigudosa,57,35,22
42,Soria,63,Cihuela,82,39,43
42,Soria,64,Ciria,103,49,54
42,Soria,65,Cirujales del Río,39,20,19
42,Soria,68,Coscurita,127,71,56
42,Soria,69,Covaleda,2024,1027,997
42,Soria,70,Cubilla,60,32,28
42,Soria,71,Cubo de la Solana,229,121,108
42,Soria,73,Cueva de Ágreda,95,52,43
42,Soria,75,Dévanos,115,61,54
42,Soria,76,Deza,346,172,174
42,Soria,78,Duruelo de la Sierra,1406,698,708
42,Soria,79,Escobosa de Almazán,38,22,16
42,Soria,80,Espeja de San Marcelino,238,132,106
42,Soria,81,Espejón,209,110,99
42,Soria,82,Estepa de San Juan,12,5,7
42,Soria,83,Frechilla de Almazán,37,19,18
42,Soria,84,Fresno de Caracena,41,23,18
42,Soria,85,Fuentearmegil,291,154,137
42,Soria,86,Fuentecambrón,58,33,25
42,Soria,87,Fuentecantos,55,28,27
42,Soria,88,Fuentelmonge,117,62,55
42,Soria,89,Fuentelsaz de Soria,53,19,34
42,Soria,90,Fuentepinilla,142,81,61
42,Soria,92,Fuentes de Magaña,84,43,41
42,Soria,93,Fuentestrún,78,46,32
42,Soria,94,Garray,498,276,222
42,Soria,95,Golmayo,1210,646,564
42,Soria,96,Gómara,426,228,198
42,Soria,97,Gormaz,19,7,12
42,Soria,98,Herrera de Soria,21,14,7
42,Soria,100,Hinojosa del Campo,41,27,14
42,Soria,103,Langa de Duero,867,481,386
42,Soria,105,Liceras,61,31,30
42,Soria,106,Losilla (La),17,11,6
42,Soria,107,Magaña,108,58,50
42,Soria,108,Maján,16,9,7
42,Soria,110,Matalebreras,118,62,56
42,Soria,111,Matamala de Almazán,378,198,180
42,Soria,113,Medinaceli,697,348,349
42,Soria,115,Miño de Medinaceli,99,49,50
42,Soria,116,Miño de San Esteban,80,44,36
42,Soria,117,Molinos de Duero,185,102,83
42,Soria,118,Momblona,37,21,16
42,Soria,119,Monteagudo de las Vicarías,268,137,131
42,Soria,120,Montejo de Tiermes,246,139,107
42,Soria,121,Montenegro de Cameros,99,59,40
42,Soria,123,Morón de Almazán,247,114,133
42,Soria,124,Muriel de la Fuente,91,51,40
42,Soria,125,Muriel Viejo,69,32,37
42,Soria,127,Nafría de Ucero,80,43,37
42,Soria,128,Narros,50,25,25
42,Soria,129,Navaleno,996,502,494
42,Soria,130,Nepas,81,48,33
42,Soria,131,Nolay,88,47,41
42,Soria,132,Noviercas,218,112,106
42,Soria,134,Ólvega,3311,1694,1617
42,Soria,135,Oncala,105,60,45
42,Soria,139,Pinilla del Campo,21,12,9
42,Soria,140,Portillo de Soria,18,11,7
42,Soria,141,Póveda de Soria (La),126,66,60
42,Soria,142,Pozalmuro,102,51,51
42,Soria,144,Quintana Redonda,564,299,265
42,Soria,145,Quintanas de Gormaz,192,105,87
42,Soria,148,Quiñonería,14,5,9
42,Soria,149,Rábanos (Los),462,280,182
42,Soria,151,Rebollar,53,28,25
42,Soria,152,Recuerda,113,62,51
42,Soria,153,Rello,33,17,16
42,Soria,154,Renieblas,121,65,56
42,Soria,155,Retortillo de Soria,238,126,112
42,Soria,156,Reznos,43,28,15
42,Soria,157,Riba de Escalote (La),25,14,11
42,Soria,158,Rioseco de Soria,140,73,67
42,Soria,159,Rollamienta,49,29,20
42,Soria,160,Royo (El),316,167,149
42,Soria,161,Salduero,193,102,91
42,Soria,162,San Esteban de Gormaz,3299,1703,1596
42,Soria,163,San Felices,81,40,41
42,Soria,164,San Leonardo de Yagüe,2277,1166,1111
42,Soria,165,San Pedro Manrique,537,288,249
42,Soria,166,Santa Cruz de Yanguas,64,38,26
42,Soria,167,Santa María de Huerta,419,231,188
42,Soria,168,Santa María de las Hoyas,191,101,90
42,Soria,171,Serón de Nágima,254,130,124
42,Soria,172,Soliedra,37,20,17
42,Soria,173,Soria,35769,17101,18668
42,Soria,174,Sotillo del Rincón,231,114,117
42,Soria,175,Suellacabras,32,20,12
42,Soria,176,Tajahuerce,37,17,20
42,Soria,177,Tajueco,109,58,51
42,Soria,178,Talveila,186,100,86
42,Soria,181,Tardelcuende,606,297,309
42,Soria,182,Taroda,76,39,37
42,Soria,183,Tejado,185,92,93
42,Soria,184,Torlengua,97,51,46
42,Soria,185,Torreblacos,33,18,15
42,Soria,187,Torrubia de Soria,81,47,34
42,Soria,188,Trévago,90,37,53
42,Soria,189,Ucero,98,51,47
42,Soria,190,Vadillo,137,69,68
42,Soria,191,Valdeavellano de Tera,230,117,113
42,Soria,192,Valdegeña,54,35,19
42,Soria,193,Valdelagua del Cerro,17,9,8
42,Soria,194,Valdemaluque,251,125,126
42,Soria,195,Valdenebro,146,74,72
42,Soria,196,Valdeprado,21,10,11
42,Soria,197,Valderrodilla,111,59,52
42,Soria,198,Valtajeros,27,16,11
42,Soria,200,Velamazán,126,73,53
42,Soria,201,Velilla de la Sierra,29,16,13
42,Soria,202,Velilla de los Ajos,41,24,17
42,Soria,204,Viana de Duero,73,44,29
42,Soria,205,Villaciervos,117,67,50
42,Soria,206,Villanueva de Gormaz,23,14,9
42,Soria,207,Villar del Ala,57,27,30
42,Soria,208,Villar del Campo,35,20,15
42,Soria,209,Villar del Río,172,100,72
42,Soria,211,Villares de Soria (Los),117,60,57
42,Soria,212,Villasayas,96,60,36
42,Soria,213,Villaseca de Arciel,40,23,17
42,Soria,215,Vinuesa,1031,548,483
42,Soria,216,Vizmanos,37,24,13
42,Soria,217,Vozmediano,45,26,19
42,Soria,218,Yanguas,128,63,65
42,Soria,219,Yelo,55,31,24
43,Tarragona,1,Aiguamúrcia,690,373,317
43,Tarragona,2,Albinyana,1926,986,940
43,Tarragona,3,Albiol (L'),288,148,140
43,Tarragona,4,Alcanar,8868,4518,4350
43,Tarragona,5,Alcover,4315,2206,2109
43,Tarragona,904,Aldea (L'),3473,1775,1698
43,Tarragona,6,Aldover,822,396,426
43,Tarragona,7,Aleixar (L'),755,380,375
43,Tarragona,8,Alfara de Carles,385,201,184
43,Tarragona,9,Alforja,1446,751,695
43,Tarragona,10,Alió,391,195,196
43,Tarragona,11,Almoster,1050,541,509
43,Tarragona,12,Altafulla,3828,1949,1879
43,Tarragona,13,Ametlla de Mar (L'),6032,3148,2884
43,Tarragona,906,Ampolla (L'),2294,1144,1150
43,Tarragona,14,Amposta,18238,9152,9086
43,Tarragona,16,Arboç (L'),4164,2211,1953
43,Tarragona,15,Arbolí,116,63,53
43,Tarragona,17,Argentera (L'),159,91,68
43,Tarragona,18,Arnes,511,261,250
43,Tarragona,19,Ascó,1629,827,802
43,Tarragona,20,Banyeres del Penedès,2003,1067,936
43,Tarragona,21,Barberà de la Conca,446,234,212
43,Tarragona,22,Batea,2073,1051,1022
43,Tarragona,23,Bellmunt del Priorat,308,151,157
43,Tarragona,24,Bellvei,1541,822,719
43,Tarragona,25,Benifallet,821,406,415
43,Tarragona,26,Benissanet,1130,594,536
43,Tarragona,27,Bisbal de Falset (La),244,125,119
43,Tarragona,28,Bisbal del Penedès (La),2483,1310,1173
43,Tarragona,29,Blancafort,409,216,193
43,Tarragona,30,Bonastre,440,236,204
43,Tarragona,31,Borges del Camp (Les),1769,890,879
43,Tarragona,32,Bot,780,399,381
43,Tarragona,33,Botarell,881,461,420
43,Tarragona,34,Bràfim,610,310,300
43,Tarragona,35,Cabacés,339,179,160
43,Tarragona,36,Cabra del Camp,768,405,363
43,Tarragona,37,Calafell,17277,8757,8520
43,Tarragona,903,Camarles,3101,1585,1516
43,Tarragona,38,Cambrils,24604,12327,12277
43,Tarragona,39,Capafonts,109,58,51
43,Tarragona,40,Capçanes,402,189,213
43,Tarragona,41,Caseres,319,153,166
43,Tarragona,42,Castellvell del Camp,1981,959,1022
43,Tarragona,43,Catllar (El),3070,1587,1483
43,Tarragona,45,Colldejou,194,109,85
43,Tarragona,46,Conesa,128,70,58
43,Tarragona,47,Constantí,5462,2892,2570
43,Tarragona,48,Corbera d'Ebre,1069,563,506
43,Tarragona,49,Cornudella de Montsant,912,465,447
43,Tarragona,50,Creixell,2411,1262,1149
43,Tarragona,51,Cunit,8086,4186,3900
43,Tarragona,901,Deltebre,10757,5447,5310
43,Tarragona,53,Duesaigües,191,114,77
43,Tarragona,54,Espluga de Francolí (L'),3687,1848,1839
43,Tarragona,55,Falset,2627,1320,1307
43,Tarragona,56,Fatarella (La),1173,592,581
43,Tarragona,57,Febró (La),58,37,21
43,Tarragona,58,Figuera (La),220,110,110
43,Tarragona,59,Figuerola del Camp,301,144,157
43,Tarragona,60,Flix,4001,2015,1986
43,Tarragona,61,Forès,59,32,27
43,Tarragona,62,Freginals,394,207,187
43,Tarragona,63,Galera (La),774,394,380
43,Tarragona,64,Gandesa,2882,1484,1398
43,Tarragona,65,Garcia,501,261,240
43,Tarragona,66,Garidells (Els),187,100,87
43,Tarragona,67,Ginestar,929,489,440
43,Tarragona,68,Godall,732,379,353
43,Tarragona,69,Gratallops,222,122,100
43,Tarragona,70,Guiamets (Els),315,166,149
43,Tarragona,71,Horta de Sant Joan,1219,650,569
43,Tarragona,72,Lloar (El),122,64,58
43,Tarragona,73,Llorac,124,58,66
43,Tarragona,74,Llorenç del Penedès,1904,919,985
43,Tarragona,76,Marçà,587,296,291
43,Tarragona,75,Margalef,127,67,60
43,Tarragona,77,Mas de Barberans,682,346,336
43,Tarragona,78,Masdenverge,1007,528,479
43,Tarragona,79,Masllorenç,467,237,230
43,Tarragona,80,Masó (La),287,143,144
43,Tarragona,81,Maspujols,513,261,252
43,Tarragona,82,Masroig (El),522,257,265
43,Tarragona,83,Milà (El),178,81,97
43,Tarragona,84,Miravet,790,418,372
43,Tarragona,85,Molar (El),284,152,132
43,Tarragona,86,Montblanc,6479,3232,3247
43,Tarragona,88,Montbrió del Camp,1574,788,786
43,Tarragona,89,Montferri,202,112,90
43,Tarragona,90,Montmell (El),904,495,409
43,Tarragona,91,Mont-ral,177,97,80
43,Tarragona,92,Mont-roig del Camp,8209,4228,3981
43,Tarragona,93,Móra d'Ebre,4960,2464,2496
43,Tarragona,94,Móra la Nova,3113,1594,1519
43,Tarragona,95,Morell (El),2530,1301,1229
43,Tarragona,96,Morera de Montsant (La),178,104,74
43,Tarragona,97,Nou de Gaià (La),409,213,196
43,Tarragona,98,Nulles,364,179,185
43,Tarragona,100,Pallaresos (Els),3000,1540,1460
43,Tarragona,99,Palma d'Ebre (La),403,192,211
43,Tarragona,101,Passanant,209,115,94
43,Tarragona,102,Paüls,615,307,308
43,Tarragona,103,Perafort,741,384,357
43,Tarragona,104,Perelló (El),2282,1222,1060
43,Tarragona,105,Piles (Les),188,106,82
43,Tarragona,106,Pinell de Brai (El),1083,557,526
43,Tarragona,107,Pira,451,218,233
43,Tarragona,108,Pla de Santa Maria (El),1820,945,875
43,Tarragona,109,Pobla de Mafumet (La),1340,671,669
43,Tarragona,110,Pobla de Massaluca (La),433,229,204
43,Tarragona,111,Pobla de Montornès (La),1882,1008,874
43,Tarragona,112,Poboleda,334,176,158
43,Tarragona,113,Pont d'Armentera (El),571,297,274
43,Tarragona,141,Pontils,138,71,67
43,Tarragona,114,Porrera,488,264,224
43,Tarragona,115,Pradell de la Teixeta,199,100,99
43,Tarragona,116,Prades,591,312,279
43,Tarragona,117,Prat de Comte,189,93,96
43,Tarragona,118,Pratdip,655,345,310
43,Tarragona,119,Puigpelat,734,381,353
43,Tarragona,120,Querol,322,179,143
43,Tarragona,121,Rasquera,842,428,414
43,Tarragona,122,Renau,91,45,46
43,Tarragona,123,Reus,96642,47777,48865
43,Tarragona,124,Riba (La),676,363,313
43,Tarragona,125,Riba-roja d'Ebre,1350,698,652
43,Tarragona,126,Riera de Gaià (La),1203,619,584
43,Tarragona,127,Riudecanyes,764,390,374
43,Tarragona,128,Riudecols,1064,555,509
43,Tarragona,129,Riudoms,5573,2841,2732
43,Tarragona,130,Rocafort de Queralt,262,138,124
43,Tarragona,131,Roda de Barà,4281,2267,2014
43,Tarragona,132,Rodonyà,455,235,220
43,Tarragona,133,Roquetes,7017,3621,3396
43,Tarragona,134,Rourell (El),309,154,155
43,Tarragona,135,Salomó,351,179,172
43,Tarragona,905,Salou,18238,9528,8710
43,Tarragona,136,Sant Carles de la Ràpita,12594,6305,6289
43,Tarragona,137,Sant Jaume dels Domenys,1725,904,821
43,Tarragona,902,Sant Jaume d'Enveja,3292,1673,1619
43,Tarragona,138,Santa Bàrbara,3617,1854,1763
43,Tarragona,139,Santa Coloma de Queralt,2934,1474,1460
43,Tarragona,140,Santa Oliva,2598,1344,1254
43,Tarragona,142,Sarral,1492,783,709
43,Tarragona,143,Savallà del Comtat,72,35,37
43,Tarragona,144,Secuita (La),1165,597,568
43,Tarragona,145,Selva del Camp (La),4628,2340,2288
43,Tarragona,146,Senan,33,23,10
43,Tarragona,44,Sénia (La),5735,2999,2736
43,Tarragona,147,Solivella,588,288,300
43,Tarragona,148,Tarragona,123584,60558,63026
43,Tarragona,149,Tivenys,886,442,444
43,Tarragona,150,Tivissa,1794,906,888
43,Tarragona,151,Torre de Fontaubella (La),130,62,68
43,Tarragona,152,Torre de l'Espanyol (La),731,388,343
43,Tarragona,153,Torredembarra,12478,6266,6212
43,Tarragona,154,Torroja del Priorat,149,89,60
43,Tarragona,155,Tortosa,31979,16016,15963
43,Tarragona,156,Ulldecona,6056,3123,2933
43,Tarragona,157,Ulldemolins,484,254,230
43,Tarragona,158,Vallclara,114,65,49
43,Tarragona,159,Vallfogona de Riucorb,164,82,82
43,Tarragona,160,Vallmoll,1378,722,656
43,Tarragona,161,Valls,22237,11083,11154
43,Tarragona,162,Vandellòs i l'Hospitalet de l'Infant,4839,2457,2382
43,Tarragona,163,Vendrell (El),28147,14141,14006
43,Tarragona,164,Vespella de Gaià,241,140,101
43,Tarragona,165,Vilabella,782,395,387
43,Tarragona,175,Vilalba dels Arcs,733,381,352
43,Tarragona,166,Vilallonga del Camp,1359,675,684
43,Tarragona,168,Vilanova de Prades,157,83,74
43,Tarragona,167,Vilanova d'Escornalbou,469,240,229
43,Tarragona,169,Vilaplana,550,281,269
43,Tarragona,170,Vila-rodona,1070,585,485
43,Tarragona,171,Vila-seca,14998,7551,7447
43,Tarragona,172,Vilaverd,416,211,205
43,Tarragona,173,Vilella Alta (La),137,72,65
43,Tarragona,174,Vilella Baixa (La),191,103,88
43,Tarragona,176,Vimbodí,1039,568,471
43,Tarragona,177,Vinebre,459,235,224
43,Tarragona,178,Vinyols i els Arcs,1418,753,665
43,Tarragona,52,Xerta,1244,632,612
44,Teruel,1,Ababuj,89,53,36
44,Teruel,2,Abejuela,68,38,30
44,Teruel,3,Aguatón,24,10,14
44,Teruel,4,Aguaviva,670,336,334
44,Teruel,5,Aguilar del Alfambra,79,43,36
44,Teruel,6,Alacón,428,213,215
44,Teruel,7,Alba,250,126,124
44,Teruel,8,Albalate del Arzobispo,2180,1102,1078
44,Teruel,9,Albarracín,1025,527,498
44,Teruel,10,Albentosa,295,158,137
44,Teruel,11,Alcaine,65,39,26
44,Teruel,12,Alcalá de la Selva,523,287,236
44,Teruel,13,Alcañiz,14704,7402,7302
44,Teruel,14,Alcorisa,3495,1785,1710
44,Teruel,16,Alfambra,640,327,313
44,Teruel,17,Aliaga,389,218,171
44,Teruel,21,Allepuz,145,71,74
44,Teruel,22,Alloza,691,340,351
44,Teruel,23,Allueva,13,11,2
44,Teruel,18,Almohaja,28,17,11
44,Teruel,19,Alobras,85,51,34
44,Teruel,20,Alpeñés,27,18,9
44,Teruel,24,Anadón,19,12,7
44,Teruel,25,Andorra,7883,4083,3800
44,Teruel,26,Arcos de las Salinas,131,64,67
44,Teruel,27,Arens de Lledó,226,104,122
44,Teruel,28,Argente,258,132,126
44,Teruel,29,Ariño,898,466,432
44,Teruel,31,Azaila,169,97,72
44,Teruel,32,Bádenas,19,12,7
44,Teruel,33,Báguena,416,215,201
44,Teruel,34,Bañón,174,98,76
44,Teruel,35,Barrachina,164,85,79
44,Teruel,36,Bea,38,21,17
44,Teruel,37,Beceite,603,313,290
44,Teruel,39,Bello,351,168,183
44,Teruel,38,Belmonte de San José,147,75,72
44,Teruel,40,Berge,246,123,123
44,Teruel,41,Bezas,76,44,32
44,Teruel,42,Blancas,171,96,75
44,Teruel,43,Blesa,142,88,54
44,Teruel,44,Bordón,139,80,59
44,Teruel,45,Bronchales,463,249,214
44,Teruel,46,Bueña,79,44,35
44,Teruel,47,Burbáguena,318,151,167
44,Teruel,48,Cabra de Mora,119,70,49
44,Teruel,49,Calaceite,1145,594,551
44,Teruel,50,Calamocha,4256,2141,2115
44,Teruel,51,Calanda,3598,1836,1762
44,Teruel,52,Calomarde,73,42,31
44,Teruel,53,Camañas,150,91,59
44,Teruel,54,Camarena de la Sierra,166,90,76
44,Teruel,55,Camarillas,102,58,44
44,Teruel,56,Caminreal,760,393,367
44,Teruel,59,Cantavieja,740,407,333
44,Teruel,60,Cañada de Benatanduz,64,39,25
44,Teruel,61,Cañada de Verich (La),103,55,48
44,Teruel,62,Cañada Vellida,51,36,15
44,Teruel,63,Cañizar del Olivar,113,59,54
44,Teruel,64,Cascante del Río,103,60,43
44,Teruel,65,Castejón de Tornos,91,56,35
44,Teruel,66,Castel de Cabra,149,78,71
44,Teruel,70,Castellar (El),81,47,34
44,Teruel,71,Castellote,794,414,380
44,Teruel,67,Castelnou,109,61,48
44,Teruel,68,Castelserás,818,434,384
44,Teruel,74,Cedrillas,517,265,252
44,Teruel,75,Celadas,419,230,189
44,Teruel,76,Cella,2816,1482,1334
44,Teruel,77,Cerollera (La),122,69,53
44,Teruel,80,Codoñera (La),340,184,156
44,Teruel,82,Corbalán,88,50,38
44,Teruel,84,Cortes de Aragón,111,59,52
44,Teruel,85,Cosa,97,51,46
44,Teruel,86,Cretas,588,297,291
44,Teruel,87,Crivillén,113,61,52
44,Teruel,88,Cuba (La),52,25,27
44,Teruel,89,Cubla,47,27,20
44,Teruel,90,Cucalón,87,51,36
44,Teruel,92,Cuervo (El),110,58,52
44,Teruel,93,Cuevas de Almudén,115,65,50
44,Teruel,94,Cuevas Labradas,162,83,79
44,Teruel,96,Ejulve,226,113,113
44,Teruel,97,Escorihuela,200,101,99
44,Teruel,99,Escucha,1099,611,488
44,Teruel,100,Estercuel,314,166,148
44,Teruel,101,Ferreruela de Huerva,76,43,33
44,Teruel,102,Fonfría,29,17,12
44,Teruel,103,Formiche Alto,191,98,93
44,Teruel,105,Fórnoles,103,47,56
44,Teruel,106,Fortanete,202,111,91
44,Teruel,107,Foz-Calanda,277,155,122
44,Teruel,108,Fresneda (La),451,251,200
44,Teruel,109,Frías de Albarracín,164,88,76
44,Teruel,110,Fuenferrada,46,24,22
44,Teruel,111,Fuentes Calientes,130,71,59
44,Teruel,112,Fuentes Claras,571,288,283
44,Teruel,113,Fuentes de Rubielos,119,66,53
44,Teruel,114,Fuentespalda,368,181,187
44,Teruel,115,Galve,141,78,63
44,Teruel,116,Gargallo,112,56,56
44,Teruel,117,Gea de Albarracín,434,225,209
44,Teruel,118,Ginebrosa (La),240,137,103
44,Teruel,119,Griegos,137,86,51
44,Teruel,120,Guadalaviar,273,140,133
44,Teruel,121,Gúdar,80,46,34
44,Teruel,122,Híjar,1907,966,941
44,Teruel,123,Hinojosa de Jarque,158,83,75
44,Teruel,124,Hoz de la Vieja (La),108,56,52
44,Teruel,125,Huesa del Común,116,72,44
44,Teruel,126,Iglesuela del Cid (La),501,270,231
44,Teruel,127,Jabaloyas,79,40,39
44,Teruel,128,Jarque de la Val,96,52,44
44,Teruel,129,Jatiel,63,31,32
44,Teruel,130,Jorcas,39,24,15
44,Teruel,131,Josa,30,18,12
44,Teruel,132,Lagueruela,56,26,30
44,Teruel,133,Lanzuela,31,22,9
44,Teruel,135,Libros,150,77,73
44,Teruel,136,Lidón,75,34,41
44,Teruel,137,Linares de Mora,329,193,136
44,Teruel,141,Lledó,191,104,87
44,Teruel,138,Loscos,184,108,76
44,Teruel,142,Maicas,39,19,20
44,Teruel,143,Manzanera,471,257,214
44,Teruel,144,Martín del Río,474,237,237
44,Teruel,145,Mas de las Matas,1446,742,704
44,Teruel,146,Mata de los Olmos (La),267,133,134
44,Teruel,147,Mazaleón,587,303,284
44,Teruel,148,Mezquita de Jarque,123,65,58
44,Teruel,149,Mirambel,137,74,63
44,Teruel,150,Miravete de la Sierra,41,25,16
44,Teruel,151,Molinos,313,172,141
44,Teruel,152,Monforte de Moyuela,75,47,28
44,Teruel,153,Monreal del Campo,2391,1187,1204
44,Teruel,154,Monroyo,324,175,149
44,Teruel,155,Montalbán,1498,766,732
44,Teruel,156,Monteagudo del Castillo,68,40,28
44,Teruel,157,Monterde de Albarracín,58,28,30
44,Teruel,158,Mora de Rubielos,1433,738,695
44,Teruel,159,Moscardón,51,29,22
44,Teruel,160,Mosqueruela,726,402,324
44,Teruel,161,Muniesa,712,369,343
44,Teruel,163,Noguera de Albarracín,161,83,78
44,Teruel,164,Nogueras,18,14,4
44,Teruel,165,Nogueruelas,227,124,103
44,Teruel,167,Obón,75,42,33
44,Teruel,168,Odón,259,127,132
44,Teruel,169,Ojos Negros,531,273,258
44,Teruel,171,Olba,230,117,113
44,Teruel,172,Oliete,474,245,229
44,Teruel,173,Olmos (Los),141,73,68
44,Teruel,174,Orihuela del Tremedal,605,303,302
44,Teruel,175,Orrios,180,91,89
44,Teruel,176,Palomar de Arroyos,227,128,99
44,Teruel,177,Pancrudo,134,73,61
44,Teruel,178,Parras de Castellote (Las),86,45,41
44,Teruel,179,Peñarroya de Tastavins,527,273,254
44,Teruel,180,Peracense,107,61,46
44,Teruel,181,Peralejos,85,45,40
44,Teruel,182,Perales del Alfambra,294,156,138
44,Teruel,183,Pitarque,112,50,62
44,Teruel,184,Plou,49,25,24
44,Teruel,185,Pobo (El),137,77,60
44,Teruel,187,Portellada (La),277,147,130
44,Teruel,189,Pozondón,97,48,49
44,Teruel,190,Pozuel del Campo,110,59,51
44,Teruel,191,Puebla de Híjar (La),1013,498,515
44,Teruel,192,Puebla de Valverde (La),508,280,228
44,Teruel,193,Puertomingalvo,182,105,77
44,Teruel,194,Ráfales,181,92,89
44,Teruel,195,Rillo,125,70,55
44,Teruel,196,Riodeva,191,91,100
44,Teruel,197,Ródenas,88,47,41
44,Teruel,198,Royuela,225,124,101
44,Teruel,199,Rubiales,60,31,29
44,Teruel,200,Rubielos de la Cérida,55,27,28
44,Teruel,201,Rubielos de Mora,652,332,320
44,Teruel,203,Salcedillo,8,4,4
44,Teruel,204,Saldón,33,18,15
44,Teruel,205,Samper de Calanda,984,481,503
44,Teruel,206,San Agustín,124,69,55
44,Teruel,207,San Martín del Río,255,124,131
44,Teruel,208,Santa Cruz de Nogueras,32,20,12
44,Teruel,209,Santa Eulalia,1154,566,588
44,Teruel,210,Sarrión,1049,548,501
44,Teruel,211,Segura de los Baños,39,21,18
44,Teruel,212,Seno,48,25,23
44,Teruel,213,Singra,94,47,47
44,Teruel,215,Terriente,183,107,76
44,Teruel,216,Teruel,32580,15741,16839
44,Teruel,217,Toril y Masegoso,31,20,11
44,Teruel,218,Tormón,39,22,17
44,Teruel,219,Tornos,239,125,114
44,Teruel,220,Torralba de los Sisones,221,122,99
44,Teruel,223,Torre de Arcas,99,49,50
44,Teruel,224,Torre de las Arcas,35,20,15
44,Teruel,225,Torre del Compte,169,84,85
44,Teruel,227,Torre los Negros,94,47,47
44,Teruel,221,Torrecilla de Alcañiz,462,251,211
44,Teruel,222,Torrecilla del Rebollar,178,88,90
44,Teruel,226,Torrelacárcel,248,130,118
44,Teruel,228,Torremocha de Jiloca,158,82,76
44,Teruel,229,Torres de Albarracín,147,81,66
44,Teruel,230,Torrevelilla,199,97,102
44,Teruel,231,Torrijas,87,40,47
44,Teruel,232,Torrijo del Campo,552,279,273
44,Teruel,234,Tramacastiel,114,65,49
44,Teruel,235,Tramacastilla,133,66,67
44,Teruel,236,Tronchón,107,58,49
44,Teruel,237,Urrea de Gaén,568,279,289
44,Teruel,238,Utrillas,3209,1662,1547
44,Teruel,239,Valacloche,23,16,7
44,Teruel,240,Valbona,212,115,97
44,Teruel,241,Valdealgorfa,728,358,370
44,Teruel,243,Valdecuenca,43,25,18
44,Teruel,244,Valdelinares,141,81,60
44,Teruel,245,Valdeltormo,354,189,165
44,Teruel,246,Valderrobres,2048,1101,947
44,Teruel,247,Valjunquera,420,216,204
44,Teruel,249,Vallecillo (El),60,35,25
44,Teruel,250,Veguillas de la Sierra,24,16,8
44,Teruel,251,Villafranca del Campo,368,190,178
44,Teruel,252,Villahermosa del Campo,97,52,45
44,Teruel,256,Villanueva del Rebollar de la Sierra,51,28,23
44,Teruel,257,Villar del Cobo,222,112,110
44,Teruel,258,Villar del Salz,104,60,44
44,Teruel,260,Villarluengo,212,122,90
44,Teruel,261,Villarquemado,938,488,450
44,Teruel,262,Villarroya de los Pinares,190,106,84
44,Teruel,263,Villastar,327,171,156
44,Teruel,264,Villel,354,202,152
44,Teruel,265,Vinaceite,281,141,140
44,Teruel,266,Visiedo,188,85,103
44,Teruel,267,Vivel del Río Martín,84,44,40
44,Teruel,268,Zoma (La),27,13,14
45,Toledo,1,Ajofrín,2171,1125,1046
45,Toledo,2,Alameda de la Sagra,3006,1588,1418
45,Toledo,3,Albarreal de Tajo,657,327,330
45,Toledo,4,Alcabón,671,339,332
45,Toledo,5,Alcañizo,314,168,146
45,Toledo,6,Alcaudete de la Jara,1959,970,989
45,Toledo,7,Alcolea de Tajo,815,405,410
45,Toledo,8,Aldea en Cabo,201,108,93
45,Toledo,9,Aldeanueva de Barbarroya,743,375,368
45,Toledo,10,Aldeanueva de San Bartolomé,527,259,268
45,Toledo,11,Almendral de la Cañada,383,200,183
45,Toledo,12,Almonacid de Toledo,824,431,393
45,Toledo,13,Almorox,2266,1191,1075
45,Toledo,14,Añover de Tajo,4987,2560,2427
45,Toledo,15,Arcicóllar,622,309,313
45,Toledo,16,Argés,3351,1682,1669
45,Toledo,17,Azután,329,163,166
45,Toledo,18,Barcience,99,52,47
45,Toledo,19,Bargas,7544,3784,3760
45,Toledo,20,Belvís de la Jara,1733,873,860
45,Toledo,21,Borox,2501,1268,1233
45,Toledo,22,Buenaventura,514,255,259
45,Toledo,23,Burguillos de Toledo,1498,769,729
45,Toledo,24,Burujón,1393,727,666
45,Toledo,25,Cabañas de la Sagra,1629,844,785
45,Toledo,26,Cabañas de Yepes,267,137,130
45,Toledo,27,Cabezamesada,489,254,235
45,Toledo,28,Calera y Chozas,3989,2023,1966
45,Toledo,29,Caleruela,296,144,152
45,Toledo,30,Calzada de Oropesa,586,294,292
45,Toledo,31,Camarena,2645,1361,1284
45,Toledo,32,Camarenilla,516,266,250
45,Toledo,33,Campillo de la Jara (El),465,243,222
45,Toledo,34,Camuñas,1788,905,883
45,Toledo,35,Cardiel de los Montes,203,114,89
45,Toledo,36,Carmena,847,439,408
45,Toledo,37,Carpio de Tajo (El),2181,1064,1117
45,Toledo,38,Carranque,2286,1159,1127
45,Toledo,39,Carriches,304,155,149
45,Toledo,40,Casar de Escalona (El),1217,618,599
45,Toledo,41,Casarrubios del Monte,3926,2059,1867
45,Toledo,42,Casasbuenas,218,108,110
45,Toledo,43,Castillo de Bayuela,1072,548,524
45,Toledo,45,Cazalegas,1341,688,653
45,Toledo,46,Cebolla,3182,1610,1572
45,Toledo,47,Cedillo del Condado,1950,989,961
45,Toledo,48,Cerralbos (Los),433,225,208
45,Toledo,49,Cervera de los Montes,355,185,170
45,Toledo,56,Chozas de Canales,1613,831,782
45,Toledo,57,Chueca,234,124,110
45,Toledo,50,Ciruelos,397,221,176
45,Toledo,51,Cobeja,1986,1001,985
45,Toledo,52,Cobisa,2670,1368,1302
45,Toledo,53,Consuegra,10352,5192,5160
45,Toledo,54,Corral de Almaguer,5693,2894,2799
45,Toledo,55,Cuerva,1348,680,668
45,Toledo,58,Domingo Pérez,488,245,243
45,Toledo,59,Dosbarrios,2169,1094,1075
45,Toledo,60,Erustes,206,99,107
45,Toledo,61,Escalona,2542,1296,1246
45,Toledo,62,Escalonilla,1443,724,719
45,Toledo,63,Espinoso del Rey,603,308,295
45,Toledo,64,Esquivias,4379,2217,2162
45,Toledo,65,Estrella (La),366,193,173
45,Toledo,66,Fuensalida,8516,4303,4213
45,Toledo,67,Gálvez,3287,1658,1629
45,Toledo,68,Garciotum,158,77,81
45,Toledo,69,Gerindote,2079,1070,1009
45,Toledo,70,Guadamur,1705,864,841
45,Toledo,71,Guardia (La),2314,1155,1159
45,Toledo,72,Herencias (Las),735,386,349
45,Toledo,73,Herreruela de Oropesa,474,239,235
45,Toledo,74,Hinojosa de San Vicente,492,266,226
45,Toledo,75,Hontanar,135,71,64
45,Toledo,76,Hormigos,467,254,213
45,Toledo,77,Huecas,519,273,246
45,Toledo,78,Huerta de Valdecarábanos,1724,849,875
45,Toledo,79,Iglesuela (La),427,221,206
45,Toledo,80,Illán de Vacas,8,5,3
45,Toledo,81,Illescas,13692,6955,6737
45,Toledo,82,Lagartera,1652,826,826
45,Toledo,83,Layos,347,168,179
45,Toledo,84,Lillo,2706,1372,1334
45,Toledo,85,Lominchar,1397,726,671
45,Toledo,86,Lucillos,481,243,238
45,Toledo,87,Madridejos,10860,5440,5420
45,Toledo,88,Magán,1500,777,723
45,Toledo,89,Malpica de Tajo,1959,997,962
45,Toledo,90,Manzaneque,513,256,257
45,Toledo,91,Maqueda,508,265,243
45,Toledo,92,Marjaliza,302,148,154
45,Toledo,93,Marrupe,160,88,72
45,Toledo,94,Mascaraque,464,230,234
45,Toledo,95,Mata (La),948,475,473
45,Toledo,96,Mazarambroz,1302,665,637
45,Toledo,97,Mejorada,1246,633,613
45,Toledo,98,Menasalbas,2987,1578,1409
45,Toledo,99,Méntrida,2854,1490,1364
45,Toledo,100,Mesegar de Tajo,220,109,111
45,Toledo,101,Miguel Esteban,5077,2566,2511
45,Toledo,102,Mocejón,4370,2242,2128
45,Toledo,103,Mohedas de la Jara,562,298,264
45,Toledo,104,Montearagón,479,249,230
45,Toledo,105,Montesclaros,423,220,203
45,Toledo,106,Mora,9814,4919,4895
45,Toledo,107,Nambroca,2876,1476,1400
45,Toledo,108,Nava de Ricomalillo (La),664,338,326
45,Toledo,109,Navahermosa,4152,2166,1986
45,Toledo,110,Navalcán,2182,1122,1060
45,Toledo,111,Navalmoralejo,68,34,34
45,Toledo,112,Navalmorales (Los),2720,1405,1315
45,Toledo,113,Navalucillos (Los),2718,1370,1348
45,Toledo,114,Navamorcuende,708,362,346
45,Toledo,115,Noblejas,3239,1678,1561
45,Toledo,116,Noez,800,400,400
45,Toledo,117,Nombela,958,493,465
45,Toledo,118,Novés,1718,882,836
45,Toledo,119,Numancia de la Sagra,3467,1851,1616
45,Toledo,120,Nuño Gómez,215,110,105
45,Toledo,121,Ocaña,6798,3436,3362
45,Toledo,122,Olías del Rey,5146,2650,2496
45,Toledo,123,Ontígola,1796,966,830
45,Toledo,124,Orgaz,2739,1381,1358
45,Toledo,125,Oropesa,2836,1374,1462
45,Toledo,126,Otero,214,99,115
45,Toledo,127,Palomeque,629,329,300
45,Toledo,128,Pantoja,2944,1493,1451
45,Toledo,129,Paredes de Escalona,112,48,64
45,Toledo,130,Parrillas,411,209,202
45,Toledo,131,Pelahustán,362,199,163
45,Toledo,132,Pepino,1460,778,682
45,Toledo,133,Polán,3523,1765,1758
45,Toledo,134,Portillo de Toledo,2152,1118,1034
45,Toledo,135,Puebla de Almoradiel (La),5594,2836,2758
45,Toledo,136,Puebla de Montalbán (La),7604,3856,3748
45,Toledo,137,Pueblanueva (La),2101,1071,1030
45,Toledo,138,Puente del Arzobispo (El),1465,704,761
45,Toledo,139,Puerto de San Vicente,285,147,138
45,Toledo,140,Pulgar,1362,716,646
45,Toledo,141,Quero,1246,627,619
45,Toledo,142,Quintanar de la Orden,10431,5245,5186
45,Toledo,143,Quismondo,1439,713,726
45,Toledo,144,Real de San Vicente (El),1044,538,506
45,Toledo,145,Recas,2922,1614,1308
45,Toledo,146,Retamoso,135,73,62
45,Toledo,147,Rielves,567,283,284
45,Toledo,148,Robledo del Mazo,457,235,222
45,Toledo,149,Romeral (El),844,419,425
45,Toledo,150,San Bartolomé de las Abiertas,457,238,219
45,Toledo,151,San Martín de Montalbán,733,350,383
45,Toledo,152,San Martín de Pusa,784,403,381
45,Toledo,153,San Pablo de los Montes,2077,1053,1024
45,Toledo,154,San Román de los Montes,1005,536,469
45,Toledo,155,Santa Ana de Pusa,401,210,191
45,Toledo,156,Santa Cruz de la Zarza,4681,2393,2288
45,Toledo,157,Santa Cruz del Retamar,2180,1123,1057
45,Toledo,158,Santa Olalla,2857,1466,1391
45,Toledo,901,Santo Domingo-Caudilla,790,397,393
45,Toledo,159,Sartajada,127,75,52
45,Toledo,160,Segurilla,1070,542,528
45,Toledo,161,Seseña,7621,3963,3658
45,Toledo,162,Sevilleja de la Jara,980,524,456
45,Toledo,163,Sonseca,10130,5154,4976
45,Toledo,164,Sotillo de las Palomas,217,106,111
45,Toledo,165,Talavera de la Reina,80305,39122,41183
45,Toledo,166,Tembleque,2190,1105,1085
45,Toledo,167,Toboso (El),2112,1055,1057
45,Toledo,168,Toledo,73485,35191,38294
45,Toledo,169,Torralba de Oropesa,262,126,136
45,Toledo,171,Torre de Esteban Hambrán (La),1627,858,769
45,Toledo,170,Torrecilla de la Jara,334,171,163
45,Toledo,172,Torrico,854,450,404
45,Toledo,173,Torrijos,10756,5297,5459
45,Toledo,174,Totanés,386,196,190
45,Toledo,175,Turleque,919,446,473
45,Toledo,176,Ugena,2630,1396,1234
45,Toledo,177,Urda,3107,1573,1534
45,Toledo,179,Valdeverdeja,730,332,398
45,Toledo,180,Valmojado,2763,1428,1335
45,Toledo,181,Velada,2432,1263,1169
45,Toledo,182,Ventas con Peña Aguilera (Las),1410,724,686
45,Toledo,183,Ventas de Retamosa (Las),1248,656,592
45,Toledo,184,Ventas de San Julián (Las),271,115,156
45,Toledo,186,Villa de Don Fadrique (La),4155,2084,2071
45,Toledo,185,Villacañas,10000,4973,5027
45,Toledo,187,Villafranca de los Caballeros,5210,2590,2620
45,Toledo,188,Villaluenga de la Sagra,2929,1457,1472
45,Toledo,189,Villamiel de Toledo,626,319,307
45,Toledo,190,Villaminaya,594,301,293
45,Toledo,191,Villamuelas,735,370,365
45,Toledo,192,Villanueva de Alcardete,3589,1875,1714
45,Toledo,193,Villanueva de Bogas,818,419,399
45,Toledo,194,Villarejo de Montalbán,78,42,36
45,Toledo,195,Villarrubia de Santiago,2851,1430,1421
45,Toledo,196,Villaseca de la Sagra,1592,790,802
45,Toledo,197,Villasequilla,2445,1267,1178
45,Toledo,198,Villatobas,2352,1199,1153
45,Toledo,199,Viso de San Juan (El),1756,952,804
45,Toledo,200,Yébenes (Los),6183,3143,3040
45,Toledo,201,Yeles,2571,1413,1158
45,Toledo,202,Yepes,4634,2359,2275
45,Toledo,203,Yuncler,2375,1210,1165
45,Toledo,204,Yunclillos,691,357,334
45,Toledo,205,Yuncos,5197,2726,2471
46,Valencia/València,1,Ademuz,1140,586,554
46,Valencia/València,2,Ador,1346,686,660
46,Valencia/València,4,Agullent,2352,1153,1199
46,Valencia/València,42,Aielo de Malferit,4320,2144,2176
46,Valencia/València,43,Aielo de Rugat,207,109,98
46,Valencia/València,5,Alaquàs,29279,14671,14608
46,Valencia/València,6,Albaida,6257,3108,3149
46,Valencia/València,7,Albal,13534,6795,6739
46,Valencia/València,8,Albalat de la Ribera,3444,1719,1725
46,Valencia/València,9,Albalat dels Sorells,3493,1707,1786
46,Valencia/València,10,Albalat dels Tarongers,799,418,381
46,Valencia/València,11,Alberic,9634,4787,4847
46,Valencia/València,12,Alborache,948,484,464
46,Valencia/València,13,Alboraya,20001,9973,10028
46,Valencia/València,14,Albuixech,3443,1706,1737
46,Valencia/València,16,Alcàntera de Xúquer,1380,680,700
46,Valencia/València,15,Alcàsser,7992,4050,3942
46,Valencia/València,18,Alcublas,794,403,391
46,Valencia/València,19,Alcúdia (l'),10654,5250,5404
46,Valencia/València,20,Alcúdia de Crespins (l'),4786,2431,2355
46,Valencia/València,21,Aldaia,26442,13241,13201
46,Valencia/València,22,Alfafar,19655,9805,9850
46,Valencia/València,24,Alfara de Algimia,487,230,257
46,Valencia/València,25,Alfara del Patriarca,2779,1389,1390
46,Valencia/València,26,Alfarp,1369,690,679
46,Valencia/València,27,Alfarrasí,1272,614,658
46,Valencia/València,23,Alfauir,381,192,189
46,Valencia/València,28,Algar de Palancia,461,236,225
46,Valencia/València,29,Algemesí,26192,12991,13201
46,Valencia/València,30,Algimia de Alfara,959,484,475
46,Valencia/València,31,Alginet,12587,6402,6185
46,Valencia/València,32,Almàssera,6556,3169,3387
46,Valencia/València,33,Almiserà,262,123,139
46,Valencia/València,34,Almoines,1668,824,844
46,Valencia/València,35,Almussafes,7459,3722,3737
46,Valencia/València,36,Alpuente,861,455,406
46,Valencia/València,37,Alqueria de la Comtessa (l'),1462,708,754
46,Valencia/València,17,Alzira,41920,20564,21356
46,Valencia/València,38,Andilla,384,226,158
46,Valencia/València,39,Anna,2775,1412,1363
46,Valencia/València,40,Antella,1498,746,752
46,Valencia/València,41,Aras de los Olmos,375,211,164
46,Valencia/València,3,Atzeneta d'Albaida,1344,701,643
46,Valencia/València,44,Ayora,5508,2799,2709
46,Valencia/València,46,Barx,1423,696,727
46,Valencia/València,45,Barxeta,1619,844,775
46,Valencia/València,47,Bèlgida,719,354,365
46,Valencia/València,48,Bellreguard,3893,1946,1947
46,Valencia/València,49,Bellús,383,190,193
46,Valencia/València,50,Benagéber,177,85,92
46,Valencia/València,51,Benaguasil,9618,4879,4739
46,Valencia/València,52,Benavites,649,319,330
46,Valencia/València,53,Beneixida,609,290,319
46,Valencia/València,54,Benetússer,14023,6953,7070
46,Valencia/València,55,Beniarjó,1432,707,725
46,Valencia/València,56,Beniatjar,240,118,122
46,Valencia/València,57,Benicolet,517,267,250
46,Valencia/València,904,Benicull de Xúquer,784,388,396
46,Valencia/València,60,Benifaió,12254,6080,6174
46,Valencia/València,59,Benifairó de la Valldigna,1692,846,846
46,Valencia/València,58,Benifairó de les Valls,1907,933,974
46,Valencia/València,61,Beniflá,238,123,115
46,Valencia/València,62,Benigánim,5720,2900,2820
46,Valencia/València,63,Benimodo,2019,1054,965
46,Valencia/València,64,Benimuslem,583,297,286
46,Valencia/València,65,Beniparrell,1780,924,856
46,Valencia/València,66,Benirredrà,1460,691,769
46,Valencia/València,67,Benisanó,1974,1012,962
46,Valencia/València,68,Benissoda,320,174,146
46,Valencia/València,69,Benisuera,194,95,99
46,Valencia/València,70,Bétera,17188,8588,8600
46,Valencia/València,71,Bicorp,645,320,325
46,Valencia/València,72,Bocairent,4496,2224,2272
46,Valencia/València,73,Bolbaite,1458,749,709
46,Valencia/València,74,Bonrepòs i Mirambell,2526,1253,1273
46,Valencia/València,75,Bufali,199,102,97
46,Valencia/València,76,Bugarra,860,433,427
46,Valencia/València,77,Buñol,9273,4628,4645
46,Valencia/València,78,Burjassot,37330,18266,19064
46,Valencia/València,79,Calles,384,215,169
46,Valencia/València,80,Camporrobles,1372,689,683
46,Valencia/València,81,Canals,13671,6852,6819
46,Valencia/València,82,Canet d'En Berenguer,3669,1856,1813
46,Valencia/València,83,Carcaixent,21119,10459,10660
46,Valencia/València,84,Càrcer,2026,970,1056
46,Valencia/València,85,Carlet,14622,7324,7298
46,Valencia/València,86,Carrícola,79,38,41
46,Valencia/València,87,Casas Altas,158,82,76
46,Valencia/València,88,Casas Bajas,243,136,107
46,Valencia/València,89,Casinos,2382,1222,1160
46,Valencia/València,90,Castelló de Rugat,2301,1189,1112
46,Valencia/València,91,Castellonet de la Conquesta,172,98,74
46,Valencia/València,92,Castielfabib,284,153,131
46,Valencia/València,93,Catadau,2487,1273,1214
46,Valencia/València,94,Catarroja,22904,11386,11518
46,Valencia/València,95,Caudete de las Fuentes,795,403,392
46,Valencia/València,96,Cerdà,291,153,138
46,Valencia/València,107,Chella,2618,1307,1311
46,Valencia/València,106,Chelva,1986,1021,965
46,Valencia/València,108,Chera,525,266,259
46,Valencia/València,109,Cheste,7255,3732,3523
46,Valencia/València,111,Chiva,11386,5778,5608
46,Valencia/València,112,Chulilla,772,391,381
46,Valencia/València,97,Cofrentes,948,470,478
46,Valencia/València,98,Corbera,3057,1493,1564
46,Valencia/València,99,Cortes de Pallás,999,513,486
46,Valencia/València,100,Cotes,363,168,195
46,Valencia/València,105,Cullera,22544,11368,11176
46,Valencia/València,113,Daimús,2242,1145,1097
46,Valencia/València,114,Domeño,568,303,265
46,Valencia/València,115,Dos Aguas,441,244,197
46,Valencia/València,116,Eliana (l'),15026,7492,7534
46,Valencia/València,117,Emperador,260,135,125
46,Valencia/València,118,Enguera,5484,2883,2601
46,Valencia/València,119,Ènova (l'),997,502,495
46,Valencia/València,120,Estivella,1164,561,603
46,Valencia/València,121,Estubeny,183,95,88
46,Valencia/València,122,Faura,2743,1380,1363
46,Valencia/València,123,Favara,1855,921,934
46,Valencia/València,126,Foios,6035,2954,3081
46,Valencia/València,128,Font de la Figuera (la),2139,1083,1056
46,Valencia/València,127,Font d'En Carròs (la),3421,1700,1721
46,Valencia/València,124,Fontanars dels Alforins,996,507,489
46,Valencia/València,125,Fortaleny,1010,503,507
46,Valencia/València,129,Fuenterrobles,737,384,353
46,Valencia/València,131,Gandia,62344,30900,31444
46,Valencia/València,902,Gátova,432,201,231
46,Valencia/València,130,Gavarda,1178,580,598
46,Valencia/València,132,Genovés,2567,1278,1289
46,Valencia/València,133,Gestalgar,714,361,353
46,Valencia/València,134,Gilet,2118,1086,1032
46,Valencia/València,135,Godella,11914,5853,6061
46,Valencia/València,136,Godelleta,2597,1320,1277
46,Valencia/València,137,Granja de la Costera (la),342,168,174
46,Valencia/València,138,Guadasequies,385,201,184
46,Valencia/València,139,Guadassuar,5568,2772,2796
46,Valencia/València,140,Guardamar de la Safor,196,103,93
46,Valencia/València,141,Higueruelas,519,267,252
46,Valencia/València,142,Jalance,981,492,489
46,Valencia/València,144,Jarafuel,861,440,421
46,Valencia/València,154,Llanera de Ranes,1059,555,504
46,Valencia/València,155,Llaurí,1269,635,634
46,Valencia/València,147,Llíria,19172,9677,9495
46,Valencia/València,153,Llocnou de Sant Jeroni,568,277,291
46,Valencia/València,151,Llocnou d'En Fenollet,820,420,400
46,Valencia/València,156,Llombai,2320,1188,1132
46,Valencia/València,157,Llosa de Ranes (la),3725,1920,1805
46,Valencia/València,150,Llutxent,2512,1281,1231
46,Valencia/València,148,Loriguilla,1177,617,560
46,Valencia/València,149,Losa del Obispo,478,242,236
46,Valencia/València,152,Lugar Nuevo de la Corona,87,41,46
46,Valencia/València,158,Macastre,1137,579,558
46,Valencia/València,159,Manises,28040,13995,14045
46,Valencia/València,160,Manuel,2497,1223,1274
46,Valencia/València,161,Marines,1464,743,721
46,Valencia/València,162,Masalavés,1535,802,733
46,Valencia/València,163,Massalfassar,1340,651,689
46,Valencia/València,164,Massamagrell,13826,6891,6935
46,Valencia/València,165,Massanassa,7843,3871,3972
46,Valencia/València,166,Meliana,9253,4572,4681
46,Valencia/València,167,Millares,567,275,292
46,Valencia/València,168,Miramar,1675,837,838
46,Valencia/València,169,Mislata,42689,20961,21728
46,Valencia/València,170,Mogente/Moixent,4465,2275,2190
46,Valencia/València,171,Moncada,20146,10010,10136
46,Valencia/València,172,Monserrat,4091,2187,1904
46,Valencia/València,173,Montaverner,1748,873,875
46,Valencia/València,174,Montesa,1400,719,681
46,Valencia/València,175,Montichelvo,673,346,327
46,Valencia/València,176,Montroy,1768,921,847
46,Valencia/València,177,Museros,4555,2278,2277
46,Valencia/València,178,Náquera,3770,1965,1805
46,Valencia/València,179,Navarrés,2929,1508,1421
46,Valencia/València,180,Novelé/Novetlè,697,327,370
46,Valencia/València,181,Oliva,23591,11755,11836
46,Valencia/València,183,Olleria (l'),7648,3907,3741
46,Valencia/València,182,Olocau,1127,584,543
46,Valencia/València,184,Ontinyent,35155,17594,17561
46,Valencia/València,185,Otos,504,264,240
46,Valencia/València,186,Paiporta,20484,10357,10127
46,Valencia/València,187,Palma de Gandía,1655,842,813
46,Valencia/València,188,Palmera,605,300,305
46,Valencia/València,189,Palomar (el),520,252,268
46,Valencia/València,190,Paterna,51162,25423,25739
46,Valencia/València,191,Pedralba,2436,1317,1119
46,Valencia/València,192,Petrés,867,432,435
46,Valencia/València,193,Picanya,9610,4808,4802
46,Valencia/València,194,Picassent,16943,8594,8349
46,Valencia/València,195,Piles,2347,1183,1164
46,Valencia/València,196,Pinet,192,101,91
46,Valencia/València,199,Pobla de Farnals (la),6172,3164,3008
46,Valencia/València,202,Pobla de Vallbona (la),15160,7760,7400
46,Valencia/València,200,Pobla del Duc (la),2595,1272,1323
46,Valencia/València,203,Pobla Llarga (la),4473,2220,2253
46,Valencia/València,197,Polinyà de Xúquer,2231,1121,1110
46,Valencia/València,198,Potríes,909,436,473
46,Valencia/València,205,Puçol,16018,7939,8079
46,Valencia/València,201,Puebla de San Miguel,68,38,30
46,Valencia/València,204,Puig,7851,3887,3964
46,Valencia/València,101,Quart de les Valls,1087,514,573
46,Valencia/València,102,Quart de Poblet,25638,12666,12972
46,Valencia/València,103,Quartell,1395,678,717
46,Valencia/València,104,Quatretonda,2529,1291,1238
46,Valencia/València,206,Quesa,745,388,357
46,Valencia/València,207,Rafelbuñol/Rafelbunyol,6349,3157,3192
46,Valencia/València,208,Rafelcofer,1395,670,725
46,Valencia/València,209,Rafelguaraf,2398,1175,1223
46,Valencia/València,210,Ráfol de Salem,389,190,199
46,Valencia/València,211,Real de Gandía,1892,927,965
46,Valencia/València,212,Real de Montroi,2031,1064,967
46,Valencia/València,213,Requena,19849,10004,9845
46,Valencia/València,214,Riba-roja de Túria,16262,8241,8021
46,Valencia/València,215,Riola,1706,845,861
46,Valencia/València,216,Rocafort,6049,2991,3058
46,Valencia/València,217,Rotglà i Corberà,999,493,506
46,Valencia/València,218,Rótova,1277,646,631
46,Valencia/València,219,Rugat,196,100,96
46,Valencia/València,220,Sagunto/Sagunt,60488,29702,30786
46,Valencia/València,221,Salem,482,246,236
46,Valencia/València,903,San Antonio de Benagéber,4021,2023,1998
46,Valencia/València,222,San Juan de Énova,386,181,205
46,Valencia/València,223,Sedaví,8778,4343,4435
46,Valencia/València,224,Segart,158,73,85
46,Valencia/València,225,Sellent,468,240,228
46,Valencia/València,226,Sempere,34,15,19
46,Valencia/València,227,Senyera,1038,498,540
46,Valencia/València,228,Serra,2335,1209,1126
46,Valencia/València,229,Siete Aguas,1232,648,584
46,Valencia/València,230,Silla,16358,8276,8082
46,Valencia/València,231,Simat de la Valldigna,3291,1688,1603
46,Valencia/València,232,Sinarcas,1238,634,604
46,Valencia/València,233,Sollana,4515,2212,2303
46,Valencia/València,234,Sot de Chera,381,191,190
46,Valencia/València,235,Sueca,26685,13204,13481
46,Valencia/València,236,Sumacàrcer,1308,669,639
46,Valencia/València,237,Tavernes Blanques,9033,4467,4566
46,Valencia/València,238,Tavernes de la Valldigna,17311,8707,8604
46,Valencia/València,239,Teresa de Cofrentes,661,347,314
46,Valencia/València,240,Terrateig,393,204,189
46,Valencia/València,241,Titaguas,544,284,260
46,Valencia/València,242,Torrebaja,432,229,203
46,Valencia/València,243,Torrella,166,87,79
46,Valencia/València,244,Torrent,71314,35584,35730
46,Valencia/València,245,Torres Torres,492,258,234
46,Valencia/València,246,Tous,1114,545,569
46,Valencia/València,247,Tuéjar,1212,632,580
46,Valencia/València,248,Turís,5305,2784,2521
46,Valencia/València,249,Utiel,11848,5904,5944
46,Valencia/València,250,Valencia,785732,376317,409415
46,Valencia/València,251,Vallada,3339,1720,1619
46,Valencia/València,252,Vallanca,190,97,93
46,Valencia/València,253,Vallés,95,55,40
46,Valencia/València,254,Venta del Moro,1493,777,716
46,Valencia/València,256,Vilamarxant,6730,3480,3250
46,Valencia/València,255,Villalonga,3996,2006,1990
46,Valencia/València,257,Villanueva de Castellón,7239,3580,3659
46,Valencia/València,258,Villar del Arzobispo,3626,1836,1790
46,Valencia/València,259,Villargordo del Cabriel,719,381,338
46,Valencia/València,260,Vinalesa,2576,1249,1327
46,Valencia/València,145,Xàtiva,27679,13675,14004
46,Valencia/València,143,Xeraco,5443,2742,2701
46,Valencia/València,146,Xeresa,1958,990,968
46,Valencia/València,110,Xirivella,28515,14161,14354
46,Valencia/València,261,Yátova,1982,1031,951
46,Valencia/València,262,Yesa (La),250,131,119
46,Valencia/València,263,Zarra,442,240,202
47,Valladolid,1,Adalia,69,37,32
47,Valladolid,2,Aguasal,25,14,11
47,Valladolid,3,Aguilar de Campos,337,182,155
47,Valladolid,4,Alaejos,1627,842,785
47,Valladolid,5,Alcazarén,702,374,328
47,Valladolid,6,Aldea de San Miguel,212,106,106
47,Valladolid,7,Aldeamayor de San Martín,1828,918,910
47,Valladolid,8,Almenara de Adaja,37,21,16
47,Valladolid,9,Amusquillo,161,88,73
47,Valladolid,10,Arroyo de la Encomienda,5709,2935,2774
47,Valladolid,11,Ataquines,816,433,383
47,Valladolid,12,Bahabón,198,93,105
47,Valladolid,13,Barcial de la Loma,151,79,72
47,Valladolid,14,Barruelo del Valle,71,42,29
47,Valladolid,15,Becilla de Valderaduey,362,196,166
47,Valladolid,16,Benafarces,114,61,53
47,Valladolid,17,Bercero,248,132,116
47,Valladolid,18,Berceruelo,41,23,18
47,Valladolid,19,Berrueces,105,59,46
47,Valladolid,20,Bobadilla del Campo,385,205,180
47,Valladolid,21,Bocigas,129,61,68
47,Valladolid,22,Bocos de Duero,74,33,41
47,Valladolid,23,Boecillo,2327,1169,1158
47,Valladolid,24,Bolaños de Campos,399,203,196
47,Valladolid,25,Brahojos de Medina,166,88,78
47,Valladolid,26,Bustillo de Chaves,102,52,50
47,Valladolid,27,Cabezón de Pisuerga,2344,1200,1144
47,Valladolid,28,Cabezón de Valderaduey,52,30,22
47,Valladolid,29,Cabreros del Monte,84,44,40
47,Valladolid,30,Campaspero,1443,756,687
47,Valladolid,31,Campillo (El),239,134,105
47,Valladolid,32,Camporredondo,201,113,88
47,Valladolid,33,Canalejas de Peñafiel,294,148,146
47,Valladolid,34,Canillas de Esgueva,113,61,52
47,Valladolid,35,Carpio,1079,579,500
47,Valladolid,36,Casasola de Arión,345,196,149
47,Valladolid,37,Castrejón de Trabancos,253,131,122
47,Valladolid,38,Castrillo de Duero,164,82,82
47,Valladolid,39,Castrillo-Tejeriego,232,124,108
47,Valladolid,40,Castrobol,100,47,53
47,Valladolid,41,Castrodeza,228,124,104
47,Valladolid,42,Castromembibre,80,44,36
47,Valladolid,43,Castromonte,394,202,192
47,Valladolid,44,Castronuevo de Esgueva,337,180,157
47,Valladolid,45,Castronuño,1049,526,523
47,Valladolid,46,Castroponce,173,91,82
47,Valladolid,47,Castroverde de Cerrato,266,157,109
47,Valladolid,48,Ceinos de Campos,278,146,132
47,Valladolid,49,Cervillego de la Cruz,139,67,72
47,Valladolid,50,Cigales,3335,1669,1666
47,Valladolid,51,Ciguñuela,381,199,182
47,Valladolid,52,Cistérniga,5359,2763,2596
47,Valladolid,53,Cogeces de Íscar,155,84,71
47,Valladolid,54,Cogeces del Monte,863,480,383
47,Valladolid,55,Corcos,258,141,117
47,Valladolid,56,Corrales de Duero,119,73,46
47,Valladolid,57,Cubillas de Santa Marta,292,160,132
47,Valladolid,58,Cuenca de Campos,259,126,133
47,Valladolid,59,Curiel de Duero,98,55,43
47,Valladolid,60,Encinas de Esgueva,340,185,155
47,Valladolid,61,Esguevillas de Esgueva,350,180,170
47,Valladolid,62,Fombellida,244,131,113
47,Valladolid,63,Fompedraza,143,84,59
47,Valladolid,64,Fontihoyuelo,41,26,15
47,Valladolid,65,Fresno el Viejo,1182,607,575
47,Valladolid,66,Fuensaldaña,1149,568,581
47,Valladolid,67,Fuente el Sol,278,146,132
47,Valladolid,68,Fuente-Olmedo,53,30,23
47,Valladolid,69,Gallegos de Hornija,151,74,77
47,Valladolid,70,Gatón de Campos,40,25,15
47,Valladolid,71,Geria,473,257,216
47,Valladolid,73,Herrín de Campos,191,91,100
47,Valladolid,74,Hornillos de Eresma,193,103,90
47,Valladolid,75,Íscar,6508,3314,3194
47,Valladolid,76,Laguna de Duero,20396,10338,10058
47,Valladolid,77,Langayo,398,224,174
47,Valladolid,79,Llano de Olmedo,82,44,38
47,Valladolid,78,Lomoviejo,240,119,121
47,Valladolid,80,Manzanillo,48,25,23
47,Valladolid,81,Marzales,64,32,32
47,Valladolid,82,Matapozuelos,1024,522,502
47,Valladolid,83,Matilla de los Caños,111,65,46
47,Valladolid,84,Mayorga,1981,1007,974
47,Valladolid,86,Medina de Rioseco,5037,2476,2561
47,Valladolid,85,Medina del Campo,20505,10042,10463
47,Valladolid,87,Megeces,446,222,224
47,Valladolid,88,Melgar de Abajo,170,93,77
47,Valladolid,89,Melgar de Arriba,271,143,128
47,Valladolid,90,Mojados,2959,1487,1472
47,Valladolid,91,Monasterio de Vega,107,57,50
47,Valladolid,92,Montealegre de Campos,135,76,59
47,Valladolid,93,Montemayor de Pililla,1036,537,499
47,Valladolid,94,Moral de la Reina,245,125,120
47,Valladolid,95,Moraleja de las Panaderas,34,24,10
47,Valladolid,96,Morales de Campos,179,88,91
47,Valladolid,97,Mota del Marqués,425,209,216
47,Valladolid,98,Mucientes,632,326,306
47,Valladolid,99,Mudarra (La),247,135,112
47,Valladolid,100,Muriel,204,104,100
47,Valladolid,101,Nava del Rey,2127,1082,1045
47,Valladolid,102,Nueva Villa de las Torres,393,217,176
47,Valladolid,103,Olivares de Duero,330,182,148
47,Valladolid,104,Olmedo,3529,1711,1818
47,Valladolid,105,Olmos de Esgueva,212,120,92
47,Valladolid,106,Olmos de Peñafiel,80,39,41
47,Valladolid,109,Palazuelo de Vedija,241,129,112
47,Valladolid,110,Parrilla (La),622,304,318
47,Valladolid,111,Pedraja de Portillo (La),1076,553,523
47,Valladolid,112,Pedrajas de San Esteban,3317,1699,1618
47,Valladolid,113,Pedrosa del Rey,216,119,97
47,Valladolid,114,Peñafiel,5433,2730,2703
47,Valladolid,115,Peñaflor de Hornija,415,225,190
47,Valladolid,116,Pesquera de Duero,538,286,252
47,Valladolid,117,Piña de Esgueva,359,179,180
47,Valladolid,118,Piñel de Abajo,194,100,94
47,Valladolid,119,Piñel de Arriba,137,65,72
47,Valladolid,121,Pollos,780,405,375
47,Valladolid,122,Portillo,2598,1336,1262
47,Valladolid,123,Pozal de Gallinas,499,269,230
47,Valladolid,124,Pozaldez,497,249,248
47,Valladolid,125,Pozuelo de la Orden,75,43,32
47,Valladolid,126,Puras,63,29,34
47,Valladolid,127,Quintanilla de Arriba,226,119,107
47,Valladolid,129,Quintanilla de Onésimo,1139,582,557
47,Valladolid,130,Quintanilla de Trigueros,118,59,59
47,Valladolid,128,Quintanilla del Molar,83,38,45
47,Valladolid,131,Rábano,249,126,123
47,Valladolid,132,Ramiro,72,41,31
47,Valladolid,133,Renedo de Esgueva,1264,659,605
47,Valladolid,134,Roales de Campos,243,116,127
47,Valladolid,135,Robladillo,108,51,57
47,Valladolid,137,Roturas,32,16,16
47,Valladolid,138,Rubí de Bracamonte,305,158,147
47,Valladolid,139,Rueda,1451,739,712
47,Valladolid,140,Saelices de Mayorga,179,96,83
47,Valladolid,141,Salvador de Zapardiel,188,104,84
47,Valladolid,142,San Cebrián de Mazote,200,109,91
47,Valladolid,143,San Llorente,178,97,81
47,Valladolid,144,San Martín de Valvení,105,56,49
47,Valladolid,145,San Miguel del Arroyo,785,405,380
47,Valladolid,146,San Miguel del Pino,217,113,104
47,Valladolid,147,San Pablo de la Moraleja,167,89,78
47,Valladolid,148,San Pedro de Latarce,615,326,289
47,Valladolid,149,San Pelayo,42,23,19
47,Valladolid,150,San Román de Hornija,425,199,226
47,Valladolid,151,San Salvador,44,24,20
47,Valladolid,156,San Vicente del Palacio,232,125,107
47,Valladolid,152,Santa Eufemia del Arroyo,144,70,74
47,Valladolid,153,Santervás de Campos,148,85,63
47,Valladolid,154,Santibáñez de Valcorba,193,92,101
47,Valladolid,155,Santovenia de Pisuerga,2688,1368,1320
47,Valladolid,157,Sardón de Duero,668,335,333
47,Valladolid,158,Seca (La),1058,545,513
47,Valladolid,159,Serrada,1106,576,530
47,Valladolid,160,Siete Iglesias de Trabancos,561,293,268
47,Valladolid,161,Simancas,4413,2255,2158
47,Valladolid,162,Tamariz de Campos,100,55,45
47,Valladolid,163,Tiedra,394,193,201
47,Valladolid,164,Tordehumos,510,257,253
47,Valladolid,165,Tordesillas,8218,4161,4057
47,Valladolid,169,Torre de Esgueva,98,48,50
47,Valladolid,170,Torre de Peñafiel,52,28,24
47,Valladolid,166,Torrecilla de la Abadesa,326,167,159
47,Valladolid,167,Torrecilla de la Orden,332,165,167
47,Valladolid,168,Torrecilla de la Torre,31,20,11
47,Valladolid,171,Torrelobatón,577,287,290
47,Valladolid,172,Torrescárcela,164,85,79
47,Valladolid,173,Traspinedo,905,476,429
47,Valladolid,174,Trigueros del Valle,336,178,158
47,Valladolid,175,Tudela de Duero,6483,3343,3140
47,Valladolid,176,Unión de Campos (La),320,161,159
47,Valladolid,177,Urones de Castroponce,147,78,69
47,Valladolid,178,Urueña,213,112,101
47,Valladolid,179,Valbuena de Duero,502,265,237
47,Valladolid,180,Valdearcos de la Vega,115,61,54
47,Valladolid,181,Valdenebro de los Valles,223,118,105
47,Valladolid,182,Valdestillas,1650,836,814
47,Valladolid,183,Valdunquillo,209,96,113
47,Valladolid,186,Valladolid,321713,154299,167414
47,Valladolid,184,Valoria la Buena,666,352,314
47,Valladolid,185,Valverde de Campos,115,64,51
47,Valladolid,187,Vega de Ruiponce,129,66,63
47,Valladolid,188,Vega de Valdetronco,162,89,73
47,Valladolid,189,Velascálvaro,189,104,85
47,Valladolid,190,Velilla,138,69,69
47,Valladolid,191,Velliza,149,93,56
47,Valladolid,192,Ventosa de la Cuesta,135,75,60
47,Valladolid,193,Viana de Cega,1716,871,845
47,Valladolid,195,Villabáñez,480,265,215
47,Valladolid,196,Villabaruz de Campos,46,24,22
47,Valladolid,197,Villabrágima,1173,623,550
47,Valladolid,198,Villacarralón,89,47,42
47,Valladolid,199,Villacid de Campos,103,57,46
47,Valladolid,200,Villaco,119,71,48
47,Valladolid,203,Villafrades de Campos,101,44,57
47,Valladolid,204,Villafranca de Duero,374,189,185
47,Valladolid,205,Villafrechós,516,272,244
47,Valladolid,206,Villafuerte,145,74,71
47,Valladolid,207,Villagarcía de Campos,418,223,195
47,Valladolid,208,Villagómez la Nueva,87,44,43
47,Valladolid,209,Villalán de Campos,52,27,25
47,Valladolid,210,Villalar de los Comuneros,449,217,232
47,Valladolid,211,Villalba de la Loma,46,25,21
47,Valladolid,212,Villalba de los Alcores,537,282,255
47,Valladolid,213,Villalbarba,156,78,78
47,Valladolid,214,Villalón de Campos,2040,1003,1037
47,Valladolid,215,Villamuriel de Campos,81,35,46
47,Valladolid,216,Villán de Tordesillas,176,89,87
47,Valladolid,217,Villanubla,1302,689,613
47,Valladolid,218,Villanueva de Duero,1067,541,526
47,Valladolid,219,Villanueva de la Condesa,44,27,17
47,Valladolid,220,Villanueva de los Caballeros,246,120,126
47,Valladolid,221,Villanueva de los Infantes,140,77,63
47,Valladolid,222,Villanueva de San Mancio,125,67,58
47,Valladolid,223,Villardefrades,219,116,103
47,Valladolid,224,Villarmentero de Esgueva,123,59,64
47,Valladolid,225,Villasexmir,111,56,55
47,Valladolid,226,Villavaquerín,206,107,99
47,Valladolid,227,Villavellid,76,43,33
47,Valladolid,228,Villaverde de Medina,587,312,275
47,Valladolid,229,Villavicencio de los Caballeros,294,138,156
47,Valladolid,194,Viloria,388,212,176
47,Valladolid,230,Wamba,373,199,174
47,Valladolid,231,Zaratán,2115,1099,1016
47,Valladolid,232,Zarza (La),152,80,72
48,Vizcaya,1,Abadiño,7031,3522,3509
48,Vizcaya,2,Abanto y Ciérvana-Abanto Zierbena,9315,4624,4691
48,Vizcaya,911,Ajangiz,428,210,218
48,Vizcaya,912,Alonsotegi,2626,1278,1348
48,Vizcaya,3,Amorebieta-Etxano,16609,8249,8360
48,Vizcaya,4,Amoroto,370,192,178
48,Vizcaya,5,Arakaldo,95,57,38
48,Vizcaya,6,Arantzazu,279,137,142
48,Vizcaya,93,Areatza,1021,477,544
48,Vizcaya,9,Arrankudiaga,779,379,400
48,Vizcaya,914,Arratzu,357,177,180
48,Vizcaya,10,Arrieta,512,263,249
48,Vizcaya,11,Arrigorriaga,11871,5883,5988
48,Vizcaya,23,Artea,673,332,341
48,Vizcaya,8,Artzentales,660,362,298
48,Vizcaya,91,Atxondo,1424,722,702
48,Vizcaya,70,Aulesti,659,337,322
48,Vizcaya,12,Bakio,1931,960,971
48,Vizcaya,90,Balmaseda,7117,3462,3655
48,Vizcaya,13,Barakaldo,94967,46293,48674
48,Vizcaya,14,Barrika,1283,646,637
48,Vizcaya,15,Basauri,44627,22041,22586
48,Vizcaya,92,Bedia,978,485,493
48,Vizcaya,16,Berango,5846,2927,2919
48,Vizcaya,17,Bermeo,16901,8304,8597
48,Vizcaya,18,Berriatua,1077,578,499
48,Vizcaya,19,Berriz,4468,2295,2173
48,Vizcaya,20,Bilbao,352317,166854,185463
48,Vizcaya,21,Busturia,1685,848,837
48,Vizcaya,901,Derio,4915,2457,2458
48,Vizcaya,26,Dima,1128,584,544
48,Vizcaya,27,Durango,26131,12788,13343
48,Vizcaya,28,Ea,791,400,391
48,Vizcaya,31,Elantxobe,463,205,258
48,Vizcaya,32,Elorrio,7099,3554,3545
48,Vizcaya,902,Erandio,23104,11382,11722
48,Vizcaya,33,Ereño,256,127,129
48,Vizcaya,34,Ermua,16597,8419,8178
48,Vizcaya,79,Errigoiti,484,271,213
48,Vizcaya,29,"Etxebarri, Anteiglesia de San Esteban-Etxebarri Doneztebeko Elizatea",7516,3853,3663
48,Vizcaya,30,Etxebarria,789,413,376
48,Vizcaya,906,Forua,1010,514,496
48,Vizcaya,35,Fruiz,363,180,183
48,Vizcaya,36,Galdakao,29603,14660,14943
48,Vizcaya,37,Galdames,808,420,388
48,Vizcaya,38,Gamiz-Fika,1254,651,603
48,Vizcaya,39,Garay,285,141,144
48,Vizcaya,40,Gatika,1340,685,655
48,Vizcaya,41,Gautegiz Arteaga,880,449,431
48,Vizcaya,46,Gernika-Lumo,15571,7574,7997
48,Vizcaya,44,Getxo,83004,39456,43548
48,Vizcaya,47,Gizaburuaga,141,73,68
48,Vizcaya,42,Gordexola,1544,776,768
48,Vizcaya,43,Gorliz,4750,2366,2384
48,Vizcaya,45,Güeñes,6061,2990,3071
48,Vizcaya,48,Ibarrangelu,541,263,278
48,Vizcaya,94,Igorre,4019,2011,2008
48,Vizcaya,49,Ispaster,615,324,291
48,Vizcaya,910,Iurreta,4046,2016,2030
48,Vizcaya,50,Izurtza,265,137,128
48,Vizcaya,22,Karrantza Harana/Valle de Carranza,2884,1496,1388
48,Vizcaya,907,Kortezubi,372,190,182
48,Vizcaya,51,Lanestosa,285,143,142
48,Vizcaya,52,Larrabetzu,1618,793,825
48,Vizcaya,53,Laukiz,975,503,472
48,Vizcaya,54,Leioa,28806,14115,14691
48,Vizcaya,57,Lekeitio,7300,3607,3693
48,Vizcaya,55,Lemoa,2793,1398,1395
48,Vizcaya,56,Lemoiz,908,476,432
48,Vizcaya,81,Lezama,2223,1116,1107
48,Vizcaya,903,Loiu,2193,1166,1027
48,Vizcaya,58,Mallabia,1105,585,520
48,Vizcaya,59,Mañaria,451,231,220
48,Vizcaya,60,Markina-Xemein,4752,2408,2344
48,Vizcaya,61,Maruri-Jatabe,772,383,389
48,Vizcaya,62,Mendata,343,176,167
48,Vizcaya,63,Mendexa,363,191,172
48,Vizcaya,64,Meñaka,563,284,279
48,Vizcaya,66,Morga,419,233,186
48,Vizcaya,68,Mundaka,1847,904,943
48,Vizcaya,69,Mungia,14446,7069,7377
48,Vizcaya,7,Munitibar-Arbatzegi Gerrikaitz,385,202,183
48,Vizcaya,908,Murueta,289,149,140
48,Vizcaya,71,Muskiz,6597,3243,3354
48,Vizcaya,67,Muxika,1290,666,624
48,Vizcaya,909,Nabarniz,231,115,116
48,Vizcaya,73,Ondarroa,9642,4929,4713
48,Vizcaya,75,Orozko,2265,1147,1118
48,Vizcaya,83,Ortuella,8644,4199,4445
48,Vizcaya,72,Otxandio,1040,548,492
48,Vizcaya,77,Plentzia,3895,1888,2007
48,Vizcaya,78,Portugalete,50357,24494,25863
48,Vizcaya,82,Santurtzi,47037,22982,24055
48,Vizcaya,84,Sestao,30766,15004,15762
48,Vizcaya,904,Sondika,4242,2061,2181
48,Vizcaya,85,Sopelana,11209,5538,5671
48,Vizcaya,86,Sopuerta,2272,1159,1113
48,Vizcaya,76,Sukarrieta,360,190,170
48,Vizcaya,87,Trucios-Turtzioz,530,265,265
48,Vizcaya,88,Ubide,161,82,79
48,Vizcaya,65,Ugao-Miraballes,4079,2064,2015
48,Vizcaya,89,Urduliz,3176,1601,1575
48,Vizcaya,74,Urduña-Orduña,4038,2088,1950
48,Vizcaya,80,Valle de Trápaga-Trapagaran,12605,6219,6386
48,Vizcaya,95,Zaldibar,2894,1420,1474
48,Vizcaya,96,Zalla,7919,3883,4036
48,Vizcaya,905,Zamudio,3149,1574,1575
48,Vizcaya,97,Zaratamo,1647,819,828
48,Vizcaya,24,Zeanuri,1155,598,557
48,Vizcaya,25,Zeberio,1025,529,496
48,Vizcaya,913,Zierbena,1265,680,585
49,Zamora,2,Abezames,95,50,45
49,Zamora,3,Alcañices,1114,554,560
49,Zamora,4,Alcubilla de Nogales,185,93,92
49,Zamora,5,Alfaraz de Sayago,194,108,86
49,Zamora,6,Algodre,181,92,89
49,Zamora,7,Almaraz de Duero,447,222,225
49,Zamora,8,Almeida de Sayago,619,311,308
49,Zamora,9,Andavías,458,225,233
49,Zamora,10,Arcenillas,309,157,152
49,Zamora,11,Arcos de la Polvorosa,280,149,131
49,Zamora,12,Argañín,89,41,48
49,Zamora,13,Argujillo,355,187,168
49,Zamora,14,Arquillinos,161,87,74
49,Zamora,15,Arrabalde,365,169,196
49,Zamora,16,Aspariegos,319,163,156
49,Zamora,17,Asturianos,322,164,158
49,Zamora,18,Ayoó de Vidriales,426,216,210
49,Zamora,19,Barcial del Barco,307,170,137
49,Zamora,20,Belver de los Montes,428,232,196
49,Zamora,21,Benavente,17764,8679,9085
49,Zamora,22,Benegiles,399,210,189
49,Zamora,23,Bermillo de Sayago,1327,710,617
49,Zamora,24,Bóveda de Toro (La),896,452,444
49,Zamora,25,Bretó,236,124,112
49,Zamora,26,Bretocino,297,160,137
49,Zamora,27,Brime de Sog,215,99,116
49,Zamora,28,Brime de Urz,153,81,72
49,Zamora,29,Burganes de Valverde,859,453,406
49,Zamora,30,Bustillo del Oro,139,71,68
49,Zamora,31,Cabañas de Sayago,183,91,92
49,Zamora,32,Calzadilla de Tera,467,223,244
49,Zamora,33,Camarzana de Tera,988,472,516
49,Zamora,34,Cañizal,592,314,278
49,Zamora,35,Cañizo,314,165,149
49,Zamora,36,Carbajales de Alba,692,355,337
49,Zamora,37,Carbellino,249,127,122
49,Zamora,38,Casaseca de Campeán,135,77,58
49,Zamora,39,Casaseca de las Chanas,360,182,178
49,Zamora,40,Castrillo de la Guareña,152,78,74
49,Zamora,41,Castrogonzalo,536,293,243
49,Zamora,42,Castronuevo,344,175,169
49,Zamora,43,Castroverde de Campos,406,215,191
49,Zamora,44,Cazurra,90,47,43
49,Zamora,46,Cerecinos de Campos,396,206,190
49,Zamora,47,Cerecinos del Carrizal,155,86,69
49,Zamora,48,Cernadilla,178,85,93
49,Zamora,50,Cobreros,672,336,336
49,Zamora,52,Coomonte,300,151,149
49,Zamora,53,Coreses,1158,591,567
49,Zamora,54,Corrales,1055,500,555
49,Zamora,55,Cotanes del Monte,152,80,72
49,Zamora,56,Cubillos,392,203,189
49,Zamora,57,Cubo de Benavente,159,83,76
49,Zamora,58,Cubo de Tierra del Vino (El),445,233,212
49,Zamora,59,Cuelgamures,133,77,56
49,Zamora,61,Entrala,168,88,80
49,Zamora,62,Espadañedo,188,91,97
49,Zamora,63,Faramontanos de Tábara,494,252,242
49,Zamora,64,Fariza,689,348,341
49,Zamora,65,Fermoselle,1552,791,761
49,Zamora,66,Ferreras de Abajo,635,313,322
49,Zamora,67,Ferreras de Arriba,515,258,257
49,Zamora,68,Ferreruela,596,306,290
49,Zamora,69,Figueruela de Arriba,498,231,267
49,Zamora,71,Fonfría,1070,543,527
49,Zamora,75,Fresno de la Polvorosa,200,97,103
49,Zamora,76,Fresno de la Ribera,420,231,189
49,Zamora,77,Fresno de Sayago,238,119,119
49,Zamora,78,Friera de Valverde,248,127,121
49,Zamora,79,Fuente Encalada,131,68,63
49,Zamora,80,Fuentelapeña,938,479,459
49,Zamora,82,Fuentes de Ropel,566,297,269
49,Zamora,81,Fuentesaúco,1867,951,916
49,Zamora,83,Fuentesecas,86,39,47
49,Zamora,84,Fuentespreadas,374,199,175
49,Zamora,85,Galende,1359,688,671
49,Zamora,86,Gallegos del Pan,159,82,77
49,Zamora,87,Gallegos del Río,749,401,348
49,Zamora,88,Gamones,98,54,44
49,Zamora,90,Gema,262,131,131
49,Zamora,91,Granja de Moreruela,337,169,168
49,Zamora,92,Granucillo,235,125,110
49,Zamora,93,Guarrate,369,190,179
49,Zamora,94,Hermisende,383,209,174
49,Zamora,95,Hiniesta (La),364,176,188
49,Zamora,96,Jambrina,221,107,114
49,Zamora,97,Justel,151,85,66
49,Zamora,98,Losacino,306,165,141
49,Zamora,99,Losacio,132,69,63
49,Zamora,100,Lubián,362,182,180
49,Zamora,101,Luelmo,228,113,115
49,Zamora,102,Maderal (El),269,144,125
49,Zamora,103,Madridanos,534,266,268
49,Zamora,104,Mahide,493,256,237
49,Zamora,105,Maire de Castroponce,230,119,111
49,Zamora,107,Malva,209,110,99
49,Zamora,108,Manganeses de la Lampreana,696,347,349
49,Zamora,109,Manganeses de la Polvorosa,812,396,416
49,Zamora,110,Manzanal de Arriba,439,231,208
49,Zamora,112,Manzanal de los Infantes,182,98,84
49,Zamora,111,Manzanal del Barco,194,101,93
49,Zamora,113,Matilla de Arzón,246,133,113
49,Zamora,114,Matilla la Seca,64,29,35
49,Zamora,115,Mayalde,232,117,115
49,Zamora,116,Melgar de Tera,530,267,263
49,Zamora,117,Micereces de Tera,595,306,289
49,Zamora,118,Milles de la Polvorosa,265,135,130
49,Zamora,119,Molacillos,286,153,133
49,Zamora,120,Molezuelas de la Carballeda,87,40,47
49,Zamora,121,Mombuey,434,221,213
49,Zamora,122,Monfarracinos,744,385,359
49,Zamora,123,Montamarta,625,316,309
49,Zamora,124,Moral de Sayago,346,188,158
49,Zamora,126,Moraleja de Sayago,296,154,142
49,Zamora,125,Moraleja del Vino,1315,701,614
49,Zamora,128,Morales de Rey,714,357,357
49,Zamora,129,Morales de Toro,1078,541,537
49,Zamora,130,Morales de Valverde,271,134,137
49,Zamora,127,Morales del Vino,2032,1056,976
49,Zamora,131,Moralina,346,172,174
49,Zamora,132,Moreruela de los Infanzones,429,220,209
49,Zamora,133,Moreruela de Tábara,482,257,225
49,Zamora,134,Muelas de los Caballeros,246,142,104
49,Zamora,135,Muelas del Pan,844,421,423
49,Zamora,136,Muga de Sayago,472,226,246
49,Zamora,137,Navianos de Valverde,253,132,121
49,Zamora,138,Olmillos de Castro,378,200,178
49,Zamora,139,Otero de Bodas,229,124,105
49,Zamora,141,Pajares de la Lampreana,496,242,254
49,Zamora,143,Palacios de Sanabria,322,155,167
49,Zamora,142,Palacios del Pan,235,105,130
49,Zamora,145,Pedralba de la Pradería,280,133,147
49,Zamora,146,Pego (El),413,211,202
49,Zamora,147,Peleagonzalo,392,196,196
49,Zamora,148,Peleas de Abajo,268,123,145
49,Zamora,149,Peñausende,506,248,258
49,Zamora,150,Peque,181,86,95
49,Zamora,151,Perdigón (El),780,401,379
49,Zamora,152,Pereruela,673,343,330
49,Zamora,153,Perilla de Castro,230,115,115
49,Zamora,154,Pías,201,104,97
49,Zamora,155,Piedrahita de Castro,138,79,59
49,Zamora,156,Pinilla de Toro,344,168,176
49,Zamora,157,Pino del Oro,221,117,104
49,Zamora,158,Piñero (El),282,147,135
49,Zamora,160,Pobladura de Valderaduey,66,33,33
49,Zamora,159,Pobladura del Valle,338,168,170
49,Zamora,162,Porto,299,159,140
49,Zamora,163,Pozoantiguo,306,157,149
49,Zamora,164,Pozuelo de Tábara,213,107,106
49,Zamora,165,Prado,99,50,49
49,Zamora,166,Puebla de Sanabria,1614,778,836
49,Zamora,167,Pueblica de Valverde,280,143,137
49,Zamora,170,Quintanilla de Urz,146,72,74
49,Zamora,168,Quintanilla del Monte,130,63,67
49,Zamora,169,Quintanilla del Olmo,50,25,25
49,Zamora,171,Quiruelas de Vidriales,934,446,488
49,Zamora,172,Rabanales,767,396,371
49,Zamora,173,Rábano de Aliste,450,229,221
49,Zamora,174,Requejo,164,80,84
49,Zamora,175,Revellinos,310,169,141
49,Zamora,176,Riofrío de Aliste,1019,533,486
49,Zamora,177,Rionegro del Puente,385,196,189
49,Zamora,178,Roales,501,254,247
49,Zamora,179,Robleda-Cervantes,476,233,243
49,Zamora,180,Roelos de Sayago,153,80,73
49,Zamora,181,Rosinos de la Requejada,492,240,252
49,Zamora,183,Salce,127,68,59
49,Zamora,184,Samir de los Caños,225,120,105
49,Zamora,185,San Agustín del Pozo,202,111,91
49,Zamora,186,San Cebrián de Castro,337,161,176
49,Zamora,187,San Cristóbal de Entreviñas,1645,841,804
49,Zamora,188,San Esteban del Molar,168,86,82
49,Zamora,189,San Justo,337,167,170
49,Zamora,190,San Martín de Valderaduey,86,43,43
49,Zamora,191,San Miguel de la Ribera,374,186,188
49,Zamora,192,San Miguel del Valle,214,107,107
49,Zamora,193,San Pedro de Ceque,651,326,325
49,Zamora,194,San Pedro de la Nave-Almendra,477,236,241
49,Zamora,208,San Vicente de la Cabeza,559,296,263
49,Zamora,209,San Vitero,677,366,311
49,Zamora,197,Santa Clara de Avedillo,240,116,124
49,Zamora,199,Santa Colomba de las Monjas,317,159,158
49,Zamora,200,Santa Cristina de la Polvorosa,1235,628,607
49,Zamora,201,Santa Croya de Tera,422,211,211
49,Zamora,202,Santa Eufemia del Barco,279,154,125
49,Zamora,203,Santa María de la Vega,475,249,226
49,Zamora,204,Santa María de Valverde,95,46,49
49,Zamora,205,Santibáñez de Tera,605,300,305
49,Zamora,206,Santibáñez de Vidriales,1287,639,648
49,Zamora,207,Santovenia,367,173,194
49,Zamora,210,Sanzoles,646,332,314
49,Zamora,214,Tábara,950,491,459
49,Zamora,216,Tapioles,216,119,97
49,Zamora,219,Toro,9396,4596,4800
49,Zamora,220,Torre del Valle (La),185,102,83
49,Zamora,221,Torregamones,325,168,157
49,Zamora,222,Torres del Carrizal,501,258,243
49,Zamora,223,Trabazos,927,472,455
49,Zamora,224,Trefacio,247,127,120
49,Zamora,225,Uña de Quintana,219,111,108
49,Zamora,226,Vadillo de la Guareña,354,187,167
49,Zamora,227,Valcabado,339,172,167
49,Zamora,228,Valdefinjas,93,52,41
49,Zamora,229,Valdescorriel,197,101,96
49,Zamora,230,Vallesa de la Guareña,163,88,75
49,Zamora,231,Vega de Tera,470,228,242
49,Zamora,232,Vega de Villalobos,152,70,82
49,Zamora,233,Vegalatrave,141,75,66
49,Zamora,234,Venialbo,502,268,234
49,Zamora,235,Vezdemarbán,639,313,326
49,Zamora,236,Vidayanes,103,49,54
49,Zamora,237,Videmala,216,101,115
49,Zamora,238,Villabrázaro,352,177,175
49,Zamora,239,Villabuena del Puente,898,477,421
49,Zamora,240,Villadepera,273,140,133
49,Zamora,241,Villaescusa,352,181,171
49,Zamora,242,Villafáfila,628,320,308
49,Zamora,243,Villaferrueña,153,79,74
49,Zamora,244,Villageriz,59,31,28
49,Zamora,245,Villalazán,375,185,190
49,Zamora,246,Villalba de la Lampreana,297,153,144
49,Zamora,247,Villalcampo,624,321,303
49,Zamora,248,Villalobos,295,144,151
49,Zamora,249,Villalonso,116,61,55
49,Zamora,250,Villalpando,1624,791,833
49,Zamora,251,Villalube,260,133,127
49,Zamora,252,Villamayor de Campos,492,248,244
49,Zamora,255,Villamor de los Escuderos,561,280,281
49,Zamora,256,Villanázar,364,174,190
49,Zamora,257,Villanueva de Azoague,315,162,153
49,Zamora,258,Villanueva de Campeán,168,81,87
49,Zamora,259,Villanueva de las Peras,167,84,83
49,Zamora,260,Villanueva del Campo,1061,527,534
49,Zamora,263,Villar de Fallaves,96,51,45
49,Zamora,264,Villar del Buey,801,433,368
49,Zamora,261,Villaralbo,1669,833,836
49,Zamora,262,Villardeciervos,515,252,263
49,Zamora,265,Villardiegua de la Ribera,162,79,83
49,Zamora,266,Villárdiga,102,52,50
49,Zamora,267,Villardondiego,121,69,52
49,Zamora,268,Villarrín de Campos,583,301,282
49,Zamora,269,Villaseco del Pan,276,127,149
49,Zamora,270,Villavendimio,202,114,88
49,Zamora,272,Villaveza de Valverde,129,66,63
49,Zamora,271,Villaveza del Agua,266,137,129
49,Zamora,273,Viñas,259,134,125
49,Zamora,275,Zamora,65646,31012,34634
50,Zaragoza,1,Abanto,155,84,71
50,Zaragoza,2,Acered,236,127,109
50,Zaragoza,3,Agón,193,101,92
50,Zaragoza,4,Aguarón,776,388,388
50,Zaragoza,5,Aguilón,290,142,148
50,Zaragoza,6,Ainzón,1229,641,588
50,Zaragoza,7,Aladrén,73,44,29
50,Zaragoza,8,Alagón,6024,3050,2974
50,Zaragoza,9,Alarba,143,81,62
50,Zaragoza,10,Alberite de San Juan,102,60,42
50,Zaragoza,11,Albeta,151,75,76
50,Zaragoza,12,Alborge,130,68,62
50,Zaragoza,13,Alcalá de Ebro,279,129,150
50,Zaragoza,14,Alcalá de Moncayo,144,76,68
50,Zaragoza,15,Alconchel de Ariza,128,73,55
50,Zaragoza,16,Aldehuela de Liestos,33,18,15
50,Zaragoza,17,Alfajarín,1742,890,852
50,Zaragoza,18,Alfamén,1507,873,634
50,Zaragoza,19,Alforque,83,46,37
50,Zaragoza,20,Alhama de Aragón,1150,586,564
50,Zaragoza,21,Almochuel,49,25,24
50,Zaragoza,22,Almolda (La),653,329,324
50,Zaragoza,23,Almonacid de la Cuba,306,156,150
50,Zaragoza,24,Almonacid de la Sierra,894,482,412
50,Zaragoza,25,Almunia de Doña Godina (La),6480,3360,3120
50,Zaragoza,26,Alpartir,603,314,289
50,Zaragoza,27,Ambel,334,152,182
50,Zaragoza,28,Anento,198,125,73
50,Zaragoza,29,Aniñón,837,450,387
50,Zaragoza,30,Añón de Moncayo,263,156,107
50,Zaragoza,31,Aranda de Moncayo,220,119,101
50,Zaragoza,32,Arándiga,472,242,230
50,Zaragoza,33,Ardisa,82,46,36
50,Zaragoza,34,Ariza,1312,674,638
50,Zaragoza,35,Artieda,107,65,42
50,Zaragoza,36,Asín,106,54,52
50,Zaragoza,37,Atea,180,105,75
50,Zaragoza,38,Ateca,2044,1024,1020
50,Zaragoza,39,Azuara,665,351,314
50,Zaragoza,40,Badules,107,55,52
50,Zaragoza,41,Bagüés,43,23,20
50,Zaragoza,42,Balconchán,18,6,12
50,Zaragoza,43,Bárboles,318,167,151
50,Zaragoza,44,Bardallur,274,132,142
50,Zaragoza,45,Belchite,1572,812,760
50,Zaragoza,46,Belmonte de Gracián,248,136,112
50,Zaragoza,47,Berdejo,66,40,26
50,Zaragoza,48,Berrueco,43,24,19
50,Zaragoza,901,Biel,215,123,92
50,Zaragoza,50,Bijuesca,109,65,44
50,Zaragoza,51,Biota,1169,597,572
50,Zaragoza,52,Bisimbre,118,55,63
50,Zaragoza,53,Boquiñeni,1013,515,498
50,Zaragoza,54,Bordalba,92,54,38
50,Zaragoza,55,Borja,4348,2160,2188
50,Zaragoza,56,Botorrita,471,252,219
50,Zaragoza,57,Brea de Aragón,2013,1034,979
50,Zaragoza,58,Bubierca,92,47,45
50,Zaragoza,59,Bujaraloz,1002,526,476
50,Zaragoza,60,Bulbuente,237,126,111
50,Zaragoza,61,Bureta,303,156,147
50,Zaragoza,62,Burgo de Ebro (El),1797,936,861
50,Zaragoza,63,Buste (El),98,49,49
50,Zaragoza,64,Cabañas de Ebro,522,278,244
50,Zaragoza,65,Cabolafuente,67,37,30
50,Zaragoza,66,Cadrete,2115,1128,987
50,Zaragoza,67,Calatayud,19634,9733,9901
50,Zaragoza,68,Calatorao,3013,1641,1372
50,Zaragoza,69,Calcena,69,36,33
50,Zaragoza,70,Calmarza,82,42,40
50,Zaragoza,71,Campillo de Aragón,173,94,79
50,Zaragoza,72,Carenas,238,117,121
50,Zaragoza,73,Cariñena,3500,1917,1583
50,Zaragoza,74,Caspe,7870,3905,3965
50,Zaragoza,75,Castejón de Alarba,98,53,45
50,Zaragoza,76,Castejón de las Armas,99,51,48
50,Zaragoza,77,Castejón de Valdejasa,315,165,150
50,Zaragoza,78,Castiliscar,395,208,187
50,Zaragoza,79,Cervera de la Cañada,329,163,166
50,Zaragoza,80,Cerveruela,29,23,6
50,Zaragoza,81,Cetina,707,344,363
50,Zaragoza,92,Chiprana,368,186,182
50,Zaragoza,93,Chodes,138,68,70
50,Zaragoza,82,Cimballa,143,71,72
50,Zaragoza,83,Cinco Olivas,123,61,62
50,Zaragoza,84,Clarés de Ribota,101,53,48
50,Zaragoza,85,Codo,228,114,114
50,Zaragoza,86,Codos,277,172,105
50,Zaragoza,87,Contamina,50,31,19
50,Zaragoza,88,Cosuenda,392,205,187
50,Zaragoza,89,Cuarte de Huerva,2582,1350,1232
50,Zaragoza,90,Cubel,198,96,102
50,Zaragoza,91,Cuerlas (Las),95,47,48
50,Zaragoza,94,Daroca,2155,1087,1068
50,Zaragoza,95,Ejea de los Caballeros,16598,8664,7934
50,Zaragoza,96,Embid de Ariza,84,48,36
50,Zaragoza,98,Encinacorba,294,152,142
50,Zaragoza,99,Épila,4089,2148,1941
50,Zaragoza,100,Erla,438,213,225
50,Zaragoza,101,Escatrón,1160,559,601
50,Zaragoza,102,Fabara,1195,636,559
50,Zaragoza,104,Farlete,442,218,224
50,Zaragoza,105,Fayón,395,201,194
50,Zaragoza,106,Fayos (Los),175,85,90
50,Zaragoza,107,Figueruelas,1111,561,550
50,Zaragoza,108,Fombuena,14,11,3
50,Zaragoza,109,Frago (El),119,71,48
50,Zaragoza,110,Frasno (El),530,280,250
50,Zaragoza,111,Fréscano,231,117,114
50,Zaragoza,113,Fuendejalón,773,395,378
50,Zaragoza,114,Fuendetodos,176,93,83
50,Zaragoza,115,Fuentes de Ebro,4085,2157,1928
50,Zaragoza,116,Fuentes de Jiloca,308,158,150
50,Zaragoza,117,Gallocanta,158,84,74
50,Zaragoza,118,Gallur,2938,1513,1425
50,Zaragoza,119,Gelsa,1216,609,607
50,Zaragoza,120,Godojos,60,29,31
50,Zaragoza,121,Gotor,389,204,185
50,Zaragoza,122,Grisel,60,37,23
50,Zaragoza,123,Grisén,477,245,232
50,Zaragoza,124,Herrera de los Navarros,634,331,303
50,Zaragoza,125,Ibdes,541,282,259
50,Zaragoza,126,Illueca,3396,1661,1735
50,Zaragoza,128,Isuerre,53,35,18
50,Zaragoza,129,Jaraba,316,169,147
50,Zaragoza,130,Jarque,556,298,258
50,Zaragoza,131,Jaulín,307,159,148
50,Zaragoza,132,Joyosa (La),609,310,299
50,Zaragoza,133,Lagata,132,73,59
50,Zaragoza,134,Langa del Castillo,175,86,89
50,Zaragoza,135,Layana,120,61,59
50,Zaragoza,136,Lécera,777,390,387
50,Zaragoza,138,Lechón,58,34,24
50,Zaragoza,137,Leciñena,1280,647,633
50,Zaragoza,139,Letux,433,225,208
50,Zaragoza,140,Litago,195,106,89
50,Zaragoza,141,Lituénigo,123,60,63
50,Zaragoza,142,Lobera de Onsella,62,37,25
50,Zaragoza,143,Longares,906,512,394
50,Zaragoza,144,Longás,53,32,21
50,Zaragoza,146,Lucena de Jalón,252,131,121
50,Zaragoza,147,Luceni,1048,523,525
50,Zaragoza,148,Luesia,384,210,174
50,Zaragoza,149,Luesma,40,22,18
50,Zaragoza,150,Lumpiaque,900,468,432
50,Zaragoza,151,Luna,881,468,413
50,Zaragoza,152,Maella,2025,1049,976
50,Zaragoza,153,Magallón,1164,621,543
50,Zaragoza,154,Mainar,162,86,76
50,Zaragoza,155,Malanquilla,132,68,64
50,Zaragoza,156,Maleján,291,145,146
50,Zaragoza,160,Mallén,3333,1784,1549
50,Zaragoza,157,Malón,427,220,207
50,Zaragoza,159,Maluenda,1020,492,528
50,Zaragoza,161,Manchones,148,77,71
50,Zaragoza,162,Mara,200,98,102
50,Zaragoza,163,María de Huerva,2125,1122,1003
50,Zaragoza,902,Marracos,111,58,53
50,Zaragoza,164,Mediana de Aragón,504,252,252
50,Zaragoza,165,Mequinenza,2493,1249,1244
50,Zaragoza,166,Mesones de Isuela,339,164,175
50,Zaragoza,167,Mezalocha,285,163,122
50,Zaragoza,168,Mianos,45,24,21
50,Zaragoza,169,Miedes de Aragón,496,255,241
50,Zaragoza,170,Monegrillo,517,285,232
50,Zaragoza,171,Moneva,123,67,56
50,Zaragoza,172,Monreal de Ariza,257,138,119
50,Zaragoza,173,Monterde,231,124,107
50,Zaragoza,174,Montón,144,79,65
50,Zaragoza,175,Morata de Jalón,1393,690,703
50,Zaragoza,176,Morata de Jiloca,307,164,143
50,Zaragoza,177,Morés,425,225,200
50,Zaragoza,178,Moros,512,264,248
50,Zaragoza,179,Moyuela,315,165,150
50,Zaragoza,180,Mozota,121,60,61
50,Zaragoza,181,Muel,1142,578,564
50,Zaragoza,182,Muela (La),2858,1489,1369
50,Zaragoza,183,Munébrega,438,236,202
50,Zaragoza,184,Murero,139,75,64
50,Zaragoza,185,Murillo de Gállego,182,103,79
50,Zaragoza,186,Navardún,54,30,24
50,Zaragoza,187,Nigüella,97,52,45
50,Zaragoza,188,Nombrevilla,50,28,22
50,Zaragoza,189,Nonaspe,1042,535,507
50,Zaragoza,190,Novallas,807,410,397
50,Zaragoza,191,Novillas,667,346,321
50,Zaragoza,192,Nuévalos,384,205,179
50,Zaragoza,193,Nuez de Ebro,627,323,304
50,Zaragoza,194,Olvés,136,74,62
50,Zaragoza,195,Orcajo,39,21,18
50,Zaragoza,196,Orera,131,68,63
50,Zaragoza,197,Orés,107,61,46
50,Zaragoza,198,Oseja,52,30,22
50,Zaragoza,199,Osera de Ebro,379,190,189
50,Zaragoza,200,Paniza,729,383,346
50,Zaragoza,201,Paracuellos de Jiloca,507,250,257
50,Zaragoza,202,Paracuellos de la Ribera,234,112,122
50,Zaragoza,203,Pastriz,1216,591,625
50,Zaragoza,204,Pedrola,2906,1509,1397
50,Zaragoza,205,Pedrosas (Las),96,52,44
50,Zaragoza,206,Perdiguera,589,306,283
50,Zaragoza,207,Piedratajada,168,86,82
50,Zaragoza,208,Pina de Ebro,2352,1197,1155
50,Zaragoza,209,Pinseque,2197,1109,1088
50,Zaragoza,210,Pintanos (Los),102,60,42
50,Zaragoza,211,Plasencia de Jalón,368,205,163
50,Zaragoza,212,Pleitas,62,35,27
50,Zaragoza,213,Plenas,131,65,66
50,Zaragoza,214,Pomer,35,20,15
50,Zaragoza,215,Pozuel de Ariza,27,17,10
50,Zaragoza,216,Pozuelo de Aragón,338,185,153
50,Zaragoza,217,Pradilla de Ebro,638,333,305
50,Zaragoza,218,Puebla de Albortón,144,86,58
50,Zaragoza,219,Puebla de Alfindén (La),3076,1563,1513
50,Zaragoza,220,Puendeluna,65,40,25
50,Zaragoza,221,Purujosa,59,42,17
50,Zaragoza,222,Quinto,2045,1021,1024
50,Zaragoza,223,Remolinos,1210,614,596
50,Zaragoza,224,Retascón,99,55,44
50,Zaragoza,225,Ricla,2653,1491,1162
50,Zaragoza,227,Romanos,124,71,53
50,Zaragoza,228,Rueda de Jalón,360,182,178
50,Zaragoza,229,Ruesca,86,44,42
50,Zaragoza,241,Sabiñán,809,397,412
50,Zaragoza,230,Sádaba,1845,925,920
50,Zaragoza,231,Salillas de Jalón,344,184,160
50,Zaragoza,232,Salvatierra de Esca,269,134,135
50,Zaragoza,233,Samper del Salz,130,68,62
50,Zaragoza,234,San Martín de la Virgen de Moncayo,291,160,131
50,Zaragoza,235,San Mateo de Gállego,2381,1244,1137
50,Zaragoza,236,Santa Cruz de Grío,214,110,104
50,Zaragoza,237,Santa Cruz de Moncayo,118,58,60
50,Zaragoza,238,Santa Eulalia de Gállego,134,72,62
50,Zaragoza,239,Santed,75,36,39
50,Zaragoza,240,Sástago,1307,657,650
50,Zaragoza,242,Sediles,93,47,46
50,Zaragoza,243,Sestrica,460,243,217
50,Zaragoza,244,Sierra de Luna,269,142,127
50,Zaragoza,245,Sigüés,172,88,84
50,Zaragoza,246,Sisamón,60,39,21
50,Zaragoza,247,Sobradiel,752,397,355
50,Zaragoza,248,Sos del Rey Católico,740,372,368
50,Zaragoza,249,Tabuenca,453,250,203
50,Zaragoza,250,Talamantes,65,36,29
50,Zaragoza,251,Tarazona,10774,5245,5529
50,Zaragoza,252,Tauste,7289,3674,3615
50,Zaragoza,253,Terrer,539,266,273
50,Zaragoza,254,Tierga,221,122,99
50,Zaragoza,255,Tobed,250,125,125
50,Zaragoza,256,Torralba de los Frailes,87,45,42
50,Zaragoza,257,Torralba de Ribota,189,101,88
50,Zaragoza,258,Torralbilla,71,37,34
50,Zaragoza,259,Torrehermosa,102,53,49
50,Zaragoza,260,Torrelapaja,40,22,18
50,Zaragoza,261,Torrellas,312,173,139
50,Zaragoza,262,Torres de Berrellén,1450,740,710
50,Zaragoza,263,Torrijo de la Cañada,337,185,152
50,Zaragoza,264,Tosos,217,112,105
50,Zaragoza,265,Trasmoz,65,35,30
50,Zaragoza,266,Trasobares,183,103,80
50,Zaragoza,267,Uncastillo,863,429,434
50,Zaragoza,268,Undués de Lerda,60,35,25
50,Zaragoza,269,Urrea de Jalón,344,168,176
50,Zaragoza,270,Urriés,59,36,23
50,Zaragoza,271,Used,350,194,156
50,Zaragoza,272,Utebo,13227,6750,6477
50,Zaragoza,274,Val de San Martín,84,42,42
50,Zaragoza,273,Valdehorna,51,26,25
50,Zaragoza,275,Valmadrid,100,63,37
50,Zaragoza,276,Valpalmas,168,83,85
50,Zaragoza,277,Valtorres,109,54,55
50,Zaragoza,278,Velilla de Ebro,256,127,129
50,Zaragoza,279,Velilla de Jiloca,114,57,57
50,Zaragoza,280,Vera de Moncayo,432,222,210
50,Zaragoza,281,Vierlas,98,48,50
50,Zaragoza,283,Villadoz,88,50,38
50,Zaragoza,284,Villafeliche,226,116,110
50,Zaragoza,285,Villafranca de Ebro,684,340,344
50,Zaragoza,286,Villalba de Perejil,123,64,59
50,Zaragoza,287,Villalengua,395,203,192
50,Zaragoza,288,Villanueva de Gállego,3662,1849,1813
50,Zaragoza,290,Villanueva de Huerva,574,302,272
50,Zaragoza,289,Villanueva de Jiloca,85,46,39
50,Zaragoza,291,Villar de los Navarros,143,71,72
50,Zaragoza,292,Villarreal de Huerva,193,114,79
50,Zaragoza,293,Villarroya de la Sierra,622,321,301
50,Zaragoza,294,Villarroya del Campo,80,43,37
50,Zaragoza,282,Vilueña (La),107,49,58
50,Zaragoza,295,Vistabella,34,21,13
50,Zaragoza,296,Zaida (La),558,282,276
50,Zaragoza,297,Zaragoza,638799,308935,329864
50,Zaragoza,298,Zuera,5973,3072,2901
51,Ceuta,1,Ceuta,74654,38113,36541
52,Melilla,1,Melilla,68016,34455,33561
